Empty_Lines,Lines_Of_Comments,Lines_Of_Program,Physic_Lines,n1_Number_Of_Distinct_Operators,n2_Number_Of_Distinct_Operands,n_Program_Vocabulary,N1_Total_Number_Of_Operators,N2_Total_Number_Of_Operands,N_Program_Length,B_Number_of_Delivered_Bugs_1,B_Number_of_Delivered_Bugs_2,D_Difficulty,E_Effort,T_Time_Required_To_Program,V_Volume,_N_Calculated_Program_Length,McCab_Number,IsVulnerable
0,0,8,8,4,11,15,21,39,60,0.000333,0.078138,6,1406.480614,78.137812,234.413436,46.053748,1,5
0,0,28,28,19,52,71,148,98,246,0.000333,0.504279,9,13615.54012,756.418896,1512.837791,377.133488,12,5
0,0,27,27,19,52,71,145,97,242,0.000333,0.49608,9,13394.14923,744.119401,1488.238803,377.133488,11,5
0,0,26,26,18,47,65,115,86,201,0.000333,0.403499,9,10894.46337,605.247965,1210.49593,336.124326,11,5
0,0,28,28,18,49,67,127,99,226,0.000333,0.456979,18,24676.85083,1370.936157,1370.936157,350.179432,9,5
0,0,26,26,19,47,66,115,88,203,0.000333,0.409004,9,11043.10806,613.506003,1227.012006,341.776299,9,5
0,0,27,27,20,47,67,118,90,208,0.000333,0.420582,10,12617.46552,700.970306,1261.746552,347.504238,9,5
0,0,8,8,4,11,15,21,39,60,0.000333,0.078138,6,1406.480614,78.137812,234.413436,46.053748,1,5
0,0,10,10,12,17,29,32,34,66,0.000333,0.106876,12,3847.520948,213.751164,320.626746,112.506418,2,5
0,0,11,11,13,19,32,42,39,81,0.000333,0.135,12,4860,270,405,128.816339,2,5
0,0,2,2,4,8,12,6,9,15,0.000333,0.017925,2,107.548875,5.974938,53.774438,32,1,5
0,0,9,9,11,17,28,28,28,56,0.000333,0.089737,5,1346.059378,74.781077,269.211876,107.540616,2,5
0,0,12,12,12,20,32,36,45,81,0.000333,0.135,12,4860,270,405,129.458112,2,5
0,0,7,7,11,16,27,24,22,46,0.000333,0.072908,5,1093.624125,60.756896,218.724825,102.053748,2,5
0,0,9,9,12,18,30,30,24,54,0.000333,0.088324,6,1589.832553,88.324031,264.972092,118.0782,4,5
0,0,9,9,12,16,28,30,24,54,0.000333,0.086532,6,1557.582995,86.532389,259.597166,107.01955,4,5
0,0,9,9,11,18,29,30,26,56,0.000333,0.090682,5,1360.234679,75.568593,272.046936,113.112398,4,5
0,0,3,3,5,9,14,6,12,18,0.000333,0.022844,2,137.064777,7.61471,68.532389,40.138965,1,5
0,0,10,10,13,18,31,34,35,69,0.000333,0.113947,6,2051.037273,113.946515,341.839545,123.164366,2,5
0,0,29,29,18,49,67,127,102,229,0.000333,0.463045,18,25004.41964,1389.134425,1389.134425,350.179432,9,5
0,0,28,28,18,48,66,119,102,221,0.000333,0.44527,18,24044.59981,1335.8111,1335.8111,343.13685,9,5
0,0,12,12,11,20,31,42,42,84,0.000333,0.138717,10,4161.524901,231.195828,416.15249,124.49231,2,5
0,0,29,29,18,50,68,121,105,226,0.000333,0.458589,18,24763.79884,1375.766602,1375.766602,357.25146,9,5
0,0,9,9,13,17,30,31,28,59,0.000333,0.096502,6,1737.039271,96.502182,289.506545,117.592585,2,5
0,0,2,2,6,6,12,6,9,15,0.000333,0.017925,3,161.323313,8.962406,53.774438,31.01955,1,5
0,0,27,27,18,48,66,119,95,214,0.000333,0.431167,9,11641.50307,646.750171,1293.500342,343.13685,9,5
0,0,10,10,12,18,30,33,29,62,0.000333,0.101409,6,1825.363302,101.409072,304.227217,118.0782,3,5
0,0,2,2,4,8,12,6,9,15,0.000333,0.017925,2,107.548875,5.974938,53.774438,32,1,5
0,0,27,27,19,47,66,117,94,211,0.000333,0.425122,18,22956.60887,1275.367159,1275.367159,341.776299,9,5
0,0,10,10,14,19,33,42,35,77,0.000333,0.129473,7,2718.92843,151.051579,388.418347,134.013592,4,5
0,0,10,10,8,16,24,29,25,54,0.000333,0.082529,4,990.3519,55.01955,247.587975,88,3,5
0,0,7,7,10,12,22,24,22,46,0.000333,0.068378,5,1025.669272,56.981626,205.133854,76.238831,2,5
0,0,7,7,9,12,21,23,22,45,0.000333,0.065885,4,790.617136,43.923174,197.654284,71.548875,2,5
0,0,7,7,9,11,20,23,21,44,0.000333,0.063388,4,760.659345,42.258852,190.164836,66.583073,2,5
0,0,7,7,9,11,20,23,21,44,0.000333,0.063388,4,760.659345,42.258852,190.164836,66.583073,2,5
0,0,6,6,8,11,19,20,20,40,0.000333,0.056639,4,679.668402,37.759356,169.917101,62.053748,1,5
0,0,5,5,7,10,17,11,12,23,0.000333,0.031337,3,282.034936,15.668608,94.011645,52.870765,2,5
0,0,24,24,18,44,62,104,85,189,0.000333,0.375114,9,10128.08792,562.671551,1125.343103,315.273641,8,5
0,0,24,24,19,44,63,105,79,184,0.000333,0.366607,9,9898.375553,549.909753,1099.819506,320.925614,8,5
0,0,23,23,18,43,61,103,78,181,0.000333,0.357821,9,9661.171123,536.731729,1073.463458,308.388034,7,5
0,0,23,23,18,43,61,100,78,178,0.000333,0.35189,9,9501.041215,527.835623,1055.671246,308.388034,7,5
0,0,24,24,18,46,64,103,83,186,0.000333,0.372,9,10044,558,1116,329.1425,7,5
0,0,24,24,20,43,63,105,80,185,0.000333,0.368599,10,11057.96786,614.331548,1105.796786,319.767946,7,5
0,0,23,23,19,43,62,102,78,180,0.000333,0.357252,9,9645.798023,535.877668,1071.755336,314.040007,7,5
0,0,7,7,11,16,27,24,22,46,0.000333,0.072908,5,1093.624125,60.756896,218.724825,102.053748,2,5
0,0,9,9,11,16,27,30,24,54,0.000333,0.085588,5,1283.819626,71.323313,256.763925,102.053748,4,5
0,0,3,3,5,9,14,6,12,18,0.000333,0.022844,2,137.064777,7.61471,68.532389,40.138965,1,5
0,0,10,10,7,14,21,22,36,58,0.000333,0.084918,6,1528.526463,84.918137,254.754411,72.954453,1,5
0,0,8,8,10,14,24,20,28,48,0.000333,0.073359,10,2200.782,122.265667,220.0782,86.52225,1,5
0,0,23,23,18,43,61,102,74,176,0.000333,0.347937,9,9394.287943,521.904886,1043.809771,308.388034,9,5
0,0,10,10,11,13,24,24,36,60,0.000333,0.091699,10,2750.9775,152.832083,275.09775,86.159464,1,5
0,0,2,2,6,6,12,6,9,15,0.000333,0.017925,3,161.323313,8.962406,53.774438,31.01955,1,5
0,0,5,5,7,11,18,11,13,24,0.000333,0.033359,3,300.2346,16.6797,100.0782,57.705232,2,5
0,0,24,24,20,44,64,131,87,218,0.000333,0.436,10,13080,726.666667,1308,326.653553,9,5
0,0,31,31,19,56,75,161,108,269,0.000333,0.558517,9,15079.97005,837.776114,1675.552228,405.922498,14,5
0,0,30,30,19,56,75,158,107,265,0.000333,0.550212,9,14855.73258,825.318476,1650.636953,405.922498,13,5
0,0,27,27,20,44,64,137,87,224,0.000333,0.448,10,13440,746.666667,1344,326.653553,9,5
0,0,27,27,19,44,63,137,87,224,0.000333,0.446304,9,12050.19633,669.455351,1338.910703,320.925614,9,5
0,0,5,5,7,9,16,11,12,23,0.000333,0.030667,3,276,15.333333,92,48.180809,2,5
0,0,4,4,6,9,15,8,11,19,0.000333,0.024744,3,222.692764,12.37182,74.230921,44.0391,1,5
0,0,5,5,7,10,17,11,12,23,0.000333,0.031337,3,282.034936,15.668608,94.011645,52.870765,2,5
0,0,5,5,7,10,17,11,13,24,0.000333,0.0327,3,294.297325,16.349851,98.099108,52.870765,2,5
0,0,29,29,21,48,69,145,106,251,0.000333,0.51108,20,30664.79277,1703.599599,1533.239639,360.316866,9,5
0,0,12,12,10,17,27,34,28,62,0.000333,0.098268,5,1474.015126,81.889729,294.803025,102.706149,3,5
0,0,6,6,8,10,18,15,17,32,0.000333,0.044479,4,533.7504,29.6528,133.4376,57.219281,1,5
0,0,10,10,8,16,24,29,25,54,0.000333,0.082529,4,990.3519,55.01955,247.587975,88,3,5
0,0,10,10,8,16,24,29,25,54,0.000333,0.082529,4,990.3519,55.01955,247.587975,88,3,5
0,0,10,10,8,16,24,29,26,55,0.000333,0.084058,4,1008.69175,56.038431,252.172938,88,3,5
0,0,4,4,6,9,15,8,11,19,0.000333,0.024744,3,222.692764,12.37182,74.230921,44.0391,1,5
0,0,9,9,8,15,23,26,24,50,0.000333,0.075393,4,904.712391,50.2618,226.178098,82.603359,2,5
0,0,7,7,8,10,18,17,19,36,0.000333,0.050039,4,600.4692,33.3594,150.1173,57.219281,1,5
0,0,10,10,8,16,24,29,25,54,0.000333,0.082529,4,990.3519,55.01955,247.587975,88,3,5
0,0,30,30,19,56,75,158,107,265,0.000333,0.550212,9,14855.73258,825.318476,1650.636953,405.922498,13,5
0,0,32,32,22,58,80,168,115,283,0.000333,0.596369,11,19680.16216,1093.342342,1789.105651,437.870393,14,5
0,0,31,31,19,56,75,161,108,269,0.000333,0.558517,9,15079.97005,837.776114,1675.552228,405.922498,14,5
0,0,31,31,20,57,77,161,108,269,0.000333,0.561922,10,16857.65579,936.536433,1685.765579,418.913293,14,5
0,0,32,32,19,57,76,164,113,277,0.000333,0.576892,9,15576.08329,865.337961,1730.675921,413.185354,13,5
0,0,32,32,19,57,76,164,119,283,0.000333,0.589388,18,31826.94275,1768.163486,1768.163486,413.185354,13,5
0,0,32,32,20,57,77,165,113,278,0.000333,0.580722,10,17421.66658,967.870366,1742.166658,418.913293,13,5
0,0,11,11,9,11,20,26,21,47,0.000333,0.06771,4,812.522482,45.140138,203.13062,66.583073,3,5
0,0,31,31,19,57,76,161,108,269,0.000333,0.560231,9,15126.23251,840.346251,1680.692501,413.185354,14,5
0,0,31,31,19,57,76,161,109,270,0.000333,0.562313,9,15182.46386,843.470214,1686.940429,413.185354,14,5
0,0,2,2,6,9,15,8,10,18,0.000333,0.023441,3,210.972092,11.720672,70.324031,44.0391,1,5
0,0,7,7,7,13,20,15,22,37,0.000333,0.053304,3,479.734019,26.65189,159.91134,67.757201,1,5
0,0,10,10,8,17,25,29,26,55,0.000333,0.085137,4,1021.648362,56.758242,255.41209,93.486868,3,5
0,0,6,6,6,10,16,12,17,29,0.000333,0.038667,3,348,19.333333,116,48.729056,1,5
0,0,10,10,8,16,24,29,25,54,0.000333,0.082529,4,990.3519,55.01955,247.587975,88,3,5
0,0,7,7,7,11,18,16,24,40,0.000333,0.055599,6,1000.782,55.599,166.797,57.705232,2,5
0,0,8,8,8,12,20,22,26,48,0.000333,0.069151,8,1659.620388,92.201133,207.452549,67.01955,1,5
0,0,7,7,8,11,19,17,18,35,0.000333,0.049559,4,594.709852,33.039436,148.677463,62.053748,2,5
0,0,33,33,19,55,74,163,133,296,0.000333,0.612666,18,33083.96753,1837.998196,1837.998196,398.685407,11,5
0,0,27,27,19,46,65,136,89,225,0.000333,0.451678,9,12195.29482,677.516379,1355.032758,334.794473,9,5
0,0,29,29,21,46,67,144,95,239,0.000333,0.483265,20,28995.90633,1610.883685,1449.795317,346.322516,9,5
0,0,29,29,20,53,73,152,103,255,0.000333,0.526135,10,15784.05263,876.891813,1578.405263,390.018346,11,5
0,0,29,29,19,55,74,152,104,256,0.000333,0.529873,9,14306.58055,794.810031,1589.620062,398.685407,11,5
0,0,21,21,18,42,60,96,72,168,0.000333,0.330786,9,8931.218581,496.17881,992.35762,301.535982,7,5
0,0,8,8,8,12,20,26,28,54,0.000333,0.077795,8,1867.072937,103.726274,233.384117,67.01955,1,5
0,0,31,31,19,54,73,157,121,278,0.000333,0.57359,18,30973.88209,1720.771227,1720.771227,391.474548,11,5
0,0,29,29,21,47,68,145,92,237,0.000333,0.48091,10,14427.28693,801.515941,1442.728693,353.304342,10,5
0,0,30,30,20,53,73,152,101,253,0.000333,0.522009,10,15660.25613,870.01423,1566.025613,390.018346,12,5
0,0,28,28,19,53,72,148,98,246,0.000333,0.505934,9,13660.21395,758.900775,1517.80155,384.290407,12,5
0,0,28,28,19,54,73,148,99,247,0.000333,0.509629,9,13759.97999,764.443333,1528.886666,391.474548,12,5
0,0,28,28,19,53,72,148,98,246,0.000333,0.505934,9,13660.21395,758.900775,1517.80155,384.290407,12,5
0,0,30,30,21,53,74,153,101,254,0.000333,0.525734,10,15772.01155,876.222864,1577.201155,395.81845,12,5
0,0,28,28,19,54,73,148,99,247,0.000333,0.509629,9,13759.97999,764.443333,1528.886666,391.474548,12,5
0,0,28,28,19,53,72,148,98,246,0.000333,0.505934,9,13660.21395,758.900775,1517.80155,384.290407,12,5
0,0,28,28,19,53,72,148,98,246,0.000333,0.505934,9,13660.21395,758.900775,1517.80155,384.290407,12,5
0,0,23,23,18,42,60,102,74,176,0.000333,0.346538,9,9356.514703,519.806372,1039.612745,301.535982,9,5
0,0,7,7,10,13,23,18,26,44,0.000333,0.066346,10,1990.367261,110.575959,199.036726,81.324997,1,5
0,0,23,23,18,44,62,102,76,178,0.000333,0.353282,9,9538.622489,529.923472,1059.846943,315.273641,9,5
0,0,23,23,18,43,61,102,74,176,0.000333,0.347937,9,9394.287943,521.904886,1043.809771,308.388034,9,5
0,0,23,23,18,43,61,102,74,176,0.000333,0.347937,9,9394.287943,521.904886,1043.809771,308.388034,9,5
0,0,2,2,6,9,15,8,10,18,0.000333,0.023441,3,210.972092,11.720672,70.324031,44.0391,1,5
0,0,22,22,18,49,67,114,84,198,0.000333,0.400362,9,10809.77094,600.54283,1201.08566,350.179432,9,5
0,0,31,31,20,50,70,153,99,252,0.000333,0.51486,10,15445.7932,858.099622,1544.57932,368.631371,12,5
0,0,31,31,19,49,68,153,99,252,0.000333,0.511347,18,27612.73145,1534.040636,1534.040636,355.831405,12,5
0,0,31,31,19,51,70,153,100,253,0.000333,0.516903,9,13956.37743,775.354302,1550.708603,370.004315,12,5
0,0,31,31,19,51,70,153,100,253,0.000333,0.516903,9,13956.37743,775.354302,1550.708603,370.004315,12,5
0,0,32,32,22,50,72,159,105,264,0.000333,0.542953,22,35834.92441,1990.829134,1628.8602,380.300305,12,5
0,0,9,9,6,12,18,22,33,55,0.000333,0.076449,6,1376.07525,76.448625,229.345875,58.529325,1,5
0,0,8,8,7,11,18,20,25,45,0.000333,0.062549,6,1125.87975,62.548875,187.646625,57.705232,1,5
0,0,8,8,4,11,15,21,39,60,0.000333,0.078138,6,1406.480614,78.137812,234.413436,46.053748,1,5
0,0,32,32,19,50,69,156,104,260,0.000333,0.529405,18,28587.89446,1588.216359,1588.216359,362.903432,11,5
0,0,7,7,7,11,18,18,19,37,0.000333,0.051429,3,462.861675,25.714538,154.287225,57.705232,1,5
0,0,3,3,6,9,15,7,10,17,0.000333,0.022139,3,199.25142,11.069523,66.41714,44.0391,1,5
0,0,11,11,6,13,19,27,43,70,0.000333,0.099118,9,2676.194333,148.677463,297.354926,63.615491,1,5
0,0,27,27,18,50,68,116,93,209,0.000333,0.424093,9,11450.5176,636.139867,1272.279734,357.25146,9,5
0,0,8,8,7,12,19,18,26,44,0.000333,0.062303,6,1121.452864,62.302937,186.908811,62.671034,2,5
0,0,8,8,8,12,20,19,20,39,0.000333,0.056185,4,674.220783,37.45671,168.555196,67.01955,2,5
0,0,7,7,8,11,19,17,19,36,0.000333,0.050975,4,611.701562,33.98342,152.92539,62.053748,1,5
0,0,7,7,6,11,17,14,19,33,0.000333,0.044962,3,404.658821,22.481046,134.886274,53.563523,1,5
0,0,8,8,7,14,21,17,24,41,0.000333,0.060028,3,540.255043,30.014169,180.085014,72.954453,1,5
0,0,8,8,8,11,19,19,21,40,0.000333,0.056639,4,679.668402,37.759356,169.917101,62.053748,1,5
0,0,7,7,7,11,18,16,19,35,0.000333,0.048649,3,437.842125,24.324563,145.947375,57.705232,1,5
0,0,22,22,18,49,67,114,84,198,0.000333,0.400362,9,10809.77094,600.54283,1201.08566,350.179432,9,5
0,0,24,24,21,51,72,124,92,216,0.000333,0.444235,10,13327.038,740.391,1332.7038,381.532358,10,5
0,0,23,23,18,51,69,117,86,203,0.000333,0.413343,9,11160.27418,620.015232,1240.030465,364.352342,10,5
0,0,23,23,18,51,69,117,86,203,0.000333,0.413343,9,11160.27418,620.015232,1240.030465,364.352342,10,5
0,0,23,23,18,49,67,117,85,202,0.000333,0.40845,9,11028.15015,612.675008,1225.350016,350.179432,10,5
0,0,23,23,18,50,68,117,85,202,0.000333,0.409889,9,11067.00745,614.833747,1229.667494,357.25146,10,5
0,0,23,23,18,50,68,117,85,202,0.000333,0.409889,9,11067.00745,614.833747,1229.667494,357.25146,10,5
0,0,25,25,20,51,71,126,89,215,0.000333,0.440732,10,13221.95631,734.553128,1322.195631,375.732254,10,5
0,0,25,25,19,50,69,121,88,209,0.000333,0.425561,9,11490.1345,638.340806,1276.681611,362.903432,10,5
0,0,7,7,7,11,18,16,15,31,0.000333,0.043089,3,387.803025,21.544613,129.267675,57.705232,3,5
0,0,7,7,7,11,18,16,17,33,0.000333,0.045869,3,412.822575,22.934588,137.607525,57.705232,3,5
0,0,7,7,7,10,17,16,15,31,0.000333,0.042237,3,380.134044,21.118558,126.711348,52.870765,3,5
0,0,5,5,6,10,16,10,13,23,0.000333,0.030667,3,276,15.333333,92,48.729056,1,5
0,0,21,21,16,48,64,111,80,191,0.000333,0.382,8,9168,509.333333,1146,332.0782,9,5
0,0,26,26,18,46,64,115,84,199,0.000333,0.398,9,10746,597,1194,329.1425,11,5
0,0,26,26,18,48,66,115,86,201,0.000333,0.404974,9,10934.30896,607.461609,1214.923218,343.13685,11,5
0,0,30,30,20,47,67,125,90,215,0.000333,0.434736,10,13042.09176,724.560653,1304.209176,347.504238,11,5
0,0,26,26,18,48,66,115,86,201,0.000333,0.404974,9,10934.30896,607.461609,1214.923218,343.13685,11,5
0,0,22,22,18,49,67,114,84,198,0.000333,0.400362,9,10809.77094,600.54283,1201.08566,350.179432,9,5
0,0,22,22,18,49,67,114,84,198,0.000333,0.400362,9,10809.77094,600.54283,1201.08566,350.179432,9,5
0,0,22,22,18,49,67,114,84,198,0.000333,0.400362,9,10809.77094,600.54283,1201.08566,350.179432,9,5
0,0,22,22,18,49,67,114,84,198,0.000333,0.400362,9,10809.77094,600.54283,1201.08566,350.179432,9,5
0,0,22,22,18,49,67,114,84,198,0.000333,0.400362,9,10809.77094,600.54283,1201.08566,350.179432,9,5
0,0,24,24,18,50,68,122,97,219,0.000333,0.444385,9,11998.38926,666.577181,1333.154362,357.25146,9,5
0,0,22,22,18,49,67,114,84,198,0.000333,0.400362,9,10809.77094,600.54283,1201.08566,350.179432,9,5
0,0,33,33,19,58,77,170,122,292,0.000333,0.609967,18,32938.23006,1829.90167,1829.90167,420.47352,13,5
0,0,30,30,19,50,69,149,99,248,0.000333,0.504971,9,13634.22659,757.457033,1514.914065,362.903432,11,5
0,0,34,34,19,59,78,179,126,305,0.000333,0.639016,18,34506.85818,1917.047677,1917.047677,427.786563,13,5
0,0,34,34,19,60,79,170,129,299,0.000333,0.628277,18,33926.94799,1884.830444,1884.830444,435.124058,13,5
0,0,34,34,19,58,77,175,126,301,0.000333,0.628768,18,33953.44948,1886.302749,1886.302749,420.47352,13,5
0,0,30,30,19,50,69,148,102,250,0.000333,0.509044,18,27488.36006,1527.131114,1527.131114,362.903432,11,5
0,0,29,29,22,46,68,146,95,241,0.000333,0.489026,22,32275.72798,1793.095999,1467.078545,352.191346,10,5
0,0,27,27,19,45,64,137,88,225,0.000333,0.45,9,12150,675,1350,327.844012,9,5
0,0,28,28,20,46,66,140,89,229,0.000333,0.461389,10,13841.66253,768.981252,1384.166253,340.522412,10,5
0,0,28,28,19,45,64,140,89,229,0.000333,0.458,9,12366,687,1374,327.844012,10,5
0,0,29,29,19,46,65,143,94,237,0.000333,0.475767,18,25691.42109,1427.301172,1427.301172,334.794473,9,5
0,0,30,30,19,46,65,149,96,245,0.000333,0.491827,18,26558.64206,1475.480114,1475.480114,334.794473,9,5
0,0,29,29,19,48,67,144,95,239,0.000333,0.483265,9,13048.15785,724.897658,1449.795317,348.788823,9,5
0,0,21,21,21,47,68,111,82,193,0.000333,0.391627,10,11748.80328,652.711294,1174.880328,353.304342,8,5
0,0,19,19,18,45,63,101,74,175,0.000333,0.348675,9,9414.21588,523.011993,1046.023987,322.192039,7,5
0,0,19,19,18,45,63,101,74,175,0.000333,0.348675,9,9414.21588,523.011993,1046.023987,322.192039,7,5
0,0,21,21,18,46,64,110,80,190,0.000333,0.38,9,10260,570,1140,329.1425,7,5
0,0,19,19,18,45,63,101,74,175,0.000333,0.348675,9,9414.21588,523.011993,1046.023987,322.192039,7,5
0,0,19,19,18,45,63,101,74,175,0.000333,0.348675,9,9414.21588,523.011993,1046.023987,322.192039,7,5
0,0,21,21,19,46,65,110,81,191,0.000333,0.383424,9,10352.45027,575.136126,1150.272252,334.794473,7,5
0,0,19,19,18,45,63,101,74,175,0.000333,0.348675,9,9414.21588,523.011993,1046.023987,322.192039,7,5
0,0,28,28,19,45,64,140,89,229,0.000333,0.458,9,12366,687,1374,327.844012,10,5
0,0,8,8,10,13,23,30,26,56,0.000333,0.08444,10,2533.194695,140.733039,253.31947,81.324997,3,5
0,0,7,7,7,12,19,18,15,33,0.000333,0.046727,3,420.544824,23.363601,140.181608,62.671034,3,5
0,0,7,7,7,10,17,18,15,33,0.000333,0.044962,3,404.658821,22.481046,134.886274,52.870765,3,5
0,0,28,28,19,46,65,140,90,230,0.000333,0.461715,9,12466.30137,692.572298,1385.144597,334.794473,10,5
0,0,28,28,19,46,65,140,89,229,0.000333,0.459707,9,12412.10006,689.561115,1379.122229,334.794473,10,5
0,0,8,8,8,12,20,21,20,41,0.000333,0.059066,4,708.796208,39.377567,177.199052,67.01955,2,5
0,0,8,8,7,12,19,20,26,46,0.000333,0.065135,6,1172.427994,65.134889,195.404666,62.671034,2,5
0,0,27,27,19,45,64,137,88,225,0.000333,0.45,9,12150,675,1350,327.844012,9,5
0,0,8,8,7,14,21,19,24,43,0.000333,0.062957,3,566.608948,31.478275,188.869649,72.954453,1,5
0,0,19,19,18,42,60,101,71,172,0.000333,0.338662,9,9143.866642,507.992591,1015.985182,301.535982,7,5
0,0,19,19,18,45,63,101,74,175,0.000333,0.348675,9,9414.21588,523.011993,1046.023987,322.192039,7,5
0,0,19,19,18,45,63,101,74,175,0.000333,0.348675,9,9414.21588,523.011993,1046.023987,322.192039,7,5
0,0,19,19,18,45,63,101,74,175,0.000333,0.348675,9,9414.21588,523.011993,1046.023987,322.192039,7,5
0,0,18,18,16,44,60,98,70,168,0.000333,0.330786,8,7938.86096,441.047831,992.35762,304.214991,7,5
0,0,19,19,18,45,63,101,74,175,0.000333,0.348675,9,9414.21588,523.011993,1046.023987,322.192039,7,5
0,0,7,7,7,12,19,18,17,35,0.000333,0.049559,3,446.032389,24.779577,148.677463,62.671034,3,5
0,0,7,7,7,12,19,18,17,35,0.000333,0.049559,3,446.032389,24.779577,148.677463,62.671034,3,5
0,0,10,10,8,17,25,29,26,55,0.000333,0.085137,4,1021.648362,56.758242,255.41209,93.486868,3,5
0,0,18,18,10,17,27,57,44,101,0.000333,0.160081,10,4802.436377,266.802021,480.243638,102.706149,4,5
0,0,12,12,9,17,26,33,28,61,0.000333,0.095576,4,1146.907291,63.717072,286.726823,98.016193,3,5
0,0,9,9,8,15,23,26,24,50,0.000333,0.075393,4,904.712391,50.2618,226.178098,82.603359,2,5
0,0,11,11,11,17,28,35,31,66,0.000333,0.105762,5,1586.427124,88.13484,317.285425,107.540616,3,5
0,0,10,10,9,16,25,29,25,54,0.000333,0.083589,4,1003.072937,55.726274,250.768234,92.529325,3,5
0,0,10,10,9,16,25,29,25,54,0.000333,0.083589,4,1003.072937,55.726274,250.768234,92.529325,3,5
0,0,10,10,8,17,25,29,26,55,0.000333,0.085137,4,1021.648362,56.758242,255.41209,93.486868,3,5
0,0,7,7,6,11,17,16,19,35,0.000333,0.047687,3,429.183598,23.843533,143.061199,53.563523,1,5
0,0,7,7,8,11,19,19,19,38,0.000333,0.053807,4,645.684982,35.871388,161.421246,62.053748,1,5
0,0,7,7,7,12,19,16,17,33,0.000333,0.046727,3,420.544824,23.363601,140.181608,62.671034,3,5
0,0,26,26,18,47,65,115,84,199,0.000333,0.399484,9,10786.06075,599.225597,1198.451195,336.124326,11,5
0,0,24,24,18,46,64,109,82,191,0.000333,0.382,9,10314,573,1146,329.1425,9,5
0,0,26,26,18,47,65,115,84,199,0.000333,0.399484,9,10786.06075,599.225597,1198.451195,336.124326,11,5
0,0,26,26,18,47,65,115,84,199,0.000333,0.399484,9,10786.06075,599.225597,1198.451195,336.124326,11,5
0,0,26,26,18,47,65,115,84,199,0.000333,0.399484,9,10786.06075,599.225597,1198.451195,336.124326,11,5
0,0,27,27,19,48,67,118,89,207,0.000333,0.41856,9,11301.12416,627.840231,1255.680462,348.788823,10,5
0,0,24,24,18,46,64,109,82,191,0.000333,0.382,9,10314,573,1146,329.1425,9,5
0,0,27,27,21,48,69,127,95,222,0.000333,0.452031,10,13560.92429,753.384683,1356.092429,360.316866,11,5
0,0,26,26,18,46,64,115,84,199,0.000333,0.398,9,10746,597,1194,329.1425,11,5
0,0,26,26,18,48,66,115,86,201,0.000333,0.404974,9,10934.30896,607.461609,1214.923218,343.13685,11,5
0,0,26,26,18,48,66,115,86,201,0.000333,0.404974,9,10934.30896,607.461609,1214.923218,343.13685,11,5
0,0,9,9,8,13,21,30,30,60,0.000333,0.087846,8,2108.312363,117.128465,263.539045,72.105716,1,5
0,0,2,2,4,8,12,6,9,15,0.000333,0.017925,2,107.548875,5.974938,53.774438,32,1,5
0,0,2,2,6,6,12,6,9,15,0.000333,0.017925,3,161.323313,8.962406,53.774438,31.01955,1,5
0,0,13,13,17,21,38,42,47,89,0.000333,0.155689,16,7473.048779,415.169377,467.065549,161.725534,2,5
0,0,10,10,15,20,35,34,37,71,0.000333,0.121393,7,2549.253659,141.625203,364.179094,145.041921,2,5
0,0,7,7,9,12,21,23,21,44,0.000333,0.064421,4,773.047866,42.947104,193.261967,71.548875,2,5
0,0,7,7,9,12,21,23,21,44,0.000333,0.064421,4,773.047866,42.947104,193.261967,71.548875,2,5
0,0,7,7,7,12,19,18,17,35,0.000333,0.049559,3,446.032389,24.779577,148.677463,62.671034,3,5
0,0,12,12,9,14,23,38,25,63,0.000333,0.094995,4,1139.937613,63.329867,284.984403,81.832294,3,5
0,0,11,11,8,11,19,26,21,47,0.000333,0.066551,4,798.610373,44.367243,199.652593,62.053748,3,5
0,0,7,7,7,11,18,18,15,33,0.000333,0.045869,3,412.822575,22.934588,137.607525,57.705232,3,5
0,0,11,11,9,11,20,28,21,49,0.000333,0.070591,4,847.097907,47.060995,211.774477,66.583073,3,5
0,0,7,7,7,12,19,18,17,35,0.000333,0.049559,3,446.032389,24.779577,148.677463,62.671034,3,5
0,0,23,23,18,43,61,102,74,176,0.000333,0.347937,9,9394.287943,521.904886,1043.809771,308.388034,9,5
0,0,2,2,6,6,12,6,9,15,0.000333,0.017925,3,161.323313,8.962406,53.774438,31.01955,1,5
0,0,2,2,6,9,15,8,10,18,0.000333,0.023441,3,210.972092,11.720672,70.324031,44.0391,1,5
0,0,27,27,21,50,71,119,97,216,0.000333,0.442782,10,13283.45378,737.969654,1328.345378,374.431475,9,5
0,0,13,13,12,17,29,38,30,68,0.000333,0.110114,6,1982.056246,110.114236,330.342708,112.506418,4,5
0,0,9,9,11,17,28,29,32,61,0.000333,0.09775,5,1466.243251,81.457958,293.24865,107.540616,2,5
0,0,3,3,6,9,15,7,10,17,0.000333,0.022139,3,199.25142,11.069523,66.41714,44.0391,1,5
0,0,2,2,5,6,11,7,7,14,0.000333,0.016144,2,96.864085,5.381338,48.432043,27.119415,1,5
0,0,10,10,13,17,30,33,30,63,0.000333,0.103045,6,1854.804645,103.044703,309.134108,117.592585,2,5
0,0,10,10,12,20,32,31,33,64,0.000333,0.106667,6,1920,106.666667,320,129.458112,2,5
0,0,9,9,11,17,28,30,24,54,0.000333,0.086532,5,1297.985829,72.110324,259.597166,107.540616,4,5
0,0,9,9,11,17,28,30,26,56,0.000333,0.089737,5,1346.059378,74.781077,269.211876,107.540616,4,5
0,0,14,14,13,20,33,50,34,84,0.000333,0.141243,6,2542.374636,141.243035,423.729106,134.544278,4,5
0,0,13,13,13,17,30,40,30,70,0.000333,0.114494,6,2060.89405,114.494114,343.482342,117.592585,4,5
0,0,9,9,11,18,29,30,26,56,0.000333,0.090682,5,1360.234679,75.568593,272.046936,113.112398,4,5
0,0,9,9,11,17,28,30,24,54,0.000333,0.086532,5,1297.985829,72.110324,259.597166,107.540616,4,5
0,0,9,9,11,18,29,30,26,56,0.000333,0.090682,5,1360.234679,75.568593,272.046936,113.112398,4,5
0,0,9,9,11,17,28,30,24,54,0.000333,0.086532,5,1297.985829,72.110324,259.597166,107.540616,4,5
0,0,26,26,18,47,65,114,92,206,0.000333,0.413536,9,11165.46993,620.303885,1240.607769,336.124326,9,5
0,0,2,2,4,8,12,6,9,15,0.000333,0.017925,2,107.548875,5.974938,53.774438,32,1,5
0,0,26,26,18,47,65,116,88,204,0.000333,0.409521,9,11057.06731,614.281517,1228.563034,336.124326,9,5
0,0,2,2,5,6,11,7,7,14,0.000333,0.016144,2,96.864085,5.381338,48.432043,27.119415,1,5
0,0,9,9,6,12,18,20,33,53,0.000333,0.073669,6,1326.03615,73.668675,221.006025,58.529325,1,5
0,0,11,11,6,13,19,25,43,68,0.000333,0.096286,9,2599.731638,144.429535,288.859071,63.615491,1,5
0,0,25,25,18,45,63,114,89,203,0.000333,0.404463,9,10920.49042,606.693912,1213.387824,322.192039,7,5
0,0,7,7,6,11,17,15,23,38,0.000333,0.051775,6,931.941528,51.774529,155.323588,53.563523,1,5
0,0,8,8,4,11,15,21,39,60,0.000333,0.078138,6,1406.480614,78.137812,234.413436,46.053748,1,5
0,0,8,8,7,11,18,18,25,43,0.000333,0.059769,6,1075.84065,59.768925,179.306775,57.705232,1,5
0,0,27,27,18,45,63,111,102,213,0.000333,0.424387,18,22916.89123,1273.160624,1273.160624,322.192039,7,5
0,0,3,3,6,9,15,7,10,17,0.000333,0.022139,3,199.25142,11.069523,66.41714,44.0391,1,5
0,0,23,23,18,43,61,101,82,183,0.000333,0.361775,9,9767.924395,542.662466,1085.324933,308.388034,7,5
0,0,24,24,18,44,62,106,85,191,0.000333,0.379084,9,10235.26346,568.625748,1137.251495,315.273641,7,5
0,0,8,8,4,11,15,21,39,60,0.000333,0.078138,6,1406.480614,78.137812,234.413436,46.053748,1,5
0,0,37,37,23,49,72,137,109,246,0.000333,0.505934,22,33391.63411,1855.090784,1517.80155,379.162707,9,5
0,0,2,2,6,6,12,6,9,15,0.000333,0.017925,3,161.323313,8.962406,53.774438,31.01955,1,5
0,0,24,24,21,46,67,106,87,193,0.000333,0.390252,10,11707.55214,650.419563,1170.755214,346.322516,7,5
0,0,2,2,6,9,15,8,10,18,0.000333,0.023441,3,210.972092,11.720672,70.324031,44.0391,1,5
0,0,3,3,5,9,14,6,12,18,0.000333,0.022844,2,137.064777,7.61471,68.532389,40.138965,1,5
0,0,26,26,18,46,64,108,95,203,0.000333,0.406,18,21924,1218,1218,329.1425,7,5
0,0,26,26,18,45,63,114,92,206,0.000333,0.41044,18,22163.75396,1231.319664,1231.319664,322.192039,7,5
0,0,3,3,6,9,15,7,10,17,0.000333,0.022139,3,199.25142,11.069523,66.41714,44.0391,1,5
0,0,33,33,19,53,72,160,105,265,0.000333,0.54501,9,14715.27113,817.515063,1635.030125,384.290407,13,5
0,0,33,33,19,53,72,160,105,265,0.000333,0.54501,9,14715.27113,817.515063,1635.030125,384.290407,13,5
0,0,35,35,20,53,73,164,108,272,0.000333,0.561211,20,33672.6456,1870.702533,1683.63228,390.018346,13,5
0,0,33,33,19,54,73,160,106,266,0.000333,0.548831,9,14818.43999,823.246666,1646.493333,391.474548,13,5
0,0,33,33,19,54,73,160,106,266,0.000333,0.548831,9,14818.43999,823.246666,1646.493333,391.474548,13,5
0,0,33,33,20,53,73,160,105,265,0.000333,0.546768,10,16403.03508,911.279727,1640.303508,390.018346,13,5
0,0,33,33,19,52,71,160,105,265,0.000333,0.543228,18,29334.29376,1629.682987,1629.682987,377.133488,13,5
0,0,34,34,22,53,75,166,111,277,0.000333,0.575128,22,37958.4211,2108.801172,1725.382777,401.68728,13,5
0,0,32,32,19,52,71,157,104,261,0.000333,0.535028,18,28891.51197,1605.083998,1605.083998,377.133488,12,5
0,0,30,30,19,50,69,147,95,242,0.000333,0.492754,9,13304.36627,739.131459,1478.262919,362.903432,11,5
0,0,30,30,19,50,69,147,95,242,0.000333,0.492754,9,13304.36627,739.131459,1478.262919,362.903432,11,5
0,0,30,30,19,49,68,147,95,242,0.000333,0.491055,9,13258.49407,736.583004,1473.166008,355.831405,11,5
0,0,29,29,19,49,68,144,94,238,0.000333,0.482939,9,13039.34541,724.408078,1448.816156,355.831405,10,5
0,0,30,30,19,50,69,147,95,242,0.000333,0.492754,9,13304.36627,739.131459,1478.262919,362.903432,11,5
0,0,30,30,19,50,69,147,96,243,0.000333,0.49479,9,13359.34299,742.185721,1484.371443,362.903432,11,5
0,0,30,30,19,51,70,147,96,243,0.000333,0.496472,9,13404.74196,744.707887,1489.415773,370.004315,11,5
0,0,30,30,19,50,69,147,95,242,0.000333,0.492754,9,13304.36627,739.131459,1478.262919,362.903432,11,5
0,0,30,30,19,51,70,147,96,243,0.000333,0.496472,9,13404.74196,744.707887,1489.415773,370.004315,11,5
2,0,13,15,17,19,36,55,40,95,0.000333,0.163714,16,7858.286002,436.571445,491.142875,150.197491,4,5
2,0,14,16,18,20,38,63,43,106,0.000333,0.185427,18,10013.0457,556.280316,556.280316,161.497212,5,5
2,0,14,16,19,20,39,63,44,107,0.000333,0.188513,18,10179.68467,565.538037,565.538037,167.149185,5,5
0,0,31,31,19,52,71,151,101,252,0.000333,0.516579,9,13947.62647,774.868137,1549.736274,377.133488,10,5
0,0,31,31,19,50,69,150,100,250,0.000333,0.509044,18,27488.36006,1527.131114,1527.131114,362.903432,10,5
0,0,33,33,19,52,71,160,105,265,0.000333,0.543228,18,29334.29376,1629.682987,1629.682987,377.133488,13,5
0,0,31,31,19,50,69,150,106,256,0.000333,0.521261,18,28148.0807,1563.782261,1563.782261,362.903432,10,5
0,0,25,25,18,39,57,145,84,229,0.000333,0.445244,18,24043.17264,1335.731813,1335.731813,281.189337,18,5
0,0,36,36,18,61,79,143,123,266,0.000333,0.558935,18,30182.50222,1676.805679,1676.805679,436.833628,13,5
0,0,25,25,22,39,61,147,87,234,0.000333,0.462598,22,30531.43581,1696.190879,1387.792537,304.238182,15,5
0,0,11,11,17,16,33,70,47,117,0.000333,0.196731,16,9443.105791,524.616988,590.194112,133.486868,3,5
0,0,11,11,17,16,33,70,47,117,0.000333,0.196731,16,9443.105791,524.616988,590.194112,133.486868,3,5
0,0,76,76,25,87,112,463,274,737,0.000333,1.67234,36,180612.7408,10034.04116,5017.020578,676.632489,38,5
0,0,37,37,22,50,72,217,129,346,0.000333,0.711598,22,46965.46911,2609.192728,2134.79405,380.300305,29,5
0,0,36,36,24,52,76,213,130,343,0.000333,0.714346,24,51432.93929,2857.385516,2143.039137,406.461965,25,5
0,0,28,28,23,42,65,169,100,269,0.000333,0.540006,22,35640.37272,1980.020707,1620.016942,330.519257,14,5
0,0,32,32,20,40,60,139,101,240,0.000333,0.472551,20,28353.07486,1575.170825,1417.653743,299.315686,10,5
0,0,36,36,25,49,74,190,118,308,0.000333,0.637504,24,45900.27928,2550.015515,1912.511637,391.217187,18,5
0,0,16,16,17,30,47,86,52,138,0.000333,0.255511,8,6132.266092,340.68145,766.533262,216.693586,12,5
0,0,14,14,16,29,45,90,52,142,0.000333,0.259948,8,6238.745117,346.596951,779.84314,204.881449,5,5
0,0,53,53,24,53,77,303,182,485,0.000333,1.01313,36,109418.093,6078.782944,3039.391472,413.618884,33,5
0,0,28,28,22,42,64,170,100,270,0.000333,0.54,22,35640,1980,1620,324.584827,14,5
0,0,41,41,22,64,86,186,141,327,0.000333,0.700463,22,46230.54865,2568.363814,2101.388575,482.107496,20,5
0,0,36,36,19,49,68,197,116,313,0.000333,0.635125,18,34296.76565,1905.375869,1905.375869,355.831405,18,5
0,0,35,35,21,51,72,193,117,310,0.000333,0.637559,20,38253.53501,2125.196389,1912.67675,381.532358,16,5
0,0,38,38,28,52,80,222,132,354,0.000333,0.745988,28,62662.95128,3481.275071,2237.962546,431.028803,18,5
0,0,40,40,30,55,85,232,140,372,0.000333,0.794764,30,71528.80285,3973.82238,2384.293428,465.181502,18,5
0,0,11,11,17,16,33,70,47,117,0.000333,0.196731,16,9443.105791,524.616988,590.194112,133.486868,3,5
0,0,11,11,17,16,33,70,47,117,0.000333,0.196731,16,9443.105791,524.616988,590.194112,133.486868,3,5
0,0,42,42,27,54,81,238,145,383,0.000333,0.809388,26,63132.22633,3507.345907,2428.162551,439.145888,19,5
0,0,41,41,29,56,85,234,146,380,0.000333,0.811856,28,68195.91956,3788.662198,2435.568556,466.093324,17,5
0,0,27,27,17,36,53,144,84,228,0.000333,0.435322,16,20895.45382,1160.858545,1305.965864,255.604168,15,5
0,0,28,28,17,39,56,139,85,224,0.000333,0.433616,16,20813.56004,1156.308891,1300.847503,275.617555,21,5
0,0,67,67,27,73,100,344,224,568,0.000333,1.257903,39,147174.7023,8176.372351,3773.710316,580.239155,25,5
0,0,36,36,19,43,62,183,120,303,0.000333,0.601374,18,32474.18668,1804.121482,1804.121482,314.040007,10,5
0,0,32,32,19,39,58,192,101,293,0.000333,0.572129,18,30894.99177,1716.388432,1716.388432,286.841309,32,5
0,0,39,39,28,51,79,227,127,354,0.000333,0.743846,28,62483.07478,3471.281932,2231.538385,423.89963,18,5
0,0,34,34,23,42,65,155,105,260,0.000333,0.521939,22,34447.94389,1913.774661,1565.815631,330.519257,11,5
0,0,33,33,17,41,58,145,94,239,0.000333,0.466686,16,22400.91933,1244.495518,1400.057458,289.1465,15,5
0,0,55,55,23,68,91,342,204,546,0.000333,1.184419,33,117257.4438,6514.302435,3553.255874,517.989398,33,5
0,0,57,57,23,68,91,344,208,552,0.000333,1.197434,33,118545.9872,6585.888176,3592.302641,517.989398,33,5
0,0,22,22,16,38,54,125,74,199,0.000333,0.381741,8,9161.780903,508.987828,1145.222613,263.421246,13,5
0,0,34,34,23,46,69,197,117,314,0.000333,0.639359,22,42197.68695,2344.315942,1918.076679,358.125775,17,5
0,0,13,13,16,23,39,73,45,118,0.000333,0.207892,8,4989.419695,277.189983,623.677462,168.041925,5,5
0,0,52,52,24,55,79,299,183,482,0.000333,1.012807,36,109383.2035,6076.844641,3038.422321,428.013884,21,5
0,0,43,43,23,47,70,223,143,366,0.000333,0.747773,33,74029.48028,4112.748904,2243.317584,365.107601,20,5
0,0,53,53,25,48,73,305,184,489,0.000333,1.008941,36,108965.6715,6053.648419,3026.824209,384.174605,32,5
0,0,77,77,24,55,79,474,271,745,0.000333,1.565439,48,225423.1996,12523.51109,4696.316657,428.013884,34,5
0,0,25,25,22,39,61,131,85,216,0.000333,0.427013,22,28182.86383,1565.714657,1281.039265,304.238182,8,5
0,0,47,47,25,51,76,280,164,444,0.000333,0.924693,36,99866.87338,5548.159632,2774.079816,405.390097,32,5
0,0,44,44,25,50,75,247,151,398,0.000333,0.826357,36,89246.5142,4958.139678,2479.069839,398.289214,28,5
0,0,48,48,20,50,70,331,166,497,0.000333,1.015418,30,91387.60978,5077.089432,3046.253659,368.631371,23,5
0,0,38,38,22,50,72,212,126,338,0.000333,0.695145,22,45879.56231,2548.864573,2085.43465,380.300305,17,5
0,0,25,25,19,43,62,152,90,242,0.000333,0.480305,18,25936.47913,1440.915507,1440.915507,314.040007,10,5
0,0,14,14,14,30,44,72,45,117,0.000333,0.212918,7,4471.274496,248.404139,638.753499,200.509687,6,5
0,0,26,26,24,42,66,170,99,269,0.000333,0.541981,24,39022.60844,2167.922691,1625.942018,336.516432,16,5
0,0,43,43,23,47,70,224,139,363,0.000333,0.741643,22,48948.45417,2719.358565,2224.929735,365.107601,24,5
0,0,46,46,25,49,74,237,149,386,0.000333,0.79895,36,86286.56397,4793.697998,2396.848999,391.217187,24,5
0,0,35,35,26,46,72,195,121,316,0.000333,0.649899,26,50692.10381,2816.22799,1949.6963,376.295283,13,5
0,0,34,34,23,46,69,194,118,312,0.000333,0.635287,22,41928.91187,2329.383993,1905.859631,358.125775,12,5
0,0,42,42,27,50,77,247,141,388,0.000333,0.810504,26,63219.34262,3512.185701,2431.513178,410.574772,22,5
0,0,34,34,27,48,75,192,116,308,0.000333,0.639492,26,49880.38007,2771.132226,1918.476157,396.460163,17,5
0,0,41,41,27,51,78,220,134,354,0.000333,0.741677,26,57850.84202,3213.935668,2225.032385,417.675655,20,5
0,0,31,31,21,44,65,231,130,361,0.000333,0.724692,20,43481.49561,2415.638645,2174.074781,332.453657,16,5
0,0,53,53,26,53,79,333,199,532,0.000333,1.11787,39,130790.843,7266.157942,3353.611358,425.791217,24,5
0,0,40,40,22,25,47,240,150,390,0.000333,0.722097,66,142975.117,7943.062058,2166.289652,214.2039,14,5
0,0,48,48,23,38,61,295,182,477,0.000333,0.942987,44,124474.3152,6915.239736,2828.96171,303.463171,18,5
0,0,57,57,26,53,79,347,211,558,0.000333,1.172503,39,137182.8766,7621.270925,3517.509657,425.791217,25,5
0,0,50,50,26,52,78,329,190,519,0.000333,1.087375,39,127222.8263,7067.934795,3262.123752,418.634298,23,5
0,0,37,37,22,24,46,236,141,377,0.000333,0.694128,55,114531.0572,6362.836509,2082.382857,208.146596,13,5
0,0,45,45,23,37,60,291,173,464,0.000333,0.913599,44,120595.0784,6699.726578,2740.797236,296.7917,17,5
0,0,54,54,26,52,78,343,202,545,0.000333,1.141848,39,133596.2242,7422.012453,3425.544209,418.634298,24,5
0,0,24,24,17,33,50,121,73,194,0.000333,0.364969,16,17518.52961,973.251645,1094.908101,235.951874,15,5
0,0,49,49,26,56,82,247,162,409,0.000333,0.866746,26,67606.20802,3755.900445,2600.23877,447.423308,22,5
0,0,35,35,24,48,72,220,126,346,0.000333,0.711598,24,51235.05721,2846.392067,2134.79405,378.1173,27,5
0,0,37,37,24,48,72,222,130,352,0.000333,0.723938,24,52123.52641,2895.751467,2171.813601,378.1173,29,5
0,0,26,26,21,24,45,187,109,296,0.000333,0.541863,40,65023.54066,3612.418926,1625.588517,202.277766,10,5
0,0,23,23,21,23,44,183,100,283,0.000333,0.515006,40,61800.76592,3433.375885,1545.019148,196.280591,9,5
0,0,20,20,20,27,47,123,77,200,0.000333,0.370306,20,22218.35541,1234.353078,1110.91777,214.820524,8,5
0,0,19,19,17,26,43,122,74,196,0.000333,0.354516,16,17016.76627,945.375904,1063.547892,191.698301,7,5
0,0,24,24,20,34,54,138,76,214,0.000333,0.410515,20,24630.91851,1368.384362,1231.545925,259.412299,13,5
0,0,61,61,24,64,88,320,202,522,0.000333,1.123941,36,121385.639,6743.64661,3371.823305,494.0391,24,5
0,0,16,16,14,31,45,81,50,131,0.000333,0.239811,7,5036.029289,279.779405,719.432756,206.883055,6,5
0,0,11,11,12,19,31,64,36,100,0.000333,0.16514,6,2972.517786,165.139877,495.419631,123.730173,7,5
0,0,12,12,21,16,37,79,52,131,0.000333,0.227479,30,20473.15173,1137.397318,682.438391,156.238666,5,5
0,0,23,23,23,47,70,159,94,253,0.000333,0.516903,22,34115.58927,1895.310515,1550.708603,365.107601,15,5
0,0,32,32,19,43,62,170,102,272,0.000333,0.539847,18,29151.74514,1619.541396,1619.541396,314.040007,18,5
0,0,28,28,22,35,57,171,99,270,0.000333,0.52496,22,34647.36668,1924.853705,1574.880304,277.632401,18,5
0,0,38,38,23,51,74,198,123,321,0.000333,0.664412,22,43851.15967,2436.175537,1993.23453,393.335617,19,5
0,0,18,18,22,34,56,148,77,225,0.000333,0.435552,22,28746.40686,1597.022604,1306.654857,271.081232,11,5
0,0,123,123,17,138,155,451,381,832,0.000333,2.017912,16,96859.76808,5381.098227,6053.735505,1050.463243,44,5
0,0,15,15,14,19,33,65,44,109,0.000333,0.18328,14,7697.745426,427.652524,549.838959,134.013592,12,5
0,0,23,23,24,46,70,163,100,263,0.000333,0.537334,24,38688.0344,2149.335245,1612.001433,364.12295,11,5
0,0,26,26,21,35,56,123,84,207,0.000333,0.400707,20,24042.44938,1335.691632,1202.122469,271.763571,10,5
0,0,52,52,31,67,98,333,211,544,0.000333,1.199467,45,161928.097,8996.005388,3598.402155,560.008061,16,5
0,0,39,39,28,54,82,283,146,429,0.000333,0.90913,28,76366.91468,4242.606371,2727.38981,445.369863,19,5
0,0,40,40,28,54,82,283,148,431,0.000333,0.913368,28,76722.93759,4262.385422,2740.104914,445.369863,19,5
0,0,22,22,16,38,54,125,74,199,0.000333,0.381741,8,9161.780903,508.987828,1145.222613,263.421246,13,5
0,0,39,39,20,53,73,227,137,364,0.000333,0.751032,20,45061.92279,2503.440155,2253.096139,390.018346,27,5
0,0,45,45,19,78,97,220,158,378,0.000333,0.831589,18,44905.80698,2494.767054,2494.767054,570.971996,12,5
0,0,33,33,26,50,76,206,121,327,0.000333,0.681024,26,53119.87972,2951.104429,2043.072297,404.404242,27,5
0,0,16,16,16,42,58,111,63,174,0.000333,0.339763,8,8154.309545,453.017197,1019.288693,290.477332,9,5
0,0,30,30,18,37,55,166,100,266,0.000333,0.512614,18,27681.15031,1537.841684,1537.841684,267.808425,8,5
0,0,12,12,21,16,37,79,52,131,0.000333,0.227479,30,20473.15173,1137.397318,682.438391,156.238666,5,5
0,0,39,39,25,39,64,245,142,387,0.000333,0.774,36,83592,4644,2322,322.227091,20,5
0,0,34,34,24,42,66,194,120,314,0.000333,0.632647,24,45550.55408,2530.586338,1897.939753,336.516432,17,5
0,0,33,33,22,42,64,193,117,310,0.000333,0.62,22,40920,2273.333333,1860,324.584827,16,5
0,0,20,20,20,26,46,129,78,207,0.000333,0.381126,30,34301.31975,1905.628875,1143.377325,208.649995,8,5
0,0,19,19,17,25,42,128,75,203,0.000333,0.36488,24,26271.37048,1459.520582,1094.640437,185.583273,7,5
0,0,63,63,28,68,96,333,209,542,0.000333,1.189683,42,149900.0864,8327.782576,3569.049675,548.553411,29,5
0,0,32,32,21,42,63,153,99,252,0.000333,0.502092,20,30125.49081,1673.638379,1506.274541,318.715998,15,5
0,0,31,31,23,46,69,174,105,279,0.000333,0.568093,22,37494.12312,2083.00684,1704.278323,358.125775,15,5
0,0,41,41,30,52,82,196,129,325,0.000333,0.688735,30,61986.13205,3443.674003,2066.204402,443.629583,13,5
0,0,4,4,11,11,22,26,18,44,0.000333,0.065405,5,981.074956,54.504164,196.214991,76.107496,1,5
0,0,55,55,23,51,74,418,240,658,0.000333,1.36194,44,179776.0938,9987.560769,4085.820315,393.335617,24,5
0,0,34,34,21,52,73,192,118,310,0.000333,0.639615,20,38376.91227,2132.050681,1918.845613,388.661531,17,5
0,0,12,12,21,16,37,79,52,131,0.000333,0.227479,30,20473.15173,1137.397318,682.438391,156.238666,5,5
0,0,12,12,21,16,37,79,52,131,0.000333,0.227479,30,20473.15173,1137.397318,682.438391,156.238666,5,5
0,0,65,65,29,61,90,390,235,625,0.000333,1.352469,42,170411.1438,9467.285765,4057.408185,502.656426,24,5
0,0,30,30,26,52,78,199,119,318,0.000333,0.666253,26,51967.70555,2887.094753,1998.757906,418.634298,19,5
0,0,46,46,23,51,74,265,158,423,0.000333,0.875533,33,86677.75953,4815.431085,2626.598774,393.335617,19,5
0,0,57,57,27,61,88,288,185,473,0.000333,1.018437,39,119157.1351,6619.840837,3055.311156,490.15694,29,5
0,0,5,5,3,8,11,8,13,21,0.000333,0.024216,1,72.648064,4.036004,72.648064,28.754888,1,5
0,0,5,5,4,9,13,13,17,30,0.000333,0.037004,2,222.026383,12.334799,111.013192,36.529325,1,5
0,0,6,6,4,12,16,24,28,52,0.000333,0.069333,4,832,46.222222,208,51.01955,1,5
0,0,2,2,3,5,8,3,8,11,0.000333,0.011,1,33,1.833333,33,16.364528,1,5
0,0,2,2,3,5,8,3,8,11,0.000333,0.011,1,33,1.833333,33,16.364528,1,5
0,0,6,6,7,8,15,14,15,29,0.000333,0.037767,3,339.899482,18.883305,113.299827,43.651484,2,5
0,0,4,4,4,10,14,17,29,46,0.000333,0.058379,4,700.553306,38.919628,175.138326,41.219281,1,5
0,0,30,30,20,59,79,166,110,276,0.000333,0.579948,10,17398.43487,966.579715,1739.843486,433.514502,11,5
0,0,30,30,20,59,79,166,110,276,0.000333,0.579948,10,17398.43487,966.579715,1739.843486,433.514502,11,5
0,0,30,30,20,58,78,166,109,275,0.000333,0.576162,10,17284.8561,960.269783,1728.48561,426.20146,11,5
0,0,30,30,20,58,78,166,109,275,0.000333,0.576162,10,17284.8561,960.269783,1728.48561,426.20146,11,5
0,0,32,32,22,58,80,171,112,283,0.000333,0.596369,11,19680.16216,1093.342342,1789.105651,437.870393,11,5
0,0,43,43,26,56,82,255,149,404,0.000333,0.85615,26,66779.72626,3709.984792,2568.45101,447.423308,32,5
0,0,31,31,19,54,73,174,108,282,0.000333,0.581844,18,31419.54946,1745.530526,1745.530526,391.474548,16,5
0,0,55,55,22,64,86,320,200,520,0.000333,1.113886,33,110274.7032,6126.372399,3341.657672,482.107496,25,5
0,0,5,5,8,13,21,18,19,37,0.000333,0.054172,4,650.062979,36.11461,162.515745,72.105716,1,5
0,0,4,4,4,8,12,7,12,19,0.000333,0.022705,2,136.228575,7.568254,68.114288,32,1,5
0,0,5,5,3,8,11,8,13,21,0.000333,0.024216,1,72.648064,4.036004,72.648064,28.754888,1,5
0,0,6,6,5,8,13,11,14,25,0.000333,0.030837,2,185.021986,10.278999,92.510993,35.60964,1,5
0,0,5,5,7,9,16,12,15,27,0.000333,0.036,3,324,18,108,48.180809,1,5
0,0,6,6,6,8,14,10,15,25,0.000333,0.031728,3,285.551619,15.863979,95.183873,39.509775,1,5
0,0,6,6,5,9,14,11,18,29,0.000333,0.036804,4,441.653171,24.536287,110.413293,40.138965,1,5
0,0,7,7,3,9,12,11,17,28,0.000333,0.03346,1,100.37895,5.576608,100.37895,33.284213,1,5
0,0,8,8,4,9,13,13,19,32,0.000333,0.039471,4,473.656284,26.314238,118.414071,36.529325,1,5
0,0,36,36,22,53,75,172,113,285,0.000333,0.591738,22,39054.69319,2169.705177,1775.213327,401.68728,12,5
0,0,34,34,21,54,75,167,111,278,0.000333,0.577204,20,34632.23192,1924.012884,1731.611596,403.002591,12,5
0,0,26,26,22,36,58,126,84,210,0.000333,0.410059,22,27063.8722,1503.548455,1230.176009,284.224796,10,5
0,0,39,39,24,53,77,231,129,360,0.000333,0.752014,24,54145.03571,3008.05754,2256.043155,413.618884,13,5
0,0,43,43,24,53,77,250,141,391,0.000333,0.816771,24,58807.5249,3267.084717,2450.313537,413.618884,14,5
0,0,34,34,23,27,50,223,118,341,0.000333,0.641518,44,84680.41827,4704.467682,1924.554961,232.423888,12,5
0,0,47,47,24,53,77,269,153,422,0.000333,0.881528,24,63470.01408,3526.111894,2644.58392,413.618884,15,5
0,0,38,38,21,53,74,230,126,356,0.000333,0.736855,20,44211.30796,2456.183776,2210.565398,395.81845,12,5
0,0,42,42,21,53,74,249,138,387,0.000333,0.801019,20,48061.16905,2670.064947,2403.058452,395.81845,13,5
0,0,33,33,20,27,47,222,115,337,0.000333,0.623965,40,74875.85772,4159.769873,1871.896443,214.820524,11,5
0,0,46,46,21,53,74,268,150,418,0.000333,0.865184,20,51911.03014,2883.946119,2595.551507,395.81845,14,5
0,0,60,60,30,65,95,300,193,493,0.000333,1.079646,30,97168.16445,5398.231358,3238.938815,538.660626,29,5
0,0,44,44,22,45,67,258,152,410,0.000333,0.829032,33,82074.18675,4559.677041,2487.096568,345.240885,30,5
0,0,26,26,21,27,48,181,107,288,0.000333,0.536156,30,48254.07601,2680.782,1608.4692,220.620628,11,5
0,0,25,25,19,26,45,184,102,286,0.000333,0.523557,27,42408.08961,2356.004978,1570.669986,202.922055,11,5
0,0,22,22,16,30,46,115,65,180,0.000333,0.331414,16,15907.85843,883.769913,994.241152,211.206718,12,5
0,0,30,30,25,49,74,180,104,284,0.000333,0.587828,24,42323.63414,2351.313008,1763.484756,391.217187,16,5
0,0,22,22,17,31,48,115,69,184,0.000333,0.342544,16,16442.1296,913.451645,1027.6331,223.066954,15,5
0,0,50,50,27,54,81,255,161,416,0.000333,0.879126,26,68571.81763,3809.545424,2637.377601,439.145888,27,5
0,0,48,48,29,58,87,224,149,373,0.000333,0.801073,28,67290.10187,3738.338993,2403.217924,480.644347,22,5
0,0,56,56,27,65,92,277,182,459,0.000333,0.998105,26,77852.18838,4325.121577,2994.314938,519.83587,26,5
0,0,48,48,20,50,70,218,143,361,0.000333,0.737557,20,44253.42338,2458.523521,2212.671169,368.631371,17,5
0,0,47,47,18,34,52,205,138,343,0.000333,0.65175,36,70389.02964,3910.501647,1955.250823,248.032387,14,5
0,0,52,52,20,50,70,232,155,387,0.000333,0.790678,30,71160.97583,3953.387546,2372.032528,368.631371,18,5
0,0,34,34,21,53,74,167,111,278,0.000333,0.575409,20,34524.56071,1918.031151,1726.228036,395.81845,12,5
0,0,76,76,29,67,96,435,246,681,0.000333,1.494786,42,188343.0974,10463.50541,4484.359463,547.309425,67,5
0,0,8,8,13,12,25,36,28,64,0.000333,0.099069,12,3566.481554,198.137864,297.206796,91.125266,2,5
0,0,35,35,25,49,74,216,125,341,0.000333,0.705808,24,50818.16634,2823.231464,2117.423598,391.217187,37,5
0,0,29,29,19,49,68,146,98,244,0.000333,0.495114,18,26736.1368,1485.340933,1485.340933,355.831405,9,5
0,0,49,49,27,58,85,309,170,479,0.000333,1.023366,26,79822.55472,4434.586373,3070.098258,468.14486,34,5
0,0,34,34,21,52,73,167,110,277,0.000333,0.571527,20,34291.62806,1905.090448,1714.581403,388.661531,12,5
0,0,33,33,21,52,73,164,109,273,0.000333,0.563274,20,33796.44209,1877.580116,1689.822105,388.661531,11,5
0,0,30,30,24,45,69,181,105,286,0.000333,0.582346,24,41928.91187,2329.383993,1747.037995,357.172489,25,5
0,0,32,32,26,47,73,192,113,305,0.000333,0.629299,26,49085.30875,2726.961597,1887.89649,383.277109,25,5
0,0,11,11,17,16,33,70,47,117,0.000333,0.196731,16,9443.105791,524.616988,590.194112,133.486868,3,5
0,0,25,25,19,49,68,122,87,209,0.000333,0.424093,9,11450.5176,636.139867,1272.279734,355.831405,10,5
0,0,31,31,20,51,71,155,102,257,0.000333,0.526828,20,31609.70019,1756.094455,1580.48501,375.732254,12,5
0,0,31,31,19,50,69,155,102,257,0.000333,0.523297,18,28258.03414,1569.890785,1569.890785,362.903432,12,5
0,0,32,32,22,52,74,162,109,271,0.000333,0.560921,22,37020.76097,2056.708943,1682.761862,394.530361,12,5
0,0,30,30,19,50,69,152,101,253,0.000333,0.515152,18,27818.22038,1545.456688,1545.456688,362.903432,11,5
0,0,32,32,20,51,71,159,107,266,0.000333,0.545278,20,32716.65468,1817.591926,1635.832734,375.732254,11,5
0,0,32,32,19,51,70,158,107,265,0.000333,0.54142,18,29236.67999,1624.259999,1624.259999,370.004315,11,5
0,0,33,33,19,51,70,164,109,273,0.000333,0.557765,18,30119.29675,1673.294264,1673.294264,370.004315,11,5
0,0,32,32,19,53,72,159,108,267,0.000333,0.549123,18,29652.65956,1647.369975,1647.369975,384.290407,11,5
0,0,23,23,18,33,51,122,72,194,0.000333,0.366817,18,19808.10929,1100.450516,1100.450516,241.523656,12,5
0,0,19,19,16,33,49,95,62,157,0.000333,0.293836,8,7052.075564,391.781976,881.509446,230.465006,9,5
0,0,32,32,24,45,69,177,113,290,0.000333,0.590491,24,42515.33022,2361.96279,1771.472092,357.172489,13,5
0,0,31,31,21,44,65,176,110,286,0.000333,0.574132,20,34447.94389,1913.774661,1722.397195,332.453657,12,5
0,0,27,27,21,35,56,198,114,312,0.000333,0.603965,30,54356.84207,3019.824559,1811.894736,271.763571,11,5
0,0,26,26,19,34,53,201,109,310,0.000333,0.591885,27,47942.69421,2663.483011,1775.655341,253.684359,11,5
0,0,28,28,19,47,66,142,93,235,0.000333,0.473478,9,12783.89356,710.216309,1420.432618,341.776299,10,5
0,0,20,20,21,27,48,135,79,214,0.000333,0.398394,20,23903.6395,1327.979972,1195.181975,220.620628,8,5
0,0,19,19,18,26,44,134,76,210,0.000333,0.38216,18,20636.65152,1146.48064,1146.48064,197.270083,7,5
0,0,67,67,29,73,102,371,256,627,0.000333,1.394537,42,175711.649,9761.758275,4183.610689,592.738642,57,5
0,0,25,25,17,34,51,123,75,198,0.000333,0.37438,16,17970.24348,998.34686,1123.140218,242.460605,15,5
0,0,35,35,23,39,62,209,133,342,0.000333,0.678778,33,67199.05956,3733.281087,2036.335138,310.172612,12,5
0,0,27,27,19,46,65,139,91,230,0.000333,0.461715,9,12466.30137,692.572298,1385.144597,334.794473,9,5
0,0,34,34,21,54,75,167,111,278,0.000333,0.577204,20,34632.23192,1924.012884,1731.611596,403.002591,12,5
0,0,32,32,24,42,66,169,111,280,0.000333,0.564143,24,40618.32848,2256.573805,1692.430353,336.516432,14,5
0,0,34,34,21,53,74,167,110,277,0.000333,0.57334,20,34400.37165,1911.131758,1720.018582,395.81845,12,5
0,0,76,76,25,88,113,456,272,728,0.000333,1.65503,36,178743.2502,9930.180569,4965.090285,684.526387,38,5
0,0,52,52,28,52,80,306,189,495,0.000333,1.043118,42,131432.8851,7301.82695,3129.354407,431.028803,23,5
0,0,40,40,26,36,62,241,154,395,0.000333,0.783969,52,122299.1922,6794.399568,2351.907543,308.328733,15,5
0,0,36,36,23,29,52,223,144,367,0.000333,0.697354,44,92050.70057,5113.927809,2092.061377,244.923374,14,5
0,0,49,49,28,51,79,302,180,482,0.000333,1.012807,42,127613.7375,7089.652081,3038.422321,423.89963,22,5
0,0,37,37,26,35,61,237,145,382,0.000333,0.755181,52,117808.1665,6544.898137,2265.541663,301.736338,14,5
0,0,33,33,23,28,51,219,135,354,0.000333,0.669346,44,88353.69713,4908.538729,2008.038571,238.647863,13,5
0,0,24,24,22,45,67,151,96,247,0.000333,0.499441,22,32963.12866,1831.284926,1498.32403,345.240885,13,5
0,0,31,31,25,51,76,179,114,293,0.000333,0.610214,24,43935.42628,2440.857015,1830.642761,405.390097,17,5
0,0,33,33,25,49,74,205,124,329,0.000333,0.68097,24,49029.84378,2723.88021,2042.910157,391.217187,21,5
0,0,28,28,19,47,66,142,92,234,0.000333,0.471463,9,12729.49402,707.194112,1414.388224,341.776299,10,5
0,0,30,30,20,47,67,146,95,241,0.000333,0.487309,20,29238.5499,1624.363883,1461.927495,347.504238,10,5
0,0,28,28,20,47,67,142,92,234,0.000333,0.473155,10,14194.64871,788.591595,1419.464871,347.504238,10,5
0,0,36,36,22,54,76,173,114,287,0.000333,0.597718,22,39449.41432,2191.634129,1793.155196,408.871421,13,5
0,0,34,34,21,55,76,168,112,280,0.000333,0.58314,20,34988.39408,1943.799671,1749.419704,410.21345,13,5
0,0,38,38,24,58,82,186,124,310,0.000333,0.656947,24,47300.18691,2627.788162,1970.841121,449.801998,13,5
0,0,36,36,21,53,74,176,117,293,0.000333,0.606457,20,36387.39672,2021.52204,1819.369836,395.81845,11,5
0,0,35,35,21,53,74,170,115,285,0.000333,0.589898,20,35393.88418,1966.326899,1769.694209,395.81845,11,5
0,0,33,33,21,52,73,164,109,273,0.000333,0.563274,20,33796.44209,1877.580116,1689.822105,388.661531,11,5
0,0,35,35,21,53,74,171,115,286,0.000333,0.591968,20,35518.07325,1973.226292,1775.903663,395.81845,11,5
0,0,35,35,21,53,74,170,115,285,0.000333,0.589898,20,35393.88418,1966.326899,1769.694209,395.81845,11,5
0,0,32,32,21,50,71,158,106,264,0.000333,0.541178,20,32470.66479,1803.925822,1623.53324,374.431475,10,5
0,0,32,32,21,50,71,159,106,265,0.000333,0.543228,20,32593.65973,1810.758874,1629.682987,374.431475,10,5
0,0,32,32,20,51,71,157,105,262,0.000333,0.537078,20,32224.67491,1790.259717,1611.233745,375.732254,12,5
0,0,31,31,19,50,69,153,100,253,0.000333,0.515152,18,27818.22038,1545.456688,1545.456688,362.903432,13,5
0,0,31,31,20,51,71,153,100,253,0.000333,0.518629,10,15558.86021,864.381123,1555.886021,375.732254,13,5
0,0,30,30,19,50,69,150,99,249,0.000333,0.507008,9,13689.20331,760.511295,1521.02259,362.903432,12,5
0,0,33,33,20,51,71,157,103,260,0.000333,0.532978,20,31978.68502,1776.593612,1598.934251,375.732254,13,5
0,0,34,34,21,53,74,168,111,279,0.000333,0.577479,20,34648.74978,1924.930543,1732.437489,395.81845,13,5
0,0,34,34,22,54,76,168,111,279,0.000333,0.581057,22,38349.77908,2130.543282,1743.171776,408.871421,13,5
0,0,34,34,21,54,75,168,111,279,0.000333,0.57928,20,34756.80829,1930.933794,1737.840415,403.002591,13,5
0,0,34,34,21,54,75,168,111,279,0.000333,0.57928,20,34756.80829,1930.933794,1737.840415,403.002591,13,5
0,0,36,36,22,54,76,172,114,286,0.000333,0.595636,22,39311.95992,2183.997773,1786.907269,408.871421,13,5
0,0,31,31,21,50,71,155,101,256,0.000333,0.524778,20,31486.70525,1749.261403,1574.335263,374.431475,11,5
0,0,31,31,19,50,69,153,100,253,0.000333,0.515152,18,27818.22038,1545.456688,1545.456688,362.903432,13,5
0,0,31,31,21,51,72,155,102,257,0.000333,0.528557,20,31713.41451,1761.856362,1585.670725,381.532358,11,5
0,0,31,31,21,50,71,155,101,256,0.000333,0.524778,20,31486.70525,1749.261403,1574.335263,374.431475,11,5
0,0,31,31,21,49,70,155,101,256,0.000333,0.523032,20,31381.92905,1743.440503,1569.096452,367.359448,11,5
0,0,30,30,21,49,70,152,100,252,0.000333,0.51486,20,30891.58641,1716.199245,1544.57932,367.359448,10,5
0,0,33,33,22,50,72,160,104,264,0.000333,0.542953,22,35834.92441,1990.829134,1628.8602,380.300305,11,5
0,0,31,31,21,51,72,155,102,257,0.000333,0.528557,20,31713.41451,1761.856362,1585.670725,381.532358,11,5
0,0,30,30,21,49,70,152,100,252,0.000333,0.51486,20,30891.58641,1716.199245,1544.57932,367.359448,10,5
0,0,36,36,23,55,78,177,119,296,0.000333,0.62016,22,40930.53925,2273.918847,1860.479057,422.016709,10,5
0,0,35,35,23,56,79,173,115,288,0.000333,0.605163,22,39940.75482,2218.930823,1815.488855,429.253801,11,5
0,0,37,37,24,55,79,178,117,295,0.000333,0.619872,24,44630.7677,2479.487094,1859.615321,428.013884,11,5
0,0,35,35,23,55,78,173,114,287,0.000333,0.601303,22,39686.02961,2204.779423,1803.910437,422.016709,11,5
0,0,37,37,23,57,80,183,123,306,0.000333,0.644837,22,42559.21994,2364.401107,1934.509997,436.516656,12,5
0,0,35,35,23,55,78,173,114,287,0.000333,0.601303,22,39686.02961,2204.779423,1803.910437,422.016709,11,5
0,0,35,35,23,55,78,173,115,288,0.000333,0.603399,22,39824.30846,2212.461581,1810.195839,422.016709,11,5
0,0,36,36,23,55,78,176,119,295,0.000333,0.618065,22,40792.2604,2266.236689,1854.193655,422.016709,10,5
0,0,37,37,24,55,79,177,117,294,0.000333,0.617771,24,44479.47696,2471.082053,1853.31154,428.013884,11,5
0,0,10,10,9,14,23,25,30,55,0.000333,0.082932,8,1990.367261,110.575959,248.795908,81.832294,2,5
0,0,10,10,8,14,22,24,36,60,0.000333,0.089189,8,2140.527177,118.918176,267.565897,77.302969,2,5
0,0,28,28,19,45,64,139,89,228,0.000333,0.456,9,12312,684,1368,327.844012,10,5
0,0,5,5,9,12,21,17,21,38,0.000333,0.055636,4,667.632248,37.09068,166.908062,71.548875,1,5
0,0,5,5,8,8,16,16,16,32,0.000333,0.042667,8,1024,56.888889,128,48,1,5
0,0,30,30,20,49,69,126,99,225,0.000333,0.458139,20,27488.36006,1527.131114,1374.418003,361.559344,9,5
0,0,5,5,9,11,20,17,19,36,0.000333,0.051863,4,622.357646,34.575425,155.589411,66.583073,1,5
0,0,30,30,18,52,70,124,102,226,0.000333,0.461739,9,12466.96166,692.608981,1385.217962,371.481515,9,5
0,0,5,5,9,10,19,15,18,33,0.000333,0.046727,4,560.726432,31.151468,140.181608,61.748606,1,5
0,0,30,30,18,50,68,125,104,229,0.000333,0.464676,18,25092.52183,1394.028991,1394.028991,357.25146,10,5
0,0,30,30,19,50,69,126,98,224,0.000333,0.456103,9,12314.78531,684.154739,1368.309478,362.903432,10,5
0,0,29,29,19,48,67,143,95,238,0.000333,0.481243,9,12993.56305,721.864614,1443.729227,348.788823,9,5
0,0,27,27,19,45,64,136,88,224,0.000333,0.448,9,12096,672,1344,327.844012,9,5
0,0,10,10,10,16,26,26,38,64,0.000333,0.100276,10,3008.28142,167.126746,300.828142,97.219281,1,5
0,0,32,32,22,51,73,159,106,265,0.000333,0.546768,22,36086.67718,2004.815399,1640.303508,387.401188,12,5
0,0,29,29,19,49,68,123,97,220,0.000333,0.446414,9,12053.17643,669.620913,1339.241825,355.831405,9,5
0,0,32,32,20,50,70,156,104,260,0.000333,0.531205,20,31872.27169,1770.68176,1593.613584,368.631371,11,5
0,0,29,29,20,47,67,144,95,239,0.000333,0.483265,20,28995.90633,1610.883685,1449.795317,347.504238,10,5
0,0,10,10,7,13,20,25,32,57,0.000333,0.082117,6,1478.099408,82.116634,246.349901,67.757201,1,5
0,0,10,10,8,15,23,24,33,57,0.000333,0.085948,8,2062.744252,114.596903,257.843031,82.603359,1,5
0,0,11,11,10,20,30,40,40,80,0.000333,0.13085,10,3925.512476,218.084026,392.551248,119.657843,3,5
0,0,29,29,19,49,68,144,96,240,0.000333,0.486997,9,13148.91974,730.495541,1460.991082,355.831405,10,5
0,0,11,11,8,16,24,27,33,60,0.000333,0.091699,8,2200.782,122.265667,275.09775,88,1,5
0,0,11,11,9,13,22,29,30,59,0.000333,0.087702,8,2104.851724,116.936207,263.106465,76.635041,1,5
0,0,10,10,8,13,21,26,28,54,0.000333,0.079062,8,1897.481127,105.415618,237.185141,72.105716,1,5
0,0,11,11,10,17,27,41,36,77,0.000333,0.122042,10,3661.263377,203.403521,366.126338,102.706149,3,5
0,0,31,31,19,52,71,155,103,258,0.000333,0.528878,9,14279.71281,793.317378,1586.634757,377.133488,12,5
0,0,31,31,19,52,71,155,103,258,0.000333,0.528878,9,14279.71281,793.317378,1586.634757,377.133488,12,5
0,0,31,31,19,52,71,155,103,258,0.000333,0.528878,9,14279.71281,793.317378,1586.634757,377.133488,12,5
0,0,33,33,21,51,72,160,105,265,0.000333,0.54501,20,32700.60251,1816.700139,1635.030125,381.532358,12,5
0,0,31,31,19,52,71,155,103,258,0.000333,0.528878,9,14279.71281,793.317378,1586.634757,377.133488,12,5
0,0,31,31,19,51,70,155,102,257,0.000333,0.525075,18,28354.06324,1575.225735,1575.225735,370.004315,12,5
0,0,31,31,19,51,70,155,102,257,0.000333,0.525075,18,28354.06324,1575.225735,1575.225735,370.004315,12,5
0,0,33,33,20,51,71,159,105,264,0.000333,0.541178,20,32470.66479,1803.925822,1623.53324,375.732254,12,5
0,0,10,10,8,13,21,28,25,53,0.000333,0.077598,4,931.171294,51.731739,232.792823,72.105716,3,5
0,0,40,40,24,58,82,190,127,317,0.000333,0.671781,24,48368.25565,2687.125314,2015.343985,449.801998,13,5
0,0,38,38,23,59,82,186,125,311,0.000333,0.659066,22,43498.37082,2416.576156,1977.198673,451.117865,13,5
0,0,38,38,23,59,82,186,125,311,0.000333,0.659066,22,43498.37082,2416.576156,1977.198673,451.117865,13,5
0,0,39,39,26,59,85,193,131,324,0.000333,0.692214,26,53992.70925,2999.594958,2076.642663,469.287373,13,5
0,0,37,37,23,57,80,183,123,306,0.000333,0.644837,22,42559.21994,2364.401107,1934.509997,436.516656,12,5
0,0,14,14,9,18,27,35,38,73,0.000333,0.115702,8,2776.854301,154.269683,347.106788,103.587975,3,5
0,0,10,10,8,16,24,27,32,59,0.000333,0.090171,8,2164.1023,120.227906,270.512788,88,3,5
0,0,10,10,8,17,25,27,34,61,0.000333,0.094425,8,2266.201821,125.900101,283.275228,93.486868,3,5
0,0,10,10,8,13,21,24,24,48,0.000333,0.070277,4,843.324945,46.851386,210.831236,72.105716,3,5
0,0,29,29,18,49,67,124,97,221,0.000333,0.446869,9,12065.4514,670.302856,1340.605711,350.179432,9,5
0,0,29,29,18,49,67,121,97,218,0.000333,0.440802,9,11901.66699,661.203722,1322.407444,350.179432,9,5
0,0,5,5,9,12,21,17,19,36,0.000333,0.052708,4,632.493709,35.138539,158.123427,71.548875,1,5
0,0,10,10,10,16,26,26,35,61,0.000333,0.095576,10,2867.268228,159.292679,286.726823,97.219281,1,5
0,0,11,11,8,15,23,34,37,71,0.000333,0.107058,8,2569.383191,142.743511,321.172899,82.603359,1,5
0,0,12,12,9,16,25,34,40,74,0.000333,0.114548,8,2749.162864,152.73127,343.645358,92.529325,1,5
0,0,6,6,7,12,19,15,21,36,0.000333,0.050975,3,458.776171,25.487565,152.92539,62.671034,1,5
0,0,14,14,9,15,24,42,34,76,0.000333,0.116152,8,2787.6572,154.869844,348.45715,87.132684,3,5
0,0,5,5,9,11,20,15,19,34,0.000333,0.048982,4,587.782221,32.654568,146.945555,66.583073,1,5
0,0,13,13,12,16,28,37,46,83,0.000333,0.133003,12,4788.125502,266.006972,399.010459,107.01955,1,5
0,0,5,5,9,12,21,17,20,37,0.000333,0.054172,4,650.062979,36.11461,162.515745,71.548875,1,5
0,0,10,10,8,16,24,27,34,61,0.000333,0.093228,8,2237.4617,124.303428,279.682713,88,3,5
0,0,10,10,8,16,24,27,32,59,0.000333,0.090171,8,2164.1023,120.227906,270.512788,88,3,5
0,0,30,30,21,48,69,151,99,250,0.000333,0.509044,20,30542.62228,1696.812349,1527.131114,360.316866,9,5
0,0,28,28,19,46,65,139,89,228,0.000333,0.4577,9,12357.89875,686.549931,1373.099861,334.794473,10,5
0,0,30,30,20,46,66,143,92,235,0.000333,0.473478,20,28408.65236,1578.258464,1420.432618,340.522412,10,5
0,0,38,38,23,57,80,186,124,310,0.000333,0.653266,22,43115.54961,2395.308312,1959.797709,436.516656,13,5
0,0,8,8,8,13,21,19,22,41,0.000333,0.060028,4,720.340057,40.018892,180.085014,72.105716,2,5
0,0,10,10,10,14,24,24,26,50,0.000333,0.076416,5,1146.240625,63.680035,229.248125,86.52225,2,5
0,0,8,8,8,14,22,19,24,43,0.000333,0.063919,4,767.022238,42.612347,191.75556,77.302969,2,5
0,0,8,8,8,14,22,19,24,43,0.000333,0.063919,4,767.022238,42.612347,191.75556,77.302969,2,5
0,0,8,8,8,13,21,19,23,42,0.000333,0.061492,4,737.909327,40.994963,184.477332,72.105716,2,5
0,0,8,8,7,12,19,22,23,45,0.000333,0.063719,3,573.470214,31.859456,191.156738,62.671034,1,5
0,0,10,10,9,14,23,23,26,49,0.000333,0.073885,4,886.618143,49.256564,221.654536,81.832294,2,5
0,0,8,8,8,13,21,19,23,42,0.000333,0.061492,4,737.909327,40.994963,184.477332,72.105716,2,5
0,0,8,8,8,13,21,19,23,42,0.000333,0.061492,4,737.909327,40.994963,184.477332,72.105716,2,5
0,0,10,10,8,14,22,28,27,55,0.000333,0.081756,4,981.074956,54.504164,245.268739,77.302969,3,5
0,0,8,8,8,14,22,19,24,43,0.000333,0.063919,4,767.022238,42.612347,191.75556,77.302969,2,5
0,0,8,8,8,14,22,19,24,43,0.000333,0.063919,4,767.022238,42.612347,191.75556,77.302969,2,5
0,0,27,27,18,48,66,117,91,208,0.000333,0.419078,9,11315.10579,628.616988,1257.233977,343.13685,9,5
0,0,8,8,8,12,20,19,21,40,0.000333,0.057626,4,691.508495,38.417139,172.877124,67.01955,2,5
0,0,10,10,8,13,21,28,25,53,0.000333,0.077598,4,931.171294,51.731739,232.792823,72.105716,3,5
0,0,29,29,18,49,67,123,93,216,0.000333,0.436758,9,11792.47739,655.137633,1310.275265,350.179432,11,5
0,0,29,29,18,49,67,123,95,218,0.000333,0.440802,9,11901.66699,661.203722,1322.407444,350.179432,11,5
0,0,29,29,18,50,68,123,95,218,0.000333,0.442356,9,11943.6021,663.53345,1327.066899,357.25146,11,5
0,0,29,29,18,49,67,123,93,216,0.000333,0.436758,9,11792.47739,655.137633,1310.275265,350.179432,11,5
0,0,33,33,19,50,69,161,106,267,0.000333,0.543659,18,29357.56854,1630.97603,1630.97603,362.903432,11,5
0,0,31,31,19,51,70,152,100,252,0.000333,0.51486,9,13901.21388,772.28966,1544.57932,370.004315,12,5
0,0,31,31,19,49,68,152,99,251,0.000333,0.509318,18,27503.15712,1527.953173,1527.953173,355.831405,12,5
0,0,31,31,20,50,70,152,99,251,0.000333,0.512817,10,15384.50037,854.694465,1538.450037,368.631371,12,5
0,0,29,29,20,46,66,143,94,237,0.000333,0.477507,20,28650.42813,1591.690451,1432.521406,340.522412,9,5
0,0,29,29,22,47,69,146,96,242,0.000333,0.492754,22,32521.78421,1806.765789,1478.262919,359.173172,10,5
0,0,32,32,19,50,69,155,104,259,0.000333,0.527369,18,28477.94102,1582.107834,1582.107834,362.903432,11,5
0,0,28,28,20,46,66,139,89,228,0.000333,0.459374,10,13781.21859,765.623255,1378.121859,340.522412,10,5
0,0,28,28,19,45,64,139,89,228,0.000333,0.456,9,12312,684,1368,327.844012,10,5
0,0,13,13,12,19,31,36,58,94,0.000333,0.155231,18,8382.500157,465.694453,465.694453,123.730173,1,5
0,0,5,5,9,12,21,15,22,37,0.000333,0.054172,4,650.062979,36.11461,162.515745,71.548875,1,5
0,0,5,5,9,11,20,15,19,34,0.000333,0.048982,4,587.782221,32.654568,146.945555,66.583073,1,5
0,0,13,13,12,17,29,37,49,86,0.000333,0.139262,12,5013.436387,278.524244,417.786366,112.506418,1,5
0,0,10,10,10,18,28,25,44,69,0.000333,0.110569,10,3317.074896,184.281939,331.70749,108.277931,1,5
0,0,5,5,9,13,22,17,23,40,0.000333,0.059459,4,713.509059,39.639392,178.377265,76.635041,1,5
0,0,10,10,8,13,21,28,27,55,0.000333,0.080526,8,1932.619666,107.367759,241.577458,72.105716,3,5
0,0,30,30,21,46,67,144,92,236,0.000333,0.477199,20,28631.94098,1590.663388,1431.597049,346.322516,10,5
0,0,6,6,8,11,19,16,19,35,0.000333,0.049559,4,594.709852,33.039436,148.677463,62.053748,1,5
0,0,28,28,19,47,66,139,90,229,0.000333,0.461389,9,12457.49628,692.083127,1384.166253,341.776299,10,5
0,0,28,28,19,46,65,139,89,228,0.000333,0.4577,9,12357.89875,686.549931,1373.099861,334.794473,10,5
0,0,11,11,7,15,22,30,61,91,0.000333,0.135269,12,4869.699328,270.538852,405.808277,78.254843,1,5
0,0,10,10,8,15,23,23,42,65,0.000333,0.098011,8,2352.252217,130.680679,294.031527,82.603359,1,5
0,0,10,10,8,16,24,25,43,68,0.000333,0.103926,8,2494.2196,138.567756,311.77745,88,1,5
0,0,11,11,8,17,25,33,48,81,0.000333,0.125384,8,3009.218811,167.178823,376.152351,93.486868,1,5
0,0,12,12,9,18,27,33,51,84,0.000333,0.133137,8,3195.284401,177.5158,399.41055,103.587975,1,5
0,0,30,30,21,48,69,151,99,250,0.000333,0.509044,20,30542.62228,1696.812349,1527.131114,360.316866,9,5
0,0,10,10,8,13,21,24,26,50,0.000333,0.073205,8,1756.926969,97.607054,219.615871,72.105716,3,5
0,0,31,31,21,50,71,154,101,255,0.000333,0.522729,20,31363.71031,1742.428351,1568.185515,374.431475,10,5
0,0,31,31,21,50,71,154,101,255,0.000333,0.522729,20,31363.71031,1742.428351,1568.185515,374.431475,10,5
0,0,10,10,8,13,21,27,28,55,0.000333,0.080526,8,1932.619666,107.367759,241.577458,72.105716,1,5
0,0,31,31,22,49,71,154,100,254,0.000333,0.520679,22,34364.7869,1909.154828,1562.035768,373.228278,10,5
0,0,31,31,21,48,69,154,100,254,0.000333,0.517188,20,31031.30424,1723.961347,1551.565212,360.316866,10,5
0,0,8,8,8,13,21,19,22,41,0.000333,0.060028,4,720.340057,40.018892,180.085014,72.105716,2,5
0,0,8,8,8,13,21,19,22,41,0.000333,0.060028,4,720.340057,40.018892,180.085014,72.105716,2,5
0,0,11,11,8,15,23,26,38,64,0.000333,0.096503,8,2316.063722,128.670207,289.507965,82.603359,2,5
0,0,9,9,8,12,20,22,26,48,0.000333,0.069151,8,1659.620388,92.201133,207.452549,67.01955,1,5
0,0,10,10,9,12,21,25,28,53,0.000333,0.077598,8,1862.342587,103.463477,232.792823,71.548875,1,5
0,0,6,6,8,12,20,16,20,36,0.000333,0.051863,4,622.357646,34.575425,155.589411,67.01955,1,5
0,0,11,11,7,13,20,26,40,66,0.000333,0.095082,9,2567.225288,142.623627,285.247254,67.757201,1,5
0,0,11,11,7,13,20,26,40,66,0.000333,0.095082,9,2567.225288,142.623627,285.247254,67.757201,1,5
0,0,12,12,8,16,24,29,45,74,0.000333,0.113096,8,2714.2978,150.794322,339.287225,88,1,5
0,0,12,12,10,20,30,41,50,91,0.000333,0.148842,10,4465.270442,248.07058,446.527044,119.657843,3,5
0,0,11,11,7,14,21,30,49,79,0.000333,0.115664,9,3122.937688,173.496538,346.993076,72.954453,1,5
0,0,10,10,8,12,20,24,32,56,0.000333,0.080676,8,1936.223787,107.567988,242.027973,67.01955,1,5
0,0,6,6,7,12,19,15,21,36,0.000333,0.050975,3,458.776171,25.487565,152.92539,62.671034,1,5
0,0,11,11,8,15,23,32,41,73,0.000333,0.110073,8,2641.760182,146.764455,330.220023,82.603359,1,5
0,0,11,11,8,14,22,30,40,70,0.000333,0.104053,8,2497.281706,138.737873,312.160213,77.302969,1,5
0,0,11,11,7,14,21,30,53,83,0.000333,0.121521,9,3281.061115,182.281173,364.562346,72.954453,1,5
0,0,14,14,7,16,23,37,59,96,0.000333,0.144754,9,3908.35753,217.130974,434.261948,83.651484,1,5
0,0,12,12,7,15,22,32,48,80,0.000333,0.118918,9,3210.790765,178.377265,356.754529,78.254843,1,5
0,0,10,10,7,14,21,27,37,64,0.000333,0.093703,6,1686.64989,93.702772,281.108315,72.954453,1,5
0,0,6,6,8,12,20,16,21,37,0.000333,0.053304,4,639.645358,35.535853,159.91134,67.01955,1,5
0,0,13,13,8,17,25,30,45,75,0.000333,0.116096,8,2786.313714,154.795206,348.289214,93.486868,1,5
0,0,13,13,9,17,26,36,42,78,0.000333,0.122211,8,2933.074384,162.948577,366.634298,98.016193,1,5
0,0,28,28,19,47,66,140,90,230,0.000333,0.463404,9,12511.89583,695.105324,1390.210647,341.776299,11,5
0,0,12,12,8,16,24,36,39,75,0.000333,0.114624,8,2750.9775,152.832083,343.872188,88,1,5
0,0,28,28,19,48,67,140,91,231,0.000333,0.467089,9,12611.39943,700.633301,1401.266603,348.788823,11,5
0,0,28,28,19,47,66,140,90,230,0.000333,0.463404,9,12511.89583,695.105324,1390.210647,341.776299,11,5
0,0,30,30,20,47,67,144,93,237,0.000333,0.479221,10,14376.63138,798.701743,1437.663138,347.504238,11,5
0,0,32,32,20,51,71,159,107,266,0.000333,0.545278,20,32716.65468,1817.591926,1635.832734,375.732254,11,5
0,0,28,28,19,47,66,140,91,231,0.000333,0.465418,9,12566.29537,698.127521,1396.255042,341.776299,11,5
0,0,28,28,19,47,66,140,90,230,0.000333,0.463404,9,12511.89583,695.105324,1390.210647,341.776299,11,5
0,0,5,5,7,11,18,15,18,33,0.000333,0.045869,3,412.822575,22.934588,137.607525,57.705232,1,5
0,0,5,5,7,12,19,15,19,34,0.000333,0.048143,3,433.288606,24.071589,144.429535,62.671034,1,5
0,0,6,6,9,17,26,29,26,55,0.000333,0.086175,4,1034.096738,57.449819,258.524184,98.016193,3,5
0,0,28,28,19,48,67,140,91,231,0.000333,0.467089,9,12611.39943,700.633301,1401.266603,348.788823,11,5
0,0,30,30,21,47,68,145,93,238,0.000333,0.482939,10,14488.16156,804.897865,1448.816156,353.304342,11,5
0,0,8,8,7,15,22,21,30,51,0.000333,0.07581,6,1364.586075,75.810338,227.431013,78.254843,1,5
0,0,10,10,8,16,24,27,32,59,0.000333,0.090171,8,2164.1023,120.227906,270.512788,88,3,5
0,0,5,5,7,10,17,15,18,33,0.000333,0.044962,3,404.658821,22.481046,134.886274,52.870765,1,5
0,0,30,30,18,47,65,119,111,230,0.000333,0.461715,18,24932.60275,1385.144597,1385.144597,336.124326,7,5
0,0,28,28,18,46,64,114,101,215,0.000333,0.43,18,23220,1290,1290,329.1425,7,5
0,0,27,27,19,45,64,112,93,205,0.000333,0.41,18,22140,1230,1230,327.844012,7,5
0,0,11,11,7,13,20,30,48,78,0.000333,0.11237,9,3033.993523,168.555196,337.110391,67.757201,1,5
0,0,29,29,18,48,66,116,104,220,0.000333,0.443256,18,23935.80071,1329.766706,1329.766706,343.13685,7,5
0,0,29,29,18,47,65,122,101,223,0.000333,0.447663,18,24173.7844,1342.988022,1342.988022,336.124326,7,5
0,0,11,11,8,16,24,25,33,58,0.000333,0.088643,8,2127.4226,118.190144,265.927825,88,1,5
0,0,11,11,9,14,23,27,29,56,0.000333,0.08444,8,2026.555756,112.586431,253.31947,81.832294,2,5
0,0,11,11,8,14,22,26,35,61,0.000333,0.090675,8,2176.20263,120.900146,272.025329,77.302969,2,5
0,0,10,10,7,13,20,22,28,50,0.000333,0.072032,6,1296.578428,72.032135,216.096405,67.757201,1,5
0,0,10,10,8,13,21,25,28,53,0.000333,0.077598,8,1862.342587,103.463477,232.792823,72.105716,1,5
0,0,10,10,8,14,22,24,24,48,0.000333,0.071351,4,856.210871,47.567271,214.052718,77.302969,3,5
0,0,10,10,8,13,21,24,24,48,0.000333,0.070277,4,843.324945,46.851386,210.831236,72.105716,3,5
0,0,11,11,10,15,25,36,35,71,0.000333,0.109905,10,3297.137895,183.174327,329.713789,91.82264,3,5
0,0,8,8,7,12,19,18,22,40,0.000333,0.056639,3,509.751302,28.319517,169.917101,62.671034,1,5
0,0,11,11,8,14,22,26,34,60,0.000333,0.089189,8,2140.527177,118.918176,267.565897,77.302969,1,5
0,0,31,31,21,50,71,155,101,256,0.000333,0.524778,20,31486.70525,1749.261403,1574.335263,374.431475,11,5
0,0,13,13,7,14,21,31,50,81,0.000333,0.118593,9,3201.999401,177.888856,355.777711,72.954453,1,5
0,0,11,11,7,14,21,30,48,78,0.000333,0.1142,9,3083.406831,171.300379,342.600759,72.954453,1,5
0,0,11,11,7,15,22,30,55,85,0.000333,0.126351,9,3411.465188,189.525844,379.051688,78.254843,1,5
0,0,12,12,9,20,29,44,62,106,0.000333,0.171649,12,6179.351826,343.297324,514.945985,114.967887,3,5
0,0,6,6,7,11,18,15,21,36,0.000333,0.050039,3,450.3519,25.01955,150.1173,57.705232,1,5
0,0,10,10,8,13,21,24,24,48,0.000333,0.070277,4,843.324945,46.851386,210.831236,72.105716,3,5
0,0,10,10,8,13,21,24,24,48,0.000333,0.070277,4,843.324945,46.851386,210.831236,72.105716,3,5
0,0,8,8,7,12,19,18,22,40,0.000333,0.056639,3,509.751302,28.319517,169.917101,62.671034,1,5
0,0,14,14,10,15,25,34,30,64,0.000333,0.099069,10,2972.067961,165.114887,297.206796,91.82264,3,5
0,0,10,10,8,13,21,24,24,48,0.000333,0.070277,4,843.324945,46.851386,210.831236,72.105716,3,5
0,0,10,10,8,13,21,24,24,48,0.000333,0.070277,4,843.324945,46.851386,210.831236,72.105716,3,5
0,0,11,11,9,14,23,27,34,61,0.000333,0.091979,8,2207.498235,122.638791,275.937279,81.832294,1,5
0,0,10,10,8,14,22,24,31,55,0.000333,0.081756,8,1962.149912,109.008328,245.268739,77.302969,1,5
0,0,10,10,8,14,22,25,32,57,0.000333,0.084729,8,2033.500818,112.972268,254.187602,77.302969,1,5
0,0,10,10,7,14,21,22,32,54,0.000333,0.079062,6,1423.110845,79.061714,237.185141,72.954453,1,5
0,0,11,11,8,17,25,25,36,61,0.000333,0.094425,8,2266.201821,125.900101,283.275228,93.486868,1,5
0,0,12,12,7,15,22,28,46,74,0.000333,0.109999,9,2969.981458,164.99897,329.99794,78.254843,1,5
0,0,14,14,7,16,23,33,57,90,0.000333,0.135707,9,3664.085184,203.560288,407.120576,83.651484,1,5
0,0,11,11,7,14,21,30,53,83,0.000333,0.121521,9,3281.061115,182.281173,364.562346,72.954453,1,5
0,0,12,12,8,16,24,36,44,80,0.000333,0.122266,8,2934.376,163.020889,366.797,88,1,5
0,0,5,5,7,11,18,15,20,35,0.000333,0.048649,3,437.842125,24.324563,145.947375,57.705232,1,5
0,0,5,5,9,11,20,15,19,34,0.000333,0.048982,4,587.782221,32.654568,146.945555,66.583073,1,5
0,0,13,13,11,16,27,36,50,86,0.000333,0.136307,15,6133.804878,340.766938,408.920325,102.053748,1,5
0,0,34,34,22,53,75,167,110,277,0.000333,0.575128,22,37958.4211,2108.801172,1725.382777,401.68728,12,5
0,0,34,34,21,52,73,167,110,277,0.000333,0.571527,20,34291.62806,1905.090448,1714.581403,388.661531,12,5
0,0,34,34,21,54,75,167,111,278,0.000333,0.577204,20,34632.23192,1924.012884,1731.611596,403.002591,12,5
0,0,34,34,21,54,75,167,111,278,0.000333,0.577204,20,34632.23192,1924.012884,1731.611596,403.002591,12,5
0,0,36,36,22,53,75,171,113,284,0.000333,0.589662,22,38917.65918,2162.092177,1768.984508,401.68728,12,5
0,0,34,34,21,53,74,167,110,277,0.000333,0.57334,20,34400.37165,1911.131758,1720.018582,395.81845,12,5
0,0,34,34,21,53,74,167,110,277,0.000333,0.57334,20,34400.37165,1911.131758,1720.018582,395.81845,12,5
0,0,35,35,24,54,78,174,117,291,0.000333,0.609684,24,43897.2491,2438.736061,1829.052046,420.803025,12,5
0,0,10,10,8,14,22,24,26,50,0.000333,0.074324,4,891.886324,49.54924,222.971581,77.302969,3,5
0,0,10,10,8,14,22,24,28,52,0.000333,0.077297,8,1855.123553,103.06242,231.890444,77.302969,3,5
0,0,10,10,8,14,22,24,26,50,0.000333,0.074324,4,891.886324,49.54924,222.971581,77.302969,3,5
0,0,8,8,7,13,20,18,24,42,0.000333,0.060507,3,544.56294,30.253497,181.52098,67.757201,1,5
0,0,14,14,10,15,25,34,32,66,0.000333,0.102165,10,3064.945085,170.274727,306.494509,91.82264,3,5
0,0,10,10,8,15,23,24,28,52,0.000333,0.078408,4,940.900887,52.272271,235.225222,82.603359,3,5
0,0,10,10,8,15,23,24,28,52,0.000333,0.078408,4,940.900887,52.272271,235.225222,82.603359,3,5
0,0,6,6,7,11,18,15,21,36,0.000333,0.050039,3,450.3519,25.01955,150.1173,57.705232,1,5
0,0,11,11,7,13,20,30,48,78,0.000333,0.11237,9,3033.993523,168.555196,337.110391,67.757201,1,5
0,0,11,11,7,14,21,30,55,85,0.000333,0.124449,9,3360.122828,186.67349,373.346981,72.954453,1,5
0,0,12,12,9,19,28,44,62,106,0.000333,0.16986,12,6114.955461,339.719748,509.579622,109.239948,3,5
0,0,10,10,8,13,21,26,33,59,0.000333,0.086382,8,2073.173824,115.176324,259.146728,72.105716,1,5
0,0,12,12,9,15,24,34,40,74,0.000333,0.113096,8,2714.2978,150.794322,339.287225,87.132684,1,5
0,0,12,12,8,15,23,28,43,71,0.000333,0.107058,8,2569.383191,142.743511,321.172899,82.603359,1,5
0,0,11,11,10,16,26,30,37,67,0.000333,0.104976,10,3149.294611,174.960812,314.929461,97.219281,1,5
0,0,30,30,19,49,68,149,98,247,0.000333,0.501201,18,27064.85979,1503.603322,1503.603322,355.831405,11,5
0,0,13,13,11,15,26,34,45,79,0.000333,0.123778,15,5570.021066,309.445615,371.334738,96.657107,1,5
0,0,5,5,9,11,20,17,19,36,0.000333,0.051863,4,622.357646,34.575425,155.589411,66.583073,1,5
0,0,10,10,10,15,25,26,35,61,0.000333,0.094425,10,2832.752276,157.375126,283.275228,91.82264,1,5
0,0,5,5,9,10,19,15,18,33,0.000333,0.046727,4,560.726432,31.151468,140.181608,61.748606,1,5
0,0,13,13,12,16,28,37,46,83,0.000333,0.133003,12,4788.125502,266.006972,399.010459,107.01955,1,5
0,0,13,13,12,17,29,37,46,83,0.000333,0.134404,12,4838.549071,268.808282,403.212423,112.506418,1,5
0,0,10,10,8,12,20,24,32,56,0.000333,0.080676,8,1936.223787,107.567988,242.027973,67.01955,1,5
0,0,27,27,19,46,65,137,89,226,0.000333,0.453685,9,12249.49613,680.527563,1361.055126,334.794473,10,5
0,0,34,34,21,55,76,168,112,280,0.000333,0.58314,20,34988.39408,1943.799671,1749.419704,410.21345,13,5
0,0,34,34,21,54,75,168,111,279,0.000333,0.57928,20,34756.80829,1930.933794,1737.840415,403.002591,13,5
0,0,34,34,21,53,74,168,111,279,0.000333,0.577479,20,34648.74978,1924.930543,1732.437489,395.81845,13,5
0,0,34,34,21,54,75,168,111,279,0.000333,0.57928,20,34756.80829,1930.933794,1737.840415,403.002591,13,5
0,0,11,11,9,13,22,27,30,57,0.000333,0.084729,8,2033.500818,112.972268,254.187602,76.635041,1,5
0,0,10,10,8,13,21,24,28,52,0.000333,0.076134,8,1827.204048,101.511336,228.400506,72.105716,1,5
0,0,10,10,8,13,21,25,28,53,0.000333,0.077598,8,1862.342587,103.463477,232.792823,72.105716,1,5
0,0,11,11,8,16,24,25,33,58,0.000333,0.088643,8,2127.4226,118.190144,265.927825,88,1,5
0,0,10,10,7,13,20,23,32,55,0.000333,0.079235,6,1426.236271,79.235348,237.706045,67.757201,1,5
0,0,6,6,8,12,20,16,20,36,0.000333,0.051863,4,622.357646,34.575425,155.589411,67.01955,1,5
0,0,10,10,7,14,21,23,35,58,0.000333,0.084918,6,1528.526463,84.918137,254.754411,72.954453,1,5
0,0,6,6,8,12,20,16,21,37,0.000333,0.053304,4,639.645358,35.535853,159.91134,67.01955,1,5
0,0,10,10,9,13,22,25,32,57,0.000333,0.084729,8,2033.500818,112.972268,254.187602,76.635041,1,5
0,0,9,9,8,13,21,22,29,51,0.000333,0.074669,8,1792.065508,99.559195,224.008189,72.105716,1,5
0,0,5,5,8,9,17,16,18,34,0.000333,0.046325,8,1111.789893,61.766105,138.973737,52.529325,1,5
0,0,9,9,7,13,20,21,33,54,0.000333,0.077795,6,1400.304703,77.794706,233.384117,67.757201,1,5
0,0,10,10,8,13,21,24,36,60,0.000333,0.087846,8,2108.312363,117.128465,263.539045,72.105716,1,5
0,0,11,11,7,14,21,30,53,83,0.000333,0.121521,9,3281.061115,182.281173,364.562346,72.954453,1,5
0,0,13,13,9,16,25,40,43,83,0.000333,0.12848,8,3083.52051,171.306695,385.440064,92.529325,1,5
0,0,8,8,8,13,21,19,22,41,0.000333,0.060028,4,720.340057,40.018892,180.085014,72.105716,2,5
0,0,10,10,10,14,24,24,24,48,0.000333,0.073359,5,1100.391,61.132833,220.0782,86.52225,2,5
0,0,10,10,9,14,23,23,24,47,0.000333,0.070869,4,850.429648,47.246092,212.607412,81.832294,2,5
0,0,14,14,9,15,24,42,32,74,0.000333,0.113096,8,2714.2978,150.794322,339.287225,87.132684,3,5
0,0,35,35,21,54,75,172,116,288,0.000333,0.597967,20,35877.99566,1993.221981,1793.899783,403.002591,12,5
0,0,12,12,12,19,31,38,37,75,0.000333,0.123855,6,2229.38834,123.854908,371.564723,123.730173,2,5
0,0,13,13,9,19,28,35,53,88,0.000333,0.141016,8,3384.377865,188.020993,423.047233,109.239948,1,5
0,0,33,33,21,53,74,165,110,275,0.000333,0.5692,20,34151.99351,1897.332973,1707.599676,395.81845,12,5
0,0,11,11,8,14,22,30,35,65,0.000333,0.096621,8,2318.904442,128.828025,289.863055,77.302969,1,5
0,0,11,11,7,13,20,30,48,78,0.000333,0.11237,9,3033.993523,168.555196,337.110391,67.757201,1,5
0,0,11,11,7,14,21,30,55,85,0.000333,0.124449,9,3360.122828,186.67349,373.346981,72.954453,1,5
0,0,12,12,9,19,28,44,62,106,0.000333,0.16986,12,6114.955461,339.719748,509.579622,109.239948,3,5
0,0,11,11,8,13,21,28,34,62,0.000333,0.090775,8,2178.589442,121.032747,272.32368,72.105716,1,5
0,0,14,14,7,15,22,35,52,87,0.000333,0.129324,9,3491.734957,193.985275,387.970551,78.254843,1,5
0,0,14,14,8,17,25,34,57,91,0.000333,0.140864,12,5071.090959,281.727276,422.590913,93.486868,1,5
0,0,15,15,10,22,32,50,64,114,0.000333,0.19,10,5700,316.666667,570,131.326777,3,5
0,0,10,10,8,14,22,28,27,55,0.000333,0.081756,4,981.074956,54.504164,245.268739,77.302969,3,5
0,0,10,10,8,14,22,28,27,55,0.000333,0.081756,4,981.074956,54.504164,245.268739,77.302969,3,5
0,0,13,13,13,19,32,41,39,80,0.000333,0.133333,12,4800,266.666667,400,128.816339,2,5
0,0,15,15,9,16,25,48,35,83,0.000333,0.12848,8,3083.52051,171.306695,385.440064,92.529325,3,5
0,0,10,10,8,13,21,28,25,53,0.000333,0.077598,4,931.171294,51.731739,232.792823,72.105716,3,5
0,0,10,10,8,13,21,28,25,53,0.000333,0.077598,4,931.171294,51.731739,232.792823,72.105716,3,5
0,0,10,10,8,14,22,28,27,55,0.000333,0.081756,4,981.074956,54.504164,245.268739,77.302969,3,5
0,0,14,14,10,15,25,38,31,69,0.000333,0.106809,10,3204.260771,178.014487,320.426077,91.82264,3,5
0,0,13,13,11,20,31,40,44,84,0.000333,0.138717,10,4161.524901,231.195828,416.15249,124.49231,3,5
0,0,13,13,12,20,32,41,38,79,0.000333,0.131667,6,2370,131.666667,395,129.458112,3,5
0,0,10,10,11,18,29,32,31,63,0.000333,0.102018,5,1530.264013,85.014667,306.052803,113.112398,2,5
0,0,13,13,14,21,35,50,44,94,0.000333,0.160718,14,6750.13645,375.007581,482.152604,145.541635,4,5
0,0,12,12,12,19,31,39,37,76,0.000333,0.125506,6,2259.113518,125.506307,376.51892,123.730173,2,5
0,0,12,12,11,19,30,36,37,73,0.000333,0.119401,5,1791.015067,99.500837,358.203013,118.764371,2,5
0,0,40,40,23,58,81,195,131,326,0.000333,0.68893,22,45469.40422,2526.078012,2066.791101,443.804823,12,5
0,0,39,39,23,58,81,189,129,318,0.000333,0.672024,22,44353.59062,2464.088368,2016.072301,443.804823,12,5
0,0,10,10,8,13,21,24,24,48,0.000333,0.070277,4,843.324945,46.851386,210.831236,72.105716,3,5
0,0,10,10,8,13,21,24,24,48,0.000333,0.070277,4,843.324945,46.851386,210.831236,72.105716,3,5
0,0,12,12,8,15,23,40,40,80,0.000333,0.120628,8,2895.079652,160.837758,361.884956,82.603359,1,5
0,0,29,29,20,47,67,146,97,243,0.000333,0.491353,20,29481.19347,1637.844081,1474.059673,347.504238,9,5
0,0,14,14,10,14,24,34,30,64,0.000333,0.097813,10,2934.376,163.020889,293.4376,86.52225,3,5
0,0,29,29,19,47,66,145,97,242,0.000333,0.487581,18,26329.38078,1462.743377,1462.743377,341.776299,9,5
0,0,30,30,19,47,66,151,99,250,0.000333,0.5037,18,27199.77354,1511.09853,1511.09853,341.776299,9,5
0,0,29,29,22,48,70,149,99,248,0.000333,0.506687,22,33441.36814,1857.853786,1520.062188,366.185696,10,5
0,0,27,27,19,46,65,139,91,230,0.000333,0.461715,9,12466.30137,692.572298,1385.144597,334.794473,9,5
0,0,35,35,21,54,75,171,116,287,0.000333,0.59589,20,35753.41928,1986.301071,1787.670964,403.002591,12,5
0,0,5,5,7,10,17,15,18,33,0.000333,0.044962,3,404.658821,22.481046,134.886274,52.870765,1,5
0,0,15,15,12,22,34,44,54,98,0.000333,0.16619,12,5982.856301,332.380906,498.571358,141.127046,2,5
0,0,15,15,11,22,33,50,51,101,0.000333,0.169828,10,5094.838061,283.046559,509.483806,136.161243,2,5
0,0,6,6,7,11,18,15,21,36,0.000333,0.050039,3,450.3519,25.01955,150.1173,57.705232,1,5
0,0,14,14,10,18,28,33,36,69,0.000333,0.110569,10,3317.074896,184.281939,331.70749,108.277931,3,5
0,0,13,13,14,22,36,42,46,88,0.000333,0.151651,14,6369.347602,353.852645,454.9534,151.410465,2,5
0,0,5,5,9,11,20,17,19,36,0.000333,0.051863,4,622.357646,34.575425,155.589411,66.583073,1,5
0,0,11,11,8,14,22,32,36,68,0.000333,0.10108,8,2425.930801,134.773933,303.24135,77.302969,1,5
0,0,12,12,7,14,21,32,43,75,0.000333,0.109808,9,2964.81426,164.711903,329.423807,72.954453,1,5
0,0,14,14,7,15,22,37,53,90,0.000333,0.133783,9,3612.139611,200.674423,401.348846,78.254843,1,5
0,0,10,10,8,13,21,28,25,53,0.000333,0.077598,4,931.171294,51.731739,232.792823,72.105716,3,5
0,0,10,10,8,13,21,24,24,48,0.000333,0.070277,4,843.324945,46.851386,210.831236,72.105716,3,5
0,0,5,5,7,12,19,15,22,37,0.000333,0.052391,3,471.519954,26.195553,157.173318,62.671034,1,5
0,0,11,11,8,17,25,27,45,72,0.000333,0.111453,8,2674.861165,148.603398,334.357646,93.486868,1,5
0,0,6,6,8,13,21,16,23,39,0.000333,0.0571,4,685.201518,38.066751,171.300379,72.105716,1,5
0,0,10,10,7,16,23,22,41,63,0.000333,0.094995,6,1709.906419,94.994801,284.984403,83.651484,1,5
0,0,14,14,7,18,25,32,67,99,0.000333,0.153247,9,4137.675865,229.870881,459.741763,94.710134,1,5
0,0,8,8,8,15,23,18,27,45,0.000333,0.067853,4,814.241152,45.23562,203.560288,82.603359,2,5
0,0,8,8,8,15,23,18,28,46,0.000333,0.069361,4,832.3354,46.240856,208.08385,82.603359,2,5
0,0,8,8,8,16,24,18,28,46,0.000333,0.070303,4,843.6331,46.868506,210.908275,88,2,5
0,0,8,8,8,15,23,18,27,45,0.000333,0.067853,4,814.241152,45.23562,203.560288,82.603359,2,5
0,0,8,8,8,15,23,18,27,45,0.000333,0.067853,4,814.241152,45.23562,203.560288,82.603359,2,5
0,0,14,14,9,18,27,41,38,79,0.000333,0.125212,8,3005.088901,166.949383,375.636113,103.587975,3,5
0,0,10,10,9,17,26,22,30,52,0.000333,0.081474,4,977.691461,54.316192,244.422865,98.016193,2,5
0,0,10,10,8,17,25,23,32,55,0.000333,0.085137,4,1021.648362,56.758242,255.41209,93.486868,3,5
0,0,10,10,8,14,22,28,25,53,0.000333,0.078783,4,945.399503,52.522195,236.349876,77.302969,3,5
0,0,10,10,8,16,24,23,32,55,0.000333,0.084058,8,2017.3835,112.076861,252.172938,88,3,5
0,0,10,10,8,16,24,23,30,53,0.000333,0.081001,4,972.01205,54.000669,243.003013,88,3,5
0,0,10,10,8,16,24,23,30,53,0.000333,0.081001,4,972.01205,54.000669,243.003013,88,3,5
0,0,8,8,7,13,20,22,23,45,0.000333,0.064829,3,583.460293,32.414461,194.486764,67.757201,1,5
0,0,8,8,7,15,22,17,28,45,0.000333,0.066891,3,602.023269,33.445737,200.674423,78.254843,1,5
0,0,10,10,8,16,24,23,30,53,0.000333,0.081001,4,972.01205,54.000669,243.003013,88,3,5
0,0,32,32,20,51,71,157,105,262,0.000333,0.537078,20,32224.67491,1790.259717,1611.233745,375.732254,12,5
0,0,32,32,19,53,72,157,106,263,0.000333,0.540897,18,29208.42496,1622.690275,1622.690275,384.290407,12,5
0,0,32,32,19,51,70,156,105,261,0.000333,0.533248,18,28795.37161,1599.742867,1599.742867,370.004315,12,5
0,0,33,33,19,51,70,162,107,269,0.000333,0.549592,18,29677.98837,1648.777132,1648.777132,370.004315,12,5
0,0,14,14,9,15,24,32,30,62,0.000333,0.094756,8,2274.1414,126.341189,284.267675,87.132684,3,5
0,0,10,10,8,14,22,24,24,48,0.000333,0.071351,4,856.210871,47.567271,214.052718,77.302969,3,5
0,0,10,10,8,14,22,24,26,50,0.000333,0.074324,4,891.886324,49.54924,222.971581,77.302969,3,5
0,0,10,10,8,15,23,24,26,50,0.000333,0.075393,4,904.712391,50.2618,226.178098,82.603359,3,5
0,0,10,10,8,14,22,24,24,48,0.000333,0.071351,4,856.210871,47.567271,214.052718,77.302969,3,5
0,0,14,14,10,15,25,34,30,64,0.000333,0.099069,10,2972.067961,165.114887,297.206796,91.82264,3,5
0,0,10,10,8,15,23,24,26,50,0.000333,0.075393,4,904.712391,50.2618,226.178098,82.603359,3,5
0,0,10,10,8,14,22,24,24,48,0.000333,0.071351,4,856.210871,47.567271,214.052718,77.302969,3,5
0,0,10,10,8,14,22,24,24,48,0.000333,0.071351,4,856.210871,47.567271,214.052718,77.302969,3,5
0,0,10,10,8,14,22,28,27,55,0.000333,0.081756,4,981.074956,54.504164,245.268739,77.302969,3,5
0,0,13,13,7,17,24,30,65,95,0.000333,0.14519,9,3920.142938,217.785719,435.571438,89.138353,1,5
0,0,11,11,7,16,23,25,52,77,0.000333,0.116105,9,3134.828436,174.157135,348.314271,83.651484,1,5
0,0,6,6,8,13,21,16,23,39,0.000333,0.0571,4,685.201518,38.066751,171.300379,72.105716,1,5
0,0,33,33,21,53,74,165,110,275,0.000333,0.5692,20,34151.99351,1897.332973,1707.599676,395.81845,12,5
0,0,35,35,24,55,79,175,118,293,0.000333,0.615669,24,44328.18622,2462.677012,1847.007759,428.013884,13,5
0,0,10,10,8,14,22,28,25,53,0.000333,0.078783,4,945.399503,52.522195,236.349876,77.302969,3,5
0,0,36,36,21,54,75,177,118,295,0.000333,0.612501,20,36750.03027,2041.668349,1837.501514,403.002591,12,5
0,0,10,10,8,17,25,23,32,55,0.000333,0.085137,4,1021.648362,56.758242,255.41209,93.486868,3,5
0,0,12,12,8,15,23,36,39,75,0.000333,0.113089,8,2714.137174,150.785399,339.267147,82.603359,1,5
0,0,5,5,7,10,17,15,18,33,0.000333,0.044962,3,404.658821,22.481046,134.886274,52.870765,1,5
0,0,5,5,7,11,18,15,19,34,0.000333,0.047259,3,425.33235,23.629575,141.77745,57.705232,1,5
0,0,6,6,9,16,25,29,26,55,0.000333,0.085137,4,1021.648362,56.758242,255.41209,92.529325,3,5
0,0,6,6,7,11,18,15,21,36,0.000333,0.050039,3,450.3519,25.01955,150.1173,57.705232,1,5
0,0,13,13,9,16,25,36,42,78,0.000333,0.12074,8,2897.766262,160.987015,362.220783,92.529325,1,5
0,0,13,13,8,16,24,30,45,75,0.000333,0.114624,8,2750.9775,152.832083,343.872188,88,1,5
0,0,31,31,19,51,70,153,100,253,0.000333,0.516903,9,13956.37743,775.354302,1550.708603,370.004315,13,5
0,0,31,31,19,52,71,153,101,254,0.000333,0.520679,9,14058.32192,781.017884,1562.035768,377.133488,13,5
0,0,31,31,19,52,71,153,101,254,0.000333,0.520679,9,14058.32192,781.017884,1562.035768,377.133488,13,5
0,0,33,33,21,51,72,158,103,261,0.000333,0.536783,20,32207.00851,1789.27825,1610.350425,381.532358,13,5
0,0,30,30,19,50,69,150,99,249,0.000333,0.507008,9,13689.20331,760.511295,1521.02259,362.903432,12,5
0,0,31,31,19,51,70,153,101,254,0.000333,0.518946,9,14011.54098,778.418943,1556.837886,370.004315,13,5
0,0,31,31,19,51,70,153,100,253,0.000333,0.516903,9,13956.37743,775.354302,1550.708603,370.004315,13,5
0,0,31,31,19,51,70,153,100,253,0.000333,0.516903,9,13956.37743,775.354302,1550.708603,370.004315,13,5
0,0,31,31,19,51,70,153,100,253,0.000333,0.516903,9,13956.37743,775.354302,1550.708603,370.004315,13,5
0,0,12,12,11,20,31,38,35,73,0.000333,0.120552,5,1808.281653,100.460092,361.656331,124.49231,4,5
0,0,12,12,11,19,30,38,33,71,0.000333,0.11613,5,1741.946161,96.774787,348.389232,118.764371,4,5
0,0,10,10,11,18,29,32,31,63,0.000333,0.102018,5,1530.264013,85.014667,306.052803,113.112398,2,5
0,0,12,12,11,19,30,38,33,71,0.000333,0.11613,5,1741.946161,96.774787,348.389232,118.764371,4,5
0,0,12,12,11,19,30,38,35,73,0.000333,0.119401,5,1791.015067,99.500837,358.203013,118.764371,4,5
0,0,10,10,10,14,24,24,24,48,0.000333,0.073359,5,1100.391,61.132833,220.0782,86.52225,2,5
0,0,8,8,8,14,22,19,22,41,0.000333,0.060946,4,731.346785,40.630377,182.836696,77.302969,2,5
0,0,8,8,8,13,21,19,21,40,0.000333,0.058564,4,702.770788,39.042822,175.692697,72.105716,2,5
0,0,8,8,8,13,21,19,21,40,0.000333,0.058564,4,702.770788,39.042822,175.692697,72.105716,2,5
0,0,10,10,9,14,23,23,24,47,0.000333,0.070869,4,850.429648,47.246092,212.607412,81.832294,2,5
0,0,8,8,8,14,22,19,22,41,0.000333,0.060946,4,731.346785,40.630377,182.836696,77.302969,2,5
0,0,8,8,8,13,21,19,21,40,0.000333,0.058564,4,702.770788,39.042822,175.692697,72.105716,2,5
0,0,31,31,21,50,71,154,101,255,0.000333,0.522729,20,31363.71031,1742.428351,1568.185515,374.431475,10,5
0,0,31,31,21,50,71,154,101,255,0.000333,0.522729,20,31363.71031,1742.428351,1568.185515,374.431475,10,5
0,0,33,33,22,49,71,159,103,262,0.000333,0.537078,22,35447.1424,1969.285689,1611.233745,373.228278,10,5
0,0,30,30,21,48,69,151,99,250,0.000333,0.509044,20,30542.62228,1696.812349,1527.131114,360.316866,9,5
0,0,31,31,21,49,70,154,101,255,0.000333,0.520989,20,31259.34339,1736.630188,1562.967169,367.359448,10,5
0,0,31,31,21,49,70,154,100,254,0.000333,0.518946,20,31136.75773,1729.819874,1556.837886,367.359448,10,5
0,0,31,31,21,49,70,154,100,254,0.000333,0.518946,20,31136.75773,1729.819874,1556.837886,367.359448,10,5
0,0,31,31,21,49,70,154,100,254,0.000333,0.518946,20,31136.75773,1729.819874,1556.837886,367.359448,10,5
0,0,34,34,23,54,77,170,113,283,0.000333,0.591167,22,39017.013,2167.611833,1773.500591,414.80585,10,5
0,0,34,34,23,54,77,170,113,283,0.000333,0.591167,22,39017.013,2167.611833,1773.500591,414.80585,10,5
0,0,35,35,23,56,79,173,115,288,0.000333,0.605163,22,39940.75482,2218.930823,1815.488855,429.253801,11,5
0,0,35,35,23,56,79,173,115,288,0.000333,0.605163,22,39940.75482,2218.930823,1815.488855,429.253801,11,5
0,0,35,35,23,54,77,173,114,287,0.000333,0.599523,22,39568.49022,2198.249457,1798.567737,414.80585,11,5
0,0,35,35,24,55,79,173,114,287,0.000333,0.603062,24,43420.44179,2412.246766,1809.185075,428.013884,11,5
0,0,37,37,23,55,78,182,121,303,0.000333,0.634826,22,41898.49119,2327.693955,1904.476872,422.016709,10,5
0,0,36,36,23,55,78,176,119,295,0.000333,0.618065,22,40792.2604,2266.236689,1854.193655,422.016709,10,5
0,0,10,10,10,13,23,24,24,48,0.000333,0.072377,5,1085.654869,60.314159,217.130974,81.324997,2,5
0,0,8,8,8,13,21,19,22,41,0.000333,0.060028,4,720.340057,40.018892,180.085014,72.105716,2,5
0,0,8,8,8,12,20,19,21,40,0.000333,0.057626,4,691.508495,38.417139,172.877124,67.01955,2,5
0,0,8,8,8,12,20,19,21,40,0.000333,0.057626,4,691.508495,38.417139,172.877124,67.01955,2,5
0,0,8,8,8,12,20,19,22,41,0.000333,0.059066,4,708.796208,39.377567,177.199052,67.01955,2,5
0,0,8,8,8,13,21,19,22,41,0.000333,0.060028,4,720.340057,40.018892,180.085014,72.105716,2,5
0,0,14,14,9,14,23,42,32,74,0.000333,0.111581,8,2677.948678,148.774927,334.743585,81.832294,3,5
0,0,10,10,9,13,22,23,24,47,0.000333,0.069864,4,838.373144,46.576286,209.593286,76.635041,2,5
0,0,8,8,7,12,19,18,22,40,0.000333,0.056639,3,509.751302,28.319517,169.917101,62.671034,1,5
0,0,10,10,8,13,21,24,24,48,0.000333,0.070277,4,843.324945,46.851386,210.831236,72.105716,3,5
0,0,28,28,19,46,65,142,92,234,0.000333,0.469745,18,25366.21323,1409.234068,1409.234068,334.794473,10,5
0,0,31,31,19,49,68,152,99,251,0.000333,0.509318,18,27503.15712,1527.953173,1527.953173,355.831405,12,5
0,0,11,11,7,14,21,30,49,79,0.000333,0.115664,9,3122.937688,173.496538,346.993076,72.954453,1,5
0,0,11,11,8,13,21,30,35,65,0.000333,0.095167,8,2284.00506,126.88917,285.500632,72.105716,1,5
0,0,5,5,8,9,17,16,17,33,0.000333,0.044962,4,539.545095,29.974728,134.886274,52.529325,1,5
0,0,28,28,19,48,67,142,93,235,0.000333,0.475177,9,12829.77864,712.76548,1425.53096,348.788823,10,5
0,0,28,28,19,47,66,142,92,234,0.000333,0.471463,9,12729.49402,707.194112,1414.388224,341.776299,10,5
0,0,10,10,7,16,23,26,43,69,0.000333,0.104042,6,1872.75465,104.041925,312.125775,83.651484,1,5
0,0,6,6,8,13,21,16,23,39,0.000333,0.0571,4,685.201518,38.066751,171.300379,72.105716,1,5
0,0,14,14,7,18,25,36,69,105,0.000333,0.162535,9,4388.444099,243.80245,487.6049,94.710134,1,5
0,0,12,12,7,17,24,31,56,87,0.000333,0.132964,9,3590.025638,199.445869,398.891738,89.138353,1,5
0,0,11,11,9,16,25,30,40,70,0.000333,0.108357,8,2600.559466,144.475526,325.069933,92.529325,1,5
0,0,10,10,8,16,24,27,37,64,0.000333,0.097813,8,2347.5008,130.416711,293.4376,88,1,5
0,0,11,11,8,16,24,29,46,75,0.000333,0.114624,8,2750.9775,152.832083,343.872188,88,1,5
0,0,11,11,7,15,22,30,61,91,0.000333,0.135269,12,4869.699328,270.538852,405.808277,78.254843,1,5
0,0,13,13,11,15,26,32,45,77,0.000333,0.120645,15,5429.007874,301.611549,361.933858,96.657107,1,5
0,0,5,5,9,11,20,15,19,34,0.000333,0.048982,4,587.782221,32.654568,146.945555,66.583073,1,5
0,0,11,11,10,16,26,28,37,65,0.000333,0.101843,10,3055.285817,169.738101,305.528582,97.219281,1,5
0,0,5,5,9,12,21,17,20,37,0.000333,0.054172,4,650.062979,36.11461,162.515745,71.548875,1,5
0,0,6,6,7,12,19,15,22,37,0.000333,0.052391,3,471.519954,26.195553,157.173318,62.671034,1,5
0,0,13,13,11,16,27,36,46,82,0.000333,0.129967,10,3899.007752,216.611542,389.900775,102.053748,1,5
0,0,5,5,9,11,20,15,18,33,0.000333,0.047541,4,570.494509,31.694139,142.623627,66.583073,1,5
0,0,13,13,8,17,25,34,46,80,0.000333,0.123836,8,2972.067961,165.114887,371.508495,93.486868,1,5
0,0,13,13,9,17,26,40,43,83,0.000333,0.130045,8,3121.091973,173.393998,390.136497,98.016193,1,5
0,0,6,6,7,12,19,15,21,36,0.000333,0.050975,3,458.776171,25.487565,152.92539,62.671034,1,5
0,0,11,11,10,17,27,32,38,70,0.000333,0.110947,10,3328.421252,184.912292,332.842125,102.706149,1,5
0,0,5,5,9,12,21,17,19,36,0.000333,0.052708,4,632.493709,35.138539,158.123427,71.548875,1,5
0,0,11,11,8,17,25,29,38,67,0.000333,0.103713,8,2489.106918,138.283718,311.138365,93.486868,1,5
0,0,10,10,7,14,21,26,34,60,0.000333,0.087846,6,1581.234272,87.846348,263.539045,72.954453,1,5
0,0,10,10,8,14,22,29,34,63,0.000333,0.093648,8,2247.553536,124.864085,280.944192,77.302969,1,5
0,0,11,11,9,15,24,31,34,65,0.000333,0.099341,8,2384.1805,132.454472,298.022563,87.132684,2,5
0,0,11,11,8,15,23,30,40,70,0.000333,0.10555,8,2533.194695,140.733039,316.649337,82.603359,2,5
0,0,11,11,10,16,26,40,39,79,0.000333,0.123778,10,3713.347377,206.297077,371.334738,97.219281,3,5
0,0,8,8,7,13,20,22,26,48,0.000333,0.069151,6,1244.715291,69.15085,207.452549,67.757201,1,5
0,0,11,11,9,14,23,31,36,67,0.000333,0.101026,8,2424.629208,134.701623,303.078651,81.832294,1,5
0,0,31,31,21,49,70,154,100,254,0.000333,0.518946,20,31136.75773,1729.819874,1556.837886,367.359448,10,5
0,0,5,5,9,12,21,15,22,37,0.000333,0.054172,4,650.062979,36.11461,162.515745,71.548875,1,5
0,0,38,38,23,58,81,186,124,310,0.000333,0.655118,22,43237.77702,2402.098723,1965.353501,443.804823,13,5
0,0,38,38,23,58,81,186,125,311,0.000333,0.657231,22,43377.25372,2409.847429,1971.693351,443.804823,13,5
0,0,37,37,23,57,80,183,123,306,0.000333,0.644837,22,42559.21994,2364.401107,1934.509997,436.516656,12,5
0,0,38,38,23,57,80,186,124,310,0.000333,0.653266,22,43115.54961,2395.308312,1959.797709,436.516656,13,5
0,0,38,38,23,59,82,186,125,311,0.000333,0.659066,22,43498.37082,2416.576156,1977.198673,451.117865,13,5
0,0,38,38,23,59,82,186,125,311,0.000333,0.659066,22,43498.37082,2416.576156,1977.198673,451.117865,13,5
0,0,38,38,23,58,81,186,124,310,0.000333,0.655118,22,43237.77702,2402.098723,1965.353501,443.804823,13,5
0,0,38,38,23,58,81,186,124,310,0.000333,0.655118,22,43237.77702,2402.098723,1965.353501,443.804823,13,5
0,0,31,31,21,50,71,155,101,256,0.000333,0.524778,20,31486.70525,1749.261403,1574.335263,374.431475,11,5
0,0,10,10,8,14,22,28,29,57,0.000333,0.084729,8,2033.500818,112.972268,254.187602,77.302969,1,5
0,0,10,10,8,13,21,25,29,54,0.000333,0.079062,8,1897.481127,105.415618,237.185141,72.105716,1,5
0,0,11,11,10,18,28,43,37,80,0.000333,0.128196,10,3845.883938,213.660219,384.588394,108.277931,3,5
0,0,33,33,22,50,72,159,104,263,0.000333,0.540897,22,35699.18606,1983.288114,1622.690275,380.300305,11,5
0,0,31,31,21,51,72,155,102,257,0.000333,0.528557,20,31713.41451,1761.856362,1585.670725,381.532358,11,5
0,0,31,31,21,51,72,155,102,257,0.000333,0.528557,20,31713.41451,1761.856362,1585.670725,381.532358,11,5
0,0,31,31,21,49,70,155,101,256,0.000333,0.523032,20,31381.92905,1743.440503,1569.096452,367.359448,11,5
0,0,30,30,21,49,70,152,100,252,0.000333,0.51486,20,30891.58641,1716.199245,1544.57932,367.359448,10,5
0,0,11,11,9,14,23,31,31,62,0.000333,0.093487,8,2243.68673,124.649263,280.460841,81.832294,1,5
0,0,10,10,8,14,22,28,28,56,0.000333,0.083243,8,1997.825365,110.990298,249.728171,77.302969,3,5
0,0,10,10,8,15,23,28,30,58,0.000333,0.087456,8,2098.932748,116.607375,262.366593,82.603359,3,5
0,0,8,8,7,13,20,22,26,48,0.000333,0.069151,6,1244.715291,69.15085,207.452549,67.757201,1,5
0,0,10,10,8,14,22,28,28,56,0.000333,0.083243,8,1997.825365,110.990298,249.728171,77.302969,3,5
0,0,10,10,8,14,22,28,30,58,0.000333,0.086216,8,2069.176271,114.954237,258.647034,77.302969,3,5
0,0,10,10,8,14,22,28,28,56,0.000333,0.083243,8,1997.825365,110.990298,249.728171,77.302969,3,5
0,0,11,11,8,17,25,29,34,63,0.000333,0.097521,8,2340.50352,130.027973,292.56294,93.486868,1,5
0,0,10,10,8,14,22,29,29,58,0.000333,0.086216,8,2069.176271,114.954237,258.647034,77.302969,1,5
0,0,10,10,7,14,21,26,29,55,0.000333,0.080526,6,1449.46475,80.525819,241.577458,72.954453,1,5
0,0,11,11,8,15,23,30,36,66,0.000333,0.099518,8,2388.440713,132.691151,298.555089,82.603359,2,5
0,0,11,11,9,15,24,31,30,61,0.000333,0.093228,8,2237.4617,124.303428,279.682713,87.132684,2,5
0,0,8,8,8,12,20,19,22,41,0.000333,0.059066,4,708.796208,39.377567,177.199052,67.01955,2,5
0,0,6,6,8,12,20,16,20,36,0.000333,0.051863,4,622.357646,34.575425,155.589411,67.01955,1,5
0,0,10,10,7,13,20,27,33,60,0.000333,0.086439,6,1555.894114,86.438562,259.315686,67.757201,1,5
0,0,34,34,23,54,77,170,113,283,0.000333,0.591167,22,39017.013,2167.611833,1773.500591,414.80585,10,5
0,0,8,8,8,12,20,19,21,40,0.000333,0.057626,4,691.508495,38.417139,172.877124,67.01955,2,5
0,0,8,8,8,12,20,19,21,40,0.000333,0.057626,4,691.508495,38.417139,172.877124,67.01955,2,5
0,0,32,32,21,49,70,157,105,262,0.000333,0.535291,20,32117.44301,1784.302389,1605.87215,367.359448,9,5
0,0,12,12,8,15,23,38,39,77,0.000333,0.116105,8,2786.514165,154.806342,348.314271,82.603359,1,5
0,0,39,39,23,58,81,189,129,318,0.000333,0.672024,22,44353.59062,2464.088368,2016.072301,443.804823,12,5
0,0,10,10,8,16,24,24,36,60,0.000333,0.091699,8,2200.782,122.265667,275.09775,88,1,5
0,0,11,11,8,17,25,25,45,70,0.000333,0.108357,8,2600.559466,144.475526,325.069933,93.486868,2,5
0,0,11,11,9,17,26,26,36,62,0.000333,0.097142,8,2331.4181,129.523228,291.427263,98.016193,2,5
0,0,11,11,9,16,25,26,38,64,0.000333,0.099069,8,2377.654369,132.091909,297.206796,92.529325,1,5
0,0,10,10,8,16,24,23,35,58,0.000333,0.088643,8,2127.4226,118.190144,265.927825,88,1,5
0,0,10,10,8,13,21,24,32,56,0.000333,0.08199,8,1967.758205,109.3199,245.969776,72.105716,1,5
0,0,11,11,7,14,21,30,48,78,0.000333,0.1142,9,3083.406831,171.300379,342.600759,72.954453,1,5
0,0,11,11,7,15,22,30,55,85,0.000333,0.126351,9,3411.465188,189.525844,379.051688,78.254843,1,5
0,0,12,12,9,20,29,44,62,106,0.000333,0.171649,12,6179.351826,343.297324,514.945985,114.967887,3,5
0,0,11,11,7,14,21,26,40,66,0.000333,0.096631,6,1739.357699,96.630983,289.89295,72.954453,1,5
0,0,12,12,8,17,25,29,45,74,0.000333,0.114548,8,2749.162864,152.73127,343.645358,93.486868,1,5
0,0,12,12,10,21,31,41,50,91,0.000333,0.150277,10,4508.318642,250.462147,450.831864,125.457947,3,5
0,0,9,9,7,13,20,21,30,51,0.000333,0.073473,6,1322.509997,73.472778,220.418333,67.757201,1,5
0,0,10,10,8,16,24,24,33,57,0.000333,0.087114,8,2090.7429,116.152383,261.342863,88,1,5
0,0,10,10,10,20,30,36,38,74,0.000333,0.121037,5,1815.54952,100.863862,363.109904,119.657843,3,5
0,0,6,6,8,12,20,16,19,35,0.000333,0.050422,4,605.069933,33.614996,151.267483,67.01955,1,5
0,0,5,5,8,9,17,16,16,32,0.000333,0.0436,4,523.195244,29.066402,130.798811,52.529325,1,5
0,0,5,5,8,10,18,16,17,33,0.000333,0.045869,4,550.4301,30.57945,137.607525,57.219281,1,5
0,0,6,6,10,15,25,30,24,54,0.000333,0.083589,5,1253.841171,69.657843,250.768234,91.82264,3,5
0,0,10,10,8,16,24,27,32,59,0.000333,0.090171,8,2164.1023,120.227906,270.512788,88,3,5
0,0,6,6,7,12,19,15,22,37,0.000333,0.052391,3,471.519954,26.195553,157.173318,62.671034,1,5
0,0,10,10,8,13,21,26,33,59,0.000333,0.086382,8,2073.173824,115.176324,259.146728,72.105716,1,5
0,0,10,10,8,17,25,27,34,61,0.000333,0.094425,8,2266.201821,125.900101,283.275228,93.486868,3,5
0,0,5,5,7,11,18,15,19,34,0.000333,0.047259,3,425.33235,23.629575,141.77745,57.705232,1,5
0,0,11,11,8,14,22,34,37,71,0.000333,0.10554,8,2532.957159,140.719842,316.619645,77.302969,1,5
0,0,10,10,8,17,25,27,34,61,0.000333,0.094425,8,2266.201821,125.900101,283.275228,93.486868,3,5
0,0,10,10,8,17,25,27,34,61,0.000333,0.094425,8,2266.201821,125.900101,283.275228,93.486868,3,5
0,0,26,26,19,46,65,110,83,193,0.000333,0.387439,9,10460.85289,581.158494,1162.316988,334.794473,9,5
0,0,26,26,18,44,62,110,83,193,0.000333,0.383053,9,10342.43899,574.579944,1149.159888,315.273641,9,5
0,0,27,27,21,46,67,122,94,216,0.000333,0.436758,20,26205.5053,1455.861406,1310.275265,346.322516,9,5
0,0,24,24,18,44,62,104,81,185,0.000333,0.367175,9,9913.736857,550.763159,1101.526317,315.273641,7,5
0,0,30,30,19,45,64,118,89,207,0.000333,0.414,9,11178,621,1242,327.844012,9,5
0,0,26,26,18,46,64,110,85,195,0.000333,0.39,9,10530,585,1170,329.1425,9,5
0,0,27,27,19,46,65,113,88,201,0.000333,0.403499,9,10894.46337,605.247965,1210.49593,334.794473,8,5
0,0,28,28,18,47,65,122,98,220,0.000333,0.44164,18,23848.57654,1324.920919,1324.920919,336.124326,7,5
0,0,28,28,19,46,65,139,89,228,0.000333,0.4577,9,12357.89875,686.549931,1373.099861,334.794473,10,5
0,0,5,5,9,11,20,15,19,34,0.000333,0.048982,4,587.782221,32.654568,146.945555,66.583073,1,5
0,0,8,8,8,12,20,19,21,40,0.000333,0.057626,4,691.508495,38.417139,172.877124,67.01955,2,5
0,0,29,29,20,46,66,143,94,237,0.000333,0.477507,20,28650.42813,1591.690451,1432.521406,340.522412,9,5
0,0,12,12,9,16,25,34,45,79,0.000333,0.122288,8,2934.917112,163.050951,366.864639,92.529325,1,5
0,0,6,6,7,12,19,15,23,38,0.000333,0.053807,3,484.263737,26.903541,161.421246,62.671034,1,5
0,0,10,10,8,14,22,26,37,63,0.000333,0.093648,8,2247.553536,124.864085,280.944192,77.302969,1,5
0,0,5,5,7,11,18,15,20,35,0.000333,0.048649,3,437.842125,24.324563,145.947375,57.705232,1,5
0,0,12,12,9,15,24,34,40,74,0.000333,0.113096,8,2714.2978,150.794322,339.287225,87.132684,1,5
0,0,28,28,19,47,66,139,90,229,0.000333,0.461389,9,12457.49628,692.083127,1384.166253,341.776299,10,5
0,0,8,8,8,13,21,19,24,43,0.000333,0.062957,4,755.478597,41.971033,188.869649,72.105716,2,5
0,0,33,33,21,49,70,163,107,270,0.000333,0.551635,20,33098.12829,1838.784905,1654.906415,367.359448,9,5
0,0,32,32,21,49,70,157,105,262,0.000333,0.535291,20,32117.44301,1784.302389,1605.87215,367.359448,9,5
0,0,8,8,8,13,21,19,23,42,0.000333,0.061492,4,737.909327,40.994963,184.477332,72.105716,2,5
0,0,33,33,19,49,68,131,99,230,0.000333,0.466705,18,25202.09616,1400.116453,1400.116453,355.831405,11,5
0,0,34,34,19,50,69,143,103,246,0.000333,0.500899,18,27048.5463,1502.697016,1502.697016,362.903432,11,5
0,0,29,29,18,49,67,123,93,216,0.000333,0.436758,9,11792.47739,655.137633,1310.275265,350.179432,11,5
0,0,29,29,18,49,67,123,93,216,0.000333,0.436758,9,11792.47739,655.137633,1310.275265,350.179432,11,5
0,0,29,29,19,50,69,123,93,216,0.000333,0.439814,9,11874.97154,659.720641,1319.441283,362.903432,11,5
0,0,29,29,18,48,66,123,93,216,0.000333,0.435196,9,11750.30217,652.794565,1305.58913,343.13685,11,5
0,0,29,29,18,50,68,123,95,218,0.000333,0.442356,9,11943.6021,663.53345,1327.066899,357.25146,11,5
0,0,29,29,18,50,68,123,95,218,0.000333,0.442356,9,11943.6021,663.53345,1327.066899,357.25146,11,5
0,0,30,30,21,50,71,135,104,239,0.000333,0.48993,20,29395.79123,1633.099513,1469.789562,374.431475,11,5
0,0,27,27,18,48,66,117,91,208,0.000333,0.419078,9,11315.10579,628.616988,1257.233977,343.13685,9,5
0,0,31,31,19,50,69,152,99,251,0.000333,0.51108,9,13799.15675,766.619819,1533.239639,362.903432,12,5
0,0,31,31,19,51,70,152,100,252,0.000333,0.51486,9,13901.21388,772.28966,1544.57932,370.004315,12,5
0,0,31,31,19,50,69,152,99,251,0.000333,0.51108,9,13799.15675,766.619819,1533.239639,362.903432,12,5
0,0,31,31,19,51,70,152,100,252,0.000333,0.51486,9,13901.21388,772.28966,1544.57932,370.004315,12,5
0,0,31,31,19,50,69,152,100,252,0.000333,0.513116,18,27708.26694,1539.348163,1539.348163,362.903432,12,5
0,0,31,31,19,50,69,152,99,251,0.000333,0.51108,9,13799.15675,766.619819,1533.239639,362.903432,12,5
0,0,33,33,20,50,70,156,102,258,0.000333,0.527118,20,31627.10037,1757.061132,1581.355018,368.631371,12,5
0,0,11,11,10,17,27,28,40,68,0.000333,0.107777,10,3233.323501,179.629083,323.33235,102.706149,1,5
0,0,31,31,18,51,69,135,108,243,0.000333,0.49479,18,26718.68597,1484.371443,1484.371443,364.352342,9,5
0,0,5,5,7,10,17,15,18,33,0.000333,0.044962,3,404.658821,22.481046,134.886274,52.870765,1,5
0,0,6,6,8,11,19,16,19,35,0.000333,0.049559,4,594.709852,33.039436,148.677463,62.053748,1,5
0,0,5,5,7,10,17,15,18,33,0.000333,0.044962,3,404.658821,22.481046,134.886274,52.870765,1,5
0,0,5,5,7,11,18,15,19,34,0.000333,0.047259,3,425.33235,23.629575,141.77745,57.705232,1,5
0,0,6,6,9,16,25,29,26,55,0.000333,0.085137,4,1021.648362,56.758242,255.41209,92.529325,3,5
0,0,31,31,18,50,68,127,111,238,0.000333,0.482939,18,26078.69081,1448.816156,1448.816156,357.25146,9,5
0,0,11,11,7,13,20,30,48,78,0.000333,0.11237,9,3033.993523,168.555196,337.110391,67.757201,1,5
0,0,30,30,19,49,68,125,103,228,0.000333,0.462647,18,24982.9475,1387.941528,1387.941528,355.831405,9,5
0,0,12,12,7,14,21,30,42,72,0.000333,0.105416,9,2846.22169,158.123427,316.246854,72.954453,1,5
0,0,12,12,8,16,24,29,45,74,0.000333,0.113096,8,2714.2978,150.794322,339.287225,88,1,5
0,0,13,13,10,21,31,45,52,97,0.000333,0.160186,10,4805.570421,266.976135,480.557042,125.457947,3,5
0,0,28,28,19,47,66,142,92,234,0.000333,0.471463,9,12729.49402,707.194112,1414.388224,341.776299,10,5
0,0,30,30,21,47,68,147,95,242,0.000333,0.491055,20,29463.32015,1636.85112,1473.166008,353.304342,10,5
0,0,28,28,19,48,67,142,93,235,0.000333,0.475177,9,12829.77864,712.76548,1425.53096,348.788823,10,5
0,0,28,28,19,48,67,142,93,235,0.000333,0.475177,9,12829.77864,712.76548,1425.53096,348.788823,10,5
0,0,29,29,18,49,67,122,101,223,0.000333,0.450913,18,24349.28201,1352.737889,1352.737889,350.179432,9,5
0,0,10,10,8,13,21,26,24,50,0.000333,0.073205,4,878.463485,48.803527,219.615871,72.105716,3,5
0,0,10,10,8,14,22,26,26,52,0.000333,0.077297,4,927.561777,51.53121,231.890444,77.302969,3,5
0,0,14,14,10,14,24,36,30,66,0.000333,0.100869,10,3026.07525,168.115292,302.607525,86.52225,3,5
0,0,10,10,8,13,21,26,24,50,0.000333,0.073205,4,878.463485,48.803527,219.615871,72.105716,3,5
0,0,10,10,8,13,21,26,24,50,0.000333,0.073205,4,878.463485,48.803527,219.615871,72.105716,3,5
0,0,10,10,8,13,21,26,24,50,0.000333,0.073205,4,878.463485,48.803527,219.615871,72.105716,3,5
0,0,16,16,10,19,29,58,41,99,0.000333,0.160313,10,4809.401185,267.188955,480.940119,113.929904,5,5
0,0,15,15,9,15,24,44,34,78,0.000333,0.119209,8,2861.0166,158.945367,357.627075,87.132684,3,5
0,0,14,14,9,14,23,32,30,62,0.000333,0.093487,8,2243.68673,124.649263,280.460841,81.832294,3,5
0,0,11,11,10,15,25,38,35,73,0.000333,0.113001,10,3390.015019,188.334168,339.001502,91.82264,3,5
0,0,14,14,9,14,23,34,30,64,0.000333,0.096503,8,2316.063722,128.670207,289.507965,81.832294,3,5
0,0,15,15,9,15,24,46,34,80,0.000333,0.122266,8,2934.376,163.020889,366.797,87.132684,3,5
0,0,10,10,8,14,22,26,26,52,0.000333,0.077297,4,927.561777,51.53121,231.890444,77.302969,3,5
0,0,11,11,9,14,23,29,29,58,0.000333,0.087456,8,2098.932748,116.607375,262.366593,81.832294,2,5
0,0,10,10,8,14,22,26,24,50,0.000333,0.074324,4,891.886324,49.54924,222.971581,77.302969,3,5
0,0,29,29,20,47,67,144,95,239,0.000333,0.483265,20,28995.90633,1610.883685,1449.795317,347.504238,10,5
0,0,28,28,19,46,65,140,90,230,0.000333,0.461715,9,12466.30137,692.572298,1385.144597,334.794473,11,5
0,0,28,28,20,47,67,140,90,230,0.000333,0.465067,10,13952.00514,775.111397,1395.200514,347.504238,11,5
0,0,28,28,19,48,67,140,91,231,0.000333,0.467089,9,12611.39943,700.633301,1401.266603,348.788823,11,5
0,0,31,31,19,51,70,155,103,258,0.000333,0.527118,18,28464.39033,1581.355018,1581.355018,370.004315,12,5
0,0,8,8,7,12,19,20,22,42,0.000333,0.059471,3,535.238867,29.735493,178.412956,62.671034,1,5
0,0,32,32,20,50,70,156,104,260,0.000333,0.531205,20,31872.27169,1770.68176,1593.613584,368.631371,11,5
0,0,30,30,19,50,69,152,101,253,0.000333,0.515152,18,27818.22038,1545.456688,1545.456688,362.903432,11,5
0,0,31,31,19,50,69,155,102,257,0.000333,0.523297,18,28258.03414,1569.890785,1569.890785,362.903432,12,5
0,0,11,11,7,15,22,30,61,91,0.000333,0.135269,12,4869.699328,270.538852,405.808277,78.254843,1,5
0,0,11,11,8,16,24,25,44,69,0.000333,0.105454,8,2530.8993,140.605517,316.362413,88,1,5
0,0,10,10,8,14,22,26,26,52,0.000333,0.077297,4,927.561777,51.53121,231.890444,77.302969,3,5
0,0,11,11,10,19,29,31,48,79,0.000333,0.127927,10,3837.804986,213.211388,383.780499,113.929904,1,5
0,0,5,5,8,8,16,16,16,32,0.000333,0.042667,8,1024,56.888889,128,48,1,5
0,0,5,5,8,9,17,16,17,33,0.000333,0.044962,4,539.545095,29.974728,134.886274,52.529325,1,5
0,0,6,6,10,14,24,30,24,54,0.000333,0.082529,5,1237.939875,68.774438,247.587975,86.52225,3,5
0,0,11,11,9,13,22,27,30,57,0.000333,0.084729,8,2033.500818,112.972268,254.187602,76.635041,1,5
0,0,10,10,8,13,21,24,28,52,0.000333,0.076134,8,1827.204048,101.511336,228.400506,72.105716,1,5
0,0,10,10,8,12,20,25,29,54,0.000333,0.077795,8,1867.072937,103.726274,233.384117,67.01955,1,5
0,0,11,11,10,16,26,39,36,75,0.000333,0.117511,10,3525.329789,195.851655,352.532979,97.219281,3,5
0,0,14,14,7,15,22,33,52,85,0.000333,0.126351,9,3411.465188,189.525844,379.051688,78.254843,1,5
0,0,14,14,8,17,25,34,57,91,0.000333,0.140864,12,5071.090959,281.727276,422.590913,93.486868,1,5
0,0,15,15,10,21,31,48,64,112,0.000333,0.184957,15,8323.049801,462.391656,554.869987,125.457947,3,5
0,0,12,12,7,14,21,28,42,70,0.000333,0.102487,9,2767.159976,153.73111,307.46222,72.954453,1,5
0,0,12,12,8,16,24,29,45,74,0.000333,0.113096,8,2714.2978,150.794322,339.287225,88,1,5
0,0,13,13,10,20,30,43,52,95,0.000333,0.155385,10,4661.546066,258.974781,466.154607,119.657843,3,5
0,0,10,10,7,13,20,23,32,55,0.000333,0.079235,6,1426.236271,79.235348,237.706045,67.757201,1,5
0,0,10,10,8,15,23,24,33,57,0.000333,0.085948,8,2062.744252,114.596903,257.843031,82.603359,1,5
0,0,11,11,10,19,29,38,40,78,0.000333,0.126308,10,3789.225176,210.51251,378.922518,113.929904,3,5
0,0,11,11,8,13,21,26,34,60,0.000333,0.087846,8,2108.312363,117.128465,263.539045,72.105716,1,5
0,0,11,11,7,13,20,30,48,78,0.000333,0.11237,9,3033.993523,168.555196,337.110391,67.757201,1,5
0,0,11,11,7,14,21,30,55,85,0.000333,0.124449,9,3360.122828,186.67349,373.346981,72.954453,1,5
0,0,12,12,9,19,28,44,62,106,0.000333,0.16986,12,6114.955461,339.719748,509.579622,109.239948,3,5
0,0,29,29,19,47,66,143,95,238,0.000333,0.479522,18,25894.18441,1438.5658,1438.5658,341.776299,10,5
0,0,5,5,9,10,19,15,18,33,0.000333,0.046727,4,560.726432,31.151468,140.181608,61.748606,1,5
0,0,40,40,23,51,74,145,118,263,0.000333,0.544362,22,35927.89717,1995.994287,1633.086235,393.335617,9,5
0,0,5,5,9,11,20,17,19,36,0.000333,0.051863,4,622.357646,34.575425,155.589411,66.583073,1,5
0,0,27,27,21,48,69,114,96,210,0.000333,0.427597,20,25655.80272,1425.322373,1282.790136,360.316866,7,5
0,0,6,6,7,11,18,15,21,36,0.000333,0.050039,3,450.3519,25.01955,150.1173,57.705232,1,5
0,0,28,28,19,48,67,140,91,231,0.000333,0.467089,9,12611.39943,700.633301,1401.266603,348.788823,11,5
0,0,31,31,19,51,70,155,102,257,0.000333,0.525075,18,28354.06324,1575.225735,1575.225735,370.004315,12,5
0,0,10,10,8,14,22,24,26,50,0.000333,0.074324,4,891.886324,49.54924,222.971581,77.302969,3,5
0,0,11,11,8,14,22,28,35,63,0.000333,0.093648,8,2247.553536,124.864085,280.944192,77.302969,2,5
0,0,13,13,8,16,24,32,45,77,0.000333,0.117681,8,2824.3369,156.907606,353.042113,88,1,5
0,0,10,10,8,14,22,24,26,50,0.000333,0.074324,4,891.886324,49.54924,222.971581,77.302969,3,5
0,0,8,8,8,12,20,19,21,40,0.000333,0.057626,4,691.508495,38.417139,172.877124,67.01955,2,5
0,0,7,7,7,11,18,16,20,36,0.000333,0.050039,3,450.3519,25.01955,150.1173,57.705232,1,5
0,0,8,8,4,11,15,21,39,60,0.000333,0.078138,6,1406.480614,78.137812,234.413436,46.053748,1,5
0,0,8,8,6,11,17,18,31,49,0.000333,0.066762,6,1201.714075,66.761893,200.285679,53.563523,1,5
0,0,10,10,6,12,18,23,41,64,0.000333,0.088958,9,2401.876801,133.4376,266.8752,58.529325,1,5
0,0,3,3,6,9,15,7,10,17,0.000333,0.022139,3,199.25142,11.069523,66.41714,44.0391,1,5
0,0,6,6,6,10,16,13,21,34,0.000333,0.045333,6,816,45.333333,136,48.729056,1,5
0,0,30,30,19,53,72,157,105,262,0.000333,0.53884,9,14548.68315,808.260175,1616.52035,384.290407,11,5
0,0,28,28,19,52,71,148,98,246,0.000333,0.504279,9,13615.54012,756.418896,1512.837791,377.133488,12,5
0,0,28,28,19,54,73,148,99,247,0.000333,0.509629,9,13759.97999,764.443333,1528.886666,391.474548,12,5
0,0,28,28,19,54,73,148,99,247,0.000333,0.509629,9,13759.97999,764.443333,1528.886666,391.474548,12,5
0,0,29,29,20,53,73,152,103,255,0.000333,0.526135,10,15784.05263,876.891813,1578.405263,390.018346,11,5
0,0,29,29,22,54,76,155,105,260,0.000333,0.541487,11,17869.07269,992.72626,1624.461153,408.871421,12,5
0,0,27,27,19,52,71,145,97,242,0.000333,0.49608,9,13394.14923,744.119401,1488.238803,377.133488,11,5
0,0,25,25,20,52,72,126,103,229,0.000333,0.470971,10,14129.12825,784.95157,1412.912825,382.861427,9,5
0,0,22,22,18,49,67,114,84,198,0.000333,0.400362,9,10809.77094,600.54283,1201.08566,350.179432,9,5
0,0,22,22,18,49,67,114,84,198,0.000333,0.400362,9,10809.77094,600.54283,1201.08566,350.179432,9,5
0,0,22,22,18,49,67,114,84,198,0.000333,0.400362,9,10809.77094,600.54283,1201.08566,350.179432,9,5
0,0,22,22,18,46,64,114,81,195,0.000333,0.39,9,10530,585,1170,329.1425,9,5
0,0,35,35,19,56,75,169,145,314,0.000333,0.65195,18,35205.28324,1955.849069,1955.849069,405.922498,11,5
0,0,29,29,20,46,66,143,101,244,0.000333,0.491611,20,29496.6433,1638.702406,1474.832165,340.522412,9,5
0,0,30,30,19,54,73,157,112,269,0.000333,0.555021,18,29971.13051,1665.062806,1665.062806,391.474548,11,5
0,0,31,31,19,55,74,166,116,282,0.000333,0.583689,18,31519.18528,1751.065849,1751.065849,398.685407,11,5
0,0,27,27,19,46,65,136,89,225,0.000333,0.451678,9,12195.29482,677.516379,1355.032758,334.794473,9,5
0,0,31,31,19,54,73,162,116,278,0.000333,0.57359,18,30973.88209,1720.771227,1720.771227,391.474548,11,5
0,0,27,27,19,46,65,135,92,227,0.000333,0.455692,18,24607.39488,1367.077494,1367.077494,334.794473,9,5
0,0,23,23,18,44,62,102,76,178,0.000333,0.353282,9,9538.622489,529.923472,1059.846943,315.273641,9,5
0,0,23,23,19,44,63,102,74,176,0.000333,0.350667,9,9468.011399,526.000633,1052.001267,320.925614,9,5
0,0,23,23,18,42,60,102,74,176,0.000333,0.346538,9,9356.514703,519.806372,1039.612745,301.535982,9,5
0,0,27,27,19,43,62,110,80,190,0.000333,0.377099,9,10181.67569,565.648649,1131.297299,314.040007,9,5
0,0,28,28,20,45,65,122,84,206,0.000333,0.413536,10,12406.0777,689.226539,1240.607769,333.571951,9,5
0,0,6,6,10,12,22,18,19,37,0.000333,0.055,5,824.994849,45.833047,164.99897,76.238831,2,5
0,0,6,6,7,10,17,14,17,31,0.000333,0.042237,3,380.134044,21.118558,126.711348,52.870765,1,5
0,0,7,7,7,12,19,16,17,33,0.000333,0.046727,3,420.544824,23.363601,140.181608,62.671034,3,5
0,0,7,7,7,11,18,16,15,31,0.000333,0.043089,3,387.803025,21.544613,129.267675,57.705232,3,5
0,0,5,5,7,11,18,11,13,24,0.000333,0.033359,3,300.2346,16.6797,100.0782,57.705232,2,5
0,0,7,7,9,10,19,16,15,31,0.000333,0.043895,4,526.743012,29.263501,131.685753,61.748606,2,5
0,0,5,5,7,10,17,11,12,23,0.000333,0.031337,3,282.034936,15.668608,94.011645,52.870765,2,5
0,0,7,7,8,10,18,15,15,30,0.000333,0.041699,4,500.391,27.7995,125.09775,57.219281,2,5
0,0,11,11,9,13,22,34,23,57,0.000333,0.084729,4,1016.750409,56.486134,254.187602,76.635041,3,5
0,0,5,5,7,11,18,11,13,24,0.000333,0.033359,3,300.2346,16.6797,100.0782,57.705232,2,5
0,0,5,5,7,11,18,11,13,24,0.000333,0.033359,3,300.2346,16.6797,100.0782,57.705232,2,5
0,0,5,5,7,10,17,11,12,23,0.000333,0.031337,3,282.034936,15.668608,94.011645,52.870765,2,5
0,0,5,5,7,9,16,11,12,23,0.000333,0.030667,3,276,15.333333,92,48.180809,2,5
0,0,38,38,19,60,79,182,155,337,0.000333,0.708125,18,38238.73402,2124.374112,2124.374112,435.124058,13,5
0,0,32,32,20,50,70,156,111,267,0.000333,0.545506,20,32730.37131,1818.353962,1636.518566,368.631371,11,5
0,0,30,30,19,50,69,148,102,250,0.000333,0.509044,18,27488.36006,1527.131114,1527.131114,362.903432,11,5
0,0,34,34,19,58,77,170,131,301,0.000333,0.628768,18,33953.44948,1886.302749,1886.302749,420.47352,13,5
0,0,36,36,19,59,78,176,143,319,0.000333,0.668348,18,36090.77954,2005.043308,2005.043308,427.786563,13,5
0,0,32,32,20,57,77,165,113,278,0.000333,0.580722,10,17421.66658,967.870366,1742.166658,418.913293,13,5
0,0,32,32,21,50,71,157,105,262,0.000333,0.537078,20,32224.67491,1790.259717,1611.233745,374.431475,11,5
0,0,30,30,19,50,69,149,99,248,0.000333,0.504971,9,13634.22659,757.457033,1514.914065,362.903432,11,5
0,0,10,10,11,13,24,26,36,62,0.000333,0.094756,10,2842.67675,157.926486,284.267675,86.159464,1,5
0,0,2,2,6,6,12,6,9,15,0.000333,0.017925,3,161.323313,8.962406,53.774438,31.01955,1,5
0,0,8,8,10,14,24,22,28,50,0.000333,0.076416,10,2292.48125,127.360069,229.248125,86.52225,1,5
0,0,29,29,19,46,65,143,98,241,0.000333,0.483797,18,26125.03157,1451.390643,1451.390643,334.794473,9,5
0,0,3,3,5,9,14,6,12,18,0.000333,0.022844,2,137.064777,7.61471,68.532389,40.138965,1,5
0,0,27,27,20,48,68,144,97,241,0.000333,0.489026,20,29341.5709,1630.087272,1467.078545,354.516762,11,5
0,0,32,32,21,52,73,158,116,274,0.000333,0.565337,20,33920.23858,1884.457699,1696.011929,388.661531,11,5
0,0,30,30,19,48,67,150,97,247,0.000333,0.499441,18,26969.83254,1498.32403,1498.32403,348.788823,11,5
0,0,30,30,20,48,68,150,97,247,0.000333,0.501201,20,30072.06644,1670.670358,1503.603322,354.516762,11,5
0,0,20,20,18,46,64,104,76,180,0.000333,0.36,9,9720,540,1080,329.1425,8,5
0,0,20,20,18,46,64,104,75,179,0.000333,0.358,9,9666,537,1074,329.1425,8,5
0,0,19,19,18,45,63,101,74,175,0.000333,0.348675,9,9414.21588,523.011993,1046.023987,322.192039,7,5
0,0,20,20,18,45,63,104,75,179,0.000333,0.356644,9,9629.397957,534.966553,1069.933106,322.192039,8,5
0,0,20,20,18,46,64,104,75,179,0.000333,0.358,9,9666,537,1074,329.1425,8,5
0,0,20,20,18,47,65,104,76,180,0.000333,0.361342,9,9756.235857,542.013103,1084.026206,336.124326,8,5
0,0,30,30,20,46,66,144,92,236,0.000333,0.475492,20,28529.54024,1584.974458,1426.477012,340.522412,10,5
0,0,28,28,19,47,66,140,90,230,0.000333,0.463404,9,12511.89583,695.105324,1390.210647,341.776299,10,5
0,0,22,22,20,48,68,113,93,206,0.000333,0.418006,10,12540.17345,696.676303,1254.017345,354.516762,7,5
0,0,32,32,19,52,71,157,105,262,0.000333,0.537078,18,29002.20742,1611.233745,1611.233745,377.133488,11,5
0,0,22,22,18,49,67,114,84,198,0.000333,0.400362,9,10809.77094,600.54283,1201.08566,350.179432,9,5
0,0,31,31,19,49,68,153,99,252,0.000333,0.511347,18,27612.73145,1534.040636,1534.040636,355.831405,12,5
0,0,33,33,20,50,70,157,102,259,0.000333,0.529161,20,31749.68603,1763.871446,1587.484301,368.631371,12,5
0,0,31,31,19,51,70,153,100,253,0.000333,0.516903,9,13956.37743,775.354302,1550.708603,370.004315,12,5
0,0,31,31,19,50,69,153,99,252,0.000333,0.513116,9,13854.13347,769.674082,1539.348163,362.903432,12,5
0,0,31,31,19,50,69,153,99,252,0.000333,0.513116,9,13854.13347,769.674082,1539.348163,362.903432,12,5
0,0,31,31,19,50,69,153,99,252,0.000333,0.513116,9,13854.13347,769.674082,1539.348163,362.903432,12,5
0,0,33,33,21,50,71,158,102,260,0.000333,0.532978,20,31978.68502,1776.593612,1598.934251,374.431475,12,5
0,0,31,31,19,51,70,153,100,253,0.000333,0.516903,9,13956.37743,775.354302,1550.708603,370.004315,12,5
0,0,9,9,8,13,21,28,30,58,0.000333,0.084918,8,2038.035284,113.224182,254.754411,72.105716,1,5
0,0,2,2,4,8,12,6,9,15,0.000333,0.017925,2,107.548875,5.974938,53.774438,32,1,5
0,0,23,23,18,51,69,117,86,203,0.000333,0.413343,9,11160.27418,620.015232,1240.030465,364.352342,10,5
0,0,25,25,20,50,70,122,88,210,0.000333,0.42905,10,12871.49434,715.083019,1287.149434,368.631371,10,5
0,0,23,23,18,50,68,117,85,202,0.000333,0.409889,9,11067.00745,614.833747,1229.667494,357.25146,10,5
0,0,23,23,18,51,69,117,86,203,0.000333,0.413343,9,11160.27418,620.015232,1240.030465,364.352342,10,5
0,0,23,23,18,50,68,117,86,203,0.000333,0.411918,9,11121.79461,617.877478,1235.754957,357.25146,10,5
0,0,23,23,18,50,68,117,85,202,0.000333,0.409889,9,11067.00745,614.833747,1229.667494,357.25146,10,5
0,0,22,22,18,49,67,114,84,198,0.000333,0.400362,9,10809.77094,600.54283,1201.08566,350.179432,9,5
0,0,23,23,18,49,67,117,85,202,0.000333,0.40845,9,11028.15015,612.675008,1225.350016,350.179432,10,5
0,0,17,17,17,43,60,100,73,173,0.000333,0.340631,8,8175.136584,454.174255,1021.892073,302.816253,7,5
0,0,11,11,11,18,29,34,42,76,0.000333,0.123069,10,3692.065556,205.114753,369.206556,113.112398,2,5
0,0,8,8,10,12,22,28,26,54,0.000333,0.08027,10,2408.093074,133.782949,240.809307,76.238831,3,5
0,0,5,5,6,10,16,10,13,23,0.000333,0.030667,3,276,15.333333,92,48.729056,1,5
0,0,24,24,19,50,69,123,91,214,0.000333,0.435741,9,11765.0181,653.612117,1307.224234,362.903432,9,5
0,0,22,22,18,49,67,114,84,198,0.000333,0.400362,9,10809.77094,600.54283,1201.08566,350.179432,9,5
0,0,22,22,18,49,67,114,84,198,0.000333,0.400362,9,10809.77094,600.54283,1201.08566,350.179432,9,5
0,0,24,24,18,50,68,123,90,213,0.000333,0.43221,9,11669.66627,648.314793,1296.629585,357.25146,9,5
0,0,7,7,7,11,18,16,15,31,0.000333,0.043089,3,387.803025,21.544613,129.267675,57.705232,3,5
0,0,7,7,7,11,18,16,15,31,0.000333,0.043089,3,387.803025,21.544613,129.267675,57.705232,3,5
0,0,11,11,8,11,19,24,21,45,0.000333,0.063719,4,764.626952,42.479275,191.156738,62.053748,3,5
0,0,12,12,9,14,23,36,25,61,0.000333,0.091979,4,1103.749117,61.319395,275.937279,81.832294,3,5
0,0,7,7,7,12,19,16,17,33,0.000333,0.046727,3,420.544824,23.363601,140.181608,62.671034,3,5
0,0,21,21,16,48,64,111,80,191,0.000333,0.382,8,9168,509.333333,1146,332.0782,9,5
0,0,7,7,7,12,19,16,15,31,0.000333,0.043895,3,395.057259,21.947625,131.685753,62.671034,3,5
0,0,7,7,7,10,17,16,15,31,0.000333,0.042237,3,380.134044,21.118558,126.711348,52.870765,3,5
0,0,3,3,5,9,14,6,12,18,0.000333,0.022844,2,137.064777,7.61471,68.532389,40.138965,1,5
0,0,28,28,19,47,66,140,90,230,0.000333,0.463404,9,12511.89583,695.105324,1390.210647,341.776299,10,5
0,0,30,30,21,46,67,145,92,237,0.000333,0.479221,20,28753.26276,1597.403487,1437.663138,346.322516,10,5
0,0,28,28,19,47,66,140,90,230,0.000333,0.463404,9,12511.89583,695.105324,1390.210647,341.776299,10,5
0,0,19,19,18,45,63,101,74,175,0.000333,0.348675,9,9414.21588,523.011993,1046.023987,322.192039,7,5
0,0,31,31,19,50,69,153,100,253,0.000333,0.515152,18,27818.22038,1545.456688,1545.456688,362.903432,12,5
0,0,20,20,18,46,64,104,75,179,0.000333,0.358,9,9666,537,1074,329.1425,8,5
0,0,30,30,19,47,66,123,90,213,0.000333,0.429152,9,11587.10353,643.727974,1287.455947,341.776299,11,5
0,0,20,20,19,46,65,104,75,179,0.000333,0.359335,9,9702.034547,539.001919,1078.003839,334.794473,8,5
0,0,20,20,18,46,64,104,75,179,0.000333,0.358,9,9666,537,1074,329.1425,8,5
0,0,19,19,18,45,63,101,74,175,0.000333,0.348675,9,9414.21588,523.011993,1046.023987,322.192039,7,5
0,0,20,20,18,47,65,104,76,180,0.000333,0.361342,9,9756.235857,542.013103,1084.026206,336.124326,8,5
0,0,22,22,20,46,66,109,78,187,0.000333,0.376767,10,11303.017,627.945389,1130.3017,340.522412,8,5
0,0,20,20,18,47,65,104,76,180,0.000333,0.361342,9,9756.235857,542.013103,1084.026206,336.124326,8,5
0,0,20,20,18,47,65,104,76,180,0.000333,0.361342,9,9756.235857,542.013103,1084.026206,336.124326,8,5
0,0,22,22,19,46,65,108,78,186,0.000333,0.373387,9,10081.44372,560.080207,1120.160413,334.794473,8,5
0,0,18,18,16,44,60,98,70,168,0.000333,0.330786,8,7938.86096,441.047831,992.35762,304.214991,7,5
0,0,19,19,18,45,63,101,74,175,0.000333,0.348675,9,9414.21588,523.011993,1046.023987,322.192039,7,5
0,0,20,20,18,45,63,104,75,179,0.000333,0.356644,9,9629.397957,534.966553,1069.933106,322.192039,8,5
0,0,19,19,18,45,63,101,74,175,0.000333,0.348675,9,9414.21588,523.011993,1046.023987,322.192039,7,5
0,0,19,19,18,45,63,101,74,175,0.000333,0.348675,9,9414.21588,523.011993,1046.023987,322.192039,7,5
0,0,31,31,19,50,69,153,99,252,0.000333,0.513116,9,13854.13347,769.674082,1539.348163,362.903432,12,5
0,0,9,9,8,13,21,26,31,57,0.000333,0.083454,8,2002.896745,111.272041,250.362093,72.105716,1,5
0,0,21,21,18,46,64,109,87,196,0.000333,0.392,9,10584,588,1176,329.1425,7,5
0,0,23,23,18,44,62,102,76,178,0.000333,0.353282,9,9538.622489,529.923472,1059.846943,315.273641,9,5
0,0,19,19,18,45,63,101,74,175,0.000333,0.348675,9,9414.21588,523.011993,1046.023987,322.192039,7,5
0,0,33,33,19,53,72,160,106,266,0.000333,0.547067,18,29541.60091,1641.20005,1641.20005,384.290407,13,5
0,0,33,33,19,54,73,160,106,266,0.000333,0.548831,9,14818.43999,823.246666,1646.493333,391.474548,13,5
0,0,33,33,19,53,72,160,105,265,0.000333,0.54501,9,14715.27113,817.515063,1635.030125,384.290407,13,5
0,0,32,32,19,52,71,157,104,261,0.000333,0.535028,18,28891.51197,1605.083998,1605.083998,377.133488,12,5
0,0,35,35,21,53,74,165,108,273,0.000333,0.56506,20,33903.61538,1883.534188,1695.180769,395.81845,13,5
0,0,33,33,19,54,73,160,106,266,0.000333,0.548831,9,14818.43999,823.246666,1646.493333,391.474548,13,5
0,0,31,31,22,50,72,153,101,254,0.000333,0.522387,22,34477.54091,1915.418939,1567.16095,380.300305,11,5
0,0,30,30,19,51,70,147,96,243,0.000333,0.496472,9,13404.74196,744.707887,1489.415773,370.004315,11,5
0,0,30,30,19,51,70,147,96,243,0.000333,0.496472,9,13404.74196,744.707887,1489.415773,370.004315,11,5
0,0,32,32,20,50,70,151,98,249,0.000333,0.50873,10,15261.91471,847.884151,1526.191471,368.631371,11,5
0,0,29,29,19,49,68,144,94,238,0.000333,0.482939,9,13039.34541,724.408078,1448.816156,355.831405,10,5
0,0,30,30,20,50,70,147,95,242,0.000333,0.494429,10,14832.8649,824.04805,1483.28649,368.631371,11,5
0,0,30,30,19,49,68,147,95,242,0.000333,0.491055,9,13258.49407,736.583004,1473.166008,355.831405,11,5
0,0,34,34,19,53,72,163,116,279,0.000333,0.573803,18,30985.36336,1721.409075,1721.409075,384.290407,12,5
0,0,34,34,19,55,74,164,111,275,0.000333,0.5692,18,30736.79416,1707.599676,1707.599676,398.685407,12,5
0,0,35,35,19,53,72,169,112,281,0.000333,0.577916,18,31207.48066,1733.748925,1733.748925,384.290407,12,5
0,0,34,34,19,53,72,163,110,273,0.000333,0.561463,18,30319.01146,1684.389525,1684.389525,384.290407,12,5
0,0,32,32,20,52,72,152,102,254,0.000333,0.522387,10,15671.6095,870.644972,1567.16095,382.861427,14,5
0,0,12,12,12,18,30,43,33,76,0.000333,0.124308,6,2237.542112,124.307895,372.923685,118.0782,2,5
0,0,12,12,12,17,29,43,33,76,0.000333,0.123069,6,2215.239334,123.068852,369.206556,112.506418,2,5
0,0,28,28,19,43,62,131,86,217,0.000333,0.430687,18,23257.09079,1292.060599,1292.060599,314.040007,14,5
0,0,28,28,19,42,61,131,86,217,0.000333,0.42899,18,23165.46004,1286.970002,1286.970002,307.187955,14,5
0,0,32,32,20,51,71,152,102,254,0.000333,0.520679,20,31240.71537,1735.595298,1562.035768,375.732254,14,5
0,0,8,8,12,14,26,34,27,61,0.000333,0.095576,6,1720.360937,95.575608,286.726823,96.322519,1,5
0,0,28,28,19,43,62,131,86,217,0.000333,0.430687,18,23257.09079,1292.060599,1292.060599,314.040007,14,5
0,0,32,32,20,51,71,152,101,253,0.000333,0.518629,10,15558.86021,864.381123,1555.886021,375.732254,14,5
0,0,34,34,21,51,72,156,104,260,0.000333,0.534727,20,32083.61001,1782.422778,1604.1805,381.532358,14,5
0,0,12,12,12,18,30,43,33,76,0.000333,0.124308,6,2237.542112,124.307895,372.923685,118.0782,2,5
0,0,14,14,14,17,31,48,35,83,0.000333,0.137066,14,5756.776113,319.820895,411.198294,122.789837,2,5
0,0,16,16,12,21,33,58,62,120,0.000333,0.201776,12,7263.927532,403.55153,605.327294,135.258216,3,5
0,0,32,32,21,54,75,142,109,251,0.000333,0.521144,20,31268.66983,1737.148324,1563.433491,403.002591,9,5
0,0,11,11,13,19,32,44,33,77,0.000333,0.128333,6,2310,128.333333,385,128.816339,3,5
0,0,31,31,20,54,74,139,107,246,0.000333,0.509175,10,15275.25528,848.625293,1527.525528,397.202487,9,5
0,0,33,33,20,55,75,144,117,261,0.000333,0.541907,20,32514.43356,1806.35742,1625.721678,404.413346,9,5
0,0,11,11,11,16,27,40,31,71,0.000333,0.112532,5,1687.985063,93.776948,337.597013,102.053748,1,5
0,0,32,32,20,55,75,144,110,254,0.000333,0.527373,20,31642.39895,1757.911053,1582.119947,404.413346,9,5
0,0,33,33,20,56,76,152,114,266,0.000333,0.553983,20,33238.97437,1846.609687,1661.948719,411.650438,9,5
0,0,12,12,12,16,28,43,32,75,0.000333,0.120184,12,4326.61943,240.367746,360.551619,107.01955,2,5
0,0,51,51,23,58,81,191,144,335,0.000333,0.70795,22,46724.69452,2595.816362,2123.849751,443.804823,12,5
0,0,28,28,20,48,68,142,92,234,0.000333,0.474822,10,14244.66305,791.370169,1424.466305,354.516762,11,5
0,0,20,20,15,27,42,75,69,144,0.000333,0.258831,14,10870.91192,603.939551,776.493709,186.985321,4,5
0,0,11,11,12,18,30,44,34,78,0.000333,0.127579,6,2296.424799,127.579155,382.737466,118.0782,3,5
0,0,28,28,20,48,68,142,92,234,0.000333,0.474822,10,14244.66305,791.370169,1424.466305,354.516762,11,5
0,0,35,35,20,56,76,149,127,276,0.000333,0.574809,20,34488.55987,1916.031104,1724.427994,411.650438,9,5
0,0,28,28,20,47,67,142,91,233,0.000333,0.471133,10,14133.98781,785.221545,1413.398781,347.504238,11,5
0,0,28,28,20,47,67,142,91,233,0.000333,0.471133,10,14133.98781,785.221545,1413.398781,347.504238,11,5
0,0,30,30,21,47,68,146,94,240,0.000333,0.486997,20,29219.82164,1623.323424,1460.991082,353.304342,11,5
0,0,28,28,20,47,67,142,91,233,0.000333,0.471133,10,14133.98781,785.221545,1413.398781,347.504238,11,5
0,0,28,28,20,47,67,142,91,233,0.000333,0.471133,10,14133.98781,785.221545,1413.398781,347.504238,11,5
0,0,30,30,22,47,69,147,94,241,0.000333,0.490718,22,32387.39667,1799.299815,1472.154394,359.173172,11,5
0,0,28,28,20,48,68,142,92,234,0.000333,0.474822,10,14244.66305,791.370169,1424.466305,354.516762,11,5
0,0,12,12,12,17,29,43,32,75,0.000333,0.12145,6,2186.091448,121.449525,364.348575,112.506418,2,5
0,0,32,32,20,50,70,153,101,254,0.000333,0.518946,20,31136.75773,1729.819874,1556.837886,368.631371,12,5
0,0,10,10,12,18,30,32,28,60,0.000333,0.098138,6,1766.480614,98.137812,294.413436,118.0782,2,5
0,0,13,13,12,19,31,49,35,84,0.000333,0.138717,6,2496.91494,138.717497,416.15249,123.730173,3,5
0,0,53,53,25,61,86,202,150,352,0.000333,0.754015,24,54289.08465,3016.060258,2262.045194,477.871382,14,5
0,0,15,15,12,20,32,55,39,94,0.000333,0.156667,6,2820,156.666667,470,129.458112,5,5
0,0,15,15,12,20,32,55,37,92,0.000333,0.153333,6,2760,153.333333,460,129.458112,5,5
0,0,10,10,14,16,30,44,31,75,0.000333,0.122672,7,2576.117563,143.117642,368.016795,117.302969,3,5
0,0,35,35,23,58,81,158,121,279,0.000333,0.589606,22,38913.99932,2161.888851,1768.818151,443.804823,11,5
0,0,15,15,12,20,32,55,37,92,0.000333,0.153333,6,2760,153.333333,460,129.458112,5,5
0,0,15,15,12,20,32,55,37,92,0.000333,0.153333,6,2760,153.333333,460,129.458112,5,5
0,0,9,9,10,15,25,34,30,64,0.000333,0.099069,10,2972.067961,165.114887,297.206796,91.82264,1,5
0,0,10,10,12,17,29,44,31,75,0.000333,0.12145,6,2186.091448,121.449525,364.348575,112.506418,3,5
0,0,9,9,14,15,29,37,29,66,0.000333,0.106876,7,2244.38722,124.688179,320.626746,111.906328,1,5
0,0,17,17,16,21,37,60,57,117,0.000333,0.203169,16,9752.0967,541.78315,609.506044,156.238666,1,5
0,0,17,17,14,24,38,68,56,124,0.000333,0.216914,14,9110.402163,506.133454,650.743012,163.342069,4,5
0,0,18,18,15,24,39,71,58,129,0.000333,0.227272,14,9545.436407,530.302023,681.816886,168.642459,4,5
0,0,31,31,22,47,69,164,100,264,0.000333,0.53755,22,35478.31005,1971.017225,1612.650457,359.173172,11,5
0,0,31,31,21,49,70,164,101,265,0.000333,0.54142,20,32485.19999,1804.733333,1624.259999,367.359448,11,5
0,0,34,34,19,54,73,151,107,258,0.000333,0.532325,9,14372.77263,798.487368,1596.974736,391.474548,10,5
0,0,9,9,10,15,25,34,30,64,0.000333,0.099069,10,2972.067961,165.114887,297.206796,91.82264,1,5
0,0,15,15,12,19,31,48,52,100,0.000333,0.16514,12,5945.035572,330.279754,495.419631,123.730173,1,5
0,0,8,8,10,14,24,34,27,61,0.000333,0.093228,5,1398.413563,77.689642,279.682713,86.52225,1,5
0,0,14,14,12,18,30,54,46,100,0.000333,0.163563,12,5888.268715,327.12604,490.68906,118.0782,1,5
0,0,13,13,12,17,29,46,42,88,0.000333,0.142501,12,5130.027931,285.001552,427.502328,112.506418,1,5
0,0,15,15,14,18,32,52,40,92,0.000333,0.153333,14,6440,357.777778,460,128.361619,2,5
0,0,15,15,13,18,31,51,46,97,0.000333,0.160186,12,5766.684505,320.371361,480.557042,123.164366,2,5
0,0,13,13,12,17,29,47,37,84,0.000333,0.136023,12,4896.844843,272.046936,408.070404,112.506418,1,5
0,0,14,14,12,20,32,47,42,89,0.000333,0.148333,12,5340,296.666667,445,129.458112,1,5
0,0,13,13,11,17,28,45,41,86,0.000333,0.137811,10,4134.325233,229.684735,413.432523,107.540616,1,5
0,0,14,14,13,17,30,49,39,88,0.000333,0.143935,12,5181.676469,287.870915,431.806372,117.592585,1,5
0,0,10,10,12,18,30,32,28,60,0.000333,0.098138,6,1766.480614,98.137812,294.413436,118.0782,2,5
0,0,32,32,21,47,68,169,102,271,0.000333,0.549901,20,32994.0486,1833.0027,1649.70243,353.304342,11,5
0,0,33,33,20,52,72,145,104,249,0.000333,0.512104,20,30726.22651,1707.012584,1536.311325,382.861427,10,5
0,0,12,12,14,20,34,37,31,68,0.000333,0.115316,7,2421.632312,134.535128,345.947473,139.741531,2,5
0,0,31,31,19,52,71,140,101,241,0.000333,0.49403,9,13338.8015,741.044528,1482.089056,377.133488,10,5
0,0,31,31,18,51,69,140,101,241,0.000333,0.490718,9,13249.38955,736.077197,1472.154394,364.352342,10,5
0,0,10,10,12,18,30,32,29,61,0.000333,0.099773,6,1795.921958,99.773442,299.320326,118.0782,2,5
0,0,10,10,12,19,31,32,29,61,0.000333,0.100735,6,1813.23585,100.735325,302.205975,123.730173,2,5
0,0,10,10,12,18,30,32,28,60,0.000333,0.098138,6,1766.480614,98.137812,294.413436,118.0782,2,5
0,0,31,31,20,51,71,155,101,256,0.000333,0.524778,10,15743.35263,874.630701,1574.335263,375.732254,13,5
0,0,31,31,18,52,70,140,101,241,0.000333,0.492386,9,13294.41486,738.578604,1477.157207,371.481515,10,5
0,0,31,31,18,53,71,140,102,242,0.000333,0.49608,9,13394.14923,744.119401,1488.238803,378.638434,10,5
0,0,31,31,20,52,72,155,102,257,0.000333,0.528557,10,15856.70725,880.928181,1585.670725,382.861427,13,5
0,0,33,33,22,51,73,160,104,264,0.000333,0.544705,22,35950.50104,1997.250058,1634.113684,387.401188,13,5
0,0,31,31,18,53,71,140,102,242,0.000333,0.49608,9,13394.14923,744.119401,1488.238803,378.638434,10,5
0,0,33,33,19,52,71,144,104,248,0.000333,0.508379,18,27452.47114,1525.137286,1525.137286,377.133488,10,5
0,0,33,33,21,51,72,159,104,263,0.000333,0.540897,20,32453.80551,1802.989195,1622.690275,381.532358,13,5
0,0,15,15,13,21,34,55,37,92,0.000333,0.156016,6,2808.279488,156.015527,468.046581,140.344382,5,5
0,0,18,18,13,24,37,60,59,119,0.000333,0.206642,12,7439.099406,413.2833,619.924951,158.144816,3,5
0,0,11,11,12,19,31,43,35,78,0.000333,0.128809,6,2318.563873,128.809104,386.427312,123.730173,3,5
0,0,10,10,12,18,30,43,32,75,0.000333,0.122672,6,2208.100768,122.672265,368.016795,118.0782,3,5
0,0,17,17,13,23,36,66,53,119,0.000333,0.205074,12,7382.652902,410.147383,615.221075,152.147641,3,5
0,0,9,9,11,15,26,35,28,63,0.000333,0.098709,5,1480.638511,82.257695,296.127702,96.657107,1,5
0,0,30,30,18,49,67,134,103,237,0.000333,0.479221,18,25877.93649,1437.663138,1437.663138,350.179432,7,5
0,0,10,10,13,16,29,44,30,74,0.000333,0.11983,6,2156.943562,119.830198,359.490594,112.105716,3,5
0,0,11,11,13,19,32,44,33,77,0.000333,0.128333,6,2310,128.333333,385,128.816339,3,5
0,0,15,15,13,21,34,51,40,91,0.000333,0.15432,6,2777.754711,154.319706,462.959119,140.344382,2,5
0,0,18,18,14,27,41,70,60,130,0.000333,0.232161,14,9750.744648,541.708036,696.481761,181.684931,5,5
0,0,17,17,14,26,40,66,53,119,0.000333,0.211103,14,8866.332206,492.574011,633.309443,175.514402,4,5
0,0,17,17,15,26,41,69,53,122,0.000333,0.217874,14,9150.698824,508.372157,653.621345,180.814792,4,5
0,0,18,18,15,29,44,69,58,127,0.000333,0.231116,14,9706.869418,539.270523,693.347816,199.484808,4,5
0,0,17,17,15,26,41,68,53,121,0.000333,0.216088,14,9075.693096,504.205172,648.263793,180.814792,4,5
0,0,31,31,20,50,70,149,100,249,0.000333,0.50873,20,30523.82942,1695.768301,1526.191471,368.631371,13,5
0,0,12,12,13,20,33,36,31,67,0.000333,0.112658,6,2027.846436,112.658135,337.974406,134.544278,2,5
0,0,31,31,18,53,71,140,102,242,0.000333,0.49608,9,13394.14923,744.119401,1488.238803,378.638434,10,5
0,0,18,18,15,25,40,73,59,132,0.000333,0.234165,14,9834.923119,546.384618,702.494509,174.699764,4,5
0,0,32,32,20,51,71,152,101,253,0.000333,0.518629,10,15558.86021,864.381123,1555.886021,375.732254,14,5
0,0,34,34,21,51,72,156,104,260,0.000333,0.534727,20,32083.61001,1782.422778,1604.1805,381.532358,14,5
0,0,54,54,21,52,73,272,181,453,0.000333,0.934664,30,84119.71576,4673.317542,2803.990525,388.661531,22,5
0,0,48,48,21,52,73,228,146,374,0.000333,0.771665,20,46299.8877,2572.215983,2314.994385,388.661531,19,5
0,0,32,32,20,52,72,152,102,254,0.000333,0.522387,10,15671.6095,870.644972,1567.16095,382.861427,14,5
0,0,32,32,20,52,72,152,102,254,0.000333,0.522387,10,15671.6095,870.644972,1567.16095,382.861427,14,5
0,0,32,32,21,51,72,152,101,253,0.000333,0.52033,10,15609.91025,867.217236,1560.991025,381.532358,14,5
0,0,33,33,23,51,74,158,107,265,0.000333,0.548502,22,36201.11312,2011.172951,1645.505142,393.335617,14,5
0,0,31,31,20,50,70,149,100,249,0.000333,0.50873,20,30523.82942,1695.768301,1526.191471,368.631371,13,5
0,0,8,8,10,14,24,34,27,61,0.000333,0.093228,5,1398.413563,77.689642,279.682713,86.52225,1,5
0,0,19,19,14,25,39,73,66,139,0.000333,0.24489,14,10285.39272,571.410707,734.670908,169.399374,4,5
0,0,32,32,20,52,72,152,102,254,0.000333,0.522387,10,15671.6095,870.644972,1567.16095,382.861427,14,5
0,0,32,32,20,51,71,152,101,253,0.000333,0.518629,10,15558.86021,864.381123,1555.886021,375.732254,14,5
0,0,31,31,20,53,73,141,100,241,0.000333,0.497249,10,14917.47719,828.748733,1491.747719,390.018346,11,5
0,0,32,32,20,52,72,152,102,254,0.000333,0.522387,10,15671.6095,870.644972,1567.16095,382.861427,14,5
0,0,32,32,20,51,71,152,101,253,0.000333,0.518629,10,15558.86021,864.381123,1555.886021,375.732254,14,5
0,0,32,32,20,51,71,152,101,253,0.000333,0.518629,10,15558.86021,864.381123,1555.886021,375.732254,14,5
0,0,9,9,14,16,30,39,30,69,0.000333,0.112858,7,2370.028158,131.668231,338.575451,117.302969,1,5
0,0,15,15,15,21,36,53,48,101,0.000333,0.174054,14,7310.273952,406.126331,522.162425,150.842025,1,5
0,0,9,9,14,15,29,37,29,66,0.000333,0.106876,7,2244.38722,124.688179,320.626746,111.906328,1,5
0,0,28,28,19,42,61,131,86,217,0.000333,0.42899,18,23165.46004,1286.970002,1286.970002,307.187955,14,5
0,0,16,16,12,20,32,59,61,120,0.000333,0.2,18,10800,600,600,129.458112,3,5
0,0,21,21,14,26,40,78,76,154,0.000333,0.273192,14,11474.07697,637.448721,819.576927,175.514402,4,5
0,0,33,33,19,54,73,161,106,267,0.000333,0.550894,9,14874.14842,826.341579,1652.683157,391.474548,13,5
0,0,34,34,19,53,72,164,110,274,0.000333,0.56352,18,30430.07011,1690.55945,1690.55945,384.290407,12,5
0,0,29,29,22,43,65,137,92,229,0.000333,0.459707,22,30340.68904,1685.593836,1379.122229,331.43688,14,5
0,0,36,36,18,54,72,152,130,282,0.000333,0.579973,18,31318.53931,1739.91885,1739.91885,385.822575,9,5
0,0,16,16,12,20,32,59,61,120,0.000333,0.2,18,10800,600,600,129.458112,3,5
0,0,36,36,20,56,76,158,126,284,0.000333,0.59147,20,35488.22828,1971.568238,1774.411414,411.650438,11,5
0,0,34,34,20,55,75,153,116,269,0.000333,0.558517,20,33511.04456,1861.724697,1675.552228,404.413346,11,5
0,0,11,11,13,18,31,45,32,77,0.000333,0.127158,6,2288.838695,127.157705,381.473116,123.164366,3,5
0,0,34,34,21,55,76,154,112,266,0.000333,0.553983,20,33238.97437,1846.609687,1661.948719,410.21345,11,5
0,0,35,35,20,58,78,155,117,272,0.000333,0.569876,20,34192.58807,1899.588226,1709.629404,426.20146,11,5
0,0,32,32,20,51,71,152,101,253,0.000333,0.518629,10,15558.86021,864.381123,1555.886021,375.732254,14,5
0,0,34,34,21,51,72,156,104,260,0.000333,0.534727,20,32083.61001,1782.422778,1604.1805,381.532358,14,5
0,0,28,28,19,43,62,131,86,217,0.000333,0.430687,18,23257.09079,1292.060599,1292.060599,314.040007,14,5
0,0,32,32,20,52,72,152,102,254,0.000333,0.522387,10,15671.6095,870.644972,1567.16095,382.861427,14,5
0,0,32,32,21,51,72,152,101,253,0.000333,0.52033,10,15609.91025,867.217236,1560.991025,381.532358,14,5
0,0,54,54,21,52,73,272,181,453,0.000333,0.934664,30,84119.71576,4673.317542,2803.990525,388.661531,22,5
0,0,48,48,21,52,73,228,146,374,0.000333,0.771665,20,46299.8877,2572.215983,2314.994385,388.661531,19,5
0,0,32,32,20,52,72,152,102,254,0.000333,0.522387,10,15671.6095,870.644972,1567.16095,382.861427,14,5
0,0,50,50,18,83,101,278,211,489,0.000333,1.085288,18,58605.57747,3255.865415,3255.865415,604.186923,25,5
0,0,53,53,19,85,104,288,217,505,0.000333,1.127907,18,60906.99704,3383.722058,3383.722058,625.508852,26,5
0,0,52,52,19,84,103,285,215,500,0.000333,1.114417,18,60178.50475,3343.250264,3343.250264,617.665286,26,5
0,0,32,32,20,50,70,152,101,253,0.000333,0.516903,20,31014.17207,1723.009559,1550.708603,368.631371,14,5
0,0,48,48,15,81,96,269,204,473,0.000333,1.038229,14,43605.62168,2422.534538,3114.687263,572.131209,24,5
0,0,51,51,16,83,99,279,210,489,0.000333,1.080585,16,51868.0862,2881.560344,3241.755387,593.128273,25,5
0,0,50,50,16,82,98,276,208,484,0.000333,1.067173,16,51224.31303,2845.795168,3201.519565,585.319264,25,5
0,0,49,49,15,83,98,272,206,478,0.000333,1.053944,14,44265.63828,2459.202126,3161.831305,587.731632,25,5
0,0,52,52,16,85,101,282,212,494,0.000333,1.096385,16,52626.50356,2923.694642,3289.156472,608.79823,26,5
0,0,51,51,16,84,100,279,210,489,0.000333,1.082949,16,51981.53083,2887.862824,3248.845677,600.954664,26,5
0,0,51,51,16,83,99,276,208,484,0.000333,1.069536,16,51337.73767,2852.096537,3208.608604,593.128273,25,5
0,0,54,54,17,85,102,286,214,500,0.000333,1.112071,16,53379.40274,2965.522374,3336.212671,614.285098,26,5
0,0,53,53,17,84,101,283,212,495,0.000333,1.098605,16,52733.03494,2929.613052,3295.814684,606.441532,26,5
0,0,49,49,16,82,98,272,205,477,0.000333,1.051739,16,50483.46553,2804.636974,3155.216596,585.319264,25,5
0,0,52,52,17,84,101,282,211,493,0.000333,1.094166,16,52519.97218,2917.776232,3282.498261,606.441532,26,5
0,0,51,51,17,83,100,279,209,488,0.000333,1.080734,16,51875.22913,2881.957174,3242.201821,598.615141,26,5
0,0,30,30,20,50,70,152,100,252,0.000333,0.51486,20,30891.58641,1716.199245,1544.57932,368.631371,12,5
0,0,31,31,21,51,72,155,101,256,0.000333,0.5265,10,15795.008,877.500445,1579.5008,381.532358,13,5
0,0,31,31,20,52,72,155,102,257,0.000333,0.528557,10,15856.70725,880.928181,1585.670725,382.861427,13,5
0,0,32,32,23,51,74,161,107,268,0.000333,0.554711,22,36610.93704,2033.940947,1664.133502,393.335617,13,5
0,0,31,31,20,50,70,155,101,256,0.000333,0.523032,20,31381.92905,1743.440503,1569.096452,368.631371,13,5
0,0,14,14,10,17,27,49,57,106,0.000333,0.168006,15,7560.271128,420.015063,504.018075,102.706149,1,5
0,0,32,32,20,57,77,141,108,249,0.000333,0.520143,10,15604.29849,866.905471,1560.429849,418.913293,9,5
0,0,32,32,22,54,76,143,105,248,0.000333,0.516495,11,17044.34626,946.908125,1549.486023,408.871421,9,5
0,0,33,33,19,52,71,145,112,257,0.000333,0.526828,18,28448.73018,1580.48501,1580.48501,377.133488,9,5
0,0,34,34,20,56,76,154,110,264,0.000333,0.549818,10,16494.52864,916.362702,1649.452864,411.650438,13,5
0,0,34,34,20,56,76,154,110,264,0.000333,0.549818,10,16494.52864,916.362702,1649.452864,411.650438,13,5
0,0,28,28,20,46,66,142,91,233,0.000333,0.469448,10,14083.4383,782.413239,1408.34383,340.522412,11,5
0,0,38,38,22,55,77,164,114,278,0.000333,0.580722,22,38327.66648,2129.314805,1742.166658,416.08228,13,5
0,0,31,31,20,53,73,141,100,241,0.000333,0.497249,10,14917.47719,828.748733,1491.747719,390.018346,11,5
0,0,32,32,23,57,80,144,112,256,0.000333,0.539471,11,17802.54952,989.030529,1618.413592,436.516656,9,5
0,0,31,31,20,52,72,141,98,239,0.000333,0.491537,10,14746.12075,819.228931,1474.612075,382.861427,11,5
0,0,31,31,20,52,72,141,98,239,0.000333,0.491537,10,14746.12075,819.228931,1474.612075,382.861427,11,5
0,0,31,31,20,52,72,141,100,241,0.000333,0.495651,10,14869.51925,826.084403,1486.951925,382.861427,11,5
0,0,29,29,20,51,71,135,96,231,0.000333,0.473531,10,14205.91585,789.217547,1420.591585,375.732254,9,5
0,0,34,34,20,55,75,154,108,262,0.000333,0.543983,10,16319.50497,906.639165,1631.950497,404.413346,13,5
0,0,32,32,18,52,70,142,110,252,0.000333,0.51486,18,27802.42777,1544.57932,1544.57932,371.481515,9,5
0,0,16,16,12,21,33,58,62,120,0.000333,0.201776,12,7263.927532,403.55153,605.327294,135.258216,3,5
0,0,19,19,12,23,35,63,66,129,0.000333,0.220559,12,7940.13011,441.118339,661.677509,147.061475,3,5
0,0,16,16,14,21,35,57,44,101,0.000333,0.172686,14,7252.806186,402.933677,518.057585,145.541635,3,5
0,0,11,11,13,19,32,44,33,77,0.000333,0.128333,6,2310,128.333333,385,128.816339,3,5
0,0,30,30,19,48,67,132,102,234,0.000333,0.473155,18,25550.36767,1419.464871,1419.464871,348.788823,7,5
0,0,14,14,10,17,27,49,57,106,0.000333,0.168006,15,7560.271128,420.015063,504.018075,102.706149,1,5
0,0,17,17,12,22,34,58,56,114,0.000333,0.193324,12,6959.649167,386.647176,579.970764,141.127046,3,5
0,0,16,16,12,20,32,59,61,120,0.000333,0.2,18,10800,600,600,129.458112,3,5
0,0,18,18,12,21,33,60,63,123,0.000333,0.20682,18,11168.28858,620.460477,620.460477,135.258216,3,5
0,0,17,17,14,22,36,63,53,116,0.000333,0.199904,14,8395.958202,466.442122,599.7113,151.410465,3,5
0,0,10,10,12,17,29,44,31,75,0.000333,0.12145,6,2186.091448,121.449525,364.348575,112.506418,3,5
0,0,16,16,13,21,34,63,50,113,0.000333,0.191628,12,6898.599613,383.255534,574.883301,140.344382,3,5
0,0,15,15,13,20,33,55,46,101,0.000333,0.169828,12,6113.805673,339.655871,509.483806,134.544278,3,5
0,0,17,17,13,22,35,57,56,113,0.000333,0.193203,12,6955.307771,386.405987,579.608981,146.213212,3,5
0,0,16,16,13,21,34,56,48,104,0.000333,0.176365,12,6349.153626,352.730757,529.096135,140.344382,3,5
0,0,16,16,14,23,37,55,49,104,0.000333,0.180594,14,7584.9641,421.386894,541.78315,157.344894,3,5
0,0,34,34,18,53,71,147,120,267,0.000333,0.547327,18,29555.68466,1641.982481,1641.982481,378.638434,9,5
0,0,31,31,19,52,71,152,101,253,0.000333,0.518629,9,14002.97419,777.943011,1555.886021,377.133488,10,5
0,0,31,31,19,50,69,151,104,255,0.000333,0.519225,18,28038.12726,1557.673736,1557.673736,362.903432,10,5
0,0,30,30,20,50,70,152,100,252,0.000333,0.51486,20,30891.58641,1716.199245,1544.57932,368.631371,12,5
0,0,9,9,14,15,29,37,29,66,0.000333,0.106876,7,2244.38722,124.688179,320.626746,111.906328,1,5
0,0,9,9,11,15,26,35,28,63,0.000333,0.098709,5,1480.638511,82.257695,296.127702,96.657107,1,5
0,0,34,34,20,55,75,154,108,262,0.000333,0.543983,10,16319.50497,906.639165,1631.950497,404.413346,13,5
0,0,28,28,20,47,67,142,92,234,0.000333,0.473155,10,14194.64871,788.591595,1419.464871,347.504238,11,5
0,0,18,18,16,23,39,62,59,121,0.000333,0.213178,16,10232.5387,568.474372,639.533668,168.041925,3,5
0,0,10,10,14,17,31,43,32,75,0.000333,0.123855,7,2600.953063,144.497392,371.564723,122.789837,3,5
0,0,16,16,15,24,39,58,51,109,0.000333,0.192036,14,8065.523786,448.084655,576.108842,168.642459,3,5
0,0,32,32,20,50,70,152,98,250,0.000333,0.510774,10,15323.20754,851.289308,1532.320754,368.631371,11,5
0,0,30,30,19,50,69,148,95,243,0.000333,0.49479,9,13359.34299,742.185721,1484.371443,362.903432,11,5
0,0,32,32,21,50,71,153,98,251,0.000333,0.514529,10,15435.86527,857.548071,1543.586527,374.431475,11,5
0,0,32,32,21,51,72,158,102,260,0.000333,0.534727,20,32083.61001,1782.422778,1604.1805,381.532358,12,5
0,0,16,16,11,20,31,58,51,109,0.000333,0.180002,10,5400.073978,300.00411,540.007398,124.49231,1,5
0,0,27,27,18,47,65,124,90,214,0.000333,0.429596,9,11599.08041,644.393356,1288.786712,336.124326,7,5
0,0,28,28,18,47,65,127,91,218,0.000333,0.437625,9,11815.88565,656.438092,1312.876183,336.124326,8,5
0,0,28,28,18,48,66,127,92,219,0.000333,0.441241,9,11913.50081,661.861156,1323.722312,343.13685,8,5
0,0,28,28,18,48,66,127,91,218,0.000333,0.439226,9,11859.10126,658.838959,1317.677918,343.13685,8,5
0,0,28,28,18,48,66,127,91,218,0.000333,0.439226,9,11859.10126,658.838959,1317.677918,343.13685,8,5
0,0,28,28,18,49,67,127,92,219,0.000333,0.442825,9,11956.26179,664.236766,1328.473533,350.179432,8,5
0,0,28,28,18,49,67,127,92,219,0.000333,0.442825,9,11956.26179,664.236766,1328.473533,350.179432,8,5
0,0,30,30,20,48,68,132,94,226,0.000333,0.458589,10,13757.66602,764.314779,1375.766602,354.516762,8,5
0,0,18,18,15,27,42,72,60,132,0.000333,0.237262,14,9965.002597,553.611255,711.7859,186.985321,4,5
0,0,19,19,15,28,43,80,64,144,0.000333,0.260461,14,10939.34975,607.741653,781.382125,193.209297,4,5
0,0,18,18,15,26,41,70,59,129,0.000333,0.230375,14,9675.73892,537.541051,691.124209,180.814792,4,5
0,0,16,16,12,21,33,58,62,120,0.000333,0.201776,12,7263.927532,403.55153,605.327294,135.258216,3,5
0,0,17,17,14,26,40,67,57,124,0.000333,0.219973,14,9238.867173,513.270398,659.919084,175.514402,4,5
0,0,10,10,12,18,30,43,32,75,0.000333,0.122672,6,2208.100768,122.672265,368.016795,118.0782,3,5
0,0,20,20,14,29,43,80,67,147,0.000333,0.265887,14,11167.25287,620.402937,797.660919,194.184418,4,5
0,0,37,37,20,59,79,165,127,292,0.000333,0.613568,20,36814.07957,2045.226643,1840.703978,433.514502,11,5
0,0,11,11,12,19,31,43,35,78,0.000333,0.128809,6,2318.563873,128.809104,386.427312,123.730173,3,5
0,0,15,15,13,20,33,54,40,94,0.000333,0.158058,12,5690.076567,316.115365,474.173047,134.544278,4,5
0,0,13,13,13,19,32,48,34,82,0.000333,0.136667,6,2460,136.666667,410,128.816339,4,5
0,0,14,14,15,22,37,55,41,96,0.000333,0.166703,7,3500.752662,194.486259,500.107523,156.710855,4,5
0,0,13,13,13,19,32,48,34,82,0.000333,0.136667,6,2460,136.666667,410,128.816339,4,5
0,0,25,25,13,23,36,94,60,154,0.000333,0.265389,12,9554.021403,530.778967,796.16845,152.147641,6,5
0,0,13,13,12,20,32,48,35,83,0.000333,0.138333,6,2490,138.333333,415,129.458112,4,5
0,0,15,15,12,20,32,53,46,99,0.000333,0.165,12,5940,330,495,129.458112,4,5
0,0,14,14,12,19,31,49,39,88,0.000333,0.145323,12,5231.631304,290.646184,435.969275,123.730173,3,5
0,0,17,17,15,24,39,64,49,113,0.000333,0.199083,14,8361.50631,464.528128,597.250451,168.642459,3,5
0,0,17,17,14,24,38,63,55,118,0.000333,0.206418,14,8669.576252,481.643125,619.255447,163.342069,3,5
0,0,14,14,13,24,37,55,42,97,0.000333,0.168439,6,3031.901859,168.438992,505.316976,158.144816,3,5
0,0,14,14,13,24,37,55,42,97,0.000333,0.168439,6,3031.901859,168.438992,505.316976,158.144816,3,5
0,0,16,16,14,23,37,59,44,103,0.000333,0.178858,7,3756.015877,208.667549,536.573697,157.344894,3,5
0,0,15,15,16,22,38,61,47,108,0.000333,0.188925,16,9068.418743,503.801041,566.776171,162.107496,3,5
0,0,13,13,13,22,35,52,40,92,0.000333,0.157298,6,2831.364225,157.298013,471.894038,146.213212,2,5
0,0,14,14,14,23,37,55,41,96,0.000333,0.166703,7,3500.752662,194.486259,500.107523,157.344894,3,5
0,0,14,14,14,22,36,55,41,96,0.000333,0.165438,7,3474.189601,193.010533,496.3128,151.410465,3,5
0,0,13,13,12,20,32,47,35,82,0.000333,0.136667,6,2460,136.666667,410,129.458112,4,5
0,0,13,13,12,20,32,47,36,83,0.000333,0.138333,6,2490,138.333333,415,129.458112,4,5
0,0,13,13,12,20,32,47,35,82,0.000333,0.136667,6,2460,136.666667,410,129.458112,4,5
0,0,13,13,12,20,32,47,35,82,0.000333,0.136667,6,2460,136.666667,410,129.458112,4,5
0,0,15,15,14,22,36,52,38,90,0.000333,0.155098,7,3257.052751,180.947375,465.29325,151.410465,4,5
0,0,13,13,12,20,32,47,35,82,0.000333,0.136667,6,2460,136.666667,410,129.458112,4,5
0,0,15,15,13,22,35,51,38,89,0.000333,0.152169,6,2739.037131,152.16873,456.506189,146.213212,4,5
0,0,10,10,11,16,27,34,29,63,0.000333,0.099853,5,1497.789563,83.210531,299.557913,102.053748,1,5
0,0,11,11,12,18,30,37,31,68,0.000333,0.111223,6,2002.011363,111.222854,333.668561,118.0782,2,5
0,0,11,11,12,17,29,37,30,67,0.000333,0.108495,6,1952.90836,108.494909,325.484727,112.506418,2,5
0,0,15,15,12,21,33,54,38,92,0.000333,0.154695,6,2784.505554,154.694753,464.084259,135.258216,5,5
0,0,19,19,14,23,37,64,44,108,0.000333,0.18754,7,3938.346744,218.797041,562.620963,157.344894,5,5
0,0,15,15,12,22,34,54,40,94,0.000333,0.159407,6,2869.329042,159.407169,478.221507,141.127046,5,5
0,0,15,15,12,22,34,54,40,94,0.000333,0.159407,6,2869.329042,159.407169,478.221507,141.127046,5,5
0,0,26,26,13,24,37,96,64,160,0.000333,0.277838,12,10002.15046,555.675026,833.512539,158.144816,6,5
0,0,19,19,13,23,36,62,44,106,0.000333,0.182671,6,3288.072301,182.670683,548.01205,152.147641,5,5
0,0,15,15,12,21,33,54,38,92,0.000333,0.154695,6,2784.505554,154.694753,464.084259,135.258216,5,5
0,0,15,15,12,22,34,54,40,94,0.000333,0.159407,6,2869.329042,159.407169,478.221507,141.127046,5,5
0,0,17,17,14,26,40,66,47,113,0.000333,0.200459,7,4209.645123,233.869174,601.377875,175.514402,3,5
0,0,32,32,20,52,72,152,102,254,0.000333,0.522387,10,15671.6095,870.644972,1567.16095,382.861427,14,5
0,0,32,32,20,51,71,152,101,253,0.000333,0.518629,10,15558.86021,864.381123,1555.886021,375.732254,14,5
0,0,34,34,21,51,72,156,104,260,0.000333,0.534727,20,32083.61001,1782.422778,1604.1805,381.532358,14,5
0,0,54,54,21,52,73,272,181,453,0.000333,0.934664,30,84119.71576,4673.317542,2803.990525,388.661531,22,5
0,0,48,48,21,52,73,228,146,374,0.000333,0.771665,20,46299.8877,2572.215983,2314.994385,388.661531,19,5
0,0,32,32,20,52,72,152,102,254,0.000333,0.522387,10,15671.6095,870.644972,1567.16095,382.861427,14,5
0,0,34,34,22,51,73,157,104,261,0.000333,0.538515,22,35541.97262,1974.554034,1615.54421,387.401188,14,5
0,0,32,32,21,51,72,152,101,253,0.000333,0.52033,10,15609.91025,867.217236,1560.991025,381.532358,14,5
0,0,11,11,12,17,29,37,30,67,0.000333,0.108495,6,1952.90836,108.494909,325.484727,112.506418,2,5
0,0,11,11,12,17,29,37,30,67,0.000333,0.108495,6,1952.90836,108.494909,325.484727,112.506418,2,5
0,0,13,13,12,21,33,47,36,83,0.000333,0.139562,6,2512.108271,139.561571,418.684712,135.258216,4,5
0,0,9,9,10,15,25,34,30,64,0.000333,0.099069,10,2972.067961,165.114887,297.206796,91.82264,1,5
0,0,14,14,12,20,32,49,44,93,0.000333,0.155,12,5580,310,465,129.458112,3,5
0,0,8,8,12,15,27,36,28,64,0.000333,0.101438,6,1825.876801,101.4376,304.3128,101.622909,1,5
0,0,14,14,14,20,34,50,46,96,0.000333,0.162799,14,6837.550059,379.863892,488.396433,139.741531,1,5
0,0,15,15,13,23,36,51,45,96,0.000333,0.165438,6,2977.876801,165.4376,496.3128,152.147641,3,5
0,0,8,8,12,14,26,34,27,61,0.000333,0.095576,6,1720.360937,95.575608,286.726823,96.322519,1,5
0,0,10,10,13,16,29,44,30,74,0.000333,0.11983,6,2156.943562,119.830198,359.490594,112.105716,3,5
0,0,15,15,14,20,34,53,42,95,0.000333,0.161103,14,6766.325579,375.906977,483.30897,139.741531,3,5
0,0,11,11,12,17,29,37,30,67,0.000333,0.108495,6,1952.90836,108.494909,325.484727,112.506418,2,5
0,0,11,11,12,17,29,37,31,68,0.000333,0.110114,6,1982.056246,110.114236,330.342708,112.506418,2,5
0,0,32,32,20,51,71,152,101,253,0.000333,0.518629,10,15558.86021,864.381123,1555.886021,375.732254,14,5
0,0,14,14,13,20,33,50,40,90,0.000333,0.151332,12,5447.945649,302.663647,453.995471,134.544278,3,5
0,0,11,11,12,18,30,37,31,68,0.000333,0.111223,6,2002.011363,111.222854,333.668561,118.0782,2,5
0,0,36,36,20,59,79,165,124,289,0.000333,0.607264,20,36435.85272,2024.21404,1821.792636,433.514502,11,5
0,0,35,35,20,58,78,157,120,277,0.000333,0.580352,20,34821.12829,1934.507127,1741.056415,426.20146,11,5
0,0,36,36,21,57,78,172,114,286,0.000333,0.599208,20,35952.50069,1997.36115,1797.625035,424.713397,14,5
0,0,56,56,21,58,79,285,190,475,0.000333,0.998099,30,89828.87566,4990.493092,2994.295855,432.001564,22,5
0,0,50,50,21,58,79,241,155,396,0.000333,0.832099,20,49925.94353,2773.663529,2496.297176,432.001564,19,5
0,0,34,34,20,57,77,168,111,279,0.000333,0.582811,10,17484.33445,971.351914,1748.433445,418.913293,14,5
0,0,34,34,21,57,78,168,111,279,0.000333,0.584542,10,17536.27219,974.237344,1753.627219,424.713397,14,5
0,0,34,34,20,56,76,168,111,279,0.000333,0.581057,10,17431.71776,968.428765,1743.171776,411.650438,14,5
0,0,34,34,20,58,78,168,112,280,0.000333,0.586638,10,17599.12621,977.729234,1759.912621,426.20146,14,5
0,0,33,33,20,56,76,165,110,275,0.000333,0.572727,10,17181.80066,954.544481,1718.180066,411.650438,13,5
0,0,16,16,12,21,33,54,54,108,0.000333,0.181598,12,6537.534779,363.196377,544.794565,135.258216,3,5
0,0,29,29,18,48,66,129,100,229,0.000333,0.461389,18,24914.99256,1384.166253,1384.166253,343.13685,7,5
0,0,30,30,20,48,68,133,98,231,0.000333,0.468735,20,28124.07833,1562.448796,1406.203916,354.516762,7,5
0,0,30,30,18,51,69,131,101,232,0.000333,0.472393,9,12754.59907,708.588837,1417.177674,364.352342,7,5
0,0,29,29,18,48,66,128,96,224,0.000333,0.451315,18,24370.99709,1353.944283,1353.944283,343.13685,7,5
0,0,31,31,20,49,69,136,99,235,0.000333,0.478501,20,28710.06495,1595.003608,1435.503247,361.559344,8,5
0,0,31,31,19,49,68,135,105,240,0.000333,0.486997,18,26297.83947,1460.991082,1460.991082,355.831405,8,5
0,0,13,13,12,20,32,48,35,83,0.000333,0.138333,6,2490,138.333333,415,129.458112,4,5
0,0,14,14,13,20,33,51,40,91,0.000333,0.153013,12,5508.478378,306.026577,459.039865,134.544278,3,5
0,0,29,29,20,47,67,145,96,241,0.000333,0.487309,20,29238.5499,1624.363883,1461.927495,347.504238,10,5
0,0,28,28,21,47,68,142,91,233,0.000333,0.472793,10,14183.78842,787.988246,1418.378842,353.304342,11,5
0,0,28,28,20,48,68,142,92,234,0.000333,0.474822,10,14244.66305,791.370169,1424.466305,354.516762,11,5
0,0,15,15,12,22,34,54,40,94,0.000333,0.159407,6,2869.329042,159.407169,478.221507,141.127046,5,5
0,0,11,11,13,19,32,44,33,77,0.000333,0.128333,6,2310,128.333333,385,128.816339,3,5
0,0,34,34,20,57,77,168,111,279,0.000333,0.582811,10,17484.33445,971.351914,1748.433445,418.913293,14,5
0,0,30,30,19,49,68,148,95,243,0.000333,0.493084,9,13313.28123,739.626735,1479.25347,355.831405,11,5
0,0,30,30,19,50,69,148,96,244,0.000333,0.496827,9,13414.31971,745.239984,1490.479967,362.903432,11,5
0,0,30,30,19,50,69,148,95,243,0.000333,0.49479,9,13359.34299,742.185721,1484.371443,362.903432,11,5
0,0,30,30,19,51,70,148,96,244,0.000333,0.498515,9,13459.90551,747.772528,1495.545056,370.004315,11,5
0,0,30,30,19,51,70,148,96,244,0.000333,0.498515,9,13459.90551,747.772528,1495.545056,370.004315,11,5
0,0,30,30,19,50,69,148,95,243,0.000333,0.49479,9,13359.34299,742.185721,1484.371443,362.903432,11,5
0,0,32,32,18,50,68,142,110,252,0.000333,0.511347,18,27612.73145,1534.040636,1534.040636,357.25146,7,5
0,0,13,13,16,17,33,49,40,89,0.000333,0.14965,16,7183.217226,399.067624,448.951077,133.486868,2,5
0,0,15,15,15,19,34,51,48,99,0.000333,0.167886,14,7051.223498,391.734639,503.658821,139.313982,2,5
0,0,12,12,14,17,31,43,34,77,0.000333,0.127158,14,5340.623623,296.701312,381.473116,122.789837,2,5
0,0,12,12,14,19,33,43,35,78,0.000333,0.131154,7,2754.239189,153.013288,393.462741,134.013592,2,5
0,0,43,43,23,54,77,165,127,292,0.000333,0.609967,22,40257.83674,2236.546485,1829.90167,414.80585,9,5
0,0,13,13,13,18,31,44,39,83,0.000333,0.137066,12,4934.379525,274.132196,411.198294,123.164366,1,5
0,0,16,16,13,23,36,56,46,102,0.000333,0.175777,12,6327.988202,351.5549,527.33235,152.147641,3,5
0,0,16,16,13,21,34,58,42,100,0.000333,0.169582,12,6104.95541,339.164189,508.746284,140.344382,4,5
0,0,13,13,12,19,31,49,35,84,0.000333,0.138717,6,2496.91494,138.717497,416.15249,123.730173,3,5
0,0,15,15,13,20,33,55,37,92,0.000333,0.154695,6,2784.505554,154.694753,464.084259,134.544278,5,5
0,0,16,16,12,21,33,57,48,105,0.000333,0.176554,12,6355.93659,353.107588,529.661383,135.258216,4,5
0,0,11,11,13,17,30,40,33,73,0.000333,0.119401,6,2149.218081,119.401004,358.203013,117.592585,1,5
0,0,15,15,15,23,38,54,49,103,0.000333,0.180179,14,7567.511474,420.417304,540.536534,162.645284,3,5
0,0,10,10,14,17,31,43,32,75,0.000333,0.123855,7,2600.953063,144.497392,371.564723,122.789837,3,5
0,0,18,18,17,24,41,65,60,125,0.000333,0.223231,16,10715.10401,595.283556,669.694001,179.525968,3,5
0,0,32,32,20,56,76,147,107,254,0.000333,0.528991,10,15869.73588,881.651994,1586.973588,411.650438,11,5
0,0,10,10,13,19,32,45,33,78,0.000333,0.13,6,2340,130,390,128.816339,3,5
0,0,13,13,14,18,32,47,39,86,0.000333,0.143333,14,6020,334.444444,430,128.361619,1,5
0,0,34,34,20,56,76,153,109,262,0.000333,0.545652,10,16369.57009,909.42056,1636.957009,411.650438,13,5
0,0,34,34,20,57,77,153,111,264,0.000333,0.551477,10,16544.31647,919.128693,1654.431647,418.913293,13,5
0,0,29,29,23,47,70,148,97,245,0.000333,0.500558,22,33036.83546,1835.379748,1501.674339,365.107601,11,5
0,0,28,28,20,46,66,142,91,233,0.000333,0.469448,10,14083.4383,782.413239,1408.34383,340.522412,11,5
0,0,15,15,13,20,33,56,41,97,0.000333,0.163102,12,5871.674755,326.204153,489.30623,134.544278,3,5
0,0,32,32,19,52,71,158,104,262,0.000333,0.537078,18,29002.20742,1611.233745,1611.233745,377.133488,12,5
0,0,29,29,21,46,67,157,94,251,0.000333,0.507529,20,30451.76774,1691.764874,1522.588387,346.322516,11,5
0,0,44,44,23,54,77,168,129,297,0.000333,0.620412,22,40947.18326,2274.843514,1861.235603,414.80585,9,5
0,0,9,9,14,16,30,39,30,69,0.000333,0.112858,7,2370.028158,131.668231,338.575451,117.302969,1,5
0,0,31,31,22,51,73,137,107,244,0.000333,0.503439,22,33226.97823,1845.943235,1510.317192,387.401188,7,5
0,0,29,29,21,46,67,157,94,251,0.000333,0.507529,20,30451.76774,1691.764874,1522.588387,346.322516,11,5
0,0,32,32,21,50,71,170,104,274,0.000333,0.561677,20,33700.61422,1872.256345,1685.030711,374.431475,13,5
0,0,33,33,21,51,72,175,107,282,0.000333,0.579973,20,34798.37701,1933.243167,1739.91885,381.532358,14,5
0,0,18,18,13,26,39,70,60,130,0.000333,0.229034,12,8245.227461,458.068192,687.102288,170.317149,2,5
0,0,18,18,14,26,40,64,63,127,0.000333,0.225295,14,9462.388153,525.688231,675.884868,175.514402,2,5
0,0,10,10,11,15,26,36,29,65,0.000333,0.101843,5,1527.642908,84.86905,305.528582,96.657107,1,5
0,0,10,10,11,15,26,36,29,65,0.000333,0.101843,5,1527.642908,84.86905,305.528582,96.657107,1,5
0,0,10,10,11,15,26,36,29,65,0.000333,0.101843,5,1527.642908,84.86905,305.528582,96.657107,1,5
0,0,16,16,14,23,37,60,52,112,0.000333,0.194486,14,8168.422877,453.801271,583.458777,157.344894,2,5
0,0,10,10,11,15,26,36,29,65,0.000333,0.101843,5,1527.642908,84.86905,305.528582,96.657107,1,5
0,0,16,16,14,24,38,62,53,115,0.000333,0.201171,14,8449.163297,469.397961,603.511664,163.342069,2,5
0,0,17,17,14,25,39,70,57,127,0.000333,0.223749,14,9397.445145,522.080286,671.246082,169.399374,2,5
0,0,8,8,10,14,24,34,27,61,0.000333,0.093228,5,1398.413563,77.689642,279.682713,86.52225,1,5
0,0,34,34,20,57,77,154,113,267,0.000333,0.557744,10,16732.32006,929.573337,1673.232006,418.913293,11,5
0,0,35,35,20,58,78,155,120,275,0.000333,0.576162,20,34569.7122,1920.539567,1728.48561,426.20146,12,5
0,0,34,34,20,57,77,151,113,264,0.000333,0.551477,10,16544.31647,919.128693,1654.431647,418.913293,11,5
0,0,32,32,20,56,76,147,107,254,0.000333,0.528991,10,15869.73588,881.651994,1586.973588,411.650438,11,5
0,0,35,35,21,58,79,156,114,270,0.000333,0.56734,10,17020.20802,945.567112,1702.020802,432.001564,12,5
0,0,34,34,20,56,76,153,109,262,0.000333,0.545652,10,16369.57009,909.42056,1636.957009,411.650438,13,5
0,0,35,35,23,58,81,165,120,285,0.000333,0.602286,22,39750.85952,2208.381084,1806.857251,443.804823,13,5
0,0,34,34,20,58,78,153,111,264,0.000333,0.553115,10,16593.46186,921.858992,1659.346186,426.20146,13,5
0,0,34,34,21,58,79,153,109,262,0.000333,0.55053,10,16515.90556,917.550309,1651.590556,432.001564,13,5
0,0,32,32,19,52,71,158,104,262,0.000333,0.537078,18,29002.20742,1611.233745,1611.233745,377.133488,12,5
0,0,34,34,22,53,75,167,111,278,0.000333,0.577204,22,38095.45511,2116.414173,1731.611596,401.68728,13,5
0,0,33,33,19,52,71,161,105,266,0.000333,0.545278,18,29444.98921,1635.832734,1635.832734,377.133488,13,5
0,0,33,33,19,54,73,161,106,267,0.000333,0.550894,9,14874.14842,826.341579,1652.683157,391.474548,13,5
0,0,32,32,20,53,73,145,109,254,0.000333,0.524072,20,31444.30876,1746.906042,1572.215438,390.018346,9,5
0,0,33,33,20,54,74,153,113,266,0.000333,0.550572,20,33034.29191,1835.238439,1651.714595,397.202487,9,5
0,0,32,32,21,52,73,143,108,251,0.000333,0.517882,20,31072.91929,1726.273294,1553.645964,388.661531,9,5
0,0,35,35,20,54,74,150,126,276,0.000333,0.57127,20,34276.18258,1904.232365,1713.809129,397.202487,9,5
0,0,16,16,12,20,32,59,61,120,0.000333,0.2,18,10800,600,600,129.458112,3,5
0,0,31,31,20,52,72,140,106,246,0.000333,0.505934,20,30356.03101,1686.446167,1517.80155,382.861427,9,5
0,0,33,33,20,53,73,145,116,261,0.000333,0.538515,20,32310.8842,1795.049122,1615.54421,390.018346,9,5
0,0,10,10,13,15,28,45,29,74,0.000333,0.118581,6,2134.465585,118.581421,355.744264,106.709075,3,5
0,0,11,11,13,18,31,45,32,77,0.000333,0.127158,6,2288.838695,127.157705,381.473116,123.164366,3,5
0,0,32,32,21,50,71,170,104,274,0.000333,0.561677,20,33700.61422,1872.256345,1685.030711,374.431475,13,5
0,0,34,34,22,51,73,177,110,287,0.000333,0.59216,22,39082.55227,2171.252904,1776.479648,387.401188,13,5
0,0,32,32,21,50,71,170,104,274,0.000333,0.561677,20,33700.61422,1872.256345,1685.030711,374.431475,13,5
0,0,32,32,21,50,71,170,104,274,0.000333,0.561677,20,33700.61422,1872.256345,1685.030711,374.431475,13,5
0,0,34,34,21,51,72,176,110,286,0.000333,0.5882,20,35291.97101,1960.665056,1764.59855,381.532358,13,5
0,0,32,32,21,50,71,170,104,274,0.000333,0.561677,20,33700.61422,1872.256345,1685.030711,374.431475,13,5
0,0,10,10,11,15,26,36,29,65,0.000333,0.101843,5,1527.642908,84.86905,305.528582,96.657107,1,5
0,0,21,21,16,26,42,79,54,133,0.000333,0.239059,16,11474.85148,637.491749,717.178217,186.211433,6,5
0,0,17,17,14,24,38,69,48,117,0.000333,0.204669,14,8596.105267,477.561404,614.007519,163.342069,6,5
0,0,45,45,25,58,83,176,133,309,0.000333,0.656629,24,47277.29242,2626.516246,1969.887184,455.859302,11,5
0,0,15,15,14,23,37,63,46,109,0.000333,0.189277,14,7949.625836,441.64588,567.830417,157.344894,4,5
0,0,17,17,14,24,38,69,48,117,0.000333,0.204669,14,8596.105267,477.561404,614.007519,163.342069,6,5
0,0,17,17,14,24,38,69,48,117,0.000333,0.204669,14,8596.105267,477.561404,614.007519,163.342069,6,5
0,0,17,17,14,24,38,69,48,117,0.000333,0.204669,14,8596.105267,477.561404,614.007519,163.342069,6,5
0,0,17,17,14,25,39,69,50,119,0.000333,0.209654,14,8805.480097,489.193339,628.962864,169.399374,6,5
0,0,17,17,14,25,39,69,50,119,0.000333,0.209654,14,8805.480097,489.193339,628.962864,169.399374,6,5
0,0,31,31,20,54,74,140,99,239,0.000333,0.494686,10,14840.59354,824.477419,1484.059354,397.202487,11,5
0,0,16,16,13,20,33,58,53,111,0.000333,0.186643,12,6719.132967,373.285165,559.927747,134.544278,1,5
0,0,14,14,14,19,33,50,46,96,0.000333,0.161421,14,6779.665696,376.648094,484.261835,134.013592,1,5
0,0,32,32,21,51,72,158,102,260,0.000333,0.534727,20,32083.61001,1782.422778,1604.1805,381.532358,12,5
0,0,9,9,10,15,25,34,30,64,0.000333,0.099069,10,2972.067961,165.114887,297.206796,91.82264,1,5
0,0,29,29,21,46,67,157,94,251,0.000333,0.507529,20,30451.76774,1691.764874,1522.588387,346.322516,11,5
0,0,32,32,22,47,69,175,105,280,0.000333,0.570129,22,37628.51065,2090.472814,1710.386848,359.173172,13,5
0,0,29,29,21,46,67,157,94,251,0.000333,0.507529,20,30451.76774,1691.764874,1522.588387,346.322516,11,5
0,0,29,29,21,46,67,157,94,251,0.000333,0.507529,20,30451.76774,1691.764874,1522.588387,346.322516,11,5
0,0,31,31,20,54,74,140,101,241,0.000333,0.498826,10,14964.78261,831.376812,1496.478261,397.202487,11,5
0,0,31,31,20,53,73,140,99,239,0.000333,0.493123,10,14793.6807,821.87115,1479.36807,390.018346,11,5
0,0,31,31,20,54,74,140,99,239,0.000333,0.494686,10,14840.59354,824.477419,1484.059354,397.202487,11,5
0,0,10,10,14,16,30,44,31,75,0.000333,0.122672,7,2576.117563,143.117642,368.016795,117.302969,3,5
0,0,29,29,20,53,73,134,97,231,0.000333,0.476616,10,14298.49473,794.360818,1429.849473,390.018346,9,5
0,0,18,18,16,22,38,63,58,121,0.000333,0.211666,16,10159.98767,564.443759,634.999229,162.107496,3,5
0,0,10,10,11,15,26,36,29,65,0.000333,0.101843,5,1527.642908,84.86905,305.528582,96.657107,1,5
0,0,31,31,21,47,68,163,100,263,0.000333,0.533668,20,32020.05455,1778.891919,1601.002727,353.304342,11,5
0,0,29,29,21,46,67,157,94,251,0.000333,0.507529,20,30451.76774,1691.764874,1522.588387,346.322516,11,5
0,0,10,10,11,15,26,36,29,65,0.000333,0.101843,5,1527.642908,84.86905,305.528582,96.657107,1,5
0,0,31,31,20,51,71,155,102,257,0.000333,0.526828,20,31609.70019,1756.094455,1580.48501,375.732254,13,5
0,0,31,31,20,50,70,155,101,256,0.000333,0.523032,20,31381.92905,1743.440503,1569.096452,368.631371,13,5
0,0,9,9,10,15,25,34,30,64,0.000333,0.099069,10,2972.067961,165.114887,297.206796,91.82264,1,5
0,0,32,32,21,50,71,170,104,274,0.000333,0.561677,20,33700.61422,1872.256345,1685.030711,374.431475,13,5
0,0,8,8,12,15,27,36,28,64,0.000333,0.101438,6,1825.876801,101.4376,304.3128,101.622909,1,5
0,0,16,16,16,26,42,62,55,117,0.000333,0.2103,16,10094.41822,560.801012,630.901138,186.211433,2,5
0,0,8,8,12,14,26,34,27,61,0.000333,0.095576,6,1720.360937,95.575608,286.726823,96.322519,1,5
0,0,19,19,18,27,45,70,65,135,0.000333,0.247133,18,13345.20302,741.400168,741.400168,203.440613,2,5
0,0,11,11,13,17,30,40,33,73,0.000333,0.119401,6,2149.218081,119.401004,358.203013,117.592585,1,5
0,0,12,12,14,17,31,43,34,77,0.000333,0.127158,14,5340.623623,296.701312,381.473116,122.789837,2,5
0,0,10,10,11,15,26,36,29,65,0.000333,0.101843,5,1527.642908,84.86905,305.528582,96.657107,1,5
0,0,16,16,14,20,34,58,43,101,0.000333,0.171278,14,7193.672458,399.64847,513.833747,139.741531,3,5
0,0,14,14,13,19,32,50,36,86,0.000333,0.143333,6,2580,143.333333,430,128.816339,2,5
0,0,16,16,13,20,33,57,47,104,0.000333,0.174872,12,6295.403861,349.744659,524.616988,134.544278,3,5
0,0,16,16,14,22,36,56,48,104,0.000333,0.179224,14,7527.410802,418.189489,537.6722,151.410465,3,5
0,0,19,19,12,22,34,64,65,129,0.000333,0.218761,12,7875.392478,437.521804,656.282707,141.127046,3,5
0,0,17,17,12,21,33,59,55,114,0.000333,0.191687,12,6900.731155,383.373953,575.06093,135.258216,3,5
0,0,11,11,13,18,31,45,32,77,0.000333,0.127158,6,2288.838695,127.157705,381.473116,123.164366,3,5
0,0,16,16,15,23,38,59,50,109,0.000333,0.190675,14,8008.337386,444.907633,572.024099,162.645284,3,5
0,0,18,18,17,27,44,73,61,134,0.000333,0.243855,16,11705.02139,650.278966,731.563837,197.868831,4,5
0,0,32,32,20,51,71,152,101,253,0.000333,0.518629,10,15558.86021,864.381123,1555.886021,375.732254,14,5
0,0,34,34,22,51,73,157,104,261,0.000333,0.538515,22,35541.97262,1974.554034,1615.54421,387.401188,14,5
0,0,32,32,20,52,72,152,102,254,0.000333,0.522387,10,15671.6095,870.644972,1567.16095,382.861427,14,5
0,0,32,32,20,51,71,152,102,254,0.000333,0.520679,20,31240.71537,1735.595298,1562.035768,375.732254,14,5
0,0,32,32,20,50,70,152,101,253,0.000333,0.516903,20,31014.17207,1723.009559,1550.708603,368.631371,14,5
0,0,13,13,12,16,28,44,41,85,0.000333,0.136208,12,4903.50202,272.416779,408.625168,107.01955,1,5
0,0,10,10,13,18,31,46,32,78,0.000333,0.128809,6,2318.563873,128.809104,386.427312,123.164366,3,5
0,0,12,12,11,16,27,41,39,80,0.000333,0.126797,10,3803.910002,211.328333,380.391,102.053748,1,5
0,0,13,13,13,16,29,45,37,82,0.000333,0.132785,12,4780.253299,265.569628,398.354442,112.105716,1,5
0,0,9,9,11,15,26,35,28,63,0.000333,0.098709,5,1480.638511,82.257695,296.127702,96.657107,1,5
0,0,14,14,11,17,28,46,49,95,0.000333,0.152233,10,4566.987176,253.72151,456.698718,107.540616,1,5
0,0,16,16,11,18,29,51,59,110,0.000333,0.178126,15,8015.668642,445.314925,534.377909,113.112398,1,5
0,0,32,32,21,51,72,152,101,253,0.000333,0.52033,10,15609.91025,867.217236,1560.991025,381.532358,14,5
0,0,32,32,20,52,72,152,102,254,0.000333,0.522387,10,15671.6095,870.644972,1567.16095,382.861427,14,5
0,0,27,27,19,42,61,128,85,213,0.000333,0.421082,18,22738.44695,1263.247053,1263.247053,307.187955,13,5
0,0,35,35,18,55,73,149,123,272,0.000333,0.561211,18,30305.38104,1683.63228,1683.63228,393.033434,9,5
0,0,35,35,18,54,72,155,120,275,0.000333,0.565576,18,30541.12876,1696.729375,1696.729375,385.822575,9,5
0,0,32,32,20,51,71,152,102,254,0.000333,0.520679,20,31240.71537,1735.595298,1562.035768,375.732254,14,5
0,0,32,32,20,50,70,152,101,253,0.000333,0.516903,20,31014.17207,1723.009559,1550.708603,368.631371,14,5
0,0,33,33,21,55,76,147,115,262,0.000333,0.545652,20,32739.14017,1818.841121,1636.957009,410.21345,9,5
0,0,8,8,12,15,27,36,28,64,0.000333,0.101438,6,1825.876801,101.4376,304.3128,101.622909,1,5
0,0,34,34,20,56,76,152,117,269,0.000333,0.560231,20,33613.85002,1867.436112,1680.692501,411.650438,9,5
0,0,11,11,12,19,31,43,35,78,0.000333,0.128809,6,2318.563873,128.809104,386.427312,123.730173,3,5
0,0,34,34,20,57,77,146,120,266,0.000333,0.555655,20,33339.3044,1852.183578,1666.96522,418.913293,9,5
0,0,32,32,21,50,71,158,101,259,0.000333,0.530928,20,31855.69008,1769.76056,1592.784504,374.431475,12,5
0,0,21,21,19,27,46,81,71,152,0.000333,0.27986,18,15112.46551,839.581417,839.581417,209.092585,4,5
0,0,9,9,14,16,30,39,30,69,0.000333,0.112858,7,2370.028158,131.668231,338.575451,117.302969,1,5
0,0,10,10,12,19,31,32,29,61,0.000333,0.100735,6,1813.23585,100.735325,302.205975,123.730173,2,5
0,0,31,31,20,50,70,149,100,249,0.000333,0.50873,20,30523.82942,1695.768301,1526.191471,368.631371,13,5
0,0,11,11,14,21,35,38,34,72,0.000333,0.123103,7,2585.158641,143.619924,369.308377,145.541635,2,5
0,0,9,9,11,17,28,29,27,56,0.000333,0.089737,5,1346.059378,74.781077,269.211876,107.540616,1,5
0,0,10,10,12,18,30,32,28,60,0.000333,0.098138,6,1766.480614,98.137812,294.413436,118.0782,2,5
0,0,10,10,12,18,30,32,28,60,0.000333,0.098138,6,1766.480614,98.137812,294.413436,118.0782,2,5
0,0,11,11,11,16,27,40,31,71,0.000333,0.112532,5,1687.985063,93.776948,337.597013,102.053748,1,5
0,0,10,10,12,19,31,32,29,61,0.000333,0.100735,6,1813.23585,100.735325,302.205975,123.730173,2,5
0,0,12,12,12,16,28,43,32,75,0.000333,0.120184,12,4326.61943,240.367746,360.551619,107.01955,2,5
0,0,12,12,12,17,29,43,32,75,0.000333,0.12145,6,2186.091448,121.449525,364.348575,112.506418,2,5
0,0,12,12,12,18,30,43,33,76,0.000333,0.124308,6,2237.542112,124.307895,372.923685,118.0782,2,5
0,0,12,12,12,18,30,43,33,76,0.000333,0.124308,6,2237.542112,124.307895,372.923685,118.0782,2,5
0,0,15,15,13,20,33,54,38,92,0.000333,0.154695,6,2784.505554,154.694753,464.084259,134.544278,2,5
0,0,12,12,12,17,29,43,32,75,0.000333,0.12145,6,2186.091448,121.449525,364.348575,112.506418,2,5
0,0,31,31,20,54,74,138,103,241,0.000333,0.498826,10,14964.78261,831.376812,1496.478261,397.202487,9,5
0,0,32,32,20,55,75,142,110,252,0.000333,0.523221,20,31393.2462,1744.069233,1569.66231,404.413346,10,5
0,0,32,32,21,55,76,143,104,247,0.000333,0.514413,10,15432.38096,857.354498,1543.238096,410.21345,10,5
0,0,31,31,21,54,75,140,103,243,0.000333,0.504534,10,15136.02942,840.890523,1513.602942,403.002591,9,5
0,0,31,31,20,54,74,141,103,244,0.000333,0.505036,10,15151.06621,841.725901,1515.106621,397.202487,9,5
0,0,32,32,20,55,75,142,107,249,0.000333,0.516992,10,15509.75854,861.653252,1550.975854,404.413346,9,5
0,0,17,17,15,24,39,70,52,122,0.000333,0.21494,14,9027.46699,501.525944,644.819071,168.642459,4,5
0,0,17,17,15,24,39,69,52,121,0.000333,0.213178,14,8953.471359,497.415075,639.533668,168.642459,4,5
0,0,16,16,14,21,35,52,56,108,0.000333,0.184654,14,7755.475922,430.859773,553.962566,145.541635,1,5
0,0,14,14,10,17,27,49,57,106,0.000333,0.168006,15,7560.271128,420.015063,504.018075,102.706149,1,5
0,0,14,14,14,18,32,48,45,93,0.000333,0.155,14,6510,361.666667,465,128.361619,1,5
0,0,14,14,13,19,32,47,44,91,0.000333,0.151667,12,5460,303.333333,455,128.816339,1,5
0,0,8,8,12,15,27,36,28,64,0.000333,0.101438,6,1825.876801,101.4376,304.3128,101.622909,1,5
0,0,8,8,11,12,23,35,25,60,0.000333,0.090471,10,2714.137174,150.785399,271.413717,81.073298,1,5
0,0,18,18,14,25,39,71,59,130,0.000333,0.229034,14,9619.432038,534.412891,687.102288,169.399374,5,5
0,0,17,17,14,24,38,67,52,119,0.000333,0.208168,14,8743.047237,485.724847,624.503374,163.342069,4,5
0,0,18,18,16,24,40,72,54,126,0.000333,0.223521,16,10729.00704,596.055947,670.56294,174.0391,4,5
0,0,18,18,15,27,42,70,57,127,0.000333,0.228275,14,9587.540378,532.641132,684.824313,186.985321,4,5
0,0,10,10,13,15,28,45,29,74,0.000333,0.118581,6,2134.465585,118.581421,355.744264,106.709075,3,5
0,0,13,13,14,16,30,49,38,87,0.000333,0.1423,14,5976.592745,332.03293,426.899482,117.302969,2,5
0,0,12,12,11,16,27,41,39,80,0.000333,0.126797,10,3803.910002,211.328333,380.391,102.053748,1,5
0,0,50,50,21,52,73,251,166,417,0.000333,0.860386,30,77434.70523,4301.928068,2581.156841,388.661531,22,5
0,0,44,44,20,44,64,207,131,338,0.000333,0.676,20,40560,2253.333333,2028,326.653553,19,5
0,0,29,29,21,46,67,157,94,251,0.000333,0.507529,20,30451.76774,1691.764874,1522.588387,346.322516,11,5
0,0,29,29,21,46,67,157,94,251,0.000333,0.507529,20,30451.76774,1691.764874,1522.588387,346.322516,11,5
0,0,18,18,17,27,44,81,59,140,0.000333,0.254773,16,12229.12683,679.395935,764.320427,197.868831,6,5
0,0,29,29,21,46,67,157,94,251,0.000333,0.507529,20,30451.76774,1691.764874,1522.588387,346.322516,11,5
0,0,29,29,21,46,67,157,94,251,0.000333,0.507529,20,30451.76774,1691.764874,1522.588387,346.322516,11,5
0,0,29,29,21,46,67,157,94,251,0.000333,0.507529,20,30451.76774,1691.764874,1522.588387,346.322516,11,5
0,0,29,29,21,46,67,157,94,251,0.000333,0.507529,20,30451.76774,1691.764874,1522.588387,346.322516,11,5
0,0,32,32,21,51,72,152,101,253,0.000333,0.52033,10,15609.91025,867.217236,1560.991025,381.532358,14,5
0,0,32,32,20,52,72,152,102,254,0.000333,0.522387,10,15671.6095,870.644972,1567.16095,382.861427,14,5
0,0,33,33,23,51,74,158,107,265,0.000333,0.548502,22,36201.11312,2011.172951,1645.505142,393.335617,14,5
0,0,34,34,19,53,72,148,115,263,0.000333,0.540897,18,29208.42496,1622.690275,1622.690275,384.290407,10,5
0,0,34,34,20,53,73,149,109,258,0.000333,0.532325,20,31939.49472,1774.416374,1596.974736,390.018346,10,5
0,0,30,30,18,51,69,137,100,237,0.000333,0.482573,9,13029.48267,723.860148,1447.720296,364.352342,9,5
0,0,32,32,21,51,72,146,107,253,0.000333,0.52033,20,31219.82051,1734.434473,1560.991025,381.532358,10,5
0,0,33,33,18,55,73,144,111,255,0.000333,0.526135,18,28411.29473,1578.405263,1578.405263,393.033434,9,5
0,0,32,32,18,52,70,144,106,250,0.000333,0.510774,18,27581.77358,1532.320754,1532.320754,371.481515,9,5
0,0,32,32,18,52,70,141,106,247,0.000333,0.504644,18,27250.79229,1513.932905,1513.932905,371.481515,9,5
0,0,33,33,20,52,72,146,108,254,0.000333,0.522387,20,31343.21901,1741.289945,1567.16095,382.861427,9,5
0,0,32,32,18,52,70,142,110,252,0.000333,0.51486,18,27802.42777,1544.57932,1544.57932,371.481515,9,5
0,0,17,17,13,24,37,62,60,122,0.000333,0.211851,12,7626.639727,423.702207,635.553311,158.144816,2,5
0,0,19,19,13,25,38,67,70,137,0.000333,0.239655,12,8627.592832,479.310713,718.966069,164.202121,2,5
0,0,34,34,20,56,76,154,110,264,0.000333,0.549818,10,16494.52864,916.362702,1649.452864,411.650438,13,5
0,0,34,34,20,54,74,154,108,262,0.000333,0.542292,20,32537.53564,1807.640869,1626.876782,397.202487,13,5
0,0,35,35,21,56,77,157,113,270,0.000333,0.564011,20,33840.64732,1880.035962,1692.032366,417.450542,12,5
0,0,34,34,20,55,75,152,112,264,0.000333,0.548136,20,32888.16269,1827.120149,1644.408134,404.413346,11,5
0,0,34,34,20,55,75,155,112,267,0.000333,0.554365,20,33261.89181,1847.882878,1663.09459,404.413346,11,5
0,0,17,17,15,26,41,68,49,117,0.000333,0.208945,7,4387.835092,243.768616,626.833585,180.814792,6,5
0,0,32,32,20,51,71,158,110,268,0.000333,0.549377,20,32962.64456,1831.258031,1648.132228,375.732254,12,5
0,0,17,17,14,27,41,68,51,119,0.000333,0.212516,7,4462.84082,247.935601,637.548689,181.684931,6,5
0,0,28,28,15,30,45,110,75,185,0.000333,0.338664,14,14223.89952,790.21664,1015.992823,205.810077,7,5
0,0,35,35,21,57,78,155,119,274,0.000333,0.574067,20,34444.00416,1913.555787,1722.200208,424.713397,11,5
0,0,10,10,12,18,30,43,32,75,0.000333,0.122672,6,2208.100768,122.672265,368.016795,118.0782,3,5
0,0,37,37,20,60,80,159,130,289,0.000333,0.609012,20,36540.74439,2030.041355,1827.037219,440.851998,11,5
0,0,34,34,20,54,74,154,108,262,0.000333,0.542292,20,32537.53564,1807.640869,1626.876782,397.202487,13,5
0,0,10,10,13,18,31,46,32,78,0.000333,0.128809,6,2318.563873,128.809104,386.427312,123.164366,3,5
0,0,18,18,17,23,40,66,59,125,0.000333,0.221747,16,10643.85619,591.325344,665.241012,173.528793,3,5
0,0,32,32,20,54,74,148,106,254,0.000333,0.525734,10,15772.01155,876.222864,1577.201155,397.202487,11,5
0,0,10,10,14,16,30,44,31,75,0.000333,0.122672,7,2576.117563,143.117642,368.016795,117.302969,3,5
0,0,48,48,15,81,96,269,204,473,0.000333,1.038229,14,43605.62168,2422.534538,3114.687263,572.131209,24,5
0,0,51,51,16,83,99,279,210,489,0.000333,1.080585,16,51868.0862,2881.560344,3241.755387,593.128273,25,5
0,0,50,50,16,82,98,276,208,484,0.000333,1.067173,16,51224.31303,2845.795168,3201.519565,585.319264,25,5
0,0,49,49,15,81,96,272,205,477,0.000333,1.047009,14,43974.37958,2443.021088,3141.027113,572.131209,25,5
0,0,52,52,16,83,99,282,211,493,0.000333,1.089424,16,52292.36502,2905.13139,3268.272814,593.128273,26,5
0,0,51,51,16,82,98,279,209,488,0.000333,1.075993,16,51647.65446,2869.314137,3227.978404,585.319264,26,5
0,0,49,49,15,82,97,272,206,478,0.000333,1.051586,14,44166.61674,2453.70093,3154.758339,579.922623,25,5
0,0,52,52,16,84,100,282,212,494,0.000333,1.094022,16,52513.03932,2917.391074,3282.064958,600.954664,26,5
0,0,51,51,16,83,99,279,210,489,0.000333,1.080585,16,51868.0862,2881.560344,3241.755387,593.128273,26,5
0,0,49,49,15,82,97,272,205,477,0.000333,1.049386,14,44074.21796,2448.567664,3148.158426,579.922623,25,5
0,0,52,52,16,84,100,282,211,493,0.000333,1.091807,16,52406.73763,2911.485424,3275.421102,600.954664,26,5
0,0,51,51,16,83,99,279,209,488,0.000333,1.078375,16,51762.01649,2875.667583,3235.126031,593.128273,26,5
0,0,49,49,15,82,97,272,205,477,0.000333,1.049386,14,44074.21796,2448.567664,3148.158426,579.922623,25,5
0,0,52,52,16,84,100,282,211,493,0.000333,1.091807,16,52406.73763,2911.485424,3275.421102,600.954664,26,5
0,0,51,51,16,83,99,279,209,488,0.000333,1.078375,16,51762.01649,2875.667583,3235.126031,593.128273,26,5
0,0,49,49,15,83,98,272,206,478,0.000333,1.053944,14,44265.63828,2459.202126,3161.831305,587.731632,25,5
0,0,52,52,16,85,101,282,212,494,0.000333,1.096385,16,52626.50356,2923.694642,3289.156472,608.79823,26,5
0,0,51,51,16,84,100,279,210,489,0.000333,1.082949,16,51981.53083,2887.862824,3248.845677,600.954664,26,5
0,0,49,49,15,83,98,272,206,478,0.000333,1.053944,14,44265.63828,2459.202126,3161.831305,587.731632,25,5
0,0,52,52,16,85,101,282,212,494,0.000333,1.096385,16,52626.50356,2923.694642,3289.156472,608.79823,26,5
0,0,51,51,16,84,100,279,210,489,0.000333,1.082949,16,51981.53083,2887.862824,3248.845677,600.954664,26,5
0,0,51,51,17,83,100,277,208,485,0.000333,1.07409,16,51556.32403,2864.240224,3222.270252,598.615141,25,5
0,0,54,54,18,85,103,287,214,501,0.000333,1.116646,18,60298.86175,3349.936764,3349.936764,619.85688,26,5
0,0,53,53,18,84,102,284,212,496,0.000333,1.103174,18,59571.41345,3309.52297,3309.52297,612.013314,26,5
0,0,17,17,14,24,38,69,50,119,0.000333,0.208168,14,8743.047237,485.724847,624.503374,163.342069,6,5
0,0,15,15,14,20,34,58,50,108,0.000333,0.183149,14,7692.243816,427.346879,549.445987,139.741531,1,5
0,0,31,31,18,53,71,140,102,242,0.000333,0.49608,9,13394.14923,744.119401,1488.238803,378.638434,10,5
0,0,31,31,18,52,70,140,101,241,0.000333,0.492386,9,13294.41486,738.578604,1477.157207,371.481515,10,5
0,0,16,16,16,20,36,57,55,112,0.000333,0.193011,16,9264.505603,514.694756,579.0316,150.438562,1,5
0,0,8,8,12,14,26,34,27,61,0.000333,0.095576,6,1720.360937,95.575608,286.726823,96.322519,1,5
0,0,31,31,18,51,69,140,101,241,0.000333,0.490718,9,13249.38955,736.077197,1472.154394,364.352342,10,5
0,0,30,30,18,51,69,137,100,237,0.000333,0.482573,9,13029.48267,723.860148,1447.720296,364.352342,9,5
0,0,31,31,18,52,70,140,101,241,0.000333,0.492386,9,13294.41486,738.578604,1477.157207,371.481515,10,5
0,0,31,31,18,52,70,140,102,242,0.000333,0.494429,9,13349.57841,741.643245,1483.28649,371.481515,10,5
0,0,34,34,20,55,75,154,110,264,0.000333,0.548136,20,32888.16269,1827.120149,1644.408134,404.413346,13,5
0,0,17,17,14,27,41,68,51,119,0.000333,0.212516,7,4462.84082,247.935601,637.548689,181.684931,6,5
0,0,15,15,12,21,33,53,46,99,0.000333,0.166465,12,5992.740214,332.930012,499.395018,135.258216,3,5
0,0,49,49,15,82,97,272,205,477,0.000333,1.049386,14,44074.21796,2448.567664,3148.158426,579.922623,25,5
0,0,52,52,16,84,100,282,211,493,0.000333,1.091807,16,52406.73763,2911.485424,3275.421102,600.954664,26,5
0,0,51,51,16,83,99,279,209,488,0.000333,1.078375,16,51762.01649,2875.667583,3235.126031,593.128273,26,5
0,0,33,33,23,51,74,158,107,265,0.000333,0.548502,22,36201.11312,2011.172951,1645.505142,393.335617,14,5
0,0,49,49,15,82,97,272,205,477,0.000333,1.049386,14,44074.21796,2448.567664,3148.158426,579.922623,25,5
0,0,52,52,16,84,100,282,211,493,0.000333,1.091807,16,52406.73763,2911.485424,3275.421102,600.954664,26,5
0,0,51,51,16,83,99,279,209,488,0.000333,1.078375,16,51762.01649,2875.667583,3235.126031,593.128273,26,5
0,0,29,29,21,46,67,157,94,251,0.000333,0.507529,20,30451.76774,1691.764874,1522.588387,346.322516,11,5
0,0,29,29,21,46,67,157,94,251,0.000333,0.507529,20,30451.76774,1691.764874,1522.588387,346.322516,11,5
0,0,37,37,20,58,78,160,129,289,0.000333,0.605494,20,36329.62483,2018.31249,1816.481241,426.20146,11,5
0,0,10,10,12,17,29,44,31,75,0.000333,0.12145,6,2186.091448,121.449525,364.348575,112.506418,3,5
0,0,37,37,20,57,77,166,126,292,0.000333,0.609967,20,36598.0334,2033.224078,1829.90167,418.913293,11,5
0,0,35,35,20,56,76,158,119,277,0.000333,0.576892,20,34613.51842,1922.973246,1730.675921,411.650438,11,5
0,0,36,36,20,57,77,166,123,289,0.000333,0.6037,20,36222.02621,2012.334789,1811.10131,418.913293,11,5
0,0,35,35,21,55,76,156,118,274,0.000333,0.570644,20,34238.64277,1902.146821,1711.932139,410.21345,11,5
0,0,17,17,17,21,38,57,58,115,0.000333,0.201171,16,9656.186625,536.454812,603.511664,161.725534,1,5
0,0,15,15,17,22,39,53,50,103,0.000333,0.181465,16,8710.342857,483.907936,544.396429,167.594364,1,5
0,0,9,9,14,16,30,39,30,69,0.000333,0.112858,7,2370.028158,131.668231,338.575451,117.302969,1,5
0,0,33,33,18,53,71,147,113,260,0.000333,0.532978,18,28780.81652,1598.934251,1598.934251,378.638434,9,5
0,0,28,28,18,49,67,127,92,219,0.000333,0.442825,9,11956.26179,664.236766,1328.473533,350.179432,8,5
0,0,28,28,18,49,67,127,92,219,0.000333,0.442825,9,11956.26179,664.236766,1328.473533,350.179432,8,5
0,0,28,28,18,47,65,127,91,218,0.000333,0.437625,9,11815.88565,656.438092,1312.876183,336.124326,8,5
0,0,28,28,19,48,67,127,91,218,0.000333,0.440802,9,11901.66699,661.203722,1322.407444,348.788823,8,5
0,0,28,28,18,48,66,127,91,218,0.000333,0.439226,9,11859.10126,658.838959,1317.677918,343.13685,8,5
0,0,31,31,19,50,69,138,97,235,0.000333,0.478501,9,12919.52923,717.751624,1435.503247,362.903432,8,5
0,0,30,30,19,48,67,131,94,225,0.000333,0.454957,9,12283.83061,682.435034,1364.870068,348.788823,8,5
0,0,27,27,18,47,65,124,90,214,0.000333,0.429596,9,11599.08041,644.393356,1288.786712,336.124326,7,5
0,0,29,29,21,47,68,133,97,230,0.000333,0.466705,20,28002.32907,1555.684948,1400.116453,353.304342,8,5
0,0,13,13,12,20,32,48,36,84,0.000333,0.14,6,2520,140,420,129.458112,3,5
0,0,34,34,19,53,72,164,114,278,0.000333,0.571746,18,30874.30471,1715.23915,1715.23915,384.290407,12,5
0,0,35,35,19,53,72,170,112,282,0.000333,0.579973,18,31318.53931,1739.91885,1739.91885,384.290407,12,5
0,0,29,29,19,49,68,145,94,239,0.000333,0.484968,9,13094.13257,727.45181,1454.903619,355.831405,10,5
0,0,31,31,22,50,72,154,101,255,0.000333,0.524444,22,34613.27926,1922.959959,1573.330875,380.300305,11,5
0,0,30,30,20,50,70,148,95,243,0.000333,0.496472,10,14894.15773,827.453207,1489.415773,368.631371,11,5
0,0,30,30,19,51,70,148,96,244,0.000333,0.498515,9,13459.90551,747.772528,1495.545056,370.004315,11,5
0,0,30,30,19,51,70,148,96,244,0.000333,0.498515,9,13459.90551,747.772528,1495.545056,370.004315,11,5
0,0,35,35,23,60,83,157,122,279,0.000333,0.592879,22,39129.99203,2173.888446,1778.636001,458.455361,11,5
0,0,10,10,14,17,31,43,32,75,0.000333,0.123855,7,2600.953063,144.497392,371.564723,122.789837,3,5
0,0,10,10,13,19,32,45,33,78,0.000333,0.13,6,2340,130,390,128.816339,3,5
0,0,15,15,12,21,33,54,38,92,0.000333,0.154695,6,2784.505554,154.694753,464.084259,135.258216,5,5
0,0,32,32,20,54,74,148,106,254,0.000333,0.525734,10,15772.01155,876.222864,1577.201155,397.202487,11,5
0,0,35,35,21,52,73,149,104,253,0.000333,0.522009,20,31320.51227,1740.028459,1566.025613,388.661531,11,5
0,0,31,31,20,53,73,141,100,241,0.000333,0.497249,10,14917.47719,828.748733,1491.747719,390.018346,11,5
0,0,10,10,13,19,32,45,33,78,0.000333,0.13,6,2340,130,390,128.816339,3,5
0,0,10,10,14,17,31,43,32,75,0.000333,0.123855,7,2600.953063,144.497392,371.564723,122.789837,3,5
0,0,18,18,17,29,46,72,62,134,0.000333,0.246719,16,11842.51683,657.917602,740.157302,210.368317,4,5
0,0,11,11,12,19,31,43,35,78,0.000333,0.128809,6,2318.563873,128.809104,386.427312,123.730173,3,5
0,0,20,20,15,29,44,74,70,144,0.000333,0.262053,14,11006.21414,611.456341,786.158153,199.484808,4,5
0,0,12,12,12,19,31,44,34,78,0.000333,0.128809,6,2318.563873,128.809104,386.427312,123.730173,3,5
0,0,21,21,19,30,49,80,72,152,0.000333,0.284479,18,15361.84613,853.435896,853.435896,227.917341,4,5
0,0,10,10,11,15,26,36,29,65,0.000333,0.101843,5,1527.642908,84.86905,305.528582,96.657107,1,5
0,0,16,16,12,22,34,56,49,105,0.000333,0.178061,12,6410.20318,356.122399,534.183598,141.127046,4,5
0,0,15,15,12,21,33,52,42,94,0.000333,0.158058,12,5690.076567,316.115365,474.173047,135.258216,3,5
0,0,15,15,13,21,34,54,42,96,0.000333,0.162799,12,5860.757193,325.597622,488.396433,140.344382,3,5
0,0,32,32,20,50,70,152,101,253,0.000333,0.516903,20,31014.17207,1723.009559,1550.708603,368.631371,14,5
0,0,27,27,19,42,61,128,85,213,0.000333,0.421082,18,22738.44695,1263.247053,1263.247053,307.187955,13,5
0,0,31,31,20,50,70,149,100,249,0.000333,0.50873,20,30523.82942,1695.768301,1526.191471,368.631371,13,5
0,0,28,28,19,43,62,131,87,218,0.000333,0.432672,18,23364.26632,1298.014796,1298.014796,314.040007,14,5
0,0,32,32,20,50,70,152,101,253,0.000333,0.516903,20,31014.17207,1723.009559,1550.708603,368.631371,14,5
0,0,28,28,19,43,62,131,86,217,0.000333,0.430687,18,23257.09079,1292.060599,1292.060599,314.040007,14,5
0,0,32,32,20,51,71,152,101,253,0.000333,0.518629,10,15558.86021,864.381123,1555.886021,375.732254,14,5
0,0,32,32,20,52,72,152,102,254,0.000333,0.522387,10,15671.6095,870.644972,1567.16095,382.861427,14,5
0,0,28,28,19,44,63,131,87,218,0.000333,0.434349,9,11727.42321,651.523512,1303.047023,320.925614,14,5
0,0,31,31,20,52,72,155,102,257,0.000333,0.528557,10,15856.70725,880.928181,1585.670725,382.861427,13,5
0,0,31,31,20,51,71,155,101,256,0.000333,0.524778,10,15743.35263,874.630701,1574.335263,375.732254,13,5
0,0,35,35,22,52,74,151,104,255,0.000333,0.527804,22,34835.03338,1935.279632,1583.410608,394.530361,11,5
0,0,31,31,20,52,72,141,98,239,0.000333,0.491537,10,14746.12075,819.228931,1474.612075,382.861427,11,5
0,0,42,42,21,54,75,184,123,307,0.000333,0.637416,20,38244.94676,2124.719264,1912.247338,403.002591,12,5
0,0,31,31,20,51,71,141,98,239,0.000333,0.48993,10,14697.89562,816.549756,1469.789562,375.732254,11,5
0,0,32,32,23,53,76,153,109,262,0.000333,0.545652,22,36013.05419,2000.725233,1636.957009,407.621709,11,5
0,0,31,31,20,53,73,141,100,241,0.000333,0.497249,10,14917.47719,828.748733,1491.747719,390.018346,11,5
0,0,15,15,14,19,33,54,41,95,0.000333,0.159739,14,6709.044179,372.724677,479.217441,134.013592,3,5
0,0,10,10,13,15,28,45,29,74,0.000333,0.118581,6,2134.465585,118.581421,355.744264,106.709075,3,5
0,0,11,11,13,18,31,45,32,77,0.000333,0.127158,6,2288.838695,127.157705,381.473116,123.164366,3,5
0,0,14,14,13,19,32,52,39,91,0.000333,0.151667,12,5460,303.333333,455,128.816339,3,5
0,0,18,18,14,24,38,66,56,122,0.000333,0.213416,14,8963.460193,497.970011,640.247157,163.342069,3,5
0,0,14,14,13,19,32,51,39,90,0.000333,0.15,12,5400,300,450,128.816339,3,5
0,0,14,14,12,19,31,50,43,93,0.000333,0.15358,12,5528.883082,307.160171,460.740257,123.730173,3,5
0,0,16,16,12,20,32,55,53,108,0.000333,0.18,12,6480,360,540,129.458112,3,5
0,0,10,10,13,19,32,45,33,78,0.000333,0.13,6,2340,130,390,128.816339,3,5
0,0,14,14,16,21,37,50,48,98,0.000333,0.170175,16,8168.422877,453.801271,510.52643,156.238666,1,5
0,0,8,8,12,15,27,36,28,64,0.000333,0.101438,6,1825.876801,101.4376,304.3128,101.622909,1,5
0,0,28,28,19,43,62,131,86,217,0.000333,0.430687,18,23257.09079,1292.060599,1292.060599,314.040007,14,5
0,0,28,28,19,43,62,131,86,217,0.000333,0.430687,18,23257.09079,1292.060599,1292.060599,314.040007,14,5
0,0,10,10,11,15,26,36,29,65,0.000333,0.101843,5,1527.642908,84.86905,305.528582,96.657107,1,5
0,0,16,16,17,20,37,54,56,110,0.000333,0.191013,16,9168.637924,509.368774,573.03987,155.92543,1,5
0,0,8,8,12,14,26,34,27,61,0.000333,0.095576,6,1720.360937,95.575608,286.726823,96.322519,1,5
0,0,32,32,20,51,71,152,102,254,0.000333,0.520679,20,31240.71537,1735.595298,1562.035768,375.732254,14,5
0,0,14,14,10,17,27,49,57,106,0.000333,0.168006,15,7560.271128,420.015063,504.018075,102.706149,1,5
0,0,32,32,20,50,70,152,101,253,0.000333,0.516903,20,31014.17207,1723.009559,1550.708603,368.631371,14,5
0,0,15,15,12,19,31,58,48,106,0.000333,0.175048,12,6301.737707,350.096539,525.144809,123.730173,1,5
0,0,13,13,11,17,28,45,41,86,0.000333,0.137811,10,4134.325233,229.684735,413.432523,107.540616,1,5
0,0,31,31,20,50,70,149,100,249,0.000333,0.50873,20,30523.82942,1695.768301,1526.191471,368.631371,13,5
0,0,15,15,11,18,29,50,51,101,0.000333,0.163552,10,4906.560805,272.586711,490.656081,113.112398,1,5
0,0,29,29,20,47,67,145,100,245,0.000333,0.495397,20,29723.83703,1651.32428,1486.191852,347.504238,10,5
0,0,15,15,12,21,33,54,38,92,0.000333,0.154695,6,2784.505554,154.694753,464.084259,135.258216,5,5
0,0,30,30,19,49,68,148,95,243,0.000333,0.493084,9,13313.28123,739.626735,1479.25347,355.831405,11,5
0,0,31,31,19,50,69,151,100,251,0.000333,0.51108,18,27598.3135,1533.239639,1533.239639,362.903432,10,5
0,0,16,16,13,20,33,56,42,98,0.000333,0.164784,12,5932.207484,329.567082,494.350624,134.544278,2,5
0,0,34,34,20,58,78,153,111,264,0.000333,0.553115,10,16593.46186,921.858992,1659.346186,426.20146,13,5
0,0,34,34,20,57,77,153,109,262,0.000333,0.547299,10,16418.98074,912.165596,1641.898074,418.913293,13,5
0,0,38,38,21,57,78,161,115,276,0.000333,0.578257,20,34695.42025,1927.523347,1734.771012,424.713397,13,5
0,0,34,34,20,58,78,153,111,264,0.000333,0.553115,10,16593.46186,921.858992,1659.346186,426.20146,13,5
0,0,45,45,21,59,80,195,135,330,0.000333,0.695412,20,41724.72543,2318.040301,2086.236271,439.314606,14,5
0,0,9,9,14,16,30,39,30,69,0.000333,0.112858,7,2370.028158,131.668231,338.575451,117.302969,1,5
0,0,33,33,19,53,72,161,105,266,0.000333,0.547067,9,14770.80045,820.600025,1641.20005,384.290407,13,5
0,0,35,35,20,53,73,165,108,273,0.000333,0.563274,20,33796.44209,1877.580116,1689.822105,390.018346,13,5
0,0,33,33,19,53,72,161,105,266,0.000333,0.547067,9,14770.80045,820.600025,1641.20005,384.290407,13,5
0,0,33,33,19,54,73,161,106,267,0.000333,0.550894,9,14874.14842,826.341579,1652.683157,391.474548,13,5
0,0,15,15,12,21,33,55,39,94,0.000333,0.158058,6,2845.038283,158.057682,474.173047,135.258216,5,5
0,0,14,14,13,23,36,55,41,96,0.000333,0.165438,6,2977.876801,165.4376,496.3128,152.147641,3,5
0,0,9,9,14,15,29,37,29,66,0.000333,0.106876,7,2244.38722,124.688179,320.626746,111.906328,1,5
0,0,14,14,13,23,36,55,41,96,0.000333,0.165438,6,2977.876801,165.4376,496.3128,152.147641,3,5
0,0,10,10,12,18,30,32,28,60,0.000333,0.098138,6,1766.480614,98.137812,294.413436,118.0782,2,5
0,0,36,36,22,57,79,173,114,287,0.000333,0.603062,22,39802.07164,2211.226202,1809.185075,430.582226,14,5
0,0,19,19,14,22,36,65,43,108,0.000333,0.186117,7,3908.463301,217.13685,558.3519,151.410465,5,5
0,0,34,34,20,58,78,168,112,280,0.000333,0.586638,10,17599.12621,977.729234,1759.912621,426.20146,14,5
0,0,16,16,13,22,35,57,43,100,0.000333,0.170976,6,3077.56981,170.976101,512.928302,146.213212,4,5
0,0,34,34,20,57,77,153,109,262,0.000333,0.547299,10,16418.98074,912.165596,1641.898074,418.913293,13,5
0,0,38,38,22,57,79,163,115,278,0.000333,0.58415,22,38553.92306,2141.884614,1752.451048,430.582226,13,5
0,0,9,9,11,17,28,29,27,56,0.000333,0.089737,5,1346.059378,74.781077,269.211876,107.540616,1,5
0,0,13,13,12,20,32,48,36,84,0.000333,0.14,6,2520,140,420,129.458112,3,5
0,0,38,38,20,57,77,163,136,299,0.000333,0.62459,20,37475.38351,2081.965751,1873.769176,418.913293,11,5
0,0,11,11,12,17,29,37,30,67,0.000333,0.108495,6,1952.90836,108.494909,325.484727,112.506418,2,5
0,0,12,12,14,20,34,43,36,79,0.000333,0.13397,7,2813.366951,156.298164,401.909564,139.741531,2,5
0,0,10,10,11,16,27,34,29,63,0.000333,0.099853,5,1497.789563,83.210531,299.557913,102.053748,1,5
0,0,13,13,13,19,32,41,33,74,0.000333,0.123333,6,2220,123.333333,370,128.816339,2,5
0,0,35,35,22,55,77,157,114,271,0.000333,0.5661,22,37362.58136,2075.698964,1698.299153,416.08228,11,5
0,0,11,11,12,18,30,37,31,68,0.000333,0.111223,6,2002.011363,111.222854,333.668561,118.0782,2,5
0,0,49,49,15,83,98,272,206,478,0.000333,1.053944,14,44265.63828,2459.202126,3161.831305,587.731632,25,5
0,0,52,52,16,85,101,282,212,494,0.000333,1.096385,16,52626.50356,2923.694642,3289.156472,608.79823,26,5
0,0,51,51,16,84,100,279,210,489,0.000333,1.082949,16,51981.53083,2887.862824,3248.845677,600.954664,26,5
0,0,15,15,13,21,34,55,42,97,0.000333,0.164495,12,5921.806747,328.989264,493.483896,140.344382,3,5
0,0,15,15,13,21,34,54,38,92,0.000333,0.156016,6,2808.279488,156.015527,468.046581,140.344382,5,5
0,0,16,16,15,24,39,66,49,115,0.000333,0.202607,14,8509.497572,472.749865,607.821255,168.642459,5,5
0,0,29,29,19,49,68,145,94,239,0.000333,0.484968,9,13094.13257,727.45181,1454.903619,355.831405,10,5
0,0,13,13,12,19,31,48,34,82,0.000333,0.135415,6,2437.464585,135.414699,406.244097,123.730173,4,5
0,0,15,15,14,21,35,53,37,90,0.000333,0.153878,7,3231.448301,179.524906,461.635472,145.541635,4,5
0,0,13,13,12,19,31,48,35,83,0.000333,0.137066,6,2467.189763,137.066098,411.198294,123.730173,4,5
0,0,13,13,12,19,31,48,34,82,0.000333,0.135415,6,2437.464585,135.414699,406.244097,123.730173,4,5
0,0,13,13,12,19,31,48,34,82,0.000333,0.135415,6,2437.464585,135.414699,406.244097,123.730173,4,5
0,0,13,13,12,19,31,48,34,82,0.000333,0.135415,6,2437.464585,135.414699,406.244097,123.730173,4,5
0,0,15,15,12,21,33,52,47,99,0.000333,0.166465,12,5992.740214,332.930012,499.395018,135.258216,4,5
0,0,15,15,13,21,34,52,37,89,0.000333,0.150928,6,2716.705157,150.928064,452.784193,140.344382,4,5
0,0,13,13,12,19,31,48,34,82,0.000333,0.135415,6,2437.464585,135.414699,406.244097,123.730173,4,5
0,0,34,34,20,57,77,168,111,279,0.000333,0.582811,10,17484.33445,971.351914,1748.433445,418.913293,14,5
0,0,31,31,20,51,71,155,101,256,0.000333,0.524778,10,15743.35263,874.630701,1574.335263,375.732254,13,5
0,0,14,14,13,22,35,55,41,96,0.000333,0.164137,6,2954.467018,164.137057,492.41117,146.213212,3,5
0,0,13,13,13,22,35,52,40,92,0.000333,0.157298,6,2831.364225,157.298013,471.894038,146.213212,2,5
0,0,14,14,13,23,36,55,41,96,0.000333,0.165438,6,2977.876801,165.4376,496.3128,152.147641,3,5
0,0,14,14,13,23,36,55,42,97,0.000333,0.167161,6,3008.896351,167.160908,501.482725,152.147641,3,5
0,0,14,14,13,24,37,55,42,97,0.000333,0.168439,6,3031.901859,168.438992,505.316976,158.144816,3,5
0,0,14,14,13,24,37,55,42,97,0.000333,0.168439,6,3031.901859,168.438992,505.316976,158.144816,3,5
0,0,14,14,15,18,33,49,41,90,0.000333,0.151332,14,6355.93659,353.107588,453.995471,133.662009,1,5
0,0,14,14,12,20,32,48,40,88,0.000333,0.146667,12,5280,293.333333,440,129.458112,3,5
0,0,15,15,13,21,34,53,41,94,0.000333,0.159407,6,2869.329042,159.407169,478.221507,140.344382,4,5
0,0,12,12,12,19,31,44,34,78,0.000333,0.128809,6,2318.563873,128.809104,386.427312,123.730173,3,5
0,0,14,14,15,23,38,54,42,96,0.000333,0.167934,7,3526.607289,195.922627,503.801041,162.645284,4,5
0,0,13,13,13,20,33,47,35,82,0.000333,0.13788,6,2481.841907,137.880106,413.640318,134.544278,4,5
0,0,13,13,13,20,33,47,35,82,0.000333,0.13788,6,2481.841907,137.880106,413.640318,134.544278,4,5
0,0,13,13,12,21,33,47,36,83,0.000333,0.139562,6,2512.108271,139.561571,418.684712,135.258216,4,5
0,0,13,13,12,21,33,47,36,83,0.000333,0.139562,6,2512.108271,139.561571,418.684712,135.258216,4,5
0,0,8,8,10,14,24,34,27,61,0.000333,0.093228,5,1398.413563,77.689642,279.682713,86.52225,1,5
0,0,31,31,18,50,68,142,107,249,0.000333,0.505259,18,27284.00845,1515.778247,1515.778247,357.25146,7,5
0,0,15,15,12,21,33,55,39,94,0.000333,0.158058,6,2845.038283,158.057682,474.173047,135.258216,5,5
0,0,15,15,12,20,32,55,37,92,0.000333,0.153333,6,2760,153.333333,460,129.458112,5,5
0,0,17,17,13,20,33,55,63,118,0.000333,0.198413,18,10714.29311,595.238506,595.238506,134.544278,1,5
0,0,15,15,12,21,33,55,39,94,0.000333,0.158058,6,2845.038283,158.057682,474.173047,135.258216,5,5
0,0,14,14,13,23,36,55,41,96,0.000333,0.165438,6,2977.876801,165.4376,496.3128,152.147641,3,5
0,0,15,15,13,19,32,50,53,103,0.000333,0.171667,12,6180,343.333333,515,128.816339,1,5
0,0,17,17,17,26,43,65,57,122,0.000333,0.220668,16,10592.0688,588.448267,662.0043,191.698301,2,5
0,0,34,34,20,57,77,153,109,262,0.000333,0.547299,10,16418.98074,912.165596,1641.898074,418.913293,13,5
0,0,9,9,14,15,29,37,29,66,0.000333,0.106876,7,2244.38722,124.688179,320.626746,111.906328,1,5
0,0,33,33,18,50,68,139,120,259,0.000333,0.525551,18,28379.75177,1576.652876,1576.652876,357.25146,7,5
0,0,31,31,18,49,67,134,110,244,0.000333,0.493375,18,26642.26372,1480.125762,1480.125762,350.179432,7,5
0,0,13,13,13,18,31,45,43,88,0.000333,0.145323,12,5231.631304,290.646184,435.969275,123.164366,1,5
0,0,9,9,11,15,26,35,28,63,0.000333,0.098709,5,1480.638511,82.257695,296.127702,96.657107,1,5
0,0,14,14,14,21,35,47,44,91,0.000333,0.155588,14,6534.706564,363.039254,466.764755,145.541635,1,5
0,0,13,13,13,18,31,45,43,88,0.000333,0.145323,12,5231.631304,290.646184,435.969275,123.164366,1,5
0,0,33,33,20,56,76,165,110,275,0.000333,0.572727,10,17181.80066,954.544481,1718.180066,411.650438,13,5
0,0,17,17,13,23,36,56,57,113,0.000333,0.194734,12,7010.418302,389.467683,584.201525,152.147641,3,5
0,0,16,16,12,21,33,58,62,120,0.000333,0.201776,12,7263.927532,403.55153,605.327294,135.258216,3,5
0,0,18,18,12,22,34,59,64,123,0.000333,0.208586,12,7509.095154,417.171953,625.757929,141.127046,3,5
0,0,15,15,13,20,33,52,46,98,0.000333,0.164784,12,5932.207484,329.567082,494.350624,134.544278,3,5
0,0,16,16,14,23,37,55,49,104,0.000333,0.180594,14,7584.9641,421.386894,541.78315,157.344894,3,5
0,0,16,16,13,22,35,62,51,113,0.000333,0.193203,12,6955.307771,386.405987,579.608981,146.213212,3,5
0,0,15,15,13,21,34,54,47,101,0.000333,0.171278,12,6166.004964,342.555831,513.833747,140.344382,3,5
0,0,20,20,18,27,45,73,67,140,0.000333,0.256286,18,13839.4698,768.859433,768.859433,203.440613,2,5
0,0,34,34,20,57,77,153,109,262,0.000333,0.547299,10,16418.98074,912.165596,1641.898074,418.913293,13,5
0,0,11,11,12,18,30,44,34,78,0.000333,0.127579,6,2296.424799,127.579155,382.737466,118.0782,3,5
0,0,34,34,22,55,77,150,117,267,0.000333,0.557744,22,36811.10414,2045.061341,1673.232006,416.08228,9,5
0,0,9,9,14,16,30,39,30,69,0.000333,0.112858,7,2370.028158,131.668231,338.575451,117.302969,1,5
0,0,26,26,13,23,36,98,62,160,0.000333,0.275729,12,9926.256003,551.458667,827.188,152.147641,6,5
0,0,15,15,15,20,35,54,40,94,0.000333,0.160718,14,6750.13645,375.007581,482.152604,145.041921,2,5
0,0,12,12,14,18,32,43,34,77,0.000333,0.128333,7,2695,149.722222,385,128.361619,2,5
0,0,12,12,14,18,32,43,34,77,0.000333,0.128333,7,2695,149.722222,385,128.361619,2,5
0,0,12,12,14,19,33,43,35,78,0.000333,0.131154,7,2754.239189,153.013288,393.462741,134.013592,2,5
0,0,12,12,14,19,33,43,35,78,0.000333,0.131154,7,2754.239189,153.013288,393.462741,134.013592,2,5
0,0,12,12,14,18,32,43,34,77,0.000333,0.128333,7,2695,149.722222,385,128.361619,2,5
0,0,12,12,14,18,32,43,35,78,0.000333,0.13,7,2730,151.666667,390,128.361619,2,5
0,0,10,10,12,18,30,43,32,75,0.000333,0.122672,6,2208.100768,122.672265,368.016795,118.0782,3,5
0,0,12,12,14,18,32,43,34,77,0.000333,0.128333,7,2695,149.722222,385,128.361619,2,5
0,0,10,10,14,17,31,43,32,75,0.000333,0.123855,7,2600.953063,144.497392,371.564723,122.789837,3,5
0,0,10,10,12,18,30,43,32,75,0.000333,0.122672,6,2208.100768,122.672265,368.016795,118.0782,3,5
0,0,10,10,13,19,32,45,33,78,0.000333,0.13,6,2340,130,390,128.816339,3,5
0,0,10,10,11,15,26,36,29,65,0.000333,0.101843,5,1527.642908,84.86905,305.528582,96.657107,1,5
0,0,10,10,11,15,26,36,29,65,0.000333,0.101843,5,1527.642908,84.86905,305.528582,96.657107,1,5
0,0,13,13,12,16,28,44,41,85,0.000333,0.136208,12,4903.50202,272.416779,408.625168,107.01955,1,5
0,0,12,12,12,16,28,43,35,78,0.000333,0.124991,12,4499.684207,249.982456,374.973684,107.01955,1,5
0,0,12,12,11,16,27,40,35,75,0.000333,0.118872,10,3566.165627,198.120313,356.616563,102.053748,1,5
0,0,28,28,15,28,43,112,73,185,0.000333,0.33462,14,14054.02572,780.779206,1003.85898,193.209297,7,5
0,0,16,16,12,21,33,58,62,120,0.000333,0.201776,12,7263.927532,403.55153,605.327294,135.258216,3,5
0,0,38,38,20,59,79,162,137,299,0.000333,0.628277,20,37696.60887,2094.256049,1884.830444,433.514502,11,5
0,0,11,11,13,19,32,44,33,77,0.000333,0.128333,6,2310,128.333333,385,128.816339,3,5
0,0,10,10,13,16,29,44,30,74,0.000333,0.11983,6,2156.943562,119.830198,359.490594,112.105716,3,5
0,0,36,36,20,58,78,157,127,284,0.000333,0.595018,20,35701.0846,1983.393589,1785.05423,426.20146,11,5
0,0,34,34,20,57,77,152,117,269,0.000333,0.561922,20,33715.31159,1873.072866,1685.765579,418.913293,11,5
0,0,34,34,21,57,78,153,113,266,0.000333,0.557306,10,16719.1699,928.842772,1671.91699,424.713397,11,5
0,0,35,35,20,60,80,154,118,272,0.000333,0.573188,10,17195.64442,955.313579,1719.564442,440.851998,11,5
0,0,32,32,21,50,71,170,104,274,0.000333,0.561677,20,33700.61422,1872.256345,1685.030711,374.431475,13,5
0,0,32,32,23,55,78,145,111,256,0.000333,0.536354,22,35399.3853,1966.632516,1609.062968,422.016709,9,5
0,0,27,27,20,46,66,139,90,229,0.000333,0.461389,10,13841.66253,768.981252,1384.166253,340.522412,10,5
0,0,32,32,22,52,74,144,104,248,0.000333,0.513315,22,33878.77756,1882.154309,1539.944435,394.530361,9,5
0,0,31,31,21,52,73,141,102,243,0.000333,0.501376,10,15041.27368,835.626315,1504.127368,388.661531,9,5
0,0,29,29,20,51,71,135,96,231,0.000333,0.473531,10,14205.91585,789.217547,1420.591585,375.732254,9,5
0,0,35,35,21,54,75,148,105,253,0.000333,0.525297,10,15758.91129,875.495071,1575.891129,403.002591,11,5
0,0,8,8,11,12,23,35,25,60,0.000333,0.090471,10,2714.137174,150.785399,271.413717,81.073298,1,5
0,0,32,32,21,50,71,170,104,274,0.000333,0.561677,20,33700.61422,1872.256345,1685.030711,374.431475,13,5
0,0,32,32,21,50,71,170,104,274,0.000333,0.561677,20,33700.61422,1872.256345,1685.030711,374.431475,13,5
0,0,15,15,13,23,36,57,50,107,0.000333,0.184394,12,6638.183702,368.787983,553.181975,152.147641,2,5
0,0,16,16,14,26,40,59,51,110,0.000333,0.195137,7,4097.884633,227.660257,585.41209,175.514402,2,5
0,0,32,32,21,50,71,170,104,274,0.000333,0.561677,20,33700.61422,1872.256345,1685.030711,374.431475,13,5
0,0,15,15,14,23,37,59,46,105,0.000333,0.182331,14,7657.896447,425.438692,546.992603,157.344894,2,5
0,0,15,15,13,23,36,56,46,102,0.000333,0.175777,12,6327.988202,351.5549,527.33235,152.147641,2,5
0,0,32,32,21,50,71,170,104,274,0.000333,0.561677,20,33700.61422,1872.256345,1685.030711,374.431475,13,5
0,0,32,32,21,50,71,170,104,274,0.000333,0.561677,20,33700.61422,1872.256345,1685.030711,374.431475,13,5
0,0,15,15,13,23,36,57,50,107,0.000333,0.184394,12,6638.183702,368.787983,553.181975,152.147641,2,5
0,0,9,9,11,15,26,35,28,63,0.000333,0.098709,5,1480.638511,82.257695,296.127702,96.657107,1,5
0,0,13,13,12,19,31,43,40,83,0.000333,0.137066,12,4934.379525,274.132196,411.198294,123.730173,1,5
0,0,31,31,20,55,75,140,101,241,0.000333,0.500382,10,15011.45304,833.969614,1501.145304,404.413346,11,5
0,0,31,31,21,55,76,140,99,239,0.000333,0.497752,10,14932.54676,829.585931,1493.254676,410.21345,11,5
0,0,42,42,21,56,77,182,125,307,0.000333,0.641301,20,38478.06936,2137.67052,1923.903468,417.450542,12,5
0,0,31,31,20,55,75,140,101,241,0.000333,0.500382,10,15011.45304,833.969614,1501.145304,404.413346,11,5
0,0,35,35,22,54,76,150,105,255,0.000333,0.531074,11,17525.43668,973.635371,1593.221516,408.871421,11,5
0,0,31,31,20,54,74,140,99,239,0.000333,0.494686,10,14840.59354,824.477419,1484.059354,397.202487,11,5
0,0,31,31,20,53,73,140,99,239,0.000333,0.493123,10,14793.6807,821.87115,1479.36807,390.018346,11,5
0,0,32,32,23,55,78,152,110,262,0.000333,0.548925,22,36229.05839,2012.725466,1646.775381,422.016709,11,5
0,0,10,10,11,15,26,36,29,65,0.000333,0.101843,5,1527.642908,84.86905,305.528582,96.657107,1,5
0,0,10,10,11,15,26,36,29,65,0.000333,0.101843,5,1527.642908,84.86905,305.528582,96.657107,1,5
0,0,31,31,20,52,72,142,102,244,0.000333,0.501821,10,15054.617,836.367611,1505.4617,382.861427,9,5
0,0,32,32,20,53,73,143,109,252,0.000333,0.519945,20,31196.71578,1733.150876,1559.835789,390.018346,10,5
0,0,8,8,12,15,27,36,28,64,0.000333,0.101438,6,1825.876801,101.4376,304.3128,101.622909,1,5
0,0,32,32,18,51,69,136,113,249,0.000333,0.507008,18,27378.40662,1521.02259,1521.02259,364.352342,7,5
0,0,34,34,20,54,74,153,116,269,0.000333,0.556781,20,33406.85911,1855.936617,1670.342955,397.202487,9,5
0,0,10,10,14,16,30,44,31,75,0.000333,0.122672,7,2576.117563,143.117642,368.016795,117.302969,3,5
0,0,17,17,14,25,39,69,50,119,0.000333,0.209654,14,8805.480097,489.193339,628.962864,169.399374,6,5
0,0,10,10,11,15,26,36,29,65,0.000333,0.101843,5,1527.642908,84.86905,305.528582,96.657107,1,5
0,0,10,10,11,15,26,36,29,65,0.000333,0.101843,5,1527.642908,84.86905,305.528582,96.657107,1,5
0,0,10,10,13,18,31,46,32,78,0.000333,0.128809,6,2318.563873,128.809104,386.427312,123.164366,3,5
0,0,30,30,21,51,72,134,105,239,0.000333,0.491537,20,29492.24151,1638.457861,1474.612075,381.532358,7,5
0,0,12,12,14,18,32,43,34,77,0.000333,0.128333,7,2695,149.722222,385,128.361619,2,5
0,0,34,34,20,55,75,147,119,266,0.000333,0.552289,20,33137.31543,1840.961969,1656.865772,404.413346,9,5
0,0,16,16,13,21,34,59,48,107,0.000333,0.181453,12,6532.302288,362.905683,544.358524,140.344382,3,5
0,0,17,17,13,22,35,67,52,119,0.000333,0.203462,12,7324.616148,406.923119,610.384679,146.213212,3,5
0,0,10,10,12,17,29,44,31,75,0.000333,0.12145,6,2186.091448,121.449525,364.348575,112.506418,3,5
0,0,18,18,14,23,37,67,55,122,0.000333,0.211851,14,8897.746348,494.319242,635.553311,157.344894,3,5
0,0,18,18,13,23,36,61,58,119,0.000333,0.205074,12,7382.652902,410.147383,615.221075,152.147641,3,5
0,0,10,10,13,18,31,46,32,78,0.000333,0.128809,6,2318.563873,128.809104,386.427312,123.164366,3,5
0,0,16,16,15,23,38,61,48,109,0.000333,0.190675,14,8008.337386,444.907633,572.024099,162.645284,2,5
0,0,17,17,14,23,37,62,54,116,0.000333,0.201432,14,8460.152266,470.008459,604.29659,157.344894,3,5
0,0,17,17,14,25,39,69,50,119,0.000333,0.209654,14,8805.480097,489.193339,628.962864,169.399374,6,5
0,0,32,32,21,50,71,170,104,274,0.000333,0.561677,20,33700.61422,1872.256345,1685.030711,374.431475,13,5
0,0,21,21,15,26,41,77,54,131,0.000333,0.233946,14,9825.750376,545.875021,701.839313,180.814792,6,5
0,0,32,32,21,50,71,170,104,274,0.000333,0.561677,20,33700.61422,1872.256345,1685.030711,374.431475,13,5
0,0,11,11,12,18,30,44,34,78,0.000333,0.127579,6,2296.424799,127.579155,382.737466,118.0782,3,5
0,0,32,32,21,50,71,170,104,274,0.000333,0.561677,20,33700.61422,1872.256345,1685.030711,374.431475,13,5
0,0,15,15,12,20,32,55,37,92,0.000333,0.153333,6,2760,153.333333,460,129.458112,5,5
0,0,32,32,21,50,71,170,104,274,0.000333,0.561677,20,33700.61422,1872.256345,1685.030711,374.431475,13,5
0,0,32,32,23,30,53,164,109,273,0.000333,0.521241,33,51602.83538,2866.824188,1563.722284,251.248643,12,5
0,0,39,39,22,33,55,192,127,319,0.000333,0.614751,33,60860.3737,3381.131872,1844.253749,264.572502,15,5
0,0,75,75,29,52,81,462,279,741,0.000333,1.565943,70,328848.0197,18269.33443,4697.828852,437.304314,44,5
0,0,44,44,28,53,81,231,150,381,0.000333,0.805161,28,67633.51983,3757.417768,2415.482851,438.185722,22,5
0,0,35,35,24,39,63,181,125,306,0.000333,0.609683,36,65845.71564,3658.095313,1829.047657,316.169787,19,5
0,0,30,30,24,32,56,162,113,275,0.000333,0.532341,36,57492.81373,3194.045207,1597.022604,270.0391,18,5
0,0,43,43,26,53,79,230,147,377,0.000333,0.792175,26,61789.65889,3432.758827,2376.525342,425.791217,21,5
0,0,34,34,21,39,60,180,122,302,0.000333,0.594627,30,53516.4288,2973.134933,1783.88096,298.369352,18,5
0,0,29,29,21,32,53,161,110,271,0.000333,0.517422,30,46567.9933,2587.110739,1552.266443,252.238666,17,5
0,0,26,26,22,34,56,143,96,239,0.000333,0.462653,22,30535.07218,1696.392899,1387.957826,271.081232,10,5
0,0,25,25,19,33,52,142,93,235,0.000333,0.446534,18,24112.86001,1339.603334,1339.603334,247.175629,9,5
0,0,32,32,16,35,51,215,122,337,0.000333,0.637202,24,45878.57617,2548.809787,1911.60734,243.524906,11,5
0,0,20,20,21,27,48,130,78,208,0.000333,0.387224,20,23233.444,1290.746889,1161.6722,220.620628,8,5
0,0,19,19,18,26,44,129,75,204,0.000333,0.371241,18,20047.0329,1113.72405,1113.72405,197.270083,7,5
0,0,22,22,18,31,49,115,67,182,0.000333,0.340626,18,18393.78945,1021.877192,1021.877192,228.638736,13,5
0,0,19,19,13,22,35,63,43,106,0.000333,0.181235,6,3262.223999,181.234667,543.704,146.213212,5,5
0,0,16,16,13,24,37,55,47,102,0.000333,0.177121,6,3188.18546,177.121414,531.364243,158.144816,3,5
0,0,54,54,21,52,73,272,181,453,0.000333,0.934664,30,84119.71576,4673.317542,2803.990525,388.661531,22,5
0,0,48,48,21,52,73,228,146,374,0.000333,0.771665,20,46299.8877,2572.215983,2314.994385,388.661531,19,5
0,0,32,32,20,52,72,152,102,254,0.000333,0.522387,10,15671.6095,870.644972,1567.16095,382.861427,14,5
0,0,32,32,20,52,72,152,102,254,0.000333,0.522387,10,15671.6095,870.644972,1567.16095,382.861427,14,5
0,0,28,28,19,44,63,131,87,218,0.000333,0.434349,9,11727.42321,651.523512,1303.047023,320.925614,14,5
0,0,32,32,20,51,71,152,101,253,0.000333,0.518629,10,15558.86021,864.381123,1555.886021,375.732254,14,5
0,0,32,32,20,51,71,152,101,253,0.000333,0.518629,10,15558.86021,864.381123,1555.886021,375.732254,14,5
0,0,30,30,20,43,63,135,89,224,0.000333,0.446304,20,26778.21406,1487.678559,1338.910703,319.767946,14,5
0,0,30,30,21,43,64,136,89,225,0.000333,0.45,20,27000,1500,1350,325.56805,14,5
0,0,32,32,20,51,71,152,101,253,0.000333,0.518629,10,15558.86021,864.381123,1555.886021,375.732254,14,5
0,0,21,21,16,28,44,78,55,133,0.000333,0.242035,8,5808.835242,322.713069,726.104405,198.605938,6,5
0,0,17,17,14,26,40,68,49,117,0.000333,0.207555,7,4358.65911,242.147728,622.665587,175.514402,6,5
0,0,17,17,14,26,40,68,51,119,0.000333,0.211103,7,4433.166103,246.287006,633.309443,175.514402,6,5
0,0,45,45,25,60,85,175,134,309,0.000333,0.660167,24,47532.04318,2640.669066,1980.501799,470.50984,11,5
0,0,15,15,14,25,39,62,47,109,0.000333,0.192036,7,4032.761893,224.042327,576.108842,169.399374,4,5
0,0,17,17,14,27,41,68,51,119,0.000333,0.212516,7,4462.84082,247.935601,637.548689,181.684931,6,5
0,0,17,17,14,27,41,68,51,119,0.000333,0.212516,7,4462.84082,247.935601,637.548689,181.684931,6,5
0,0,17,17,14,26,40,68,49,117,0.000333,0.207555,7,4358.65911,242.147728,622.665587,175.514402,6,5
0,0,32,32,20,51,71,158,106,264,0.000333,0.541178,20,32470.66479,1803.925822,1623.53324,375.732254,12,5
0,0,33,33,20,51,71,164,108,272,0.000333,0.557577,20,33454.62433,1858.590241,1672.731217,375.732254,12,5
0,0,34,34,20,56,76,154,110,264,0.000333,0.549818,10,16494.52864,916.362702,1649.452864,411.650438,13,5
0,0,45,45,21,57,78,197,133,330,0.000333,0.691394,20,41483.65464,2304.64748,2074.182732,424.713397,14,5
0,0,34,34,20,55,75,154,108,262,0.000333,0.543983,10,16319.50497,906.639165,1631.950497,404.413346,13,5
0,0,17,17,15,25,40,69,48,117,0.000333,0.207555,7,4358.65911,242.147728,622.665587,174.699764,6,5
0,0,17,17,15,24,39,69,48,117,0.000333,0.206131,14,8657.488834,480.971602,618.39206,168.642459,6,5
0,0,18,18,15,25,40,72,53,125,0.000333,0.221747,14,9313.374166,517.409676,665.241012,174.699764,5,5
0,0,15,15,14,23,37,63,46,109,0.000333,0.189277,14,7949.625836,441.64588,567.830417,157.344894,4,5
0,0,34,34,20,55,75,154,108,262,0.000333,0.543983,10,16319.50497,906.639165,1631.950497,404.413346,13,5
0,0,35,35,21,51,72,182,112,294,0.000333,0.604653,20,36279.15901,2015.508834,1813.95795,381.532358,13,5
0,0,34,34,22,51,73,177,110,287,0.000333,0.59216,22,39082.55227,2171.252904,1776.479648,387.401188,13,5
0,0,12,12,21,16,37,79,52,131,0.000333,0.227479,30,20473.15173,1137.397318,682.438391,156.238666,5,5
0,0,38,38,24,46,70,235,140,375,0.000333,0.76616,36,82745.32073,4596.962263,2298.481131,364.12295,18,5
0,0,36,36,24,46,70,209,129,338,0.000333,0.690566,24,49720.74383,2762.263546,2071.69766,364.12295,16,5
0,0,31,31,25,53,78,197,124,321,0.000333,0.672538,24,48422.73869,2690.15215,2017.614112,419.676189,13,5
0,0,24,24,17,33,50,121,73,194,0.000333,0.364969,16,17518.52961,973.251645,1094.908101,235.951874,15,5
0,0,27,27,20,38,58,142,86,228,0.000333,0.445207,20,26712.39334,1484.021852,1335.619667,285.859807,16,5
0,0,43,43,24,43,67,286,160,446,0.000333,0.901825,36,97397.12804,5410.951558,2705.475779,343.368484,21,5
0,0,43,43,26,47,73,255,155,410,0.000333,0.845943,39,98975.2947,5498.627483,2537.828069,383.277109,19,5
0,0,42,42,24,46,70,258,150,408,0.000333,0.833582,36,90026.90895,5001.494942,2500.747471,364.12295,19,5
0,0,49,49,22,45,67,252,154,406,0.000333,0.820944,33,81273.46297,4515.192387,2462.832211,345.240885,24,5
0,0,50,50,25,51,76,258,165,423,0.000333,0.880958,36,95143.44018,5285.746676,2642.873338,405.390097,20,5
0,0,27,27,26,40,66,155,96,251,0.000333,0.505714,26,39445.71602,2191.428668,1517.142924,335.088556,13,5
0,0,26,26,26,45,71,142,99,241,0.000333,0.49403,26,38534.31545,2140.795303,1482.089056,369.344822,10,5
0,0,16,16,20,36,56,100,66,166,0.000333,0.32134,10,9640.209171,535.567176,964.020917,272.555862,9,5
0,0,54,54,23,60,83,292,187,479,0.000333,1.017881,33,100770.2483,5598.347127,3053.643888,458.455361,26,5
0,0,41,41,24,56,80,260,142,402,0.000333,0.847138,24,60993.96226,3388.553459,2541.415094,435.250976,22,5
0,0,39,39,24,56,80,245,137,382,0.000333,0.804992,24,57959.43677,3219.96871,2414.976532,435.250976,20,5
0,0,41,41,24,56,80,267,151,418,0.000333,0.880855,24,63421.58265,3523.421258,2642.565944,435.250976,26,5
0,0,30,30,17,32,49,167,107,274,0.000333,0.51281,24,36922.33194,2051.240663,1538.430497,229.486868,10,5
0,0,11,11,17,16,33,70,47,117,0.000333,0.196731,16,9443.105791,524.616988,590.194112,133.486868,3,5
0,0,23,23,14,60,74,150,93,243,0.000333,0.502966,7,10562.28018,586.793343,1508.897168,407.716405,9,5
0,0,19,19,14,44,58,126,74,200,0.000333,0.390532,7,8201.173393,455.620744,1171.596199,293.51796,7,5
0,0,30,30,20,58,78,166,109,275,0.000333,0.576162,10,17284.8561,960.269783,1728.48561,426.20146,11,5
0,0,50,50,27,54,81,261,161,422,0.000333,0.891806,26,69560.83423,3864.490791,2675.416701,439.145888,26,5
0,0,49,49,29,59,88,233,151,384,0.000333,0.826807,28,69451.80876,3858.43382,2480.421742,487.957389,22,5
0,0,38,38,21,50,71,225,140,365,0.000333,0.748219,20,44893.15397,2494.06411,2244.657699,374.431475,16,5
0,0,28,28,25,52,77,155,106,261,0.000333,0.54521,24,39255.15089,2180.841716,1635.631287,412.51927,11,5
0,0,41,41,30,52,82,195,128,323,0.000333,0.684496,30,61604.67893,3422.482162,2053.489297,443.629583,13,5
0,0,10,10,15,23,38,55,39,94,0.000333,0.164435,7,3453.136304,191.840906,493.305186,162.645284,4,5
0,0,45,45,26,54,80,274,165,439,0.000333,0.925109,39,108237.7309,6013.207273,2775.326434,432.975358,14,5
0,0,44,44,24,48,72,327,184,511,0.000333,1.050944,36,113501.9403,6305.663351,3152.831676,378.1173,14,5
0,0,31,31,25,52,77,181,120,301,0.000333,0.628768,24,45271.26597,2515.070332,1886.302749,412.51927,12,5
0,0,32,32,24,47,71,181,121,302,0.000333,0.619075,24,44573.36712,2476.298173,1857.22363,371.104776,10,5
0,0,36,36,24,47,71,195,133,328,0.000333,0.672372,24,48410.80933,2689.489407,2017.117055,371.104776,11,5
0,0,28,28,23,25,48,146,101,247,0.000333,0.459829,44,60697.37246,3372.076248,1379.485738,220.13833,8,5
0,0,26,26,23,50,73,144,99,243,0.000333,0.501376,11,16545.40105,919.188947,1504.127368,386.234734,11,5
0,0,27,27,22,45,67,144,100,244,0.000333,0.493375,22,32562.76677,1809.042599,1480.125762,345.240885,9,5
0,0,31,31,22,45,67,158,112,270,0.000333,0.545948,22,36032.56979,2001.809433,1637.844081,345.240885,10,5
0,0,23,23,20,22,42,109,80,189,0.000333,0.339716,30,30574.43979,1698.579988,1019.147993,184.546058,7,5
0,0,27,27,22,44,66,161,97,258,0.000333,0.519818,22,34307.98102,1905.998946,1559.453683,338.322487,10,5
0,0,49,49,26,62,88,254,163,417,0.000333,0.897861,26,70033.15761,3890.730978,2693.582985,491.371604,24,5
0,0,58,58,27,66,93,301,192,493,0.000333,1.074602,26,83818.93764,4656.607647,3223.805294,527.311974,30,5
0,0,54,54,21,55,76,258,167,425,0.000333,0.885123,30,79661.0758,4425.615322,2655.369193,410.21345,21,5
0,0,43,43,19,37,56,198,131,329,0.000333,0.636873,27,51586.73377,2865.929654,1910.619769,273.460397,12,5
0,0,41,41,23,42,65,227,132,359,0.000333,0.720677,33,71346.99148,3963.721749,2162.030045,330.519257,28,5
0,0,30,30,22,33,55,211,123,334,0.000333,0.643658,33,63722.14676,3540.119265,1930.974144,264.572502,13,5
0,0,27,27,22,32,54,207,114,321,0.000333,0.615773,33,60961.52331,3386.751295,1847.318888,258.107496,12,5
0,0,19,19,22,35,57,121,73,194,0.000333,0.377194,22,24894.77458,1383.043032,1131.580663,277.632401,13,5
0,0,26,26,24,40,64,149,91,240,0.000333,0.48,24,34560,1920,1440,322.916224,16,5
0,0,31,31,23,48,71,179,110,289,0.000333,0.592426,22,39100.09219,2172.227344,1777.276918,372.120125,24,5
0,0,67,67,18,55,73,379,236,615,0.000333,1.268914,36,137042.7157,7613.484207,3806.742104,393.033434,21,5
0,0,35,35,25,52,77,201,125,326,0.000333,0.680991,24,49031.33789,2723.963216,2042.972412,412.51927,16,5
0,0,34,34,25,48,73,192,119,311,0.000333,0.641678,24,46200.85051,2566.713917,1925.035438,384.174605,14,5
0,0,38,38,25,48,73,236,142,378,0.000333,0.779918,24,56154.0884,3119.671578,2339.753683,384.174605,18,5
0,0,26,26,18,31,49,126,75,201,0.000333,0.376186,18,20314.02022,1128.556679,1128.556679,228.638736,14,5
0,0,23,23,18,30,48,111,68,179,0.000333,0.333236,18,17994.74918,999.708288,999.708288,222.265368,13,5
0,0,13,13,14,15,29,65,35,100,0.000333,0.161933,14,6801.173393,377.842966,485.7981,111.906328,8,5
0,0,15,15,14,18,32,109,43,152,0.000333,0.253333,14,10640,591.111111,760,128.361619,5,5
0,0,74,74,26,81,107,484,258,742,0.000333,1.66739,39,195084.5717,10838.03176,5002.168504,635.739283,40,5
0,0,48,48,23,60,83,261,167,428,0.000333,0.909506,22,60027.37129,3334.85396,2728.516877,458.455361,24,5
0,0,28,28,25,44,69,175,102,277,0.000333,0.56402,24,40609.47059,2256.081699,1692.061275,356.311396,14,5
0,0,28,28,17,40,57,120,83,203,0.000333,0.394692,16,18945.22677,1052.512598,1184.076673,282.363992,9,5
0,0,11,11,17,16,33,70,47,117,0.000333,0.196731,16,9443.105791,524.616988,590.194112,133.486868,3,5
0,0,24,24,21,35,56,147,92,239,0.000333,0.462653,20,27759.15653,1542.175363,1387.957826,271.763571,11,5
0,0,23,23,18,35,53,146,89,235,0.000333,0.448687,18,24229.10352,1346.061307,1346.061307,254.583556,10,5
0,0,23,23,18,31,49,119,69,188,0.000333,0.351855,18,19000.17811,1055.565451,1055.565451,228.638736,14,5
0,0,88,88,24,97,121,682,246,928,0.000333,2.140235,24,154096.922,8560.940112,6420.705084,750.230646,21,5
0,0,32,32,21,27,48,202,130,332,0.000333,0.618069,40,74168.30201,4120.461223,1854.20755,220.620628,14,5
0,0,87,87,22,96,118,685,241,926,0.000333,2.124442,22,140213.2042,7789.622456,6373.327464,730.263896,21,5
0,0,31,31,19,26,45,205,125,330,0.000333,0.604104,36,65243.21478,3624.623044,1812.311522,202.922055,14,5
0,0,36,36,20,31,51,195,123,318,0.000333,0.601277,30,54114.93776,3006.385431,1803.831259,240.018648,20,5
0,0,44,44,24,57,81,250,160,410,0.000333,0.866446,24,62384.12403,3465.784668,2599.338501,442.513831,17,5
0,0,45,45,18,56,74,192,140,332,0.000333,0.68718,18,37107.69331,2061.538517,2061.538517,400.270526,17,5
0,0,24,24,21,35,56,147,92,239,0.000333,0.462653,20,27759.15653,1542.175363,1387.957826,271.763571,11,5
0,0,23,23,18,35,53,146,89,235,0.000333,0.448687,18,24229.10352,1346.061307,1346.061307,254.583556,10,5
0,0,60,60,30,70,100,289,191,480,0.000333,1.063017,30,95671.52913,5315.084952,3189.050971,576.256529,30,5
0,0,54,54,23,56,79,235,157,392,0.000333,0.823694,22,54363.80517,3020.211398,2471.082053,429.253801,23,5
0,0,47,47,18,35,53,196,137,333,0.000333,0.635799,27,51499.73281,2861.096267,1907.397511,254.583556,22,5
0,0,58,58,23,56,79,248,169,417,0.000333,0.876226,33,86746.32688,4819.240382,2628.676572,429.253801,26,5
0,0,60,60,31,73,104,301,200,501,0.000333,1.118973,30,100707.609,5594.867165,3356.920299,605.437278,24,5
0,0,43,43,20,39,59,189,132,321,0.000333,0.629443,30,56649.85257,3147.214031,1888.328419,292.569248,12,5
0,0,56,56,24,62,86,256,175,431,0.000333,0.92324,24,66473.28262,3692.960146,2769.720109,479.199271,15,5
0,0,15,15,21,29,50,96,59,155,0.000333,0.291599,20,17495.95419,971.997455,874.797709,233.120115,7,5
0,0,22,22,23,34,57,124,77,201,0.000333,0.390804,22,25793.03964,1432.946647,1172.410893,277.015662,10,5
0,0,15,15,19,28,47,94,58,152,0.000333,0.281433,18,15197.3551,844.297505,844.297505,215.316561,10,5
0,0,22,22,21,33,54,122,76,198,0.000333,0.379823,20,22789.35451,1266.07525,1139.467725,258.703672,14,5
0,0,12,12,21,16,37,79,52,131,0.000333,0.227479,30,20473.15173,1137.397318,682.438391,156.238666,5,5
0,0,100,100,29,67,96,550,425,975,0.000333,2.140113,84,539308.4288,29961.57938,6420.338438,547.309425,40,5
0,0,94,94,29,65,94,537,413,950,0.000333,2.07562,84,523056.1904,29058.67724,6226.859409,532.335357,40,5
0,0,106,106,30,101,131,473,386,859,0.000333,2.013903,45,271876.9661,15104.2759,6041.710358,819.686078,26,5
0,0,99,99,29,100,129,450,368,818,0.000333,1.911728,42,240877.7236,13382.09576,5735.183895,805.267068,25,5
0,0,65,65,27,53,80,306,250,556,0.000333,1.171664,52,182779.5851,10154.42139,3514.992021,431.961747,25,5
0,0,59,59,27,51,78,293,238,531,0.000333,1.112516,52,173552.5261,9641.807004,3337.548578,417.675655,25,5
0,0,19,19,19,33,52,92,61,153,0.000333,0.290722,9,7849.505492,436.083638,872.167277,247.175629,11,5
0,0,22,22,19,34,53,108,68,176,0.000333,0.336038,18,18146.052,1008.114,1008.114,253.684359,13,5
0,0,72,72,26,102,128,408,304,712,0.000333,1.661333,26,129584,7199.111111,4984,802.798818,16,5
0,0,69,69,26,100,126,403,297,700,0.000333,1.628032,26,126986.4946,7054.805256,4884.095946,786.597052,15,5
0,0,99,99,29,110,139,526,393,919,0.000333,2.180769,42,274776.8875,15265.38264,6542.306846,886.831017,29,5
0,0,56,56,25,84,109,296,237,533,0.000333,1.202481,24,86578.61388,4809.922993,3607.442245,653.051068,14,5
0,0,24,24,16,40,56,114,89,203,0.000333,0.392964,16,18862.28879,1047.904933,1178.893049,276.877124,5,5
0,0,20,20,14,32,46,124,69,193,0.000333,0.355349,14,14924.66441,829.148023,1066.047458,213.302969,7,5
0,0,19,19,14,36,50,93,61,154,0.000333,0.289718,7,6084.076973,338.004276,869.153853,239.420269,7,5
0,0,20,20,19,30,49,102,63,165,0.000333,0.308809,18,16675.68824,926.427124,926.427124,227.917341,7,5
0,0,22,22,19,31,50,118,70,188,0.000333,0.353682,18,19098.80935,1061.044964,1061.044964,234.290708,8,5
0,0,40,40,22,39,61,226,118,344,0.000333,0.680058,33,67325.73026,3740.318348,2040.173644,304.238182,28,5
0,0,34,34,29,52,81,180,121,301,0.000333,0.636098,28,53432.25582,2968.458657,1908.294851,437.304314,18,5
0,0,41,41,28,55,83,208,139,347,0.000333,0.73738,28,61939.88312,3441.104617,2212.138683,452.580722,21,5
0,0,61,61,24,62,86,343,204,547,0.000333,1.171722,36,126546.0056,7030.333642,3515.166821,479.199271,26,5
0,0,26,26,20,38,58,134,84,218,0.000333,0.42568,20,25540.79714,1418.933174,1277.039857,285.859807,16,5
0,0,36,36,23,48,71,219,137,356,0.000333,0.72977,22,48164.81944,2675.823302,2189.309975,372.120125,13,5
0,0,17,17,21,35,56,150,80,230,0.000333,0.445231,20,26713.83264,1484.101813,1335.691632,271.763571,13,5
0,0,32,32,20,48,68,189,107,296,0.000333,0.60063,20,36037.78002,2002.09889,1801.889001,354.516762,19,5
0,0,33,33,20,48,68,189,109,298,0.000333,0.604688,20,36281.27853,2015.626585,1814.063927,354.516762,21,5
0,0,47,47,21,50,71,224,143,367,0.000333,0.752319,20,45139.14386,2507.730214,2256.957193,374.431475,25,5
0,0,49,49,23,52,75,234,151,385,0.000333,0.799365,22,52758.09431,2931.005239,2398.095196,400.46479,25,5
0,0,26,26,24,43,67,174,101,275,0.000333,0.556058,24,40036.18866,2224.232703,1668.174527,343.368484,15,5
0,0,50,50,27,68,95,249,174,423,0.000333,0.92635,26,72255.27198,4014.181777,2779.048922,542.329436,24,5
0,0,38,38,26,45,71,211,125,336,0.000333,0.688772,26,53724.19084,2984.677269,2066.315032,369.344822,22,5
0,0,46,46,23,42,65,272,148,420,0.000333,0.843131,33,83470.01789,4637.223216,2529.394481,330.519257,30,5
0,0,25,25,20,36,56,149,84,233,0.000333,0.451038,20,27062.27394,1503.459663,1353.113697,272.555862,13,5
0,0,32,32,19,39,58,179,100,279,0.000333,0.544792,18,29418.78056,1634.376698,1634.376698,286.841309,17,5
0,0,39,39,25,39,64,245,142,387,0.000333,0.774,36,83592,4644,2322,322.227091,20,5
0,0,34,34,24,42,66,194,120,314,0.000333,0.632647,24,45550.55408,2530.586338,1897.939753,336.516432,17,5
0,0,33,33,22,42,64,193,117,310,0.000333,0.62,22,40920,2273.333333,1860,324.584827,16,5
0,0,36,36,28,48,76,209,124,333,0.000333,0.69352,28,58255.67614,3236.426452,2080.559862,402.684138,18,5
0,0,31,31,25,41,66,181,114,295,0.000333,0.594365,24,42794.31037,2377.461687,1783.096265,335.756037,16,5
0,0,31,31,25,43,68,174,113,287,0.000333,0.582367,24,41930.44405,2329.469114,1747.101835,349.425789,16,5
0,0,26,26,22,41,63,148,94,242,0.000333,0.482167,22,31823.03831,1767.946573,1446.501741,317.767128,15,5
0,0,29,29,28,55,83,162,117,279,0.000333,0.592879,28,49801.80804,2766.767113,1778.636001,452.580722,22,5
0,0,24,24,24,29,53,131,94,225,0.000333,0.429594,36,46396.15568,2577.564205,1288.782102,250.920549,16,5
0,0,32,32,27,53,80,172,127,299,0.000333,0.630086,26,49146.66901,2730.370501,1890.2565,431.961747,24,5
0,0,24,24,25,53,78,132,97,229,0.000333,0.479786,12,17272.2853,959.571405,1439.357108,419.676189,18,5
0,0,19,19,20,26,46,101,74,175,0.000333,0.322208,20,19332.46685,1074.025936,966.623342,208.649995,12,5
0,0,27,27,24,51,75,142,107,249,0.000333,0.516992,24,37223.42049,2067.967805,1550.975854,399.332792,20,5
0,0,58,58,30,54,84,393,207,600,0.000333,1.278463,45,172592.5704,9588.476134,3835.390454,457.970643,23,5
0,0,40,40,26,51,77,239,137,376,0.000333,0.785437,26,61264.10522,3403.561401,2356.311739,411.505125,32,5
0,0,54,54,24,51,75,318,179,497,0.000333,1.031908,36,111446.024,6191.445778,3095.722889,399.332792,31,5
0,0,12,12,21,16,37,79,52,131,0.000333,0.227479,30,20473.15173,1137.397318,682.438391,156.238666,5,5
0,0,41,41,26,51,77,234,138,372,0.000333,0.777082,26,60612.35942,3367.353301,2331.244593,411.505125,22,5
0,0,34,34,26,49,75,191,118,309,0.000333,0.641568,26,50042.32936,2780.129409,1924.704975,397.332215,15,5
0,0,41,41,28,54,82,219,136,355,0.000333,0.75231,28,63194.06693,3510.781496,2256.930962,445.369863,18,5
0,0,43,43,28,53,81,245,146,391,0.000333,0.826294,28,69408.67783,3856.037657,2478.881351,438.185722,22,5
0,0,37,37,23,54,77,193,119,312,0.000333,0.651746,22,43015.22282,2389.734601,1955.237401,414.80585,19,5
0,0,25,25,17,36,53,130,78,208,0.000333,0.397136,16,19062.51927,1059.028848,1191.407455,255.604168,14,5
0,0,11,11,17,16,33,70,47,117,0.000333,0.196731,16,9443.105791,524.616988,590.194112,133.486868,3,5
0,0,27,27,24,36,60,167,102,269,0.000333,0.529651,24,38134.88569,2118.60476,1588.95357,296.1564,10,5
0,0,26,26,21,35,56,166,99,265,0.000333,0.512983,20,30778.98109,1709.943394,1538.949054,271.763571,9,5
0,0,31,31,25,33,58,217,124,341,0.000333,0.665857,36,71912.5747,3995.143039,1997.571519,282.561411,13,5
0,0,12,12,21,16,37,79,52,131,0.000333,0.227479,30,20473.15173,1137.397318,682.438391,156.238666,5,5
0,0,11,11,17,16,33,70,47,117,0.000333,0.196731,16,9443.105791,524.616988,590.194112,133.486868,3,5
0,0,11,11,17,16,33,70,47,117,0.000333,0.196731,16,9443.105791,524.616988,590.194112,133.486868,3,5
0,0,76,76,25,87,112,514,273,787,0.000333,1.785796,36,192865.9797,10714.77665,5357.388324,676.632489,40,5
0,0,12,12,21,16,37,79,52,131,0.000333,0.227479,30,20473.15173,1137.397318,682.438391,156.238666,5,5
0,0,41,41,26,49,75,268,163,431,0.000333,0.894874,39,104700.2134,5816.67852,2684.620856,397.332215,18,5
0,0,24,24,20,44,64,183,98,281,0.000333,0.562,20,33720,1873.333333,1686,326.653553,18,5
0,0,30,30,17,52,69,164,102,266,0.000333,0.541623,8,12998.94004,722.163336,1624.867506,365.909734,16,5
0,0,44,44,28,54,82,263,154,417,0.000333,0.8837,28,74230.77721,4123.932067,2651.099186,445.369863,20,5
0,0,28,28,26,50,76,209,115,324,0.000333,0.674776,26,52632.54137,2924.030076,2024.328514,404.404242,16,5
0,0,30,30,26,50,76,211,119,330,0.000333,0.687272,26,53607.21807,2978.178781,2061.816079,404.404242,17,5
0,0,17,17,23,32,55,112,72,184,0.000333,0.35459,22,23402.94412,1300.163562,1063.770187,264.041925,7,5
0,0,12,12,19,27,46,79,51,130,0.000333,0.239354,9,6462.567489,359.031527,718.063054,209.092585,6,5
0,0,29,29,22,41,63,163,103,266,0.000333,0.529985,22,34979.04211,1943.280117,1589.95646,317.767128,18,5
0,0,55,55,30,66,96,269,180,449,0.000333,0.985549,30,88699.44489,4927.746938,2956.648163,546.13673,26,5
0,0,49,49,23,52,75,216,146,362,0.000333,0.751611,22,49606.31205,2755.906225,2254.832366,400.46479,17,5
0,0,47,47,20,36,56,201,138,339,0.000333,0.656231,30,59060.79956,3281.155531,1968.693319,272.555862,16,5
0,0,53,53,23,52,75,230,158,388,0.000333,0.805594,33,79753.79451,4430.766362,2416.781652,400.46479,18,5
0,0,41,41,26,55,81,266,135,401,0.000333,0.847427,26,66099.27613,3672.182007,2542.279851,440.186217,13,5
0,0,40,40,23,55,78,265,132,397,0.000333,0.831768,22,54896.70298,3049.816832,2495.304681,422.016709,12,5
0,0,31,31,28,50,78,171,113,284,0.000333,0.595018,28,49981.51844,2776.751025,1785.05423,416.798747,18,5
0,0,38,38,27,53,80,199,131,330,0.000333,0.695412,26,54242.14305,3013.452392,2086.236271,431.961747,22,5
0,0,20,20,21,27,48,126,78,204,0.000333,0.379777,20,22786.647,1265.924833,1139.33235,220.620628,8,5
0,0,19,19,18,26,44,125,75,200,0.000333,0.363962,18,19653.95383,1091.886324,1091.886324,197.270083,7,5
0,0,11,11,17,16,33,70,47,117,0.000333,0.196731,16,9443.105791,524.616988,590.194112,133.486868,3,5
0,0,44,44,27,59,86,284,155,439,0.000333,0.940377,26,73349.38591,4074.965884,2821.130227,475.457902,33,5
0,0,45,45,27,59,86,284,157,441,0.000333,0.944661,26,73683.55168,4093.530649,2833.982757,475.457902,33,5
0,0,37,37,18,51,69,229,125,354,0.000333,0.720806,18,38923.51784,2162.417658,2162.417658,364.352342,17,5
0,0,35,35,18,51,69,214,120,334,0.000333,0.680082,18,36724.44903,2040.247169,2040.247169,364.352342,15,5
0,0,34,34,23,49,72,202,121,323,0.000333,0.664295,22,43843.48706,2435.749281,1992.885775,379.162707,14,5
0,0,36,36,23,50,73,232,137,369,0.000333,0.761348,22,50248.99577,2791.610876,2284.045262,386.234734,17,5
0,0,40,40,25,51,76,222,144,366,0.000333,0.762247,24,54881.79528,3048.988627,2286.74147,405.390097,20,5
0,0,36,36,25,49,74,216,129,345,0.000333,0.714087,24,51414.27387,2856.348548,2142.261411,391.217187,19,5
0,0,29,29,25,44,69,183,104,287,0.000333,0.584382,24,42075.51646,2337.528692,1753.146519,356.311396,16,5
0,0,25,25,22,45,67,135,87,222,0.000333,0.448891,11,14813.3898,822.9661,1346.6718,345.240885,16,5
0,0,28,28,22,39,61,149,94,243,0.000333,0.48039,22,31705.72181,1761.428989,1441.169173,304.238182,17,5
0,0,72,72,19,81,100,713,167,880,0.000333,1.948864,18,105238.682,5846.593447,5846.593447,594.238473,19,5
0,0,20,20,16,35,51,116,67,183,0.000333,0.346018,8,8304.430701,461.357261,1038.053838,243.524906,7,5
0,0,30,30,24,42,66,175,110,285,0.000333,0.574217,24,41343.65578,2296.869765,1722.652324,336.516432,15,5
0,0,29,29,21,42,63,174,107,281,0.000333,0.559872,20,33592.31317,1866.239621,1679.615659,318.715998,14,5
0,0,21,21,17,37,54,92,61,153,0.000333,0.293499,8,7043.982303,391.33235,880.497788,262.236643,9,5
0,0,39,39,25,47,72,222,131,353,0.000333,0.725995,24,52271.60461,2903.978034,2177.983526,377.162081,22,5
0,0,29,29,24,44,68,165,101,266,0.000333,0.539755,24,38862.36278,2159.020154,1619.265116,350.254091,15,5
0,0,36,36,25,48,73,193,119,312,0.000333,0.643742,24,46349.4063,2574.967016,1931.225262,384.174605,18,5
0,0,45,45,24,51,75,291,162,453,0.000333,0.940552,36,101579.5752,5643.309734,2821.654867,399.332792,24,5
0,0,44,44,26,51,77,249,147,396,0.000333,0.827216,26,64522.83422,3584.601901,2481.64747,411.505125,20,5
0,0,18,18,17,36,53,84,58,142,0.000333,0.271122,8,6506.917636,361.495424,813.364705,255.604168,6,5
0,0,9,9,14,12,26,44,25,69,0.000333,0.10811,14,4540.624768,252.256932,324.330341,96.322519,5,5
0,0,19,19,20,34,54,109,69,178,0.000333,0.341457,20,20487.39951,1138.188862,1024.369975,259.412299,8,5
0,0,21,21,20,35,55,131,76,207,0.000333,0.398914,20,23934.82921,1329.712734,1196.741461,265.963467,9,5
0,0,32,32,19,50,69,158,102,260,0.000333,0.529405,18,28587.89446,1588.216359,1588.216359,362.903432,12,5
0,0,34,34,20,55,75,152,111,263,0.000333,0.54606,20,32763.58631,1820.19924,1638.179316,404.413346,11,5
0,0,39,39,21,57,78,175,130,305,0.000333,0.639016,20,38340.95354,2130.052974,1917.047677,424.713397,11,5
0,0,14,14,15,20,35,55,42,97,0.000333,0.165847,14,6965.566337,386.975908,497.540453,145.041921,3,5
0,0,36,36,21,54,75,162,120,282,0.000333,0.585509,20,35130.53741,1951.696523,1756.526871,403.002591,9,5
0,0,14,14,13,18,31,49,38,87,0.000333,0.143672,12,5172.180948,287.343386,431.015079,123.164366,3,5
0,0,14,14,14,20,34,56,42,98,0.000333,0.16619,14,6979.999018,387.777723,498.571358,139.741531,3,5
0,0,14,14,15,20,35,55,42,97,0.000333,0.165847,14,6965.566337,386.975908,497.540453,145.041921,3,5
0,0,12,12,12,17,29,44,32,76,0.000333,0.123069,6,2215.239334,123.068852,369.206556,112.506418,3,5
0,0,22,22,15,29,44,90,70,160,0.000333,0.29117,14,12229.12683,679.395935,873.509059,199.484808,4,5
0,0,15,15,13,19,32,53,40,93,0.000333,0.155,12,5580,310,465,128.816339,3,5
0,0,31,31,20,52,72,139,101,240,0.000333,0.493594,10,14807.82,822.656667,1480.782,382.861427,9,5
0,0,12,12,12,17,29,44,32,76,0.000333,0.123069,6,2215.239334,123.068852,369.206556,112.506418,3,5
0,0,32,32,20,57,77,176,115,291,0.000333,0.607878,20,36472.69767,2026.260981,1823.634883,418.913293,12,5
0,0,29,29,20,54,74,163,105,268,0.000333,0.554711,10,16641.33502,924.518612,1664.133502,397.202487,10,5
0,0,12,12,12,17,29,44,32,76,0.000333,0.123069,6,2215.239334,123.068852,369.206556,112.506418,3,5
0,0,12,12,12,17,29,44,32,76,0.000333,0.123069,6,2215.239334,123.068852,369.206556,112.506418,3,5
0,0,17,17,15,24,39,67,51,118,0.000333,0.207892,14,8731.484466,485.08247,623.677462,168.642459,4,5
0,0,19,19,15,23,38,72,57,129,0.000333,0.225661,14,9477.757089,526.542061,676.982649,162.645284,3,5
0,0,14,14,14,20,34,56,42,98,0.000333,0.16619,14,6979.999018,387.777723,498.571358,139.741531,3,5
0,0,27,27,20,44,64,139,88,227,0.000333,0.454,20,27240,1513.333333,1362,326.653553,10,5
0,0,30,30,19,48,67,149,93,242,0.000333,0.489331,9,13211.94226,733.996792,1467.993584,348.788823,11,5
0,0,12,12,12,17,29,44,32,76,0.000333,0.123069,6,2215.239334,123.068852,369.206556,112.506418,3,5
0,0,30,30,19,48,67,149,93,242,0.000333,0.489331,9,13211.94226,733.996792,1467.993584,348.788823,11,5
0,0,31,31,19,51,70,156,101,257,0.000333,0.525075,9,14177.03162,787.612868,1575.225735,370.004315,12,5
0,0,14,14,15,20,35,55,42,97,0.000333,0.165847,14,6965.566337,386.975908,497.540453,145.041921,3,5
0,0,14,14,14,20,34,56,42,98,0.000333,0.16619,14,6979.999018,387.777723,498.571358,139.741531,3,5
0,0,20,20,15,24,39,76,59,135,0.000333,0.237843,14,9989.410194,554.967233,713.5293,168.642459,3,5
0,0,30,30,19,48,67,152,99,251,0.000333,0.507529,18,27406.59096,1522.588387,1522.588387,348.788823,11,5
0,0,29,29,19,45,64,146,94,240,0.000333,0.48,18,25920,1440,1440,327.844012,9,5
0,0,30,30,20,45,65,147,92,239,0.000333,0.479782,20,28786.91815,1599.27323,1439.345907,333.571951,10,5
0,0,28,28,19,46,65,143,90,233,0.000333,0.467737,9,12628.9053,701.60585,1403.2117,334.794473,10,5
0,0,28,28,19,46,65,143,90,233,0.000333,0.467737,9,12628.9053,701.60585,1403.2117,334.794473,10,5
0,0,30,30,21,45,66,148,92,240,0.000333,0.483552,20,29013.09177,1611.838432,1450.654589,339.372055,10,5
0,0,28,28,19,45,64,143,89,232,0.000333,0.464,9,12528,696,1392,327.844012,10,5
0,0,28,28,19,45,64,143,89,232,0.000333,0.464,9,12528,696,1392,327.844012,10,5
0,0,28,28,19,44,63,143,89,232,0.000333,0.462243,18,24961.12096,1386.728942,1386.728942,320.925614,10,5
0,0,31,31,19,50,69,156,100,256,0.000333,0.521261,18,28148.0807,1563.782261,1563.782261,362.903432,12,5
0,0,31,31,20,47,67,154,100,254,0.000333,0.513596,20,30815.73309,1711.985172,1540.786654,347.504238,11,5
0,0,32,32,19,50,69,159,105,264,0.000333,0.53755,18,29027.70822,1612.650457,1612.650457,362.903432,11,5
0,0,31,31,19,50,69,156,100,256,0.000333,0.521261,18,28148.0807,1563.782261,1563.782261,362.903432,12,5
0,0,31,31,20,50,70,156,100,256,0.000333,0.523032,20,31381.92905,1743.440503,1569.096452,368.631371,12,5
0,0,31,31,19,51,70,156,101,257,0.000333,0.525075,9,14177.03162,787.612868,1575.225735,370.004315,12,5
0,0,31,31,19,51,70,156,101,257,0.000333,0.525075,9,14177.03162,787.612868,1575.225735,370.004315,12,5
0,0,32,32,22,50,72,162,106,268,0.000333,0.55118,22,36377.87781,2020.993212,1653.5399,380.300305,12,5
0,0,33,33,21,50,71,161,103,264,0.000333,0.541178,20,32470.66479,1803.925822,1623.53324,374.431475,12,5
0,0,34,34,19,50,69,165,107,272,0.000333,0.55384,18,29907.33574,1661.518652,1661.518652,362.903432,12,5
0,0,33,33,19,50,69,165,107,272,0.000333,0.55384,18,29907.33574,1661.518652,1661.518652,362.903432,11,5
0,0,28,28,20,45,65,143,89,232,0.000333,0.46573,10,13971.89333,776.216296,1397.189333,333.571951,10,5
0,0,28,28,19,46,65,143,90,233,0.000333,0.467737,9,12628.9053,701.60585,1403.2117,334.794473,10,5
0,0,33,33,20,56,76,169,110,279,0.000333,0.581057,10,17431.71776,968.428765,1743.171776,411.650438,13,5
0,0,33,33,20,57,77,169,111,280,0.000333,0.5849,10,17547.00231,974.833462,1754.700231,418.913293,13,5
0,0,33,33,20,56,76,169,111,280,0.000333,0.58314,10,17494.19704,971.899835,1749.419704,411.650438,13,5
0,0,31,31,20,50,70,156,100,256,0.000333,0.523032,20,31381.92905,1743.440503,1569.096452,368.631371,12,5
0,0,35,35,22,56,78,174,113,287,0.000333,0.601303,22,39686.02961,2204.779423,1803.910437,423.319371,13,5
0,0,28,28,19,43,62,140,90,230,0.000333,0.456488,18,24650.37273,1369.465151,1369.465151,314.040007,9,5
0,0,29,29,19,45,64,160,102,262,0.000333,0.524,18,28296,1572,1572,327.844012,9,5
0,0,33,33,20,55,75,169,110,279,0.000333,0.57928,20,34756.80829,1930.933794,1737.840415,404.413346,13,5
0,0,33,33,21,50,71,164,107,271,0.000333,0.555527,20,33331.62939,1851.757188,1666.581469,374.431475,11,5
0,0,35,35,21,50,71,167,105,272,0.000333,0.557577,20,33454.62433,1858.590241,1672.731217,374.431475,13,5
0,0,33,33,19,51,70,162,103,265,0.000333,0.54142,18,29236.67999,1624.259999,1624.259999,370.004315,13,5
0,0,33,33,19,50,69,162,102,264,0.000333,0.53755,18,29027.70822,1612.650457,1612.650457,362.903432,13,5
0,0,33,33,19,50,69,162,103,265,0.000333,0.539586,18,29137.66166,1618.758981,1618.758981,362.903432,13,5
0,0,32,32,21,53,74,160,103,263,0.000333,0.544362,10,16330.86235,907.270131,1633.086235,395.81845,11,5
0,0,30,30,20,54,74,156,101,257,0.000333,0.531943,10,15958.29515,886.571953,1595.829515,397.202487,11,5
0,0,30,30,20,54,74,156,101,257,0.000333,0.531943,10,15958.29515,886.571953,1595.829515,397.202487,11,5
0,0,30,30,20,52,72,156,100,256,0.000333,0.5265,10,15795.008,877.500445,1579.5008,382.861427,11,5
0,0,30,30,20,52,72,156,99,255,0.000333,0.524444,10,15733.30875,874.072709,1573.330875,382.861427,11,5
0,0,37,37,23,54,77,183,120,303,0.000333,0.632945,22,41774.39908,2320.799949,1898.836322,414.80585,12,5
0,0,28,28,19,44,63,143,89,232,0.000333,0.462243,18,24961.12096,1386.728942,1386.728942,320.925614,10,5
0,0,28,28,20,45,65,143,89,232,0.000333,0.46573,10,13971.89333,776.216296,1397.189333,333.571951,10,5
0,0,27,27,19,44,63,140,88,228,0.000333,0.454273,18,24530.75681,1362.819823,1362.819823,320.925614,9,5
0,0,29,29,22,45,67,149,95,244,0.000333,0.493375,22,32562.76677,1809.042599,1480.125762,345.240885,10,5
0,0,29,29,19,45,64,146,94,240,0.000333,0.48,18,25920,1440,1440,327.844012,9,5
0,0,29,29,19,47,66,146,92,238,0.000333,0.479522,9,12947.0922,719.2829,1438.5658,341.776299,10,5
0,0,32,32,19,50,69,159,102,261,0.000333,0.531442,18,28697.8479,1594.324883,1594.324883,362.903432,12,5
0,0,31,31,23,53,76,162,106,268,0.000333,0.558148,22,36837.78062,2046.543368,1674.444574,407.621709,11,5
0,0,28,28,19,46,65,143,90,233,0.000333,0.467737,9,12628.9053,701.60585,1403.2117,334.794473,10,5
0,0,32,32,20,52,72,165,106,271,0.000333,0.55735,20,33440.99351,1857.832973,1672.049675,382.861427,10,5
0,0,29,29,20,52,72,153,99,252,0.000333,0.518274,10,15548.211,863.7895,1554.8211,382.861427,10,5
0,0,30,30,21,45,66,148,92,240,0.000333,0.483552,20,29013.09177,1611.838432,1450.654589,339.372055,10,5
0,0,28,28,19,46,65,143,90,233,0.000333,0.467737,9,12628.9053,701.60585,1403.2117,334.794473,10,5
0,0,28,28,19,45,64,143,89,232,0.000333,0.464,9,12528,696,1392,327.844012,10,5
0,0,28,28,19,45,64,143,89,232,0.000333,0.464,9,12528,696,1392,327.844012,10,5
0,0,31,31,19,49,68,156,99,255,0.000333,0.517434,18,27941.45444,1552.303025,1552.303025,355.831405,12,5
0,0,31,31,19,49,68,156,100,256,0.000333,0.519463,18,28051.02877,1558.390487,1558.390487,355.831405,12,5
0,0,33,33,20,55,75,165,108,273,0.000333,0.566823,10,17004.67503,944.704168,1700.467503,404.413346,13,5
0,0,33,33,20,55,75,165,107,272,0.000333,0.564746,10,16942.38684,941.243713,1694.238684,404.413346,13,5
0,0,32,32,20,54,74,162,106,268,0.000333,0.554711,10,16641.33502,924.518612,1664.133502,397.202487,12,5
0,0,33,33,20,54,74,165,107,272,0.000333,0.56299,10,16889.71316,938.317397,1688.971315,397.202487,13,5
0,0,33,33,20,55,75,165,107,272,0.000333,0.564746,10,16942.38684,941.243713,1694.238684,404.413346,13,5
0,0,21,21,18,43,61,108,77,185,0.000333,0.365729,9,9874.677667,548.593204,1097.186407,308.388034,7,5
0,0,21,21,19,43,62,109,77,186,0.000333,0.36916,9,9967.324624,553.740257,1107.480514,314.040007,7,5
0,0,32,32,19,47,66,158,99,257,0.000333,0.517803,18,27961.3672,1553.409289,1553.409289,341.776299,10,5
0,0,31,31,19,47,66,152,97,249,0.000333,0.501685,18,27090.97444,1505.054136,1505.054136,341.776299,10,5
0,0,29,29,19,46,65,146,91,237,0.000333,0.475767,9,12845.71055,713.650586,1427.301172,334.794473,10,5
0,0,31,31,22,47,69,155,98,253,0.000333,0.515152,22,34000.04713,1888.891507,1545.456688,359.173172,11,5
0,0,30,30,19,48,67,149,93,242,0.000333,0.489331,9,13211.94226,733.996792,1467.993584,348.788823,11,5
0,0,30,30,19,48,67,149,93,242,0.000333,0.489331,9,13211.94226,733.996792,1467.993584,348.788823,11,5
0,0,30,30,19,46,65,149,92,241,0.000333,0.483797,18,26125.03157,1451.390643,1451.390643,334.794473,11,5
0,0,29,29,19,47,66,147,95,242,0.000333,0.487581,18,26329.38078,1462.743377,1462.743377,341.776299,9,5
0,0,30,30,21,47,68,152,98,250,0.000333,0.507289,20,30437.31421,1690.9619,1521.86571,353.304342,10,5
0,0,31,31,20,49,69,156,99,255,0.000333,0.519225,20,31153.47473,1730.748596,1557.673736,361.559344,12,5
0,0,31,31,20,51,71,155,102,257,0.000333,0.526828,20,31609.70019,1756.094455,1580.48501,375.732254,10,5
0,0,32,32,20,51,71,161,104,265,0.000333,0.543228,20,32593.65973,1810.758874,1629.682987,375.732254,10,5
0,0,31,31,20,51,71,155,102,257,0.000333,0.526828,20,31609.70019,1756.094455,1580.48501,375.732254,10,5
0,0,31,31,20,53,73,156,103,259,0.000333,0.534388,10,16031.64561,890.646978,1603.164561,390.018346,10,5
0,0,29,29,20,50,70,149,96,245,0.000333,0.500558,10,15016.74339,834.263522,1501.674339,368.631371,10,5
0,0,29,29,20,50,70,149,96,245,0.000333,0.500558,10,15016.74339,834.263522,1501.674339,368.631371,10,5
0,0,31,31,23,51,74,158,103,261,0.000333,0.540222,22,35654.68123,1980.815624,1620.667328,393.335617,11,5
0,0,33,33,19,49,68,165,106,271,0.000333,0.549901,18,29694.64374,1649.70243,1649.70243,355.831405,11,5
0,0,32,32,19,49,68,159,104,263,0.000333,0.533668,18,28818.04909,1601.002727,1601.002727,355.831405,11,5
0,0,32,32,22,49,71,162,105,267,0.000333,0.547327,22,36123.61458,2006.867477,1641.982481,373.228278,12,5
0,0,32,32,19,51,70,160,105,265,0.000333,0.54142,18,29236.67999,1624.259999,1624.259999,370.004315,11,5
0,0,30,30,19,48,67,153,98,251,0.000333,0.507529,18,27406.59096,1522.588387,1522.588387,348.788823,11,5
0,0,22,22,18,46,64,114,81,195,0.000333,0.39,9,10530,585,1170,329.1425,9,5
0,0,31,31,19,47,66,153,100,253,0.000333,0.509744,18,27526.17082,1529.231712,1529.231712,341.776299,11,5
0,0,33,33,20,55,75,165,107,272,0.000333,0.564746,10,16942.38684,941.243713,1694.238684,404.413346,13,5
0,0,29,29,19,46,65,144,91,235,0.000333,0.471752,9,12737.30793,707.628218,1415.256436,334.794473,10,5
0,0,30,30,21,52,73,156,99,255,0.000333,0.526135,10,15784.05263,876.891813,1578.405263,388.661531,11,5
0,0,30,30,20,51,71,156,99,255,0.000333,0.522729,10,15681.85516,871.214175,1568.185515,375.732254,11,5
0,0,31,31,23,52,75,162,105,267,0.000333,0.554365,22,36588.08099,2032.671166,1663.09459,400.46479,11,5
0,0,29,29,20,51,71,153,98,251,0.000333,0.514529,10,15435.86527,857.548071,1543.586527,375.732254,10,5
0,0,32,32,21,52,73,160,102,262,0.000333,0.540578,10,16217.34034,900.963352,1621.734034,388.661531,11,5
0,0,30,30,20,53,73,156,100,256,0.000333,0.528198,10,15845.95087,880.330604,1584.595087,390.018346,11,5
0,0,30,30,20,53,73,156,100,256,0.000333,0.528198,10,15845.95087,880.330604,1584.595087,390.018346,11,5
0,0,30,30,20,52,72,152,98,250,0.000333,0.51416,10,15424.8125,856.934028,1542.48125,382.861427,11,5
0,0,30,30,20,51,71,152,97,249,0.000333,0.510429,10,15312.87033,850.715018,1531.287033,375.732254,11,5
0,0,30,30,20,51,71,152,97,249,0.000333,0.510429,10,15312.87033,850.715018,1531.287033,375.732254,11,5
0,0,30,30,20,51,71,152,98,250,0.000333,0.512479,10,15374.3678,854.131544,1537.43678,375.732254,11,5
0,0,30,30,20,50,70,152,97,249,0.000333,0.50873,10,15261.91471,847.884151,1526.191471,368.631371,11,5
0,0,29,29,20,50,70,149,96,245,0.000333,0.500558,10,15016.74339,834.263522,1501.674339,368.631371,10,5
0,0,33,33,21,50,71,161,103,264,0.000333,0.541178,20,32470.66479,1803.925822,1623.53324,374.431475,12,5
0,0,33,33,19,51,70,162,103,265,0.000333,0.54142,18,29236.67999,1624.259999,1624.259999,370.004315,13,5
0,0,33,33,19,52,71,162,104,266,0.000333,0.545278,18,29444.98921,1635.832734,1635.832734,377.133488,13,5
0,0,30,30,19,48,67,149,93,242,0.000333,0.489331,9,13211.94226,733.996792,1467.993584,348.788823,11,5
0,0,30,30,19,48,67,149,94,243,0.000333,0.491353,9,13266.53706,737.029837,1474.059673,348.788823,11,5
0,0,30,30,19,47,66,149,93,242,0.000333,0.487581,9,13164.69039,731.371688,1462.743377,341.776299,11,5
0,0,32,32,21,48,69,154,96,250,0.000333,0.509044,20,30542.62228,1696.812349,1527.131114,360.316866,11,5
0,0,30,30,19,49,68,149,94,243,0.000333,0.493084,9,13313.28123,739.626735,1479.25347,355.831405,11,5
0,0,30,30,19,49,68,149,94,243,0.000333,0.493084,9,13313.28123,739.626735,1479.25347,355.831405,11,5
0,0,30,30,19,48,67,149,93,242,0.000333,0.489331,9,13211.94226,733.996792,1467.993584,348.788823,11,5
0,0,31,31,20,50,70,155,101,256,0.000333,0.523032,20,31381.92905,1743.440503,1569.096452,368.631371,10,5
0,0,29,29,20,49,69,149,95,244,0.000333,0.496827,10,14904.79968,828.044426,1490.479967,361.559344,10,5
0,0,31,31,20,52,72,156,102,258,0.000333,0.530614,10,15918.4065,884.355917,1591.84065,382.861427,10,5
0,0,31,31,20,50,70,155,101,256,0.000333,0.523032,20,31381.92905,1743.440503,1569.096452,368.631371,10,5
0,0,30,30,20,50,70,152,96,248,0.000333,0.506687,10,15200.62188,844.478993,1520.062188,368.631371,11,5
0,0,34,34,23,51,74,170,110,280,0.000333,0.579549,22,38250.23273,2125.01293,1738.646942,393.335617,10,5
0,0,35,35,20,50,70,166,105,271,0.000333,0.553679,20,33220.71395,1845.59522,1661.035698,368.631371,13,5
0,0,30,30,20,50,70,152,96,248,0.000333,0.506687,10,15200.62188,844.478993,1520.062188,368.631371,11,5
0,0,30,30,20,51,71,152,97,249,0.000333,0.510429,10,15312.87033,850.715018,1531.287033,375.732254,11,5
0,0,29,29,19,46,65,146,91,237,0.000333,0.475767,9,12845.71055,713.650586,1427.301172,334.794473,10,5
0,0,30,30,19,46,65,149,92,241,0.000333,0.483797,18,26125.03157,1451.390643,1451.390643,334.794473,11,5
0,0,30,30,19,49,68,149,94,243,0.000333,0.493084,9,13313.28123,739.626735,1479.25347,355.831405,11,5
0,0,31,31,19,51,70,156,101,257,0.000333,0.525075,9,14177.03162,787.612868,1575.225735,370.004315,12,5
0,0,31,31,19,50,69,156,100,256,0.000333,0.521261,18,28148.0807,1563.782261,1563.782261,362.903432,12,5
0,0,31,31,19,50,69,156,100,256,0.000333,0.521261,18,28148.0807,1563.782261,1563.782261,362.903432,12,5
0,0,31,31,19,50,69,156,100,256,0.000333,0.521261,18,28148.0807,1563.782261,1563.782261,362.903432,12,5
0,0,31,31,19,51,70,156,101,257,0.000333,0.525075,9,14177.03162,787.612868,1575.225735,370.004315,12,5
0,0,32,32,19,52,71,160,106,266,0.000333,0.545278,18,29444.98921,1635.832734,1635.832734,377.133488,11,5
0,0,30,30,19,49,68,153,99,252,0.000333,0.511347,18,27612.73145,1534.040636,1534.040636,355.831405,11,5
0,0,32,32,19,50,69,159,105,264,0.000333,0.53755,18,29027.70822,1612.650457,1612.650457,362.903432,11,5
0,0,31,31,19,48,67,156,99,255,0.000333,0.515618,18,27843.34938,1546.852744,1546.852744,348.788823,12,5
0,0,30,30,19,48,67,153,98,251,0.000333,0.507529,18,27406.59096,1522.588387,1522.588387,348.788823,11,5
0,0,31,31,19,49,68,156,100,256,0.000333,0.519463,18,28051.02877,1558.390487,1558.390487,355.831405,12,5
0,0,30,30,19,49,68,153,99,252,0.000333,0.511347,18,27612.73145,1534.040636,1534.040636,355.831405,11,5
0,0,27,27,19,44,63,137,87,224,0.000333,0.446304,9,12050.19633,669.455351,1338.910703,320.925614,10,5
0,0,28,28,20,46,66,143,90,233,0.000333,0.469448,10,14083.4383,782.413239,1408.34383,340.522412,10,5
0,0,29,29,19,46,65,146,95,241,0.000333,0.483797,18,26125.03157,1451.390643,1451.390643,334.794473,9,5
0,0,34,34,22,51,73,168,109,277,0.000333,0.571527,22,37720.79086,2095.599492,1714.581403,387.401188,13,5
0,0,33,33,19,50,69,162,103,265,0.000333,0.539586,18,29137.66166,1618.758981,1618.758981,362.903432,13,5
0,0,33,33,19,52,71,162,104,266,0.000333,0.545278,18,29444.98921,1635.832734,1635.832734,377.133488,13,5
0,0,35,35,20,51,71,166,106,272,0.000333,0.557577,20,33454.62433,1858.590241,1672.731217,375.732254,13,5
0,0,30,30,20,49,69,152,96,248,0.000333,0.504971,10,15149.14065,841.618925,1514.914065,361.559344,11,5
0,0,29,29,20,49,69,149,95,244,0.000333,0.496827,10,14904.79968,828.044426,1490.479967,361.559344,10,5
0,0,32,32,22,50,72,157,99,256,0.000333,0.5265,11,17374.5088,965.250489,1579.5008,380.300305,11,5
0,0,30,30,20,51,71,152,97,249,0.000333,0.510429,10,15312.87033,850.715018,1531.287033,375.732254,11,5
0,0,24,24,19,47,66,122,87,209,0.000333,0.421093,9,11369.50534,631.639185,1263.278371,341.776299,9,5
0,0,28,28,19,46,65,143,90,233,0.000333,0.467737,9,12628.9053,701.60585,1403.2117,334.794473,10,5
0,0,28,28,19,47,66,143,91,234,0.000333,0.471463,9,12729.49402,707.194112,1414.388224,341.776299,10,5
0,0,30,30,21,46,67,148,93,241,0.000333,0.487309,20,29238.5499,1624.363883,1461.927495,346.322516,10,5
0,0,28,28,19,46,65,143,90,233,0.000333,0.467737,9,12628.9053,701.60585,1403.2117,334.794473,10,5
0,0,30,30,20,46,66,147,93,240,0.000333,0.483552,20,29013.09177,1611.838432,1450.654589,340.522412,10,5
0,0,28,28,19,47,66,143,91,234,0.000333,0.471463,9,12729.49402,707.194112,1414.388224,341.776299,10,5
0,0,28,28,19,47,66,143,91,234,0.000333,0.471463,9,12729.49402,707.194112,1414.388224,341.776299,10,5
0,0,34,34,20,56,76,172,115,287,0.000333,0.597718,20,35863.10393,1992.394663,1793.155196,411.650438,12,5
0,0,35,35,20,56,76,178,117,295,0.000333,0.61438,20,36862.77233,2047.931796,1843.138616,411.650438,12,5
0,0,32,32,20,55,75,166,109,275,0.000333,0.570975,10,17129.2514,951.625078,1712.92514,404.413346,12,5
0,0,34,34,20,58,78,173,116,289,0.000333,0.605494,20,36329.62483,2018.31249,1816.481241,426.20146,12,5
0,0,34,34,20,56,76,172,115,287,0.000333,0.597718,20,35863.10393,1992.394663,1793.155196,411.650438,12,5
0,0,31,31,19,49,68,156,100,256,0.000333,0.519463,18,28051.02877,1558.390487,1558.390487,355.831405,12,5
0,0,31,31,19,50,69,156,100,256,0.000333,0.521261,18,28148.0807,1563.782261,1563.782261,362.903432,12,5
0,0,31,31,19,50,69,156,100,256,0.000333,0.521261,18,28148.0807,1563.782261,1563.782261,362.903432,12,5
0,0,31,31,19,50,69,156,100,256,0.000333,0.521261,18,28148.0807,1563.782261,1563.782261,362.903432,12,5
0,0,33,33,20,56,76,169,110,279,0.000333,0.581057,10,17431.71776,968.428765,1743.171776,411.650438,13,5
0,0,31,31,19,51,70,156,101,257,0.000333,0.525075,9,14177.03162,787.612868,1575.225735,370.004315,12,5
0,0,30,30,19,53,72,158,104,262,0.000333,0.53884,9,14548.68315,808.260175,1616.52035,384.290407,13,5
0,0,33,33,21,56,77,169,110,279,0.000333,0.582811,10,17484.33445,971.351914,1748.433445,417.450542,13,5
0,0,31,31,19,48,67,152,98,250,0.000333,0.505507,18,27297.40136,1516.522298,1516.522298,348.788823,10,5
0,0,32,32,19,48,67,158,100,258,0.000333,0.521684,18,28170.9182,1565.051011,1565.051011,348.788823,10,5
0,0,31,31,19,50,69,153,99,252,0.000333,0.513116,9,13854.13347,769.674082,1539.348163,362.903432,10,5
0,0,31,31,19,48,67,152,98,250,0.000333,0.505507,18,27297.40136,1516.522298,1516.522298,348.788823,10,5
0,0,28,28,19,45,64,143,89,232,0.000333,0.464,9,12528,696,1392,327.844012,10,5
0,0,30,30,20,45,65,147,92,239,0.000333,0.479782,20,28786.91815,1599.27323,1439.345907,333.571951,10,5
0,0,31,31,19,49,68,156,99,255,0.000333,0.517434,18,27941.45444,1552.303025,1552.303025,355.831405,12,5
0,0,33,33,20,49,69,160,102,262,0.000333,0.533478,20,32008.66815,1778.259342,1600.433408,361.559344,12,5
0,0,28,28,20,43,63,141,90,231,0.000333,0.460251,20,27615.03325,1534.168514,1380.751662,319.767946,9,5
0,0,30,30,20,53,73,156,100,256,0.000333,0.528198,10,15845.95087,880.330604,1584.595087,390.018346,11,5
0,0,31,31,20,53,73,159,105,264,0.000333,0.544705,10,16341.13684,907.840935,1634.113684,390.018346,10,5
0,0,31,31,19,50,69,156,100,256,0.000333,0.521261,18,28148.0807,1563.782261,1563.782261,362.903432,12,5
0,0,31,31,19,50,69,156,101,257,0.000333,0.523297,18,28258.03414,1569.890785,1569.890785,362.903432,12,5
0,0,32,32,19,49,68,159,101,260,0.000333,0.52758,18,28489.3261,1582.740339,1582.740339,355.831405,12,5
0,0,31,31,20,53,73,159,105,264,0.000333,0.544705,10,16341.13684,907.840935,1634.113684,390.018346,10,5
0,0,29,29,20,52,72,153,99,252,0.000333,0.518274,10,15548.211,863.7895,1554.8211,382.861427,10,5
0,0,31,31,20,55,75,160,106,266,0.000333,0.552289,10,16568.65772,920.480984,1656.865772,404.413346,10,5
0,0,27,27,19,44,63,139,89,228,0.000333,0.454273,18,24530.75681,1362.819823,1362.819823,320.925614,9,5
0,0,27,27,19,44,63,140,88,228,0.000333,0.454273,18,24530.75681,1362.819823,1362.819823,320.925614,9,5
0,0,29,29,19,45,64,146,94,240,0.000333,0.48,18,25920,1440,1440,327.844012,9,5
0,0,30,30,19,45,64,152,96,248,0.000333,0.496,18,26784,1488,1488,327.844012,9,5
0,0,29,29,22,45,67,149,95,244,0.000333,0.493375,22,32562.76677,1809.042599,1480.125762,345.240885,10,5
0,0,27,27,19,44,63,140,88,228,0.000333,0.454273,18,24530.75681,1362.819823,1362.819823,320.925614,9,5
0,0,33,33,20,51,71,162,103,265,0.000333,0.543228,20,32593.65973,1810.758874,1629.682987,375.732254,13,5
0,0,32,32,19,49,68,157,101,258,0.000333,0.523522,18,28270.17744,1570.565413,1570.565413,355.831405,12,5
0,0,27,27,19,44,63,140,88,228,0.000333,0.454273,18,24530.75681,1362.819823,1362.819823,320.925614,9,5
0,0,33,33,19,51,70,162,103,265,0.000333,0.54142,18,29236.67999,1624.259999,1624.259999,370.004315,13,5
0,0,33,33,19,51,70,162,103,265,0.000333,0.54142,18,29236.67999,1624.259999,1624.259999,370.004315,13,5
0,0,33,33,20,50,70,162,102,264,0.000333,0.539377,20,32362.61433,1797.923018,1618.130716,368.631371,13,5
0,0,33,33,19,49,68,162,102,264,0.000333,0.535697,18,28927.62342,1607.09019,1607.09019,355.831405,13,5
0,0,34,34,22,50,72,168,108,276,0.000333,0.567633,22,37463.78461,2081.321367,1702.8993,380.300305,13,5
0,0,32,32,19,49,68,159,101,260,0.000333,0.52758,18,28489.3261,1582.740339,1582.740339,355.831405,12,5
0,0,32,32,20,53,73,165,107,272,0.000333,0.561211,20,33672.6456,1870.702533,1683.63228,390.018346,10,5
0,0,30,30,20,53,73,156,101,257,0.000333,0.530262,10,15907.84912,883.769395,1590.784912,390.018346,11,5
0,0,30,30,20,53,73,156,100,256,0.000333,0.528198,10,15845.95087,880.330604,1584.595087,390.018346,11,5
0,0,30,30,20,53,73,156,100,256,0.000333,0.528198,10,15845.95087,880.330604,1584.595087,390.018346,11,5
0,0,30,30,20,54,74,156,101,257,0.000333,0.531943,10,15958.29515,886.571953,1595.829515,397.202487,11,5
0,0,19,19,18,42,60,101,71,172,0.000333,0.338662,9,9143.866642,507.992591,1015.985182,301.535982,7,5
0,0,30,30,20,54,74,156,101,257,0.000333,0.531943,10,15958.29515,886.571953,1595.829515,397.202487,11,5
0,0,32,32,22,53,75,161,103,264,0.000333,0.548136,11,18088.48948,1004.916082,1644.408134,401.68728,11,5
0,0,9,9,8,11,19,21,28,49,0.000333,0.069383,8,1665.187585,92.510421,208.148448,62.053748,1,5
0,0,28,28,19,45,64,143,90,233,0.000333,0.466,18,25164,1398,1398,327.844012,10,5
0,0,28,28,19,45,64,143,89,232,0.000333,0.464,9,12528,696,1392,327.844012,10,5
0,0,27,27,19,44,63,140,88,228,0.000333,0.454273,18,24530.75681,1362.819823,1362.819823,320.925614,9,5
0,0,28,28,19,44,63,143,89,232,0.000333,0.462243,18,24961.12096,1386.728942,1386.728942,320.925614,10,5
0,0,31,31,19,49,68,156,99,255,0.000333,0.517434,18,27941.45444,1552.303025,1552.303025,355.831405,12,5
0,0,31,31,19,49,68,156,99,255,0.000333,0.517434,18,27941.45444,1552.303025,1552.303025,355.831405,12,5
0,0,31,31,19,50,69,156,100,256,0.000333,0.521261,18,28148.0807,1563.782261,1563.782261,362.903432,12,5
0,0,27,27,19,44,63,140,88,228,0.000333,0.454273,18,24530.75681,1362.819823,1362.819823,320.925614,9,5
0,0,28,28,19,44,63,143,89,232,0.000333,0.462243,18,24961.12096,1386.728942,1386.728942,320.925614,10,5
0,0,28,28,19,45,64,143,90,233,0.000333,0.466,18,25164,1398,1398,327.844012,10,5
0,0,28,28,19,45,64,143,89,232,0.000333,0.464,9,12528,696,1392,327.844012,10,5
0,0,28,28,19,46,65,143,90,233,0.000333,0.467737,9,12628.9053,701.60585,1403.2117,334.794473,10,5
0,0,32,32,19,49,68,159,104,263,0.000333,0.533668,18,28818.04909,1601.002727,1601.002727,355.831405,11,5
0,0,32,32,19,48,67,158,103,261,0.000333,0.52775,18,28498.48702,1583.249279,1583.249279,348.788823,11,5
0,0,29,29,22,46,68,149,96,245,0.000333,0.497143,22,32811.42471,1822.856929,1491.428396,352.191346,10,5
0,0,27,27,19,45,64,140,89,229,0.000333,0.458,9,12366,687,1374,327.844012,9,5
0,0,28,28,19,47,66,143,91,234,0.000333,0.471463,9,12729.49402,707.194112,1414.388224,341.776299,10,5
0,0,28,28,19,47,66,143,91,234,0.000333,0.471463,9,12729.49402,707.194112,1414.388224,341.776299,10,5
0,0,28,28,19,45,64,143,90,233,0.000333,0.466,18,25164,1398,1398,327.844012,10,5
0,0,7,7,7,9,16,16,18,34,0.000333,0.045333,6,816,45.333333,136,48.180809,1,5
0,0,32,32,20,47,67,153,95,248,0.000333,0.501463,20,30087.80239,1671.544577,1504.390119,347.504238,11,5
0,0,30,30,19,47,66,149,92,241,0.000333,0.485566,9,13110.29085,728.349491,1456.698983,341.776299,11,5
0,0,30,30,19,47,66,149,92,241,0.000333,0.485566,9,13110.29085,728.349491,1456.698983,341.776299,11,5
0,0,32,32,21,47,68,154,95,249,0.000333,0.505259,20,30315.56495,1684.198053,1515.778247,353.304342,11,5
0,0,30,30,19,47,66,149,92,241,0.000333,0.485566,9,13110.29085,728.349491,1456.698983,341.776299,11,5
0,0,30,30,19,48,67,149,93,242,0.000333,0.489331,9,13211.94226,733.996792,1467.993584,348.788823,11,5
0,0,30,30,19,47,66,149,93,242,0.000333,0.487581,9,13164.69039,731.371688,1462.743377,341.776299,11,5
0,0,4,4,12,16,28,22,19,41,0.000333,0.065701,6,1182.609311,65.700517,197.101552,107.01955,2,5
0,0,15,15,11,16,27,50,46,96,0.000333,0.152156,10,4564.692002,253.594,456.4692,102.053748,1,5
0,0,9,9,10,13,23,28,28,56,0.000333,0.08444,10,2533.194695,140.733039,253.31947,81.324997,1,5
0,0,10,10,8,12,20,27,32,59,0.000333,0.084998,8,2039.950061,113.330559,254.993758,67.01955,1,5
0,0,30,30,20,50,70,152,97,249,0.000333,0.50873,10,15261.91471,847.884151,1526.191471,368.631371,11,5
0,0,9,9,8,12,20,20,31,51,0.000333,0.073473,8,1763.346663,97.963703,220.418333,67.01955,1,5
0,0,32,32,19,49,68,173,112,285,0.000333,0.578309,18,31228.68438,1734.92691,1734.92691,355.831405,11,5
0,0,36,36,21,56,77,184,125,309,0.000333,0.645479,20,38728.74082,2151.596712,1936.437041,417.450542,13,5
0,0,35,35,22,55,77,170,110,280,0.000333,0.5849,22,38603.40509,2144.633616,1754.700231,416.08228,13,5
0,0,33,33,20,55,75,165,107,272,0.000333,0.564746,10,16942.38684,941.243713,1694.238684,404.413346,13,5
0,0,35,35,21,55,76,169,110,279,0.000333,0.581057,20,34863.43553,1936.857529,1743.171776,410.21345,13,5
0,0,33,33,20,56,76,165,108,273,0.000333,0.568561,10,17056.84211,947.60234,1705.684211,411.650438,13,5
0,0,33,33,20,56,76,165,108,273,0.000333,0.568561,10,17056.84211,947.60234,1705.684211,411.650438,13,5
0,0,33,33,20,54,74,165,107,272,0.000333,0.56299,10,16889.71316,938.317397,1688.971315,397.202487,13,5
0,0,33,33,21,49,70,161,102,263,0.000333,0.537334,20,32240.02867,1791.112704,1612.001433,367.359448,12,5
0,0,31,31,20,52,72,159,104,263,0.000333,0.540897,20,32453.80551,1802.989195,1622.690275,382.861427,10,5
0,0,30,30,20,52,72,156,100,256,0.000333,0.5265,10,15795.008,877.500445,1579.5008,382.861427,11,5
0,0,6,6,9,10,19,18,19,37,0.000333,0.052391,4,628.693272,34.927404,157.173318,61.748606,1,5
0,0,30,30,19,49,68,153,99,252,0.000333,0.511347,18,27612.73145,1534.040636,1534.040636,355.831405,11,5
0,0,31,31,19,49,68,153,98,251,0.000333,0.509318,18,27503.15712,1527.953173,1527.953173,355.831405,10,5
0,0,15,15,11,17,28,46,45,91,0.000333,0.145823,10,4374.692979,243.038499,437.469298,107.540616,1,5
0,0,34,34,19,50,69,165,107,272,0.000333,0.55384,18,29907.33574,1661.518652,1661.518652,362.903432,12,5
0,0,35,35,19,50,69,171,109,280,0.000333,0.570129,18,30786.96326,1710.386848,1710.386848,362.903432,12,5
0,0,31,31,23,50,73,158,102,260,0.000333,0.536451,22,35405.79648,1966.988693,1609.354385,386.234734,11,5
0,0,32,32,21,50,71,156,99,255,0.000333,0.522729,10,15681.85516,871.214175,1568.185515,374.431475,11,5
0,0,30,30,20,50,70,152,96,248,0.000333,0.506687,10,15200.62188,844.478993,1520.062188,368.631371,11,5
0,0,30,30,21,50,71,152,96,248,0.000333,0.508379,10,15251.37286,847.298492,1525.137286,374.431475,11,5
0,0,30,30,20,49,69,152,96,248,0.000333,0.504971,10,15149.14065,841.618925,1514.914065,361.559344,11,5
0,0,30,30,20,51,71,152,97,249,0.000333,0.510429,10,15312.87033,850.715018,1531.287033,375.732254,11,5
0,0,30,30,20,51,71,152,97,249,0.000333,0.510429,10,15312.87033,850.715018,1531.287033,375.732254,11,5
0,0,29,29,20,49,69,149,95,244,0.000333,0.496827,10,14904.79968,828.044426,1490.479967,361.559344,10,5
0,0,31,31,20,54,74,160,105,265,0.000333,0.548502,10,16455.05142,914.169523,1645.505142,397.202487,10,5
0,0,29,29,20,51,71,153,98,251,0.000333,0.514529,10,15435.86527,857.548071,1543.586527,375.732254,10,5
0,0,31,31,20,52,72,159,104,263,0.000333,0.540897,20,32453.80551,1802.989195,1622.690275,382.861427,10,5
0,0,30,30,20,52,72,156,100,256,0.000333,0.5265,10,15795.008,877.500445,1579.5008,382.861427,11,5
0,0,32,32,22,52,74,161,102,263,0.000333,0.544362,11,17963.94859,997.997144,1633.086235,394.530361,11,5
0,0,30,30,20,53,73,156,100,256,0.000333,0.528198,10,15845.95087,880.330604,1584.595087,390.018346,11,5
0,0,29,29,20,51,71,153,98,251,0.000333,0.514529,10,15435.86527,857.548071,1543.586527,375.732254,10,5
0,0,30,30,20,50,70,152,96,248,0.000333,0.506687,10,15200.62188,844.478993,1520.062188,368.631371,11,5
0,0,30,30,20,52,72,156,99,255,0.000333,0.524444,10,15733.30875,874.072709,1573.330875,382.861427,11,5
0,0,28,28,19,46,65,143,90,233,0.000333,0.467737,9,12628.9053,701.60585,1403.2117,334.794473,10,5
0,0,28,28,19,46,65,143,91,234,0.000333,0.469745,9,12683.10661,704.617034,1409.234068,334.794473,10,5
0,0,28,28,19,45,64,143,90,233,0.000333,0.466,18,25164,1398,1398,327.844012,10,5
0,0,27,27,19,45,64,140,89,229,0.000333,0.458,9,12366,687,1374,327.844012,9,5
0,0,30,30,20,52,72,152,98,250,0.000333,0.51416,10,15424.8125,856.934028,1542.48125,382.861427,11,5
0,0,32,32,22,51,73,157,100,257,0.000333,0.530262,11,17498.63403,972.146335,1590.784912,387.401188,11,5
0,0,34,34,20,57,77,169,113,282,0.000333,0.589078,10,17672.33805,981.796558,1767.233804,418.913293,12,5
0,0,32,32,20,54,74,162,106,268,0.000333,0.554711,10,16641.33502,924.518612,1664.133502,397.202487,12,5
0,0,30,30,20,51,71,152,97,249,0.000333,0.510429,10,15312.87033,850.715018,1531.287033,375.732254,11,5
0,0,33,33,19,49,68,162,102,264,0.000333,0.535697,18,28927.62342,1607.09019,1607.09019,355.831405,13,5
0,0,32,32,19,49,68,159,101,260,0.000333,0.52758,18,28489.3261,1582.740339,1582.740339,355.831405,12,5
0,0,4,4,6,7,13,8,9,17,0.000333,0.020969,3,188.722426,10.484579,62.907475,35.161259,1,5
0,0,6,6,8,10,18,19,19,38,0.000333,0.052819,4,633.8286,35.2127,158.45715,57.219281,1,5
0,0,31,31,20,47,67,137,105,242,0.000333,0.489331,20,29359.87168,1631.103982,1467.993584,347.504238,9,5
0,0,35,35,20,55,75,174,114,288,0.000333,0.597967,20,35877.99566,1993.221981,1793.899783,404.413346,12,5
0,0,34,34,20,55,75,168,112,280,0.000333,0.581356,20,34881.38467,1937.854704,1744.069233,404.413346,12,5
0,0,7,7,7,11,18,15,23,38,0.000333,0.052819,6,950.7429,52.81905,158.45715,57.705232,1,5
0,0,7,7,7,10,17,16,18,34,0.000333,0.046325,3,416.92121,23.162289,138.973737,52.870765,1,5
0,0,33,33,19,51,70,162,103,265,0.000333,0.54142,18,29236.67999,1624.259999,1624.259999,370.004315,13,5
0,0,33,33,19,52,71,162,104,266,0.000333,0.545278,18,29444.98921,1635.832734,1635.832734,377.133488,13,5
0,0,33,33,19,51,70,162,103,265,0.000333,0.54142,18,29236.67999,1624.259999,1624.259999,370.004315,13,5
0,0,33,33,19,50,69,162,103,265,0.000333,0.539586,18,29137.66166,1618.758981,1618.758981,362.903432,13,5
0,0,9,9,10,13,23,28,29,57,0.000333,0.085948,10,2578.430315,143.246129,257.843031,81.324997,1,5
0,0,33,33,19,51,70,162,103,265,0.000333,0.54142,18,29236.67999,1624.259999,1624.259999,370.004315,13,5
0,0,30,30,21,51,72,152,97,249,0.000333,0.512104,10,15363.11325,853.506292,1536.311325,381.532358,11,5
0,0,30,30,20,50,70,152,97,249,0.000333,0.50873,10,15261.91471,847.884151,1526.191471,368.631371,11,5
0,0,28,28,19,46,65,143,90,233,0.000333,0.467737,9,12628.9053,701.60585,1403.2117,334.794473,10,5
0,0,28,28,19,47,66,143,91,234,0.000333,0.471463,9,12729.49402,707.194112,1414.388224,341.776299,10,5
0,0,30,30,20,46,66,147,93,240,0.000333,0.483552,20,29013.09177,1611.838432,1450.654589,340.522412,10,5
0,0,30,30,20,51,71,152,97,249,0.000333,0.510429,10,15312.87033,850.715018,1531.287033,375.732254,11,5
0,0,30,30,20,52,72,152,98,250,0.000333,0.51416,10,15424.8125,856.934028,1542.48125,382.861427,11,5
0,0,30,30,20,52,72,152,98,250,0.000333,0.51416,10,15424.8125,856.934028,1542.48125,382.861427,11,5
0,0,9,9,12,15,27,29,26,55,0.000333,0.087173,6,1569.112876,87.172938,261.518813,101.622909,2,5
0,0,33,33,19,50,69,162,102,264,0.000333,0.53755,18,29027.70822,1612.650457,1612.650457,362.903432,13,5
0,0,33,33,19,50,69,162,102,264,0.000333,0.53755,18,29027.70822,1612.650457,1612.650457,362.903432,13,5
0,0,33,33,19,51,70,162,103,265,0.000333,0.54142,18,29236.67999,1624.259999,1624.259999,370.004315,13,5
0,0,33,33,19,50,69,162,102,264,0.000333,0.53755,18,29027.70822,1612.650457,1612.650457,362.903432,13,5
0,0,34,34,19,53,72,166,109,275,0.000333,0.565576,18,30541.12876,1696.729375,1696.729375,384.290407,12,5
0,0,32,32,19,50,69,159,102,261,0.000333,0.531442,18,28697.8479,1594.324883,1594.324883,362.903432,12,5
0,0,35,35,19,51,70,171,110,281,0.000333,0.57411,18,31001.9135,1722.328528,1722.328528,370.004315,12,5
0,0,34,34,19,51,70,165,108,273,0.000333,0.557765,18,30119.29675,1673.294264,1673.294264,370.004315,12,5
0,0,34,34,19,51,70,165,108,273,0.000333,0.557765,18,30119.29675,1673.294264,1673.294264,370.004315,12,5
0,0,29,29,19,46,65,146,91,237,0.000333,0.475767,9,12845.71055,713.650586,1427.301172,334.794473,10,5
0,0,30,30,19,46,65,152,97,249,0.000333,0.499857,18,26992.25254,1499.569585,1499.569585,334.794473,9,5
0,0,29,29,19,46,65,146,95,241,0.000333,0.483797,18,26125.03157,1451.390643,1451.390643,334.794473,9,5
0,0,27,27,19,45,64,140,89,229,0.000333,0.458,9,12366,687,1374,327.844012,9,5
0,0,29,29,22,46,68,149,96,245,0.000333,0.497143,22,32811.42471,1822.856929,1491.428396,352.191346,10,5
0,0,28,28,19,45,64,143,90,233,0.000333,0.466,18,25164,1398,1398,327.844012,10,5
0,0,29,29,19,48,67,147,96,243,0.000333,0.491353,18,26533.07412,1474.059673,1474.059673,348.788823,9,5
0,0,27,27,19,45,64,140,89,229,0.000333,0.458,9,12366,687,1374,327.844012,9,5
0,0,33,33,20,57,77,169,111,280,0.000333,0.5849,10,17547.00231,974.833462,1754.700231,418.913293,13,5
0,0,33,33,20,57,77,169,111,280,0.000333,0.5849,10,17547.00231,974.833462,1754.700231,418.913293,13,5
0,0,33,33,20,56,76,169,110,279,0.000333,0.581057,10,17431.71776,968.428765,1743.171776,411.650438,13,5
0,0,32,32,20,55,75,166,109,275,0.000333,0.570975,10,17129.2514,951.625078,1712.92514,404.413346,12,5
0,0,34,34,23,56,79,175,116,291,0.000333,0.611467,22,40356.80435,2242.044686,1834.400198,429.253801,13,5
0,0,30,30,20,48,68,149,93,242,0.000333,0.491055,10,14731.66008,818.42556,1473.166008,354.516762,11,5
0,0,30,30,19,47,66,149,93,242,0.000333,0.487581,9,13164.69039,731.371688,1462.743377,341.776299,11,5
0,0,31,31,22,48,70,155,99,254,0.000333,0.518946,22,34250.4335,1902.801861,1556.837886,366.185696,11,5
0,0,32,32,20,48,68,153,96,249,0.000333,0.505259,20,30315.56495,1684.198053,1515.778247,354.516762,11,5
0,0,30,30,19,49,68,149,94,243,0.000333,0.493084,9,13313.28123,739.626735,1479.25347,355.831405,11,5
0,0,30,30,21,46,67,151,97,248,0.000333,0.501463,20,30087.80239,1671.544577,1504.390119,346.322516,9,5
0,0,29,29,19,47,66,147,95,242,0.000333,0.487581,18,26329.38078,1462.743377,1462.743377,341.776299,9,5
0,0,14,14,11,16,27,44,43,87,0.000333,0.137892,10,4136.752127,229.819563,413.675213,102.053748,1,5
0,0,9,9,11,13,24,27,29,56,0.000333,0.085586,10,2567.579,142.643278,256.7579,86.159464,1,5
0,0,33,33,19,51,70,162,104,266,0.000333,0.543463,18,29347.00709,1630.389283,1630.389283,370.004315,13,5
0,0,6,6,9,10,19,18,19,37,0.000333,0.052391,4,628.693272,34.927404,157.173318,61.748606,1,5
0,0,33,33,20,49,69,139,105,244,0.000333,0.496827,20,29809.59935,1656.088853,1490.479967,361.559344,7,5
0,0,33,33,20,48,68,145,106,251,0.000333,0.509318,20,30559.06346,1697.725748,1527.953173,354.516762,7,5
0,0,31,31,21,46,67,135,98,233,0.000333,0.471133,20,28267.97563,1570.44309,1413.398781,346.322516,7,5
0,0,34,34,20,48,68,142,108,250,0.000333,0.507289,20,30437.31421,1690.9619,1521.86571,354.516762,7,5
0,0,32,32,20,48,68,145,103,248,0.000333,0.50323,20,30193.81569,1677.434205,1509.690785,354.516762,7,5
0,0,31,31,20,47,67,137,99,236,0.000333,0.477199,20,28631.94098,1590.663388,1431.597049,347.504238,7,5
0,0,32,32,20,50,70,143,101,244,0.000333,0.498515,20,29910.90112,1661.716729,1495.545056,368.631371,10,5
0,0,32,32,20,50,70,143,101,244,0.000333,0.498515,20,29910.90112,1661.716729,1495.545056,368.631371,10,5
0,0,32,32,20,51,71,143,102,245,0.000333,0.502229,20,30133.76089,1674.097827,1506.688044,375.732254,10,5
0,0,31,31,20,49,69,140,100,240,0.000333,0.488682,20,29320.91739,1628.939855,1466.04587,361.559344,9,5
0,0,32,32,20,49,69,143,101,244,0.000333,0.496827,20,29809.59935,1656.088853,1490.479967,361.559344,10,5
0,0,32,32,20,51,71,143,102,245,0.000333,0.502229,20,30133.76089,1674.097827,1506.688044,375.732254,10,5
0,0,34,34,22,50,72,148,104,252,0.000333,0.518274,22,34206.06421,1900.3369,1554.8211,380.300305,10,5
0,0,30,30,20,53,73,156,100,256,0.000333,0.528198,10,15845.95087,880.330604,1584.595087,390.018346,11,5
0,0,17,17,13,17,30,64,52,116,0.000333,0.189733,18,10245.58756,569.199309,569.199309,117.592585,1,5
0,0,32,32,20,55,75,166,109,275,0.000333,0.570975,10,17129.2514,951.625078,1712.92514,404.413346,12,5
0,0,30,30,19,47,66,149,96,245,0.000333,0.493626,18,26655.77807,1480.876559,1480.876559,341.776299,11,5
0,0,13,13,12,15,27,45,35,80,0.000333,0.126797,12,4564.692002,253.594,380.391,101.622909,1,5
0,0,30,30,20,52,72,156,99,255,0.000333,0.524444,10,15733.30875,874.072709,1573.330875,382.861427,11,5
0,0,29,29,19,46,65,146,95,241,0.000333,0.483797,18,26125.03157,1451.390643,1451.390643,334.794473,9,5
0,0,29,29,19,48,67,147,96,243,0.000333,0.491353,18,26533.07412,1474.059673,1474.059673,348.788823,9,5
0,0,27,27,19,45,64,140,89,229,0.000333,0.458,9,12366,687,1374,327.844012,9,5
0,0,7,7,7,9,16,16,18,34,0.000333,0.045333,6,816,45.333333,136,48.180809,1,5
0,0,4,4,6,7,13,8,9,17,0.000333,0.020969,3,188.722426,10.484579,62.907475,35.161259,1,5
0,0,7,7,7,10,17,16,20,36,0.000333,0.04905,6,882.891974,49.049554,147.148662,52.870765,1,5
0,0,33,33,19,50,69,165,107,272,0.000333,0.55384,18,29907.33574,1661.518652,1661.518652,362.903432,11,5
0,0,32,32,19,50,69,159,105,264,0.000333,0.53755,18,29027.70822,1612.650457,1612.650457,362.903432,11,5
0,0,30,30,19,49,68,153,99,252,0.000333,0.511347,18,27612.73145,1534.040636,1534.040636,355.831405,11,5
0,0,18,18,13,18,31,58,49,107,0.000333,0.1767,12,6361.188063,353.399337,530.099005,123.164366,1,5
0,0,16,16,13,17,30,53,43,96,0.000333,0.15702,12,5652.737966,314.040998,471.061497,117.592585,1,5
0,0,28,28,19,46,65,143,90,233,0.000333,0.467737,9,12628.9053,701.60585,1403.2117,334.794473,10,5
0,0,28,28,19,47,66,143,91,234,0.000333,0.471463,9,12729.49402,707.194112,1414.388224,341.776299,10,5
0,0,30,30,21,46,67,148,93,241,0.000333,0.487309,20,29238.5499,1624.363883,1461.927495,346.322516,10,5
0,0,28,28,19,46,65,143,90,233,0.000333,0.467737,9,12628.9053,701.60585,1403.2117,334.794473,10,5
0,0,28,28,19,46,65,143,90,233,0.000333,0.467737,9,12628.9053,701.60585,1403.2117,334.794473,10,5
0,0,7,7,7,11,18,15,23,38,0.000333,0.052819,6,950.7429,52.81905,158.45715,57.705232,1,5
0,0,7,7,7,9,16,16,18,34,0.000333,0.045333,6,816,45.333333,136,48.180809,1,5
0,0,28,28,19,45,64,143,90,233,0.000333,0.466,18,25164,1398,1398,327.844012,10,5
0,0,28,28,20,43,63,124,95,219,0.000333,0.436341,20,26180.48607,1454.471448,1309.024303,319.767946,7,5
0,0,6,6,8,10,18,19,19,38,0.000333,0.052819,4,633.8286,35.2127,158.45715,57.219281,1,5
0,0,9,9,10,13,23,28,32,60,0.000333,0.090471,10,2714.137174,150.785399,271.413717,81.324997,1,5
0,0,10,10,11,13,24,36,27,63,0.000333,0.096284,10,2888.526375,160.473688,288.852638,86.159464,1,5
0,0,9,9,10,12,22,28,28,56,0.000333,0.083243,10,2497.281706,138.737873,249.728171,76.238831,1,5
0,0,31,31,20,45,65,132,104,236,0.000333,0.47376,20,28425.57608,1579.198671,1421.278804,333.571951,7,5
0,0,9,9,11,12,23,27,28,55,0.000333,0.082932,10,2487.959076,138.219949,248.795908,81.073298,1,5
0,0,15,15,11,16,27,50,52,102,0.000333,0.161666,15,7274.977878,404.165438,484.998525,102.053748,1,5
0,0,30,30,21,53,74,156,100,256,0.000333,0.529873,10,15896.20062,883.122256,1589.620062,395.81845,11,5
0,0,34,34,23,55,78,175,115,290,0.000333,0.607589,22,40100.86616,2227.825898,1822.766643,422.016709,13,5
0,0,34,34,20,54,74,168,111,279,0.000333,0.577479,20,34648.74978,1924.930543,1732.437489,397.202487,12,5
0,0,32,32,20,53,73,162,105,267,0.000333,0.550894,10,16526.83157,918.15731,1652.683157,390.018346,12,5
0,0,34,34,20,56,76,169,112,281,0.000333,0.585223,20,35113.35263,1950.741813,1755.667631,411.650438,12,5
0,0,39,39,21,55,76,176,129,305,0.000333,0.635206,20,38112.35783,2117.353213,1905.617892,410.21345,11,5
0,0,14,14,14,16,30,49,38,87,0.000333,0.1423,14,5976.592745,332.03293,426.899482,117.302969,1,5
0,0,12,12,12,16,28,45,31,76,0.000333,0.121786,6,2192.153844,121.786325,365.358974,107.01955,3,5
0,0,14,14,14,15,29,47,37,84,0.000333,0.136023,14,5712.98565,317.388092,408.070404,111.906328,1,5
0,0,15,15,13,16,29,49,41,90,0.000333,0.145739,12,5246.619475,291.47886,437.21829,112.105716,1,5
0,0,17,17,13,17,30,54,47,101,0.000333,0.165199,12,5947.151402,330.3973,495.59595,117.592585,1,5
0,0,13,13,13,15,28,44,35,79,0.000333,0.126594,12,4557.372466,253.187359,379.781039,106.709075,1,5
0,0,13,13,14,16,30,45,37,82,0.000333,0.134122,14,5633.110404,312.950578,402.365029,117.302969,1,5
0,0,11,11,13,14,27,39,29,68,0.000333,0.107777,12,3879.988202,215.5549,323.33235,101.408685,1,5
0,0,11,11,13,14,27,39,29,68,0.000333,0.107777,12,3879.988202,215.5549,323.33235,101.408685,1,5
0,0,15,15,15,18,33,53,36,89,0.000333,0.14965,14,6285.315073,349.184171,448.951077,133.662009,2,5
0,0,11,11,13,14,27,39,29,68,0.000333,0.107777,12,3879.988202,215.5549,323.33235,101.408685,1,5
0,0,31,31,20,49,69,156,99,255,0.000333,0.519225,20,31153.47473,1730.748596,1557.673736,361.559344,12,5
0,0,31,31,19,48,67,156,99,255,0.000333,0.515618,18,27843.34938,1546.852744,1546.852744,348.788823,12,5
0,0,31,31,19,50,69,156,100,256,0.000333,0.521261,18,28148.0807,1563.782261,1563.782261,362.903432,12,5
0,0,31,31,19,50,69,156,100,256,0.000333,0.521261,18,28148.0807,1563.782261,1563.782261,362.903432,12,5
0,0,31,31,19,50,69,156,100,256,0.000333,0.521261,18,28148.0807,1563.782261,1563.782261,362.903432,12,5
0,0,33,33,21,49,70,161,102,263,0.000333,0.537334,20,32240.02867,1791.112704,1612.001433,367.359448,12,5
0,0,31,31,19,49,68,156,99,255,0.000333,0.517434,18,27941.45444,1552.303025,1552.303025,355.831405,12,5
0,0,31,31,19,49,68,156,99,255,0.000333,0.517434,18,27941.45444,1552.303025,1552.303025,355.831405,12,5
0,0,30,30,19,48,67,153,98,251,0.000333,0.507529,18,27406.59096,1522.588387,1522.588387,348.788823,11,5
0,0,10,10,11,13,24,36,27,63,0.000333,0.096284,10,2888.526375,160.473688,288.852638,86.159464,1,5
0,0,16,16,16,19,35,61,46,107,0.000333,0.182944,16,8781.332525,487.851807,548.833283,144.710623,1,5
0,0,15,15,16,18,34,53,42,95,0.000333,0.161103,16,7732.943519,429.607973,483.30897,139.05865,1,5
0,0,13,13,14,17,31,49,39,88,0.000333,0.145323,14,6103.569854,339.087214,435.969275,122.789837,1,5
0,0,17,17,15,19,34,61,49,110,0.000333,0.18654,14,7834.692776,435.26071,559.620913,139.313982,1,5
0,0,13,13,15,17,32,50,39,89,0.000333,0.148333,14,6230,346.111111,445,128.090227,1,5
0,0,19,19,17,19,36,71,58,129,0.000333,0.222307,24,16006.0878,889.2271,666.920325,150.197491,1,5
0,0,35,35,20,55,75,178,116,294,0.000333,0.610424,20,36625.4539,2034.747439,1831.272695,404.413346,12,5
0,0,30,30,19,47,66,150,96,246,0.000333,0.49564,18,26764.57716,1486.920953,1486.920953,341.776299,11,5
0,0,15,15,16,20,36,50,42,92,0.000333,0.158544,16,7610.129602,422.784978,475.6331,150.438562,1,5
0,0,16,16,18,18,36,55,42,97,0.000333,0.167161,18,9026.689053,501.482725,501.482725,150.1173,2,5
0,0,16,16,17,18,35,54,42,96,0.000333,0.164137,16,7878.578714,437.698817,492.41117,144.545518,2,5
0,0,14,14,15,17,32,47,39,86,0.000333,0.143333,14,6020,334.444444,430,128.090227,1,5
0,0,14,14,16,17,33,50,39,89,0.000333,0.14965,16,7183.217226,399.067624,448.951077,133.486868,1,5
0,0,13,13,16,17,33,46,34,80,0.000333,0.134517,16,6456.824473,358.712471,403.55153,133.486868,2,5
0,0,13,13,16,16,32,46,34,80,0.000333,0.133333,16,6400,355.555556,400,128,2,5
0,0,14,14,18,16,34,52,40,92,0.000333,0.156016,18,8424.838465,468.046581,468.046581,139.05865,2,5
0,0,12,12,15,16,31,43,33,76,0.000333,0.125506,14,5271.264874,292.848049,376.51892,122.603359,1,5
0,0,32,32,20,53,73,162,105,267,0.000333,0.550894,10,16526.83157,918.15731,1652.683157,390.018346,12,5
0,0,33,33,20,53,73,165,106,271,0.000333,0.559147,20,33548.84911,1863.824951,1677.442455,390.018346,13,5
0,0,33,33,20,54,74,165,107,272,0.000333,0.56299,10,16889.71316,938.317397,1688.971315,397.202487,13,5
0,0,33,33,20,54,74,165,106,271,0.000333,0.560921,10,16827.61862,934.867701,1682.761862,397.202487,13,5
0,0,33,33,20,54,74,165,106,271,0.000333,0.560921,10,16827.61862,934.867701,1682.761862,397.202487,13,5
0,0,33,33,20,55,75,165,107,272,0.000333,0.564746,10,16942.38684,941.243713,1694.238684,404.413346,13,5
0,0,33,33,20,55,75,165,107,272,0.000333,0.564746,10,16942.38684,941.243713,1694.238684,404.413346,13,5
0,0,35,35,22,54,76,170,109,279,0.000333,0.581057,22,38349.77908,2130.543282,1743.171776,408.871421,13,5
0,0,15,15,17,17,34,50,37,87,0.000333,0.147536,16,7081.748275,393.43046,442.609267,138.973737,2,5
0,0,13,13,14,16,30,46,32,78,0.000333,0.127579,14,5358.32453,297.684696,382.737466,117.302969,2,5
0,0,13,13,14,16,30,46,32,78,0.000333,0.127579,14,5358.32453,297.684696,382.737466,117.302969,2,5
0,0,12,12,13,15,28,43,31,74,0.000333,0.118581,12,4268.931171,237.162843,355.744264,106.709075,1,5
0,0,13,13,14,16,30,46,32,78,0.000333,0.127579,14,5358.32453,297.684696,382.737466,117.302969,2,5
0,0,13,13,14,16,30,46,32,78,0.000333,0.127579,14,5358.32453,297.684696,382.737466,117.302969,2,5
0,0,15,15,16,16,32,51,35,86,0.000333,0.143333,16,6880,382.222222,430,128,2,5
0,0,12,12,13,16,29,47,37,84,0.000333,0.136023,12,4896.844843,272.046936,408.070404,112.105716,1,5
0,0,18,18,13,18,31,68,54,122,0.000333,0.201471,18,10879.4151,604.41195,604.41195,123.164366,1,5
0,0,29,29,21,44,65,157,92,249,0.000333,0.499857,20,29991.39171,1666.188428,1499.569585,332.453657,11,5
0,0,15,15,14,17,31,53,40,93,0.000333,0.15358,14,6450.363596,358.353533,460.740257,122.789837,1,5
0,0,11,11,13,14,27,39,29,68,0.000333,0.107777,12,3879.988202,215.5549,323.33235,101.408685,1,5
0,0,10,10,11,13,24,36,27,63,0.000333,0.096284,10,2888.526375,160.473688,288.852638,86.159464,1,5
0,0,9,9,12,13,25,37,27,64,0.000333,0.099069,12,3566.481554,198.137864,297.206796,91.125266,1,5
0,0,10,10,12,16,28,37,30,67,0.000333,0.107364,6,1932.556679,107.36426,322.09278,107.01955,1,5
0,0,13,13,14,17,31,49,39,88,0.000333,0.145323,14,6103.569854,339.087214,435.969275,122.789837,1,5
0,0,12,12,12,16,28,46,37,83,0.000333,0.133003,12,4788.125502,266.006972,399.010459,107.01955,1,5
0,0,11,11,13,14,27,39,29,68,0.000333,0.107777,12,3879.988202,215.5549,323.33235,101.408685,1,5
0,0,17,17,16,21,37,63,48,111,0.000333,0.19275,16,9251.989177,513.999399,578.249324,156.238666,2,5
0,0,35,35,20,51,71,150,112,262,0.000333,0.537078,20,32224.67491,1790.259717,1611.233745,375.732254,9,5
0,0,33,33,20,50,70,145,106,251,0.000333,0.512817,20,30769.00075,1709.38893,1538.450037,368.631371,9,5
0,0,11,11,13,14,27,39,29,68,0.000333,0.107777,12,3879.988202,215.5549,323.33235,101.408685,1,5
0,0,32,32,20,51,71,143,102,245,0.000333,0.502229,20,30133.76089,1674.097827,1506.688044,375.732254,10,5
0,0,32,32,20,51,71,143,102,245,0.000333,0.502229,20,30133.76089,1674.097827,1506.688044,375.732254,10,5
0,0,32,32,20,50,70,143,101,244,0.000333,0.498515,20,29910.90112,1661.716729,1495.545056,368.631371,10,5
0,0,32,32,20,50,70,143,101,244,0.000333,0.498515,20,29910.90112,1661.716729,1495.545056,368.631371,10,5
0,0,34,34,21,50,71,147,104,251,0.000333,0.514529,20,30871.73054,1715.096141,1543.586527,374.431475,10,5
0,0,35,35,21,52,73,154,107,261,0.000333,0.538515,20,32310.8842,1795.049122,1615.54421,388.661531,10,5
0,0,19,19,16,24,40,67,55,122,0.000333,0.216425,16,10388.40364,577.133536,649.275228,174.0391,2,5
0,0,9,9,12,13,25,37,27,64,0.000333,0.099069,12,3566.481554,198.137864,297.206796,91.125266,1,5
0,0,17,17,16,22,38,65,49,114,0.000333,0.199421,16,9572.219785,531.789988,598.263737,162.107496,2,5
0,0,12,12,13,16,29,47,37,84,0.000333,0.136023,12,4896.844843,272.046936,408.070404,112.105716,1,5
0,0,37,37,20,52,72,155,118,273,0.000333,0.561463,20,33687.79051,1871.543917,1684.389525,382.861427,9,5
0,0,34,34,20,51,71,150,109,259,0.000333,0.530928,20,31855.69008,1769.76056,1592.784504,375.732254,9,5
0,0,12,12,12,16,28,46,37,83,0.000333,0.133003,12,4788.125502,266.006972,399.010459,107.01955,1,5
0,0,15,15,12,16,28,52,45,97,0.000333,0.155438,12,5595.761129,310.875618,466.313427,107.01955,1,5
0,0,34,34,21,50,71,148,108,256,0.000333,0.524778,20,31486.70525,1749.261403,1574.335263,374.431475,9,5
0,0,35,35,20,52,72,158,113,271,0.000333,0.55735,20,33440.99351,1857.832973,1672.049675,382.861427,9,5
0,0,14,14,15,20,35,55,40,95,0.000333,0.162427,14,6821.946413,378.997023,487.281887,145.041921,2,5
0,0,15,15,15,20,35,58,41,99,0.000333,0.169266,14,7109.186261,394.954792,507.799019,145.041921,3,5
0,0,13,13,15,17,32,50,39,89,0.000333,0.148333,14,6230,346.111111,445,128.090227,1,5
0,0,35,35,22,48,70,155,115,270,0.000333,0.551635,22,36407.94112,2022.663396,1654.906415,366.185696,7,5
0,0,13,13,14,17,31,49,39,88,0.000333,0.145323,14,6103.569854,339.087214,435.969275,122.789837,1,5
0,0,32,32,20,49,69,143,101,244,0.000333,0.496827,20,29809.59935,1656.088853,1490.479967,361.559344,10,5
0,0,12,12,13,16,29,47,37,84,0.000333,0.136023,12,4896.844843,272.046936,408.070404,112.105716,1,5
0,0,34,34,20,55,75,172,114,286,0.000333,0.593814,20,35628.84291,1979.380162,1781.442145,404.413346,12,5
0,0,32,32,20,54,74,166,108,274,0.000333,0.56713,20,34027.80444,1890.43358,1701.390222,397.202487,12,5
0,0,34,34,20,57,77,173,115,288,0.000333,0.601612,20,36096.69047,2005.371693,1804.834524,418.913293,12,5
0,0,34,34,20,55,75,172,114,286,0.000333,0.593814,20,35628.84291,1979.380162,1781.442145,404.413346,12,5
0,0,16,16,15,21,36,59,46,105,0.000333,0.180947,14,7599.789752,422.210542,542.842125,150.842025,2,5
0,0,16,16,16,21,37,62,46,108,0.000333,0.18754,16,9001.935416,500.107523,562.620963,156.238666,2,5
0,0,15,15,15,22,37,58,42,100,0.000333,0.173648,7,3646.617356,202.589853,520.945337,156.710855,3,5
0,0,15,15,15,22,37,58,42,100,0.000333,0.173648,7,3646.617356,202.589853,520.945337,156.710855,3,5
0,0,15,15,16,21,37,58,41,99,0.000333,0.171912,8,4125.887066,229.215948,515.735883,156.238666,3,5
0,0,15,15,16,20,36,58,41,99,0.000333,0.170608,16,8189.161202,454.9534,511.822575,150.438562,3,5
0,0,16,16,18,20,38,64,47,111,0.000333,0.194173,18,10485.35917,582.519954,582.519954,161.497212,3,5
0,0,14,14,15,20,35,55,40,95,0.000333,0.162427,14,6821.946413,378.997023,487.281887,145.041921,2,5
0,0,18,18,17,22,39,67,49,116,0.000333,0.204369,16,9809.706518,544.983695,613.106657,167.594364,3,5
0,0,18,18,16,22,38,66,49,115,0.000333,0.201171,16,9656.186625,536.454812,603.511664,162.107496,3,5
0,0,20,20,15,24,39,80,63,143,0.000333,0.251938,14,10581.37524,587.85418,755.812517,168.642459,2,5
0,0,15,15,13,18,31,54,39,93,0.000333,0.15358,12,5528.883082,307.160171,460.740257,123.164366,3,5
0,0,12,12,12,16,28,46,37,83,0.000333,0.133003,12,4788.125502,266.006972,399.010459,107.01955,1,5
0,0,22,22,15,27,42,91,69,160,0.000333,0.28759,14,12078.79103,671.043946,862.770788,186.985321,4,5
0,0,14,14,15,19,34,56,41,97,0.000333,0.164495,14,6908.774538,383.820808,493.483896,139.313982,3,5
0,0,14,14,14,19,33,57,41,98,0.000333,0.164784,14,6920.908732,384.49493,494.350624,134.013592,3,5
0,0,10,10,11,13,24,36,27,63,0.000333,0.096284,10,2888.526375,160.473688,288.852638,86.159464,1,5
0,0,12,12,12,16,28,46,37,83,0.000333,0.133003,12,4788.125502,266.006972,399.010459,107.01955,1,5
0,0,37,37,20,52,72,165,123,288,0.000333,0.592313,20,35538.76801,1974.376,1776.9384,382.861427,9,5
0,0,12,12,13,16,29,47,37,84,0.000333,0.136023,12,4896.844843,272.046936,408.070404,112.105716,1,5
0,0,29,29,20,46,66,130,92,222,0.000333,0.447285,20,26837.10989,1490.950549,1341.855494,340.522412,8,5
0,0,29,29,20,47,67,130,92,222,0.000333,0.448891,10,13466.718,748.151,1346.6718,347.504238,8,5
0,0,28,28,20,45,65,127,90,217,0.000333,0.435618,20,26137.07631,1452.059795,1306.853815,333.571951,7,5
0,0,29,29,20,45,65,130,91,221,0.000333,0.443648,20,26618.86573,1478.825874,1330.943287,333.571951,8,5
0,0,29,29,20,47,67,130,92,222,0.000333,0.448891,10,13466.718,748.151,1346.6718,347.504238,8,5
0,0,31,31,22,46,68,135,94,229,0.000333,0.464676,22,30668.63779,1703.813211,1394.028991,352.191346,8,5
0,0,29,29,20,46,66,130,91,221,0.000333,0.44527,10,13358.111,742.117278,1335.8111,340.522412,8,5
0,0,29,29,20,46,66,130,91,221,0.000333,0.44527,10,13358.111,742.117278,1335.8111,340.522412,8,5
0,0,29,29,20,46,66,130,91,221,0.000333,0.44527,10,13358.111,742.117278,1335.8111,340.522412,8,5
0,0,17,17,15,22,37,68,50,118,0.000333,0.204905,14,8606.01696,478.112053,614.715497,156.710855,4,5
0,0,12,12,12,16,28,45,31,76,0.000333,0.121786,6,2192.153844,121.786325,365.358974,107.01955,3,5
0,0,15,15,15,21,36,58,41,99,0.000333,0.170608,7,3582.758026,199.042113,511.822575,150.842025,3,5
0,0,12,12,12,16,28,45,31,76,0.000333,0.121786,6,2192.153844,121.786325,365.358974,107.01955,3,5
0,0,10,10,13,14,27,38,28,66,0.000333,0.104608,12,3765.870902,209.21505,313.822575,101.408685,1,5
0,0,30,30,20,46,66,132,96,228,0.000333,0.459374,20,27562.43718,1531.24651,1378.121859,340.522412,7,5
0,0,30,30,20,46,66,132,96,228,0.000333,0.459374,20,27562.43718,1531.24651,1378.121859,340.522412,7,5
0,0,11,11,13,14,27,39,29,68,0.000333,0.107777,12,3879.988202,215.5549,323.33235,101.408685,1,5
0,0,30,30,20,46,66,131,96,227,0.000333,0.457359,20,27441.5493,1524.530517,1372.077465,340.522412,7,5
0,0,30,30,20,46,66,134,96,230,0.000333,0.463404,20,27804.21295,1544.678497,1390.210647,340.522412,7,5
0,0,30,30,20,46,66,132,96,228,0.000333,0.459374,20,27562.43718,1531.24651,1378.121859,340.522412,7,5
0,0,31,31,20,49,69,134,99,233,0.000333,0.474429,20,28465.72397,1581.429109,1423.286198,361.559344,7,5
0,0,34,34,20,53,73,153,110,263,0.000333,0.542641,20,32558.47718,1808.804288,1627.923859,390.018346,11,5
0,0,32,32,20,53,73,162,105,267,0.000333,0.550894,10,16526.83157,918.15731,1652.683157,390.018346,12,5
0,0,34,34,23,54,77,171,112,283,0.000333,0.591167,22,39017.013,2167.611833,1773.500591,414.80585,13,5
0,0,16,16,14,18,32,51,44,95,0.000333,0.158333,14,6650,369.444444,475,128.361619,1,5
0,0,16,16,13,18,31,57,45,102,0.000333,0.168443,12,6063.936284,336.885349,505.328024,123.164366,1,5
0,0,10,10,12,16,28,37,30,67,0.000333,0.107364,6,1932.556679,107.36426,322.09278,107.01955,1,5
0,0,33,33,20,53,73,165,106,271,0.000333,0.559147,20,33548.84911,1863.824951,1677.442455,390.018346,13,5
0,0,33,33,21,54,75,165,106,271,0.000333,0.56267,10,16880.09865,937.783258,1688.009865,403.002591,13,5
0,0,33,33,20,55,75,165,107,272,0.000333,0.564746,10,16942.38684,941.243713,1694.238684,404.413346,13,5
0,0,33,33,20,55,75,165,107,272,0.000333,0.564746,10,16942.38684,941.243713,1694.238684,404.413346,13,5
0,0,32,32,21,48,69,158,99,257,0.000333,0.523297,20,31397.81571,1744.323095,1569.890785,360.316866,12,5
0,0,35,35,21,54,75,169,109,278,0.000333,0.577204,20,34632.23192,1924.012884,1731.611596,403.002591,13,5
0,0,33,33,20,54,74,165,106,271,0.000333,0.560921,10,16827.61862,934.867701,1682.761862,397.202487,13,5
0,0,33,33,20,54,74,165,106,271,0.000333,0.560921,10,16827.61862,934.867701,1682.761862,397.202487,13,5
0,0,11,11,13,14,27,39,29,68,0.000333,0.107777,12,3879.988202,215.5549,323.33235,101.408685,1,5
0,0,14,14,14,16,30,48,37,85,0.000333,0.139029,14,5839.199809,324.399989,417.085701,117.302969,1,5
0,0,15,15,14,19,33,50,40,90,0.000333,0.151332,14,6355.93659,353.107588,453.995471,134.013592,1,5
0,0,14,14,13,16,29,47,37,84,0.000333,0.136023,12,4896.844843,272.046936,408.070404,112.105716,1,5
0,0,14,14,14,16,30,50,37,87,0.000333,0.1423,14,5976.592745,332.03293,426.899482,117.302969,1,5
0,0,14,14,15,15,30,48,37,85,0.000333,0.139029,14,5839.199809,324.399989,417.085701,117.206718,1,5
0,0,13,13,13,15,28,44,35,79,0.000333,0.126594,12,4557.372466,253.187359,379.781039,106.709075,1,5
0,0,13,13,14,15,29,46,35,81,0.000333,0.131165,14,5508.950448,306.052803,393.496461,111.906328,1,5
0,0,13,13,13,15,28,43,35,78,0.000333,0.124991,12,4499.684207,249.982456,374.973684,106.709075,1,5
0,0,14,14,14,18,32,46,38,84,0.000333,0.14,14,5880,326.666667,420,128.361619,1,5
0,0,13,13,14,15,29,44,35,79,0.000333,0.127927,14,5372.926981,298.495943,383.780499,111.906328,1,5
0,0,11,11,13,14,27,39,29,68,0.000333,0.107777,12,3879.988202,215.5549,323.33235,101.408685,1,5
0,0,11,11,13,14,27,39,29,68,0.000333,0.107777,12,3879.988202,215.5549,323.33235,101.408685,1,5
0,0,14,14,14,15,29,47,37,84,0.000333,0.136023,14,5712.98565,317.388092,408.070404,111.906328,1,5
0,0,14,14,15,15,30,48,37,85,0.000333,0.139029,14,5839.199809,324.399989,417.085701,117.206718,1,5
0,0,12,12,12,16,28,46,37,83,0.000333,0.133003,12,4788.125502,266.006972,399.010459,107.01955,1,5
0,0,32,32,18,50,68,142,104,246,0.000333,0.499172,18,26955.28546,1497.515859,1497.515859,357.25146,9,5
0,0,30,30,19,48,67,153,98,251,0.000333,0.507529,18,27406.59096,1522.588387,1522.588387,348.788823,11,5
0,0,32,32,22,49,71,162,105,267,0.000333,0.547327,22,36123.61458,2006.867477,1641.982481,373.228278,12,5
0,0,32,32,19,51,70,160,105,265,0.000333,0.54142,18,29236.67999,1624.259999,1624.259999,370.004315,11,5
0,0,30,30,19,48,67,153,98,251,0.000333,0.507529,18,27406.59096,1522.588387,1522.588387,348.788823,11,5
0,0,33,33,19,49,68,165,106,271,0.000333,0.549901,18,29694.64374,1649.70243,1649.70243,355.831405,11,5
0,0,32,32,19,49,68,159,104,263,0.000333,0.533668,18,28818.04909,1601.002727,1601.002727,355.831405,11,5
0,0,32,32,19,49,68,159,104,263,0.000333,0.533668,18,28818.04909,1601.002727,1601.002727,355.831405,11,5
0,0,14,14,15,19,34,56,41,97,0.000333,0.164495,14,6908.774538,383.820808,493.483896,139.313982,3,5
0,0,14,14,14,19,33,57,41,98,0.000333,0.164784,14,6920.908732,384.49493,494.350624,134.013592,3,5
0,0,11,11,13,14,27,39,29,68,0.000333,0.107777,12,3879.988202,215.5549,323.33235,101.408685,1,5
0,0,11,11,13,14,27,39,29,68,0.000333,0.107777,12,3879.988202,215.5549,323.33235,101.408685,1,5
0,0,11,11,13,14,27,39,29,68,0.000333,0.107777,12,3879.988202,215.5549,323.33235,101.408685,1,5
0,0,12,12,13,15,28,43,31,74,0.000333,0.118581,12,4268.931171,237.162843,355.744264,106.709075,1,5
0,0,13,13,14,15,29,46,32,78,0.000333,0.126308,14,5304.915247,294.717514,378.922518,111.906328,2,5
0,0,13,13,14,16,30,46,32,78,0.000333,0.127579,14,5358.32453,297.684696,382.737466,117.302969,2,5
0,0,13,13,14,17,31,46,33,79,0.000333,0.130461,7,2739.67056,152.20392,391.381509,122.789837,2,5
0,0,13,13,14,17,31,46,33,79,0.000333,0.130461,7,2739.67056,152.20392,391.381509,122.789837,2,5
0,0,16,16,15,19,34,57,38,95,0.000333,0.161103,14,6766.325579,375.906977,483.30897,139.313982,2,5
0,0,15,15,17,17,34,52,41,93,0.000333,0.157711,16,7570.144708,420.563595,473.134044,138.973737,1,5
0,0,9,9,13,13,26,38,27,65,0.000333,0.101843,12,3666.34298,203.685721,305.528582,96.211433,1,5
0,0,11,11,13,14,27,39,29,68,0.000333,0.107777,12,3879.988202,215.5549,323.33235,101.408685,1,5
0,0,14,14,15,17,32,48,39,87,0.000333,0.145,14,6090,338.333333,435,128.090227,1,5
0,0,10,10,13,14,27,38,28,66,0.000333,0.104608,12,3765.870902,209.21505,313.822575,101.408685,1,5
0,0,18,18,15,19,34,58,51,109,0.000333,0.184844,14,7763.468296,431.303794,554.53345,139.313982,1,5
0,0,15,15,16,17,33,51,41,92,0.000333,0.154695,16,7425.348144,412.519341,464.084259,133.486868,1,5
0,0,15,15,15,17,32,50,42,92,0.000333,0.153333,14,6440,357.777778,460,128.090227,1,5
0,0,15,15,12,16,28,52,45,97,0.000333,0.155438,12,5595.761129,310.875618,466.313427,107.01955,1,5
0,0,14,14,15,17,32,48,39,87,0.000333,0.145,14,6090,338.333333,435,128.090227,1,5
0,0,16,16,15,18,33,53,45,98,0.000333,0.164784,14,6920.908732,384.49493,494.350624,133.662009,1,5
0,0,19,19,15,22,37,73,56,129,0.000333,0.224006,14,9408.272778,522.681821,672.019484,156.710855,3,5
0,0,13,13,16,18,34,46,35,81,0.000333,0.137361,8,3296.675921,183.148662,412.08449,139.05865,2,5
0,0,17,17,14,19,33,55,46,101,0.000333,0.169828,14,7132.773285,396.265182,509.483806,134.013592,1,5
0,0,17,17,13,19,32,61,47,108,0.000333,0.18,12,6480,360,540,128.816339,1,5
0,0,13,13,16,18,34,46,35,81,0.000333,0.137361,8,3296.675921,183.148662,412.08449,139.05865,2,5
0,0,13,13,16,18,34,46,35,81,0.000333,0.137361,8,3296.675921,183.148662,412.08449,139.05865,2,5
0,0,13,13,16,17,33,46,34,80,0.000333,0.134517,16,6456.824473,358.712471,403.55153,133.486868,2,5
0,0,16,16,17,19,36,57,40,97,0.000333,0.167161,16,8023.723602,445.762422,501.482725,150.197491,2,5
0,0,13,13,16,17,33,46,34,80,0.000333,0.134517,16,6456.824473,358.712471,403.55153,133.486868,2,5
0,0,13,13,16,18,34,46,35,81,0.000333,0.137361,8,3296.675921,183.148662,412.08449,139.05865,2,5
0,0,14,14,16,15,31,52,38,90,0.000333,0.148626,16,7134.042687,396.335705,445.877668,122.603359,2,5
0,0,15,15,15,16,31,50,35,85,0.000333,0.140369,14,5895.493609,327.527423,421.106686,122.603359,2,5
0,0,16,16,15,17,32,54,40,94,0.000333,0.156667,14,6580,365.555556,470,128.090227,2,5
0,0,16,16,16,17,33,55,40,95,0.000333,0.159739,16,7667.479061,425.971059,479.217441,133.486868,2,5
0,0,33,33,20,55,75,169,109,278,0.000333,0.577204,10,17316.11596,962.006442,1731.611596,404.413346,13,5
0,0,33,33,20,55,75,169,109,278,0.000333,0.577204,10,17316.11596,962.006442,1731.611596,404.413346,13,5
0,0,33,33,20,55,75,169,109,278,0.000333,0.577204,10,17316.11596,962.006442,1731.611596,404.413346,13,5
0,0,33,33,20,55,75,169,110,279,0.000333,0.57928,20,34756.80829,1930.933794,1737.840415,404.413346,13,5
0,0,32,32,20,54,74,166,108,274,0.000333,0.56713,20,34027.80444,1890.43358,1701.390222,397.202487,12,5
0,0,35,35,22,55,77,174,112,286,0.000333,0.597434,22,39430.62091,2190.590051,1792.300951,416.08228,13,5
0,0,33,33,20,55,75,169,109,278,0.000333,0.577204,10,17316.11596,962.006442,1731.611596,404.413346,13,5
0,0,27,27,19,43,62,137,86,223,0.000333,0.442595,18,23900.14399,1327.785777,1327.785777,314.040007,9,5
0,0,13,13,15,17,32,50,39,89,0.000333,0.148333,14,6230,346.111111,445,128.090227,1,5
0,0,33,33,20,50,70,145,106,251,0.000333,0.512817,20,30769.00075,1709.38893,1538.450037,368.631371,9,5
0,0,31,31,19,49,68,156,100,256,0.000333,0.519463,18,28051.02877,1558.390487,1558.390487,355.831405,12,5
0,0,31,31,19,49,68,156,99,255,0.000333,0.517434,18,27941.45444,1552.303025,1552.303025,355.831405,12,5
0,0,33,33,20,50,70,144,106,250,0.000333,0.510774,20,30646.41509,1702.578616,1532.320754,368.631371,9,5
0,0,36,36,20,53,73,152,115,267,0.000333,0.550894,20,33053.66314,1836.314619,1652.683157,390.018346,9,5
0,0,35,35,22,51,73,152,109,261,0.000333,0.538515,22,35541.97262,1974.554034,1615.54421,387.401188,10,5
0,0,31,31,19,48,67,156,99,255,0.000333,0.515618,18,27843.34938,1546.852744,1546.852744,348.788823,12,5
0,0,25,25,19,47,66,121,85,206,0.000333,0.415048,9,11206.3067,622.572594,1245.145189,341.776299,10,5
0,0,25,25,20,48,68,126,86,212,0.000333,0.430181,10,12905.42122,716.967846,1290.542122,354.516762,10,5
0,0,9,9,13,13,26,38,27,65,0.000333,0.101843,12,3666.34298,203.685721,305.528582,96.211433,1,5
0,0,11,11,13,14,27,39,29,68,0.000333,0.107777,12,3879.988202,215.5549,323.33235,101.408685,1,5
0,0,34,34,20,53,73,147,109,256,0.000333,0.528198,20,31691.90174,1760.661208,1584.595087,390.018346,9,5
0,0,33,33,20,50,70,145,106,251,0.000333,0.512817,20,30769.00075,1709.38893,1538.450037,368.631371,9,5
0,0,10,10,12,16,28,37,30,67,0.000333,0.107364,6,1932.556679,107.36426,322.09278,107.01955,1,5
0,0,38,38,22,52,74,168,125,293,0.000333,0.606457,22,40026.1364,2223.674244,1819.369836,394.530361,9,5
0,0,35,35,21,51,72,151,109,260,0.000333,0.534727,20,32083.61001,1782.422778,1604.1805,381.532358,10,5
0,0,34,34,22,50,72,149,108,257,0.000333,0.528557,22,34884.75596,1938.041998,1585.670725,380.300305,9,5
0,0,33,33,20,54,74,169,109,278,0.000333,0.575409,20,34524.56071,1918.031151,1726.228036,397.202487,13,5
0,0,33,33,21,55,76,169,109,278,0.000333,0.578975,10,17369.23849,964.957694,1736.923849,410.21345,13,5
0,0,35,35,21,55,76,173,112,285,0.000333,0.593553,20,35613.18683,1978.510379,1780.659341,410.21345,13,5
0,0,33,33,20,56,76,169,110,279,0.000333,0.581057,10,17431.71776,968.428765,1743.171776,411.650438,13,5
0,0,33,33,20,56,76,169,110,279,0.000333,0.581057,10,17431.71776,968.428765,1743.171776,411.650438,13,5
0,0,9,9,12,13,25,37,27,64,0.000333,0.099069,12,3566.481554,198.137864,297.206796,91.125266,1,5
0,0,10,10,12,16,28,37,30,67,0.000333,0.107364,6,1932.556679,107.36426,322.09278,107.01955,1,5
0,0,13,13,14,17,31,49,39,88,0.000333,0.145323,14,6103.569854,339.087214,435.969275,122.789837,1,5
0,0,17,17,16,20,36,55,48,103,0.000333,0.177501,16,8520.036402,473.335356,532.502275,150.438562,1,5
0,0,18,18,16,24,40,69,47,116,0.000333,0.205781,8,4938.749272,274.37496,617.343659,174.0391,3,5
0,0,17,17,16,21,37,62,44,106,0.000333,0.184067,16,8835.232908,490.846273,552.202057,156.238666,3,5
0,0,15,15,15,21,36,58,41,99,0.000333,0.170608,7,3582.758026,199.042113,511.822575,150.842025,3,5
0,0,15,15,15,21,36,58,41,99,0.000333,0.170608,7,3582.758026,199.042113,511.822575,150.842025,3,5
0,0,15,15,15,21,36,58,42,100,0.000333,0.172331,14,7237.895002,402.105278,516.9925,150.842025,3,5
0,0,15,15,15,22,37,58,42,100,0.000333,0.173648,7,3646.617356,202.589853,520.945337,156.710855,3,5
0,0,12,12,12,14,26,41,33,74,0.000333,0.115944,12,4173.99047,231.888359,347.832539,96.322519,1,5
0,0,12,12,12,16,28,45,31,76,0.000333,0.121786,6,2192.153844,121.786325,365.358974,107.01955,3,5
0,0,31,31,20,50,70,140,100,240,0.000333,0.490343,20,29420.55848,1634.475471,1471.027924,368.631371,9,5
0,0,10,10,11,13,24,36,27,63,0.000333,0.096284,10,2888.526375,160.473688,288.852638,86.159464,1,5
0,0,13,13,16,17,33,46,34,80,0.000333,0.134517,16,6456.824473,358.712471,403.55153,133.486868,2,5
0,0,13,13,16,17,33,46,35,81,0.000333,0.136199,16,6537.534779,363.196377,408.595924,133.486868,2,5
0,0,21,21,17,24,41,83,65,148,0.000333,0.264306,16,12686.68315,704.81573,792.917697,179.525968,2,5
0,0,13,13,15,17,32,50,39,89,0.000333,0.148333,14,6230,346.111111,445,128.090227,1,5
0,0,13,13,16,16,32,46,34,80,0.000333,0.133333,16,6400,355.555556,400,128,2,5
0,0,12,12,15,16,31,43,33,76,0.000333,0.125506,14,5271.264874,292.848049,376.51892,122.603359,1,5
0,0,31,31,19,50,69,156,100,256,0.000333,0.521261,18,28148.0807,1563.782261,1563.782261,362.903432,12,5
0,0,14,14,15,19,34,56,41,97,0.000333,0.164495,14,6908.774538,383.820808,493.483896,139.313982,3,5
0,0,14,14,14,19,33,57,41,98,0.000333,0.164784,14,6920.908732,384.49493,494.350624,134.013592,3,5
0,0,18,18,15,18,33,68,56,124,0.000333,0.208502,21,13135.60229,729.755683,625.504871,133.662009,1,5
0,0,16,16,15,21,36,60,46,106,0.000333,0.182671,14,7672.168702,426.231595,548.01205,150.842025,2,5
0,0,10,10,13,14,27,38,28,66,0.000333,0.104608,12,3765.870902,209.21505,313.822575,101.408685,1,5
0,0,9,9,13,13,26,38,27,65,0.000333,0.101843,12,3666.34298,203.685721,305.528582,96.211433,1,5
0,0,11,11,13,14,27,39,29,68,0.000333,0.107777,12,3879.988202,215.5549,323.33235,101.408685,1,5
0,0,17,17,17,21,38,64,48,112,0.000333,0.195923,16,9404.286104,522.460339,587.767882,161.725534,2,5
0,0,16,16,15,21,36,60,46,106,0.000333,0.182671,14,7672.168702,426.231595,548.01205,150.842025,2,5
0,0,17,17,16,24,40,62,49,111,0.000333,0.196911,16,9451.744297,525.096905,590.734019,174.0391,2,5
0,0,16,16,16,21,37,60,46,106,0.000333,0.184067,16,8835.232908,490.846273,552.202057,156.238666,2,5
0,0,20,20,15,23,38,70,58,128,0.000333,0.223912,14,9404.286104,522.460339,671.734722,162.645284,2,5
0,0,14,14,14,19,33,57,41,98,0.000333,0.164784,14,6920.908732,384.49493,494.350624,134.013592,3,5
0,0,14,14,15,19,34,56,41,97,0.000333,0.164495,14,6908.774538,383.820808,493.483896,139.313982,3,5
0,0,12,12,13,16,29,47,37,84,0.000333,0.136023,12,4896.844843,272.046936,408.070404,112.105716,1,5
0,0,32,32,21,48,69,141,97,238,0.000333,0.48461,20,29076.57641,1615.365356,1453.828821,360.316866,8,5
0,0,31,31,21,46,67,134,94,228,0.000333,0.461023,20,27661.36671,1536.742595,1383.068335,346.322516,8,5
0,0,29,29,20,47,67,130,92,222,0.000333,0.448891,10,13466.718,748.151,1346.6718,347.504238,8,5
0,0,29,29,20,47,67,130,92,222,0.000333,0.448891,10,13466.718,748.151,1346.6718,347.504238,8,5
0,0,29,29,20,45,65,130,91,221,0.000333,0.443648,20,26618.86573,1478.825874,1330.943287,333.571951,8,5
0,0,29,29,21,46,67,130,91,221,0.000333,0.446869,10,13406.05711,744.780951,1340.605711,346.322516,8,5
0,0,28,28,20,45,65,127,90,217,0.000333,0.435618,20,26137.07631,1452.059795,1306.853815,333.571951,7,5
0,0,30,30,23,45,68,136,97,233,0.000333,0.472793,22,31204.33452,1733.57414,1418.378842,351.175314,8,5
0,0,32,32,21,47,68,138,99,237,0.000333,0.48091,20,28854.57387,1603.031882,1442.728693,353.304342,8,5
0,0,32,32,22,47,69,139,99,238,0.000333,0.48461,22,31984.23406,1776.901892,1453.828821,359.173172,8,5
0,0,14,14,13,16,29,48,37,85,0.000333,0.137643,12,4955.140615,275.28559,412.928385,112.105716,1,5
0,0,15,15,15,16,31,52,39,91,0.000333,0.150277,14,6311.646099,350.647006,450.831864,122.603359,1,5
0,0,32,32,21,48,69,170,102,272,0.000333,0.55384,20,33230.37305,1846.131836,1661.518652,360.316866,13,5
0,0,29,29,21,40,61,139,94,233,0.000333,0.460621,20,27637.23599,1535.402,1381.8618,305.11579,13,5
1,0,13,14,15,33,48,65,67,132,0.000333,0.245738,14,10321.0107,573.389483,737.21505,225.068365,4,5
1,0,11,12,15,28,43,55,55,110,0.000333,0.198963,7,4178.223861,232.123548,596.889123,193.209297,4,5
0,0,62,62,23,32,55,235,184,419,0.000333,0.807463,55,133231.4346,7401.746367,2422.38972,264.041925,23,5
0,0,62,62,23,32,55,235,184,419,0.000333,0.807463,55,133231.4346,7401.746367,2422.38972,264.041925,23,5
0,0,19,19,24,27,51,132,98,230,0.000333,0.434886,36,46967.68183,2609.315657,1304.657829,238.421063,9,5
0,0,19,19,24,27,51,132,98,230,0.000333,0.434886,36,46967.68183,2609.315657,1304.657829,238.421063,9,5
0,0,36,36,24,46,70,165,111,276,0.000333,0.563894,24,40600.3707,2255.57615,1691.682113,364.12295,16,5
0,0,27,27,29,36,65,128,101,229,0.000333,0.459707,28,38615.42242,2145.301245,1379.122229,326.998749,12,5
0,0,38,38,29,43,72,221,162,383,0.000333,0.787694,42,99249.41357,5513.85631,2363.081276,374.210833,25,5
1,0,35,36,24,62,86,151,114,265,0.000333,0.567653,12,20435.52192,1135.306773,1702.96016,479.199271,11,5
1,0,30,31,22,55,77,133,99,232,0.000333,0.484631,11,15992.83925,888.49107,1453.894477,416.08228,10,5
1,0,31,32,24,74,98,190,126,316,0.000333,0.696749,12,25082.97973,1393.498874,2090.248311,569.538649,16,5
0,0,45,45,22,48,70,293,220,513,0.000333,1.048107,44,138350.1763,7686.120903,3144.322188,366.185696,15,5
0,0,44,44,22,48,70,286,215,501,0.000333,1.02359,44,135113.9148,7506.328601,3070.770791,366.185696,15,5
0,0,41,41,22,46,68,259,197,456,0.000333,0.925294,44,122138.8544,6785.491914,2775.883056,352.191346,15,5
0,0,19,19,20,29,49,114,90,204,0.000333,0.3818,30,34362.02425,1909.001347,1145.400808,227.320011,8,5
0,0,14,14,17,31,48,75,66,141,0.000333,0.262493,16,12599.6754,699.981967,787.479713,223.066954,6,5
0,0,9,9,16,27,43,47,44,91,0.000333,0.164597,8,3950.320741,219.462263,493.790093,192.381963,4,5
0,0,8,8,16,20,36,44,37,81,0.000333,0.139588,8,3350.111401,186.1173,418.763925,150.438562,5,5
0,0,40,40,25,58,83,197,159,356,0.000333,0.756505,24,54468.3369,3026.018717,2269.514038,455.859302,13,5
0,0,24,24,23,44,67,126,103,229,0.000333,0.463045,22,30560.95734,1697.830963,1389.134425,344.256916,9,5
0,0,21,21,23,39,62,114,93,207,0.000333,0.41084,22,27115.41,1506.411667,1232.518636,310.172612,11,5
0,0,5,5,10,17,27,19,22,41,0.000333,0.064983,5,974.751938,54.152885,194.950388,102.706149,1,5
0,0,6,6,11,19,30,33,30,63,0.000333,0.103045,5,1545.670538,85.870585,309.134108,118.764371,3,5
0,0,7,7,11,16,27,31,26,57,0.000333,0.090343,5,1355.142938,75.285719,271.028588,102.053748,4,5
1,0,11,12,14,32,46,46,52,98,0.000333,0.180436,7,3789.163502,210.509083,541.309072,213.302969,2,5
1,0,9,10,14,27,41,36,40,76,0.000333,0.135725,7,2850.217666,158.345426,407.173952,181.684931,2,5
1,0,11,12,14,32,46,46,52,98,0.000333,0.180436,7,3789.163502,210.509083,541.309072,213.302969,2,5
1,0,9,10,14,27,41,36,40,76,0.000333,0.135725,7,2850.217666,158.345426,407.173952,181.684931,2,5
0,0,62,62,23,32,55,237,189,426,0.000333,0.820953,55,135457.2581,7525.403227,2462.859238,264.041925,23,5
0,0,4,4,10,15,25,15,19,34,0.000333,0.05263,5,789.455552,43.858642,157.89111,91.82264,1,5
0,0,14,14,13,30,43,106,90,196,0.000333,0.354516,18,19143.86206,1063.547892,1063.547892,195.312434,9,5
0,0,13,13,13,29,42,99,84,183,0.000333,0.328931,12,11841.52906,657.862726,986.794088,188.987165,9,5
0,0,12,12,12,26,38,88,76,164,0.000333,0.286887,12,10327.92135,573.773408,860.660112,165.230983,9,5
0,0,11,11,12,26,38,81,70,151,0.000333,0.264146,12,9509.244654,528.29137,792.437055,165.230983,9,5
0,0,6,6,12,19,31,39,38,77,0.000333,0.127158,12,4577.677391,254.315411,381.473116,123.730173,4,5
0,0,19,19,24,27,51,132,98,230,0.000333,0.434886,36,46967.68183,2609.315657,1304.657829,238.421063,9,5
0,0,19,19,24,27,51,132,98,230,0.000333,0.434886,36,46967.68183,2609.315657,1304.657829,238.421063,9,5
0,0,40,40,25,60,85,288,238,526,0.000333,1.12378,36,121368.2268,6742.679265,3371.339632,470.50984,15,5
0,0,41,41,24,60,84,286,239,525,0.000333,1.118656,36,120814.7993,6711.933294,3355.966647,464.452536,15,5
0,0,35,35,23,56,79,235,198,433,0.000333,0.909846,33,90074.72311,5004.151284,2729.537064,429.253801,14,5
0,0,119,119,34,65,99,524,358,882,0.000333,1.949031,85,497002.8658,27611.27032,5847.092539,564.427644,72,5
0,0,119,119,34,65,99,524,358,882,0.000333,1.949031,85,497002.8658,27611.27032,5847.092539,564.427644,72,5
0,0,65,65,33,51,84,312,219,531,0.000333,1.13144,64,217236.5153,12068.69529,3394.320551,455.758698,48,5
0,0,27,27,27,36,63,135,104,239,0.000333,0.47619,26,37142.81745,2063.489858,1428.569902,314.499263,24,5
0,0,47,47,32,45,77,240,173,413,0.000333,0.862728,48,124232.7764,6901.82091,2588.182841,407.133389,40,5
0,0,34,34,29,42,71,180,135,315,0.000333,0.645723,42,81361.15439,4520.064133,1937.170343,367.358781,31,5
0,0,33,33,29,40,69,168,129,297,0.000333,0.604744,42,76197.73407,4233.207449,1814.231764,353.758573,28,5
0,0,32,32,29,39,68,165,125,290,0.000333,0.588455,42,74145.29741,4119.183189,1765.364224,347.012135,28,5
0,0,113,113,28,82,110,390,342,732,0.000333,1.654652,56,277981.4974,15443.41652,4963.95531,655.925202,34,5
0,0,113,113,28,82,110,390,342,732,0.000333,1.654652,56,277981.4974,15443.41652,4963.95531,655.925202,34,5
0,0,113,113,28,82,110,390,342,732,0.000333,1.654652,56,277981.4974,15443.41652,4963.95531,655.925202,34,5
0,0,94,94,28,69,97,307,267,574,0.000333,1.262783,42,159110.6988,8839.483267,3788.349971,556.094125,32,5
0,0,94,94,28,69,97,307,267,574,0.000333,1.262783,42,159110.6988,8839.483267,3788.349971,556.094125,32,5
0,0,94,94,28,69,97,307,267,574,0.000333,1.262783,42,159110.6988,8839.483267,3788.349971,556.094125,32,5
0,0,101,101,28,77,105,342,299,641,0.000333,1.43461,42,180760.9178,10042.27321,4303.831377,617.148501,32,5
0,0,96,96,28,73,101,317,276,593,0.000333,1.316106,42,165829.4152,9212.745288,3948.319409,586.463131,32,5
0,0,26,26,22,38,60,93,91,184,0.000333,0.362289,22,23911.09313,1328.394063,1086.86787,297.528741,8,5
0,0,25,25,22,38,60,91,89,180,0.000333,0.354413,22,23391.28676,1299.515931,1063.240307,297.528741,8,5
1,0,6,7,10,19,29,31,28,59,0.000333,0.09554,5,1433.104394,79.616911,286.620879,113.929904,5,5
0,0,52,52,29,74,103,287,233,520,0.000333,1.158993,42,146033.1715,8112.953973,3476.980274,600.380998,24,5
1,0,38,39,26,40,66,195,145,340,0.000333,0.685031,39,80148.66602,4452.703668,2055.094001,335.088556,12,5
1,0,35,36,26,40,66,183,138,321,0.000333,0.64675,39,75669.76998,4203.87611,1940.250512,335.088556,11,5
1,0,35,36,26,40,66,183,138,321,0.000333,0.64675,39,75669.76998,4203.87611,1940.250512,335.088556,11,5
1,0,35,36,26,40,66,183,138,321,0.000333,0.64675,39,75669.76998,4203.87611,1940.250512,335.088556,11,5
1,0,35,36,26,40,66,183,138,321,0.000333,0.64675,39,75669.76998,4203.87611,1940.250512,335.088556,11,5
1,0,8,9,14,23,37,52,46,98,0.000333,0.170175,14,7147.370018,397.076112,510.52643,157.344894,3,5
0,0,8,8,15,16,31,42,33,75,0.000333,0.123855,14,5201.906126,288.994785,371.564723,122.603359,4,5
0,0,59,59,30,72,102,302,244,546,0.000333,1.214381,45,163941.4907,9107.860592,3643.144237,591.441318,28,5
0,0,59,59,30,72,102,303,245,548,0.000333,1.21883,45,164542.0089,9141.222719,3656.489087,591.441318,28,5
0,0,66,66,30,72,102,322,264,586,0.000333,1.303347,45,175951.8563,9775.103126,3910.04125,591.441318,28,5
0,0,21,21,18,31,49,89,87,176,0.000333,0.329396,18,17787.40079,988.188933,988.188933,228.638736,4,5
0,0,17,17,18,27,45,63,66,129,0.000333,0.23615,18,12752.08289,708.449049,708.449049,203.440613,4,5
0,0,17,17,18,27,45,63,66,129,0.000333,0.23615,18,12752.08289,708.449049,708.449049,203.440613,4,5
0,0,12,12,15,22,37,39,45,84,0.000333,0.145865,14,6126.317158,340.350953,437.594083,156.710855,3,5
0,0,51,51,25,54,79,255,198,453,0.000333,0.951871,36,102802.0564,5711.225358,2855.612679,426.86033,19,5
0,0,51,51,25,54,79,255,198,453,0.000333,0.951871,36,102802.0564,5711.225358,2855.612679,426.86033,19,5
0,0,51,51,25,54,79,255,198,453,0.000333,0.951871,36,102802.0564,5711.225358,2855.612679,426.86033,19,5
0,0,45,45,27,54,81,267,209,476,0.000333,1.005923,39,117692.9755,6538.498636,3017.768601,439.145888,42,5
0,0,9,9,16,26,42,71,49,120,0.000333,0.215693,8,5176.624726,287.590263,647.078091,186.211433,7,5
1,0,12,13,10,24,34,21,31,52,0.000333,0.088183,5,1322.740339,73.485574,264.548068,143.258381,1,5
0,0,30,30,25,35,60,150,125,275,0.000333,0.541465,36,58478.2169,3248.789828,1624.394914,295.62131,26,5
0,0,21,21,23,25,48,95,79,174,0.000333,0.323928,33,32068.85468,1781.603038,971.783475,220.13833,24,5
0,0,21,21,23,25,48,95,79,174,0.000333,0.323928,33,32068.85468,1781.603038,971.783475,220.13833,24,5
0,0,21,21,23,25,48,95,79,174,0.000333,0.323928,33,32068.85468,1781.603038,971.783475,220.13833,24,5
0,0,8,8,16,25,41,59,51,110,0.000333,0.196444,16,9429.291528,523.849529,589.330721,180.096405,4,5
1,0,96,97,31,132,163,565,404,969,0.000333,2.373639,45,320441.2912,17802.29395,7120.917581,1083.440109,76,5
1,0,59,60,29,81,110,284,217,501,0.000333,1.132487,28,95128.91406,5284.93967,3397.461216,654.409299,41,5
1,0,60,61,28,79,107,287,220,507,0.000333,1.139308,28,95701.86534,5316.770297,3417.923762,632.604617,40,5
1,0,55,56,28,72,100,264,199,463,0.000333,1.025368,28,86130.95164,4785.052869,3076.105416,578.840538,35,5
1,0,56,57,28,73,101,267,203,470,0.000333,1.04312,28,87622.06311,4867.892395,3129.359397,586.463131,37,5
1,0,55,56,28,72,100,264,199,463,0.000333,1.025368,28,86130.95164,4785.052869,3076.105416,578.840538,35,5
0,0,7,7,14,17,31,37,32,69,0.000333,0.113947,7,2392.876818,132.937601,341.839545,122.789837,4,5
0,0,65,65,23,40,63,282,207,489,0.000333,0.974297,55,160758.9435,8931.052419,2922.889883,316.919049,29,5
0,0,53,53,23,39,62,239,173,412,0.000333,0.81771,44,107937.6707,5996.537262,2453.12888,310.172612,25,5
0,0,45,45,23,38,61,199,146,345,0.000333,0.682035,33,67521.44459,3751.191366,2046.104381,303.463171,22,5
0,0,36,36,21,35,56,135,105,240,0.000333,0.464588,30,41812.95544,2322.941969,1393.765181,271.763571,12,5
0,0,25,25,25,40,65,135,114,249,0.000333,0.499857,24,35989.67005,1999.426114,1499.569585,328.973529,17,5
0,0,25,25,25,40,65,135,114,249,0.000333,0.499857,24,35989.67005,1999.426114,1499.569585,328.973529,17,5
0,0,25,25,25,40,65,135,114,249,0.000333,0.499857,24,35989.67005,1999.426114,1499.569585,328.973529,17,5
0,0,87,87,31,73,104,549,444,993,0.000333,2.217846,90,598818.2976,33267.6832,6653.53664,605.437278,45,5
0,0,43,43,26,48,74,185,154,339,0.000333,0.701668,39,82095.18295,4560.843497,2105.004691,390.289633,27,5
0,0,42,42,26,48,74,182,152,334,0.000333,0.691319,39,80884.33954,4493.574419,2073.957424,390.289633,26,5
0,0,46,46,28,51,79,212,178,390,0.000333,0.819491,42,103255.9287,5736.440481,2458.474492,423.89963,32,5
0,0,35,35,25,43,68,152,126,278,0.000333,0.564105,24,40615.55208,2256.41956,1692.31467,349.425789,23,5
0,0,21,21,18,29,47,112,88,200,0.000333,0.370306,27,29994.7798,1666.376656,1110.91777,215.940099,8,5
0,0,21,21,18,29,47,112,88,200,0.000333,0.370306,27,29994.7798,1666.376656,1110.91777,215.940099,8,5
0,0,29,29,18,36,54,133,89,222,0.000333,0.425862,18,22996.53046,1277.585025,1277.585025,261.17595,13,5
0,0,41,41,25,37,62,186,143,329,0.000333,0.652977,36,70521.5011,3917.861172,1958.930586,308.846179,18,5
0,0,41,41,25,37,62,186,143,329,0.000333,0.652977,36,70521.5011,3917.861172,1958.930586,308.846179,18,5
0,0,41,41,25,37,62,186,143,329,0.000333,0.652977,36,70521.5011,3917.861172,1958.930586,308.846179,18,5
0,0,30,30,17,27,44,114,95,209,0.000333,0.38034,24,27384.509,1521.361611,1141.021208,197.868831,8,5
0,0,43,43,17,29,46,165,136,301,0.000333,0.554197,32,53202.94876,2955.719376,1662.592149,210.368317,8,5
1,0,8,9,14,13,27,57,32,89,0.000333,0.141062,14,5924.589828,329.143879,423.184988,101.408685,3,5
0,0,88,88,30,101,131,467,315,782,0.000333,1.833379,45,247506.1554,13750.34197,5500.136787,819.686078,36,5
0,0,89,89,29,102,131,469,323,792,0.000333,1.856824,42,233959.7827,12997.76571,5570.471017,821.468834,37,5
0,0,79,79,29,97,126,407,280,687,0.000333,1.597797,28,134214.9566,7456.386478,4793.391307,781.072995,34,5
0,0,39,39,27,58,85,236,185,421,0.000333,0.899451,39,105235.7898,5846.432766,2698.353584,468.14486,12,5
0,0,39,39,27,58,85,236,185,421,0.000333,0.899451,39,105235.7898,5846.432766,2698.353584,468.14486,12,5
0,0,33,33,26,51,77,188,145,333,0.000333,0.695613,26,54257.83787,3014.324326,2086.839918,411.505125,12,5
1,0,69,70,29,69,98,329,239,568,0.000333,1.252385,42,157800.518,8766.695447,3757.155191,562.369636,29,5
1,0,99,100,32,68,100,574,371,945,0.000333,2.092815,80,502275.5279,27904.196,6278.444099,573.947473,54,5
1,0,68,69,32,66,98,435,332,767,0.000333,1.691161,80,405878.596,22548.81089,5073.48245,558.930012,35,5
0,0,63,63,29,67,96,392,298,690,0.000333,1.514541,56,254442.951,14135.7195,4543.624125,547.309425,34,5
0,0,68,68,29,70,99,408,308,716,0.000333,1.582206,56,265810.683,14767.26017,4746.61934,569.93126,36,5
0,0,77,77,25,82,107,339,256,595,0.000333,1.337058,36,144402.2228,8022.345714,4011.172857,637.415669,34,5
0,0,23,23,22,35,57,107,86,193,0.000333,0.375249,22,24766.451,1375.913944,1125.747773,277.632401,12,5
0,0,53,53,33,85,118,308,251,559,0.000333,1.282466,32,123116.7189,6839.817715,3847.397465,711.263236,32,5
0,0,86,86,22,83,105,407,292,699,0.000333,1.564419,33,154877.5014,8604.305631,4693.257617,627.235768,42,5
0,0,21,21,24,39,63,118,84,202,0.000333,0.40247,24,28977.85307,1609.880726,1207.410545,316.169787,7,5
0,0,34,34,27,56,83,197,131,328,0.000333,0.697004,26,54366.33627,3020.352015,2091.012933,453.593838,13,5
0,0,79,79,30,73,103,429,273,702,0.000333,1.564641,45,211226.5517,11734.80843,4693.92337,599.063911,34,5
0,0,29,29,24,47,71,155,106,261,0.000333,0.535028,24,38522.01596,2140.111998,1605.083998,371.104776,19,5
0,0,93,93,36,117,153,486,344,830,0.000333,2.007877,36,216850.7487,12047.26382,6023.631909,989.949972,48,5
0,0,73,73,34,102,136,398,277,675,0.000333,1.594679,34,162657.2722,9036.515123,4784.037418,853.561121,39,5
0,0,75,75,34,105,139,410,286,696,0.000333,1.651594,34,168462.6215,9359.03453,4954.782987,877.969516,42,5
0,0,94,94,36,111,147,489,342,831,0.000333,1.994309,54,323078.0968,17948.78316,5982.927719,940.297461,48,5
0,0,74,74,34,98,132,401,275,676,0.000333,1.587337,34,161908.3544,8994.90858,4762.010425,821.215301,39,5
0,0,76,76,34,101,135,413,284,697,0.000333,1.64418,34,167706.376,9317.02089,4932.540471,845.453096,42,5
0,0,23,23,25,46,71,126,92,218,0.000333,0.446882,24,32175.47693,1787.526496,1340.644872,370.180255,7,5
0,0,21,21,25,46,71,120,89,209,0.000333,0.428432,12,15423.56578,856.864765,1285.297148,370.180255,7,5
2,0,14,16,16,57,73,143,128,271,0.000333,0.559147,16,26839.07929,1491.05996,1677.442455,396.474731,6,5
2,0,13,15,15,55,70,137,123,260,0.000333,0.531205,14,22310.59018,1239.477232,1593.613584,376.578143,6,5
3,0,13,16,15,28,43,81,86,167,0.000333,0.302062,21,19029.9105,1057.21725,906.186214,193.209297,2,5
3,0,20,23,17,39,56,130,135,265,0.000333,0.512983,24,36934.7773,2051.932072,1538.949054,275.617555,5,5
3,0,28,31,16,44,60,138,130,268,0.000333,0.527682,16,25328.74687,1407.152604,1583.04668,304.214991,7,5
2,0,56,58,19,65,84,322,278,600,0.000333,1.278463,36,138074.0563,7670.780907,3835.390454,472.164531,20,5
3,0,28,31,16,44,60,138,130,268,0.000333,0.527682,16,25328.74687,1407.152604,1583.04668,304.214991,7,5
2,0,56,58,19,65,84,322,278,600,0.000333,1.278463,36,138074.0563,7670.780907,3835.390454,472.164531,20,5
3,0,28,31,16,44,60,138,130,268,0.000333,0.527682,16,25328.74687,1407.152604,1583.04668,304.214991,7,5
2,0,56,58,19,66,85,322,279,601,0.000333,1.284015,36,138673.5823,7704.087905,3852.043953,479.640635,20,5
3,0,28,31,16,45,61,138,131,269,0.000333,0.531789,16,25525.8935,1418.105194,1595.368344,311.133389,7,5
3,0,57,60,23,62,85,303,257,560,0.000333,1.19642,44,157927.3927,8773.744037,3589.258924,473.202096,25,5
2,0,70,72,19,67,86,429,364,793,0.000333,1.698676,45,229321.2578,12740.06988,5096.02795,487.138599,27,5
3,0,42,45,19,58,77,245,216,461,0.000333,0.962996,27,78002.69207,4333.482893,2888.988595,420.47352,14,5
3,0,54,57,23,62,85,288,245,533,0.000333,1.138735,33,112734.7772,6263.043176,3416.205369,473.202096,23,5
2,0,56,58,19,65,84,322,278,600,0.000333,1.278463,36,138074.0563,7670.780907,3835.390454,472.164531,20,5
3,0,28,31,16,44,60,138,130,268,0.000333,0.527682,16,25328.74687,1407.152604,1583.04668,304.214991,7,5
2,0,56,58,19,65,84,322,278,600,0.000333,1.278463,36,138074.0563,7670.780907,3835.390454,472.164531,20,5
3,0,28,31,16,44,60,138,130,268,0.000333,0.527682,16,25328.74687,1407.152604,1583.04668,304.214991,7,5
2,0,56,58,19,66,85,322,279,601,0.000333,1.284015,36,138673.5823,7704.087905,3852.043953,479.640635,20,5
3,0,28,31,16,45,61,138,131,269,0.000333,0.531789,16,25525.8935,1418.105194,1595.368344,311.133389,7,5
2,0,56,58,19,64,83,322,278,600,0.000333,1.275008,36,137700.8517,7650.047318,3825.023659,464.710623,20,5
3,0,28,31,16,44,60,138,130,268,0.000333,0.527682,16,25328.74687,1407.152604,1583.04668,304.214991,7,5
2,0,56,58,19,65,84,322,278,600,0.000333,1.278463,36,138074.0563,7670.780907,3835.390454,472.164531,20,5
3,0,28,31,16,44,60,138,130,268,0.000333,0.527682,16,25328.74687,1407.152604,1583.04668,304.214991,7,5
2,0,56,58,19,65,84,322,278,600,0.000333,1.278463,36,138074.0563,7670.780907,3835.390454,472.164531,20,5
3,0,28,31,16,44,60,138,130,268,0.000333,0.527682,16,25328.74687,1407.152604,1583.04668,304.214991,7,5
2,0,56,58,19,65,84,322,278,600,0.000333,1.278463,36,138074.0563,7670.780907,3835.390454,472.164531,20,5
3,0,28,31,16,44,60,138,130,268,0.000333,0.527682,16,25328.74687,1407.152604,1583.04668,304.214991,7,5
3,0,14,17,15,34,49,105,103,208,0.000333,0.389287,21,24525.0526,1362.502922,1167.859648,231.577096,3,5
3,0,21,24,17,43,60,154,152,306,0.000333,0.602503,24,43380.20453,2410.011363,1807.508522,302.816253,6,5
3,0,29,32,16,45,61,162,147,309,0.000333,0.610866,24,43982.3481,2443.463783,1832.597837,311.133389,8,5
2,0,57,59,19,65,84,346,295,641,0.000333,1.365825,36,147509.1168,8194.950936,4097.475468,472.164531,21,5
3,0,29,32,16,45,61,162,147,309,0.000333,0.610866,24,43982.3481,2443.463783,1832.597837,311.133389,8,5
2,0,57,59,19,65,84,346,295,641,0.000333,1.365825,36,147509.1168,8194.950936,4097.475468,472.164531,21,5
3,0,29,32,16,45,61,162,147,309,0.000333,0.610866,24,43982.3481,2443.463783,1832.597837,311.133389,8,5
2,0,57,59,19,66,85,346,296,642,0.000333,1.37161,36,148133.8433,8229.657962,4114.828981,479.640635,21,5
3,0,29,32,16,46,62,162,148,310,0.000333,0.615267,24,44299.22055,2461.067808,1845.800856,318.08385,8,5
3,0,58,61,23,62,85,327,274,601,0.000333,1.284015,44,169489.9339,9416.10744,3852.043953,473.202096,26,5
2,0,71,73,19,67,86,453,381,834,0.000333,1.786502,45,241177.7162,13398.76201,5359.504805,487.138599,28,5
3,0,43,46,19,60,79,269,233,502,0.000333,1.054833,27,85441.44426,4746.746903,3164.497936,435.124058,15,5
3,0,55,58,23,62,85,312,262,574,0.000333,1.22633,44,161875.5775,8993.087638,3678.990397,473.202096,24,5
2,0,57,59,19,65,84,346,295,641,0.000333,1.365825,36,147509.1168,8194.950936,4097.475468,472.164531,21,5
3,0,29,32,16,45,61,162,147,309,0.000333,0.610866,24,43982.3481,2443.463783,1832.597837,311.133389,8,5
2,0,57,59,19,65,84,346,295,641,0.000333,1.365825,36,147509.1168,8194.950936,4097.475468,472.164531,21,5
3,0,29,32,16,45,61,162,147,309,0.000333,0.610866,24,43982.3481,2443.463783,1832.597837,311.133389,8,5
2,0,57,59,19,66,85,346,296,642,0.000333,1.37161,36,148133.8433,8229.657962,4114.828981,479.640635,21,5
3,0,29,32,16,46,62,162,148,310,0.000333,0.615267,24,44299.22055,2461.067808,1845.800856,318.08385,8,5
2,0,57,59,19,64,83,346,295,641,0.000333,1.362133,36,147110.4099,8172.800551,4086.400275,464.710623,21,5
3,0,29,32,16,45,61,162,147,309,0.000333,0.610866,24,43982.3481,2443.463783,1832.597837,311.133389,8,5
2,0,57,59,19,65,84,346,295,641,0.000333,1.365825,36,147509.1168,8194.950936,4097.475468,472.164531,21,5
3,0,29,32,16,45,61,162,147,309,0.000333,0.610866,24,43982.3481,2443.463783,1832.597837,311.133389,8,5
2,0,57,59,19,65,84,346,295,641,0.000333,1.365825,36,147509.1168,8194.950936,4097.475468,472.164531,21,5
3,0,29,32,16,45,61,162,147,309,0.000333,0.610866,24,43982.3481,2443.463783,1832.597837,311.133389,8,5
2,0,57,59,19,65,84,346,295,641,0.000333,1.365825,36,147509.1168,8194.950936,4097.475468,472.164531,21,5
3,0,29,32,16,45,61,162,147,309,0.000333,0.610866,24,43982.3481,2443.463783,1832.597837,311.133389,8,5
1,0,13,14,19,41,60,99,79,178,0.000333,0.350476,9,9462.838734,525.713263,1051.426526,300.370255,8,5
2,0,33,35,26,69,95,234,195,429,0.000333,0.939489,26,73280.16946,4071.120525,2818.468056,543.69962,18,5
2,0,33,35,26,69,95,234,195,429,0.000333,0.939489,26,73280.16946,4071.120525,2818.468056,543.69962,18,5
2,0,36,38,28,71,99,256,216,472,0.000333,1.043019,42,131420.3656,7301.131424,3129.056325,571.237983,18,5
3,0,50,53,28,80,108,315,262,577,0.000333,1.29919,42,163697.9437,9094.330207,3897.570089,640.360185,23,5
2,0,78,80,28,98,126,499,410,909,0.000333,2.114116,56,355171.4572,19731.74762,6342.34745,782.847503,36,5
3,0,50,53,28,80,108,315,262,577,0.000333,1.29919,42,163697.9437,9094.330207,3897.570089,640.360185,23,5
2,0,33,35,26,69,95,234,195,429,0.000333,0.939489,26,73280.16946,4071.120525,2818.468056,543.69962,18,5
2,0,33,35,26,69,95,234,195,429,0.000333,0.939489,26,73280.16946,4071.120525,2818.468056,543.69962,18,5
2,0,36,38,28,71,99,256,216,472,0.000333,1.043019,42,131420.3656,7301.131424,3129.056325,571.237983,18,5
3,0,50,53,28,80,108,315,262,577,0.000333,1.29919,42,163697.9437,9094.330207,3897.570089,640.360185,23,5
2,0,78,80,28,98,126,499,410,909,0.000333,2.114116,56,355171.4572,19731.74762,6342.34745,782.847503,36,5
3,0,50,53,28,80,108,315,262,577,0.000333,1.29919,42,163697.9437,9094.330207,3897.570089,640.360185,23,5
2,0,33,35,26,69,95,234,195,429,0.000333,0.939489,26,73280.16946,4071.120525,2818.468056,543.69962,18,5
2,0,33,35,26,69,95,234,195,429,0.000333,0.939489,26,73280.16946,4071.120525,2818.468056,543.69962,18,5
2,0,36,38,28,71,99,256,216,472,0.000333,1.043019,42,131420.3656,7301.131424,3129.056325,571.237983,18,5
3,0,50,53,28,80,108,315,262,577,0.000333,1.29919,42,163697.9437,9094.330207,3897.570089,640.360185,23,5
2,0,78,80,28,98,126,499,410,909,0.000333,2.114116,56,355171.4572,19731.74762,6342.34745,782.847503,36,5
3,0,50,53,28,80,108,315,262,577,0.000333,1.29919,42,163697.9437,9094.330207,3897.570089,640.360185,23,5
2,0,32,34,26,67,93,213,177,390,0.000333,0.850091,26,66307.07035,3683.72613,2550.271936,528.639408,18,5
2,0,32,34,26,67,93,213,177,390,0.000333,0.850091,26,66307.07035,3683.72613,2550.271936,528.639408,18,5
2,0,35,37,28,69,97,235,198,433,0.000333,0.952587,28,80017.3433,4445.407961,2857.762261,556.094125,18,5
3,0,49,52,28,78,106,294,244,538,0.000333,1.20654,42,152024.0906,8445.782811,3619.621205,624.867311,23,5
2,0,77,79,28,96,124,478,392,870,0.000333,2.016717,56,338808.4442,18822.69135,6050.15079,766.762338,36,5
3,0,49,52,28,78,106,294,244,538,0.000333,1.20654,42,152024.0906,8445.782811,3619.621205,624.867311,23,5
2,0,58,60,19,70,89,365,307,672,0.000333,1.450564,36,156660.9432,8703.385731,4351.692866,509.760434,24,5
3,0,44,47,24,73,97,270,233,503,0.000333,1.106585,36,119511.2217,6639.512319,3319.75616,561.896293,17,5
3,0,60,63,27,83,110,352,278,630,0.000333,1.424086,39,166618.0082,9256.556009,4272.25662,657.510235,28,5
3,0,44,47,24,75,99,272,235,507,0.000333,1.120361,36,120999.017,6722.167613,3361.083806,577.200502,17,5
5,0,57,62,27,87,114,336,298,634,0.000333,1.444017,39,168950.0385,9386.113249,4332.052269,688.918047,21,5
5,0,69,74,29,98,127,416,348,764,0.000333,1.779785,42,224252.9142,12458.49524,5339.355101,789.123014,29,5
2,0,45,47,26,77,103,281,242,523,0.000333,1.16568,39,136384.5513,7576.919514,3497.039776,604.753996,21,5
2,0,44,46,23,78,101,251,222,473,0.000333,1.049778,22,69285.34869,3849.186038,3149.334031,594.303298,19,5
2,0,47,49,26,89,115,315,263,578,0.000333,1.318898,26,102874.0245,5715.223583,3956.693249,698.551708,21,5
3,0,43,46,24,76,100,268,234,502,0.000333,1.111739,36,120067.7691,6670.431615,3335.215807,584.881591,16,5
3,0,45,48,27,82,109,289,248,537,0.000333,1.211505,39,141746.0843,7874.782462,3634.514982,649.701227,19,5
3,0,43,46,21,66,87,263,220,483,0.000333,1.037314,30,93358.25126,5186.569514,3111.941708,491.168678,19,5
5,0,75,80,27,100,127,412,346,758,0.000333,1.765808,39,206599.4967,11477.74982,5297.422993,792.767582,30,5
3,0,45,48,26,82,108,298,250,548,0.000333,1.233893,39,144365.4557,8020.303094,3701.678351,643.530697,21,5
2,0,31,33,17,53,70,181,157,338,0.000333,0.690566,16,33147.16256,1841.509031,2071.69766,373.066652,11,5
3,0,46,49,26,85,111,301,251,552,0.000333,1.250173,26,97513.45651,5417.414251,3750.517558,667.009662,21,5
2,0,54,56,18,68,86,321,272,593,0.000333,1.270258,36,137187.9,7621.549999,3810.775,489.006123,22,5
3,0,40,43,23,71,94,226,198,424,0.000333,0.926382,22,61141.20481,3396.7336,2779.145673,540.67397,15,5
3,0,56,59,27,81,108,308,243,551,0.000333,1.240648,39,145155.7775,8064.209863,3721.943014,641.909813,26,5
3,0,40,43,23,73,96,228,200,428,0.000333,0.939455,22,62004.00691,3444.66705,2818.36395,555.899118,15,5
5,0,53,58,26,83,109,292,263,555,0.000333,1.252114,39,146497.3497,8138.741651,3756.3423,651.339705,19,5
5,0,65,70,28,96,124,372,313,685,0.000333,1.587875,42,200072.2279,11115.12377,4763.624473,766.762338,27,5
2,0,41,43,25,75,100,237,207,444,0.000333,0.983291,24,70796.93156,3933.162864,2949.872148,583.257807,19,5
2,0,40,42,22,74,96,207,187,394,0.000333,0.864825,22,57078.45496,3171.025275,2594.475225,557.607045,17,5
2,0,43,45,25,87,112,271,228,499,0.000333,1.13229,24,81524.88255,4529.160141,3396.870106,676.632489,19,5
3,0,39,42,23,74,97,224,199,423,0.000333,0.930588,22,61418.78891,3412.154939,2791.763132,563.541474,14,5
3,0,41,44,26,80,106,245,213,458,0.000333,1.027129,26,80116.07677,4450.893154,3081.387568,627.96568,17,5
3,0,39,42,21,64,85,219,185,404,0.000333,0.863131,20,51787.87876,2877.104376,2589.393938,476.238666,17,5
5,0,71,76,26,96,122,368,311,679,0.000333,1.568657,39,183532.8554,10196.26975,4705.970652,754.367833,28,5
3,0,41,44,26,80,106,254,215,469,0.000333,1.051798,26,82040.26202,4557.792335,3155.394693,627.96568,19,5
2,0,27,29,16,49,65,137,122,259,0.000333,0.519931,16,24956.69222,1386.482901,1559.793264,339.120782,9,5
3,0,42,45,25,83,108,257,216,473,0.000333,1.065021,24,76681.48293,4260.082385,3195.061789,645.224678,19,5
2,0,55,57,18,68,86,344,290,634,0.000333,1.358084,36,146673.0668,8148.503709,4074.251854,489.006123,23,5
3,0,41,44,23,71,94,249,216,465,0.000333,1.015961,33,100580.1659,5587.786996,3047.883816,540.67397,16,5
3,0,57,60,27,81,108,331,261,592,0.000333,1.332964,39,155956.8427,8664.269036,3998.893401,641.909813,27,5
3,0,41,44,23,73,96,251,218,469,0.000333,1.029449,22,67943.64308,3774.646838,3088.347413,555.899118,16,5
5,0,54,59,26,85,111,315,281,596,0.000333,1.349824,39,157929.4024,8773.855689,4049.471856,667.009662,20,5
5,0,66,71,28,96,124,395,331,726,0.000333,1.682916,42,212047.3539,11780.40855,5048.746521,766.762338,28,5
2,0,42,44,25,75,100,260,225,485,0.000333,1.07409,36,116001.7291,6444.540504,3222.270252,583.257807,20,5
2,0,41,43,22,76,98,230,205,435,0.000333,0.959133,22,63302.77321,3516.820734,2877.398782,572.949987,18,5
2,0,44,46,25,87,112,294,246,540,0.000333,1.225324,24,88223.31979,4901.295544,3675.971658,676.632489,20,5
3,0,40,43,23,74,97,247,217,464,0.000333,1.020787,22,67371.91029,3742.883905,3062.359559,563.541474,15,5
3,0,42,45,26,80,106,268,231,499,0.000333,1.119077,26,87288.03998,4849.335554,3357.232307,627.96568,18,5
3,0,40,43,21,64,85,242,203,445,0.000333,0.950726,30,85565.369,4753.631611,2852.178967,476.238666,18,5
5,0,72,77,26,98,124,391,329,720,0.000333,1.669007,39,195273.8324,10848.54624,5007.021343,770.452997,29,5
3,0,42,45,26,80,106,277,233,510,0.000333,1.143746,26,89212.22523,4956.234735,3431.239432,627.96568,20,5
2,0,28,30,16,51,67,160,140,300,0.000333,0.606609,16,29117.22811,1617.623784,1819.826757,353.293692,10,5
3,0,43,46,25,83,108,280,234,514,0.000333,1.157337,24,83328.29223,4629.349568,3472.012176,645.224678,20,5
4,0,94,98,26,82,108,440,373,813,0.000333,1.830575,52,285569.624,15864.97911,5491.723539,643.530697,33,5
4,0,94,98,26,82,108,441,374,815,0.000333,1.835078,52,286272.1323,15904.00735,5505.233314,643.530697,33,5
1,0,15,16,20,39,59,78,71,149,0.000333,0.292171,10,8765.138144,486.952119,876.513814,292.569248,7,5
1,0,14,15,20,40,60,75,71,146,0.000333,0.287469,10,8624.06027,479.114459,862.406027,299.315686,6,5
1,0,19,20,20,49,69,110,98,208,0.000333,0.423524,20,25411.46174,1411.747874,1270.573087,361.559344,8,5
1,0,19,20,20,49,69,111,99,210,0.000333,0.427597,20,25655.80272,1425.322373,1282.790136,361.559344,8,5
2,0,55,57,17,64,81,329,278,607,0.000333,1.282763,32,123145.2465,6841.402581,3848.288952,453.486868,20,5
3,0,41,44,22,65,87,234,204,438,0.000333,0.94067,33,93126.30529,5173.683627,2822.009251,489.561403,13,5
3,0,57,60,27,74,101,316,249,565,0.000333,1.253963,39,146713.69,8150.760557,3761.889488,587.881512,24,5
3,0,41,44,22,67,89,236,206,442,0.000333,0.954091,33,94455.04782,5247.502657,2862.274176,504.535471,13,5
5,0,54,59,25,79,104,300,269,569,0.000333,1.27085,36,137251.8072,7625.100399,3812.5502,614.095084,17,5
5,0,66,71,28,91,119,380,319,699,0.000333,1.606493,42,202418.0599,11245.44777,4819.477617,726.81525,25,5
2,0,42,44,24,69,93,245,213,458,0.000333,0.998312,36,107817.6505,5989.869471,2994.934735,531.527288,17,5
2,0,41,43,20,68,88,215,193,408,0.000333,0.878483,20,52708.96201,2928.275667,2635.4481,500.386035,15,5
2,0,44,46,24,82,106,279,234,513,0.000333,1.150474,24,82834.15664,4601.897591,3451.423193,631.358364,17,5
3,0,40,43,21,63,84,232,205,437,0.000333,0.931148,30,83803.28141,4655.737856,2793.442714,468.807301,12,5
3,0,42,45,25,74,99,253,219,472,0.000333,1.043019,24,75097.35179,4172.0751,3129.056325,575.595954,15,5
3,0,40,43,20,58,78,227,191,418,0.000333,0.875766,30,78818.94383,4378.830212,2627.298127,426.20146,15,5
5,0,72,77,25,90,115,376,317,693,0.000333,1.581308,36,170781.2858,9487.849211,4743.924605,700.363183,26,5
3,0,42,45,25,74,99,262,221,483,0.000333,1.067326,24,76847.50194,4269.305663,3201.979247,575.595954,17,5
2,0,28,30,14,44,58,145,128,273,0.000333,0.533076,14,22389.20336,1243.844631,1599.228812,293.51796,7,5
3,0,43,46,24,78,102,265,222,487,0.000333,1.083157,24,77987.3074,4332.628189,3249.471142,600.300473,17,5
7,0,105,112,22,68,90,507,453,960,0.000333,2.077393,66,411323.8122,22851.3229,6232.178972,512.054969,32,5
1,0,10,11,12,22,34,53,56,109,0.000333,0.184844,12,6654.401396,369.688966,554.53345,141.127046,3,5
1,0,10,11,12,22,34,53,56,109,0.000333,0.184844,12,6654.401396,369.688966,554.53345,141.127046,2,5
4,0,92,96,23,62,85,428,377,805,0.000333,1.719853,66,340530.9404,18918.38558,5159.559704,473.202096,27,5
1,0,16,17,18,30,48,109,111,220,0.000333,0.409564,27,33174.67725,1843.037625,1228.69175,222.265368,4,5
1,0,28,29,18,43,61,152,142,294,0.000333,0.581212,27,47078.19299,2615.455166,1743.636777,308.388034,9,5
1,0,12,13,14,28,42,75,72,147,0.000333,0.264224,14,11097.38926,616.521625,792.670661,187.908907,4,5
1,0,12,13,14,28,42,75,72,147,0.000333,0.264224,14,11097.38926,616.521625,792.670661,187.908907,3,5
4,0,94,98,24,64,88,450,393,843,0.000333,1.8151,72,392061.6615,21781.20342,5445.300855,494.0391,28,5
1,0,18,19,18,35,53,131,127,258,0.000333,0.492601,27,39900.69389,2216.705216,1477.803477,254.583556,5,5
1,0,30,31,19,45,64,174,158,332,0.000333,0.664,27,53784,2988,1992,327.844012,10,5
1,0,66,67,27,91,118,379,304,683,0.000333,1.566948,39,183332.9629,10185.16461,4700.845203,720.591275,33,5
1,0,66,67,27,91,118,377,300,677,0.000333,1.553183,39,181722.4244,10095.69025,4659.549344,720.591275,33,5
1,0,66,67,27,90,117,379,304,683,0.000333,1.564153,39,183005.905,10166.99472,4692.459103,712.648741,33,5
1,0,73,74,24,83,107,427,341,768,0.000333,1.725816,48,248517.439,13806.52439,5177.446646,639.167373,36,5
1,0,73,74,24,84,108,425,337,762,0.000333,1.715741,48,247066.7653,13725.9314,5147.224277,646.993764,36,5
1,0,73,74,24,83,107,427,341,768,0.000333,1.725816,48,248517.439,13806.52439,5177.446646,639.167373,36,5
1,0,57,58,25,102,127,480,392,872,0.000333,2.031378,36,219388.7897,12188.26609,6094.133047,796.68379,29,5
1,0,57,58,25,102,127,478,388,866,0.000333,2.0174,36,217879.2338,12104.40188,6052.200939,796.68379,29,5
1,0,57,58,25,101,126,480,392,872,0.000333,2.028063,36,219030.7714,12168.37619,6084.188093,788.575765,29,5
1,0,16,17,21,52,73,120,113,233,0.000333,0.480743,20,28844.58244,1602.476802,1442.229122,388.661531,7,5
1,0,16,17,21,51,72,122,117,239,0.000333,0.491537,20,29492.24151,1638.457861,1474.612075,381.532358,7,5
1,0,16,17,21,51,72,120,113,233,0.000333,0.479198,20,28751.85051,1597.325028,1437.592525,381.532358,7,5
1,0,16,17,21,50,71,122,117,239,0.000333,0.48993,20,29395.79123,1633.099513,1469.789562,374.431475,7,5
1,0,19,20,21,57,78,146,132,278,0.000333,0.582447,20,34946.83634,1941.490908,1747.341817,424.713397,8,5
1,0,19,20,21,56,77,148,136,284,0.000333,0.593256,20,35595.34755,1977.519308,1779.767378,417.450542,8,5
1,0,19,20,21,56,77,146,132,278,0.000333,0.580722,20,34843.33317,1935.740731,1742.166658,417.450542,8,5
1,0,19,20,21,55,76,148,136,284,0.000333,0.59147,20,35488.22828,1971.568238,1774.411414,410.21345,8,5
1,0,8,9,10,18,28,28,28,56,0.000333,0.089737,5,1346.059378,74.781077,269.211876,108.277931,2,5
1,0,10,11,12,24,36,50,44,94,0.000333,0.161991,6,2915.837701,161.990983,485.97295,153.05865,3,5
1,0,30,31,29,59,88,233,140,373,0.000333,0.803123,28,67462.30383,3747.905768,2409.367994,487.957389,25,5
3,0,32,35,30,57,87,238,192,430,0.000333,0.923489,45,124670.9566,6926.164258,2770.465703,479.681449,14,5
3,0,47,50,32,66,98,296,234,530,0.000333,1.168599,48,168278.2184,9348.789913,3505.796217,558.930012,19,5
3,0,11,14,14,32,46,95,101,196,0.000333,0.360873,21,22734.98101,1263.054501,1082.618143,213.302969,2,5
3,0,26,29,17,47,64,153,143,296,0.000333,0.592,24,42624,2368,1776,330.552544,7,5
3,0,13,16,15,38,53,118,117,235,0.000333,0.448687,21,28267.28744,1570.404858,1346.061307,258.024604,3,5
3,0,28,31,18,49,67,176,159,335,0.000333,0.67738,27,54867.77673,3048.209818,2032.139879,350.179432,8,5
2,0,20,22,22,50,72,163,132,295,0.000333,0.606709,22,40042.81326,2224.600737,1820.127875,380.300305,15,5
2,0,20,22,22,50,72,163,132,295,0.000333,0.606709,22,40042.81326,2224.600737,1820.127875,380.300305,15,5
2,0,23,25,24,52,76,185,153,338,0.000333,0.703933,24,50683.18799,2815.732666,2111.7995,406.461965,15,5
3,0,37,40,25,61,86,244,199,443,0.000333,0.948945,36,102486.0703,5693.670573,2846.835286,477.871382,20,5
2,0,65,67,25,79,104,428,347,775,0.000333,1.730947,48,249256.3575,13847.57542,5192.840782,614.095084,33,5
3,0,37,40,25,61,86,244,199,443,0.000333,0.948945,36,102486.0703,5693.670573,2846.835286,477.871382,20,5
3,0,25,28,25,62,87,200,175,375,0.000333,0.805368,24,57986.49146,3221.471748,2416.103811,485.256576,13,5
3,0,40,43,27,71,98,258,217,475,0.000333,1.047329,39,122537.4999,6807.638881,3141.987176,565.014008,18,5
1,0,11,12,14,13,27,42,35,77,0.000333,0.122042,14,5125.768727,284.764929,366.126338,101.408685,7,5
1,0,9,10,14,12,26,36,29,65,0.000333,0.101843,14,4277.400144,237.633341,305.528582,96.322519,7,5
9,0,62,71,26,65,91,321,232,553,0.000333,1.199603,39,140353.607,7797.422611,3598.810436,513.665341,33,5
0,0,18,18,23,41,64,110,77,187,0.000333,0.374,11,12342,685.666667,1122,323.701557,6,5
0,0,11,11,14,28,42,68,55,123,0.000333,0.221085,7,4642.785301,257.932517,663.255043,187.908907,8,5
1,0,13,14,22,25,47,57,50,107,0.000333,0.198114,22,13075.50216,726.416786,594.341007,214.2039,4,5
1,0,11,12,21,23,44,54,46,100,0.000333,0.181981,20,10918.86324,606.603513,545.943162,196.280591,3,5
1,0,12,13,22,24,46,56,48,104,0.000333,0.191483,22,12637.90976,702.106098,574.450443,208.146596,3,5
1,0,21,22,20,23,43,87,65,152,0.000333,0.274931,20,16495.84485,916.435825,824.792243,190.480487,9,5
0,0,56,56,22,59,81,233,221,454,0.000333,0.959431,33,94983.63274,5276.868486,2878.291901,445.183436,21,5
0,0,60,60,26,69,95,242,232,474,0.000333,1.038037,39,121450.3508,6747.24171,3114.111558,543.69962,20,5
0,0,26,26,19,43,62,118,95,213,0.000333,0.422748,18,22828.38865,1268.243814,1268.243814,314.040007,3,5
0,0,27,27,19,45,64,123,99,222,0.000333,0.444,18,23976,1332,1332,327.844012,3,5
0,0,22,22,19,37,56,89,69,158,0.000333,0.305854,9,8258.058699,458.781039,917.562078,273.460397,4,5
3,0,38,41,19,47,66,159,132,291,0.000333,0.586306,18,31660.5364,1758.918689,1758.918689,341.776299,7,5
0,0,31,31,19,48,67,158,105,263,0.000333,0.531794,18,28716.86623,1595.381457,1595.381457,348.788823,9,0
0,0,8,8,4,12,16,21,46,67,0.000333,0.089333,6,1608,89.333333,268,51.01955,1,0
0,0,9,9,6,13,19,25,48,73,0.000333,0.103366,9,2790.888376,155.049354,310.098708,63.615491,2,0
0,0,37,37,25,64,89,222,144,366,0.000333,0.790039,24,56882.84246,3160.157914,2370.118436,500.096405,15,0
0,0,37,37,25,64,89,222,144,366,0.000333,0.790039,24,56882.84246,3160.157914,2370.118436,500.096405,15,0
0,0,36,36,25,64,89,219,143,362,0.000333,0.781405,24,56261.17205,3125.620669,2344.215502,500.096405,14,0
0,0,27,27,19,46,65,121,87,208,0.000333,0.417551,9,11273.87255,626.326253,1252.652505,334.794473,12,0
0,0,27,27,19,46,65,120,87,207,0.000333,0.415543,9,11219.67124,623.315069,1246.630137,334.794473,12,0
0,0,7,7,9,10,19,18,16,34,0.000333,0.048143,4,577.718142,32.095452,144.429535,61.748606,3,0
0,0,7,7,8,10,18,17,16,33,0.000333,0.045869,4,550.4301,30.57945,137.607525,57.219281,3,0
0,0,9,9,9,15,24,29,31,60,0.000333,0.091699,8,2200.782,122.265667,275.09775,87.132684,1,0
0,0,29,29,19,51,70,132,102,234,0.000333,0.478084,18,25816.54007,1434.252226,1434.252226,370.004315,10,0
0,0,7,7,7,10,17,17,20,37,0.000333,0.050412,6,907.416751,50.412042,151.236125,52.870765,1,0
0,0,27,27,19,46,65,120,91,211,0.000333,0.423573,9,11436.47648,635.359804,1270.719609,334.794473,10,0
0,0,8,8,8,10,18,20,22,42,0.000333,0.058379,8,1401.0948,77.8386,175.13685,57.219281,1,0
0,0,28,28,20,46,66,123,93,216,0.000333,0.435196,20,26111.7826,1450.654589,1305.58913,340.522412,10,0
0,0,8,8,4,12,16,21,46,67,0.000333,0.089333,6,1608,89.333333,268,51.01955,1,0
0,0,9,9,6,13,19,25,48,73,0.000333,0.103366,9,2790.888376,155.049354,310.098708,63.615491,2,0
0,0,8,8,8,13,21,19,26,45,0.000333,0.065885,8,1581.234272,87.846348,197.654284,72.105716,1,0
0,0,11,11,13,20,33,37,37,74,0.000333,0.124428,6,2239.710989,124.428388,373.285165,134.544278,3,0
0,0,24,24,20,43,63,131,85,216,0.000333,0.430364,10,12910.92464,717.273591,1291.092463,319.767946,9,0
0,0,23,23,18,50,68,118,85,203,0.000333,0.411918,9,11121.79461,617.877478,1235.754957,357.25146,10,0
0,0,9,9,9,15,24,29,31,60,0.000333,0.091699,8,2200.782,122.265667,275.09775,87.132684,1,0
0,0,12,12,14,22,36,47,42,89,0.000333,0.153374,7,3220.863276,178.936849,460.123325,151.410465,3,0
0,0,2,2,4,9,13,6,10,16,0.000333,0.019736,2,118.414071,6.578559,59.207035,36.529325,1,0
0,0,3,3,6,10,16,10,12,22,0.000333,0.029333,3,264,14.666667,88,48.729056,2,0
0,0,7,7,7,10,17,15,18,33,0.000333,0.044962,3,404.658821,22.481046,134.886274,52.870765,1,0
0,0,10,10,12,17,29,33,29,62,0.000333,0.100398,6,1807.16893,100.398274,301.194822,112.506418,3,0
0,0,10,10,8,16,24,23,37,60,0.000333,0.091699,8,2200.782,122.265667,275.09775,88,1,0
0,0,13,13,13,23,36,41,48,89,0.000333,0.153374,12,5521.479902,306.748883,460.123325,152.147641,3,0
0,0,22,22,20,47,67,114,89,203,0.000333,0.410472,10,12314.16106,684.120059,1231.416106,347.504238,7,0
0,0,17,17,17,42,59,100,71,171,0.000333,0.335311,8,8047.455692,447.080872,1005.931961,295.9642,7,0
0,0,24,24,18,49,67,124,89,213,0.000333,0.430692,9,11628.69298,646.038499,1292.076998,350.179432,9,0
0,0,8,8,12,16,28,29,23,52,0.000333,0.083327,6,1499.894736,83.327485,249.982456,107.01955,3,0
0,0,5,5,7,9,16,11,12,23,0.000333,0.030667,3,276,15.333333,92,48.180809,1,0
0,0,10,10,13,18,31,35,25,60,0.000333,0.099084,6,1783.510672,99.083926,297.251779,123.164366,5,0
0,0,10,10,13,18,31,35,25,60,0.000333,0.099084,6,1783.510672,99.083926,297.251779,123.164366,5,0
0,0,7,7,8,10,18,17,14,31,0.000333,0.043089,4,517.0707,28.72615,129.267675,57.219281,3,0
0,0,7,7,8,10,18,17,14,31,0.000333,0.043089,4,517.0707,28.72615,129.267675,57.219281,3,0
0,0,10,10,13,16,29,35,25,60,0.000333,0.09716,6,1748.873158,97.15962,291.47886,112.105716,5,0
0,0,7,7,8,9,17,17,14,31,0.000333,0.042237,4,506.845392,28.158077,126.711348,52.529325,3,0
0,0,10,10,12,18,30,36,27,63,0.000333,0.103045,6,1854.804645,103.044703,309.134108,118.0782,5,0
0,0,10,10,12,18,30,35,27,62,0.000333,0.101409,6,1825.363302,101.409072,304.227217,118.0782,5,0
0,0,7,7,9,11,20,18,16,34,0.000333,0.048982,4,587.782221,32.654568,146.945555,66.583073,3,0
0,0,7,7,8,11,19,17,16,33,0.000333,0.046727,4,560.726432,31.151468,140.181608,62.053748,3,0
0,0,22,22,18,48,66,115,83,198,0.000333,0.39893,9,10771.11032,598.395018,1196.790036,343.13685,9,0
0,0,22,22,18,48,66,115,83,198,0.000333,0.39893,9,10771.11032,598.395018,1196.790036,343.13685,9,0
0,0,3,3,5,11,16,6,14,20,0.000333,0.026667,2,160,8.888889,80,49.663388,1,0
0,0,4,4,7,12,19,10,16,26,0.000333,0.036815,3,331.338346,18.407686,110.446115,62.671034,2,0
0,0,8,8,9,14,23,21,27,48,0.000333,0.072377,4,868.523896,48.251328,217.130974,81.832294,1,0
0,0,11,11,14,21,35,39,38,77,0.000333,0.131652,7,2764.683546,153.59353,394.954792,145.541635,3,0
0,0,10,10,9,16,25,29,34,63,0.000333,0.097521,8,2340.50352,130.027973,292.56294,92.529325,1,0
0,0,30,30,19,51,70,132,105,237,0.000333,0.484213,18,26147.52135,1452.640075,1452.640075,370.004315,10,0
0,0,23,23,18,48,66,118,84,202,0.000333,0.406989,9,10988.70851,610.483806,1220.967612,343.13685,10,0
0,0,32,32,21,52,73,158,116,274,0.000333,0.565337,20,33920.23858,1884.457699,1696.011929,388.661531,11,0
0,0,23,23,19,49,68,118,84,202,0.000333,0.409889,9,11067.00745,614.833747,1229.667494,355.831405,10,0
0,0,27,27,20,48,68,144,97,241,0.000333,0.489026,20,29341.5709,1630.087272,1467.078545,354.516762,11,0
0,0,23,23,18,50,68,118,85,203,0.000333,0.411918,9,11121.79461,617.877478,1235.754957,357.25146,10,0
0,0,9,9,7,14,21,21,36,57,0.000333,0.083454,6,1502.172559,83.454031,250.362093,72.954453,1,0
0,0,29,29,19,50,69,124,107,231,0.000333,0.470356,18,25399.24469,1411.06915,1411.06915,362.903432,10,0
0,0,29,29,21,47,68,145,102,247,0.000333,0.501201,20,30072.06644,1670.670358,1503.603322,353.304342,9,0
0,0,30,30,19,48,67,151,97,248,0.000333,0.501463,18,27079.02215,1504.390119,1504.390119,348.788823,11,0
0,0,19,19,18,44,62,102,73,175,0.000333,0.347328,9,9377.859189,520.992177,1041.984354,315.273641,7,0
0,0,25,25,18,50,68,126,97,223,0.000333,0.452501,9,12217.53792,678.752107,1357.504214,357.25146,10,0
0,0,19,19,18,44,62,102,73,175,0.000333,0.347328,9,9377.859189,520.992177,1041.984354,315.273641,7,0
0,0,19,19,18,44,62,102,73,175,0.000333,0.347328,9,9377.859189,520.992177,1041.984354,315.273641,7,0
0,0,25,25,19,50,69,127,91,218,0.000333,0.443886,9,11984.92498,665.829166,1331.658332,362.903432,10,0
0,0,10,10,9,16,25,29,34,63,0.000333,0.097521,8,2340.50352,130.027973,292.56294,92.529325,1,0
0,0,13,13,12,23,35,47,45,92,0.000333,0.157298,6,2831.364225,157.298013,471.894038,147.061475,3,0
0,0,10,10,8,16,24,23,37,60,0.000333,0.091699,8,2200.782,122.265667,275.09775,88,1,0
0,0,30,30,19,52,71,126,108,234,0.000333,0.47968,18,25902.73487,1439.040826,1439.040826,377.133488,10,0
0,0,7,7,9,10,19,18,18,36,0.000333,0.050975,4,611.701562,33.98342,152.92539,61.748606,1,0
0,0,10,10,14,17,31,36,29,65,0.000333,0.107341,7,2254.159321,125.231073,322.02276,122.789837,3,0
0,0,3,3,8,8,16,10,13,23,0.000333,0.030667,4,368,20.444444,92,48,2,0
0,0,2,2,6,7,13,6,11,17,0.000333,0.020969,3,188.722426,10.484579,62.907475,35.161259,1,0
0,0,8,8,9,14,23,21,27,48,0.000333,0.072377,4,868.523896,48.251328,217.130974,81.832294,1,0
0,0,28,28,19,50,69,124,98,222,0.000333,0.452031,9,12204.83187,678.046215,1356.092429,362.903432,10,0
0,0,11,11,12,18,30,38,36,74,0.000333,0.121037,12,4357.318849,242.073269,363.109904,118.0782,4,0
0,0,11,11,12,18,30,38,36,74,0.000333,0.121037,12,4357.318849,242.073269,363.109904,118.0782,4,0
0,0,8,8,8,11,19,20,22,42,0.000333,0.059471,8,1427.303645,79.294647,178.412956,62.053748,2,0
0,0,32,32,21,53,74,158,117,275,0.000333,0.5692,20,34151.99351,1897.332973,1707.599676,395.81845,11,0
0,0,24,24,21,49,70,124,90,214,0.000333,0.437222,10,13116.66566,728.703648,1311.666566,367.359448,10,0
0,0,2,2,4,9,13,6,10,16,0.000333,0.019736,2,118.414071,6.578559,59.207035,36.529325,1,0
0,0,3,3,6,10,16,10,12,22,0.000333,0.029333,3,264,14.666667,88,48.729056,2,0
0,0,8,8,8,13,21,19,26,45,0.000333,0.065885,8,1581.234272,87.846348,197.654284,72.105716,1,0
0,0,28,28,20,49,69,122,97,219,0.000333,0.445922,10,13377.66856,743.203809,1337.766856,361.559344,10,0
0,0,11,11,15,18,33,47,36,83,0.000333,0.139562,14,5861.585967,325.643665,418.684712,133.662009,5,0
0,0,8,8,11,12,23,29,25,54,0.000333,0.081424,10,2442.723456,135.706859,244.272346,81.073298,3,0
0,0,25,25,20,51,71,126,99,225,0.000333,0.461231,10,13836.93102,768.71839,1383.693102,375.732254,13,0
0,0,20,20,17,46,63,113,81,194,0.000333,0.386531,8,9276.738441,515.374358,1159.592305,323.570718,11,0
0,0,11,11,10,15,25,34,25,59,0.000333,0.091329,5,1369.937576,76.107643,273.987515,91.82264,4,0
0,0,11,11,10,15,25,34,25,59,0.000333,0.091329,5,1369.937576,76.107643,273.987515,91.82264,4,0
0,0,7,7,10,13,23,24,22,46,0.000333,0.069361,5,1040.41925,57.801069,208.08385,81.324997,2,0
0,0,7,7,9,13,22,23,22,45,0.000333,0.066891,4,802.697691,44.594316,200.674423,76.635041,2,0
0,0,7,7,9,12,21,23,21,44,0.000333,0.064421,4,773.047866,42.947104,193.261967,71.548875,2,0
0,0,7,7,9,12,21,23,21,44,0.000333,0.064421,4,773.047866,42.947104,193.261967,71.548875,2,0
0,0,7,7,9,12,21,23,21,44,0.000333,0.064421,4,773.047866,42.947104,193.261967,71.548875,2,0
0,0,7,7,9,12,21,23,21,44,0.000333,0.064421,4,773.047866,42.947104,193.261967,71.548875,2,0
0,0,6,6,9,10,19,16,13,29,0.000333,0.041063,4,492.759592,27.375533,123.189898,61.748606,3,0
0,0,6,6,9,10,19,16,13,29,0.000333,0.041063,4,492.759592,27.375533,123.189898,61.748606,3,0
0,0,2,2,5,7,12,7,8,15,0.000333,0.017925,2,107.548875,5.974938,53.774438,31.261125,1,0
0,0,3,3,7,8,15,11,10,21,0.000333,0.027348,3,246.134108,13.674117,82.044703,43.651484,2,0
0,0,25,25,19,46,65,109,92,201,0.000333,0.403499,18,21788.92675,1210.49593,1210.49593,334.794473,9,0
0,0,25,25,19,46,65,109,92,201,0.000333,0.403499,18,21788.92675,1210.49593,1210.49593,334.794473,9,0
0,0,8,8,8,14,22,19,28,47,0.000333,0.069864,8,1676.746289,93.152572,209.593286,77.302969,2,0
0,0,25,25,19,43,62,110,86,196,0.000333,0.389007,18,21006.40458,1167.022477,1167.022477,314.040007,9,0
0,0,25,25,19,43,62,110,86,196,0.000333,0.389007,18,21006.40458,1167.022477,1167.022477,314.040007,9,0
0,0,8,8,8,11,19,20,22,42,0.000333,0.059471,8,1427.303645,79.294647,178.412956,62.053748,2,0
0,0,7,7,9,10,19,18,18,36,0.000333,0.050975,4,611.701562,33.98342,152.92539,61.748606,1,0
0,0,24,24,19,42,61,108,79,187,0.000333,0.369683,9,9981.430939,554.523941,1109.047882,307.187955,8,0
0,0,7,7,7,10,17,15,18,33,0.000333,0.044962,3,404.658821,22.481046,134.886274,52.870765,1,0
0,0,24,24,19,42,61,105,79,184,0.000333,0.363752,9,9821.301031,545.627835,1091.25567,307.187955,8,0
0,0,8,8,8,15,23,18,23,41,0.000333,0.061822,4,741.864161,41.214676,185.46604,82.603359,1,0
0,0,25,25,19,47,66,108,84,192,0.000333,0.386841,9,10444.71304,580.261835,1160.523671,341.776299,8,0
0,0,8,8,8,10,18,20,22,42,0.000333,0.058379,8,1401.0948,77.8386,175.13685,57.219281,1,0
0,0,25,25,20,42,62,110,83,193,0.000333,0.383053,10,11491.59888,638.42216,1149.159888,312.915894,8,0
0,0,7,7,7,10,17,17,20,37,0.000333,0.050412,6,907.416751,50.412042,151.236125,52.870765,1,0
0,0,24,24,19,42,61,107,81,188,0.000333,0.37166,9,10034.80758,557.48931,1114.978619,307.187955,8,0
0,0,5,5,7,9,16,11,12,23,0.000333,0.030667,3,276,15.333333,92,48.180809,1,0
0,0,8,8,12,16,28,29,23,52,0.000333,0.083327,6,1499.894736,83.327485,249.982456,107.01955,3,0
0,0,10,10,12,16,28,35,25,60,0.000333,0.096147,6,1730.647772,96.147098,288.441295,107.01955,5,0
0,0,10,10,12,16,28,35,25,60,0.000333,0.096147,6,1730.647772,96.147098,288.441295,107.01955,5,0
0,0,7,7,8,10,18,17,14,31,0.000333,0.043089,4,517.0707,28.72615,129.267675,57.219281,3,0
0,0,7,7,8,9,17,17,14,31,0.000333,0.042237,4,506.845392,28.158077,126.711348,52.529325,3,0
0,0,3,3,5,11,16,6,14,20,0.000333,0.026667,2,160,8.888889,80,49.663388,1,0
0,0,4,4,7,12,19,10,16,26,0.000333,0.036815,3,331.338346,18.407686,110.446115,62.671034,2,0
0,0,10,10,8,16,24,23,37,60,0.000333,0.091699,8,2200.782,122.265667,275.09775,88,1,0
0,0,11,11,10,16,26,27,39,66,0.000333,0.10341,10,3102.290214,172.349456,310.229021,97.219281,2,0
0,0,9,9,13,15,28,25,33,58,0.000333,0.092942,12,3345.919026,185.88439,278.826585,106.709075,2,0
0,0,8,8,11,15,26,21,31,52,0.000333,0.081474,10,2444.228653,135.790481,244.422865,96.657107,1,0
0,0,24,24,19,43,62,107,75,182,0.000333,0.361221,9,9752.973556,541.831864,1083.663728,314.040007,10,0
0,0,24,24,19,42,61,107,75,182,0.000333,0.359798,9,9714.547759,539.697098,1079.394195,307.187955,10,0
0,0,7,7,8,11,19,17,14,31,0.000333,0.043895,4,526.743012,29.263501,131.685753,62.053748,3,0
0,0,7,7,8,10,18,17,14,31,0.000333,0.043089,4,517.0707,28.72615,129.267675,57.219281,3,0
0,0,17,17,17,42,59,100,71,171,0.000333,0.335311,8,8047.455692,447.080872,1005.931961,295.9642,7,0
0,0,22,22,20,47,67,114,89,203,0.000333,0.410472,10,12314.16106,684.120059,1231.416106,347.504238,7,0
0,0,11,11,14,14,28,29,47,76,0.000333,0.121786,21,7672.538456,426.252136,365.358974,106.605938,2,0
0,0,10,10,12,14,26,25,45,70,0.000333,0.109677,18,5922.554045,329.03078,329.03078,96.322519,1,0
0,0,3,3,8,8,16,10,13,23,0.000333,0.030667,4,368,20.444444,92,48,2,0
0,0,2,2,6,7,13,6,11,17,0.000333,0.020969,3,188.722426,10.484579,62.907475,35.161259,1,0
0,0,6,6,9,11,20,17,14,31,0.000333,0.04466,4,535.919084,29.773282,133.979771,66.583073,3,0
0,0,6,6,9,11,20,16,14,30,0.000333,0.043219,4,518.631371,28.812854,129.657843,66.583073,3,0
0,0,24,24,20,45,65,131,89,220,0.000333,0.44164,10,13249.20919,736.067177,1324.920919,333.571951,9,0
0,0,40,40,25,68,93,235,154,389,0.000333,0.847911,24,61049.58666,3391.643703,2543.732778,530.043878,17,0
0,0,40,40,25,68,93,235,154,389,0.000333,0.847911,24,61049.58666,3391.643703,2543.732778,530.043878,17,0
0,0,40,40,26,70,96,244,160,404,0.000333,0.886775,26,69168.44611,3842.69145,2660.32485,551.261244,17,0
0,0,27,27,21,45,66,138,88,226,0.000333,0.455344,10,13660.33071,758.907262,1366.033071,339.372055,9,0
0,0,27,27,20,45,65,138,88,226,0.000333,0.453685,10,13610.55126,756.141737,1361.055126,333.571951,9,0
0,0,6,6,9,9,18,16,13,29,0.000333,0.040309,4,483.7113,26.87285,120.927825,57.05865,3,0
0,0,6,6,9,9,18,16,13,29,0.000333,0.040309,4,483.7113,26.87285,120.927825,57.05865,3,0
0,0,5,5,9,9,18,13,12,25,0.000333,0.034749,4,416.9925,23.16625,104.248125,57.05865,2,0
0,0,6,6,9,10,19,16,13,29,0.000333,0.041063,4,492.759592,27.375533,123.189898,61.748606,3,0
0,0,6,6,9,10,19,16,13,29,0.000333,0.041063,4,492.759592,27.375533,123.189898,61.748606,3,0
0,0,6,6,9,10,19,17,14,31,0.000333,0.043895,4,526.743012,29.263501,131.685753,61.748606,3,0
0,0,6,6,9,10,19,16,14,30,0.000333,0.042479,4,509.751302,28.319517,127.437825,61.748606,3,0
0,0,25,25,20,51,71,126,99,225,0.000333,0.461231,10,13836.93102,768.71839,1383.693102,375.732254,9,0
0,0,20,20,17,46,63,113,81,194,0.000333,0.386531,8,9276.738441,515.374358,1159.592305,323.570718,9,0
0,0,25,25,20,51,71,127,99,226,0.000333,0.463281,10,13898.42849,772.134916,1389.842849,375.732254,9,0
0,0,20,20,17,46,63,113,81,194,0.000333,0.386531,8,9276.738441,515.374358,1159.592305,323.570718,9,0
0,0,29,29,22,49,71,146,112,258,0.000333,0.528878,22,34905.96465,1939.220258,1586.634757,373.228278,9,0
0,0,24,24,20,43,63,131,85,216,0.000333,0.430364,10,12910.92464,717.273591,1291.092463,319.767946,9,0
0,0,29,29,21,48,69,145,103,248,0.000333,0.504971,20,30298.28131,1683.23785,1514.914065,360.316866,9,0
0,0,13,13,11,15,26,39,28,67,0.000333,0.104976,5,1574.647306,87.480406,314.929461,96.657107,4,0
0,0,13,13,11,16,27,39,28,67,0.000333,0.106192,5,1592.887313,88.49374,318.577463,102.053748,4,0
0,0,7,7,11,10,21,20,18,38,0.000333,0.055636,5,834.54031,46.363351,166.908062,71.273029,2,0
0,0,11,11,10,15,25,34,25,59,0.000333,0.091329,5,1369.937576,76.107643,273.987515,91.82264,4,0
0,0,11,11,10,15,25,34,25,59,0.000333,0.091329,5,1369.937576,76.107643,273.987515,91.82264,4,0
0,0,11,11,10,15,25,34,25,59,0.000333,0.091329,5,1369.937576,76.107643,273.987515,91.82264,4,0
0,0,11,11,10,15,25,34,25,59,0.000333,0.091329,5,1369.937576,76.107643,273.987515,91.82264,4,0
0,0,11,11,11,15,26,35,26,61,0.000333,0.095576,5,1433.634114,79.64634,286.726823,96.657107,4,0
0,0,11,11,10,15,25,34,26,60,0.000333,0.092877,5,1393.156857,77.397603,278.631371,91.82264,4,0
0,0,5,5,9,9,18,13,12,25,0.000333,0.034749,4,416.9925,23.16625,104.248125,57.05865,2,0
0,0,10,10,10,14,24,31,24,55,0.000333,0.084058,5,1260.864688,70.048038,252.172938,86.52225,3,0
0,0,8,8,10,10,20,22,22,44,0.000333,0.063388,10,1901.648362,105.647131,190.164836,66.438562,2,0
0,0,11,11,10,15,25,34,25,59,0.000333,0.091329,5,1369.937576,76.107643,273.987515,91.82264,4,0
0,0,11,11,10,15,25,34,25,59,0.000333,0.091329,5,1369.937576,76.107643,273.987515,91.82264,4,0
0,0,39,39,25,68,93,232,153,385,0.000333,0.839192,24,60421.82742,3356.76819,2517.576142,530.043878,16,0
0,0,42,42,28,72,100,254,168,422,0.000333,0.934569,28,78503.80474,4361.322485,2803.707312,578.840538,18,0
0,0,40,40,25,68,93,235,154,389,0.000333,0.847911,24,61049.58666,3391.643703,2543.732778,530.043878,17,0
0,0,40,40,26,69,95,235,154,389,0.000333,0.851891,26,66447.51962,3691.528868,2555.673832,543.69962,17,0
0,0,40,40,26,69,95,235,154,389,0.000333,0.851891,26,66447.51962,3691.528868,2555.673832,543.69962,17,0
0,0,41,41,25,69,94,238,159,397,0.000333,0.867391,24,62452.12258,3469.562365,2602.171774,537.584592,16,0
0,0,41,41,25,73,98,238,169,407,0.000333,0.897396,24,64612.48576,3589.582542,2692.186907,567.953598,16,0
0,0,41,41,25,73,98,238,169,407,0.000333,0.897396,24,64612.48576,3589.582542,2692.186907,567.953598,16,0
0,0,41,41,25,69,94,239,163,402,0.000333,0.878315,24,63238.67324,3513.259624,2634.944718,537.584592,16,0
0,0,42,42,26,71,97,251,170,421,0.000333,0.926188,26,72242.64597,4013.480332,2778.563307,558.843478,17,0
0,0,31,31,19,49,68,149,107,256,0.000333,0.519463,18,28051.02877,1558.390487,1558.390487,355.831405,9,0
0,0,12,12,10,11,21,31,22,53,0.000333,0.077598,10,2327.928234,129.329346,232.792823,71.273029,4,0
0,0,12,12,10,10,20,31,22,53,0.000333,0.076354,10,2290.62189,127.256772,229.062189,66.438562,4,0
0,0,40,40,25,69,94,235,154,389,0.000333,0.849912,24,61193.64152,3399.646751,2549.735063,537.584592,17,0
0,0,40,40,25,69,94,235,154,389,0.000333,0.849912,24,61193.64152,3399.646751,2549.735063,537.584592,17,0
0,0,40,40,25,69,94,235,155,390,0.000333,0.852097,24,61350.95165,3408.386203,2556.289652,537.584592,17,0
0,0,41,41,26,71,97,247,162,409,0.000333,0.899788,26,70183.47316,3899.081842,2699.364352,558.843478,18,0
0,0,30,30,19,49,68,149,100,249,0.000333,0.505259,18,27284.00845,1515.778247,1515.778247,355.831405,11,0
0,0,3,3,8,11,19,12,13,25,0.000333,0.035399,4,424.792751,23.599597,106.198188,62.053748,2,0
0,0,2,2,6,10,16,8,11,19,0.000333,0.025333,3,228,12.666667,76,48.729056,1,0
0,0,8,8,8,15,23,18,23,41,0.000333,0.061822,4,741.864161,41.214676,185.46604,82.603359,1,0
0,0,8,8,10,15,25,20,23,43,0.000333,0.066562,5,998.429081,55.468282,199.685816,91.82264,2,0
0,0,11,11,11,16,27,35,26,61,0.000333,0.096683,5,1450.240688,80.568927,290.048138,102.053748,4,0
0,0,11,11,10,16,26,34,26,60,0.000333,0.094009,5,1410.131915,78.340662,282.026383,97.219281,4,0
0,0,7,7,9,10,19,17,18,35,0.000333,0.049559,4,594.709852,33.039436,148.677463,61.748606,2,0
0,0,11,11,10,14,24,34,25,59,0.000333,0.090171,5,1352.563938,75.142441,270.512788,86.52225,4,0
0,0,11,11,10,15,25,34,25,59,0.000333,0.091329,5,1369.937576,76.107643,273.987515,91.82264,4,0
0,0,8,8,9,14,23,21,31,52,0.000333,0.078408,8,1881.801774,104.544543,235.225222,81.832294,3,0
0,0,8,8,9,14,23,21,31,52,0.000333,0.078408,8,1881.801774,104.544543,235.225222,81.832294,3,0
0,0,8,8,8,14,22,19,28,47,0.000333,0.069864,8,1676.746289,93.152572,209.593286,77.302969,2,0
0,0,8,8,9,14,23,21,27,48,0.000333,0.072377,4,868.523896,48.251328,217.130974,81.832294,1,0
0,0,9,9,11,15,26,27,29,56,0.000333,0.087742,5,1316.123121,73.117951,263.224624,96.657107,2,0
0,0,8,8,9,11,20,22,25,47,0.000333,0.06771,8,1625.044964,90.280276,203.13062,66.583073,3,0
0,0,8,8,9,11,20,22,25,47,0.000333,0.06771,8,1625.044964,90.280276,203.13062,66.583073,3,0
0,0,24,24,20,43,63,131,85,216,0.000333,0.430364,10,12910.92464,717.273591,1291.092463,319.767946,9,0
0,0,42,42,25,71,96,237,185,422,0.000333,0.926285,24,66692.50021,3705.1389,2778.854175,552.72845,14,0
0,0,27,27,20,44,64,137,87,224,0.000333,0.448,10,13440,746.666667,1344,326.653553,9,0
0,0,29,29,21,44,65,145,95,240,0.000333,0.481789,20,28907.3655,1605.96475,1445.368275,332.453657,9,0
0,0,38,38,25,65,90,226,151,377,0.000333,0.81581,24,58738.28682,3263.238156,2447.428617,507.550313,14,0
0,0,38,38,25,67,92,226,150,376,0.000333,0.81762,24,58868.62309,3270.479061,2452.859295,522.524381,14,0
0,0,5,5,7,9,16,11,12,23,0.000333,0.030667,3,276,15.333333,92,48.180809,1,0
0,0,22,22,19,41,60,101,73,174,0.000333,0.3426,9,9250.190673,513.899482,1027.798964,300.370255,8,0
0,0,9,9,9,15,24,29,31,60,0.000333,0.091699,8,2200.782,122.265667,275.09775,87.132684,1,0
0,0,9,9,11,15,26,31,31,62,0.000333,0.097142,10,2914.272625,161.904035,291.427263,96.657107,2,0
0,0,40,40,25,70,95,231,171,402,0.000333,0.880361,24,63385.96691,3521.442606,2641.081955,545.146216,14,0
0,0,50,50,26,68,94,328,213,541,0.000333,1.182011,39,138295.2702,7683.070566,3546.032569,536.158906,21,0
0,0,29,29,22,45,67,146,90,236,0.000333,0.477199,22,31495.13508,1749.729726,1431.597049,345.240885,10,0
0,0,39,39,25,65,90,226,147,373,0.000333,0.807154,24,58115.06892,3228.61494,2421.461205,507.550313,15,0
0,0,39,39,25,65,90,226,147,373,0.000333,0.807154,24,58115.06892,3228.61494,2421.461205,507.550313,15,0
0,0,32,32,21,52,73,158,113,271,0.000333,0.559147,20,33548.84911,1863.824951,1677.442455,388.661531,15,0
0,0,38,38,26,67,93,234,151,385,0.000333,0.839192,26,65456.9797,3636.498872,2517.576142,528.639408,16,0
0,0,38,38,26,67,93,234,151,385,0.000333,0.839192,26,65456.9797,3636.498872,2517.576142,528.639408,16,0
0,0,37,37,25,66,91,222,145,367,0.000333,0.79612,24,57320.65519,3184.480844,2388.360633,515.026417,15,0
0,0,37,37,25,66,91,222,145,367,0.000333,0.79612,24,57320.65519,3184.480844,2388.360633,515.026417,15,0
0,0,37,37,25,65,90,222,144,366,0.000333,0.792006,24,57024.4376,3168.024311,2376.018233,507.550313,15,0
0,0,37,37,25,65,90,222,144,366,0.000333,0.792006,24,57024.4376,3168.024311,2376.018233,507.550313,15,0
0,0,39,39,25,65,90,227,147,374,0.000333,0.809318,24,58270.87339,3237.270744,2427.953058,507.550313,15,0
0,0,39,39,25,65,90,227,147,374,0.000333,0.809318,24,58270.87339,3237.270744,2427.953058,507.550313,15,0
0,0,37,37,25,66,91,222,145,367,0.000333,0.79612,24,57320.65519,3184.480844,2388.360633,515.026417,15,0
0,0,38,38,26,68,94,234,152,386,0.000333,0.843357,26,65781.85372,3654.547429,2530.071297,536.158906,16,0
0,0,38,38,26,67,93,234,151,385,0.000333,0.839192,26,65456.9797,3636.498872,2517.576142,528.639408,16,0
0,0,37,37,25,65,90,222,144,366,0.000333,0.792006,24,57024.4376,3168.024311,2376.018233,507.550313,15,0
0,0,37,37,25,65,90,222,144,366,0.000333,0.792006,24,57024.4376,3168.024311,2376.018233,507.550313,15,0
0,0,38,38,26,67,93,234,151,385,0.000333,0.839192,26,65456.9797,3636.498872,2517.576142,528.639408,16,0
0,0,14,14,17,21,38,62,43,105,0.000333,0.183677,16,8816.518223,489.806568,551.032389,161.725534,4,0
0,0,13,13,17,20,37,59,41,100,0.000333,0.173648,16,8335.125385,463.062521,520.945337,155.92543,4,0
0,0,13,13,17,18,35,60,39,99,0.000333,0.169266,16,8124.784299,451.376905,507.799019,144.545518,4,0
0,0,11,11,15,15,30,53,35,88,0.000333,0.143935,14,6045.289214,335.849401,431.806372,117.206718,4,0
0,0,12,12,15,18,33,53,39,92,0.000333,0.154695,14,6497.179626,360.954424,464.084259,133.662009,4,0
0,0,11,11,15,15,30,51,35,86,0.000333,0.140664,14,5907.896277,328.21646,421.992591,117.206718,4,0
0,0,11,11,15,15,30,51,35,86,0.000333,0.140664,14,5907.896277,328.21646,421.992591,117.206718,4,0
0,0,24,24,19,41,60,107,75,182,0.000333,0.358351,9,9675.486796,537.527044,1075.054088,300.370255,10,0
0,0,24,24,19,41,60,107,75,182,0.000333,0.358351,9,9675.486796,537.527044,1075.054088,300.370255,10,0
0,0,7,7,8,10,18,17,14,31,0.000333,0.043089,4,517.0707,28.72615,129.267675,57.219281,3,0
0,0,7,7,8,9,17,17,14,31,0.000333,0.042237,4,506.845392,28.158077,126.711348,52.529325,3,0
0,0,8,8,13,15,28,23,31,54,0.000333,0.086532,12,3115.165989,173.064777,259.597166,106.709075,2,0
0,0,8,8,11,15,26,21,31,52,0.000333,0.081474,10,2444.228653,135.790481,244.422865,96.657107,1,0
0,0,24,24,19,43,62,108,77,185,0.000333,0.367175,9,9913.736857,550.763159,1101.526317,314.040007,10,0
0,0,24,24,19,43,62,107,77,184,0.000333,0.365191,9,9860.14909,547.786061,1095.572121,314.040007,10,0
0,0,7,7,9,11,20,18,16,34,0.000333,0.048982,4,587.782221,32.654568,146.945555,66.583073,3,0
0,0,7,7,8,11,19,17,16,33,0.000333,0.046727,4,560.726432,31.151468,140.181608,62.053748,3,0
0,0,24,24,19,43,62,107,75,182,0.000333,0.361221,9,9752.973556,541.831864,1083.663728,314.040007,10,0
0,0,24,24,19,42,61,107,75,182,0.000333,0.359798,9,9714.547759,539.697098,1079.394195,307.187955,10,0
0,0,7,7,8,11,19,17,14,31,0.000333,0.043895,4,526.743012,29.263501,131.685753,62.053748,3,0
0,0,7,7,8,10,18,17,14,31,0.000333,0.043089,4,517.0707,28.72615,129.267675,57.219281,3,0
0,0,24,24,19,43,62,107,75,182,0.000333,0.361221,9,9752.973556,541.831864,1083.663728,314.040007,10,0
0,0,24,24,19,42,61,107,75,182,0.000333,0.359798,9,9714.547759,539.697098,1079.394195,307.187955,10,0
0,0,7,7,8,11,19,17,14,31,0.000333,0.043895,4,526.743012,29.263501,131.685753,62.053748,3,0
0,0,7,7,8,10,18,17,14,31,0.000333,0.043089,4,517.0707,28.72615,129.267675,57.219281,3,0
0,0,3,3,8,11,19,12,13,25,0.000333,0.035399,4,424.792751,23.599597,106.198188,62.053748,2,0
0,0,2,2,6,10,16,8,11,19,0.000333,0.025333,3,228,12.666667,76,48.729056,1,0
0,0,29,29,21,48,69,145,103,248,0.000333,0.504971,20,30298.28131,1683.23785,1514.914065,360.316866,9,0
0,0,33,33,21,50,71,161,105,266,0.000333,0.545278,20,32716.65468,1817.591926,1635.832734,374.431475,12,0
0,0,33,33,20,50,70,160,111,271,0.000333,0.553679,20,33220.71395,1845.59522,1661.035698,368.631371,12,0
0,0,9,9,7,14,21,21,36,57,0.000333,0.083454,6,1502.172559,83.454031,250.362093,72.954453,1,0
0,0,10,10,9,15,24,27,38,65,0.000333,0.099341,8,2384.1805,132.454472,298.022563,87.132684,2,0
0,0,8,8,8,13,21,19,26,45,0.000333,0.065885,8,1581.234272,87.846348,197.654284,72.105716,1,0
0,0,9,9,10,14,24,25,28,53,0.000333,0.081001,10,2430.030125,135.001674,243.003013,86.52225,2,0
0,0,8,8,4,12,16,21,46,67,0.000333,0.089333,6,1608,89.333333,268,51.01955,1,0
0,0,9,9,6,13,19,25,48,73,0.000333,0.103366,9,2790.888376,155.049354,310.098708,63.615491,2,0
0,0,24,24,20,43,63,131,85,216,0.000333,0.430364,10,12910.92464,717.273591,1291.092463,319.767946,9,0
0,0,17,17,17,42,59,100,71,171,0.000333,0.335311,8,8047.455692,447.080872,1005.931961,295.9642,7,0
0,0,13,13,15,18,33,59,45,104,0.000333,0.174872,14,7344.637838,408.035435,524.616988,133.662009,4,0
0,0,12,12,15,16,31,57,41,98,0.000333,0.161837,14,6797.157338,377.619852,485.511238,122.603359,4,0
0,0,12,12,16,18,34,53,39,92,0.000333,0.156016,16,7488.745302,416.041406,468.046581,139.05865,4,0
0,0,11,11,16,15,31,51,35,86,0.000333,0.14202,16,6816.974123,378.720785,426.060883,122.603359,4,0
0,0,11,11,16,15,31,51,35,86,0.000333,0.14202,16,6816.974123,378.720785,426.060883,122.603359,4,0
0,0,24,24,20,43,63,131,85,216,0.000333,0.430364,10,12910.92464,717.273591,1291.092463,319.767946,11,0
0,0,29,29,21,47,68,145,102,247,0.000333,0.501201,20,30072.06644,1670.670358,1503.603322,353.304342,13,0
0,0,29,29,21,47,68,145,102,247,0.000333,0.501201,20,30072.06644,1670.670358,1503.603322,353.304342,9,0
0,0,8,8,9,11,20,23,22,45,0.000333,0.064829,8,1555.894114,86.438562,194.486764,66.583073,2,0
0,0,3,3,6,11,17,7,12,19,0.000333,0.025887,3,232.985382,12.943632,77.661794,53.563523,1,0
0,0,4,4,8,12,20,11,14,25,0.000333,0.036016,4,432.192809,24.010712,108.048202,67.01955,2,0
0,0,11,11,7,15,22,26,48,74,0.000333,0.109999,9,2969.981458,164.99897,329.99794,78.254843,1,0
0,0,12,12,9,16,25,32,50,82,0.000333,0.126932,12,4569.554491,253.864138,380.796208,92.529325,2,0
0,0,8,8,8,15,23,18,23,41,0.000333,0.061822,4,741.864161,41.214676,185.46604,82.603359,1,0
0,0,28,28,19,51,70,121,94,215,0.000333,0.439265,9,11860.16264,658.897924,1317.795849,370.004315,10,0
0,0,9,9,9,14,23,23,33,56,0.000333,0.08444,8,2026.555756,112.586431,253.31947,81.832294,3,0
0,0,9,9,9,14,23,23,33,56,0.000333,0.08444,8,2026.555756,112.586431,253.31947,81.832294,3,0
0,0,8,8,8,14,22,19,28,47,0.000333,0.069864,8,1676.746289,93.152572,209.593286,77.302969,2,0
0,0,9,9,9,11,20,24,27,51,0.000333,0.073473,8,1763.346663,97.963703,220.418333,66.583073,3,0
0,0,9,9,9,11,20,24,27,51,0.000333,0.073473,8,1763.346663,97.963703,220.418333,66.583073,3,0
0,0,8,8,11,10,21,22,20,42,0.000333,0.061492,10,1844.773318,102.487407,184.477332,71.273029,2,0
0,0,8,8,9,10,19,19,20,39,0.000333,0.055223,8,1325.353384,73.630744,165.669173,61.748606,2,0
0,0,8,8,8,15,23,18,23,41,0.000333,0.061822,4,741.864161,41.214676,185.46604,82.603359,1,0
0,0,9,9,10,15,25,22,25,47,0.000333,0.072754,5,1091.306205,60.628122,218.261241,91.82264,2,0
0,0,9,9,10,10,20,24,24,48,0.000333,0.069151,10,2074.525486,115.251416,207.452549,66.438562,2,0
0,0,8,8,9,10,19,21,22,43,0.000333,0.060887,8,1461.287065,81.182615,182.660883,61.748606,2,0
0,0,22,22,19,47,66,115,82,197,0.000333,0.396915,9,10716.71077,595.372821,1190.745642,341.776299,9,0
0,0,24,24,22,49,71,125,90,215,0.000333,0.440732,11,14544.15194,808.008441,1322.195631,373.228278,10,0
0,0,23,23,19,49,68,118,84,202,0.000333,0.409889,9,11067.00745,614.833747,1229.667494,355.831405,10,0
0,0,23,23,19,49,68,118,84,202,0.000333,0.409889,9,11067.00745,614.833747,1229.667494,355.831405,10,0
0,0,23,23,19,49,68,118,84,202,0.000333,0.409889,9,11067.00745,614.833747,1229.667494,355.831405,10,0
0,0,23,23,19,49,68,118,84,202,0.000333,0.409889,9,11067.00745,614.833747,1229.667494,355.831405,10,0
0,0,23,23,19,47,66,118,83,201,0.000333,0.404974,9,10934.30896,607.461609,1214.923218,341.776299,10,0
0,0,23,23,19,48,67,118,83,201,0.000333,0.406428,9,10973.55535,609.641964,1219.283927,348.788823,10,0
0,0,23,23,19,48,67,118,83,201,0.000333,0.406428,9,10973.55535,609.641964,1219.283927,348.788823,10,0
0,0,23,23,19,48,67,118,83,201,0.000333,0.406428,9,10973.55535,609.641964,1219.283927,348.788823,10,0
0,0,23,23,19,48,67,118,83,201,0.000333,0.406428,9,10973.55535,609.641964,1219.283927,348.788823,10,0
0,0,25,25,21,49,70,127,87,214,0.000333,0.437222,10,13116.66566,728.703648,1311.666566,367.359448,10,0
0,0,25,25,21,49,70,127,87,214,0.000333,0.437222,10,13116.66566,728.703648,1311.666566,367.359448,10,0
0,0,25,25,20,48,68,122,86,208,0.000333,0.422064,10,12661.92271,703.440151,1266.192271,354.516762,10,0
0,0,25,25,20,48,68,122,86,208,0.000333,0.422064,10,12661.92271,703.440151,1266.192271,354.516762,10,0
0,0,27,27,19,44,63,138,87,225,0.000333,0.448296,9,12103.99185,672.443991,1344.887983,320.925614,9,0
0,0,27,27,20,44,64,138,87,225,0.000333,0.45,10,13500,750,1350,326.653553,9,0
0,0,12,12,15,18,33,53,39,92,0.000333,0.154695,14,6497.179626,360.954424,464.084259,133.662009,4,0
0,0,11,11,15,15,30,51,35,86,0.000333,0.140664,14,5907.896277,328.21646,421.992591,117.206718,4,0
0,0,11,11,15,15,30,51,35,86,0.000333,0.140664,14,5907.896277,328.21646,421.992591,117.206718,4,0
0,0,12,12,15,19,34,53,40,93,0.000333,0.157711,14,6623.876619,367.993146,473.134044,139.313982,4,0
0,0,11,11,15,16,31,52,36,88,0.000333,0.145323,14,6103.569854,339.087214,435.969275,122.603359,4,0
0,0,11,11,15,16,31,51,36,87,0.000333,0.143672,14,6034.211106,335.23395,431.015079,122.603359,4,0
0,0,8,8,9,11,20,21,16,37,0.000333,0.053304,4,639.645358,35.535853,159.91134,66.583073,4,0
0,0,8,8,9,10,19,21,16,37,0.000333,0.052391,4,628.693272,34.927404,157.173318,61.748606,4,0
0,0,7,7,8,11,19,17,14,31,0.000333,0.043895,4,526.743012,29.263501,131.685753,62.053748,3,0
0,0,7,7,8,10,18,17,14,31,0.000333,0.043089,4,517.0707,28.72615,129.267675,57.219281,3,0
0,0,8,8,9,10,19,22,18,40,0.000333,0.056639,4,679.668402,37.759356,169.917101,61.748606,4,0
0,0,8,8,9,10,19,21,18,39,0.000333,0.055223,4,662.676692,36.815372,165.669173,61.748606,4,0
0,0,7,7,9,10,19,18,16,34,0.000333,0.048143,4,577.718142,32.095452,144.429535,61.748606,3,0
0,0,7,7,8,10,18,17,16,33,0.000333,0.045869,4,550.4301,30.57945,137.607525,57.219281,3,0
0,0,8,8,9,9,18,21,16,37,0.000333,0.051429,4,617.1489,34.28605,154.287225,57.05865,4,0
0,0,8,8,9,9,18,21,16,37,0.000333,0.051429,4,617.1489,34.28605,154.287225,57.05865,4,0
0,0,7,7,8,10,18,17,14,31,0.000333,0.043089,4,517.0707,28.72615,129.267675,57.219281,3,0
0,0,7,7,8,9,17,17,14,31,0.000333,0.042237,4,506.845392,28.158077,126.711348,52.529325,3,0
0,0,5,5,7,9,16,11,12,23,0.000333,0.030667,3,276,15.333333,92,48.180809,1,0
0,0,6,6,9,9,18,15,14,29,0.000333,0.040309,4,483.7113,26.87285,120.927825,57.05865,2,0
0,0,21,21,17,46,63,112,78,190,0.000333,0.378561,8,9085.465484,504.748082,1135.683185,323.570718,9,0
0,0,27,27,19,45,64,120,85,205,0.000333,0.41,9,11070,615,1230,327.844012,12,0
0,0,27,27,19,45,64,120,85,205,0.000333,0.41,9,11070,615,1230,327.844012,12,0
0,0,7,7,8,10,18,17,14,31,0.000333,0.043089,4,517.0707,28.72615,129.267675,57.219281,3,0
0,0,7,7,8,9,17,17,14,31,0.000333,0.042237,4,506.845392,28.158077,126.711348,52.529325,3,0
0,0,27,27,19,47,66,121,87,208,0.000333,0.419078,9,11315.10579,628.616988,1257.233977,341.776299,12,0
0,0,27,27,19,47,66,120,87,207,0.000333,0.417063,9,11260.70624,625.594791,1251.189583,341.776299,12,0
0,0,7,7,9,11,20,18,16,34,0.000333,0.048982,4,587.782221,32.654568,146.945555,66.583073,3,0
0,0,7,7,8,11,19,17,16,33,0.000333,0.046727,4,560.726432,31.151468,140.181608,62.053748,3,0
0,0,31,31,20,47,67,130,91,221,0.000333,0.446869,10,13406.05711,744.780951,1340.605711,347.504238,12,0
0,0,31,31,20,46,66,130,91,221,0.000333,0.44527,10,13358.111,742.117278,1335.8111,340.522412,12,0
0,0,11,11,9,12,21,27,20,47,0.000333,0.068813,4,825.755675,45.875315,206.438919,71.548875,3,0
0,0,11,11,9,10,19,27,20,47,0.000333,0.066551,8,1597.220745,88.734486,199.652593,61.748606,3,0
0,0,27,27,19,47,66,121,87,208,0.000333,0.419078,9,11315.10579,628.616988,1257.233977,341.776299,12,0
0,0,27,27,19,47,66,120,87,207,0.000333,0.417063,9,11260.70624,625.594791,1251.189583,341.776299,12,0
0,0,7,7,9,11,20,18,16,34,0.000333,0.048982,4,587.782221,32.654568,146.945555,66.583073,3,0
0,0,7,7,8,11,19,17,16,33,0.000333,0.046727,4,560.726432,31.151468,140.181608,62.053748,3,0
0,0,22,22,19,47,66,115,82,197,0.000333,0.396915,9,10716.71077,595.372821,1190.745642,341.776299,9,0
0,0,24,24,19,52,71,123,97,220,0.000333,0.450981,9,12176.4993,676.472183,1352.944366,377.133488,9,0
0,0,22,22,19,47,66,115,82,197,0.000333,0.396915,9,10716.71077,595.372821,1190.745642,341.776299,9,0
0,0,12,12,15,17,32,53,39,92,0.000333,0.153333,14,6440,357.777778,460,128.090227,4,0
0,0,11,11,15,14,29,51,35,86,0.000333,0.139262,14,5849.009118,324.944951,417.786366,111.906328,4,0
0,0,11,11,15,14,29,51,35,86,0.000333,0.139262,14,5849.009118,324.944951,417.786366,111.906328,4,0
0,0,12,12,15,18,33,53,39,92,0.000333,0.154695,14,6497.179626,360.954424,464.084259,133.662009,4,0
0,0,11,11,15,15,30,51,35,86,0.000333,0.140664,14,5907.896277,328.21646,421.992591,117.206718,4,0
0,0,11,11,15,15,30,51,35,86,0.000333,0.140664,14,5907.896277,328.21646,421.992591,117.206718,4,0
0,0,42,42,25,74,99,244,170,414,0.000333,0.914851,24,65869.28738,3659.404854,2744.553641,575.595954,16,0
0,0,30,30,20,48,68,150,97,247,0.000333,0.501201,20,30072.06644,1670.670358,1503.603322,354.516762,11,0
0,0,43,43,25,75,100,253,174,427,0.000333,0.945642,24,68086.23823,3782.568791,2836.926593,583.257807,16,0
0,0,43,43,25,76,101,244,177,421,0.000333,0.934369,24,67274.56882,3737.476046,2803.107034,590.938896,16,0
0,0,44,44,26,76,102,261,181,442,0.000333,0.983071,26,76679.51203,4259.972891,2949.212001,597.053924,17,0
0,0,30,30,20,52,72,149,101,250,0.000333,0.51416,10,15424.8125,856.934028,1542.48125,382.861427,11,0
0,0,30,30,20,46,66,147,101,248,0.000333,0.49967,20,29980.19483,1665.56638,1499.009742,340.522412,10,0
0,0,21,21,22,45,67,112,80,192,0.000333,0.38823,11,12811.58037,711.754465,1164.689125,345.240885,8,0
0,0,19,19,19,43,62,102,72,174,0.000333,0.345343,9,9324.271422,518.015079,1036.030158,314.040007,7,0
0,0,19,19,19,43,62,102,72,174,0.000333,0.345343,9,9324.271422,518.015079,1036.030158,314.040007,7,0
0,0,19,19,19,43,62,102,72,174,0.000333,0.345343,9,9324.271422,518.015079,1036.030158,314.040007,7,0
0,0,19,19,19,43,62,102,72,174,0.000333,0.345343,9,9324.271422,518.015079,1036.030158,314.040007,7,0
0,0,21,21,19,44,63,111,78,189,0.000333,0.376569,9,10167.35315,564.852953,1129.705906,320.925614,7,0
0,0,19,19,19,43,62,102,72,174,0.000333,0.345343,9,9324.271422,518.015079,1036.030158,314.040007,7,0
0,0,19,19,19,43,62,102,72,174,0.000333,0.345343,9,9324.271422,518.015079,1036.030158,314.040007,7,0
0,0,21,21,19,44,63,111,81,192,0.000333,0.382546,9,10328.73971,573.818873,1147.637745,320.925614,7,0
0,0,19,19,19,43,62,102,72,174,0.000333,0.345343,9,9324.271422,518.015079,1036.030158,314.040007,7,0
0,0,24,24,20,43,63,131,85,216,0.000333,0.430364,10,12910.92464,717.273591,1291.092463,319.767946,9,0
0,0,19,19,18,42,60,102,71,173,0.000333,0.340631,9,9197.028657,510.946037,1021.892073,301.535982,7,0
0,0,22,22,20,47,67,114,89,203,0.000333,0.410472,10,12314.16106,684.120059,1231.416106,347.504238,7,0
0,0,9,9,13,12,25,35,27,62,0.000333,0.095973,12,3455.029005,191.946056,287.919084,91.125266,4,0
0,0,8,8,10,12,22,23,16,39,0.000333,0.057973,5,869.589166,48.310509,173.917833,76.238831,4,0
0,0,8,8,10,12,22,23,16,39,0.000333,0.057973,5,869.589166,48.310509,173.917833,76.238831,4,0
0,0,8,8,10,10,20,23,16,39,0.000333,0.056185,5,842.775979,46.820888,168.555196,66.438562,4,0
0,0,9,9,9,12,21,26,27,53,0.000333,0.077598,8,1862.342587,103.463477,232.792823,71.548875,3,0
0,0,9,9,9,12,21,26,27,53,0.000333,0.077598,8,1862.342587,103.463477,232.792823,71.548875,3,0
0,0,8,8,8,11,19,20,22,42,0.000333,0.059471,8,1427.303645,79.294647,178.412956,62.053748,2,0
0,0,9,9,9,15,24,25,33,58,0.000333,0.088643,8,2127.4226,118.190144,265.927825,87.132684,3,0
0,0,9,9,9,15,24,25,33,58,0.000333,0.088643,8,2127.4226,118.190144,265.927825,87.132684,3,0
0,0,8,8,8,14,22,19,28,47,0.000333,0.069864,8,1676.746289,93.152572,209.593286,77.302969,2,0
0,0,8,8,8,15,23,18,23,41,0.000333,0.061822,4,741.864161,41.214676,185.46604,82.603359,1,0
0,0,9,9,10,16,26,24,25,49,0.000333,0.076774,5,1151.607731,63.978207,230.321546,97.219281,2,0
0,0,19,19,19,43,62,102,72,174,0.000333,0.345343,9,9324.271422,518.015079,1036.030158,314.040007,7,0
0,0,19,19,19,43,62,102,72,174,0.000333,0.345343,9,9324.271422,518.015079,1036.030158,314.040007,7,0
0,0,19,19,19,43,62,102,72,174,0.000333,0.345343,9,9324.271422,518.015079,1036.030158,314.040007,7,0
0,0,19,19,19,43,62,102,72,174,0.000333,0.345343,9,9324.271422,518.015079,1036.030158,314.040007,7,0
0,0,19,19,19,43,62,102,72,174,0.000333,0.345343,9,9324.271422,518.015079,1036.030158,314.040007,7,0
0,0,18,18,17,42,59,99,68,167,0.000333,0.327467,8,7859.211114,436.62284,982.401389,295.9642,7,0
0,0,8,8,9,12,21,24,18,42,0.000333,0.061492,4,737.909327,40.994963,184.477332,71.548875,4,0
0,0,8,8,9,12,21,23,18,41,0.000333,0.060028,4,720.340057,40.018892,180.085014,71.548875,4,0
0,0,8,8,9,12,21,24,18,42,0.000333,0.061492,4,737.909327,40.994963,184.477332,71.548875,4,0
0,0,8,8,9,12,21,23,18,41,0.000333,0.060028,4,720.340057,40.018892,180.085014,71.548875,4,0
0,0,23,23,18,49,67,118,84,202,0.000333,0.40845,9,11028.15015,612.675008,1225.350016,350.179432,10,0
0,0,11,11,11,16,27,35,26,61,0.000333,0.096683,5,1450.240688,80.568927,290.048138,102.053748,4,0
0,0,11,11,10,16,26,34,26,60,0.000333,0.094009,5,1410.131915,78.340662,282.026383,97.219281,4,0
0,0,17,17,10,17,27,56,41,97,0.000333,0.153741,10,4612.240877,256.235604,461.224088,102.706149,5,0
0,0,14,14,11,15,26,44,31,75,0.000333,0.117511,10,3525.329789,195.851655,352.532979,96.657107,4,0
0,0,16,16,11,15,26,53,37,90,0.000333,0.141013,10,4230.395746,235.021986,423.039575,96.657107,4,0
0,0,13,13,11,15,26,38,28,66,0.000333,0.10341,5,1551.145107,86.174728,310.229021,96.657107,4,0
0,0,13,13,11,16,27,38,28,66,0.000333,0.104608,5,1569.112876,87.172938,313.822575,102.053748,4,0
0,0,10,10,10,14,24,31,24,55,0.000333,0.084058,5,1260.864688,70.048038,252.172938,86.52225,3,0
0,0,12,12,13,16,29,40,31,71,0.000333,0.114972,6,2069.499904,114.972217,344.916651,112.105716,4,0
0,0,11,11,11,15,26,34,25,59,0.000333,0.092442,5,1386.629717,77.034984,277.325943,96.657107,4,0
0,0,11,11,11,15,26,34,25,59,0.000333,0.092442,5,1386.629717,77.034984,277.325943,96.657107,4,0
0,0,11,11,11,15,26,34,25,59,0.000333,0.092442,5,1386.629717,77.034984,277.325943,96.657107,4,0
0,0,11,11,11,16,27,35,26,61,0.000333,0.096683,5,1450.240688,80.568927,290.048138,102.053748,4,0
0,0,11,11,10,16,26,34,26,60,0.000333,0.094009,5,1410.131915,78.340662,282.026383,97.219281,4,0
0,0,23,23,18,49,67,118,85,203,0.000333,0.410472,9,11082.74495,615.708053,1231.416106,350.179432,10,0
0,0,17,17,17,43,60,100,73,173,0.000333,0.340631,8,8175.136584,454.174255,1021.892073,302.816253,7,0
0,0,7,7,7,10,17,15,18,33,0.000333,0.044962,3,404.658821,22.481046,134.886274,52.870765,1,0
0,0,8,8,9,11,20,21,20,41,0.000333,0.059066,4,708.796208,39.377567,177.199052,66.583073,2,0
0,0,7,7,9,10,19,18,18,36,0.000333,0.050975,4,611.701562,33.98342,152.92539,61.748606,1,0
0,0,8,8,11,11,22,24,20,44,0.000333,0.065405,5,981.074956,54.504164,196.214991,76.107496,2,0
0,0,27,27,19,44,63,137,87,224,0.000333,0.446304,9,12050.19633,669.455351,1338.910703,320.925614,9,0
0,0,14,14,16,19,35,57,42,99,0.000333,0.169266,16,8124.784299,451.376905,507.799019,144.710623,4,0
0,0,13,13,16,16,32,55,38,93,0.000333,0.155,16,7440,413.333333,465,128,4,0
0,0,13,13,16,16,32,55,38,93,0.000333,0.155,16,7440,413.333333,465,128,4,0
0,0,14,14,16,19,35,58,42,100,0.000333,0.170976,16,8206.852827,455.936268,512.928302,144.710623,4,0
0,0,13,13,16,16,32,56,38,94,0.000333,0.156667,16,7520,417.777778,470,128,4,0
0,0,13,13,16,16,32,56,38,94,0.000333,0.156667,16,7520,417.777778,470,128,4,0
0,0,12,12,15,18,33,53,39,92,0.000333,0.154695,14,6497.179626,360.954424,464.084259,133.662009,4,0
0,0,11,11,15,15,30,51,35,86,0.000333,0.140664,14,5907.896277,328.21646,421.992591,117.206718,4,0
0,0,11,11,15,15,30,51,35,86,0.000333,0.140664,14,5907.896277,328.21646,421.992591,117.206718,4,0
0,0,12,12,15,19,34,53,40,93,0.000333,0.157711,14,6623.876619,367.993146,473.134044,139.313982,4,0
0,0,11,11,15,16,31,51,36,87,0.000333,0.143672,14,6034.211106,335.23395,431.015079,122.603359,4,0
0,0,11,11,15,16,31,52,36,88,0.000333,0.145323,14,6103.569854,339.087214,435.969275,122.603359,4,0
0,0,8,8,9,11,20,22,18,40,0.000333,0.057626,4,691.508495,38.417139,172.877124,66.583073,4,0
0,0,8,8,9,11,20,21,18,39,0.000333,0.056185,4,674.220783,37.45671,168.555196,66.583073,4,0
0,0,32,32,21,52,73,158,113,271,0.000333,0.559147,20,33548.84911,1863.824951,1677.442455,388.661531,11,0
0,0,27,27,20,47,67,144,95,239,0.000333,0.483265,20,28995.90633,1610.883685,1449.795317,347.504238,11,0
0,0,27,27,19,47,66,120,85,205,0.000333,0.413034,9,11151.90715,619.550397,1239.100794,341.776299,12,0
0,0,27,27,19,46,65,120,85,205,0.000333,0.411528,9,11111.26862,617.292701,1234.585402,334.794473,12,0
0,0,7,7,8,11,19,17,14,31,0.000333,0.043895,4,526.743012,29.263501,131.685753,62.053748,3,0
0,0,7,7,8,10,18,17,14,31,0.000333,0.043089,4,517.0707,28.72615,129.267675,57.219281,3,0
0,0,5,5,7,9,16,11,12,23,0.000333,0.030667,3,276,15.333333,92,48.180809,1,0
0,0,25,25,19,45,64,114,83,197,0.000333,0.394,9,10638,591,1182,327.844012,10,0
0,0,27,27,19,47,66,120,85,205,0.000333,0.413034,9,11151.90715,619.550397,1239.100794,341.776299,12,0
0,0,27,27,19,46,65,120,85,205,0.000333,0.411528,9,11111.26862,617.292701,1234.585402,334.794473,12,0
0,0,7,7,8,11,19,17,14,31,0.000333,0.043895,4,526.743012,29.263501,131.685753,62.053748,3,0
0,0,7,7,8,10,18,17,14,31,0.000333,0.043089,4,517.0707,28.72615,129.267675,57.219281,3,0
0,0,27,27,19,47,66,120,85,205,0.000333,0.413034,9,11151.90715,619.550397,1239.100794,341.776299,12,0
0,0,27,27,19,46,65,120,85,205,0.000333,0.411528,9,11111.26862,617.292701,1234.585402,334.794473,12,0
0,0,7,7,8,11,19,17,14,31,0.000333,0.043895,4,526.743012,29.263501,131.685753,62.053748,3,0
0,0,7,7,8,10,18,17,14,31,0.000333,0.043089,4,517.0707,28.72615,129.267675,57.219281,3,0
0,0,27,27,19,47,66,120,85,205,0.000333,0.413034,9,11151.90715,619.550397,1239.100794,341.776299,12,0
0,0,27,27,19,46,65,120,85,205,0.000333,0.411528,9,11111.26862,617.292701,1234.585402,334.794473,12,0
0,0,7,7,8,11,19,17,14,31,0.000333,0.043895,4,526.743012,29.263501,131.685753,62.053748,3,0
0,0,7,7,8,10,18,17,14,31,0.000333,0.043089,4,517.0707,28.72615,129.267675,57.219281,3,0
0,0,27,27,20,47,67,144,95,239,0.000333,0.483265,20,28995.90633,1610.883685,1449.795317,347.504238,13,0
0,0,22,22,18,48,66,115,83,198,0.000333,0.39893,9,10771.11032,598.395018,1196.790036,343.13685,9,0
0,0,21,21,16,47,63,111,79,190,0.000333,0.378561,8,9085.465484,504.748082,1135.683185,325.065676,9,0
0,0,22,22,18,48,66,115,83,198,0.000333,0.39893,9,10771.11032,598.395018,1196.790036,343.13685,9,0
0,0,22,22,18,48,66,115,83,198,0.000333,0.39893,9,10771.11032,598.395018,1196.790036,343.13685,9,0
0,0,28,28,19,47,66,123,96,219,0.000333,0.441241,18,23827.00162,1323.722312,1323.722312,341.776299,11,0
0,0,28,28,19,47,66,123,96,219,0.000333,0.441241,18,23827.00162,1323.722312,1323.722312,341.776299,11,0
0,0,8,8,8,11,19,20,22,42,0.000333,0.059471,8,1427.303645,79.294647,178.412956,62.053748,2,0
0,0,25,25,19,45,64,114,83,197,0.000333,0.394,9,10638,591,1182,327.844012,10,0
0,0,5,5,7,9,16,11,12,23,0.000333,0.030667,3,276,15.333333,92,48.180809,1,0
0,0,28,28,22,47,69,132,96,228,0.000333,0.464248,22,30640.35868,1702.242149,1392.743576,359.173172,12,0
0,0,8,8,11,12,23,29,25,54,0.000333,0.081424,10,2442.723456,135.706859,244.272346,81.073298,3,0
0,0,27,27,19,45,64,120,85,205,0.000333,0.41,9,11070,615,1230,327.844012,12,0
0,0,7,7,8,9,17,17,14,31,0.000333,0.042237,4,506.845392,28.158077,126.711348,52.529325,3,0
0,0,27,27,19,47,66,121,87,208,0.000333,0.419078,9,11315.10579,628.616988,1257.233977,341.776299,12,0
0,0,27,27,19,47,66,120,87,207,0.000333,0.417063,9,11260.70624,625.594791,1251.189583,341.776299,12,0
0,0,7,7,9,11,20,18,16,34,0.000333,0.048982,4,587.782221,32.654568,146.945555,66.583073,3,0
0,0,7,7,8,11,19,17,16,33,0.000333,0.046727,4,560.726432,31.151468,140.181608,62.053748,3,0
0,0,27,27,19,47,66,121,87,208,0.000333,0.419078,9,11315.10579,628.616988,1257.233977,341.776299,12,0
0,0,27,27,19,47,66,120,87,207,0.000333,0.417063,9,11260.70624,625.594791,1251.189583,341.776299,12,0
0,0,7,7,9,11,20,18,16,34,0.000333,0.048982,4,587.782221,32.654568,146.945555,66.583073,3,0
0,0,7,7,8,11,19,17,16,33,0.000333,0.046727,4,560.726432,31.151468,140.181608,62.053748,3,0
0,0,9,9,9,15,24,29,31,60,0.000333,0.091699,8,2200.782,122.265667,275.09775,87.132684,1,0
0,0,10,10,11,16,27,35,33,68,0.000333,0.107777,10,3233.323501,179.629083,323.33235,102.053748,2,0
0,0,2,2,4,9,13,6,10,16,0.000333,0.019736,2,118.414071,6.578559,59.207035,36.529325,1,0
0,0,3,3,6,10,16,10,12,22,0.000333,0.029333,3,264,14.666667,88,48.729056,2,0
0,0,3,3,8,8,16,10,13,23,0.000333,0.030667,4,368,20.444444,92,48,2,0
0,0,2,2,6,7,13,6,11,17,0.000333,0.020969,3,188.722426,10.484579,62.907475,35.161259,1,0
0,0,14,14,18,23,41,47,58,105,0.000333,0.187514,18,10125.77329,562.54296,562.54296,179.100575,3,0
0,0,10,10,12,14,26,25,45,70,0.000333,0.109677,18,5922.554045,329.03078,329.03078,96.322519,1,0
0,0,11,11,16,22,38,39,42,81,0.000333,0.141694,8,3400.657029,188.92539,425.082129,162.107496,3,0
0,0,8,8,11,15,26,21,31,52,0.000333,0.081474,10,2444.228653,135.790481,244.422865,96.657107,1,0
0,0,33,33,19,51,70,162,111,273,0.000333,0.557765,18,30119.29675,1673.294264,1673.294264,370.004315,11,0
0,0,9,9,10,12,22,28,24,52,0.000333,0.077297,10,2318.904442,128.828025,231.890444,76.238831,2,0
0,0,9,9,10,12,22,28,24,52,0.000333,0.077297,10,2318.904442,128.828025,231.890444,76.238831,2,0
0,0,7,7,10,13,23,24,22,46,0.000333,0.069361,5,1040.41925,57.801069,208.08385,81.324997,2,0
0,0,7,7,9,13,22,23,22,45,0.000333,0.066891,4,802.697691,44.594316,200.674423,76.635041,2,0
0,0,22,22,20,45,65,110,77,187,0.000333,0.375394,10,11261.82781,625.657101,1126.182781,333.571951,8,0
0,0,20,20,18,46,64,105,75,180,0.000333,0.36,9,9720,540,1080,329.1425,8,0
0,0,8,8,9,12,21,24,18,42,0.000333,0.061492,4,737.909327,40.994963,184.477332,71.548875,4,0
0,0,8,8,9,12,21,23,18,41,0.000333,0.060028,4,720.340057,40.018892,180.085014,71.548875,4,0
0,0,13,13,10,15,25,42,27,69,0.000333,0.106809,5,1602.130385,89.007244,320.426077,91.82264,4,0
0,0,13,13,11,13,24,45,26,71,0.000333,0.108511,10,3255.323376,180.851299,325.532338,86.159464,4,0
0,0,13,13,11,13,24,45,26,71,0.000333,0.108511,10,3255.323376,180.851299,325.532338,86.159464,4,0
0,0,12,12,10,12,22,31,22,53,0.000333,0.078783,5,1181.749379,65.652743,236.349876,76.238831,4,0
0,0,12,12,10,11,21,31,22,53,0.000333,0.077598,10,2327.928234,129.329346,232.792823,71.273029,4,0
0,0,8,8,9,12,21,23,16,39,0.000333,0.0571,4,685.201518,38.066751,171.300379,71.548875,4,0
0,0,8,8,9,11,20,23,16,39,0.000333,0.056185,4,674.220783,37.45671,168.555196,66.583073,4,0
0,0,12,12,10,12,22,33,22,55,0.000333,0.081756,5,1226.343695,68.130205,245.268739,76.238831,4,0
0,0,12,12,10,11,21,33,22,55,0.000333,0.080526,10,2415.774583,134.209699,241.577458,71.273029,4,0
0,0,8,8,9,12,21,24,18,42,0.000333,0.061492,4,737.909327,40.994963,184.477332,71.548875,4,0
0,0,8,8,9,12,21,23,18,41,0.000333,0.060028,4,720.340057,40.018892,180.085014,71.548875,4,0
0,0,24,24,19,43,62,107,75,182,0.000333,0.361221,9,9752.973556,541.831864,1083.663728,314.040007,10,0
0,0,24,24,19,42,61,107,75,182,0.000333,0.359798,9,9714.547759,539.697098,1079.394195,307.187955,10,0
0,0,7,7,8,11,19,17,14,31,0.000333,0.043895,4,526.743012,29.263501,131.685753,62.053748,3,0
0,0,7,7,8,10,18,17,14,31,0.000333,0.043089,4,517.0707,28.72615,129.267675,57.219281,3,0
0,0,3,3,8,8,16,10,13,23,0.000333,0.030667,4,368,20.444444,92,48,2,0
0,0,2,2,6,7,13,6,11,17,0.000333,0.020969,3,188.722426,10.484579,62.907475,35.161259,1,0
0,0,3,3,8,11,19,12,13,25,0.000333,0.035399,4,424.792751,23.599597,106.198188,62.053748,2,0
0,0,2,2,6,10,16,8,11,19,0.000333,0.025333,3,228,12.666667,76,48.729056,1,0
0,0,28,28,22,51,73,124,102,226,0.000333,0.4663,22,30775.80771,1709.767095,1398.90035,387.401188,10,0
0,0,8,8,11,15,26,21,31,52,0.000333,0.081474,10,2444.228653,135.790481,244.422865,96.657107,1,0
0,0,23,23,18,49,67,118,84,202,0.000333,0.40845,9,11028.15015,612.675008,1225.350016,350.179432,10,0
0,0,23,23,18,49,67,118,84,202,0.000333,0.40845,9,11028.15015,612.675008,1225.350016,350.179432,10,0
0,0,25,25,20,50,70,127,88,215,0.000333,0.439265,10,13177.95849,732.108805,1317.795849,368.631371,10,0
0,0,27,27,20,47,67,144,95,239,0.000333,0.483265,20,28995.90633,1610.883685,1449.795317,347.504238,11,0
0,0,32,32,21,51,72,158,112,270,0.000333,0.555293,20,33317.59501,1850.9775,1665.87975,381.532358,11,0
0,0,20,20,18,46,64,105,75,180,0.000333,0.36,9,9720,540,1080,329.1425,8,0
0,0,20,20,18,45,63,105,74,179,0.000333,0.356644,9,9629.397957,534.966553,1069.933106,322.192039,8,0
0,0,20,20,18,45,63,105,74,179,0.000333,0.356644,9,9629.397957,534.966553,1069.933106,322.192039,8,0
0,0,22,22,20,46,66,114,78,192,0.000333,0.386841,10,11605.23671,644.735373,1160.523671,340.522412,8,0
0,0,22,22,19,45,64,109,77,186,0.000333,0.372,9,10044,558,1116,327.844012,8,0
0,0,20,20,18,46,64,105,75,180,0.000333,0.36,9,9720,540,1080,329.1425,8,0
0,0,20,20,18,46,64,105,75,180,0.000333,0.36,9,9720,540,1080,329.1425,8,0
0,0,14,14,13,18,31,43,31,74,0.000333,0.122204,6,2199.663162,122.203509,366.610527,123.164366,5,0
0,0,14,14,13,17,30,43,31,74,0.000333,0.121037,6,2178.659424,121.036635,363.109904,117.592585,5,0
0,0,11,11,9,12,21,25,20,45,0.000333,0.065885,4,790.617136,43.923174,197.654284,71.548875,3,0
0,0,11,11,9,10,19,25,20,45,0.000333,0.063719,8,1529.253905,84.95855,191.156738,61.748606,3,0
0,0,7,7,7,13,20,16,24,40,0.000333,0.057626,3,518.631371,28.812854,172.877124,67.757201,1,0
0,0,10,10,12,20,32,34,35,69,0.000333,0.115,6,2070,115,345,129.458112,3,0
0,0,3,3,6,11,17,7,12,19,0.000333,0.025887,3,232.985382,12.943632,77.661794,53.563523,1,0
0,0,4,4,8,12,20,11,14,25,0.000333,0.036016,4,432.192809,24.010712,108.048202,67.01955,2,0
0,0,2,2,5,7,12,7,8,15,0.000333,0.017925,2,107.548875,5.974938,53.774438,31.261125,1,0
0,0,3,3,7,8,15,11,10,21,0.000333,0.027348,3,246.134108,13.674117,82.044703,43.651484,2,0
0,0,8,8,8,10,18,20,22,42,0.000333,0.058379,8,1401.0948,77.8386,175.13685,57.219281,1,0
0,0,11,11,13,17,30,38,33,71,0.000333,0.11613,6,2090.335394,116.129744,348.389232,117.592585,3,0
0,0,8,8,8,15,23,18,23,41,0.000333,0.061822,4,741.864161,41.214676,185.46604,82.603359,1,0
0,0,11,11,13,22,35,36,34,70,0.000333,0.119683,6,2154.298867,119.68327,359.049811,146.213212,3,0
0,0,25,25,20,51,71,127,99,226,0.000333,0.463281,10,13898.42849,772.134916,1389.842849,375.732254,9,0
0,0,20,20,17,46,63,113,81,194,0.000333,0.386531,8,9276.738441,515.374358,1159.592305,323.570718,9,0
0,0,20,20,17,46,63,113,81,194,0.000333,0.386531,8,9276.738441,515.374358,1159.592305,323.570718,9,0
0,0,25,25,20,51,71,127,99,226,0.000333,0.463281,10,13898.42849,772.134916,1389.842849,375.732254,9,0
0,0,10,10,12,18,30,35,25,60,0.000333,0.098138,6,1766.480614,98.137812,294.413436,118.0782,5,0
0,0,10,10,12,17,29,35,25,60,0.000333,0.09716,6,1748.873158,97.15962,291.47886,112.506418,5,0
0,0,7,7,8,11,19,17,14,31,0.000333,0.043895,4,526.743012,29.263501,131.685753,62.053748,3,0
0,0,7,7,8,10,18,17,14,31,0.000333,0.043089,4,517.0707,28.72615,129.267675,57.219281,3,0
0,0,10,10,12,17,29,36,27,63,0.000333,0.102018,6,1836.316816,102.017601,306.052803,112.506418,5,0
0,0,10,10,12,17,29,35,27,62,0.000333,0.100398,6,1807.16893,100.398274,301.194822,112.506418,5,0
0,0,7,7,9,10,19,18,16,34,0.000333,0.048143,4,577.718142,32.095452,144.429535,61.748606,3,0
0,0,7,7,8,10,18,17,16,33,0.000333,0.045869,4,550.4301,30.57945,137.607525,57.219281,3,0
0,0,21,21,19,45,64,111,80,191,0.000333,0.382,9,10314,573,1146,327.844012,7,0
0,0,19,19,18,44,62,102,73,175,0.000333,0.347328,9,9377.859189,520.992177,1041.984354,315.273641,7,0
0,0,19,19,18,44,62,102,73,175,0.000333,0.347328,9,9377.859189,520.992177,1041.984354,315.273641,7,0
0,0,19,19,18,44,62,102,73,175,0.000333,0.347328,9,9377.859189,520.992177,1041.984354,315.273641,7,0
0,0,19,19,18,44,62,102,73,175,0.000333,0.347328,9,9377.859189,520.992177,1041.984354,315.273641,7,0
0,0,19,19,18,44,62,102,73,175,0.000333,0.347328,9,9377.859189,520.992177,1041.984354,315.273641,7,0
0,0,32,32,20,49,69,157,108,265,0.000333,0.539586,20,32375.17962,1798.62109,1618.758981,361.559344,11,0
0,0,11,11,15,17,32,50,38,88,0.000333,0.146667,14,6160,342.222222,440,128.090227,3,0
0,0,10,10,15,14,29,48,34,82,0.000333,0.132785,14,5576.962182,309.831232,398.354442,111.906328,3,0
0,0,34,34,19,52,71,171,115,286,0.000333,0.586276,18,31658.89817,1758.827676,1758.827676,377.133488,11,0
0,0,30,30,19,49,68,150,98,248,0.000333,0.50323,18,27174.43412,1509.690785,1509.690785,355.831405,11,0
0,0,34,34,19,51,70,167,115,282,0.000333,0.576153,18,31112.24059,1728.457811,1728.457811,370.004315,11,0
0,0,22,22,18,48,66,115,83,198,0.000333,0.39893,9,10771.11032,598.395018,1196.790036,343.13685,9,0
0,0,22,22,18,48,66,115,83,198,0.000333,0.39893,9,10771.11032,598.395018,1196.790036,343.13685,9,0
0,0,22,22,18,48,66,115,83,198,0.000333,0.39893,9,10771.11032,598.395018,1196.790036,343.13685,9,0
0,0,15,15,13,21,34,54,36,90,0.000333,0.152624,6,2747.229934,152.623885,457.871656,140.344382,5,0
0,0,17,17,14,19,33,69,44,113,0.000333,0.190006,14,7980.231497,443.346194,570.016535,134.013592,6,0
0,0,17,17,14,19,33,69,44,113,0.000333,0.190006,14,7980.231497,443.346194,570.016535,134.013592,6,0
0,0,12,12,10,12,22,37,24,61,0.000333,0.090675,10,2720.253287,151.125183,272.025329,76.238831,3,0
0,0,12,12,10,12,22,37,24,61,0.000333,0.090675,10,2720.253287,151.125183,272.025329,76.238831,3,0
0,0,22,22,18,48,66,115,83,198,0.000333,0.39893,9,10771.11032,598.395018,1196.790036,343.13685,9,0
0,0,22,22,18,48,66,115,83,198,0.000333,0.39893,9,10771.11032,598.395018,1196.790036,343.13685,9,0
0,0,24,24,19,49,68,124,90,214,0.000333,0.434239,9,11724.45343,651.358524,1302.717048,355.831405,9,0
0,0,14,14,13,18,31,45,31,76,0.000333,0.125506,6,2259.113518,125.506307,376.51892,123.164366,5,0
0,0,14,14,13,17,30,45,31,76,0.000333,0.124308,6,2237.542112,124.307895,372.923685,117.592585,5,0
0,0,11,11,9,12,21,27,20,47,0.000333,0.068813,4,825.755675,45.875315,206.438919,71.548875,3,0
0,0,11,11,9,10,19,27,20,47,0.000333,0.066551,8,1597.220745,88.734486,199.652593,61.748606,3,0
0,0,10,10,12,18,30,36,27,63,0.000333,0.103045,6,1854.804645,103.044703,309.134108,118.0782,5,0
0,0,10,10,12,18,30,35,27,62,0.000333,0.101409,6,1825.363302,101.409072,304.227217,118.0782,5,0
0,0,7,7,9,11,20,18,16,34,0.000333,0.048982,4,587.782221,32.654568,146.945555,66.583073,3,0
0,0,7,7,8,11,19,17,16,33,0.000333,0.046727,4,560.726432,31.151468,140.181608,62.053748,3,0
0,0,10,10,12,18,30,35,25,60,0.000333,0.098138,6,1766.480614,98.137812,294.413436,118.0782,5,0
0,0,10,10,12,17,29,35,25,60,0.000333,0.09716,6,1748.873158,97.15962,291.47886,112.506418,5,0
0,0,7,7,8,11,19,17,14,31,0.000333,0.043895,4,526.743012,29.263501,131.685753,62.053748,3,0
0,0,7,7,8,10,18,17,14,31,0.000333,0.043089,4,517.0707,28.72615,129.267675,57.219281,3,0
0,0,22,22,18,48,66,115,83,198,0.000333,0.39893,9,10771.11032,598.395018,1196.790036,343.13685,9,0
0,0,10,10,12,18,30,36,27,63,0.000333,0.103045,6,1854.804645,103.044703,309.134108,118.0782,5,0
0,0,10,10,12,18,30,35,27,62,0.000333,0.101409,6,1825.363302,101.409072,304.227217,118.0782,5,0
0,0,7,7,9,11,20,18,16,34,0.000333,0.048982,4,587.782221,32.654568,146.945555,66.583073,3,0
0,0,7,7,8,11,19,17,16,33,0.000333,0.046727,4,560.726432,31.151468,140.181608,62.053748,3,0
0,0,10,10,12,18,30,35,25,60,0.000333,0.098138,6,1766.480614,98.137812,294.413436,118.0782,5,0
0,0,10,10,12,17,29,35,25,60,0.000333,0.09716,6,1748.873158,97.15962,291.47886,112.506418,5,0
0,0,7,7,8,11,19,17,14,31,0.000333,0.043895,4,526.743012,29.263501,131.685753,62.053748,3,0
0,0,7,7,8,10,18,17,14,31,0.000333,0.043089,4,517.0707,28.72615,129.267675,57.219281,3,0
0,0,17,17,17,42,59,100,71,171,0.000333,0.335311,8,8047.455692,447.080872,1005.931961,295.9642,7,0
0,0,22,22,20,47,67,113,89,202,0.000333,0.40845,10,12253.50017,680.750009,1225.350016,347.504238,11,0
0,0,17,17,17,42,59,100,71,171,0.000333,0.335311,8,8047.455692,447.080872,1005.931961,295.9642,9,0
0,0,7,7,7,13,20,16,24,40,0.000333,0.057626,3,518.631371,28.812854,172.877124,67.757201,1,0
0,0,27,27,19,49,68,119,95,214,0.000333,0.434239,9,11724.45343,651.358524,1302.717048,355.831405,10,0
0,0,2,2,4,9,13,6,10,16,0.000333,0.019736,2,118.414071,6.578559,59.207035,36.529325,1,0
0,0,3,3,6,10,16,10,12,22,0.000333,0.029333,3,264,14.666667,88,48.729056,2,0
0,0,22,22,20,47,67,114,89,203,0.000333,0.410472,10,12314.16106,684.120059,1231.416106,347.504238,7,0
0,0,7,7,9,10,19,18,18,36,0.000333,0.050975,4,611.701562,33.98342,152.92539,61.748606,1,0
0,0,27,27,19,46,65,121,89,210,0.000333,0.421566,9,11382.27517,632.34862,1264.697241,334.794473,10,0
0,0,2,2,5,7,12,7,8,15,0.000333,0.017925,2,107.548875,5.974938,53.774438,31.261125,1,0
0,0,3,3,7,8,15,11,10,21,0.000333,0.027348,3,246.134108,13.674117,82.044703,43.651484,2,0
0,0,17,17,17,42,59,100,71,171,0.000333,0.335311,8,8047.455692,447.080872,1005.931961,295.9642,7,0
0,0,22,22,20,48,68,114,93,207,0.000333,0.420035,10,12601.04808,700.058227,1260.104808,354.516762,7,0
0,0,9,9,7,14,21,21,36,57,0.000333,0.083454,6,1502.172559,83.454031,250.362093,72.954453,1,0
0,0,10,10,9,14,23,25,38,63,0.000333,0.094995,8,2279.875226,126.659735,284.984403,81.832294,2,0
0,0,11,11,7,15,22,26,48,74,0.000333,0.109999,9,2969.981458,164.99897,329.99794,78.254843,1,0
0,0,12,12,9,15,24,30,50,80,0.000333,0.122266,12,4401.564001,244.531333,366.797,87.132684,2,0
0,0,9,9,9,15,24,29,31,60,0.000333,0.091699,8,2200.782,122.265667,275.09775,87.132684,1,0
0,0,26,26,19,47,66,119,92,211,0.000333,0.425122,9,11478.30443,637.68358,1275.367159,341.776299,8,0
0,0,7,7,7,13,20,16,24,40,0.000333,0.057626,3,518.631371,28.812854,172.877124,67.757201,1,0
0,0,8,8,9,13,22,20,26,46,0.000333,0.068378,8,1641.070836,91.170602,205.133854,76.635041,2,0
0,0,8,8,4,12,16,21,46,67,0.000333,0.089333,6,1608,89.333333,268,51.01955,1,0
0,0,9,9,6,13,19,25,48,73,0.000333,0.103366,9,2790.888376,155.049354,310.098708,63.615491,2,0
0,0,8,8,8,13,21,19,26,45,0.000333,0.065885,8,1581.234272,87.846348,197.654284,72.105716,1,0
0,0,9,9,10,13,23,23,28,51,0.000333,0.076901,10,2307.016598,128.167589,230.70166,81.324997,2,0
0,0,11,11,7,15,22,26,48,74,0.000333,0.109999,9,2969.981458,164.99897,329.99794,78.254843,1,0
0,0,28,28,19,47,66,116,109,225,0.000333,0.45333,18,24479.79618,1359.988677,1359.988677,341.776299,8,0
0,0,3,3,6,11,17,7,12,19,0.000333,0.025887,3,232.985382,12.943632,77.661794,53.563523,1,0
0,0,4,4,8,12,20,11,14,25,0.000333,0.036016,4,432.192809,24.010712,108.048202,67.01955,2,0
0,0,7,7,7,13,20,16,24,40,0.000333,0.057626,3,518.631371,28.812854,172.877124,67.757201,1,0
0,0,24,24,19,45,64,106,85,191,0.000333,0.382,9,10314,573,1146,327.844012,8,0
0,0,8,8,9,14,23,21,27,48,0.000333,0.072377,4,868.523896,48.251328,217.130974,81.832294,1,0
0,0,25,25,19,46,65,111,88,199,0.000333,0.399484,9,10786.06075,599.225597,1198.451195,334.794473,8,0
0,0,8,8,4,12,16,21,46,67,0.000333,0.089333,6,1608,89.333333,268,51.01955,1,0
0,0,9,9,6,13,19,25,48,73,0.000333,0.103366,9,2790.888376,155.049354,310.098708,63.615491,2,0
0,0,22,22,20,47,67,113,89,202,0.000333,0.40845,10,12253.50017,680.750009,1225.350016,347.504238,7,0
0,0,38,38,24,50,74,142,120,262,0.000333,0.542292,24,39045.04276,2169.169042,1626.876782,392.23191,10,0
0,0,10,10,12,14,26,25,45,70,0.000333,0.109677,18,5922.554045,329.03078,329.03078,96.322519,1,0
0,0,3,3,8,8,16,10,13,23,0.000333,0.030667,4,368,20.444444,92,48,2,0
0,0,2,2,6,7,13,6,11,17,0.000333,0.020969,3,188.722426,10.484579,62.907475,35.161259,1,0
0,0,25,25,22,47,69,111,92,203,0.000333,0.413343,11,13640.33511,757.796395,1240.030465,359.173172,8,0
0,0,8,8,11,15,26,21,31,52,0.000333,0.081474,10,2444.228653,135.790481,244.422865,96.657107,1,0
0,0,3,3,8,11,19,12,13,25,0.000333,0.035399,4,424.792751,23.599597,106.198188,62.053748,2,0
0,0,2,2,6,10,16,8,11,19,0.000333,0.025333,3,228,12.666667,76,48.729056,1,0
0,0,17,17,17,43,60,100,73,173,0.000333,0.340631,8,8175.136584,454.174255,1021.892073,302.816253,7,0
0,0,3,3,5,11,16,6,14,20,0.000333,0.026667,2,160,8.888889,80,49.663388,1,0
0,0,4,4,7,12,19,10,16,26,0.000333,0.036815,3,331.338346,18.407686,110.446115,62.671034,2,0
0,0,10,10,8,16,24,23,37,60,0.000333,0.091699,8,2200.782,122.265667,275.09775,88,1,0
0,0,27,27,19,48,67,113,98,211,0.000333,0.426648,18,23039.00675,1279.944819,1279.944819,348.788823,8,0
0,0,10,10,9,16,25,29,34,63,0.000333,0.097521,8,2340.50352,130.027973,292.56294,92.529325,1,0
0,0,27,27,19,47,66,119,95,214,0.000333,0.431167,18,23283.00615,1293.500342,1293.500342,341.776299,8,0
0,0,3,3,6,11,17,7,12,19,0.000333,0.025887,3,232.985382,12.943632,77.661794,53.563523,1,0
0,0,4,4,8,12,20,11,14,25,0.000333,0.036016,4,432.192809,24.010712,108.048202,67.01955,2,0
0,0,20,20,18,45,63,105,74,179,0.000333,0.356644,9,9629.397957,534.966553,1069.933106,322.192039,8,0
0,0,20,20,18,45,63,105,75,180,0.000333,0.358637,9,9683.193476,537.955193,1075.910386,322.192039,8,0
0,0,20,20,18,44,62,105,74,179,0.000333,0.355267,9,9592.210256,532.90057,1065.80114,315.273641,8,0
0,0,19,19,18,44,62,102,73,175,0.000333,0.347328,9,9377.859189,520.992177,1041.984354,315.273641,7,0
0,0,32,32,21,51,72,159,112,271,0.000333,0.55735,20,33440.99351,1857.832973,1672.049675,381.532358,11,0
0,0,30,30,20,48,68,151,97,248,0.000333,0.50323,20,30193.81569,1677.434205,1509.690785,354.516762,11,0
0,0,32,32,21,51,72,158,102,260,0.000333,0.534727,20,32083.61001,1782.422778,1604.1805,381.532358,12,0
0,0,36,36,19,54,73,169,128,297,0.000333,0.612793,18,33090.80209,1838.377894,1838.377894,391.474548,12,0
0,0,38,38,19,55,74,175,140,315,0.000333,0.651993,18,35207.60058,1955.97781,1955.97781,398.685407,12,0
0,0,30,30,19,50,69,148,102,250,0.000333,0.509044,18,27488.36006,1527.131114,1527.131114,362.903432,11,0
0,0,34,34,19,53,72,163,116,279,0.000333,0.573803,18,30985.36336,1721.409075,1721.409075,384.290407,12,0
0,0,35,35,19,54,73,169,119,288,0.000333,0.594223,18,32088.05051,1782.669473,1782.669473,391.474548,12,0
0,0,40,40,19,56,75,181,152,333,0.000333,0.691399,18,37335.53923,2074.196624,2074.196624,405.922498,12,0
0,0,32,32,20,50,70,156,111,267,0.000333,0.545506,20,32730.37131,1818.353962,1636.518566,368.631371,11,0
0,0,25,25,20,51,71,126,89,215,0.000333,0.440732,10,13221.95631,734.553128,1322.195631,375.732254,10,0
0,0,23,23,18,51,69,117,86,203,0.000333,0.413343,9,11160.27418,620.015232,1240.030465,364.352342,10,0
0,0,23,23,18,51,69,117,86,203,0.000333,0.413343,9,11160.27418,620.015232,1240.030465,364.352342,10,0
0,0,23,23,18,49,67,117,85,202,0.000333,0.40845,9,11028.15015,612.675008,1225.350016,350.179432,10,0
0,0,27,27,19,46,65,135,92,227,0.000333,0.455692,18,24607.39488,1367.077494,1367.077494,334.794473,9,0
2,0,14,16,18,20,38,62,43,105,0.000333,0.183677,18,9918.583,551.032389,551.032389,161.497212,5,0
0,0,22,22,18,49,67,114,84,198,0.000333,0.400362,9,10809.77094,600.54283,1201.08566,350.179432,9,0
0,0,37,37,19,53,72,168,142,310,0.000333,0.637559,18,34428.18151,1912.67675,1912.67675,384.290407,10,0
0,0,29,29,20,46,66,143,101,244,0.000333,0.491611,20,29496.6433,1638.702406,1474.832165,340.522412,9,0
0,0,22,22,18,49,67,114,84,198,0.000333,0.400362,9,10809.77094,600.54283,1201.08566,350.179432,9,0
0,0,32,32,19,51,70,156,109,265,0.000333,0.54142,18,29236.67999,1624.259999,1624.259999,370.004315,10,0
0,0,33,33,19,52,71,165,113,278,0.000333,0.569877,18,30773.33459,1709.629699,1709.629699,377.133488,10,0
0,0,27,27,19,46,65,136,89,225,0.000333,0.451678,9,12195.29482,677.516379,1355.032758,334.794473,9,0
0,0,21,21,16,48,64,111,80,191,0.000333,0.382,8,9168,509.333333,1146,332.0782,9,0
0,0,18,18,16,44,60,98,70,168,0.000333,0.330786,8,7938.86096,441.047831,992.35762,304.214991,7,0
0,0,19,19,18,45,63,101,74,175,0.000333,0.348675,9,9414.21588,523.011993,1046.023987,322.192039,7,0
0,0,19,19,18,45,63,101,74,175,0.000333,0.348675,9,9414.21588,523.011993,1046.023987,322.192039,7,0
0,0,19,19,18,45,63,101,74,175,0.000333,0.348675,9,9414.21588,523.011993,1046.023987,322.192039,7,0
0,0,21,21,18,46,64,109,87,196,0.000333,0.392,9,10584,588,1176,329.1425,7,0
0,0,19,19,18,45,63,101,74,175,0.000333,0.348675,9,9414.21588,523.011993,1046.023987,322.192039,7,0
0,0,21,21,21,46,67,110,81,191,0.000333,0.386208,10,11586.23035,643.679464,1158.623035,346.322516,8,0
0,0,19,19,18,45,63,101,74,175,0.000333,0.348675,9,9414.21588,523.011993,1046.023987,322.192039,7,0
0,0,25,25,19,51,70,126,92,218,0.000333,0.445395,9,12025.65328,668.091849,1336.183698,370.004315,10,0
0,0,25,25,18,51,69,125,101,226,0.000333,0.460176,9,12424.73875,690.263264,1380.526527,364.352342,10,0
0,0,19,19,18,45,63,101,74,175,0.000333,0.348675,9,9414.21588,523.011993,1046.023987,322.192039,7,0
0,0,23,23,19,50,69,117,85,202,0.000333,0.411307,9,11105.29746,616.96097,1233.92194,362.903432,10,0
0,0,20,20,18,47,65,104,76,180,0.000333,0.361342,9,9756.235857,542.013103,1084.026206,336.124326,8,0
0,0,27,27,19,46,65,136,89,225,0.000333,0.451678,9,12195.29482,677.516379,1355.032758,334.794473,9,0
0,0,22,22,18,49,67,114,84,198,0.000333,0.400362,9,10809.77094,600.54283,1201.08566,350.179432,9,0
0,0,22,22,18,47,65,112,91,203,0.000333,0.407514,9,11002.86599,611.270333,1222.540666,336.124326,8,0
0,0,31,31,19,50,69,150,106,256,0.000333,0.521261,18,28148.0807,1563.782261,1563.782261,362.903432,10,0
0,0,19,19,18,45,63,101,74,175,0.000333,0.348675,9,9414.21588,523.011993,1046.023987,322.192039,7,0
0,0,22,22,19,47,66,113,82,195,0.000333,0.392886,9,10607.91168,589.328427,1178.656853,341.776299,8,0
0,0,20,20,18,45,63,104,75,179,0.000333,0.356644,9,9629.397957,534.966553,1069.933106,322.192039,8,0
0,0,12,12,14,20,34,63,39,102,0.000333,0.172974,7,3632.448469,201.802693,518.92121,139.741531,9,0
0,0,14,14,14,19,33,73,50,123,0.000333,0.20682,14,8686.446674,482.580371,620.460477,134.013592,1,0
0,0,14,14,14,19,33,80,56,136,0.000333,0.228679,14,9604.526403,533.5848,686.0376,134.013592,1,0
0,0,14,14,14,20,34,78,55,133,0.000333,0.225544,14,9472.85581,526.269767,676.632558,139.741531,1,0
0,0,14,14,14,20,34,78,56,134,0.000333,0.22724,14,9544.08029,530.226683,681.720021,139.741531,1,0
0,0,22,22,17,31,48,127,88,215,0.000333,0.400256,16,19212.271,1067.348389,1200.766938,223.066954,2,0
0,0,10,10,12,27,39,55,47,102,0.000333,0.179704,6,3234.666158,179.703675,539.111026,171.401513,2,0
0,0,9,9,12,18,30,46,41,87,0.000333,0.1423,12,5122.793782,284.599655,426.899482,118.0782,2,0
0,0,6,6,9,15,24,36,31,67,0.000333,0.102397,8,2457.5399,136.529994,307.192488,87.132684,1,0
0,0,6,6,9,16,25,34,30,64,0.000333,0.099069,4,1188.827185,66.045955,297.206796,92.529325,1,0
0,0,45,45,30,43,73,254,184,438,0.000333,0.903714,60,162668.5894,9037.143856,2711.143157,380.536102,9,0
0,0,12,12,14,27,41,59,52,111,0.000333,0.198229,7,4162.817908,231.267662,594.688273,181.684931,2,0
0,0,11,11,14,18,32,50,46,96,0.000333,0.16,14,6720,373.333333,480,128.361619,2,0
0,0,8,8,11,15,26,40,36,76,0.000333,0.119078,10,3572.334186,198.46301,357.233419,96.657107,1,0
0,0,8,8,11,16,27,38,35,73,0.000333,0.115702,10,3471.067877,192.837104,347.106788,102.053748,1,0
0,0,7,7,12,11,23,44,38,82,0.000333,0.123644,18,6676.777447,370.93208,370.93208,81.073298,3,0
0,0,46,46,25,34,59,340,265,605,0.000333,1.186333,84,298955.9198,16608.66221,3558.999045,289.070141,20,0
0,0,20,20,17,28,45,132,86,218,0.000333,0.399075,24,28733.3754,1596.298633,1197.223975,204.092806,8,0
0,0,22,22,18,28,46,141,91,232,0.000333,0.427155,27,34599.59209,1922.199561,1281.466374,209.664588,9,0
0,0,30,30,23,33,56,175,134,309,0.000333,0.598158,44,78956.79752,4386.488751,1794.472671,270.506931,4,0
0,0,10,10,11,26,37,50,42,92,0.000333,0.159757,5,2396.348548,133.130475,479.26971,160.26518,5,0
0,0,49,49,22,75,97,269,212,481,0.000333,1.058186,22,69840.2777,3880.015428,3174.558077,565.268897,28,0
0,0,53,53,24,83,107,300,234,534,0.000333,1.199981,24,86398.6409,4799.924494,3599.943371,639.167373,30,0
0,0,35,35,20,51,71,176,153,329,0.000333,0.674422,30,60698.00407,3372.111337,2023.266802,375.732254,18,0
0,0,39,39,22,61,83,207,175,382,0.000333,0.811755,22,53575.83138,2976.435077,2435.265063,459.882473,20,0
0,0,19,19,23,38,61,118,106,224,0.000333,0.442828,22,29226.6736,1623.704089,1328.485164,303.463171,14,0
0,0,19,19,22,33,55,109,94,203,0.000333,0.391205,22,25819.55248,1434.419582,1173.616022,264.572502,9,0
0,0,18,18,19,29,48,73,59,132,0.000333,0.245738,18,13269.8709,737.21505,737.21505,221.592072,4,0
0,0,78,78,30,56,86,316,226,542,0.000333,1.161012,60,208982.1298,11610.11832,3483.035497,472.418594,23,0
0,0,78,78,30,56,86,316,226,542,0.000333,1.161012,60,208982.1298,11610.11832,3483.035497,472.418594,23,0
0,0,46,46,19,38,57,185,134,319,0.000333,0.620231,27,50238.68169,2791.037872,1860.691915,280.131868,12,0
0,0,8,8,12,15,27,33,24,57,0.000333,0.090343,6,1626.171526,90.342863,271.028588,101.622909,5,0
0,0,13,13,16,17,33,54,37,91,0.000333,0.153013,16,7344.637838,408.035435,459.039865,133.486868,7,0
0,0,29,29,19,28,47,116,81,197,0.000333,0.364751,18,19696.57207,1094.254004,1094.254004,215.316561,11,0
0,0,29,29,21,28,49,122,82,204,0.000333,0.3818,20,22908.01616,1272.667565,1145.400808,226.844604,12,0
0,0,28,28,20,28,48,114,77,191,0.000333,0.355576,20,21334.55675,1185.253153,1066.727838,221.0445,10,0
0,0,24,24,19,27,46,115,73,188,0.000333,0.346143,18,18691.73366,1038.429648,1038.429648,209.092585,10,0
0,0,49,49,28,39,67,256,134,390,0.000333,0.788592,42,99362.54094,5520.141163,2365.774784,340.736624,26,0
0,0,18,18,15,25,40,103,57,160,0.000333,0.283836,14,11921.11893,662.284385,851.508495,174.699764,7,0
0,0,18,18,15,25,40,104,57,161,0.000333,0.28561,14,11995.62593,666.423663,856.830423,174.699764,7,0
0,0,20,20,19,24,43,91,63,154,0.000333,0.278548,18,15041.6059,835.644772,835.644772,190.749723,9,0
0,0,33,33,21,48,69,176,116,292,0.000333,0.594563,20,35673.78283,1981.876824,1783.689141,360.316866,9,0
0,0,57,57,22,58,80,295,195,490,0.000333,1.032582,33,102225.5773,5679.198739,3097.744766,437.870393,14,0
0,0,54,54,22,58,80,281,187,468,0.000333,0.986221,33,97635.8575,5424.214305,2958.662348,437.870393,13,0
0,0,50,50,22,58,80,271,178,449,0.000333,0.946182,33,93672.00858,5204.000477,2838.545715,437.870393,12,0
0,0,21,21,20,24,44,163,104,267,0.000333,0.485889,40,58306.72969,3239.26276,1457.668242,196.477662,5,0
0,0,21,21,20,25,45,159,102,261,0.000333,0.477791,40,57334.94633,3185.274796,1433.373658,202.534967,5,0
0,0,20,20,20,26,46,165,102,267,0.000333,0.491597,30,44243.73127,2457.98507,1474.791042,208.649995,5,0
0,0,43,43,19,47,66,227,145,372,0.000333,0.749505,27,60709.89454,3372.771919,2248.514612,341.776299,6,0
0,0,36,36,17,39,56,205,126,331,0.000333,0.640745,24,46133.6275,2562.979306,1922.234479,275.617555,5,0
0,0,39,39,19,47,66,217,136,353,0.000333,0.711224,18,38406.08023,2133.671124,2133.671124,341.776299,5,0
0,0,32,32,17,39,56,195,117,312,0.000333,0.603965,24,43485.47366,2415.859648,1811.894736,275.617555,4,0
0,0,18,18,15,25,40,103,57,160,0.000333,0.283836,14,11921.11893,662.284385,851.508495,174.699764,7,0
0,0,18,18,15,25,40,104,57,161,0.000333,0.28561,14,11995.62593,666.423663,856.830423,174.699764,7,0
0,0,13,13,17,17,34,82,47,129,0.000333,0.218761,16,10500.5233,583.362406,656.282707,138.973737,2,0
0,0,41,41,30,58,88,291,187,478,0.000333,1.029203,45,138942.3741,7719.020784,3087.608314,486.969616,21,0
0,0,83,83,25,84,109,499,324,823,0.000333,1.856739,36,200527.7652,11140.4314,5570.215699,653.051068,28,0
0,0,57,57,25,63,88,362,228,590,0.000333,1.270355,36,137198.3276,7622.12931,3811.064655,492.66504,14,0
0,0,52,52,28,43,71,253,143,396,0.000333,0.811767,42,102282.5941,5682.366338,2435.299859,367.935322,31,0
0,0,40,40,25,41,66,198,115,313,0.000333,0.630632,24,45405.48863,2522.527146,1891.895359,335.756037,20,0
0,0,36,36,22,25,47,175,99,274,0.000333,0.507319,33,50224.5924,2790.255133,1521.957345,214.2039,16,0
0,0,9,9,13,15,28,59,39,98,0.000333,0.15704,12,5653.449388,314.080522,471.120782,106.709075,4,0
0,0,25,25,26,27,53,164,111,275,0.000333,0.525059,52,81909.2625,4550.514583,1575.178125,250.593395,9,0
0,0,19,19,24,26,50,134,90,224,0.000333,0.421408,36,45512.05631,2528.447573,1264.223787,232.250533,8,0
0,0,22,22,18,48,66,114,83,197,0.000333,0.396915,9,10716.71077,595.372821,1190.745642,343.13685,9,0
0,0,22,22,18,48,66,114,83,197,0.000333,0.396915,9,10716.71077,595.372821,1190.745642,343.13685,9,0
0,0,22,22,18,48,66,114,83,197,0.000333,0.396915,9,10716.71077,595.372821,1190.745642,343.13685,9,0
0,0,22,22,18,48,66,114,83,197,0.000333,0.396915,9,10716.71077,595.372821,1190.745642,343.13685,9,0
0,0,22,22,18,48,66,114,83,197,0.000333,0.396915,9,10716.71077,595.372821,1190.745642,343.13685,9,0
0,0,24,24,18,49,67,122,94,216,0.000333,0.436758,9,11792.47739,655.137633,1310.275265,350.179432,9,0
0,0,22,22,18,48,66,114,83,197,0.000333,0.396915,9,10716.71077,595.372821,1190.745642,343.13685,9,0
0,0,25,25,19,50,69,126,91,217,0.000333,0.44185,9,11929.94826,662.774904,1325.549807,362.903432,10,0
0,0,51,51,26,53,79,318,177,495,0.000333,1.040124,39,121694.4873,6760.804852,3120.37147,425.791217,19,0
0,0,24,24,21,21,42,164,87,251,0.000333,0.451157,40,54138.86693,3007.714829,1353.471673,184.477332,12,0
0,0,9,9,16,14,30,49,35,84,0.000333,0.137393,16,6594.86096,366.381164,412.17881,117.302969,3,0
0,0,13,13,19,15,34,77,46,123,0.000333,0.208586,27,16895.4641,938.636894,625.757929,139.313982,5,0
0,0,8,8,16,14,30,52,34,86,0.000333,0.140664,16,6751.88146,375.104526,421.992591,117.302969,2,0
0,0,12,12,14,20,34,63,39,102,0.000333,0.172974,7,3632.448469,201.802693,518.92121,139.741531,9,0
0,0,38,38,22,51,73,281,165,446,0.000333,0.920221,33,91101.83786,5061.213214,2760.661753,387.401188,23,0
0,0,8,8,16,14,30,51,34,85,0.000333,0.139029,16,6673.37121,370.742845,417.085701,117.302969,2,0
0,0,77,77,37,106,143,544,420,964,0.000333,2.300705,54,372714.2623,20706.34791,6902.115969,905.909343,28,0
0,0,18,18,15,25,40,103,57,160,0.000333,0.283836,14,11921.11893,662.284385,851.508495,174.699764,7,0
0,0,18,18,15,25,40,104,57,161,0.000333,0.28561,14,11995.62593,666.423663,856.830423,174.699764,7,0
0,0,8,8,16,14,30,51,34,85,0.000333,0.139029,16,6673.37121,370.742845,417.085701,117.302969,2,0
0,0,18,18,15,25,40,103,57,160,0.000333,0.283836,14,11921.11893,662.284385,851.508495,174.699764,7,0
0,0,18,18,15,25,40,104,57,161,0.000333,0.28561,14,11995.62593,666.423663,856.830423,174.699764,7,0
0,0,78,78,29,59,88,472,312,784,0.000333,1.688065,70,354493.6072,19694.08929,5064.194389,487.957389,31,0
0,0,71,71,29,53,82,426,282,708,0.000333,1.500382,70,315080.2773,17504.45985,4501.146819,444.461233,30,0
0,0,67,67,29,55,84,408,271,679,0.000333,1.446795,56,243061.4777,13503.41543,4340.38353,458.856233,27,0
0,0,60,60,29,49,78,362,241,603,0.000333,1.263366,56,212245.4621,11791.41456,3790.097538,416.002231,26,0
0,0,63,63,28,54,82,388,254,642,0.000333,1.360516,56,228566.7097,12698.15054,4081.548387,445.369863,27,0
0,0,63,63,28,53,81,392,256,648,0.000333,1.369408,56,230060.4769,12781.13761,4108.222802,438.185722,27,0
0,0,54,54,26,45,71,315,201,516,0.000333,1.057757,52,165010.0147,9167.223039,3173.269514,369.344822,25,0
0,0,12,12,14,20,34,63,39,102,0.000333,0.172974,7,3632.448469,201.802693,518.92121,139.741531,9,0
0,0,37,37,24,50,74,291,164,455,0.000333,0.941767,36,101710.8461,5650.602563,2825.301281,392.23191,24,0
0,0,13,13,19,15,34,77,46,123,0.000333,0.208586,27,16895.4641,938.636894,625.757929,139.313982,5,0
0,0,55,55,21,39,60,266,186,452,0.000333,0.889972,40,106796.582,5933.143443,2669.914549,298.369352,6,0
0,0,21,21,20,32,52,143,86,229,0.000333,0.435134,20,26108.01391,1450.445217,1305.400695,246.438562,4,0
0,0,53,53,29,47,76,267,183,450,0.000333,0.937189,42,118085.83,6560.323889,2811.567381,401.947125,20,0
0,0,12,12,20,13,33,72,55,127,0.000333,0.213546,40,25625.52213,1423.640118,640.638053,134.544278,5,0
0,0,44,44,32,46,78,279,187,466,0.000333,0.976332,64,187455.8358,10414.2131,2928.997434,414.08385,17,0
0,0,15,15,19,20,39,96,72,168,0.000333,0.295983,27,23974.58447,1331.921359,887.947573,167.149185,8,0
0,0,13,13,18,19,37,89,68,157,0.000333,0.272628,27,22082.87282,1226.826268,817.884178,155.769273,7,0
0,0,47,47,33,53,86,303,204,507,0.000333,1.086039,48,156389.5791,8688.309948,3258.116231,470.04479,20,0
0,0,12,12,19,20,39,87,66,153,0.000333,0.269556,27,21833.99657,1212.999809,808.666539,167.149185,7,0
0,0,17,17,21,21,42,98,61,159,0.000333,0.285793,20,17147.5694,952.642745,857.37847,184.477332,5,0
0,0,35,35,18,44,62,256,190,446,0.000333,0.885191,36,95600.57596,5311.143109,2655.571554,315.273641,6,0
0,0,36,36,19,44,63,261,194,455,0.000333,0.906554,36,97907.84515,5439.32473,2719.662365,320.925614,7,0
0,0,42,42,16,51,67,269,209,478,0.000333,0.96653,32,92786.90026,5154.827792,2899.590633,353.293692,9,0
0,0,10,10,12,15,27,57,45,102,0.000333,0.161666,18,8729.973454,484.998525,484.998525,101.622909,3,0
0,0,19,19,23,24,47,118,89,207,0.000333,0.383267,33,37943.39645,2107.966469,1149.799892,214.081025,7,0
0,0,20,20,26,27,53,128,92,220,0.000333,0.420048,39,49145.5575,2730.30875,1260.1425,250.593395,8,0
0,0,14,14,17,21,38,86,65,151,0.000333,0.264146,24,19018.48931,1056.582739,792.437055,161.725534,5,0
0,0,15,15,20,25,45,96,68,164,0.000333,0.300221,20,18013.27816,1000.737675,900.663908,202.534967,6,0
0,0,13,13,13,14,27,67,51,118,0.000333,0.187026,18,10099.38106,561.076725,561.076725,101.408685,4,0
0,0,45,45,21,39,60,235,187,422,0.000333,0.830903,40,99708.31325,5539.350736,2492.707831,298.369352,19,0
0,0,47,47,23,35,58,243,186,429,0.000333,0.837691,55,138219.0616,7678.836754,2513.073847,283.566831,23,0
0,0,23,23,17,37,54,209,155,364,0.000333,0.69826,32,67032.92963,3724.051646,2094.779051,262.236643,5,0
0,0,22,22,20,31,51,125,94,219,0.000333,0.414087,30,37267.8345,2070.43525,1242.26115,240.018648,8,0
0,0,24,24,21,31,52,135,100,235,0.000333,0.446534,30,40188.10001,2232.672223,1339.603334,245.818752,9,0
0,0,12,12,14,20,34,63,39,102,0.000333,0.172974,7,3632.448469,201.802693,518.92121,139.741531,9,0
0,0,21,21,20,25,45,100,81,181,0.000333,0.331342,30,29820.76231,1656.709017,994.02541,202.534967,13,0
0,0,60,60,30,39,69,419,256,675,0.000333,1.374418,90,371092.8607,20616.27004,4123.254008,353.337404,37,0
0,0,37,37,29,44,73,272,177,449,0.000333,0.92641,56,155636.9487,8646.49715,2779.231227,381.09644,14,0
0,0,21,21,20,25,45,101,83,184,0.000333,0.336834,30,30315.02909,1684.168283,1010.50097,202.534967,13,0
0,0,46,46,28,39,67,413,205,618,0.000333,1.249614,70,262419.0184,14578.83435,3748.84312,340.736624,13,0
0,0,71,71,29,53,82,426,282,708,0.000333,1.500382,70,315080.2773,17504.45985,4501.146819,444.461233,30,0
0,0,78,78,29,59,88,472,312,784,0.000333,1.688065,70,354493.6072,19694.08929,5064.194389,487.957389,31,0
0,0,60,60,29,49,78,362,241,603,0.000333,1.263366,56,212245.4621,11791.41456,3790.097538,416.002231,26,0
0,0,67,67,29,55,84,408,271,679,0.000333,1.446795,56,243061.4777,13503.41543,4340.38353,458.856233,27,0
0,0,63,63,28,54,82,388,254,642,0.000333,1.360516,56,228566.7097,12698.15054,4081.548387,445.369863,27,0
0,0,63,63,28,53,81,392,256,648,0.000333,1.369408,56,230060.4769,12781.13761,4108.222802,438.185722,27,0
0,0,54,54,26,45,71,315,201,516,0.000333,1.057757,52,165010.0147,9167.223039,3173.269514,369.344822,25,0
0,0,26,26,23,29,52,167,114,281,0.000333,0.533941,33,52860.17751,2936.676528,1601.823561,244.923374,10,0
0,0,28,28,23,29,52,175,120,295,0.000333,0.560543,44,73991.70754,4110.650419,1681.629717,244.923374,10,0
0,0,11,11,21,26,47,92,56,148,0.000333,0.274026,20,16441.583,913.421278,822.07915,214.450099,6,0
0,0,11,11,21,26,47,92,56,148,0.000333,0.274026,20,16441.583,913.421278,822.07915,214.450099,6,0
0,0,8,8,16,14,30,51,34,85,0.000333,0.139029,16,6673.37121,370.742845,417.085701,117.302969,2,0
0,0,22,22,18,49,67,114,84,198,0.000333,0.400362,9,10809.77094,600.54283,1201.08566,350.179432,9,0
0,0,20,20,17,47,64,113,83,196,0.000333,0.392,8,9408,522.666667,1176,330.552544,9,0
0,0,22,22,18,46,64,114,81,195,0.000333,0.39,9,10530,585,1170,329.1425,9,0
0,0,23,23,18,49,67,117,85,202,0.000333,0.40845,9,11028.15015,612.675008,1225.350016,350.179432,10,0
0,0,16,16,16,27,43,170,88,258,0.000333,0.466659,24,33599.43136,1866.635076,1399.976307,192.381963,8,0
0,0,15,15,16,25,41,166,84,250,0.000333,0.446463,24,32145.31203,1785.850668,1339.388001,180.096405,8,0
0,0,12,12,14,20,34,63,39,102,0.000333,0.172974,7,3632.448469,201.802693,518.92121,139.741531,9,0
0,0,43,43,19,42,61,228,137,365,0.000333,0.721573,27,58447.41646,3247.078692,2164.719128,307.187955,16,0
0,0,42,42,24,77,101,267,208,475,0.000333,1.054217,24,75903.6109,4216.867272,3162.650454,592.581664,27,0
0,0,87,87,29,88,117,475,334,809,0.000333,1.852708,42,233441.2524,12968.95847,5558.125058,709.311431,52,0
0,0,18,18,15,25,40,103,57,160,0.000333,0.283836,14,11921.11893,662.284385,851.508495,174.699764,7,0
0,0,18,18,15,25,40,104,57,161,0.000333,0.28561,14,11995.62593,666.423663,856.830423,174.699764,7,0
0,0,5,5,11,12,23,27,21,48,0.000333,0.072377,5,1085.654869,60.314159,217.130974,81.073298,2,0
0,0,27,27,20,46,66,242,139,381,0.000333,0.767638,30,69087.42478,3838.190266,2302.914159,340.522412,20,0
0,0,12,12,13,25,38,60,39,99,0.000333,0.173182,6,3117.268943,173.181608,519.544824,164.202121,4,0
0,0,13,13,19,22,41,79,54,133,0.000333,0.237518,18,12825.9795,712.554417,712.554417,178.818118,6,0
0,0,33,33,24,52,76,259,171,430,0.000333,0.895536,36,96717.91791,5373.217662,2686.608831,406.461965,11,0
0,0,45,45,24,54,78,249,161,410,0.000333,0.859005,24,61848.35783,3436.01988,2577.01491,420.803025,20,0
0,0,34,34,24,54,78,255,173,428,0.000333,0.896717,36,96845.47739,5380.304299,2690.15215,420.803025,11,0
0,0,19,19,23,34,57,121,86,207,0.000333,0.402469,22,26562.98113,1475.721174,1207.408233,277.015662,7,0
0,0,15,15,19,26,45,105,76,181,0.000333,0.331342,18,17892.45739,994.02541,994.02541,202.922055,6,0
0,0,92,92,22,65,87,507,304,811,0.000333,1.741742,44,229909.9957,12772.77754,5225.227175,489.561403,40,0
0,0,23,23,23,37,60,146,103,249,0.000333,0.490272,22,32357.94668,1797.663705,1470.815758,296.7917,9,0
0,0,18,18,22,38,60,144,91,235,0.000333,0.462706,22,30538.62438,1696.590243,1388.11929,297.528741,6,0
0,0,38,38,25,65,90,324,208,532,0.000333,1.151222,36,124331.9705,6907.331694,3453.665847,507.550313,11,0
0,0,50,50,26,68,94,314,198,512,0.000333,1.11865,26,87254.68679,4847.4826,3355.949492,536.158906,20,0
0,0,39,39,25,67,92,320,210,530,0.000333,1.152496,36,124469.5621,6914.975673,3457.487837,522.524381,11,0
0,0,24,24,25,50,75,186,123,309,0.000333,0.641568,24,46192.91941,2566.2733,1924.704975,398.289214,7,0
0,0,20,20,22,42,64,170,113,283,0.000333,0.566,22,37356,2075.333333,1698,324.584827,6,0
0,0,97,97,25,78,103,572,341,913,0.000333,2.034925,48,293029.1991,16279.39995,6104.774981,606.357778,40,0
0,0,28,28,25,53,78,211,140,351,0.000333,0.735392,24,52948.22829,2941.568238,2206.176179,419.676189,9,0
0,0,15,15,22,38,60,137,85,222,0.000333,0.43711,22,28849.25367,1602.736315,1311.329712,297.528741,6,0
0,0,35,35,25,65,90,317,202,519,0.000333,1.123091,36,121293.7833,6738.543514,3369.271757,507.550313,11,0
0,0,47,47,26,68,94,307,192,499,0.000333,1.090247,26,85039.23576,4724.401987,3270.739837,536.158906,20,0
0,0,36,36,25,67,92,313,204,517,0.000333,1.124227,36,121416.5351,6745.363063,3372.681531,522.524381,11,0
0,0,21,21,25,50,75,179,117,296,0.000333,0.614577,24,44249.52798,2458.30711,1843.730332,398.289214,7,0
0,0,17,17,22,42,64,163,107,270,0.000333,0.54,22,35640,1980,1620,324.584827,6,0
0,0,94,94,25,78,103,565,335,900,0.000333,2.00595,48,288856.8228,16047.60127,6017.850474,606.357778,40,0
0,0,25,25,25,53,78,204,134,338,0.000333,0.708155,24,50987.1828,2832.621267,2124.46595,419.676189,9,0
0,0,27,27,27,49,76,278,141,419,0.000333,0.872627,26,68064.92233,3781.384574,2617.881628,403.502745,8,0
0,0,19,19,23,44,67,199,104,303,0.000333,0.612675,22,40436.55054,2246.47503,1838.025025,344.256916,6,0
0,0,24,24,19,34,53,142,94,236,0.000333,0.450596,18,24332.20609,1351.789227,1351.789227,253.684359,8,0
0,0,16,16,13,27,40,63,57,120,0.000333,0.212877,12,7663.576457,425.754248,638.631371,176.487679,6,0
0,0,36,36,16,42,58,267,167,434,0.000333,0.847455,24,61016.73005,3389.818336,2542.363752,290.477332,4,0
0,0,35,35,16,42,58,263,165,428,0.000333,0.835739,24,60173.18078,3342.954488,2507.215866,290.477332,3,0
0,0,34,34,16,42,58,259,163,422,0.000333,0.824023,24,59329.63152,3296.09064,2472.06798,290.477332,2,0
0,0,17,17,14,34,48,126,80,206,0.000333,0.383501,14,16107.03185,894.835103,1150.502275,226.276706,1,0
0,0,28,28,27,55,82,268,148,416,0.000333,0.881581,26,68763.28248,3820.18236,2644.741634,446.356747,8,0
0,0,25,25,27,54,81,249,138,387,0.000333,0.817841,26,63791.57073,3543.976152,2453.521951,439.145888,8,0
0,0,22,22,27,54,81,241,131,372,0.000333,0.786141,26,61319.02923,3406.612735,2358.424201,439.145888,8,0
0,0,24,24,21,49,70,124,90,214,0.000333,0.437222,10,13116.66566,728.703648,1311.666566,367.359448,10,0
0,0,22,22,18,48,66,115,83,198,0.000333,0.39893,9,10771.11032,598.395018,1196.790036,343.13685,9,0
0,0,25,25,19,50,69,127,91,218,0.000333,0.443886,9,11984.92498,665.829166,1331.658332,362.903432,10,0
0,0,22,22,18,48,66,115,83,198,0.000333,0.39893,9,10771.11032,598.395018,1196.790036,343.13685,9,0
0,0,24,24,18,49,67,124,89,213,0.000333,0.430692,9,11628.69298,646.038499,1292.076998,350.179432,9,0
0,0,20,20,18,30,48,98,61,159,0.000333,0.296003,18,15984.16268,888.009038,888.009038,222.265368,10,0
0,0,22,22,20,31,51,109,69,178,0.000333,0.336564,20,20193.83422,1121.879679,1009.691711,240.018648,10,0
0,0,21,21,17,24,41,101,78,179,0.000333,0.319667,24,23016.04341,1278.669078,959.001809,179.525968,9,0
0,0,40,40,27,48,75,237,163,400,0.000333,0.830509,39,97169.57157,5398.309532,2491.527476,396.460163,21,0
0,0,22,22,19,26,45,114,86,200,0.000333,0.366124,27,29656.00672,1647.555929,1098.370619,202.922055,11,0
0,0,41,41,29,49,78,250,171,421,0.000333,0.882051,42,111138.482,6174.360113,2646.154334,416.002231,23,0
0,0,10,10,18,21,39,90,61,151,0.000333,0.266032,18,14365.72323,798.095735,798.095735,167.297316,4,0
0,0,27,27,17,30,47,86,66,152,0.000333,0.281433,16,13508.76009,750.486672,844.297505,216.693586,7,0
0,0,33,33,21,49,70,189,139,328,0.000333,0.670135,20,40208.09659,2233.783144,2010.40483,367.359448,20,0
0,0,37,37,21,51,72,196,150,346,0.000333,0.711598,20,42695.88101,2371.993389,2134.79405,381.532358,17,0
0,0,25,25,19,41,60,148,106,254,0.000333,0.500117,18,27006.3038,1500.350211,1500.350211,300.370255,19,0
0,0,31,31,20,45,65,163,123,286,0.000333,0.574132,20,34447.94389,1913.774661,1722.397195,333.571951,16,0
0,0,15,15,29,25,54,127,94,221,0.000333,0.423943,42,53416.8658,2967.603655,1271.830138,256.977854,14,0
0,0,18,18,15,25,40,103,57,160,0.000333,0.283836,14,11921.11893,662.284385,851.508495,174.699764,7,0
0,0,18,18,15,25,40,104,57,161,0.000333,0.28561,14,11995.62593,666.423663,856.830423,174.699764,7,0
0,0,18,18,15,25,40,103,57,160,0.000333,0.283836,14,11921.11893,662.284385,851.508495,174.699764,7,0
0,0,18,18,15,25,40,104,57,161,0.000333,0.28561,14,11995.62593,666.423663,856.830423,174.699764,7,0
0,0,40,40,25,76,101,268,205,473,0.000333,1.049778,24,75584.01675,4199.112042,3149.334031,590.938896,25,0
0,0,49,49,24,57,81,205,159,364,0.000333,0.769235,24,55384.92963,3076.940535,2307.705401,442.513831,25,0
0,0,49,49,27,67,94,278,201,479,0.000333,1.046549,39,122446.2743,6802.570797,3139.64806,534.809938,23,0
0,0,43,43,28,66,94,255,180,435,0.000333,0.950415,28,79834.89221,4435.27179,2851.24615,533.53595,20,0
0,0,45,45,28,67,95,260,186,446,0.000333,0.976719,28,82044.35684,4558.019824,2930.155601,541.033914,20,0
0,0,38,38,26,61,87,282,180,462,0.000333,0.992213,26,77392.63727,4299.59096,2976.639895,483.98641,12,0
0,0,91,91,29,89,118,494,350,844,0.000333,1.936317,42,243975.9308,13554.21838,5808.950734,717.221724,56,0
0,0,6,6,12,10,22,30,20,50,0.000333,0.074324,12,2675.658971,148.647721,222.971581,76.238831,4,0
0,0,15,15,16,18,34,72,55,127,0.000333,0.215369,24,15506.58674,861.477041,646.107781,139.05865,8,0
0,0,18,18,20,31,51,104,87,191,0.000333,0.361144,20,21668.66481,1203.814711,1083.43324,240.018648,11,0
0,0,11,11,15,17,32,73,59,132,0.000333,0.22,21,13860,770,660,128.090227,11,0
0,0,16,16,21,31,52,106,93,199,0.000333,0.378129,30,34031.62512,1890.64584,1134.387504,245.818752,9,0
0,0,16,16,20,31,51,104,93,197,0.000333,0.372489,30,33524.03377,1862.446321,1117.467792,240.018648,9,0
0,0,12,12,16,24,40,81,67,148,0.000333,0.262548,16,12602.32573,700.129207,787.645358,174.0391,7,0
0,0,31,31,23,29,52,175,105,280,0.000333,0.532041,33,52672.063,2926.225722,1596.123121,244.923374,9,0
0,0,25,25,22,28,50,138,88,226,0.000333,0.42517,33,42091.87946,2338.437748,1275.511499,232.713433,9,0
0,0,28,28,24,41,65,170,120,290,0.000333,0.582162,24,41915.67998,2328.648888,1746.486666,329.698732,12,0
0,0,21,21,22,27,49,139,92,231,0.000333,0.432333,33,42800.93314,2377.829619,1296.997974,226.489458,12,0
0,0,31,31,21,30,51,170,102,272,0.000333,0.5143,30,46286.99079,2571.499488,1542.899693,239.445384,13,0
0,0,25,25,19,25,44,153,83,236,0.000333,0.429475,27,34787.49827,1932.638793,1288.425862,196.807027,14,0
0,0,31,31,20,27,47,185,98,283,0.000333,0.523983,30,47158.45935,2619.914408,1571.948645,214.820524,19,0
0,0,26,26,26,41,67,172,126,298,0.000333,0.602565,39,70500.08857,3916.671587,1807.694579,341.871065,10,0
0,0,26,26,26,41,67,170,126,296,0.000333,0.598521,39,70026.93362,3890.385201,1795.5624,341.871065,10,0
0,0,22,22,21,34,55,147,100,247,0.000333,0.475999,20,28559.91699,1586.662055,1427.995849,265.212402,8,0
0,0,27,27,16,21,37,159,94,253,0.000333,0.439331,32,42175.73445,2343.096358,1317.991702,156.238666,18,0
0,0,48,48,29,52,81,309,201,510,0.000333,1.077775,42,135799.5871,7544.421503,3233.323501,437.304314,18,0
0,0,47,47,30,50,80,300,194,494,0.000333,1.041011,45,140536.4615,7807.581197,3123.032479,429.399527,19,0
0,0,48,48,30,53,83,311,201,512,0.000333,1.088007,45,146880.9085,8160.050472,3264.020189,450.786502,18,0
0,0,47,47,31,50,81,302,194,496,0.000333,1.048189,45,141505.4521,7861.414004,3144.565601,435.772895,19,0
0,0,12,12,14,20,34,63,39,102,0.000333,0.172974,7,3632.448469,201.802693,518.92121,139.741531,9,0
0,0,13,13,17,17,34,82,47,129,0.000333,0.218761,16,10500.5233,583.362406,656.282707,138.973737,2,0
0,0,41,41,30,58,88,291,187,478,0.000333,1.029203,45,138942.3741,7719.020784,3087.608314,486.969616,21,0
0,0,83,83,25,84,109,499,324,823,0.000333,1.856739,36,200527.7652,11140.4314,5570.215699,653.051068,28,0
0,0,57,57,25,63,88,362,228,590,0.000333,1.270355,36,137198.3276,7622.12931,3811.064655,492.66504,14,0
0,0,12,12,14,20,34,63,39,102,0.000333,0.172974,7,3632.448469,201.802693,518.92121,139.741531,9,0
0,0,20,20,18,30,48,93,60,153,0.000333,0.284833,18,15380.98673,854.499263,854.499263,222.265368,14,0
0,0,22,22,20,32,52,103,68,171,0.000333,0.324925,20,19495.50384,1083.083546,974.775192,246.438562,15,0
0,0,29,29,22,47,69,314,169,483,0.000333,0.983472,33,97363.77132,5409.098406,2950.417313,359.173172,6,0
0,0,29,29,22,47,69,314,169,483,0.000333,0.983472,33,97363.77132,5409.098406,2950.417313,359.173172,6,0
0,0,28,28,22,48,70,308,167,475,0.000333,0.97047,33,96076.51129,5337.583961,2911.409433,366.185696,6,0
0,0,28,28,22,48,70,308,167,475,0.000333,0.97047,33,96076.51129,5337.583961,2911.409433,366.185696,6,0
0,0,26,26,21,23,44,115,72,187,0.000333,0.340305,30,30627.41138,1701.522854,1020.913713,196.280591,11,0
0,0,10,10,16,19,35,51,39,90,0.000333,0.153878,16,7386.167544,410.342641,461.635472,144.710623,4,0
0,0,10,10,16,21,37,53,43,96,0.000333,0.166703,16,8001.72037,444.540021,500.107523,156.238666,4,0
0,0,13,13,17,21,38,67,53,120,0.000333,0.209917,16,10076.02083,559.778935,629.751302,161.725534,6,0
0,0,10,10,16,20,36,52,41,93,0.000333,0.160268,16,7692.848402,427.380467,480.803025,150.438562,4,0
0,0,13,13,21,24,45,69,56,125,0.000333,0.228827,20,13729.63274,762.757374,686.481637,202.277766,5,0
0,0,13,13,21,23,44,68,55,123,0.000333,0.223837,20,13430.20178,746.122321,671.510089,196.280591,5,0
0,0,13,13,21,25,46,72,60,132,0.000333,0.243037,20,14582.20356,810.12242,729.110178,208.335071,5,0
0,0,13,13,21,25,46,70,58,128,0.000333,0.235672,20,14140.31861,785.573256,707.01593,208.335071,5,0
0,0,13,13,21,23,44,68,54,122,0.000333,0.222017,20,13321.01315,740.056286,666.050657,196.280591,5,0
0,0,48,48,32,35,67,215,133,348,0.000333,0.703666,48,101327.9538,5629.330769,2110.999038,339.524906,17,0
0,0,44,44,29,44,73,206,151,357,0.000333,0.736589,42,92810.22944,5156.123858,2209.767368,381.09644,14,0
0,0,15,15,20,26,46,100,68,168,0.000333,0.309319,20,18559.16817,1031.064898,927.958409,208.649995,7,0
0,0,49,49,29,45,74,227,162,389,0.000333,0.805159,42,101450.0491,5636.113838,2415.477359,388.014838,16,0
0,0,49,49,29,48,77,237,168,405,0.000333,0.846016,42,106598.0391,5922.113281,2538.048549,408.959649,16,0
0,0,37,37,30,38,68,176,117,293,0.000333,0.594542,45,80263.19756,4459.066531,1783.626612,346.627963,12,0
0,0,37,37,30,40,70,186,123,309,0.000333,0.631316,45,85227.68035,4734.871131,1893.948452,360.083842,12,0
0,0,12,12,14,20,34,63,39,102,0.000333,0.172974,7,3632.448469,201.802693,518.92121,139.741531,9,0
0,0,21,21,17,29,46,94,63,157,0.000333,0.289066,16,13875.18763,770.843757,867.199227,210.368317,15,0
0,0,27,27,20,46,66,242,139,381,0.000333,0.767638,30,69087.42478,3838.190266,2302.914159,340.522412,20,0
0,0,29,29,21,40,61,163,96,259,0.000333,0.51202,20,30721.21941,1706.734412,1536.06097,305.11579,17,0
0,0,32,32,23,43,66,182,108,290,0.000333,0.584291,22,38563.23448,2142.401916,1752.874295,337.371309,18,0
0,0,51,51,22,54,76,450,264,714,0.000333,1.487007,44,196284.8908,10904.71615,4461.020245,408.871421,28,0
0,0,18,18,15,25,40,103,57,160,0.000333,0.283836,14,11921.11893,662.284385,851.508495,174.699764,7,0
0,0,18,18,15,25,40,104,57,161,0.000333,0.28561,14,11995.62593,666.423663,856.830423,174.699764,7,0
0,0,34,34,27,48,75,203,130,333,0.000333,0.691399,26,53929.11222,2996.06179,2074.196624,396.460163,33,0
0,0,60,60,30,44,74,357,208,565,0.000333,1.169447,60,210500.4691,11694.47051,3508.341152,387.421709,42,0
0,0,18,18,20,26,46,113,92,205,0.000333,0.377443,30,33969.90603,1887.217002,1132.330201,208.649995,8,0
0,0,10,10,15,14,29,47,38,85,0.000333,0.137643,14,5780.997384,321.166521,412.928385,111.906328,3,0
0,0,80,80,28,83,111,511,410,921,0.000333,2.085886,56,350428.7927,19468.26626,6257.657013,663.734211,58,0
0,0,80,80,27,80,107,504,409,913,0.000333,2.051653,65,400072.3583,22226.24213,6154.959359,634.13621,60,0
0,0,86,86,28,83,111,540,432,972,0.000333,2.201391,70,462292.0555,25682.89198,6604.172222,663.734211,64,0
0,0,57,57,30,50,80,286,233,519,0.000333,1.093694,60,196864.8409,10936.9356,3281.080681,429.399527,34,0
0,0,45,45,29,41,70,223,187,410,0.000333,0.837669,56,140728.3381,7818.241004,2513.006037,360.541081,27,0
0,0,53,53,29,46,75,290,236,526,0.000333,1.09212,70,229345.1042,12741.39468,3276.358631,394.965299,36,0
0,0,45,45,29,41,70,224,187,411,0.000333,0.839712,56,141071.5779,7837.309884,2519.13532,360.541081,27,0
0,0,54,54,28,54,82,328,269,597,0.000333,1.265153,56,212545.6786,11808.09326,3795.458547,445.369863,37,0
0,0,63,63,28,58,86,399,323,722,0.000333,1.546588,70,324783.4207,18043.52337,4639.763153,474.368836,44,0
0,0,26,26,21,18,39,150,64,214,0.000333,0.377025,30,33932.28225,1885.126791,1131.076075,167.297316,21,0
0,0,22,22,20,17,37,134,53,187,0.000333,0.324723,30,29225.03338,1623.612966,974.167779,155.92543,15,0
0,0,30,30,20,21,41,143,75,218,0.000333,0.389315,30,35038.39011,1946.577228,1167.946337,178.677228,14,0
0,0,77,77,30,65,95,505,307,812,0.000333,1.778241,60,320083.3652,17782.40918,5334.722754,538.660626,46,0
0,0,22,22,14,20,34,97,67,164,0.000333,0.278115,21,17521.22203,973.401224,834.343906,139.741531,7,0
0,0,60,60,27,48,75,342,240,582,0.000333,1.208391,65,235636.2111,13090.90062,3625.172478,396.460163,38,0
0,0,39,39,24,38,62,213,152,365,0.000333,0.724427,48,104317.5194,5795.417742,2173.281653,309.460346,12,0
0,0,46,46,26,35,61,248,170,418,0.000333,0.826349,52,128910.5068,7161.694821,2479.048207,301.736338,18,0
0,0,45,45,26,35,61,246,168,414,0.000333,0.818442,52,127676.9134,7093.161856,2455.325258,301.736338,18,0
0,0,41,41,26,35,61,232,158,390,0.000333,0.770996,52,120275.3532,6681.964067,2312.987562,301.736338,17,0
0,0,12,12,14,20,34,63,39,102,0.000333,0.172974,7,3632.448469,201.802693,518.92121,139.741531,9,0
0,0,55,55,21,39,60,266,186,452,0.000333,0.889972,40,106796.582,5933.143443,2669.914549,298.369352,6,0
0,0,21,21,20,32,52,143,86,229,0.000333,0.435134,20,26108.01391,1450.445217,1305.400695,246.438562,4,0
0,0,53,53,29,47,76,267,183,450,0.000333,0.937189,42,118085.83,6560.323889,2811.567381,401.947125,20,0
0,0,12,12,20,13,33,72,55,127,0.000333,0.213546,40,25625.52213,1423.640118,640.638053,134.544278,5,0
0,0,44,44,32,46,78,279,187,466,0.000333,0.976332,64,187455.8358,10414.2131,2928.997434,414.08385,17,0
0,0,13,13,18,19,37,89,68,157,0.000333,0.272628,27,22082.87282,1226.826268,817.884178,155.769273,7,0
0,0,15,15,19,20,39,96,72,168,0.000333,0.295983,27,23974.58447,1331.921359,887.947573,167.149185,8,0
0,0,45,45,33,53,86,296,200,496,0.000333,1.062476,48,152996.5113,8499.806182,3187.427318,470.04479,19,0
0,0,14,14,20,21,41,94,70,164,0.000333,0.29288,30,26359.15586,1464.397548,878.638529,178.677228,8,0
0,0,60,60,30,39,69,419,256,675,0.000333,1.374418,90,371092.8607,20616.27004,4123.254008,353.337404,37,0
0,0,37,37,29,44,73,272,177,449,0.000333,0.92641,56,155636.9487,8646.49715,2779.231227,381.09644,14,0
0,0,21,21,20,25,45,101,83,184,0.000333,0.336834,30,30315.02909,1684.168283,1010.50097,202.534967,13,0
0,0,46,46,28,39,67,413,205,618,0.000333,1.249614,70,262419.0184,14578.83435,3748.84312,340.736624,13,0
0,0,78,78,29,59,88,472,312,784,0.000333,1.688065,70,354493.6072,19694.08929,5064.194389,487.957389,31,0
0,0,71,71,29,53,82,426,282,708,0.000333,1.500382,70,315080.2773,17504.45985,4501.146819,444.461233,30,0
0,0,67,67,29,55,84,408,271,679,0.000333,1.446795,56,243061.4777,13503.41543,4340.38353,458.856233,27,0
0,0,60,60,29,49,78,362,241,603,0.000333,1.263366,56,212245.4621,11791.41456,3790.097538,416.002231,26,0
0,0,63,63,28,54,82,388,254,642,0.000333,1.360516,56,228566.7097,12698.15054,4081.548387,445.369863,27,0
0,0,63,63,28,53,81,392,256,648,0.000333,1.369408,56,230060.4769,12781.13761,4108.222802,438.185722,27,0
0,0,54,54,26,45,71,315,201,516,0.000333,1.057757,52,165010.0147,9167.223039,3173.269514,369.344822,25,0
0,0,26,26,23,29,52,167,114,281,0.000333,0.533941,33,52860.17751,2936.676528,1601.823561,244.923374,10,0
0,0,28,28,23,29,52,175,120,295,0.000333,0.560543,44,73991.70754,4110.650419,1681.629717,244.923374,10,0
0,0,11,11,21,26,47,92,56,148,0.000333,0.274026,20,16441.583,913.421278,822.07915,214.450099,6,0
0,0,11,11,21,26,47,92,56,148,0.000333,0.274026,20,16441.583,913.421278,822.07915,214.450099,6,0
0,0,6,6,12,10,22,30,20,50,0.000333,0.074324,12,2675.658971,148.647721,222.971581,76.238831,4,0
0,0,18,18,20,31,51,104,87,191,0.000333,0.361144,20,21668.66481,1203.814711,1083.43324,240.018648,11,0
0,0,11,11,15,17,32,73,59,132,0.000333,0.22,21,13860,770,660,128.090227,11,0
0,0,15,15,16,18,34,72,55,127,0.000333,0.215369,24,15506.58674,861.477041,646.107781,139.05865,8,0
0,0,16,16,21,31,52,106,93,199,0.000333,0.378129,30,34031.62512,1890.64584,1134.387504,245.818752,9,0
0,0,16,16,20,31,51,104,93,197,0.000333,0.372489,30,33524.03377,1862.446321,1117.467792,240.018648,9,0
0,0,12,12,16,24,40,81,67,148,0.000333,0.262548,16,12602.32573,700.129207,787.645358,174.0391,7,0
0,0,31,31,23,29,52,175,105,280,0.000333,0.532041,33,52672.063,2926.225722,1596.123121,244.923374,9,0
0,0,28,28,24,41,65,170,120,290,0.000333,0.582162,24,41915.67998,2328.648888,1746.486666,329.698732,12,0
0,0,21,21,22,27,49,139,92,231,0.000333,0.432333,33,42800.93314,2377.829619,1296.997974,226.489458,12,0
0,0,25,25,22,28,50,138,88,226,0.000333,0.42517,33,42091.87946,2338.437748,1275.511499,232.713433,9,0
0,0,31,31,20,27,47,185,98,283,0.000333,0.523983,30,47158.45935,2619.914408,1571.948645,214.820524,19,0
0,0,25,25,19,25,44,153,83,236,0.000333,0.429475,27,34787.49827,1932.638793,1288.425862,196.807027,14,0
0,0,31,31,21,30,51,170,102,272,0.000333,0.5143,30,46286.99079,2571.499488,1542.899693,239.445384,13,0
0,0,26,26,26,41,67,172,126,298,0.000333,0.602565,39,70500.08857,3916.671587,1807.694579,341.871065,10,0
0,0,26,26,26,41,67,170,126,296,0.000333,0.598521,39,70026.93362,3890.385201,1795.5624,341.871065,10,0
0,0,22,22,21,34,55,147,100,247,0.000333,0.475999,20,28559.91699,1586.662055,1427.995849,265.212402,8,0
0,0,27,27,16,21,37,159,94,253,0.000333,0.439331,32,42175.73445,2343.096358,1317.991702,156.238666,18,0
0,0,48,48,29,52,81,309,201,510,0.000333,1.077775,42,135799.5871,7544.421503,3233.323501,437.304314,18,0
0,0,47,47,30,50,80,300,194,494,0.000333,1.041011,45,140536.4615,7807.581197,3123.032479,429.399527,19,0
0,0,48,48,30,53,83,311,201,512,0.000333,1.088007,45,146880.9085,8160.050472,3264.020189,450.786502,18,0
0,0,47,47,31,50,81,302,194,496,0.000333,1.048189,45,141505.4521,7861.414004,3144.565601,435.772895,19,0
0,0,20,20,19,31,50,93,60,153,0.000333,0.287837,9,7771.589973,431.754999,863.509997,234.290708,12,0
0,0,23,23,22,37,59,129,96,225,0.000333,0.441198,22,29119.08309,1617.726839,1323.594686,290.85727,12,0
0,0,23,23,22,37,59,129,96,225,0.000333,0.441198,22,29119.08309,1617.726839,1323.594686,290.85727,12,0
0,0,24,24,22,37,59,136,99,235,0.000333,0.460807,22,30413.26457,1689.625809,1382.421117,290.85727,13,0
0,0,31,31,17,35,52,136,109,245,0.000333,0.465536,24,33518.58554,1862.143641,1396.607731,249.011774,8,0
0,0,26,26,15,34,49,110,91,201,0.000333,0.376186,14,15799.7935,877.766306,1128.556679,231.577096,8,0
0,0,27,27,15,34,49,117,94,211,0.000333,0.394901,14,16585.85288,921.436271,1184.703777,231.577096,9,0
0,0,12,12,14,20,34,63,39,102,0.000333,0.172974,7,3632.448469,201.802693,518.92121,139.741531,9,0
0,0,29,29,25,35,60,145,116,261,0.000333,0.513899,36,55501.14404,3083.396891,1541.698445,295.62131,14,0
0,0,53,53,22,52,74,256,208,464,0.000333,0.960395,44,126772.1999,7042.899995,2881.186362,394.530361,29,0
0,0,54,54,24,52,76,268,212,480,0.000333,0.999668,48,143952.2499,7997.347217,2999.005206,406.461965,31,0
0,0,61,61,27,52,79,277,224,501,0.000333,1.052731,52,164226.0961,9123.672003,3158.194155,424.804828,31,0
0,0,66,66,25,60,85,353,279,632,0.000333,1.350245,48,194435.2834,10801.96019,4050.735072,470.50984,37,0
0,0,67,67,26,60,86,365,283,648,0.000333,1.388073,52,216539.4172,12029.96762,4164.219561,476.624868,39,0
0,0,74,74,30,60,90,374,295,669,0.000333,1.447683,60,260582.9833,14476.83241,4343.049721,501.620154,39,0
0,0,70,70,24,65,89,382,300,682,0.000333,1.47215,48,211989.6096,11777.20053,4416.4502,501.493008,42,0
0,0,71,71,25,65,90,394,304,698,0.000333,1.510438,48,217503.0461,12083.50256,4531.313461,507.550313,44,0
0,0,78,78,29,65,94,403,316,719,0.000333,1.570916,56,263913.9655,14661.88697,4712.749384,532.335357,44,0
0,0,80,80,32,60,92,409,303,712,0.000333,1.548259,80,371582.089,20643.44939,4644.776113,514.413436,29,0
0,0,78,78,33,71,104,433,322,755,0.000333,1.686277,64,323765.2472,17986.95818,5058.831987,603.097051,29,0
0,0,79,79,33,71,104,438,326,764,0.000333,1.706379,64,327624.7005,18201.37225,5119.135945,603.097051,29,0
0,0,70,70,24,49,73,395,280,675,0.000333,1.392711,60,250687.8946,13927.10526,4178.131577,385.159882,29,0
0,0,30,30,18,30,48,145,118,263,0.000333,0.489615,27,39658.81872,2203.267707,1468.845138,222.265368,20,0
0,0,32,32,19,31,50,155,125,280,0.000333,0.52676,36,56890.07039,3160.559466,1580.279733,234.290708,21,0
0,0,25,25,16,25,41,116,96,212,0.000333,0.3786,24,27259.2246,1514.401367,1135.801025,180.096405,15,0
0,0,25,25,16,26,42,115,93,208,0.000333,0.373867,24,26918.44858,1495.469365,1121.602024,186.211433,14,0
0,0,79,79,24,55,79,455,318,773,0.000333,1.624274,60,292369.3511,16242.74173,4872.822518,428.013884,31,0
0,0,18,18,15,25,40,103,57,160,0.000333,0.283836,14,11921.11893,662.284385,851.508495,174.699764,7,0
0,0,18,18,15,25,40,104,57,161,0.000333,0.28561,14,11995.62593,666.423663,856.830423,174.699764,7,0
0,0,12,12,14,20,34,63,39,102,0.000333,0.172974,7,3632.448469,201.802693,518.92121,139.741531,9,0
0,0,20,20,17,29,46,92,59,151,0.000333,0.278019,16,13344.92569,741.38476,834.057855,210.368317,10,0
0,0,51,51,26,53,79,318,177,495,0.000333,1.040124,39,121694.4873,6760.804852,3120.37147,425.791217,19,0
0,0,24,24,21,21,42,164,87,251,0.000333,0.451157,40,54138.86693,3007.714829,1353.471673,184.477332,12,0
0,0,12,12,14,20,34,63,39,102,0.000333,0.172974,7,3632.448469,201.802693,518.92121,139.741531,9,0
0,0,14,14,14,19,33,73,50,123,0.000333,0.20682,14,8686.446674,482.580371,620.460477,134.013592,1,0
0,0,14,14,14,20,34,78,56,134,0.000333,0.22724,14,9544.08029,530.226683,681.720021,139.741531,1,0
0,0,14,14,14,20,34,78,55,133,0.000333,0.225544,14,9472.85581,526.269767,676.632558,139.741531,1,0
0,0,14,14,14,19,33,80,56,136,0.000333,0.228679,14,9604.526403,533.5848,686.0376,134.013592,1,0
0,0,22,22,17,31,48,113,85,198,0.000333,0.368608,16,17693.1612,982.9534,1105.822575,223.066954,2,0
0,0,9,9,12,18,30,46,41,87,0.000333,0.1423,12,5122.793782,284.599655,426.899482,118.0782,2,0
0,0,6,6,9,16,25,34,30,64,0.000333,0.099069,4,1188.827185,66.045955,297.206796,92.529325,1,0
0,0,6,6,9,15,24,36,31,67,0.000333,0.102397,8,2457.5399,136.529994,307.192488,87.132684,1,0
0,0,10,10,14,27,41,69,50,119,0.000333,0.212516,7,4462.84082,247.935601,637.548689,181.684931,2,0
0,0,45,45,30,43,73,240,181,421,0.000333,0.868639,60,156354.9684,8686.387131,2605.916139,380.536102,9,0
0,0,11,11,14,18,32,50,46,96,0.000333,0.16,14,6720,373.333333,480,128.361619,2,0
0,0,8,8,11,16,27,38,35,73,0.000333,0.115702,10,3471.067877,192.837104,347.106788,102.053748,1,0
0,0,8,8,11,15,26,40,36,76,0.000333,0.119078,10,3572.334186,198.46301,357.233419,96.657107,1,0
0,0,12,12,14,27,41,73,55,128,0.000333,0.228589,14,9600.733192,533.374066,685.766657,181.684931,2,0
0,0,7,7,12,11,23,44,38,82,0.000333,0.123644,18,6676.777447,370.93208,370.93208,81.073298,3,0
0,0,46,46,25,34,59,340,265,605,0.000333,1.186333,84,298955.9198,16608.66221,3558.999045,289.070141,20,0
0,0,22,22,18,28,46,141,91,232,0.000333,0.427155,27,34599.59209,1922.199561,1281.466374,209.664588,9,0
0,0,20,20,17,28,45,132,86,218,0.000333,0.399075,24,28733.3754,1596.298633,1197.223975,204.092806,8,0
0,0,30,30,23,33,56,175,134,309,0.000333,0.598158,44,78956.79752,4386.488751,1794.472671,270.506931,4,0
0,0,77,77,37,106,143,544,420,964,0.000333,2.300705,54,372714.2623,20706.34791,6902.115969,905.909343,28,0
0,0,29,29,25,35,60,145,116,261,0.000333,0.513899,36,55501.14404,3083.396891,1541.698445,295.62131,14,0
0,0,59,59,27,51,78,267,217,484,0.000333,1.014045,52,158191.003,8788.389058,3042.134674,417.675655,31,0
0,0,51,51,22,51,73,246,201,447,0.000333,0.922284,33,91306.10207,5072.561226,2766.851578,387.401188,29,0
0,0,52,52,24,51,75,258,205,463,0.000333,0.961314,48,138429.2666,7690.51481,2883.943054,399.332792,31,0
0,0,74,74,30,60,90,374,295,669,0.000333,1.447683,60,260582.9833,14476.83241,4343.049721,501.620154,39,0
0,0,66,66,25,60,85,353,279,632,0.000333,1.350245,48,194435.2834,10801.96019,4050.735072,470.50984,37,0
0,0,67,67,26,60,86,365,283,648,0.000333,1.388073,52,216539.4172,12029.96762,4164.219561,476.624868,39,0
0,0,78,78,29,65,94,403,316,719,0.000333,1.570916,56,263913.9655,14661.88697,4712.749384,532.335357,44,0
0,0,70,70,24,65,89,382,300,682,0.000333,1.47215,48,211989.6096,11777.20053,4416.4502,501.493008,42,0
0,0,71,71,25,65,90,394,304,698,0.000333,1.510438,48,217503.0461,12083.50256,4531.313461,507.550313,44,0
0,0,80,80,32,60,92,409,303,712,0.000333,1.548259,80,371582.089,20643.44939,4644.776113,514.413436,29,0
0,0,79,79,34,72,106,451,335,786,0.000333,1.762715,68,359593.8925,19977.43847,5288.145477,617.208337,33,0
0,0,80,80,34,72,106,456,339,795,0.000333,1.782899,68,363711.3798,20206.18777,5348.696761,617.208337,33,0
0,0,60,60,23,46,69,355,249,604,0.000333,1.22985,55,202925.1825,11273.62125,3689.548772,358.125775,27,0
0,0,42,42,21,36,57,195,156,351,0.000333,0.682448,40,81893.7758,4549.654211,2047.344395,278.355966,23,0
0,0,25,25,16,25,41,116,96,212,0.000333,0.3786,24,27259.2246,1514.401367,1135.801025,180.096405,15,0
0,0,30,30,18,30,48,145,118,263,0.000333,0.489615,27,39658.81872,2203.267707,1468.845138,222.265368,20,0
0,0,25,25,16,26,42,115,93,208,0.000333,0.373867,24,26918.44858,1495.469365,1121.602024,186.211433,14,0
0,0,79,79,24,55,79,455,318,773,0.000333,1.624274,60,292369.3511,16242.74173,4872.822518,428.013884,31,0
0,0,77,77,29,53,82,503,314,817,0.000333,1.731373,70,363588.3991,20199.35551,5194.119988,444.461233,30,0
0,0,55,55,28,49,77,354,228,582,0.000333,1.215757,56,204247.1069,11347.0615,3647.269767,409.72672,20,0
0,0,41,41,22,40,62,274,172,446,0.000333,0.885191,44,116845.1484,6491.397133,2655.571554,310.984619,16,0
0,0,62,62,30,39,69,447,277,724,0.000333,1.474191,105,464370.0292,25798.33496,4422.571707,353.337404,39,0
0,0,37,37,29,44,73,272,177,449,0.000333,0.92641,56,155636.9487,8646.49715,2779.231227,381.09644,14,0
0,0,21,21,20,25,45,101,83,184,0.000333,0.336834,30,30315.02909,1684.168283,1010.50097,202.534967,13,0
0,0,46,46,28,39,67,413,205,618,0.000333,1.249614,70,262419.0184,14578.83435,3748.84312,340.736624,13,0
0,0,78,78,29,59,88,472,312,784,0.000333,1.688065,70,354493.6072,19694.08929,5064.194389,487.957389,31,0
0,0,71,71,29,53,82,426,282,708,0.000333,1.500382,70,315080.2773,17504.45985,4501.146819,444.461233,30,0
0,0,67,67,29,55,84,408,271,679,0.000333,1.446795,56,243061.4777,13503.41543,4340.38353,458.856233,27,0
0,0,60,60,29,49,78,362,241,603,0.000333,1.263366,56,212245.4621,11791.41456,3790.097538,416.002231,26,0
0,0,63,63,28,54,82,388,254,642,0.000333,1.360516,56,228566.7097,12698.15054,4081.548387,445.369863,27,0
0,0,63,63,28,53,81,392,256,648,0.000333,1.369408,56,230060.4769,12781.13761,4108.222802,438.185722,27,0
0,0,54,54,26,45,71,315,201,516,0.000333,1.057757,52,165010.0147,9167.223039,3173.269514,369.344822,25,0
0,0,26,26,23,29,52,167,114,281,0.000333,0.533941,33,52860.17751,2936.676528,1601.823561,244.923374,10,0
0,0,28,28,23,29,52,175,120,295,0.000333,0.560543,44,73991.70754,4110.650419,1681.629717,244.923374,10,0
0,0,11,11,21,26,47,92,56,148,0.000333,0.274026,20,16441.583,913.421278,822.07915,214.450099,6,0
0,0,11,11,21,26,47,92,56,148,0.000333,0.274026,20,16441.583,913.421278,822.07915,214.450099,6,0
0,0,6,6,12,10,22,30,20,50,0.000333,0.074324,12,2675.658971,148.647721,222.971581,76.238831,4,0
0,0,15,15,16,18,34,72,55,127,0.000333,0.215369,24,15506.58674,861.477041,646.107781,139.05865,8,0
0,0,18,18,20,31,51,104,87,191,0.000333,0.361144,20,21668.66481,1203.814711,1083.43324,240.018648,11,0
0,0,11,11,15,17,32,73,59,132,0.000333,0.22,21,13860,770,660,128.090227,11,0
0,0,16,16,21,31,52,106,93,199,0.000333,0.378129,30,34031.62512,1890.64584,1134.387504,245.818752,9,0
0,0,16,16,20,31,51,104,93,197,0.000333,0.372489,30,33524.03377,1862.446321,1117.467792,240.018648,9,0
0,0,12,12,16,24,40,81,67,148,0.000333,0.262548,16,12602.32573,700.129207,787.645358,174.0391,7,0
0,0,31,31,23,29,52,175,105,280,0.000333,0.532041,33,52672.063,2926.225722,1596.123121,244.923374,9,0
0,0,25,25,22,28,50,138,88,226,0.000333,0.42517,33,42091.87946,2338.437748,1275.511499,232.713433,9,0
0,0,28,28,24,41,65,170,120,290,0.000333,0.582162,24,41915.67998,2328.648888,1746.486666,329.698732,12,0
0,0,21,21,22,27,49,139,92,231,0.000333,0.432333,33,42800.93314,2377.829619,1296.997974,226.489458,12,0
0,0,31,31,20,27,47,185,98,283,0.000333,0.523983,30,47158.45935,2619.914408,1571.948645,214.820524,19,0
0,0,31,31,21,30,51,170,102,272,0.000333,0.5143,30,46286.99079,2571.499488,1542.899693,239.445384,13,0
0,0,25,25,19,25,44,153,83,236,0.000333,0.429475,27,34787.49827,1932.638793,1288.425862,196.807027,14,0
0,0,26,26,26,41,67,172,126,298,0.000333,0.602565,39,70500.08857,3916.671587,1807.694579,341.871065,10,0
0,0,26,26,26,41,67,170,126,296,0.000333,0.598521,39,70026.93362,3890.385201,1795.5624,341.871065,10,0
0,0,22,22,21,34,55,147,100,247,0.000333,0.475999,20,28559.91699,1586.662055,1427.995849,265.212402,8,0
0,0,27,27,16,21,37,159,94,253,0.000333,0.439331,32,42175.73445,2343.096358,1317.991702,156.238666,18,0
0,0,48,48,29,52,81,309,201,510,0.000333,1.077775,42,135799.5871,7544.421503,3233.323501,437.304314,18,0
0,0,47,47,30,50,80,300,194,494,0.000333,1.041011,45,140536.4615,7807.581197,3123.032479,429.399527,19,0
0,0,48,48,30,53,83,311,201,512,0.000333,1.088007,45,146880.9085,8160.050472,3264.020189,450.786502,18,0
0,0,47,47,31,50,81,302,194,496,0.000333,1.048189,45,141505.4521,7861.414004,3144.565601,435.772895,19,0
0,0,29,29,25,35,60,145,116,261,0.000333,0.513899,36,55501.14404,3083.396891,1541.698445,295.62131,14,0
0,0,53,53,22,52,74,256,208,464,0.000333,0.960395,44,126772.1999,7042.899995,2881.186362,394.530361,29,0
0,0,54,54,24,52,76,268,212,480,0.000333,0.999668,48,143952.2499,7997.347217,2999.005206,406.461965,31,0
0,0,61,61,27,52,79,277,224,501,0.000333,1.052731,52,164226.0961,9123.672003,3158.194155,424.804828,31,0
0,0,66,66,25,60,85,353,279,632,0.000333,1.350245,48,194435.2834,10801.96019,4050.735072,470.50984,37,0
0,0,67,67,26,60,86,365,283,648,0.000333,1.388073,52,216539.4172,12029.96762,4164.219561,476.624868,39,0
0,0,74,74,30,60,90,374,295,669,0.000333,1.447683,60,260582.9833,14476.83241,4343.049721,501.620154,39,0
0,0,70,70,24,65,89,382,300,682,0.000333,1.47215,48,211989.6096,11777.20053,4416.4502,501.493008,42,0
0,0,71,71,25,65,90,394,304,698,0.000333,1.510438,48,217503.0461,12083.50256,4531.313461,507.550313,44,0
0,0,78,78,29,65,94,403,316,719,0.000333,1.570916,56,263913.9655,14661.88697,4712.749384,532.335357,44,0
0,0,80,80,32,60,92,409,303,712,0.000333,1.548259,80,371582.089,20643.44939,4644.776113,514.413436,29,0
0,0,78,78,33,71,104,433,322,755,0.000333,1.686277,64,323765.2472,17986.95818,5058.831987,603.097051,29,0
0,0,79,79,33,71,104,438,326,764,0.000333,1.706379,64,327624.7005,18201.37225,5119.135945,603.097051,29,0
0,0,40,40,21,43,64,220,161,381,0.000333,0.762,30,68580,3810,2286,325.56805,18,0
0,0,47,47,23,47,70,259,190,449,0.000333,0.917349,44,121090.1153,6727.228627,2752.048075,365.107601,24,0
0,0,26,26,16,27,43,119,96,215,0.000333,0.388882,24,27999.52613,1555.52923,1166.646922,192.381963,14,0
0,0,31,31,18,31,49,149,121,270,0.000333,0.505324,27,40931.23476,2273.957487,1515.971658,228.638736,20,0
0,0,43,43,21,37,58,199,159,358,0.000333,0.699052,40,83886.28785,4660.349325,2097.157196,284.98844,23,0
0,0,79,79,24,55,79,455,318,773,0.000333,1.624274,60,292369.3511,16242.74173,4872.822518,428.013884,31,0
0,0,18,18,15,25,40,103,57,160,0.000333,0.283836,14,11921.11893,662.284385,851.508495,174.699764,7,0
0,0,18,18,15,25,40,104,57,161,0.000333,0.28561,14,11995.62593,666.423663,856.830423,174.699764,7,0
0,0,13,13,17,17,34,82,47,129,0.000333,0.218761,16,10500.5233,583.362406,656.282707,138.973737,2,0
0,0,41,41,30,58,88,291,187,478,0.000333,1.029203,45,138942.3741,7719.020784,3087.608314,486.969616,21,0
0,0,83,83,25,84,109,499,324,823,0.000333,1.856739,36,200527.7652,11140.4314,5570.215699,653.051068,28,0
0,0,57,57,25,63,88,362,228,590,0.000333,1.270355,36,137198.3276,7622.12931,3811.064655,492.66504,14,0
0,0,57,57,31,46,77,409,237,646,0.000333,1.349448,75,303625.8079,16868.10044,4048.344105,407.663936,35,0
0,0,35,35,30,42,72,236,170,406,0.000333,0.834997,60,150299.373,8349.965169,2504.989551,373.68405,21,0
0,0,41,41,31,44,75,283,199,482,0.000333,1.000764,60,180137.4365,10007.63536,3002.290609,393.795077,25,0
0,0,12,12,14,20,34,63,39,102,0.000333,0.172974,7,3632.448469,201.802693,518.92121,139.741531,9,0
0,0,19,19,18,28,46,86,56,142,0.000333,0.261449,18,14118.22436,784.345798,784.345798,209.664588,10,0
0,0,29,29,25,35,60,145,116,261,0.000333,0.513899,36,55501.14404,3083.396891,1541.698445,295.62131,14,0
0,0,54,54,24,52,76,268,212,480,0.000333,0.999668,48,143952.2499,7997.347217,2999.005206,406.461965,31,0
0,0,53,53,22,52,74,256,208,464,0.000333,0.960395,44,126772.1999,7042.899995,2881.186362,394.530361,29,0
0,0,61,61,27,52,79,277,224,501,0.000333,1.052731,52,164226.0961,9123.672003,3158.194155,424.804828,31,0
0,0,67,67,26,60,86,365,283,648,0.000333,1.388073,52,216539.4172,12029.96762,4164.219561,476.624868,39,0
0,0,66,66,25,60,85,353,279,632,0.000333,1.350245,48,194435.2834,10801.96019,4050.735072,470.50984,37,0
0,0,74,74,30,60,90,374,295,669,0.000333,1.447683,60,260582.9833,14476.83241,4343.049721,501.620154,39,0
0,0,71,71,25,65,90,394,304,698,0.000333,1.510438,48,217503.0461,12083.50256,4531.313461,507.550313,44,0
0,0,70,70,24,65,89,382,300,682,0.000333,1.47215,48,211989.6096,11777.20053,4416.4502,501.493008,42,0
0,0,78,78,29,65,94,403,316,719,0.000333,1.570916,56,263913.9655,14661.88697,4712.749384,532.335357,44,0
0,0,80,80,32,60,92,409,303,712,0.000333,1.548259,80,371582.089,20643.44939,4644.776113,514.413436,29,0
0,0,78,78,33,71,104,433,322,755,0.000333,1.686277,64,323765.2472,17986.95818,5058.831987,603.097051,29,0
0,0,79,79,33,71,104,438,326,764,0.000333,1.706379,64,327624.7005,18201.37225,5119.135945,603.097051,29,0
0,0,39,39,21,41,62,216,158,374,0.000333,0.74229,30,66806.0826,3711.449033,2226.86942,311.898298,18,0
0,0,44,44,22,45,67,245,180,425,0.000333,0.859363,44,113435.8679,6301.992659,2578.087906,345.240885,23,0
0,0,42,42,21,36,57,195,156,351,0.000333,0.682448,40,81893.7758,4549.654211,2047.344395,278.355966,23,0
0,0,25,25,16,26,42,115,93,208,0.000333,0.373867,24,26918.44858,1495.469365,1121.602024,186.211433,14,0
0,0,32,32,19,31,50,155,125,280,0.000333,0.52676,36,56890.07039,3160.559466,1580.279733,234.290708,21,0
0,0,79,79,24,55,79,455,318,773,0.000333,1.624274,60,292369.3511,16242.74173,4872.822518,428.013884,31,0
0,0,36,36,22,48,70,237,129,366,0.000333,0.747773,22,49352.98685,2741.832603,2243.317584,366.185696,22,0
0,0,18,18,15,25,40,103,57,160,0.000333,0.283836,14,11921.11893,662.284385,851.508495,174.699764,7,0
0,0,18,18,15,25,40,104,57,161,0.000333,0.28561,14,11995.62593,666.423663,856.830423,174.699764,7,0
0,0,22,22,14,20,34,97,67,164,0.000333,0.278115,21,17521.22203,973.401224,834.343906,139.741531,7,0
0,0,37,37,26,40,66,243,146,389,0.000333,0.783756,39,91699.50319,5094.416844,2351.269312,335.088556,18,0
0,0,18,18,15,25,40,103,57,160,0.000333,0.283836,14,11921.11893,662.284385,851.508495,174.699764,7,0
0,0,18,18,15,25,40,104,57,161,0.000333,0.28561,14,11995.62593,666.423663,856.830423,174.699764,7,0
0,0,27,27,20,46,66,242,139,381,0.000333,0.767638,30,69087.42478,3838.190266,2302.914159,340.522412,20,0
0,0,12,12,14,20,34,63,39,102,0.000333,0.172974,7,3632.448469,201.802693,518.92121,139.741531,9,0
0,0,10,10,11,26,37,50,42,92,0.000333,0.159757,5,2396.348548,133.130475,479.26971,160.26518,5,0
0,0,49,49,22,75,97,269,212,481,0.000333,1.058186,22,69840.2777,3880.015428,3174.558077,565.268897,28,0
0,0,53,53,24,83,107,300,234,534,0.000333,1.199981,24,86398.6409,4799.924494,3599.943371,639.167373,30,0
0,0,35,35,20,51,71,176,153,329,0.000333,0.674422,30,60698.00407,3372.111337,2023.266802,375.732254,18,0
0,0,39,39,22,61,83,207,175,382,0.000333,0.811755,22,53575.83138,2976.435077,2435.265063,459.882473,20,0
0,0,19,19,22,33,55,109,94,203,0.000333,0.391205,22,25819.55248,1434.419582,1173.616022,264.572502,9,0
0,0,18,18,19,29,48,73,59,132,0.000333,0.245738,18,13269.8709,737.21505,737.21505,221.592072,4,0
0,0,19,19,23,38,61,118,106,224,0.000333,0.442828,22,29226.6736,1623.704089,1328.485164,303.463171,14,0
0,0,78,78,30,56,86,316,226,542,0.000333,1.161012,60,208982.1298,11610.11832,3483.035497,472.418594,23,0
0,0,78,78,30,56,86,316,226,542,0.000333,1.161012,60,208982.1298,11610.11832,3483.035497,472.418594,23,0
0,0,46,46,19,38,57,185,134,319,0.000333,0.620231,27,50238.68169,2791.037872,1860.691915,280.131868,12,0
0,0,8,8,12,15,27,33,24,57,0.000333,0.090343,6,1626.171526,90.342863,271.028588,101.622909,5,0
0,0,13,13,16,17,33,54,37,91,0.000333,0.153013,16,7344.637838,408.035435,459.039865,133.486868,7,0
0,0,29,29,19,28,47,116,81,197,0.000333,0.364751,18,19696.57207,1094.254004,1094.254004,215.316561,11,0
0,0,29,29,21,28,49,122,82,204,0.000333,0.3818,20,22908.01616,1272.667565,1145.400808,226.844604,12,0
0,0,28,28,20,28,48,114,77,191,0.000333,0.355576,20,21334.55675,1185.253153,1066.727838,221.0445,10,0
0,0,24,24,19,27,46,115,73,188,0.000333,0.346143,18,18691.73366,1038.429648,1038.429648,209.092585,10,0
0,0,18,18,13,30,43,99,79,178,0.000333,0.321958,12,11590.50152,643.916751,965.875126,195.312434,5,0
0,0,12,12,14,20,34,63,39,102,0.000333,0.172974,7,3632.448469,201.802693,518.92121,139.741531,9,0
0,0,18,18,15,25,40,103,57,160,0.000333,0.283836,14,11921.11893,662.284385,851.508495,174.699764,7,0
0,0,18,18,15,25,40,104,57,161,0.000333,0.28561,14,11995.62593,666.423663,856.830423,174.699764,7,0
0,0,36,36,19,44,63,261,194,455,0.000333,0.906554,36,97907.84515,5439.32473,2719.662365,320.925614,7,0
0,0,35,35,18,44,62,256,190,446,0.000333,0.885191,36,95600.57596,5311.143109,2655.571554,315.273641,6,0
0,0,42,42,16,51,67,269,209,478,0.000333,0.96653,32,92786.90026,5154.827792,2899.590633,353.293692,9,0
0,0,20,20,26,27,53,128,92,220,0.000333,0.420048,39,49145.5575,2730.30875,1260.1425,250.593395,8,0
0,0,19,19,23,24,47,118,89,207,0.000333,0.383267,33,37943.39645,2107.966469,1149.799892,214.081025,7,0
0,0,10,10,12,15,27,57,45,102,0.000333,0.161666,18,8729.973454,484.998525,484.998525,101.622909,3,0
0,0,15,15,20,25,45,96,68,164,0.000333,0.300221,20,18013.27816,1000.737675,900.663908,202.534967,6,0
0,0,14,14,17,21,38,86,65,151,0.000333,0.264146,24,19018.48931,1056.582739,792.437055,161.725534,5,0
0,0,13,13,13,14,27,67,51,118,0.000333,0.187026,18,10099.38106,561.076725,561.076725,101.408685,4,0
0,0,61,61,24,41,65,306,238,544,0.000333,1.092056,60,196570.0854,10920.5603,3276.16809,329.698732,25,0
0,0,31,31,20,33,53,172,135,307,0.000333,0.586157,40,70338.86318,3907.714621,1758.47158,252.903568,17,0
0,0,23,23,17,37,54,209,155,364,0.000333,0.69826,32,67032.92963,3724.051646,2094.779051,262.236643,5,0
0,0,12,12,14,20,34,63,39,102,0.000333,0.172974,7,3632.448469,201.802693,518.92121,139.741531,9,0
0,0,16,16,16,27,43,170,88,258,0.000333,0.466659,24,33599.43136,1866.635076,1399.976307,192.381963,8,0
0,0,15,15,16,25,41,166,84,250,0.000333,0.446463,24,32145.31203,1785.850668,1339.388001,180.096405,8,0
0,0,22,22,14,20,34,97,67,164,0.000333,0.278115,21,17521.22203,973.401224,834.343906,139.741531,7,0
0,0,60,60,27,48,75,342,240,582,0.000333,1.208391,65,235636.2111,13090.90062,3625.172478,396.460163,38,0
0,0,60,60,30,39,69,419,256,675,0.000333,1.374418,90,371092.8607,20616.27004,4123.254008,353.337404,37,0
0,0,8,8,16,14,30,51,34,85,0.000333,0.139029,16,6673.37121,370.742845,417.085701,117.302969,2,0
0,0,62,62,30,39,69,447,277,724,0.000333,1.474191,105,464370.0292,25798.33496,4422.571707,353.337404,39,0
0,0,37,37,29,44,73,272,177,449,0.000333,0.92641,56,155636.9487,8646.49715,2779.231227,381.09644,14,0
0,0,21,21,20,25,45,100,81,181,0.000333,0.331342,30,29820.76231,1656.709017,994.02541,202.534967,13,0
0,0,46,46,28,39,67,413,205,618,0.000333,1.249614,70,262419.0184,14578.83435,3748.84312,340.736624,13,0
0,0,78,78,29,59,88,472,312,784,0.000333,1.688065,70,354493.6072,19694.08929,5064.194389,487.957389,31,0
0,0,71,71,29,53,82,426,282,708,0.000333,1.500382,70,315080.2773,17504.45985,4501.146819,444.461233,30,0
0,0,67,67,29,55,84,408,271,679,0.000333,1.446795,56,243061.4777,13503.41543,4340.38353,458.856233,27,0
0,0,60,60,29,49,78,362,241,603,0.000333,1.263366,56,212245.4621,11791.41456,3790.097538,416.002231,26,0
0,0,63,63,28,54,82,388,254,642,0.000333,1.360516,56,228566.7097,12698.15054,4081.548387,445.369863,27,0
0,0,63,63,28,53,81,392,256,648,0.000333,1.369408,56,230060.4769,12781.13761,4108.222802,438.185722,27,0
0,0,54,54,26,45,71,315,201,516,0.000333,1.057757,52,165010.0147,9167.223039,3173.269514,369.344822,25,0
0,0,26,26,23,29,52,167,114,281,0.000333,0.533941,33,52860.17751,2936.676528,1601.823561,244.923374,10,0
0,0,28,28,23,29,52,175,120,295,0.000333,0.560543,44,73991.70754,4110.650419,1681.629717,244.923374,10,0
0,0,11,11,21,26,47,92,56,148,0.000333,0.274026,20,16441.583,913.421278,822.07915,214.450099,6,0
0,0,11,11,21,26,47,92,56,148,0.000333,0.274026,20,16441.583,913.421278,822.07915,214.450099,6,0
0,0,13,13,13,26,39,65,41,106,0.000333,0.186751,6,3361.515811,186.750878,560.252635,170.317149,4,0
0,0,18,18,15,25,40,103,57,160,0.000333,0.283836,14,11921.11893,662.284385,851.508495,174.699764,7,0
0,0,18,18,15,25,40,104,57,161,0.000333,0.28561,14,11995.62593,666.423663,856.830423,174.699764,7,0
0,0,62,62,30,39,69,447,277,724,0.000333,1.474191,105,464370.0292,25798.33496,4422.571707,353.337404,39,0
0,0,37,37,29,44,73,272,177,449,0.000333,0.92641,56,155636.9487,8646.49715,2779.231227,381.09644,14,0
0,0,21,21,20,25,45,101,83,184,0.000333,0.336834,30,30315.02909,1684.168283,1010.50097,202.534967,13,0
0,0,46,46,28,39,67,413,205,618,0.000333,1.249614,70,262419.0184,14578.83435,3748.84312,340.736624,13,0
0,0,78,78,29,59,88,472,312,784,0.000333,1.688065,70,354493.6072,19694.08929,5064.194389,487.957389,31,0
0,0,71,71,29,53,82,426,282,708,0.000333,1.500382,70,315080.2773,17504.45985,4501.146819,444.461233,30,0
0,0,67,67,29,55,84,408,271,679,0.000333,1.446795,56,243061.4777,13503.41543,4340.38353,458.856233,27,0
0,0,60,60,29,49,78,362,241,603,0.000333,1.263366,56,212245.4621,11791.41456,3790.097538,416.002231,26,0
0,0,63,63,28,54,82,388,254,642,0.000333,1.360516,56,228566.7097,12698.15054,4081.548387,445.369863,27,0
0,0,63,63,28,53,81,392,256,648,0.000333,1.369408,56,230060.4769,12781.13761,4108.222802,438.185722,27,0
0,0,54,54,26,45,71,315,201,516,0.000333,1.057757,52,165010.0147,9167.223039,3173.269514,369.344822,25,0
0,0,26,26,23,29,52,167,114,281,0.000333,0.533941,33,52860.17751,2936.676528,1601.823561,244.923374,10,0
0,0,28,28,23,29,52,175,120,295,0.000333,0.560543,44,73991.70754,4110.650419,1681.629717,244.923374,10,0
0,0,11,11,21,26,47,92,56,148,0.000333,0.274026,20,16441.583,913.421278,822.07915,214.450099,6,0
0,0,11,11,21,26,47,92,56,148,0.000333,0.274026,20,16441.583,913.421278,822.07915,214.450099,6,0
0,0,42,42,16,51,67,269,209,478,0.000333,0.96653,32,92786.90026,5154.827792,2899.590633,353.293692,9,0
0,0,35,35,18,44,62,256,190,446,0.000333,0.885191,36,95600.57596,5311.143109,2655.571554,315.273641,6,0
0,0,36,36,19,44,63,261,194,455,0.000333,0.906554,36,97907.84515,5439.32473,2719.662365,320.925614,7,0
0,0,14,14,17,17,34,87,68,155,0.000333,0.262852,32,25233.81569,1401.87865,788.55674,138.973737,5,0
0,0,25,25,25,30,55,167,132,299,0.000333,0.576209,48,82974.07461,4609.670812,1728.626554,263.303123,24,0
0,0,20,20,26,27,53,128,92,220,0.000333,0.420048,39,49145.5575,2730.30875,1260.1425,250.593395,8,0
0,0,21,21,20,24,44,124,94,218,0.000333,0.396719,30,35704.68279,1983.593488,1190.156093,196.477662,8,0
0,0,19,19,23,24,47,118,89,207,0.000333,0.383267,33,37943.39645,2107.966469,1149.799892,214.081025,7,0
0,0,19,19,19,25,44,101,78,179,0.000333,0.325746,27,26385.43301,1465.85739,977.23826,196.807027,6,0
0,0,12,12,14,19,33,74,56,130,0.000333,0.21859,14,9180.797297,510.044294,655.771236,134.013592,4,0
0,0,13,13,14,17,31,76,55,131,0.000333,0.216333,21,13628.99405,757.166336,648.999717,122.789837,5,0
0,0,12,12,14,17,31,76,57,133,0.000333,0.219636,21,13837.0703,768.726127,658.908109,122.789837,4,0
0,0,12,12,13,18,31,75,57,132,0.000333,0.217985,18,11771.17043,653.953913,653.953913,123.164366,4,0
0,0,10,10,12,15,27,57,45,102,0.000333,0.161666,18,8729.973454,484.998525,484.998525,101.622909,3,0
0,0,14,14,14,23,37,93,71,164,0.000333,0.284783,21,17941.35739,996.742077,854.350352,157.344894,4,0
0,0,14,14,15,24,39,93,72,165,0.000333,0.290697,21,18313.91869,1017.439927,872.091366,168.642459,4,0
0,0,14,14,14,20,34,90,69,159,0.000333,0.269636,21,16987.03843,943.724357,808.906592,139.741531,4,0
0,0,14,14,14,18,32,91,69,160,0.000333,0.266667,21,16800,933.333333,800,128.361619,4,0
0,0,14,14,15,22,37,86,67,153,0.000333,0.265682,21,16737.97366,929.887426,797.046365,156.710855,4,0
0,0,14,14,15,20,35,85,69,154,0.000333,0.263303,21,16588.10128,921.561182,789.909585,145.041921,4,0
0,0,30,30,23,40,63,160,123,283,0.000333,0.563857,33,55821.81721,3101.212067,1691.570218,316.919049,9,0
0,0,30,30,22,38,60,155,118,273,0.000333,0.537527,33,53215.17738,2956.398743,1612.581133,297.528741,9,0
0,0,31,31,23,43,66,167,132,299,0.000333,0.602425,33,59640.03678,3313.335376,1807.273842,337.371309,9,0
0,0,14,14,14,23,37,85,67,152,0.000333,0.263946,14,11085.71676,615.873153,791.836912,157.344894,4,0
0,0,14,14,14,21,35,84,69,153,0.000333,0.261593,21,16480.38633,915.577019,784.780302,145.541635,4,0
0,0,30,30,23,39,62,159,123,282,0.000333,0.559694,33,55409.75086,3078.319492,1679.08336,310.172612,9,0
0,0,30,30,22,37,59,154,118,272,0.000333,0.53336,33,52802.60401,2933.478001,1600.078909,290.85727,9,0
0,0,31,31,23,42,65,166,132,298,0.000333,0.598222,33,59223.96507,3290.220282,1794.665608,330.519257,9,0
0,0,14,14,14,22,36,89,69,158,0.000333,0.272283,21,17153.81116,952.989509,816.84815,151.410465,4,0
0,0,14,14,15,23,38,89,70,159,0.000333,0.27814,21,17522.82997,973.490554,834.420475,162.645284,4,0
0,0,14,14,14,22,36,90,70,160,0.000333,0.275729,21,17370.94801,965.052667,827.188,151.410465,4,0
0,0,14,14,14,23,37,90,71,161,0.000333,0.279574,21,17613.16183,978.508991,838.721992,157.344894,4,0
0,0,14,14,14,22,36,89,69,158,0.000333,0.272283,21,17153.81116,952.989509,816.84815,151.410465,4,0
0,0,14,14,15,23,38,89,70,159,0.000333,0.27814,21,17522.82997,973.490554,834.420475,162.645284,4,0
0,0,14,14,14,23,37,93,71,164,0.000333,0.284783,21,17941.35739,996.742077,854.350352,157.344894,4,0
0,0,14,14,15,24,39,93,72,165,0.000333,0.290697,21,18313.91869,1017.439927,872.091366,168.642459,4,0
0,0,14,14,14,23,37,93,71,164,0.000333,0.284783,21,17941.35739,996.742077,854.350352,157.344894,4,0
0,0,14,14,15,24,39,93,72,165,0.000333,0.290697,21,18313.91869,1017.439927,872.091366,168.642459,4,0
0,0,14,14,14,22,36,90,70,160,0.000333,0.275729,21,17370.94801,965.052667,827.188,151.410465,4,0
0,0,14,14,14,23,37,90,71,161,0.000333,0.279574,21,17613.16183,978.508991,838.721992,157.344894,4,0
0,0,14,14,14,23,37,93,71,164,0.000333,0.284783,21,17941.35739,996.742077,854.350352,157.344894,4,0
0,0,14,14,15,24,39,93,72,165,0.000333,0.290697,21,18313.91869,1017.439927,872.091366,168.642459,4,0
0,0,13,13,13,14,27,67,51,118,0.000333,0.187026,18,10099.38106,561.076725,561.076725,101.408685,4,0
0,0,15,15,20,25,45,96,68,164,0.000333,0.300221,20,18013.27816,1000.737675,900.663908,202.534967,6,0
0,0,16,16,15,22,37,92,70,162,0.000333,0.28131,21,17722.56035,984.586686,843.931445,156.710855,6,0
0,0,14,14,17,21,38,86,65,151,0.000333,0.264146,24,19018.48931,1056.582739,792.437055,161.725534,5,0
0,0,19,19,23,26,49,128,107,235,0.000333,0.439819,44,58056.09979,3225.338877,1319.456813,226.253358,22,0
0,0,16,16,22,21,43,88,79,167,0.000333,0.302062,33,29904.14506,1661.341392,906.186214,190.346161,11,0
0,0,17,17,22,25,47,119,98,217,0.000333,0.401782,33,39776.41077,2209.800598,1205.345781,214.2039,20,0
0,0,24,24,24,28,52,160,125,285,0.000333,0.541542,48,77982.01534,4332.334186,1624.62532,244.645038,22,0
0,0,20,20,22,27,49,147,113,260,0.000333,0.486608,44,64232.28062,3568.460034,1459.824559,226.489458,19,0
0,0,49,49,23,35,58,259,199,458,0.000333,0.894318,55,147562.5413,8197.918959,2682.955296,283.566831,23,0
0,0,33,33,20,33,53,188,148,336,0.000333,0.641527,40,76983.25091,4276.847273,1924.581273,252.903568,17,0
0,0,32,32,22,33,55,179,141,320,0.000333,0.616678,44,81401.54477,4522.308043,1850.035108,264.572502,14,0
0,0,32,32,22,33,55,176,138,314,0.000333,0.605116,44,79875.2658,4437.514767,1815.34695,264.572502,15,0
0,0,32,32,22,33,55,179,141,320,0.000333,0.616678,44,81401.54477,4522.308043,1850.035108,264.572502,14,0
0,0,34,34,24,34,58,206,156,362,0.000333,0.706863,48,101788.2778,5654.904321,2120.58912,283.012837,17,0
0,0,37,37,24,34,58,223,164,387,0.000333,0.75568,48,108817.855,6045.436387,2267.038645,283.012837,19,0
0,0,32,32,22,34,56,182,142,324,0.000333,0.627194,44,82789.65177,4599.425098,1881.582995,271.081232,16,0
0,0,61,61,23,37,60,298,227,525,0.000333,1.033706,66,204673.7591,11370.7644,3101.117563,296.7917,29,0
0,0,44,44,20,34,54,231,175,406,0.000333,0.778828,50,116824.2163,6490.234239,2336.484326,259.412299,23,0
0,0,44,44,27,42,69,280,221,501,0.000333,1.020124,65,198924.0989,11051.33883,3060.370753,354.859294,35,0
0,0,34,34,21,34,55,184,150,334,0.000333,0.643658,40,77238.96577,4291.053654,1930.974144,265.212402,14,0
0,0,43,43,23,51,74,244,199,443,0.000333,0.916929,33,90775.99875,5043.111042,2750.787841,393.335617,20,0
0,0,34,34,21,33,54,184,150,334,0.000333,0.640711,40,76885.29703,4271.40539,1922.132426,258.703672,14,0
0,0,35,35,22,34,56,188,153,341,0.000333,0.660103,44,87133.55325,4840.752958,1980.308028,271.081232,14,0
0,0,36,36,22,34,56,194,156,350,0.000333,0.677525,44,89433.2658,4968.514767,2032.574223,271.081232,14,0
0,0,35,35,22,33,55,189,152,341,0.000333,0.657148,44,86743.52114,4819.084508,1971.443662,264.572502,14,0
0,0,35,35,22,33,55,189,152,341,0.000333,0.657148,44,86743.52114,4819.084508,1971.443662,264.572502,14,0
0,0,44,44,24,51,75,250,202,452,0.000333,0.938475,36,101355.3377,5630.852096,2815.426048,399.332792,20,0
0,0,35,35,22,34,56,190,153,343,0.000333,0.663974,44,87644.60048,4869.144471,1991.922738,271.081232,14,0
0,0,44,44,24,51,75,250,202,452,0.000333,0.938475,36,101355.3377,5630.852096,2815.426048,399.332792,20,0
0,0,35,35,22,33,55,190,153,343,0.000333,0.661002,44,87252.2808,4847.348933,1983.006382,264.572502,14,0
0,0,36,36,22,34,56,194,156,350,0.000333,0.677525,44,89433.2658,4968.514767,2032.574223,271.081232,14,0
0,0,35,35,22,33,55,187,152,339,0.000333,0.653294,44,86234.76149,4790.820083,1959.880943,264.572502,14,0
0,0,34,34,20,32,52,182,148,330,0.000333,0.627048,40,75245.80428,4180.32246,1881.145107,246.438562,14,0
0,0,34,34,20,32,52,182,148,330,0.000333,0.627048,40,75245.80428,4180.32246,1881.145107,246.438562,14,0
0,0,43,43,23,50,73,243,198,441,0.000333,0.909904,33,90080.51681,5004.473156,2729.71263,386.234734,20,0
0,0,61,61,24,41,65,306,238,544,0.000333,1.092056,60,196570.0854,10920.5603,3276.16809,329.698732,25,0
0,0,31,31,20,33,53,172,135,307,0.000333,0.586157,40,70338.86318,3907.714621,1758.47158,252.903568,17,0
0,0,30,30,22,33,55,163,128,291,0.000333,0.560792,33,55518.39733,3084.355407,1682.375677,264.572502,14,0
0,0,30,30,22,33,55,160,125,285,0.000333,0.549229,33,54373.68811,3020.76045,1647.687518,264.572502,15,0
0,0,30,30,22,33,55,163,128,291,0.000333,0.560792,33,55518.39733,3084.355407,1682.375677,264.572502,14,0
0,0,32,32,24,34,58,190,143,333,0.000333,0.650236,48,93633.96823,5201.887124,1950.707671,283.012837,17,0
0,0,35,35,24,34,58,207,151,358,0.000333,0.699052,48,100663.5454,5592.41919,2097.157196,283.012837,19,0
0,0,30,30,22,34,56,166,129,295,0.000333,0.571057,33,56534.60017,3140.81112,1713.169702,271.081232,16,0
0,0,59,59,23,37,60,282,214,496,0.000333,0.976606,55,161139.9754,8952.220858,2929.817735,296.7917,29,0
0,0,42,42,20,34,54,215,162,377,0.000333,0.723198,40,86783.70353,4821.316863,2169.592588,259.412299,23,0
0,0,42,42,27,42,69,264,208,472,0.000333,0.961075,52,149927.6243,8329.312459,2883.223544,354.859294,35,0
0,0,32,32,21,34,55,168,137,305,0.000333,0.587772,40,70532.58851,3918.477139,1763.314713,265.212402,14,0
0,0,41,41,23,51,74,228,186,414,0.000333,0.856905,33,84833.55188,4712.975105,2570.713693,393.335617,20,0
0,0,32,32,21,33,54,168,137,305,0.000333,0.58508,40,70209.62753,3900.534863,1755.240688,258.703672,14,0
0,0,33,33,22,34,56,172,140,312,0.000333,0.603965,44,79723.36837,4429.076021,1811.894736,271.081232,14,0
0,0,34,34,22,34,56,178,143,321,0.000333,0.621387,44,82023.08092,4556.837829,1864.16093,271.081232,14,0
0,0,33,33,22,33,55,173,139,312,0.000333,0.601261,44,79366.50615,4409.250342,1803.784231,264.572502,14,0
0,0,33,33,22,33,55,173,139,312,0.000333,0.601261,44,79366.50615,4409.250342,1803.784231,264.572502,14,0
0,0,42,42,24,51,75,234,189,423,0.000333,0.878263,36,94852.45102,5269.580612,2634.790306,399.332792,20,0
0,0,33,33,22,34,56,174,140,314,0.000333,0.607836,44,80234.4156,4457.467534,1823.509446,271.081232,14,0
0,0,42,42,24,51,75,234,189,423,0.000333,0.878263,36,94852.45102,5269.580612,2634.790306,399.332792,20,0
0,0,33,33,22,33,55,174,140,314,0.000333,0.605116,44,79875.2658,4437.514767,1815.34695,264.572502,14,0
0,0,34,34,22,34,56,178,143,321,0.000333,0.621387,44,82023.08092,4556.837829,1864.16093,271.081232,14,0
0,0,33,33,22,33,55,171,139,310,0.000333,0.597407,44,78857.74649,4380.985916,1792.221511,264.572502,14,0
0,0,32,32,20,32,52,166,135,301,0.000333,0.571944,40,68633.29421,3812.960789,1715.832355,246.438562,14,0
0,0,32,32,20,32,52,166,135,301,0.000333,0.571944,40,68633.29421,3812.960789,1715.832355,246.438562,14,0
0,0,41,41,23,50,73,227,185,412,0.000333,0.850069,33,84156.8547,4675.380817,2550.207718,386.234734,20,0
0,0,4,4,9,11,20,35,23,58,0.000333,0.083557,8,2005.374636,111.409702,250.67183,66.583073,1,0
0,0,23,23,17,22,39,104,81,185,0.000333,0.325933,24,23467.18585,1303.732547,977.79941,167.594364,11,0
0,0,75,75,25,44,69,366,279,645,0.000333,1.313333,72,283679.8758,15759.9931,3939.998275,356.311396,31,0
0,0,61,61,22,42,64,310,236,546,0.000333,1.092,55,180180,10010,3276,324.584827,25,0
0,0,59,59,22,42,64,297,225,522,0.000333,1.044,55,172260,9570,3132,324.584827,25,0
0,0,48,48,24,40,64,250,198,448,0.000333,0.896,48,129024,7168,2688,322.916224,22,0
0,0,27,27,19,29,48,155,125,280,0.000333,0.521263,36,56296.42201,3127.579,1563.7895,221.592072,13,0
0,0,29,29,19,30,49,160,127,287,0.000333,0.537141,36,58011.18211,3222.843451,1611.421725,227.917341,14,0
0,0,32,32,19,35,54,179,147,326,0.000333,0.625364,36,67539.35973,3752.186651,1876.093326,260.235528,16,0
0,0,41,41,26,42,68,261,208,469,0.000333,0.951673,52,148461.0438,8247.835765,2855.020073,348.688764,34,0
0,0,26,26,16,36,52,197,152,349,0.000333,0.663151,32,63662.51077,3536.806154,1989.453462,250.1173,6,0
0,0,23,23,17,37,54,209,155,364,0.000333,0.69826,32,67032.92963,3724.051646,2094.779051,262.236643,5,0
0,0,24,24,15,28,43,115,92,207,0.000333,0.374412,21,23587.97289,1310.442938,1123.236804,193.209297,6,0
0,0,22,22,15,27,42,110,86,196,0.000333,0.352298,21,22194.77851,1233.043251,1056.894215,186.985321,6,0
0,0,21,21,15,27,42,109,84,193,0.000333,0.346906,21,21855.06252,1214.17014,1040.717263,186.985321,6,0
0,0,19,19,15,25,40,107,79,186,0.000333,0.32996,21,20787.45114,1154.858397,989.878626,174.699764,6,0
0,0,22,22,20,31,51,125,94,219,0.000333,0.414087,30,37267.8345,2070.43525,1242.26115,240.018648,8,0
0,0,24,24,21,31,52,135,100,235,0.000333,0.446534,30,40188.10001,2232.672223,1339.603334,245.818752,9,0
0,0,34,34,23,50,73,264,154,418,0.000333,0.862449,33,85382.43997,4743.468887,2587.346666,386.234734,20,0
0,0,27,27,20,33,53,150,99,249,0.000333,0.475417,30,42787.5658,2377.086989,1426.252193,252.903568,9,0
0,0,77,77,29,53,82,503,314,817,0.000333,1.731373,70,363588.3991,20199.35551,5194.119988,444.461233,30,0
0,0,55,55,28,49,77,354,228,582,0.000333,1.215757,56,204247.1069,11347.0615,3647.269767,409.72672,20,0
0,0,41,41,22,40,62,274,172,446,0.000333,0.885191,44,116845.1484,6491.397133,2655.571554,310.984619,16,0
0,0,36,36,25,53,78,274,162,436,0.000333,0.913478,36,98655.67323,5480.870735,2740.435367,419.676189,21,0
0,0,18,18,15,25,40,103,57,160,0.000333,0.283836,14,11921.11893,662.284385,851.508495,174.699764,7,0
0,0,18,18,15,25,40,104,57,161,0.000333,0.28561,14,11995.62593,666.423663,856.830423,174.699764,7,0
0,0,42,42,24,77,101,267,208,475,0.000333,1.054217,24,75903.6109,4216.867272,3162.650454,592.581664,27,0
0,0,48,48,24,57,81,203,157,360,0.000333,0.760782,24,54776.30403,3043.128001,2282.346001,442.513831,25,0
0,0,48,48,27,67,94,276,199,475,0.000333,1.03781,26,80949.17232,4497.17624,3113.429705,534.809938,23,0
0,0,42,42,28,66,94,253,178,431,0.000333,0.941676,28,79100.77826,4394.487681,2825.027795,533.53595,20,0
0,0,44,44,28,67,95,258,184,442,0.000333,0.967959,28,81308.53301,4517.140723,2903.876179,541.033914,20,0
0,0,37,37,26,61,87,280,178,458,0.000333,0.983623,26,76722.57115,4262.365064,2950.868121,483.98641,12,0
0,0,87,87,29,88,117,475,334,809,0.000333,1.852708,42,233441.2524,12968.95847,5558.125058,709.311431,52,0
0,0,8,8,16,14,30,52,34,86,0.000333,0.140664,16,6751.88146,375.104526,421.992591,117.302969,2,0
0,0,60,60,30,44,74,357,208,565,0.000333,1.169447,60,210500.4691,11694.47051,3508.341152,387.421709,42,0
0,0,30,30,27,45,72,191,122,313,0.000333,0.643729,26,50210.84966,2789.491648,1931.186525,375.515352,28,0
0,0,18,18,20,26,46,113,92,205,0.000333,0.377443,30,33969.90603,1887.217002,1132.330201,208.649995,8,0
0,0,10,10,15,14,29,47,38,85,0.000333,0.137643,14,5780.997384,321.166521,412.928385,111.906328,3,0
0,0,80,80,27,80,107,504,409,913,0.000333,2.051653,65,400072.3583,22226.24213,6154.959359,634.13621,60,0
0,0,80,80,28,83,111,511,410,921,0.000333,2.085886,56,350428.7927,19468.26626,6257.657013,663.734211,58,0
0,0,58,58,31,50,81,285,233,518,0.000333,1.094681,60,197042.5381,10946.80767,3284.042301,435.772895,33,0
0,0,53,53,29,46,75,290,236,526,0.000333,1.09212,70,229345.1042,12741.39468,3276.358631,394.965299,36,0
0,0,45,45,29,41,70,224,187,411,0.000333,0.839712,56,141071.5779,7837.309884,2519.13532,360.541081,27,0
0,0,44,44,28,41,69,224,187,411,0.000333,0.836868,56,140593.7989,7810.766605,2510.603552,354.26557,28,0
0,0,54,54,28,54,82,328,269,597,0.000333,1.265153,56,212545.6786,11808.09326,3795.458547,445.369863,37,0
0,0,63,63,28,58,86,399,323,722,0.000333,1.546588,70,324783.4207,18043.52337,4639.763153,474.368836,44,0
0,0,26,26,21,18,39,150,64,214,0.000333,0.377025,30,33932.28225,1885.126791,1131.076075,167.297316,21,0
0,0,22,22,20,17,37,134,53,187,0.000333,0.324723,30,29225.03338,1623.612966,974.167779,155.92543,15,0
0,0,30,30,20,21,41,143,75,218,0.000333,0.389315,30,35038.39011,1946.577228,1167.946337,178.677228,14,0
0,0,57,57,31,46,77,409,237,646,0.000333,1.349448,75,303625.8079,16868.10044,4048.344105,407.663936,35,0
0,0,35,35,30,42,72,236,170,406,0.000333,0.834997,60,150299.373,8349.965169,2504.989551,373.68405,21,0
0,0,41,41,31,44,75,283,199,482,0.000333,1.000764,60,180137.4365,10007.63536,3002.290609,393.795077,25,0
0,0,27,27,19,44,63,137,87,224,0.000333,0.446304,9,12050.19633,669.455351,1338.910703,320.925614,9,0
0,0,12,12,14,20,34,63,39,102,0.000333,0.172974,7,3632.448469,201.802693,518.92121,139.741531,9,0
0,0,22,22,14,20,34,97,67,164,0.000333,0.278115,21,17521.22203,973.401224,834.343906,139.741531,7,0
0,0,37,37,26,40,66,243,146,389,0.000333,0.783756,39,91699.50319,5094.416844,2351.269312,335.088556,18,0
0,0,22,22,14,20,34,97,67,164,0.000333,0.278115,21,17521.22203,973.401224,834.343906,139.741531,7,0
0,0,37,37,26,40,66,243,146,389,0.000333,0.783756,39,91699.50319,5094.416844,2351.269312,335.088556,18,0
0,0,19,19,23,44,67,199,104,303,0.000333,0.612675,22,40436.55054,2246.47503,1838.025025,344.256916,6,0
0,0,27,27,27,49,76,278,141,419,0.000333,0.872627,26,68064.92233,3781.384574,2617.881628,403.502745,8,0
0,0,24,24,19,34,53,142,94,236,0.000333,0.450596,18,24332.20609,1351.789227,1351.789227,253.684359,8,0
0,0,16,16,13,27,40,63,57,120,0.000333,0.212877,12,7663.576457,425.754248,638.631371,176.487679,6,0
0,0,36,36,16,42,58,267,167,434,0.000333,0.847455,24,61016.73005,3389.818336,2542.363752,290.477332,4,0
0,0,35,35,16,42,58,263,165,428,0.000333,0.835739,24,60173.18078,3342.954488,2507.215866,290.477332,3,0
0,0,34,34,16,42,58,259,163,422,0.000333,0.824023,24,59329.63152,3296.09064,2472.06798,290.477332,2,0
0,0,17,17,14,34,48,126,80,206,0.000333,0.383501,14,16107.03185,894.835103,1150.502275,226.276706,1,0
0,0,28,28,27,55,82,268,148,416,0.000333,0.881581,26,68763.28248,3820.18236,2644.741634,446.356747,8,0
0,0,25,25,27,54,81,249,138,387,0.000333,0.817841,26,63791.57073,3543.976152,2453.521951,439.145888,8,0
0,0,22,22,27,54,81,241,131,372,0.000333,0.786141,26,61319.02923,3406.612735,2358.424201,439.145888,8,0
0,0,34,34,30,69,99,705,290,995,0.000333,2.198737,60,395772.5902,21987.36612,6596.209837,568.694905,18,0
0,0,34,34,30,69,99,705,290,995,0.000333,2.198737,60,395772.5902,21987.36612,6596.209837,568.694905,18,0
0,0,63,63,25,71,96,398,258,656,0.000333,1.439912,36,155510.4744,8639.470801,4319.7354,552.72845,24,0
0,0,19,19,23,35,58,121,87,208,0.000333,0.406153,22,26806.12103,1489.228946,1218.460047,283.566831,7,0
0,0,33,33,24,52,76,259,171,430,0.000333,0.895536,36,96717.91791,5373.217662,2686.608831,406.461965,11,0
0,0,78,78,31,94,125,563,354,917,0.000333,2.129208,45,287443.0885,15969.06047,6387.624189,769.711438,31,0
0,0,13,13,19,22,41,79,54,133,0.000333,0.237518,18,12825.9795,712.554417,712.554417,178.818118,6,0
0,0,23,23,23,37,60,146,103,249,0.000333,0.490272,22,32357.94668,1797.663705,1470.815758,296.7917,9,0
0,0,15,15,19,26,45,105,76,181,0.000333,0.331342,18,17892.45739,994.02541,994.02541,202.922055,6,0
0,0,92,92,22,65,87,507,304,811,0.000333,1.741742,44,229909.9957,12772.77754,5225.227175,489.561403,40,0
0,0,68,68,26,83,109,463,295,758,0.000333,1.710095,39,200081.065,11115.61472,5130.283718,651.339705,24,0
0,0,24,24,25,51,76,186,124,310,0.000333,0.645619,24,46484.5807,2582.476706,1936.857529,405.390097,7,0
0,0,38,38,25,65,90,324,208,532,0.000333,1.151222,36,124331.9705,6907.331694,3453.665847,507.550313,11,0
0,0,18,18,22,38,60,144,91,235,0.000333,0.462706,22,30538.62438,1696.590243,1388.11929,297.528741,6,0
0,0,28,28,25,53,78,211,140,351,0.000333,0.735392,24,52948.22829,2941.568238,2206.176179,419.676189,9,0
0,0,20,20,22,42,64,170,113,283,0.000333,0.566,22,37356,2075.333333,1698,324.584827,6,0
0,0,97,97,25,78,103,572,341,913,0.000333,2.034925,48,293029.1991,16279.39995,6104.774981,606.357778,40,0
0,0,65,65,26,83,109,456,289,745,0.000333,1.680766,39,196649.5956,10924.97753,5042.297322,651.339705,24,0
0,0,21,21,25,51,76,179,118,297,0.000333,0.618545,24,44535.22732,2474.179295,1855.634471,405.390097,7,0
0,0,35,35,25,65,90,317,202,519,0.000333,1.123091,36,121293.7833,6738.543514,3369.271757,507.550313,11,0
0,0,15,15,22,38,60,137,85,222,0.000333,0.43711,22,28849.25367,1602.736315,1311.329712,297.528741,6,0
0,0,25,25,25,53,78,204,134,338,0.000333,0.708155,24,50987.1828,2832.621267,2124.46595,419.676189,9,0
0,0,17,17,22,42,64,163,107,270,0.000333,0.54,22,35640,1980,1620,324.584827,6,0
0,0,94,94,25,78,103,565,335,900,0.000333,2.00595,48,288856.8228,16047.60127,6017.850474,606.357778,40,0
0,0,25,25,18,51,69,125,101,226,0.000333,0.460176,9,12424.73875,690.263264,1380.526527,364.352342,10,0
0,0,22,22,18,49,67,114,84,198,0.000333,0.400362,9,10809.77094,600.54283,1201.08566,350.179432,9,0
0,0,25,25,19,51,70,126,92,218,0.000333,0.445395,9,12025.65328,668.091849,1336.183698,370.004315,10,0
0,0,14,14,14,20,34,78,55,133,0.000333,0.225544,14,9472.85581,526.269767,676.632558,139.741531,1,0
0,0,14,14,14,19,33,80,56,136,0.000333,0.228679,14,9604.526403,533.5848,686.0376,134.013592,1,0
0,0,14,14,14,20,34,78,56,134,0.000333,0.22724,14,9544.08029,530.226683,681.720021,139.741531,1,0
0,0,14,14,14,19,33,73,50,123,0.000333,0.20682,14,8686.446674,482.580371,620.460477,134.013592,1,0
0,0,22,22,17,31,48,113,85,198,0.000333,0.368608,16,17693.1612,982.9534,1105.822575,223.066954,2,0
0,0,10,10,14,27,41,69,50,119,0.000333,0.212516,7,4462.84082,247.935601,637.548689,181.684931,2,0
0,0,9,9,12,18,30,46,41,87,0.000333,0.1423,12,5122.793782,284.599655,426.899482,118.0782,2,0
0,0,6,6,9,16,25,34,30,64,0.000333,0.099069,4,1188.827185,66.045955,297.206796,92.529325,1,0
0,0,6,6,9,15,24,36,31,67,0.000333,0.102397,8,2457.5399,136.529994,307.192488,87.132684,1,0
0,0,45,45,30,43,73,240,181,421,0.000333,0.868639,60,156354.9684,8686.387131,2605.916139,380.536102,9,0
0,0,12,12,14,27,41,73,55,128,0.000333,0.228589,14,9600.733192,533.374066,685.766657,181.684931,2,0
0,0,11,11,14,18,32,50,46,96,0.000333,0.16,14,6720,373.333333,480,128.361619,2,0
0,0,8,8,11,16,27,38,35,73,0.000333,0.115702,10,3471.067877,192.837104,347.106788,102.053748,1,0
0,0,8,8,11,15,26,40,36,76,0.000333,0.119078,10,3572.334186,198.46301,357.233419,96.657107,1,0
0,0,7,7,12,11,23,44,38,82,0.000333,0.123644,18,6676.777447,370.93208,370.93208,81.073298,3,0
0,0,46,46,25,34,59,340,265,605,0.000333,1.186333,84,298955.9198,16608.66221,3558.999045,289.070141,20,0
0,0,20,20,17,28,45,132,86,218,0.000333,0.399075,24,28733.3754,1596.298633,1197.223975,204.092806,8,0
0,0,22,22,18,28,46,141,91,232,0.000333,0.427155,27,34599.59209,1922.199561,1281.466374,209.664588,9,0
0,0,30,30,23,33,56,175,134,309,0.000333,0.598158,44,78956.79752,4386.488751,1794.472671,270.506931,4,0
0,0,48,48,34,48,82,378,322,700,0.000333,1.483429,102,453929.2131,25218.28962,4450.286403,441.051937,37,0
0,0,50,50,34,50,84,401,338,739,0.000333,1.574641,102,481840.1027,26768.89459,4723.922575,455.166546,42,0
0,0,45,45,33,45,78,354,302,656,0.000333,1.374408,96,395829.4901,21990.52723,4123.223856,413.598395,33,0
0,0,47,47,33,48,81,377,318,695,0.000333,1.468732,96,422994.7922,23499.71068,4406.195752,434.543206,38,0
0,0,53,53,36,77,113,475,339,814,0.000333,1.850542,72,399717.0486,22206.5027,5551.625675,668.659864,53,0
0,0,63,63,33,66,99,551,441,992,0.000333,2.192107,96,631326.8896,35073.71609,6576.321767,565.395018,39,0
0,0,39,39,30,64,94,482,375,857,0.000333,1.872428,75,421296.1984,23405.34436,5617.282646,531.206718,38,0
0,0,11,11,18,30,48,168,116,284,0.000333,0.52871,27,42825.49246,2379.194025,1586.12935,222.265368,5,0
0,0,18,18,15,25,40,103,57,160,0.000333,0.283836,14,11921.11893,662.284385,851.508495,174.699764,7,0
0,0,18,18,15,25,40,104,57,161,0.000333,0.28561,14,11995.62593,666.423663,856.830423,174.699764,7,0
0,0,62,62,30,39,69,447,277,724,0.000333,1.474191,105,464370.0292,25798.33496,4422.571707,353.337404,39,0
0,0,37,37,29,44,73,272,177,449,0.000333,0.92641,56,155636.9487,8646.49715,2779.231227,381.09644,14,0
0,0,21,21,20,25,45,100,81,181,0.000333,0.331342,30,29820.76231,1656.709017,994.02541,202.534967,13,0
0,0,46,46,28,39,67,413,205,618,0.000333,1.249614,70,262419.0184,14578.83435,3748.84312,340.736624,13,0
0,0,78,78,29,59,88,472,312,784,0.000333,1.688065,70,354493.6072,19694.08929,5064.194389,487.957389,31,0
0,0,71,71,29,53,82,426,282,708,0.000333,1.500382,70,315080.2773,17504.45985,4501.146819,444.461233,30,0
0,0,67,67,29,55,84,408,271,679,0.000333,1.446795,56,243061.4777,13503.41543,4340.38353,458.856233,27,0
0,0,60,60,29,49,78,362,241,603,0.000333,1.263366,56,212245.4621,11791.41456,3790.097538,416.002231,26,0
0,0,63,63,28,54,82,388,254,642,0.000333,1.360516,56,228566.7097,12698.15054,4081.548387,445.369863,27,0
0,0,63,63,28,53,81,392,256,648,0.000333,1.369408,56,230060.4769,12781.13761,4108.222802,438.185722,27,0
0,0,54,54,26,45,71,315,201,516,0.000333,1.057757,52,165010.0147,9167.223039,3173.269514,369.344822,25,0
0,0,26,26,23,29,52,167,114,281,0.000333,0.533941,33,52860.17751,2936.676528,1601.823561,244.923374,10,0
0,0,28,28,23,29,52,175,120,295,0.000333,0.560543,44,73991.70754,4110.650419,1681.629717,244.923374,10,0
0,0,11,11,21,26,47,92,56,148,0.000333,0.274026,20,16441.583,913.421278,822.07915,214.450099,6,0
0,0,11,11,21,26,47,92,56,148,0.000333,0.274026,20,16441.583,913.421278,822.07915,214.450099,6,0
0,0,26,26,23,41,64,167,110,277,0.000333,0.554,22,36564,2031.333333,1662,323.701557,12,0
0,0,34,34,23,46,69,271,153,424,0.000333,0.863338,33,85470.4742,4748.359678,2590.01437,358.125775,20,0
0,0,13,13,19,15,34,77,46,123,0.000333,0.208586,27,16895.4641,938.636894,625.757929,139.313982,5,0
0,0,12,12,14,20,34,63,39,102,0.000333,0.172974,7,3632.448469,201.802693,518.92121,139.741531,9,0
0,0,22,22,23,20,43,109,76,185,0.000333,0.33462,33,33127.34633,1840.408129,1003.85898,190.480487,7,0
0,0,22,22,30,20,50,167,100,267,0.000333,0.502303,75,113018.2202,6278.790011,1506.909603,233.64528,15,0
0,0,10,10,16,14,30,47,33,80,0.000333,0.13085,16,6280.819962,348.934442,392.551248,117.302969,3,0
0,0,22,22,22,35,57,151,80,231,0.000333,0.449133,22,29642.74705,1646.819281,1347.397593,277.632401,10,0
0,0,77,77,37,106,143,544,420,964,0.000333,2.300705,54,372714.2623,20706.34791,6902.115969,905.909343,28,0
0,0,18,18,15,25,40,103,57,160,0.000333,0.283836,14,11921.11893,662.284385,851.508495,174.699764,7,0
0,0,18,18,15,25,40,104,57,161,0.000333,0.28561,14,11995.62593,666.423663,856.830423,174.699764,7,0
0,0,13,13,19,15,34,77,46,123,0.000333,0.208586,27,16895.4641,938.636894,625.757929,139.313982,5,0
0,0,48,48,29,66,95,285,181,466,0.000333,1.020518,28,85723.47598,4762.415332,3061.552713,539.811461,21,0
0,0,30,30,21,43,64,157,104,261,0.000333,0.522,20,31320,1740,1566,325.56805,16,0
0,0,30,30,21,43,64,160,108,268,0.000333,0.536,20,32160,1786.666667,1608,325.56805,20,0
0,0,56,56,27,60,87,372,227,599,0.000333,1.286441,39,150513.603,8361.866834,3859.323154,482.795398,13,0
0,0,60,60,27,60,87,404,247,651,0.000333,1.398119,52,218106.5232,12117.02907,4194.356216,482.795398,14,0
0,0,55,55,27,57,84,390,229,619,0.000333,1.318948,52,205755.9132,11430.88407,3956.844485,460.856693,15,0
0,0,59,59,26,57,83,422,249,671,0.000333,1.425884,52,222437.8758,12357.65977,4277.651458,454.686163,16,0
0,0,13,13,13,19,32,70,40,110,0.000333,0.183333,12,6600,366.666667,550,128.816339,4,0
0,0,11,11,17,21,38,55,40,95,0.000333,0.166184,8,3988.42491,221.579162,498.553114,161.725534,7,0
0,0,29,29,23,23,46,127,80,207,0.000333,0.381126,33,37731.45172,2096.191762,1143.377325,208.08385,13,0
0,0,10,10,16,20,36,52,41,93,0.000333,0.160268,16,7692.848402,427.380467,480.803025,150.438562,4,0
0,0,10,10,16,21,37,53,43,96,0.000333,0.166703,16,8001.72037,444.540021,500.107523,156.238666,4,0
0,0,10,10,16,19,35,51,39,90,0.000333,0.153878,16,7386.167544,410.342641,461.635472,144.710623,4,0
0,0,10,10,15,21,36,55,45,100,0.000333,0.172331,14,7237.895002,402.105278,516.9925,150.842025,4,0
0,0,13,13,21,24,45,69,56,125,0.000333,0.228827,20,13729.63274,762.757374,686.481637,202.277766,5,0
0,0,13,13,21,23,44,68,54,122,0.000333,0.222017,20,13321.01315,740.056286,666.050657,196.280591,5,0
0,0,13,13,21,25,46,70,58,128,0.000333,0.235672,20,14140.31861,785.573256,707.01593,208.335071,5,0
0,0,13,13,21,23,44,68,55,123,0.000333,0.223837,20,13430.20178,746.122321,671.510089,196.280591,5,0
0,0,13,13,21,25,46,72,60,132,0.000333,0.243037,20,14582.20356,810.12242,729.110178,208.335071,5,0
0,0,48,48,32,35,67,215,133,348,0.000333,0.703666,48,101327.9538,5629.330769,2110.999038,339.524906,17,0
0,0,44,44,29,44,73,206,151,357,0.000333,0.736589,42,92810.22944,5156.123858,2209.767368,381.09644,14,0
0,0,49,49,29,48,77,237,168,405,0.000333,0.846016,42,106598.0391,5922.113281,2538.048549,408.959649,16,0
0,0,37,37,30,38,68,176,117,293,0.000333,0.594542,45,80263.19756,4459.066531,1783.626612,346.627963,12,0
0,0,37,37,30,40,70,186,123,309,0.000333,0.631316,45,85227.68035,4734.871131,1893.948452,360.083842,12,0
0,0,49,49,29,45,74,227,162,389,0.000333,0.805159,42,101450.0491,5636.113838,2415.477359,388.014838,16,0
0,0,15,15,20,26,46,100,68,168,0.000333,0.309319,20,18559.16817,1031.064898,927.958409,208.649995,7,0
0,0,12,12,14,20,34,63,39,102,0.000333,0.172974,7,3632.448469,201.802693,518.92121,139.741531,9,0
0,0,34,34,23,50,73,190,128,318,0.000333,0.656121,22,43304.01261,2405.778479,1968.36421,386.234734,22,0
0,0,44,44,28,60,88,255,161,416,0.000333,0.895708,28,75239.45949,4179.969972,2687.123553,489.019374,19,0
0,0,30,30,21,43,64,157,104,261,0.000333,0.522,20,31320,1740,1566,325.56805,16,0
0,0,56,56,27,60,87,372,227,599,0.000333,1.286441,39,150513.603,8361.866834,3859.323154,482.795398,13,0
0,0,60,60,27,60,87,404,247,651,0.000333,1.398119,52,218106.5232,12117.02907,4194.356216,482.795398,14,0
0,0,55,55,27,57,84,390,229,619,0.000333,1.318948,52,205755.9132,11430.88407,3956.844485,460.856693,15,0
0,0,59,59,26,57,83,422,249,671,0.000333,1.425884,52,222437.8758,12357.65977,4277.651458,454.686163,16,0
0,0,13,13,13,19,32,70,40,110,0.000333,0.183333,12,6600,366.666667,550,128.816339,4,0
0,0,11,11,17,21,38,55,40,95,0.000333,0.166184,8,3988.42491,221.579162,498.553114,161.725534,7,0
0,0,18,18,15,25,40,103,57,160,0.000333,0.283836,14,11921.11893,662.284385,851.508495,174.699764,7,0
0,0,18,18,15,25,40,104,57,161,0.000333,0.28561,14,11995.62593,666.423663,856.830423,174.699764,7,0
0,0,29,29,22,47,69,314,169,483,0.000333,0.983472,33,97363.77132,5409.098406,2950.417313,359.173172,6,0
0,0,29,29,22,47,69,314,169,483,0.000333,0.983472,33,97363.77132,5409.098406,2950.417313,359.173172,6,0
0,0,28,28,22,48,70,308,167,475,0.000333,0.97047,33,96076.51129,5337.583961,2911.409433,366.185696,6,0
0,0,28,28,22,48,70,308,167,475,0.000333,0.97047,33,96076.51129,5337.583961,2911.409433,366.185696,6,0
0,0,18,18,15,25,40,103,57,160,0.000333,0.283836,14,11921.11893,662.284385,851.508495,174.699764,7,0
0,0,18,18,15,25,40,104,57,161,0.000333,0.28561,14,11995.62593,666.423663,856.830423,174.699764,7,0
0,0,77,77,29,53,82,503,314,817,0.000333,1.731373,70,363588.3991,20199.35551,5194.119988,444.461233,30,0
0,0,55,55,28,49,77,354,228,582,0.000333,1.215757,56,204247.1069,11347.0615,3647.269767,409.72672,20,0
0,0,41,41,22,40,62,274,172,446,0.000333,0.885191,44,116845.1484,6491.397133,2655.571554,310.984619,16,0
0,0,18,18,15,25,40,103,57,160,0.000333,0.283836,14,11921.11893,662.284385,851.508495,174.699764,7,0
0,0,18,18,15,25,40,104,57,161,0.000333,0.28561,14,11995.62593,666.423663,856.830423,174.699764,7,0
0,0,25,25,19,49,68,121,87,208,0.000333,0.422064,9,11395.73044,633.096135,1266.192271,355.831405,10,0
0,0,25,25,20,50,70,126,88,214,0.000333,0.437222,10,13116.66566,728.703648,1311.666566,368.631371,10,0
0,0,23,23,18,50,68,117,85,202,0.000333,0.409889,9,11067.00745,614.833747,1229.667494,357.25146,10,0
0,0,23,23,18,50,68,117,85,202,0.000333,0.409889,9,11067.00745,614.833747,1229.667494,357.25146,10,0
0,0,23,23,19,49,68,117,84,201,0.000333,0.40786,9,11012.22028,611.790016,1223.580031,355.831405,10,0
0,0,23,23,18,48,66,117,84,201,0.000333,0.404974,9,10934.30896,607.461609,1214.923218,343.13685,10,0
0,0,24,24,21,49,70,123,90,213,0.000333,0.435179,10,13055.37283,725.29849,1305.537283,367.359448,10,0
0,0,18,18,15,26,41,86,54,140,0.000333,0.250019,14,10500.80193,583.377885,750.057281,180.814792,10,0
0,0,18,18,13,30,43,99,79,178,0.000333,0.321958,12,11590.50152,643.916751,965.875126,195.312434,5,0
0,0,18,18,13,30,43,99,79,178,0.000333,0.321958,12,11590.50152,643.916751,965.875126,195.312434,5,0
0,0,8,8,16,14,30,51,34,85,0.000333,0.139029,16,6673.37121,370.742845,417.085701,117.302969,2,0
0,0,26,26,21,23,44,115,72,187,0.000333,0.340305,30,30627.41138,1701.522854,1020.913713,196.280591,11,0
0,0,10,10,16,21,37,53,43,96,0.000333,0.166703,16,8001.72037,444.540021,500.107523,156.238666,4,0
0,0,10,10,16,20,36,52,41,93,0.000333,0.160268,16,7692.848402,427.380467,480.803025,150.438562,4,0
0,0,10,10,16,19,35,51,39,90,0.000333,0.153878,16,7386.167544,410.342641,461.635472,144.710623,4,0
0,0,13,13,17,21,38,67,53,120,0.000333,0.209917,16,10076.02083,559.778935,629.751302,161.725534,6,0
0,0,13,13,21,23,44,68,54,122,0.000333,0.222017,20,13321.01315,740.056286,666.050657,196.280591,5,0
0,0,13,13,21,25,46,70,58,128,0.000333,0.235672,20,14140.31861,785.573256,707.01593,208.335071,5,0
0,0,13,13,21,23,44,68,55,123,0.000333,0.223837,20,13430.20178,746.122321,671.510089,196.280591,5,0
0,0,13,13,21,24,45,69,56,125,0.000333,0.228827,20,13729.63274,762.757374,686.481637,202.277766,5,0
0,0,13,13,21,25,46,72,60,132,0.000333,0.243037,20,14582.20356,810.12242,729.110178,208.335071,5,0
0,0,44,44,29,44,73,206,151,357,0.000333,0.736589,42,92810.22944,5156.123858,2209.767368,381.09644,14,0
0,0,48,48,32,35,67,215,133,348,0.000333,0.703666,48,101327.9538,5629.330769,2110.999038,339.524906,17,0
0,0,37,37,30,38,68,176,117,293,0.000333,0.594542,45,80263.19756,4459.066531,1783.626612,346.627963,12,0
0,0,15,15,20,26,46,100,68,168,0.000333,0.309319,20,18559.16817,1031.064898,927.958409,208.649995,7,0
0,0,37,37,30,40,70,186,123,309,0.000333,0.631316,45,85227.68035,4734.871131,1893.948452,360.083842,12,0
0,0,49,49,29,48,77,237,168,405,0.000333,0.846016,42,106598.0391,5922.113281,2538.048549,408.959649,16,0
0,0,49,49,29,45,74,227,162,389,0.000333,0.805159,42,101450.0491,5636.113838,2415.477359,388.014838,16,0
0,0,57,57,31,46,77,409,237,646,0.000333,1.349448,75,303625.8079,16868.10044,4048.344105,407.663936,35,0
0,0,35,35,30,42,72,236,170,406,0.000333,0.834997,60,150299.373,8349.965169,2504.989551,373.68405,21,0
0,0,41,41,31,44,75,283,199,482,0.000333,1.000764,60,180137.4365,10007.63536,3002.290609,393.795077,25,0
0,0,8,8,16,14,30,51,34,85,0.000333,0.139029,16,6673.37121,370.742845,417.085701,117.302969,2,0
0,0,17,17,21,21,42,98,61,159,0.000333,0.285793,20,17147.5694,952.642745,857.37847,184.477332,5,0
0,0,17,17,21,21,42,98,61,159,0.000333,0.285793,20,17147.5694,952.642745,857.37847,184.477332,5,0
0,0,18,18,15,25,40,103,57,160,0.000333,0.283836,14,11921.11893,662.284385,851.508495,174.699764,7,0
0,0,18,18,15,25,40,104,57,161,0.000333,0.28561,14,11995.62593,666.423663,856.830423,174.699764,7,0
0,0,9,9,16,14,30,49,35,84,0.000333,0.137393,16,6594.86096,366.381164,412.17881,117.302969,3,0
0,0,42,42,24,77,101,267,208,475,0.000333,1.054217,24,75903.6109,4216.867272,3162.650454,592.581664,27,0
0,0,87,87,29,88,117,475,334,809,0.000333,1.852708,42,233441.2524,12968.95847,5558.125058,709.311431,52,0
0,0,24,24,18,50,68,123,90,213,0.000333,0.43221,9,11669.66627,648.314793,1296.629585,357.25146,9,0
0,0,25,25,19,51,70,126,92,218,0.000333,0.445395,9,12025.65328,668.091849,1336.183698,370.004315,10,0
0,0,22,22,18,49,67,114,84,198,0.000333,0.400362,9,10809.77094,600.54283,1201.08566,350.179432,9,0
0,0,23,23,19,50,69,117,85,202,0.000333,0.411307,9,11105.29746,616.96097,1233.92194,362.903432,10,0
0,0,24,24,21,50,71,123,91,214,0.000333,0.438682,10,13160.45884,731.136602,1316.045884,374.431475,10,0
0,0,23,23,18,49,67,117,85,202,0.000333,0.40845,9,11028.15015,612.675008,1225.350016,350.179432,10,0
0,0,17,17,15,25,40,79,51,130,0.000333,0.230617,14,9685.909133,538.106063,691.850652,174.699764,10,0
0,0,10,10,10,16,26,71,41,112,0.000333,0.175483,10,5264.492484,292.471805,526.449248,97.219281,3,0
0,0,10,10,10,16,26,67,41,108,0.000333,0.169216,10,5076.474896,282.026383,507.64749,97.219281,3,0
0,0,10,10,10,16,26,71,41,112,0.000333,0.175483,10,5264.492484,292.471805,526.449248,97.219281,3,0
0,0,10,10,10,16,26,67,41,108,0.000333,0.169216,10,5076.474896,282.026383,507.64749,97.219281,3,0
0,0,10,10,10,16,26,67,41,108,0.000333,0.169216,10,5076.474896,282.026383,507.64749,97.219281,3,0
0,0,10,10,10,16,26,67,41,108,0.000333,0.169216,10,5076.474896,282.026383,507.64749,97.219281,3,0
0,0,12,12,14,20,34,63,39,102,0.000333,0.172974,7,3632.448469,201.802693,518.92121,139.741531,9,0
0,0,27,27,18,33,51,140,86,226,0.000333,0.427323,18,23075.42629,1281.968127,1281.968127,241.523656,18,0
0,0,40,40,25,25,50,203,105,308,0.000333,0.579436,48,83438.76991,4635.487217,1738.307706,232.192809,28,0
0,0,12,12,14,20,34,63,39,102,0.000333,0.172974,7,3632.448469,201.802693,518.92121,139.741531,9,0
0,0,18,18,16,26,42,82,53,135,0.000333,0.242654,16,11647.40563,647.078091,727.962852,186.211433,16,0
0,0,50,50,34,50,84,401,338,739,0.000333,1.574641,102,481840.1027,26768.89459,4723.922575,455.166546,42,0
0,0,48,48,34,48,82,378,322,700,0.000333,1.483429,102,453929.2131,25218.28962,4450.286403,441.051937,37,0
0,0,47,47,33,48,81,377,318,695,0.000333,1.468732,96,422994.7922,23499.71068,4406.195752,434.543206,38,0
0,0,45,45,33,45,78,354,302,656,0.000333,1.374408,96,395829.4901,21990.52723,4123.223856,413.598395,33,0
0,0,53,53,36,77,113,475,339,814,0.000333,1.850542,72,399717.0486,22206.5027,5551.625675,668.659864,53,0
0,0,37,37,30,62,92,459,359,818,0.000333,1.778758,75,400220.526,22234.47367,5336.27368,516.366889,33,0
0,0,11,11,18,30,48,168,116,284,0.000333,0.52871,27,42825.49246,2379.194025,1586.12935,222.265368,5,0
0,0,12,12,16,24,40,62,40,102,0.000333,0.180946,8,4342.693325,241.26074,542.836666,174.0391,10,0
0,0,77,77,37,106,143,544,420,964,0.000333,2.300705,54,372714.2623,20706.34791,6902.115969,905.909343,28,0
0,0,21,21,20,25,45,100,81,181,0.000333,0.331342,30,29820.76231,1656.709017,994.02541,202.534967,13,0
0,0,18,18,15,25,40,103,57,160,0.000333,0.283836,14,11921.11893,662.284385,851.508495,174.699764,7,0
0,0,18,18,15,25,40,104,57,161,0.000333,0.28561,14,11995.62593,666.423663,856.830423,174.699764,7,0
0,0,23,23,18,48,66,118,84,202,0.000333,0.406989,9,10988.70851,610.483806,1220.967612,343.13685,10,0
0,0,20,20,17,46,63,113,81,194,0.000333,0.386531,8,9276.738441,515.374358,1159.592305,323.570718,9,0
0,0,22,22,18,48,66,115,83,198,0.000333,0.39893,9,10771.11032,598.395018,1196.790036,343.13685,9,0
0,0,25,25,20,51,71,127,99,226,0.000333,0.463281,10,13898.42849,772.134916,1389.842849,375.732254,9,0
0,0,13,13,17,17,34,82,47,129,0.000333,0.218761,16,10500.5233,583.362406,656.282707,138.973737,2,0
0,0,41,41,30,58,88,291,187,478,0.000333,1.029203,45,138942.3741,7719.020784,3087.608314,486.969616,21,0
0,0,83,83,25,84,109,499,324,823,0.000333,1.856739,36,200527.7652,11140.4314,5570.215699,653.051068,28,0
0,0,57,57,25,63,88,362,228,590,0.000333,1.270355,36,137198.3276,7622.12931,3811.064655,492.66504,14,0
0,0,22,22,23,20,43,109,76,185,0.000333,0.33462,33,33127.34633,1840.408129,1003.85898,190.480487,7,0
0,0,22,22,30,20,50,167,100,267,0.000333,0.502303,75,113018.2202,6278.790011,1506.909603,233.64528,15,0
0,0,10,10,16,14,30,47,33,80,0.000333,0.13085,16,6280.819962,348.934442,392.551248,117.302969,3,0
0,0,29,29,22,47,69,314,169,483,0.000333,0.983472,33,97363.77132,5409.098406,2950.417313,359.173172,6,0
0,0,29,29,22,47,69,314,169,483,0.000333,0.983472,33,97363.77132,5409.098406,2950.417313,359.173172,6,0
0,0,28,28,22,48,70,308,167,475,0.000333,0.97047,33,96076.51129,5337.583961,2911.409433,366.185696,6,0
0,0,28,28,22,48,70,308,167,475,0.000333,0.97047,33,96076.51129,5337.583961,2911.409433,366.185696,6,0
0,0,27,27,20,33,53,150,99,249,0.000333,0.475417,30,42787.5658,2377.086989,1426.252193,252.903568,9,0
0,0,9,9,16,14,30,49,35,84,0.000333,0.137393,16,6594.86096,366.381164,412.17881,117.302969,3,0
0,0,13,13,19,15,34,77,46,123,0.000333,0.208586,27,16895.4641,938.636894,625.757929,139.313982,5,0
0,0,27,27,20,46,66,242,139,381,0.000333,0.767638,30,69087.42478,3838.190266,2302.914159,340.522412,20,0
0,0,18,18,15,25,40,103,57,160,0.000333,0.283836,14,11921.11893,662.284385,851.508495,174.699764,7,0
0,0,18,18,15,25,40,104,57,161,0.000333,0.28561,14,11995.62593,666.423663,856.830423,174.699764,7,0
0,0,9,9,16,14,30,49,35,84,0.000333,0.137393,16,6594.86096,366.381164,412.17881,117.302969,3,0
0,0,29,29,25,35,60,145,116,261,0.000333,0.513899,36,55501.14404,3083.396891,1541.698445,295.62131,14,0
0,0,52,52,24,51,75,258,205,463,0.000333,0.961314,48,138429.2666,7690.51481,2883.943054,399.332792,31,0
0,0,51,51,22,51,73,246,201,447,0.000333,0.922284,33,91306.10207,5072.561226,2766.851578,387.401188,29,0
0,0,59,59,27,51,78,267,217,484,0.000333,1.014045,52,158191.003,8788.389058,3042.134674,417.675655,31,0
0,0,67,67,26,60,86,365,283,648,0.000333,1.388073,52,216539.4172,12029.96762,4164.219561,476.624868,39,0
0,0,66,66,25,60,85,353,279,632,0.000333,1.350245,48,194435.2834,10801.96019,4050.735072,470.50984,37,0
0,0,74,74,30,60,90,374,295,669,0.000333,1.447683,60,260582.9833,14476.83241,4343.049721,501.620154,39,0
0,0,71,71,25,65,90,394,304,698,0.000333,1.510438,48,217503.0461,12083.50256,4531.313461,507.550313,44,0
0,0,70,70,24,65,89,382,300,682,0.000333,1.47215,48,211989.6096,11777.20053,4416.4502,501.493008,42,0
0,0,78,78,29,65,94,403,316,719,0.000333,1.570916,56,263913.9655,14661.88697,4712.749384,532.335357,44,0
0,0,80,80,32,60,92,409,303,712,0.000333,1.548259,80,371582.089,20643.44939,4644.776113,514.413436,29,0
0,0,78,78,33,71,104,433,322,755,0.000333,1.686277,64,323765.2472,17986.95818,5058.831987,603.097051,29,0
0,0,79,79,33,71,104,438,326,764,0.000333,1.706379,64,327624.7005,18201.37225,5119.135945,603.097051,29,0
0,0,58,58,22,45,67,345,242,587,0.000333,1.186931,55,195843.6895,10880.20497,3560.794355,345.240885,26,0
0,0,32,32,19,31,50,155,125,280,0.000333,0.52676,36,56890.07039,3160.559466,1580.279733,234.290708,21,0
0,0,25,25,16,25,41,116,96,212,0.000333,0.3786,24,27259.2246,1514.401367,1135.801025,180.096405,15,0
0,0,25,25,16,26,42,115,93,208,0.000333,0.373867,24,26918.44858,1495.469365,1121.602024,186.211433,14,0
0,0,42,42,21,36,57,195,156,351,0.000333,0.682448,40,81893.7758,4549.654211,2047.344395,278.355966,23,0
0,0,79,79,24,55,79,455,318,773,0.000333,1.624274,60,292369.3511,16242.74173,4872.822518,428.013884,31,0
0,0,12,12,14,20,34,63,39,102,0.000333,0.172974,7,3632.448469,201.802693,518.92121,139.741531,9,0
0,0,9,9,16,14,30,49,35,84,0.000333,0.137393,16,6594.86096,366.381164,412.17881,117.302969,3,0
0,0,77,77,29,53,82,503,314,817,0.000333,1.731373,70,363588.3991,20199.35551,5194.119988,444.461233,30,0
0,0,55,55,28,49,77,354,228,582,0.000333,1.215757,56,204247.1069,11347.0615,3647.269767,409.72672,20,0
0,0,41,41,22,40,62,274,172,446,0.000333,0.885191,44,116845.1484,6491.397133,2655.571554,310.984619,16,0
0,0,9,9,16,14,30,49,35,84,0.000333,0.137393,16,6594.86096,366.381164,412.17881,117.302969,3,0
0,0,8,8,16,14,30,51,34,85,0.000333,0.139029,16,6673.37121,370.742845,417.085701,117.302969,2,0
0,0,18,18,15,25,40,103,57,160,0.000333,0.283836,14,11921.11893,662.284385,851.508495,174.699764,7,0
0,0,18,18,15,25,40,104,57,161,0.000333,0.28561,14,11995.62593,666.423663,856.830423,174.699764,7,0
0,0,8,8,16,14,30,52,34,86,0.000333,0.140664,16,6751.88146,375.104526,421.992591,117.302969,2,0
0,0,34,34,27,48,75,203,130,333,0.000333,0.691399,26,53929.11222,2996.06179,2074.196624,396.460163,33,0
0,0,60,60,30,44,74,357,208,565,0.000333,1.169447,60,210500.4691,11694.47051,3508.341152,387.421709,42,0
0,0,18,18,20,26,46,113,92,205,0.000333,0.377443,30,33969.90603,1887.217002,1132.330201,208.649995,8,0
0,0,10,10,15,14,29,47,38,85,0.000333,0.137643,14,5780.997384,321.166521,412.928385,111.906328,3,0
0,0,79,79,27,80,107,500,408,908,0.000333,2.040417,65,397881.3815,22104.5212,6121.252024,634.13621,59,0
0,0,79,79,28,83,111,507,409,916,0.000333,2.074562,56,348526.3563,19362.57535,6223.684934,663.734211,57,0
0,0,58,58,31,50,81,285,233,518,0.000333,1.094681,60,197042.5381,10946.80767,3284.042301,435.772895,33,0
0,0,53,53,29,46,75,290,236,526,0.000333,1.09212,70,229345.1042,12741.39468,3276.358631,394.965299,36,0
0,0,44,44,28,41,69,224,187,411,0.000333,0.836868,56,140593.7989,7810.766605,2510.603552,354.26557,28,0
0,0,45,45,29,41,70,224,187,411,0.000333,0.839712,56,141071.5779,7837.309884,2519.13532,360.541081,27,0
0,0,54,54,28,54,82,328,269,597,0.000333,1.265153,56,212545.6786,11808.09326,3795.458547,445.369863,37,0
0,0,74,74,29,63,92,467,368,835,0.000333,1.815725,70,381302.1963,21183.45535,5447.174233,517.450084,49,0
0,0,26,26,21,18,39,150,64,214,0.000333,0.377025,30,33932.28225,1885.126791,1131.076075,167.297316,21,0
0,0,22,22,20,17,37,134,53,187,0.000333,0.324723,30,29225.03338,1623.612966,974.167779,155.92543,15,0
0,0,30,30,20,21,41,143,75,218,0.000333,0.389315,30,35038.39011,1946.577228,1167.946337,178.677228,14,0
0,0,29,29,21,48,69,145,106,251,0.000333,0.51108,20,30664.79277,1703.599599,1533.239639,360.316866,9,0
0,0,27,27,20,44,64,137,87,224,0.000333,0.448,10,13440,746.666667,1344,326.653553,9,0
0,0,24,24,20,44,64,131,87,218,0.000333,0.436,10,13080,726.666667,1308,326.653553,9,0
0,0,51,51,26,53,79,318,177,495,0.000333,1.040124,39,121694.4873,6760.804852,3120.37147,425.791217,19,0
0,0,24,24,21,21,42,164,87,251,0.000333,0.451157,40,54138.86693,3007.714829,1353.471673,184.477332,12,0
0,0,18,18,15,25,40,103,57,160,0.000333,0.283836,14,11921.11893,662.284385,851.508495,174.699764,7,0
0,0,18,18,15,25,40,104,57,161,0.000333,0.28561,14,11995.62593,666.423663,856.830423,174.699764,7,0
0,0,22,22,14,20,34,97,67,164,0.000333,0.278115,21,17521.22203,973.401224,834.343906,139.741531,7,0
0,0,60,60,27,48,75,342,240,582,0.000333,1.208391,65,235636.2111,13090.90062,3625.172478,396.460163,38,0
0,0,42,42,16,51,67,269,209,478,0.000333,0.96653,32,92786.90026,5154.827792,2899.590633,353.293692,9,0
0,0,36,36,19,44,63,261,194,455,0.000333,0.906554,36,97907.84515,5439.32473,2719.662365,320.925614,7,0
0,0,35,35,18,44,62,256,190,446,0.000333,0.885191,36,95600.57596,5311.143109,2655.571554,315.273641,6,0
0,0,14,14,17,17,34,87,68,155,0.000333,0.262852,32,25233.81569,1401.87865,788.55674,138.973737,5,0
0,0,21,21,20,24,44,124,94,218,0.000333,0.396719,30,35704.68279,1983.593488,1190.156093,196.477662,8,0
0,0,20,20,26,27,53,128,92,220,0.000333,0.420048,39,49145.5575,2730.30875,1260.1425,250.593395,8,0
0,0,19,19,23,24,47,118,89,207,0.000333,0.383267,33,37943.39645,2107.966469,1149.799892,214.081025,7,0
0,0,10,10,12,15,27,57,45,102,0.000333,0.161666,18,8729.973454,484.998525,484.998525,101.622909,3,0
0,0,25,25,25,30,55,167,132,299,0.000333,0.576209,48,82974.07461,4609.670812,1728.626554,263.303123,24,0
0,0,13,13,14,17,31,76,55,131,0.000333,0.216333,21,13628.99405,757.166336,648.999717,122.789837,5,0
0,0,12,12,14,17,31,76,57,133,0.000333,0.219636,21,13837.0703,768.726127,658.908109,122.789837,4,0
0,0,12,12,13,18,31,75,57,132,0.000333,0.217985,18,11771.17043,653.953913,653.953913,123.164366,4,0
0,0,19,19,19,25,44,101,78,179,0.000333,0.325746,27,26385.43301,1465.85739,977.23826,196.807027,6,0
0,0,12,12,14,19,33,74,56,130,0.000333,0.21859,14,9180.797297,510.044294,655.771236,134.013592,4,0
0,0,13,13,13,14,27,67,51,118,0.000333,0.187026,18,10099.38106,561.076725,561.076725,101.408685,4,0
0,0,16,16,15,22,37,92,70,162,0.000333,0.28131,21,17722.56035,984.586686,843.931445,156.710855,6,0
0,0,15,15,20,25,45,96,68,164,0.000333,0.300221,20,18013.27816,1000.737675,900.663908,202.534967,6,0
0,0,14,14,17,21,38,86,65,151,0.000333,0.264146,24,19018.48931,1056.582739,792.437055,161.725534,5,0
0,0,14,14,15,23,38,89,70,159,0.000333,0.27814,21,17522.82997,973.490554,834.420475,162.645284,4,0
0,0,14,14,14,22,36,89,69,158,0.000333,0.272283,21,17153.81116,952.989509,816.84815,151.410465,4,0
0,0,30,30,22,37,59,154,118,272,0.000333,0.53336,33,52802.60401,2933.478001,1600.078909,290.85727,9,0
0,0,30,30,23,39,62,159,123,282,0.000333,0.559694,33,55409.75086,3078.319492,1679.08336,310.172612,9,0
0,0,14,14,14,23,37,85,67,152,0.000333,0.263946,14,11085.71676,615.873153,791.836912,157.344894,4,0
0,0,31,31,23,42,65,166,132,298,0.000333,0.598222,33,59223.96507,3290.220282,1794.665608,330.519257,9,0
0,0,14,14,14,21,35,84,69,153,0.000333,0.261593,21,16480.38633,915.577019,784.780302,145.541635,4,0
0,0,14,14,15,24,39,93,72,165,0.000333,0.290697,21,18313.91869,1017.439927,872.091366,168.642459,4,0
0,0,14,14,14,23,37,93,71,164,0.000333,0.284783,21,17941.35739,996.742077,854.350352,157.344894,4,0
0,0,30,30,22,38,60,155,118,273,0.000333,0.537527,33,53215.17738,2956.398743,1612.581133,297.528741,9,0
0,0,30,30,23,40,63,160,123,283,0.000333,0.563857,33,55821.81721,3101.212067,1691.570218,316.919049,9,0
0,0,14,14,15,22,37,86,67,153,0.000333,0.265682,21,16737.97366,929.887426,797.046365,156.710855,4,0
0,0,31,31,23,43,66,167,132,299,0.000333,0.602425,33,59640.03678,3313.335376,1807.273842,337.371309,9,0
0,0,14,14,15,20,35,85,69,154,0.000333,0.263303,21,16588.10128,921.561182,789.909585,145.041921,4,0
0,0,14,14,15,23,38,89,70,159,0.000333,0.27814,21,17522.82997,973.490554,834.420475,162.645284,4,0
0,0,14,14,14,22,36,89,69,158,0.000333,0.272283,21,17153.81116,952.989509,816.84815,151.410465,4,0
0,0,14,14,14,18,32,91,69,160,0.000333,0.266667,21,16800,933.333333,800,128.361619,4,0
0,0,14,14,15,24,39,93,72,165,0.000333,0.290697,21,18313.91869,1017.439927,872.091366,168.642459,4,0
0,0,14,14,14,23,37,93,71,164,0.000333,0.284783,21,17941.35739,996.742077,854.350352,157.344894,4,0
0,0,14,14,14,23,37,90,71,161,0.000333,0.279574,21,17613.16183,978.508991,838.721992,157.344894,4,0
0,0,14,14,14,22,36,90,70,160,0.000333,0.275729,21,17370.94801,965.052667,827.188,151.410465,4,0
0,0,14,14,14,20,34,90,69,159,0.000333,0.269636,21,16987.03843,943.724357,808.906592,139.741531,4,0
0,0,14,14,15,24,39,93,72,165,0.000333,0.290697,21,18313.91869,1017.439927,872.091366,168.642459,4,0
0,0,14,14,14,23,37,93,71,164,0.000333,0.284783,21,17941.35739,996.742077,854.350352,157.344894,4,0
0,0,14,14,15,24,39,93,72,165,0.000333,0.290697,21,18313.91869,1017.439927,872.091366,168.642459,4,0
0,0,14,14,14,23,37,93,71,164,0.000333,0.284783,21,17941.35739,996.742077,854.350352,157.344894,4,0
0,0,14,14,14,23,37,90,71,161,0.000333,0.279574,21,17613.16183,978.508991,838.721992,157.344894,4,0
0,0,14,14,14,22,36,90,70,160,0.000333,0.275729,21,17370.94801,965.052667,827.188,151.410465,4,0
0,0,19,19,23,26,49,128,107,235,0.000333,0.439819,44,58056.09979,3225.338877,1319.456813,226.253358,22,0
0,0,16,16,22,21,43,88,79,167,0.000333,0.302062,33,29904.14506,1661.341392,906.186214,190.346161,11,0
0,0,17,17,22,25,47,119,98,217,0.000333,0.401782,33,39776.41077,2209.800598,1205.345781,214.2039,20,0
0,0,24,24,24,28,52,160,125,285,0.000333,0.541542,48,77982.01534,4332.334186,1624.62532,244.645038,22,0
0,0,20,20,22,27,49,147,113,260,0.000333,0.486608,44,64232.28062,3568.460034,1459.824559,226.489458,19,0
0,0,49,49,23,35,58,259,199,458,0.000333,0.894318,55,147562.5413,8197.918959,2682.955296,283.566831,23,0
0,0,33,33,20,33,53,188,148,336,0.000333,0.641527,40,76983.25091,4276.847273,1924.581273,252.903568,17,0
0,0,32,32,22,33,55,179,141,320,0.000333,0.616678,44,81401.54477,4522.308043,1850.035108,264.572502,14,0
0,0,32,32,22,33,55,176,138,314,0.000333,0.605116,44,79875.2658,4437.514767,1815.34695,264.572502,15,0
0,0,32,32,22,33,55,179,141,320,0.000333,0.616678,44,81401.54477,4522.308043,1850.035108,264.572502,14,0
0,0,37,37,24,34,58,223,164,387,0.000333,0.75568,48,108817.855,6045.436387,2267.038645,283.012837,19,0
0,0,32,32,22,34,56,182,142,324,0.000333,0.627194,44,82789.65177,4599.425098,1881.582995,271.081232,16,0
0,0,34,34,24,34,58,206,156,362,0.000333,0.706863,48,101788.2778,5654.904321,2120.58912,283.012837,17,0
0,0,44,44,27,42,69,280,221,501,0.000333,1.020124,65,198924.0989,11051.33883,3060.370753,354.859294,35,0
0,0,44,44,20,34,54,231,175,406,0.000333,0.778828,50,116824.2163,6490.234239,2336.484326,259.412299,23,0
0,0,61,61,23,37,60,298,227,525,0.000333,1.033706,66,204673.7591,11370.7644,3101.117563,296.7917,29,0
0,0,44,44,24,51,75,250,202,452,0.000333,0.938475,36,101355.3377,5630.852096,2815.426048,399.332792,20,0
0,0,36,36,22,34,56,194,156,350,0.000333,0.677525,44,89433.2658,4968.514767,2032.574223,271.081232,14,0
0,0,35,35,22,34,56,190,153,343,0.000333,0.663974,44,87644.60048,4869.144471,1991.922738,271.081232,14,0
0,0,35,35,22,33,55,190,153,343,0.000333,0.661002,44,87252.2808,4847.348933,1983.006382,264.572502,14,0
0,0,35,35,22,33,55,189,152,341,0.000333,0.657148,44,86743.52114,4819.084508,1971.443662,264.572502,14,0
0,0,44,44,24,51,75,250,202,452,0.000333,0.938475,36,101355.3377,5630.852096,2815.426048,399.332792,20,0
0,0,35,35,22,33,55,189,152,341,0.000333,0.657148,44,86743.52114,4819.084508,1971.443662,264.572502,14,0
0,0,36,36,22,34,56,194,156,350,0.000333,0.677525,44,89433.2658,4968.514767,2032.574223,271.081232,14,0
0,0,34,34,20,32,52,182,148,330,0.000333,0.627048,40,75245.80428,4180.32246,1881.145107,246.438562,14,0
0,0,43,43,23,50,73,243,198,441,0.000333,0.909904,33,90080.51681,5004.473156,2729.71263,386.234734,20,0
0,0,34,34,20,32,52,182,148,330,0.000333,0.627048,40,75245.80428,4180.32246,1881.145107,246.438562,14,0
0,0,35,35,22,33,55,187,152,339,0.000333,0.653294,44,86234.76149,4790.820083,1959.880943,264.572502,14,0
0,0,43,43,23,51,74,244,199,443,0.000333,0.916929,33,90775.99875,5043.111042,2750.787841,393.335617,20,0
0,0,35,35,22,34,56,188,153,341,0.000333,0.660103,44,87133.55325,4840.752958,1980.308028,271.081232,14,0
0,0,34,34,21,34,55,184,150,334,0.000333,0.643658,40,77238.96577,4291.053654,1930.974144,265.212402,14,0
0,0,34,34,21,33,54,184,150,334,0.000333,0.640711,40,76885.29703,4271.40539,1922.132426,258.703672,14,0
0,0,61,61,24,41,65,306,238,544,0.000333,1.092056,60,196570.0854,10920.5603,3276.16809,329.698732,25,0
0,0,31,31,20,33,53,172,135,307,0.000333,0.586157,40,70338.86318,3907.714621,1758.47158,252.903568,17,0
0,0,30,30,22,33,55,163,128,291,0.000333,0.560792,33,55518.39733,3084.355407,1682.375677,264.572502,14,0
0,0,30,30,22,33,55,160,125,285,0.000333,0.549229,33,54373.68811,3020.76045,1647.687518,264.572502,15,0
0,0,30,30,22,33,55,163,128,291,0.000333,0.560792,33,55518.39733,3084.355407,1682.375677,264.572502,14,0
0,0,35,35,24,34,58,207,151,358,0.000333,0.699052,48,100663.5454,5592.41919,2097.157196,283.012837,19,0
0,0,30,30,22,34,56,166,129,295,0.000333,0.571057,33,56534.60017,3140.81112,1713.169702,271.081232,16,0
0,0,32,32,24,34,58,190,143,333,0.000333,0.650236,48,93633.96823,5201.887124,1950.707671,283.012837,17,0
0,0,42,42,27,42,69,264,208,472,0.000333,0.961075,52,149927.6243,8329.312459,2883.223544,354.859294,35,0
0,0,42,42,20,34,54,215,162,377,0.000333,0.723198,40,86783.70353,4821.316863,2169.592588,259.412299,23,0
0,0,59,59,23,37,60,282,214,496,0.000333,0.976606,55,161139.9754,8952.220858,2929.817735,296.7917,29,0
0,0,42,42,24,51,75,234,189,423,0.000333,0.878263,36,94852.45102,5269.580612,2634.790306,399.332792,20,0
0,0,34,34,22,34,56,178,143,321,0.000333,0.621387,44,82023.08092,4556.837829,1864.16093,271.081232,14,0
0,0,33,33,22,34,56,174,140,314,0.000333,0.607836,44,80234.4156,4457.467534,1823.509446,271.081232,14,0
0,0,33,33,22,33,55,174,140,314,0.000333,0.605116,44,79875.2658,4437.514767,1815.34695,264.572502,14,0
0,0,33,33,22,33,55,173,139,312,0.000333,0.601261,44,79366.50615,4409.250342,1803.784231,264.572502,14,0
0,0,42,42,24,51,75,234,189,423,0.000333,0.878263,36,94852.45102,5269.580612,2634.790306,399.332792,20,0
0,0,33,33,22,33,55,173,139,312,0.000333,0.601261,44,79366.50615,4409.250342,1803.784231,264.572502,14,0
0,0,34,34,22,34,56,178,143,321,0.000333,0.621387,44,82023.08092,4556.837829,1864.16093,271.081232,14,0
0,0,32,32,20,32,52,166,135,301,0.000333,0.571944,40,68633.29421,3812.960789,1715.832355,246.438562,14,0
0,0,41,41,23,50,73,227,185,412,0.000333,0.850069,33,84156.8547,4675.380817,2550.207718,386.234734,20,0
0,0,32,32,20,32,52,166,135,301,0.000333,0.571944,40,68633.29421,3812.960789,1715.832355,246.438562,14,0
0,0,33,33,22,33,55,171,139,310,0.000333,0.597407,44,78857.74649,4380.985916,1792.221511,264.572502,14,0
0,0,41,41,23,51,74,228,186,414,0.000333,0.856905,33,84833.55188,4712.975105,2570.713693,393.335617,20,0
0,0,33,33,22,34,56,172,140,312,0.000333,0.603965,44,79723.36837,4429.076021,1811.894736,271.081232,14,0
0,0,32,32,21,34,55,168,137,305,0.000333,0.587772,40,70532.58851,3918.477139,1763.314713,265.212402,14,0
0,0,32,32,21,33,54,168,137,305,0.000333,0.58508,40,70209.62753,3900.534863,1755.240688,258.703672,14,0
0,0,4,4,9,11,20,35,23,58,0.000333,0.083557,8,2005.374636,111.409702,250.67183,66.583073,1,0
0,0,23,23,17,22,39,104,81,185,0.000333,0.325933,24,23467.18585,1303.732547,977.79941,167.594364,11,0
0,0,75,75,25,44,69,366,279,645,0.000333,1.313333,72,283679.8758,15759.9931,3939.998275,356.311396,31,0
0,0,61,61,22,42,64,310,236,546,0.000333,1.092,55,180180,10010,3276,324.584827,25,0
0,0,59,59,22,42,64,297,225,522,0.000333,1.044,55,172260,9570,3132,324.584827,25,0
0,0,27,27,19,29,48,155,125,280,0.000333,0.521263,36,56296.42201,3127.579,1563.7895,221.592072,13,0
0,0,48,48,24,40,64,250,198,448,0.000333,0.896,48,129024,7168,2688,322.916224,22,0
0,0,32,32,19,35,54,179,147,326,0.000333,0.625364,36,67539.35973,3752.186651,1876.093326,260.235528,16,0
0,0,41,41,26,42,68,261,208,469,0.000333,0.951673,52,148461.0438,8247.835765,2855.020073,348.688764,34,0
0,0,29,29,19,30,49,160,127,287,0.000333,0.537141,36,58011.18211,3222.843451,1611.421725,227.917341,14,0
0,0,26,26,16,36,52,197,152,349,0.000333,0.663151,32,63662.51077,3536.806154,1989.453462,250.1173,6,0
0,0,23,23,17,37,54,209,155,364,0.000333,0.69826,32,67032.92963,3724.051646,2094.779051,262.236643,5,0
0,0,24,24,15,28,43,115,92,207,0.000333,0.374412,21,23587.97289,1310.442938,1123.236804,193.209297,6,0
0,0,22,22,15,27,42,110,86,196,0.000333,0.352298,21,22194.77851,1233.043251,1056.894215,186.985321,6,0
0,0,21,21,15,27,42,109,84,193,0.000333,0.346906,21,21855.06252,1214.17014,1040.717263,186.985321,6,0
0,0,19,19,15,25,40,107,79,186,0.000333,0.32996,21,20787.45114,1154.858397,989.878626,174.699764,6,0
0,0,24,24,21,31,52,135,100,235,0.000333,0.446534,30,40188.10001,2232.672223,1339.603334,245.818752,9,0
0,0,22,22,20,31,51,125,94,219,0.000333,0.414087,30,37267.8345,2070.43525,1242.26115,240.018648,8,0
0,0,77,77,29,53,82,503,314,817,0.000333,1.731373,70,363588.3991,20199.35551,5194.119988,444.461233,30,0
0,0,55,55,28,49,77,354,228,582,0.000333,1.215757,56,204247.1069,11347.0615,3647.269767,409.72672,20,0
0,0,41,41,22,40,62,274,172,446,0.000333,0.885191,44,116845.1484,6491.397133,2655.571554,310.984619,16,0
0,0,13,13,19,15,34,77,46,123,0.000333,0.208586,27,16895.4641,938.636894,625.757929,139.313982,5,0
0,0,18,18,15,25,40,103,57,160,0.000333,0.283836,14,11921.11893,662.284385,851.508495,174.699764,7,0
0,0,18,18,15,25,40,104,57,161,0.000333,0.28561,14,11995.62593,666.423663,856.830423,174.699764,7,0
0,0,18,18,15,25,40,103,57,160,0.000333,0.283836,14,11921.11893,662.284385,851.508495,174.699764,7,0
0,0,18,18,15,25,40,104,57,161,0.000333,0.28561,14,11995.62593,666.423663,856.830423,174.699764,7,0
0,0,13,13,17,17,34,82,47,129,0.000333,0.218761,16,10500.5233,583.362406,656.282707,138.973737,2,0
0,0,41,41,30,58,88,291,187,478,0.000333,1.029203,45,138942.3741,7719.020784,3087.608314,486.969616,21,0
0,0,83,83,25,84,109,499,324,823,0.000333,1.856739,36,200527.7652,11140.4314,5570.215699,653.051068,28,0
0,0,57,57,25,63,88,362,228,590,0.000333,1.270355,36,137198.3276,7622.12931,3811.064655,492.66504,14,0
0,0,24,24,18,50,68,123,90,213,0.000333,0.43221,9,11669.66627,648.314793,1296.629585,357.25146,9,0
0,0,22,22,18,49,67,114,84,198,0.000333,0.400362,9,10809.77094,600.54283,1201.08566,350.179432,9,0
0,0,22,22,18,49,67,114,84,198,0.000333,0.400362,9,10809.77094,600.54283,1201.08566,350.179432,9,0
0,0,22,22,18,49,67,114,84,198,0.000333,0.400362,9,10809.77094,600.54283,1201.08566,350.179432,9,0
0,0,21,21,16,48,64,111,80,191,0.000333,0.382,8,9168,509.333333,1146,332.0782,9,0
0,0,55,55,21,39,60,266,186,452,0.000333,0.889972,40,106796.582,5933.143443,2669.914549,298.369352,6,0
0,0,21,21,20,32,52,143,86,229,0.000333,0.435134,20,26108.01391,1450.445217,1305.400695,246.438562,4,0
0,0,53,53,29,47,76,267,183,450,0.000333,0.937189,42,118085.83,6560.323889,2811.567381,401.947125,20,0
0,0,12,12,20,13,33,72,55,127,0.000333,0.213546,40,25625.52213,1423.640118,640.638053,134.544278,5,0
0,0,44,44,32,46,78,279,187,466,0.000333,0.976332,64,187455.8358,10414.2131,2928.997434,414.08385,17,0
0,0,13,13,18,19,37,89,68,157,0.000333,0.272628,27,22082.87282,1226.826268,817.884178,155.769273,7,0
0,0,15,15,19,20,39,96,72,168,0.000333,0.295983,27,23974.58447,1331.921359,887.947573,167.149185,8,0
0,0,45,45,33,53,86,296,200,496,0.000333,1.062476,48,152996.5113,8499.806182,3187.427318,470.04479,19,0
0,0,14,14,20,21,41,94,70,164,0.000333,0.29288,30,26359.15586,1464.397548,878.638529,178.677228,8,0
0,0,12,12,14,20,34,63,39,102,0.000333,0.172974,7,3632.448469,201.802693,518.92121,139.741531,9,0
0,0,21,21,19,30,49,96,64,160,0.000333,0.299451,18,16170.36435,898.353575,898.353575,227.917341,11,0
0,0,18,18,15,25,40,103,57,160,0.000333,0.283836,14,11921.11893,662.284385,851.508495,174.699764,7,0
0,0,18,18,15,25,40,104,57,161,0.000333,0.28561,14,11995.62593,666.423663,856.830423,174.699764,7,0
0,0,20,20,19,24,43,91,63,154,0.000333,0.278548,18,15041.6059,835.644772,835.644772,190.749723,9,0
0,0,33,33,21,48,69,176,116,292,0.000333,0.594563,20,35673.78283,1981.876824,1783.689141,360.316866,9,0
0,0,57,57,22,58,80,295,195,490,0.000333,1.032582,33,102225.5773,5679.198739,3097.744766,437.870393,14,0
0,0,54,54,22,58,80,281,187,468,0.000333,0.986221,33,97635.8575,5424.214305,2958.662348,437.870393,13,0
0,0,50,50,22,58,80,271,178,449,0.000333,0.946182,33,93672.00858,5204.000477,2838.545715,437.870393,12,0
0,0,21,21,20,24,44,163,104,267,0.000333,0.485889,40,58306.72969,3239.26276,1457.668242,196.477662,5,0
0,0,21,21,20,25,45,159,102,261,0.000333,0.477791,40,57334.94633,3185.274796,1433.373658,202.534967,5,0
0,0,20,20,20,26,46,165,102,267,0.000333,0.491597,30,44243.73127,2457.98507,1474.791042,208.649995,5,0
0,0,43,43,19,47,66,227,145,372,0.000333,0.749505,27,60709.89454,3372.771919,2248.514612,341.776299,6,0
0,0,36,36,17,39,56,205,126,331,0.000333,0.640745,24,46133.6275,2562.979306,1922.234479,275.617555,5,0
0,0,39,39,19,47,66,217,136,353,0.000333,0.711224,18,38406.08023,2133.671124,2133.671124,341.776299,5,0
0,0,32,32,17,39,56,195,117,312,0.000333,0.603965,24,43485.47366,2415.859648,1811.894736,275.617555,4,0
0,0,29,29,22,47,69,314,169,483,0.000333,0.983472,33,97363.77132,5409.098406,2950.417313,359.173172,6,0
0,0,29,29,22,47,69,314,169,483,0.000333,0.983472,33,97363.77132,5409.098406,2950.417313,359.173172,6,0
0,0,28,28,22,48,70,308,167,475,0.000333,0.97047,33,96076.51129,5337.583961,2911.409433,366.185696,6,0
0,0,28,28,22,48,70,308,167,475,0.000333,0.97047,33,96076.51129,5337.583961,2911.409433,366.185696,6,0
0,0,18,18,15,25,40,103,57,160,0.000333,0.283836,14,11921.11893,662.284385,851.508495,174.699764,7,0
0,0,18,18,15,25,40,104,57,161,0.000333,0.28561,14,11995.62593,666.423663,856.830423,174.699764,7,0
0,0,29,29,23,23,46,127,80,207,0.000333,0.381126,33,37731.45172,2096.191762,1143.377325,208.08385,13,0
0,0,10,10,16,20,36,52,41,93,0.000333,0.160268,16,7692.848402,427.380467,480.803025,150.438562,4,0
0,0,10,10,16,21,37,53,43,96,0.000333,0.166703,16,8001.72037,444.540021,500.107523,156.238666,4,0
0,0,10,10,16,19,35,51,39,90,0.000333,0.153878,16,7386.167544,410.342641,461.635472,144.710623,4,0
0,0,10,10,15,21,36,55,45,100,0.000333,0.172331,14,7237.895002,402.105278,516.9925,150.842025,4,0
0,0,13,13,21,25,46,72,60,132,0.000333,0.243037,20,14582.20356,810.12242,729.110178,208.335071,5,0
0,0,13,13,21,23,44,68,54,122,0.000333,0.222017,20,13321.01315,740.056286,666.050657,196.280591,5,0
0,0,13,13,21,23,44,68,55,123,0.000333,0.223837,20,13430.20178,746.122321,671.510089,196.280591,5,0
0,0,13,13,21,24,45,69,56,125,0.000333,0.228827,20,13729.63274,762.757374,686.481637,202.277766,5,0
0,0,13,13,21,25,46,70,58,128,0.000333,0.235672,20,14140.31861,785.573256,707.01593,208.335071,5,0
0,0,44,44,29,44,73,206,151,357,0.000333,0.736589,42,92810.22944,5156.123858,2209.767368,381.09644,14,0
0,0,48,48,32,35,67,215,133,348,0.000333,0.703666,48,101327.9538,5629.330769,2110.999038,339.524906,17,0
0,0,15,15,20,26,46,100,68,168,0.000333,0.309319,20,18559.16817,1031.064898,927.958409,208.649995,7,0
0,0,49,49,29,45,74,227,162,389,0.000333,0.805159,42,101450.0491,5636.113838,2415.477359,388.014838,16,0
0,0,49,49,29,48,77,237,168,405,0.000333,0.846016,42,106598.0391,5922.113281,2538.048549,408.959649,16,0
0,0,37,37,30,38,68,176,117,293,0.000333,0.594542,45,80263.19756,4459.066531,1783.626612,346.627963,12,0
0,0,37,37,30,40,70,186,123,309,0.000333,0.631316,45,85227.68035,4734.871131,1893.948452,360.083842,12,0
0,0,12,12,14,20,34,63,39,102,0.000333,0.172974,7,3632.448469,201.802693,518.92121,139.741531,9,0
0,0,34,34,23,50,73,187,124,311,0.000333,0.641678,22,42350.77963,2352.821091,1925.035438,386.234734,18,0
0,0,30,30,21,43,64,160,108,268,0.000333,0.536,20,32160,1786.666667,1608,325.56805,20,0
0,0,44,44,28,60,88,255,161,416,0.000333,0.895708,28,75239.45949,4179.969972,2687.123553,489.019374,19,0
0,0,56,56,27,60,87,372,227,599,0.000333,1.286441,39,150513.603,8361.866834,3859.323154,482.795398,13,0
0,0,60,60,27,60,87,404,247,651,0.000333,1.398119,52,218106.5232,12117.02907,4194.356216,482.795398,14,0
0,0,55,55,27,57,84,390,229,619,0.000333,1.318948,52,205755.9132,11430.88407,3956.844485,460.856693,15,0
0,0,59,59,26,57,83,422,249,671,0.000333,1.425884,52,222437.8758,12357.65977,4277.651458,454.686163,16,0
0,0,13,13,13,19,32,70,40,110,0.000333,0.183333,12,6600,366.666667,550,128.816339,4,0
0,0,11,11,17,21,38,55,40,95,0.000333,0.166184,8,3988.42491,221.579162,498.553114,161.725534,7,0
0,0,60,60,30,39,69,419,256,675,0.000333,1.374418,90,371092.8607,20616.27004,4123.254008,353.337404,37,0
0,0,37,37,29,44,73,272,177,449,0.000333,0.92641,56,155636.9487,8646.49715,2779.231227,381.09644,14,0
0,0,21,21,20,25,45,101,83,184,0.000333,0.336834,30,30315.02909,1684.168283,1010.50097,202.534967,13,0
0,0,46,46,28,39,67,413,205,618,0.000333,1.249614,70,262419.0184,14578.83435,3748.84312,340.736624,13,0
0,0,74,74,29,54,83,438,291,729,0.000333,1.549135,70,325318.2622,18073.23679,4647.403745,451.645374,30,0
0,0,81,81,29,60,89,484,321,805,0.000333,1.737655,70,364907.5788,20272.64327,5212.965412,495.294885,31,0
0,0,63,63,29,50,79,374,250,624,0.000333,1.311186,70,275349.1431,15297.17462,3933.559187,423.074258,26,0
0,0,70,70,29,56,85,420,280,700,0.000333,1.495525,70,314060.1559,17447.78644,4486.573655,466.093324,27,0
0,0,66,66,28,55,83,400,263,663,0.000333,1.408884,56,236692.464,13149.58133,4226.651143,452.580722,27,0
0,0,66,66,28,54,82,404,265,669,0.000333,1.417734,56,238179.3283,13232.18491,4253.202291,445.369863,27,0
0,0,57,57,26,46,72,327,210,537,0.000333,1.104417,52,172288.9857,9571.610319,3313.249726,376.295283,25,0
0,0,26,26,23,29,52,167,114,281,0.000333,0.533941,33,52860.17751,2936.676528,1601.823561,244.923374,10,0
0,0,28,28,23,29,52,175,120,295,0.000333,0.560543,44,73991.70754,4110.650419,1681.629717,244.923374,10,0
0,0,11,11,21,26,47,92,56,148,0.000333,0.274026,20,16441.583,913.421278,822.07915,214.450099,6,0
0,0,11,11,21,26,47,92,56,148,0.000333,0.274026,20,16441.583,913.421278,822.07915,214.450099,6,0
0,0,56,56,34,48,82,279,158,437,0.000333,0.926083,51,141690.7615,7871.708974,2778.250226,441.051937,32,0
0,0,34,34,24,30,54,170,97,267,0.000333,0.512185,36,55315.97867,3073.109926,1536.554963,257.245818,19,0
0,0,12,12,14,20,34,63,39,102,0.000333,0.172974,7,3632.448469,201.802693,518.92121,139.741531,9,0
0,0,60,60,30,44,74,357,208,565,0.000333,1.169447,60,210500.4691,11694.47051,3508.341152,387.421709,42,0
0,0,30,30,27,45,72,191,122,313,0.000333,0.643729,26,50210.84966,2789.491648,1931.186525,375.515352,28,0
0,0,18,18,20,26,46,113,92,205,0.000333,0.377443,30,33969.90603,1887.217002,1132.330201,208.649995,8,0
0,0,10,10,15,14,29,47,38,85,0.000333,0.137643,14,5780.997384,321.166521,412.928385,111.906328,3,0
0,0,79,79,27,80,107,500,408,908,0.000333,2.040417,65,397881.3815,22104.5212,6121.252024,634.13621,59,0
0,0,79,79,28,83,111,507,409,916,0.000333,2.074562,56,348526.3563,19362.57535,6223.684934,663.734211,57,0
0,0,64,64,34,67,101,372,291,663,0.000333,1.471465,68,300178.8065,16676.60036,4414.394213,579.401712,35,0
0,0,66,66,31,55,86,352,282,634,0.000333,1.358084,75,305568.8891,16976.04939,4074.251854,471.55487,42,0
0,0,44,44,28,41,69,224,187,411,0.000333,0.836868,56,140593.7989,7810.766605,2510.603552,354.26557,28,0
0,0,45,45,29,41,70,223,187,410,0.000333,0.837669,56,140728.3381,7818.241004,2513.006037,360.541081,27,0
0,0,45,45,29,41,70,224,187,411,0.000333,0.839712,56,141071.5779,7837.309884,2519.13532,360.541081,27,0
0,0,54,54,28,54,82,328,269,597,0.000333,1.265153,56,212545.6786,11808.09326,3795.458547,445.369863,37,0
0,0,63,63,28,58,86,399,323,722,0.000333,1.546588,70,324783.4207,18043.52337,4639.763153,474.368836,44,0
0,0,26,26,21,18,39,150,64,214,0.000333,0.377025,30,33932.28225,1885.126791,1131.076075,167.297316,21,0
0,0,22,22,20,17,37,134,53,187,0.000333,0.324723,30,29225.03338,1623.612966,974.167779,155.92543,15,0
0,0,30,30,20,21,41,143,75,218,0.000333,0.389315,30,35038.39011,1946.577228,1167.946337,178.677228,14,0
0,0,18,18,13,30,43,99,79,178,0.000333,0.321958,12,11590.50152,643.916751,965.875126,195.312434,5,0
0,0,26,26,21,23,44,115,72,187,0.000333,0.340305,30,30627.41138,1701.522854,1020.913713,196.280591,11,0
0,0,10,10,16,19,35,51,39,90,0.000333,0.153878,16,7386.167544,410.342641,461.635472,144.710623,4,0
0,0,13,13,17,21,38,67,53,120,0.000333,0.209917,16,10076.02083,559.778935,629.751302,161.725534,6,0
0,0,10,10,16,20,36,52,41,93,0.000333,0.160268,16,7692.848402,427.380467,480.803025,150.438562,4,0
0,0,10,10,16,21,37,53,43,96,0.000333,0.166703,16,8001.72037,444.540021,500.107523,156.238666,4,0
0,0,13,13,21,24,45,69,56,125,0.000333,0.228827,20,13729.63274,762.757374,686.481637,202.277766,5,0
0,0,13,13,21,23,44,68,54,122,0.000333,0.222017,20,13321.01315,740.056286,666.050657,196.280591,5,0
0,0,13,13,21,25,46,70,58,128,0.000333,0.235672,20,14140.31861,785.573256,707.01593,208.335071,5,0
0,0,13,13,21,25,46,72,60,132,0.000333,0.243037,20,14582.20356,810.12242,729.110178,208.335071,5,0
0,0,13,13,21,23,44,68,55,123,0.000333,0.223837,20,13430.20178,746.122321,671.510089,196.280591,5,0
0,0,48,48,32,35,67,215,133,348,0.000333,0.703666,48,101327.9538,5629.330769,2110.999038,339.524906,17,0
0,0,44,44,29,44,73,206,151,357,0.000333,0.736589,42,92810.22944,5156.123858,2209.767368,381.09644,14,0
0,0,49,49,29,45,74,227,162,389,0.000333,0.805159,42,101450.0491,5636.113838,2415.477359,388.014838,16,0
0,0,15,15,20,26,46,100,68,168,0.000333,0.309319,20,18559.16817,1031.064898,927.958409,208.649995,7,0
0,0,37,37,30,40,70,186,123,309,0.000333,0.631316,45,85227.68035,4734.871131,1893.948452,360.083842,12,0
0,0,49,49,29,48,77,237,168,405,0.000333,0.846016,42,106598.0391,5922.113281,2538.048549,408.959649,16,0
0,0,37,37,30,38,68,176,117,293,0.000333,0.594542,45,80263.19756,4459.066531,1783.626612,346.627963,12,0
0,0,27,27,20,46,66,242,139,381,0.000333,0.767638,30,69087.42478,3838.190266,2302.914159,340.522412,20,0
0,0,18,18,15,25,40,103,57,160,0.000333,0.283836,14,11921.11893,662.284385,851.508495,174.699764,7,0
0,0,18,18,15,25,40,104,57,161,0.000333,0.28561,14,11995.62593,666.423663,856.830423,174.699764,7,0
0,0,10,10,11,16,27,73,44,117,0.000333,0.185441,10,5563.218378,309.067688,556.321838,102.053748,4,0
0,0,10,10,10,16,26,67,41,108,0.000333,0.169216,10,5076.474896,282.026383,507.64749,97.219281,3,0
0,0,10,10,10,16,26,71,41,112,0.000333,0.175483,10,5264.492484,292.471805,526.449248,97.219281,3,0
0,0,10,10,10,16,26,67,41,108,0.000333,0.169216,10,5076.474896,282.026383,507.64749,97.219281,3,0
0,0,10,10,10,16,26,71,41,112,0.000333,0.175483,10,5264.492484,292.471805,526.449248,97.219281,3,0
0,0,10,10,10,16,26,67,41,108,0.000333,0.169216,10,5076.474896,282.026383,507.64749,97.219281,3,0
0,0,10,10,10,16,26,67,41,108,0.000333,0.169216,10,5076.474896,282.026383,507.64749,97.219281,3,0
0,0,10,10,10,16,26,67,41,108,0.000333,0.169216,10,5076.474896,282.026383,507.64749,97.219281,3,0
0,0,18,18,15,25,40,103,57,160,0.000333,0.283836,14,11921.11893,662.284385,851.508495,174.699764,7,0
0,0,18,18,15,25,40,104,57,161,0.000333,0.28561,14,11995.62593,666.423663,856.830423,174.699764,7,0
0,0,36,36,19,44,63,261,194,455,0.000333,0.906554,36,97907.84515,5439.32473,2719.662365,320.925614,7,0
0,0,35,35,18,44,62,256,190,446,0.000333,0.885191,36,95600.57596,5311.143109,2655.571554,315.273641,6,0
0,0,42,42,16,51,67,269,209,478,0.000333,0.96653,32,92786.90026,5154.827792,2899.590633,353.293692,9,0
0,0,14,14,17,17,34,87,68,155,0.000333,0.262852,32,25233.81569,1401.87865,788.55674,138.973737,5,0
0,0,13,13,14,17,31,76,55,131,0.000333,0.216333,21,13628.99405,757.166336,648.999717,122.789837,5,0
0,0,12,12,14,17,31,76,57,133,0.000333,0.219636,21,13837.0703,768.726127,658.908109,122.789837,4,0
0,0,12,12,14,19,33,74,56,130,0.000333,0.21859,14,9180.797297,510.044294,655.771236,134.013592,4,0
0,0,19,19,19,25,44,101,78,179,0.000333,0.325746,27,26385.43301,1465.85739,977.23826,196.807027,6,0
0,0,12,12,13,18,31,75,57,132,0.000333,0.217985,18,11771.17043,653.953913,653.953913,123.164366,4,0
0,0,19,19,23,24,47,118,89,207,0.000333,0.383267,33,37943.39645,2107.966469,1149.799892,214.081025,7,0
0,0,21,21,20,24,44,124,94,218,0.000333,0.396719,30,35704.68279,1983.593488,1190.156093,196.477662,8,0
0,0,20,20,26,27,53,128,92,220,0.000333,0.420048,39,49145.5575,2730.30875,1260.1425,250.593395,8,0
0,0,25,25,25,30,55,167,132,299,0.000333,0.576209,48,82974.07461,4609.670812,1728.626554,263.303123,24,0
0,0,10,10,12,15,27,57,45,102,0.000333,0.161666,18,8729.973454,484.998525,484.998525,101.622909,3,0
0,0,14,14,14,23,37,93,71,164,0.000333,0.284783,21,17941.35739,996.742077,854.350352,157.344894,4,0
0,0,14,14,15,24,39,93,72,165,0.000333,0.290697,21,18313.91869,1017.439927,872.091366,168.642459,4,0
0,0,14,14,14,22,36,89,69,158,0.000333,0.272283,21,17153.81116,952.989509,816.84815,151.410465,4,0
0,0,14,14,15,23,38,89,70,159,0.000333,0.27814,21,17522.82997,973.490554,834.420475,162.645284,4,0
0,0,14,14,14,23,37,93,71,164,0.000333,0.284783,21,17941.35739,996.742077,854.350352,157.344894,4,0
0,0,14,14,15,24,39,93,72,165,0.000333,0.290697,21,18313.91869,1017.439927,872.091366,168.642459,4,0
0,0,14,14,14,23,37,93,71,164,0.000333,0.284783,21,17941.35739,996.742077,854.350352,157.344894,4,0
0,0,14,14,15,24,39,93,72,165,0.000333,0.290697,21,18313.91869,1017.439927,872.091366,168.642459,4,0
0,0,14,14,14,23,37,93,71,164,0.000333,0.284783,21,17941.35739,996.742077,854.350352,157.344894,4,0
0,0,14,14,15,24,39,93,72,165,0.000333,0.290697,21,18313.91869,1017.439927,872.091366,168.642459,4,0
0,0,14,14,14,20,34,90,69,159,0.000333,0.269636,21,16987.03843,943.724357,808.906592,139.741531,4,0
0,0,14,14,14,22,36,90,70,160,0.000333,0.275729,21,17370.94801,965.052667,827.188,151.410465,4,0
0,0,14,14,14,23,37,90,71,161,0.000333,0.279574,21,17613.16183,978.508991,838.721992,157.344894,4,0
0,0,14,14,14,22,36,89,69,158,0.000333,0.272283,21,17153.81116,952.989509,816.84815,151.410465,4,0
0,0,14,14,15,23,38,89,70,159,0.000333,0.27814,21,17522.82997,973.490554,834.420475,162.645284,4,0
0,0,14,14,14,18,32,91,69,160,0.000333,0.266667,21,16800,933.333333,800,128.361619,4,0
0,0,30,30,23,40,63,160,123,283,0.000333,0.563857,33,55821.81721,3101.212067,1691.570218,316.919049,9,0
0,0,14,14,15,20,35,85,69,154,0.000333,0.263303,21,16588.10128,921.561182,789.909585,145.041921,4,0
0,0,14,14,15,22,37,86,67,153,0.000333,0.265682,21,16737.97366,929.887426,797.046365,156.710855,4,0
0,0,31,31,23,43,66,167,132,299,0.000333,0.602425,33,59640.03678,3313.335376,1807.273842,337.371309,9,0
0,0,30,30,22,38,60,155,118,273,0.000333,0.537527,33,53215.17738,2956.398743,1612.581133,297.528741,9,0
0,0,14,14,14,22,36,90,70,160,0.000333,0.275729,21,17370.94801,965.052667,827.188,151.410465,4,0
0,0,14,14,14,23,37,90,71,161,0.000333,0.279574,21,17613.16183,978.508991,838.721992,157.344894,4,0
0,0,30,30,23,39,62,159,123,282,0.000333,0.559694,33,55409.75086,3078.319492,1679.08336,310.172612,9,0
0,0,14,14,14,21,35,84,69,153,0.000333,0.261593,21,16480.38633,915.577019,784.780302,145.541635,4,0
0,0,14,14,14,23,37,85,67,152,0.000333,0.263946,14,11085.71676,615.873153,791.836912,157.344894,4,0
0,0,31,31,23,42,65,166,132,298,0.000333,0.598222,33,59223.96507,3290.220282,1794.665608,330.519257,9,0
0,0,30,30,22,37,59,154,118,272,0.000333,0.53336,33,52802.60401,2933.478001,1600.078909,290.85727,9,0
0,0,14,14,17,21,38,86,65,151,0.000333,0.264146,24,19018.48931,1056.582739,792.437055,161.725534,5,0
0,0,16,16,15,22,37,92,70,162,0.000333,0.28131,21,17722.56035,984.586686,843.931445,156.710855,6,0
0,0,15,15,20,25,45,96,68,164,0.000333,0.300221,20,18013.27816,1000.737675,900.663908,202.534967,6,0
0,0,13,13,13,14,27,67,51,118,0.000333,0.187026,18,10099.38106,561.076725,561.076725,101.408685,4,0
0,0,19,19,23,26,49,128,107,235,0.000333,0.439819,44,58056.09979,3225.338877,1319.456813,226.253358,22,0
0,0,16,16,22,21,43,88,79,167,0.000333,0.302062,33,29904.14506,1661.341392,906.186214,190.346161,11,0
0,0,17,17,22,25,47,119,98,217,0.000333,0.401782,33,39776.41077,2209.800598,1205.345781,214.2039,20,0
0,0,24,24,24,28,52,160,125,285,0.000333,0.541542,48,77982.01534,4332.334186,1624.62532,244.645038,22,0
0,0,20,20,22,27,49,147,113,260,0.000333,0.486608,44,64232.28062,3568.460034,1459.824559,226.489458,19,0
0,0,33,33,20,33,53,188,148,336,0.000333,0.641527,40,76983.25091,4276.847273,1924.581273,252.903568,17,0
0,0,49,49,23,35,58,259,199,458,0.000333,0.894318,55,147562.5413,8197.918959,2682.955296,283.566831,23,0
0,0,32,32,22,33,55,176,138,314,0.000333,0.605116,44,79875.2658,4437.514767,1815.34695,264.572502,15,0
0,0,32,32,22,33,55,179,141,320,0.000333,0.616678,44,81401.54477,4522.308043,1850.035108,264.572502,14,0
0,0,32,32,22,33,55,179,141,320,0.000333,0.616678,44,81401.54477,4522.308043,1850.035108,264.572502,14,0
0,0,32,32,22,34,56,182,142,324,0.000333,0.627194,44,82789.65177,4599.425098,1881.582995,271.081232,16,0
0,0,37,37,24,34,58,223,164,387,0.000333,0.75568,48,108817.855,6045.436387,2267.038645,283.012837,19,0
0,0,34,34,24,34,58,206,156,362,0.000333,0.706863,48,101788.2778,5654.904321,2120.58912,283.012837,17,0
0,0,44,44,27,42,69,280,221,501,0.000333,1.020124,65,198924.0989,11051.33883,3060.370753,354.859294,35,0
0,0,61,61,23,37,60,298,227,525,0.000333,1.033706,66,204673.7591,11370.7644,3101.117563,296.7917,29,0
0,0,44,44,20,34,54,231,175,406,0.000333,0.778828,50,116824.2163,6490.234239,2336.484326,259.412299,23,0
0,0,44,44,24,51,75,250,202,452,0.000333,0.938475,36,101355.3377,5630.852096,2815.426048,399.332792,20,0
0,0,35,35,22,33,55,189,152,341,0.000333,0.657148,44,86743.52114,4819.084508,1971.443662,264.572502,14,0
0,0,36,36,22,34,56,194,156,350,0.000333,0.677525,44,89433.2658,4968.514767,2032.574223,271.081232,14,0
0,0,35,35,22,33,55,189,152,341,0.000333,0.657148,44,86743.52114,4819.084508,1971.443662,264.572502,14,0
0,0,43,43,23,50,73,243,198,441,0.000333,0.909904,33,90080.51681,5004.473156,2729.71263,386.234734,20,0
0,0,34,34,20,32,52,182,148,330,0.000333,0.627048,40,75245.80428,4180.32246,1881.145107,246.438562,14,0
0,0,35,35,22,33,55,187,152,339,0.000333,0.653294,44,86234.76149,4790.820083,1959.880943,264.572502,14,0
0,0,34,34,20,32,52,182,148,330,0.000333,0.627048,40,75245.80428,4180.32246,1881.145107,246.438562,14,0
0,0,34,34,21,33,54,184,150,334,0.000333,0.640711,40,76885.29703,4271.40539,1922.132426,258.703672,14,0
0,0,43,43,23,51,74,244,199,443,0.000333,0.916929,33,90775.99875,5043.111042,2750.787841,393.335617,20,0
0,0,35,35,22,34,56,188,153,341,0.000333,0.660103,44,87133.55325,4840.752958,1980.308028,271.081232,14,0
0,0,34,34,21,34,55,184,150,334,0.000333,0.643658,40,77238.96577,4291.053654,1930.974144,265.212402,14,0
0,0,35,35,22,33,55,190,153,343,0.000333,0.661002,44,87252.2808,4847.348933,1983.006382,264.572502,14,0
0,0,44,44,24,51,75,250,202,452,0.000333,0.938475,36,101355.3377,5630.852096,2815.426048,399.332792,20,0
0,0,36,36,22,34,56,194,156,350,0.000333,0.677525,44,89433.2658,4968.514767,2032.574223,271.081232,14,0
0,0,35,35,22,34,56,190,153,343,0.000333,0.663974,44,87644.60048,4869.144471,1991.922738,271.081232,14,0
0,0,45,45,21,39,60,235,187,422,0.000333,0.830903,40,99708.31325,5539.350736,2492.707831,298.369352,19,0
0,0,47,47,23,35,58,243,186,429,0.000333,0.837691,55,138219.0616,7678.836754,2513.073847,283.566831,23,0
0,0,30,30,22,33,55,160,125,285,0.000333,0.549229,33,54373.68811,3020.76045,1647.687518,264.572502,15,0
0,0,30,30,22,33,55,163,128,291,0.000333,0.560792,33,55518.39733,3084.355407,1682.375677,264.572502,14,0
0,0,30,30,22,33,55,163,128,291,0.000333,0.560792,33,55518.39733,3084.355407,1682.375677,264.572502,14,0
0,0,30,30,22,34,56,166,129,295,0.000333,0.571057,33,56534.60017,3140.81112,1713.169702,271.081232,16,0
0,0,35,35,24,34,58,207,151,358,0.000333,0.699052,48,100663.5454,5592.41919,2097.157196,283.012837,19,0
0,0,32,32,24,34,58,190,143,333,0.000333,0.650236,48,93633.96823,5201.887124,1950.707671,283.012837,17,0
0,0,42,42,27,42,69,264,208,472,0.000333,0.961075,52,149927.6243,8329.312459,2883.223544,354.859294,35,0
0,0,59,59,23,37,60,282,214,496,0.000333,0.976606,55,161139.9754,8952.220858,2929.817735,296.7917,29,0
0,0,42,42,20,34,54,215,162,377,0.000333,0.723198,40,86783.70353,4821.316863,2169.592588,259.412299,23,0
0,0,42,42,24,51,75,234,189,423,0.000333,0.878263,36,94852.45102,5269.580612,2634.790306,399.332792,20,0
0,0,33,33,22,33,55,173,139,312,0.000333,0.601261,44,79366.50615,4409.250342,1803.784231,264.572502,14,0
0,0,34,34,22,34,56,178,143,321,0.000333,0.621387,44,82023.08092,4556.837829,1864.16093,271.081232,14,0
0,0,33,33,22,33,55,173,139,312,0.000333,0.601261,44,79366.50615,4409.250342,1803.784231,264.572502,14,0
0,0,41,41,23,50,73,227,185,412,0.000333,0.850069,33,84156.8547,4675.380817,2550.207718,386.234734,20,0
0,0,32,32,20,32,52,166,135,301,0.000333,0.571944,40,68633.29421,3812.960789,1715.832355,246.438562,14,0
0,0,33,33,22,33,55,171,139,310,0.000333,0.597407,44,78857.74649,4380.985916,1792.221511,264.572502,14,0
0,0,32,32,20,32,52,166,135,301,0.000333,0.571944,40,68633.29421,3812.960789,1715.832355,246.438562,14,0
0,0,32,32,21,33,54,168,137,305,0.000333,0.58508,40,70209.62753,3900.534863,1755.240688,258.703672,14,0
0,0,41,41,23,51,74,228,186,414,0.000333,0.856905,33,84833.55188,4712.975105,2570.713693,393.335617,20,0
0,0,33,33,22,34,56,172,140,312,0.000333,0.603965,44,79723.36837,4429.076021,1811.894736,271.081232,14,0
0,0,32,32,21,34,55,168,137,305,0.000333,0.587772,40,70532.58851,3918.477139,1763.314713,265.212402,14,0
0,0,33,33,22,33,55,174,140,314,0.000333,0.605116,44,79875.2658,4437.514767,1815.34695,264.572502,14,0
0,0,42,42,24,51,75,234,189,423,0.000333,0.878263,36,94852.45102,5269.580612,2634.790306,399.332792,20,0
0,0,34,34,22,34,56,178,143,321,0.000333,0.621387,44,82023.08092,4556.837829,1864.16093,271.081232,14,0
0,0,33,33,22,34,56,174,140,314,0.000333,0.607836,44,80234.4156,4457.467534,1823.509446,271.081232,14,0
0,0,4,4,9,11,20,35,23,58,0.000333,0.083557,8,2005.374636,111.409702,250.67183,66.583073,1,0
0,0,23,23,17,22,39,104,81,185,0.000333,0.325933,24,23467.18585,1303.732547,977.79941,167.594364,11,0
0,0,75,75,25,44,69,366,279,645,0.000333,1.313333,72,283679.8758,15759.9931,3939.998275,356.311396,31,0
0,0,61,61,22,42,64,310,236,546,0.000333,1.092,55,180180,10010,3276,324.584827,25,0
0,0,59,59,22,42,64,297,225,522,0.000333,1.044,55,172260,9570,3132,324.584827,25,0
0,0,32,32,19,35,54,179,147,326,0.000333,0.625364,36,67539.35973,3752.186651,1876.093326,260.235528,16,0
0,0,27,27,19,29,48,155,125,280,0.000333,0.521263,36,56296.42201,3127.579,1563.7895,221.592072,13,0
0,0,48,48,24,40,64,250,198,448,0.000333,0.896,48,129024,7168,2688,322.916224,22,0
0,0,41,41,26,42,68,261,208,469,0.000333,0.951673,52,148461.0438,8247.835765,2855.020073,348.688764,34,0
0,0,29,29,19,30,49,160,127,287,0.000333,0.537141,36,58011.18211,3222.843451,1611.421725,227.917341,14,0
0,0,23,23,17,37,54,209,155,364,0.000333,0.69826,32,67032.92963,3724.051646,2094.779051,262.236643,5,0
0,0,26,26,16,36,52,197,152,349,0.000333,0.663151,32,63662.51077,3536.806154,1989.453462,250.1173,6,0
0,0,24,24,15,28,43,115,92,207,0.000333,0.374412,21,23587.97289,1310.442938,1123.236804,193.209297,6,0
0,0,22,22,15,27,42,110,86,196,0.000333,0.352298,21,22194.77851,1233.043251,1056.894215,186.985321,6,0
0,0,21,21,15,27,42,109,84,193,0.000333,0.346906,21,21855.06252,1214.17014,1040.717263,186.985321,6,0
0,0,19,19,15,25,40,107,79,186,0.000333,0.32996,21,20787.45114,1154.858397,989.878626,174.699764,6,0
0,0,24,24,21,31,52,135,100,235,0.000333,0.446534,30,40188.10001,2232.672223,1339.603334,245.818752,9,0
0,0,22,22,20,31,51,125,94,219,0.000333,0.414087,30,37267.8345,2070.43525,1242.26115,240.018648,8,0
0,0,27,27,17,30,47,86,66,152,0.000333,0.281433,16,13508.76009,750.486672,844.297505,216.693586,7,0
0,0,13,13,15,26,41,64,42,106,0.000333,0.1893,7,3975.303587,220.850199,567.900512,180.814792,8,0
0,0,38,38,24,45,69,233,127,360,0.000333,0.733023,24,52777.65131,2932.091739,2199.068804,357.172489,18,0
0,0,14,14,14,19,33,73,50,123,0.000333,0.20682,14,8686.446674,482.580371,620.460477,134.013592,1,0
0,0,14,14,14,20,34,78,56,134,0.000333,0.22724,14,9544.08029,530.226683,681.720021,139.741531,1,0
0,0,14,14,14,20,34,78,55,133,0.000333,0.225544,14,9472.85581,526.269767,676.632558,139.741531,1,0
0,0,14,14,14,19,33,80,56,136,0.000333,0.228679,14,9604.526403,533.5848,686.0376,134.013592,1,0
0,0,6,6,9,16,25,34,30,64,0.000333,0.099069,4,1188.827185,66.045955,297.206796,92.529325,1,0
0,0,22,22,17,31,48,127,88,215,0.000333,0.400256,16,19212.271,1067.348389,1200.766938,223.066954,2,0
0,0,9,9,12,18,30,46,41,87,0.000333,0.1423,12,5122.793782,284.599655,426.899482,118.0782,2,0
0,0,6,6,9,15,24,36,31,67,0.000333,0.102397,8,2457.5399,136.529994,307.192488,87.132684,1,0
0,0,10,10,12,27,39,55,47,102,0.000333,0.179704,6,3234.666158,179.703675,539.111026,171.401513,2,0
0,0,29,29,26,33,59,161,126,287,0.000333,0.562773,39,65844.42365,3658.023536,1688.318555,288.676439,8,0
0,0,24,24,17,31,48,131,93,224,0.000333,0.417011,24,30024.7584,1668.042134,1251.0316,223.066954,2,0
0,0,11,11,14,18,32,50,46,96,0.000333,0.16,14,6720,373.333333,480,128.361619,2,0
0,0,8,8,11,15,26,40,36,76,0.000333,0.119078,10,3572.334186,198.46301,357.233419,96.657107,1,0
0,0,12,12,14,27,41,59,52,111,0.000333,0.198229,7,4162.817908,231.267662,594.688273,181.684931,2,0
0,0,7,7,12,11,23,44,38,82,0.000333,0.123644,18,6676.777447,370.93208,370.93208,81.073298,3,0
0,0,46,46,25,34,59,340,265,605,0.000333,1.186333,84,298955.9198,16608.66221,3558.999045,289.070141,20,0
0,0,20,20,17,28,45,132,86,218,0.000333,0.399075,24,28733.3754,1596.298633,1197.223975,204.092806,8,0
0,0,22,22,18,28,46,141,91,232,0.000333,0.427155,27,34599.59209,1922.199561,1281.466374,209.664588,9,0
0,0,30,30,23,33,56,175,134,309,0.000333,0.598158,44,78956.79752,4386.488751,1794.472671,270.506931,4,0
0,0,29,29,22,47,69,314,169,483,0.000333,0.983472,33,97363.77132,5409.098406,2950.417313,359.173172,6,0
0,0,29,29,22,47,69,314,169,483,0.000333,0.983472,33,97363.77132,5409.098406,2950.417313,359.173172,6,0
0,0,28,28,22,48,70,308,167,475,0.000333,0.97047,33,96076.51129,5337.583961,2911.409433,366.185696,6,0
0,0,28,28,22,48,70,308,167,475,0.000333,0.97047,33,96076.51129,5337.583961,2911.409433,366.185696,6,0
0,0,22,22,14,20,34,97,67,164,0.000333,0.278115,21,17521.22203,973.401224,834.343906,139.741531,7,0
0,0,37,37,26,40,66,243,146,389,0.000333,0.783756,39,91699.50319,5094.416844,2351.269312,335.088556,18,0
0,0,18,18,15,25,40,103,57,160,0.000333,0.283836,14,11921.11893,662.284385,851.508495,174.699764,7,0
0,0,18,18,15,25,40,104,57,161,0.000333,0.28561,14,11995.62593,666.423663,856.830423,174.699764,7,0
0,0,52,52,27,67,94,360,213,573,0.000333,1.251926,39,146475.3971,8137.522059,3755.779412,534.809938,24,0
0,0,18,18,15,25,40,103,57,160,0.000333,0.283836,14,11921.11893,662.284385,851.508495,174.699764,7,0
0,0,18,18,15,25,40,104,57,161,0.000333,0.28561,14,11995.62593,666.423663,856.830423,174.699764,7,0
0,0,18,18,15,25,40,103,57,160,0.000333,0.283836,14,11921.11893,662.284385,851.508495,174.699764,7,0
0,0,18,18,15,25,40,104,57,161,0.000333,0.28561,14,11995.62593,666.423663,856.830423,174.699764,7,0
0,0,19,19,23,44,67,199,104,303,0.000333,0.612675,22,40436.55054,2246.47503,1838.025025,344.256916,6,0
0,0,27,27,27,49,76,278,141,419,0.000333,0.872627,26,68064.92233,3781.384574,2617.881628,403.502745,8,0
0,0,24,24,19,34,53,142,94,236,0.000333,0.450596,18,24332.20609,1351.789227,1351.789227,253.684359,8,0
0,0,16,16,13,27,40,63,57,120,0.000333,0.212877,12,7663.576457,425.754248,638.631371,176.487679,6,0
0,0,36,36,16,42,58,267,167,434,0.000333,0.847455,24,61016.73005,3389.818336,2542.363752,290.477332,4,0
0,0,35,35,16,42,58,263,165,428,0.000333,0.835739,24,60173.18078,3342.954488,2507.215866,290.477332,3,0
0,0,34,34,16,42,58,259,163,422,0.000333,0.824023,24,59329.63152,3296.09064,2472.06798,290.477332,2,0
0,0,17,17,14,34,48,126,80,206,0.000333,0.383501,14,16107.03185,894.835103,1150.502275,226.276706,1,0
0,0,28,28,27,55,82,268,148,416,0.000333,0.881581,26,68763.28248,3820.18236,2644.741634,446.356747,8,0
0,0,25,25,27,54,81,249,138,387,0.000333,0.817841,26,63791.57073,3543.976152,2453.521951,439.145888,8,0
0,0,22,22,27,54,81,241,131,372,0.000333,0.786141,26,61319.02923,3406.612735,2358.424201,439.145888,8,0
0,0,34,34,30,69,99,705,290,995,0.000333,2.198737,60,395772.5902,21987.36612,6596.209837,568.694905,18,0
0,0,34,34,30,69,99,705,290,995,0.000333,2.198737,60,395772.5902,21987.36612,6596.209837,568.694905,18,0
0,0,16,16,16,27,43,170,88,258,0.000333,0.466659,24,33599.43136,1866.635076,1399.976307,192.381963,8,0
0,0,15,15,16,25,41,166,84,250,0.000333,0.446463,24,32145.31203,1785.850668,1339.388001,180.096405,8,0
0,0,30,30,23,36,59,228,131,359,0.000333,0.703956,33,69691.67221,3871.759567,2111.868855,290.159225,18,0
0,0,60,60,30,39,69,419,256,675,0.000333,1.374418,90,371092.8607,20616.27004,4123.254008,353.337404,37,0
0,0,21,21,20,25,45,100,81,181,0.000333,0.331342,30,29820.76231,1656.709017,994.02541,202.534967,13,0
0,0,75,75,29,54,83,441,293,734,0.000333,1.55976,70,327549.526,18197.19589,4679.278943,451.645374,30,0
0,0,82,82,29,60,89,487,323,810,0.000333,1.748448,70,367174.0855,20398.56031,5245.344079,495.294885,31,0
0,0,64,64,29,50,79,377,252,629,0.000333,1.321693,70,277555.4663,15419.74813,3965.078091,423.074258,26,0
0,0,71,71,29,56,85,423,282,705,0.000333,1.506207,70,316303.4427,17572.41348,4518.62061,466.093324,27,0
0,0,67,67,28,55,83,403,265,668,0.000333,1.419509,56,238477.475,13248.74861,4258.52634,452.580722,27,0
0,0,67,67,28,54,82,407,267,674,0.000333,1.42833,56,239959.4429,13331.08016,4284.990051,445.369863,27,0
0,0,58,58,26,46,72,330,212,542,0.000333,1.1147,52,173893.1662,9660.731458,3344.099351,376.295283,25,0
0,0,81,81,29,60,89,484,321,805,0.000333,1.737655,70,364907.5788,20272.64327,5212.965412,495.294885,31,0
0,0,74,74,29,54,83,438,291,729,0.000333,1.549135,70,325318.2622,18073.23679,4647.403745,451.645374,30,0
0,0,70,70,29,56,85,420,280,700,0.000333,1.495525,70,314060.1559,17447.78644,4486.573655,466.093324,27,0
0,0,63,63,29,50,79,374,250,624,0.000333,1.311186,70,275349.1431,15297.17462,3933.559187,423.074258,26,0
0,0,66,66,28,55,83,400,263,663,0.000333,1.408884,56,236692.464,13149.58133,4226.651143,452.580722,27,0
0,0,66,66,28,54,82,404,265,669,0.000333,1.417734,56,238179.3283,13232.18491,4253.202291,445.369863,27,0
0,0,57,57,26,46,72,327,210,537,0.000333,1.104417,52,172288.9857,9571.610319,3313.249726,376.295283,25,0
0,0,16,16,16,27,43,170,88,258,0.000333,0.466659,24,33599.43136,1866.635076,1399.976307,192.381963,8,0
0,0,15,15,16,25,41,166,84,250,0.000333,0.446463,24,32145.31203,1785.850668,1339.388001,180.096405,8,0
0,0,18,18,15,25,40,103,57,160,0.000333,0.283836,14,11921.11893,662.284385,851.508495,174.699764,7,0
0,0,18,18,15,25,40,104,57,161,0.000333,0.28561,14,11995.62593,666.423663,856.830423,174.699764,7,0
0,0,12,12,14,20,34,63,39,102,0.000333,0.172974,7,3632.448469,201.802693,518.92121,139.741531,9,0
0,0,32,32,18,39,57,185,102,287,0.000333,0.558013,18,30132.70981,1674.039434,1674.039434,281.189337,15,0
0,0,77,77,29,53,82,503,314,817,0.000333,1.731373,70,363588.3991,20199.35551,5194.119988,444.461233,30,0
0,0,55,55,28,49,77,354,228,582,0.000333,1.215757,56,204247.1069,11347.0615,3647.269767,409.72672,20,0
0,0,41,41,22,40,62,274,172,446,0.000333,0.885191,44,116845.1484,6491.397133,2655.571554,310.984619,16,0
0,0,62,62,30,39,69,447,277,724,0.000333,1.474191,105,464370.0292,25798.33496,4422.571707,353.337404,39,0
0,0,37,37,29,44,73,272,177,449,0.000333,0.92641,56,155636.9487,8646.49715,2779.231227,381.09644,14,0
0,0,21,21,20,25,45,100,81,181,0.000333,0.331342,30,29820.76231,1656.709017,994.02541,202.534967,13,0
0,0,46,46,28,39,67,413,205,618,0.000333,1.249614,70,262419.0184,14578.83435,3748.84312,340.736624,13,0
0,0,75,75,29,54,83,441,293,734,0.000333,1.55976,70,327549.526,18197.19589,4679.278943,451.645374,30,0
0,0,82,82,29,60,89,487,323,810,0.000333,1.748448,70,367174.0855,20398.56031,5245.344079,495.294885,31,0
0,0,64,64,29,50,79,377,252,629,0.000333,1.321693,70,277555.4663,15419.74813,3965.078091,423.074258,26,0
0,0,71,71,29,56,85,423,282,705,0.000333,1.506207,70,316303.4427,17572.41348,4518.62061,466.093324,27,0
0,0,67,67,28,55,83,403,265,668,0.000333,1.419509,56,238477.475,13248.74861,4258.52634,452.580722,27,0
0,0,67,67,28,54,82,407,267,674,0.000333,1.42833,56,239959.4429,13331.08016,4284.990051,445.369863,27,0
0,0,58,58,26,46,72,330,212,542,0.000333,1.1147,52,173893.1662,9660.731458,3344.099351,376.295283,25,0
0,0,26,26,23,29,52,167,114,281,0.000333,0.533941,33,52860.17751,2936.676528,1601.823561,244.923374,10,0
0,0,28,28,23,29,52,175,120,295,0.000333,0.560543,44,73991.70754,4110.650419,1681.629717,244.923374,10,0
0,0,11,11,21,26,47,92,56,148,0.000333,0.274026,20,16441.583,913.421278,822.07915,214.450099,6,0
0,0,11,11,21,26,47,92,56,148,0.000333,0.274026,20,16441.583,913.421278,822.07915,214.450099,6,0
0,0,18,18,15,25,40,103,57,160,0.000333,0.283836,14,11921.11893,662.284385,851.508495,174.699764,7,0
0,0,18,18,15,25,40,104,57,161,0.000333,0.28561,14,11995.62593,666.423663,856.830423,174.699764,7,0
0,0,41,41,31,44,75,283,199,482,0.000333,1.000764,60,180137.4365,10007.63536,3002.290609,393.795077,25,0
0,0,35,35,30,42,72,236,170,406,0.000333,0.834997,60,150299.373,8349.965169,2504.989551,373.68405,21,0
0,0,12,12,14,20,34,63,39,102,0.000333,0.172974,7,3632.448469,201.802693,518.92121,139.741531,9,0
0,0,14,14,14,19,33,80,56,136,0.000333,0.228679,14,9604.526403,533.5848,686.0376,134.013592,1,0
0,0,14,14,14,20,34,78,56,134,0.000333,0.22724,14,9544.08029,530.226683,681.720021,139.741531,1,0
0,0,14,14,14,20,34,78,55,133,0.000333,0.225544,14,9472.85581,526.269767,676.632558,139.741531,1,0
0,0,14,14,14,19,33,73,50,123,0.000333,0.20682,14,8686.446674,482.580371,620.460477,134.013592,1,0
0,0,9,9,12,18,30,46,41,87,0.000333,0.1423,12,5122.793782,284.599655,426.899482,118.0782,2,0
0,0,6,6,9,15,24,36,31,67,0.000333,0.102397,8,2457.5399,136.529994,307.192488,87.132684,1,0
0,0,22,22,17,31,48,113,85,198,0.000333,0.368608,16,17693.1612,982.9534,1105.822575,223.066954,2,0
0,0,10,10,14,27,41,69,50,119,0.000333,0.212516,7,4462.84082,247.935601,637.548689,181.684931,2,0
0,0,6,6,9,16,25,34,30,64,0.000333,0.099069,4,1188.827185,66.045955,297.206796,92.529325,1,0
0,0,32,32,26,33,59,173,137,310,0.000333,0.607873,52,94828.20596,5268.233664,1823.619345,288.676439,9,0
0,0,8,8,11,15,26,40,36,76,0.000333,0.119078,10,3572.334186,198.46301,357.233419,96.657107,1,0
0,0,24,24,17,31,48,117,90,207,0.000333,0.385362,16,18497.3958,1027.6331,1156.087238,223.066954,2,0
0,0,12,12,14,27,41,73,55,128,0.000333,0.228589,14,9600.733192,533.374066,685.766657,181.684931,2,0
0,0,8,8,11,16,27,38,35,73,0.000333,0.115702,10,3471.067877,192.837104,347.106788,102.053748,1,0
0,0,7,7,12,11,23,44,38,82,0.000333,0.123644,18,6676.777447,370.93208,370.93208,81.073298,3,0
0,0,46,46,25,34,59,340,265,605,0.000333,1.186333,84,298955.9198,16608.66221,3558.999045,289.070141,20,0
0,0,22,22,18,28,46,141,91,232,0.000333,0.427155,27,34599.59209,1922.199561,1281.466374,209.664588,9,0
0,0,20,20,17,28,45,132,86,218,0.000333,0.399075,24,28733.3754,1596.298633,1197.223975,204.092806,8,0
0,0,30,30,23,33,56,175,134,309,0.000333,0.598158,44,78956.79752,4386.488751,1794.472671,270.506931,4,0
0,0,16,16,16,27,43,170,88,258,0.000333,0.466659,24,33599.43136,1866.635076,1399.976307,192.381963,8,0
0,0,15,15,16,25,41,166,84,250,0.000333,0.446463,24,32145.31203,1785.850668,1339.388001,180.096405,8,0
0,0,21,21,17,28,45,112,64,176,0.000333,0.322189,16,15465.05832,859.169907,966.566145,204.092806,12,0
0,0,62,62,30,39,69,447,277,724,0.000333,1.474191,105,464370.0292,25798.33496,4422.571707,353.337404,39,0
0,0,37,37,29,44,73,272,177,449,0.000333,0.92641,56,155636.9487,8646.49715,2779.231227,381.09644,14,0
0,0,21,21,20,25,45,101,83,184,0.000333,0.336834,30,30315.02909,1684.168283,1010.50097,202.534967,13,0
0,0,46,46,28,39,67,413,205,618,0.000333,1.249614,70,262419.0184,14578.83435,3748.84312,340.736624,13,0
0,0,78,78,29,59,88,472,312,784,0.000333,1.688065,70,354493.6072,19694.08929,5064.194389,487.957389,31,0
0,0,71,71,29,53,82,426,282,708,0.000333,1.500382,70,315080.2773,17504.45985,4501.146819,444.461233,30,0
0,0,67,67,29,55,84,408,271,679,0.000333,1.446795,56,243061.4777,13503.41543,4340.38353,458.856233,27,0
0,0,60,60,29,49,78,362,241,603,0.000333,1.263366,56,212245.4621,11791.41456,3790.097538,416.002231,26,0
0,0,63,63,28,54,82,388,254,642,0.000333,1.360516,56,228566.7097,12698.15054,4081.548387,445.369863,27,0
0,0,63,63,28,53,81,392,256,648,0.000333,1.369408,56,230060.4769,12781.13761,4108.222802,438.185722,27,0
0,0,54,54,26,45,71,315,201,516,0.000333,1.057757,52,165010.0147,9167.223039,3173.269514,369.344822,25,0
0,0,26,26,23,29,52,167,114,281,0.000333,0.533941,33,52860.17751,2936.676528,1601.823561,244.923374,10,0
0,0,28,28,23,29,52,175,120,295,0.000333,0.560543,44,73991.70754,4110.650419,1681.629717,244.923374,10,0
0,0,11,11,21,26,47,92,56,148,0.000333,0.274026,20,16441.583,913.421278,822.07915,214.450099,6,0
0,0,11,11,21,26,47,92,56,148,0.000333,0.274026,20,16441.583,913.421278,822.07915,214.450099,6,0
0,0,12,12,14,20,34,63,39,102,0.000333,0.172974,7,3632.448469,201.802693,518.92121,139.741531,9,0
0,0,60,60,30,44,74,357,208,565,0.000333,1.169447,60,210500.4691,11694.47051,3508.341152,387.421709,42,0
0,0,34,34,27,48,75,203,130,333,0.000333,0.691399,26,53929.11222,2996.06179,2074.196624,396.460163,33,0
0,0,18,18,20,26,46,113,92,205,0.000333,0.377443,30,33969.90603,1887.217002,1132.330201,208.649995,8,0
0,0,10,10,15,14,29,47,38,85,0.000333,0.137643,14,5780.997384,321.166521,412.928385,111.906328,3,0
0,0,85,85,28,83,111,536,431,967,0.000333,2.190067,70,459914.01,25550.77833,6570.200143,663.734211,63,0
0,0,79,79,28,83,111,507,409,916,0.000333,2.074562,56,348526.3563,19362.57535,6223.684934,663.734211,57,0
0,0,64,64,34,67,101,372,291,663,0.000333,1.471465,68,300178.8065,16676.60036,4414.394213,579.401712,35,0
0,0,66,66,31,55,86,352,282,634,0.000333,1.358084,75,305568.8891,16976.04939,4074.251854,471.55487,42,0
0,0,44,44,28,41,69,224,187,411,0.000333,0.836868,56,140593.7989,7810.766605,2510.603552,354.26557,28,0
0,0,45,45,29,41,70,224,187,411,0.000333,0.839712,56,141071.5779,7837.309884,2519.13532,360.541081,27,0
0,0,45,45,29,41,70,223,187,410,0.000333,0.837669,56,140728.3381,7818.241004,2513.006037,360.541081,27,0
0,0,54,54,28,54,82,328,269,597,0.000333,1.265153,56,212545.6786,11808.09326,3795.458547,445.369863,37,0
0,0,63,63,28,58,86,399,323,722,0.000333,1.546588,70,324783.4207,18043.52337,4639.763153,474.368836,44,0
0,0,26,26,21,18,39,150,64,214,0.000333,0.377025,30,33932.28225,1885.126791,1131.076075,167.297316,21,0
0,0,22,22,20,17,37,134,53,187,0.000333,0.324723,30,29225.03338,1623.612966,974.167779,155.92543,15,0
0,0,30,30,20,21,41,143,75,218,0.000333,0.389315,30,35038.39011,1946.577228,1167.946337,178.677228,14,0
0,0,62,62,30,39,69,447,277,724,0.000333,1.474191,105,464370.0292,25798.33496,4422.571707,353.337404,39,0
0,0,37,37,29,44,73,272,177,449,0.000333,0.92641,56,155636.9487,8646.49715,2779.231227,381.09644,14,0
0,0,21,21,20,25,45,101,83,184,0.000333,0.336834,30,30315.02909,1684.168283,1010.50097,202.534967,13,0
0,0,46,46,28,39,67,413,205,618,0.000333,1.249614,70,262419.0184,14578.83435,3748.84312,340.736624,13,0
0,0,82,82,29,60,89,487,323,810,0.000333,1.748448,70,367174.0855,20398.56031,5245.344079,495.294885,31,0
0,0,75,75,29,54,83,441,293,734,0.000333,1.55976,70,327549.526,18197.19589,4679.278943,451.645374,30,0
0,0,71,71,29,56,85,423,282,705,0.000333,1.506207,70,316303.4427,17572.41348,4518.62061,466.093324,27,0
0,0,64,64,29,50,79,377,252,629,0.000333,1.321693,70,277555.4663,15419.74813,3965.078091,423.074258,26,0
0,0,67,67,28,55,83,403,265,668,0.000333,1.419509,56,238477.475,13248.74861,4258.52634,452.580722,27,0
0,0,67,67,28,54,82,407,267,674,0.000333,1.42833,56,239959.4429,13331.08016,4284.990051,445.369863,27,0
0,0,58,58,26,46,72,330,212,542,0.000333,1.1147,52,173893.1662,9660.731458,3344.099351,376.295283,25,0
0,0,26,26,23,29,52,167,114,281,0.000333,0.533941,33,52860.17751,2936.676528,1601.823561,244.923374,10,0
0,0,28,28,23,29,52,175,120,295,0.000333,0.560543,44,73991.70754,4110.650419,1681.629717,244.923374,10,0
0,0,11,11,21,26,47,92,56,148,0.000333,0.274026,20,16441.583,913.421278,822.07915,214.450099,6,0
0,0,11,11,21,26,47,92,56,148,0.000333,0.274026,20,16441.583,913.421278,822.07915,214.450099,6,0
0,0,6,6,13,13,26,32,21,53,0.000333,0.083041,6,1494.73983,83.041102,249.123305,96.211433,3,0
0,0,5,5,13,12,25,29,19,48,0.000333,0.074302,6,1337.430583,74.301699,222.905097,91.125266,3,0
0,0,46,46,30,55,85,231,151,382,0.000333,0.816129,30,73451.62013,4080.645563,2448.387338,465.181502,15,0
0,0,50,50,30,55,85,243,159,402,0.000333,0.858858,30,77297.25469,4294.291927,2576.575156,465.181502,15,0
0,0,60,60,30,39,69,419,256,675,0.000333,1.374418,90,371092.8607,20616.27004,4123.254008,353.337404,37,0
0,0,37,37,29,44,73,272,177,449,0.000333,0.92641,56,155636.9487,8646.49715,2779.231227,381.09644,14,0
0,0,21,21,20,25,45,101,83,184,0.000333,0.336834,30,30315.02909,1684.168283,1010.50097,202.534967,13,0
0,0,46,46,28,39,67,413,205,618,0.000333,1.249614,70,262419.0184,14578.83435,3748.84312,340.736624,13,0
0,0,78,78,29,59,88,472,312,784,0.000333,1.688065,70,354493.6072,19694.08929,5064.194389,487.957389,31,0
0,0,71,71,29,53,82,426,282,708,0.000333,1.500382,70,315080.2773,17504.45985,4501.146819,444.461233,30,0
0,0,67,67,29,55,84,408,271,679,0.000333,1.446795,56,243061.4777,13503.41543,4340.38353,458.856233,27,0
0,0,60,60,29,49,78,362,241,603,0.000333,1.263366,56,212245.4621,11791.41456,3790.097538,416.002231,26,0
0,0,63,63,28,54,82,388,254,642,0.000333,1.360516,56,228566.7097,12698.15054,4081.548387,445.369863,27,0
0,0,63,63,28,53,81,392,256,648,0.000333,1.369408,56,230060.4769,12781.13761,4108.222802,438.185722,27,0
0,0,54,54,26,45,71,315,201,516,0.000333,1.057757,52,165010.0147,9167.223039,3173.269514,369.344822,25,0
0,0,26,26,23,29,52,167,114,281,0.000333,0.533941,33,52860.17751,2936.676528,1601.823561,244.923374,10,0
0,0,28,28,23,29,52,175,120,295,0.000333,0.560543,44,73991.70754,4110.650419,1681.629717,244.923374,10,0
0,0,11,11,21,26,47,92,56,148,0.000333,0.274026,20,16441.583,913.421278,822.07915,214.450099,6,0
0,0,11,11,21,26,47,92,56,148,0.000333,0.274026,20,16441.583,913.421278,822.07915,214.450099,6,0
0,0,19,19,16,27,43,84,55,139,0.000333,0.251417,16,12068.01281,670.445156,754.250801,192.381963,10,0
0,0,12,12,14,20,34,63,39,102,0.000333,0.172974,7,3632.448469,201.802693,518.92121,139.741531,9,0
0,0,22,22,23,20,43,109,76,185,0.000333,0.33462,33,33127.34633,1840.408129,1003.85898,190.480487,7,0
0,0,22,22,30,20,50,167,100,267,0.000333,0.502303,75,113018.2202,6278.790011,1506.909603,233.64528,15,0
0,0,10,10,16,14,30,47,33,80,0.000333,0.13085,16,6280.819962,348.934442,392.551248,117.302969,3,0
0,0,21,21,17,24,41,101,78,179,0.000333,0.319667,24,23016.04341,1278.669078,959.001809,179.525968,9,0
0,0,40,40,27,48,75,237,163,400,0.000333,0.830509,39,97169.57157,5398.309532,2491.527476,396.460163,21,0
0,0,22,22,19,26,45,114,86,200,0.000333,0.366124,27,29656.00672,1647.555929,1098.370619,202.922055,11,0
0,0,41,41,29,49,78,250,171,421,0.000333,0.882051,42,111138.482,6174.360113,2646.154334,416.002231,23,0
0,0,10,10,18,21,39,90,61,151,0.000333,0.266032,18,14365.72323,798.095735,798.095735,167.297316,4,0
0,0,27,27,17,30,47,86,66,152,0.000333,0.281433,16,13508.76009,750.486672,844.297505,216.693586,7,0
0,0,33,33,21,49,70,189,139,328,0.000333,0.670135,20,40208.09659,2233.783144,2010.40483,367.359448,20,0
0,0,37,37,21,51,72,196,150,346,0.000333,0.711598,20,42695.88101,2371.993389,2134.79405,381.532358,17,0
0,0,25,25,19,41,60,148,106,254,0.000333,0.500117,18,27006.3038,1500.350211,1500.350211,300.370255,19,0
0,0,31,31,20,45,65,163,123,286,0.000333,0.574132,20,34447.94389,1913.774661,1722.397195,333.571951,16,0
0,0,15,15,29,25,54,127,94,221,0.000333,0.423943,42,53416.8658,2967.603655,1271.830138,256.977854,14,0
0,0,39,39,22,53,75,291,170,461,0.000333,0.957162,33,94759.01874,5264.38993,2871.485416,401.68728,18,0
0,0,57,57,31,46,77,409,237,646,0.000333,1.349448,75,303625.8079,16868.10044,4048.344105,407.663936,35,0
0,0,41,41,31,44,75,283,199,482,0.000333,1.000764,60,180137.4365,10007.63536,3002.290609,393.795077,25,0
0,0,35,35,30,42,72,236,170,406,0.000333,0.834997,60,150299.373,8349.965169,2504.989551,373.68405,21,0
0,0,34,34,21,47,68,265,156,421,0.000333,0.854274,30,76884.65569,4271.36976,2562.821856,353.304342,23,0
0,0,12,12,14,20,34,63,39,102,0.000333,0.172974,7,3632.448469,201.802693,518.92121,139.741531,9,0
0,0,51,51,26,53,79,318,177,495,0.000333,1.040124,39,121694.4873,6760.804852,3120.37147,425.791217,19,0
0,0,24,24,21,21,42,164,87,251,0.000333,0.451157,40,54138.86693,3007.714829,1353.471673,184.477332,12,0
0,0,18,18,15,25,40,103,57,160,0.000333,0.283836,14,11921.11893,662.284385,851.508495,174.699764,7,0
0,0,18,18,15,25,40,104,57,161,0.000333,0.28561,14,11995.62593,666.423663,856.830423,174.699764,7,0
0,0,62,62,25,69,94,402,256,658,0.000333,1.43764,36,155265.1007,8625.838929,4312.919464,537.584592,24,0
0,0,19,19,23,35,58,121,87,208,0.000333,0.406153,22,26806.12103,1489.228946,1218.460047,283.566831,7,0
0,0,34,34,24,54,78,255,173,428,0.000333,0.896717,36,96845.47739,5380.304299,2690.15215,420.803025,11,0
0,0,78,78,31,94,125,563,354,917,0.000333,2.129208,45,287443.0885,15969.06047,6387.624189,769.711438,31,0
0,0,13,13,19,22,41,79,54,133,0.000333,0.237518,18,12825.9795,712.554417,712.554417,178.818118,6,0
0,0,23,23,23,37,60,146,103,249,0.000333,0.490272,22,32357.94668,1797.663705,1470.815758,296.7917,9,0
0,0,92,92,22,65,87,507,304,811,0.000333,1.741742,44,229909.9957,12772.77754,5225.227175,489.561403,40,0
0,0,15,15,19,26,45,105,76,181,0.000333,0.331342,18,17892.45739,994.02541,994.02541,202.922055,6,0
0,0,67,67,26,81,107,467,293,760,0.000333,1.707838,39,199817.0815,11100.94897,5123.51491,635.739283,24,0
0,0,24,24,25,51,76,186,124,310,0.000333,0.645619,24,46484.5807,2582.476706,1936.857529,405.390097,7,0
0,0,39,39,25,67,92,320,210,530,0.000333,1.152496,36,124469.5621,6914.975673,3457.487837,522.524381,11,0
0,0,18,18,22,38,60,144,91,235,0.000333,0.462706,22,30538.62438,1696.590243,1388.11929,297.528741,6,0
0,0,28,28,25,53,78,211,140,351,0.000333,0.735392,24,52948.22829,2941.568238,2206.176179,419.676189,9,0
0,0,97,97,25,78,103,572,341,913,0.000333,2.034925,48,293029.1991,16279.39995,6104.774981,606.357778,40,0
0,0,20,20,22,42,64,170,113,283,0.000333,0.566,22,37356,2075.333333,1698,324.584827,6,0
0,0,64,64,26,81,107,460,287,747,0.000333,1.678625,39,196399.1577,10911.06432,5035.875839,635.739283,24,0
0,0,21,21,25,51,76,179,118,297,0.000333,0.618545,24,44535.22732,2474.179295,1855.634471,405.390097,7,0
0,0,36,36,25,67,92,313,204,517,0.000333,1.124227,36,121416.5351,6745.363063,3372.681531,522.524381,11,0
0,0,15,15,22,38,60,137,85,222,0.000333,0.43711,22,28849.25367,1602.736315,1311.329712,297.528741,6,0
0,0,25,25,25,53,78,204,134,338,0.000333,0.708155,24,50987.1828,2832.621267,2124.46595,419.676189,9,0
0,0,94,94,25,78,103,565,335,900,0.000333,2.00595,48,288856.8228,16047.60127,6017.850474,606.357778,40,0
0,0,17,17,22,42,64,163,107,270,0.000333,0.54,22,35640,1980,1620,324.584827,6,0
0,0,18,18,15,25,40,103,57,160,0.000333,0.283836,14,11921.11893,662.284385,851.508495,174.699764,7,0
0,0,18,18,15,25,40,104,57,161,0.000333,0.28561,14,11995.62593,666.423663,856.830423,174.699764,7,0
0,0,62,62,30,39,69,447,277,724,0.000333,1.474191,105,464370.0292,25798.33496,4422.571707,353.337404,39,0
0,0,37,37,29,44,73,272,177,449,0.000333,0.92641,56,155636.9487,8646.49715,2779.231227,381.09644,14,0
0,0,21,21,20,25,45,101,83,184,0.000333,0.336834,30,30315.02909,1684.168283,1010.50097,202.534967,13,0
0,0,46,46,28,39,67,413,205,618,0.000333,1.249614,70,262419.0184,14578.83435,3748.84312,340.736624,13,0
0,0,71,71,29,53,82,426,282,708,0.000333,1.500382,70,315080.2773,17504.45985,4501.146819,444.461233,30,0
0,0,78,78,29,59,88,472,312,784,0.000333,1.688065,70,354493.6072,19694.08929,5064.194389,487.957389,31,0
0,0,60,60,29,49,78,362,241,603,0.000333,1.263366,56,212245.4621,11791.41456,3790.097538,416.002231,26,0
0,0,67,67,29,55,84,408,271,679,0.000333,1.446795,56,243061.4777,13503.41543,4340.38353,458.856233,27,0
0,0,63,63,28,54,82,388,254,642,0.000333,1.360516,56,228566.7097,12698.15054,4081.548387,445.369863,27,0
0,0,63,63,28,53,81,392,256,648,0.000333,1.369408,56,230060.4769,12781.13761,4108.222802,438.185722,27,0
0,0,54,54,26,45,71,315,201,516,0.000333,1.057757,52,165010.0147,9167.223039,3173.269514,369.344822,25,0
0,0,26,26,23,29,52,167,114,281,0.000333,0.533941,33,52860.17751,2936.676528,1601.823561,244.923374,10,0
0,0,28,28,23,29,52,175,120,295,0.000333,0.560543,44,73991.70754,4110.650419,1681.629717,244.923374,10,0
0,0,11,11,21,26,47,92,56,148,0.000333,0.274026,20,16441.583,913.421278,822.07915,214.450099,6,0
0,0,11,11,21,26,47,92,56,148,0.000333,0.274026,20,16441.583,913.421278,822.07915,214.450099,6,0
0,0,12,12,14,20,34,63,39,102,0.000333,0.172974,7,3632.448469,201.802693,518.92121,139.741531,9,0
0,0,10,10,11,26,37,50,42,92,0.000333,0.159757,5,2396.348548,133.130475,479.26971,160.26518,5,0
0,0,49,49,22,75,97,269,212,481,0.000333,1.058186,22,69840.2777,3880.015428,3174.558077,565.268897,28,0
0,0,53,53,24,83,107,300,234,534,0.000333,1.199981,24,86398.6409,4799.924494,3599.943371,639.167373,30,0
0,0,35,35,20,51,71,176,153,329,0.000333,0.674422,30,60698.00407,3372.111337,2023.266802,375.732254,18,0
0,0,39,39,22,61,83,207,175,382,0.000333,0.811755,22,53575.83138,2976.435077,2435.265063,459.882473,20,0
0,0,19,19,22,33,55,109,94,203,0.000333,0.391205,22,25819.55248,1434.419582,1173.616022,264.572502,9,0
0,0,19,19,23,38,61,118,106,224,0.000333,0.442828,22,29226.6736,1623.704089,1328.485164,303.463171,14,0
0,0,18,18,19,29,48,73,59,132,0.000333,0.245738,18,13269.8709,737.21505,737.21505,221.592072,4,0
0,0,78,78,30,56,86,316,226,542,0.000333,1.161012,60,208982.1298,11610.11832,3483.035497,472.418594,23,0
0,0,78,78,30,56,86,316,226,542,0.000333,1.161012,60,208982.1298,11610.11832,3483.035497,472.418594,23,0
0,0,46,46,19,38,57,185,134,319,0.000333,0.620231,27,50238.68169,2791.037872,1860.691915,280.131868,12,0
0,0,8,8,12,15,27,33,24,57,0.000333,0.090343,6,1626.171526,90.342863,271.028588,101.622909,5,0
0,0,13,13,16,17,33,54,37,91,0.000333,0.153013,16,7344.637838,408.035435,459.039865,133.486868,7,0
0,0,29,29,19,28,47,116,81,197,0.000333,0.364751,18,19696.57207,1094.254004,1094.254004,215.316561,11,0
0,0,29,29,21,28,49,122,82,204,0.000333,0.3818,20,22908.01616,1272.667565,1145.400808,226.844604,12,0
0,0,28,28,20,28,48,114,77,191,0.000333,0.355576,20,21334.55675,1185.253153,1066.727838,221.0445,10,0
0,0,24,24,19,27,46,115,73,188,0.000333,0.346143,18,18691.73366,1038.429648,1038.429648,209.092585,10,0
0,0,23,23,16,31,47,115,69,184,0.000333,0.340681,16,16352.70958,908.483866,1022.044349,217.580086,13,0
0,0,60,60,30,39,69,419,256,675,0.000333,1.374418,90,371092.8607,20616.27004,4123.254008,353.337404,37,0
0,0,37,37,29,44,73,272,177,449,0.000333,0.92641,56,155636.9487,8646.49715,2779.231227,381.09644,14,0
0,0,21,21,20,25,45,100,81,181,0.000333,0.331342,30,29820.76231,1656.709017,994.02541,202.534967,13,0
0,0,46,46,28,39,67,413,205,618,0.000333,1.249614,70,262419.0184,14578.83435,3748.84312,340.736624,13,0
0,0,74,74,29,54,83,438,291,729,0.000333,1.549135,70,325318.2622,18073.23679,4647.403745,451.645374,30,0
0,0,81,81,29,60,89,484,321,805,0.000333,1.737655,70,364907.5788,20272.64327,5212.965412,495.294885,31,0
0,0,63,63,29,50,79,374,250,624,0.000333,1.311186,70,275349.1431,15297.17462,3933.559187,423.074258,26,0
0,0,70,70,29,56,85,420,280,700,0.000333,1.495525,70,314060.1559,17447.78644,4486.573655,466.093324,27,0
0,0,66,66,28,55,83,400,263,663,0.000333,1.408884,56,236692.464,13149.58133,4226.651143,452.580722,27,0
0,0,66,66,28,54,82,404,265,669,0.000333,1.417734,56,238179.3283,13232.18491,4253.202291,445.369863,27,0
0,0,57,57,26,46,72,327,210,537,0.000333,1.104417,52,172288.9857,9571.610319,3313.249726,376.295283,25,0
0,0,26,26,23,29,52,167,114,281,0.000333,0.533941,33,52860.17751,2936.676528,1601.823561,244.923374,10,0
0,0,28,28,23,29,52,175,120,295,0.000333,0.560543,44,73991.70754,4110.650419,1681.629717,244.923374,10,0
0,0,11,11,21,26,47,92,56,148,0.000333,0.274026,20,16441.583,913.421278,822.07915,214.450099,6,0
0,0,11,11,21,26,47,92,56,148,0.000333,0.274026,20,16441.583,913.421278,822.07915,214.450099,6,0
0,0,18,18,20,26,46,106,61,167,0.000333,0.307478,20,18448.69693,1024.927607,922.434847,208.649995,7,0
0,0,2,2,8,9,17,9,13,22,0.000333,0.029975,4,359.69673,19.983152,89.924183,52.529325,1,0
0,0,2,2,8,9,17,9,13,22,0.000333,0.029975,4,359.69673,19.983152,89.924183,52.529325,1,0
0,0,8,8,15,16,31,44,33,77,0.000333,0.127158,14,5340.623623,296.701312,381.473116,122.603359,2,0
0,0,12,12,14,20,34,63,39,102,0.000333,0.172974,7,3632.448469,201.802693,518.92121,139.741531,9,0
0,0,52,52,29,56,85,425,242,667,0.000333,1.425021,56,239403.5702,13300.19835,4275.063754,466.093324,25,0
0,0,17,17,21,21,42,98,61,159,0.000333,0.285793,20,17147.5694,952.642745,857.37847,184.477332,5,0
0,0,18,18,15,25,40,103,57,160,0.000333,0.283836,14,11921.11893,662.284385,851.508495,174.699764,7,0
0,0,18,18,15,25,40,104,57,161,0.000333,0.28561,14,11995.62593,666.423663,856.830423,174.699764,7,0
0,0,16,16,16,27,43,170,88,258,0.000333,0.466659,24,33599.43136,1866.635076,1399.976307,192.381963,8,0
0,0,15,15,16,25,41,166,84,250,0.000333,0.446463,24,32145.31203,1785.850668,1339.388001,180.096405,8,0
0,0,18,18,15,25,40,103,57,160,0.000333,0.283836,14,11921.11893,662.284385,851.508495,174.699764,7,0
0,0,18,18,15,25,40,104,57,161,0.000333,0.28561,14,11995.62593,666.423663,856.830423,174.699764,7,0
0,0,60,60,30,39,69,419,256,675,0.000333,1.374418,90,371092.8607,20616.27004,4123.254008,353.337404,37,0
0,0,37,37,29,44,73,272,177,449,0.000333,0.92641,56,155636.9487,8646.49715,2779.231227,381.09644,14,0
0,0,21,21,20,25,45,101,83,184,0.000333,0.336834,30,30315.02909,1684.168283,1010.50097,202.534967,13,0
0,0,46,46,28,39,67,413,205,618,0.000333,1.249614,70,262419.0184,14578.83435,3748.84312,340.736624,13,0
0,0,81,81,29,60,89,484,321,805,0.000333,1.737655,70,364907.5788,20272.64327,5212.965412,495.294885,31,0
0,0,74,74,29,54,83,438,291,729,0.000333,1.549135,70,325318.2622,18073.23679,4647.403745,451.645374,30,0
0,0,70,70,29,56,85,420,280,700,0.000333,1.495525,70,314060.1559,17447.78644,4486.573655,466.093324,27,0
0,0,63,63,29,50,79,374,250,624,0.000333,1.311186,70,275349.1431,15297.17462,3933.559187,423.074258,26,0
0,0,66,66,28,55,83,400,263,663,0.000333,1.408884,56,236692.464,13149.58133,4226.651143,452.580722,27,0
0,0,66,66,28,54,82,404,265,669,0.000333,1.417734,56,238179.3283,13232.18491,4253.202291,445.369863,27,0
0,0,57,57,26,46,72,327,210,537,0.000333,1.104417,52,172288.9857,9571.610319,3313.249726,376.295283,25,0
0,0,26,26,23,29,52,167,114,281,0.000333,0.533941,33,52860.17751,2936.676528,1601.823561,244.923374,10,0
0,0,28,28,23,29,52,175,120,295,0.000333,0.560543,44,73991.70754,4110.650419,1681.629717,244.923374,10,0
0,0,11,11,21,26,47,92,56,148,0.000333,0.274026,20,16441.583,913.421278,822.07915,214.450099,6,0
0,0,11,11,21,26,47,92,56,148,0.000333,0.274026,20,16441.583,913.421278,822.07915,214.450099,6,0
0,0,18,18,15,25,40,103,57,160,0.000333,0.283836,14,11921.11893,662.284385,851.508495,174.699764,7,0
0,0,18,18,15,25,40,104,57,161,0.000333,0.28561,14,11995.62593,666.423663,856.830423,174.699764,7,0
0,0,51,51,26,53,79,318,177,495,0.000333,1.040124,39,121694.4873,6760.804852,3120.37147,425.791217,19,0
0,0,24,24,21,21,42,164,87,251,0.000333,0.451157,40,54138.86693,3007.714829,1353.471673,184.477332,12,0
0,0,18,18,15,25,40,103,57,160,0.000333,0.283836,14,11921.11893,662.284385,851.508495,174.699764,7,0
0,0,18,18,15,25,40,104,57,161,0.000333,0.28561,14,11995.62593,666.423663,856.830423,174.699764,7,0
0,0,77,77,37,106,143,544,420,964,0.000333,2.300705,54,372714.2623,20706.34791,6902.115969,905.909343,28,0
0,0,12,12,14,20,34,63,39,102,0.000333,0.172974,7,3632.448469,201.802693,518.92121,139.741531,9,0
0,0,12,12,14,20,34,63,39,102,0.000333,0.172974,7,3632.448469,201.802693,518.92121,139.741531,9,0
0,0,77,77,29,53,82,503,314,817,0.000333,1.731373,70,363588.3991,20199.35551,5194.119988,444.461233,30,0
0,0,55,55,28,49,77,354,228,582,0.000333,1.215757,56,204247.1069,11347.0615,3647.269767,409.72672,20,0
0,0,41,41,22,40,62,274,172,446,0.000333,0.885191,44,116845.1484,6491.397133,2655.571554,310.984619,16,0
0,0,18,18,15,25,40,103,57,160,0.000333,0.283836,14,11921.11893,662.284385,851.508495,174.699764,7,0
0,0,18,18,15,25,40,104,57,161,0.000333,0.28561,14,11995.62593,666.423663,856.830423,174.699764,7,0
0,0,10,10,11,16,27,73,44,117,0.000333,0.185441,10,5563.218378,309.067688,556.321838,102.053748,4,0
0,0,10,10,10,16,26,67,41,108,0.000333,0.169216,10,5076.474896,282.026383,507.64749,97.219281,3,0
0,0,10,10,10,16,26,71,41,112,0.000333,0.175483,10,5264.492484,292.471805,526.449248,97.219281,3,0
0,0,10,10,10,16,26,67,41,108,0.000333,0.169216,10,5076.474896,282.026383,507.64749,97.219281,3,0
0,0,10,10,10,16,26,71,41,112,0.000333,0.175483,10,5264.492484,292.471805,526.449248,97.219281,3,0
0,0,10,10,10,16,26,67,41,108,0.000333,0.169216,10,5076.474896,282.026383,507.64749,97.219281,3,0
0,0,10,10,10,16,26,67,41,108,0.000333,0.169216,10,5076.474896,282.026383,507.64749,97.219281,3,0
0,0,10,10,10,16,26,67,41,108,0.000333,0.169216,10,5076.474896,282.026383,507.64749,97.219281,3,0
0,0,12,12,14,20,34,63,39,102,0.000333,0.172974,7,3632.448469,201.802693,518.92121,139.741531,9,0
0,0,18,18,17,27,44,83,54,137,0.000333,0.249314,16,11967.07411,664.83745,747.942132,197.868831,10,0
0,0,18,18,18,13,31,94,42,136,0.000333,0.22459,27,18191.80885,1010.656047,673.770698,123.164366,11,0
0,0,55,55,21,39,60,266,186,452,0.000333,0.889972,40,106796.582,5933.143443,2669.914549,298.369352,6,0
0,0,21,21,20,32,52,143,86,229,0.000333,0.435134,20,26108.01391,1450.445217,1305.400695,246.438562,4,0
0,0,53,53,29,47,76,267,183,450,0.000333,0.937189,42,118085.83,6560.323889,2811.567381,401.947125,20,0
0,0,12,12,20,13,33,72,55,127,0.000333,0.213546,40,25625.52213,1423.640118,640.638053,134.544278,5,0
0,0,44,44,32,46,78,279,187,466,0.000333,0.976332,64,187455.8358,10414.2131,2928.997434,414.08385,17,0
0,0,13,13,18,19,37,89,68,157,0.000333,0.272628,27,22082.87282,1226.826268,817.884178,155.769273,7,0
0,0,15,15,19,20,39,96,72,168,0.000333,0.295983,27,23974.58447,1331.921359,887.947573,167.149185,8,0
0,0,45,45,33,53,86,296,200,496,0.000333,1.062476,48,152996.5113,8499.806182,3187.427318,470.04479,19,0
0,0,14,14,20,21,41,94,70,164,0.000333,0.29288,30,26359.15586,1464.397548,878.638529,178.677228,8,0
0,0,12,12,14,20,34,63,39,102,0.000333,0.172974,7,3632.448469,201.802693,518.92121,139.741531,9,0
0,0,18,18,15,25,40,103,57,160,0.000333,0.283836,14,11921.11893,662.284385,851.508495,174.699764,7,0
0,0,18,18,15,25,40,104,57,161,0.000333,0.28561,14,11995.62593,666.423663,856.830423,174.699764,7,0
0,0,13,13,14,29,43,69,44,113,0.000333,0.204389,7,4292.175421,238.45419,613.167917,194.184418,8,0
0,0,21,21,20,30,50,138,93,231,0.000333,0.434577,30,39111.9234,2172.884633,1303.73078,233.64528,9,0
0,0,60,60,30,39,69,419,256,675,0.000333,1.374418,90,371092.8607,20616.27004,4123.254008,353.337404,37,0
0,0,37,37,29,44,73,272,177,449,0.000333,0.92641,56,155636.9487,8646.49715,2779.231227,381.09644,14,0
0,0,21,21,20,25,45,101,83,184,0.000333,0.336834,30,30315.02909,1684.168283,1010.50097,202.534967,13,0
0,0,46,46,28,39,67,413,205,618,0.000333,1.249614,70,262419.0184,14578.83435,3748.84312,340.736624,13,0
0,0,78,78,29,59,88,472,312,784,0.000333,1.688065,70,354493.6072,19694.08929,5064.194389,487.957389,31,0
0,0,71,71,29,53,82,426,282,708,0.000333,1.500382,70,315080.2773,17504.45985,4501.146819,444.461233,30,0
0,0,67,67,29,55,84,408,271,679,0.000333,1.446795,56,243061.4777,13503.41543,4340.38353,458.856233,27,0
0,0,60,60,29,49,78,362,241,603,0.000333,1.263366,56,212245.4621,11791.41456,3790.097538,416.002231,26,0
0,0,63,63,28,54,82,388,254,642,0.000333,1.360516,56,228566.7097,12698.15054,4081.548387,445.369863,27,0
0,0,63,63,28,53,81,392,256,648,0.000333,1.369408,56,230060.4769,12781.13761,4108.222802,438.185722,27,0
0,0,54,54,26,45,71,315,201,516,0.000333,1.057757,52,165010.0147,9167.223039,3173.269514,369.344822,25,0
0,0,26,26,23,29,52,167,114,281,0.000333,0.533941,33,52860.17751,2936.676528,1601.823561,244.923374,10,0
0,0,28,28,23,29,52,175,120,295,0.000333,0.560543,44,73991.70754,4110.650419,1681.629717,244.923374,10,0
0,0,11,11,21,26,47,92,56,148,0.000333,0.274026,20,16441.583,913.421278,822.07915,214.450099,6,0
0,0,11,11,21,26,47,92,56,148,0.000333,0.274026,20,16441.583,913.421278,822.07915,214.450099,6,0
0,0,48,48,34,48,82,378,322,700,0.000333,1.483429,102,453929.2131,25218.28962,4450.286403,441.051937,37,0
0,0,50,50,34,50,84,401,338,739,0.000333,1.574641,102,481840.1027,26768.89459,4723.922575,455.166546,42,0
0,0,45,45,33,45,78,354,302,656,0.000333,1.374408,96,395829.4901,21990.52723,4123.223856,413.598395,33,0
0,0,47,47,33,48,81,377,318,695,0.000333,1.468732,96,422994.7922,23499.71068,4406.195752,434.543206,38,0
0,0,53,53,36,77,113,475,339,814,0.000333,1.850542,72,399717.0486,22206.5027,5551.625675,668.659864,53,0
0,0,63,63,33,66,99,551,441,992,0.000333,2.192107,96,631326.8896,35073.71609,6576.321767,565.395018,39,0
0,0,39,39,30,64,94,482,375,857,0.000333,1.872428,75,421296.1984,23405.34436,5617.282646,531.206718,38,0
0,0,11,11,18,30,48,168,116,284,0.000333,0.52871,27,42825.49246,2379.194025,1586.12935,222.265368,5,0
0,0,18,18,15,25,40,103,57,160,0.000333,0.283836,14,11921.11893,662.284385,851.508495,174.699764,7,0
0,0,18,18,15,25,40,104,57,161,0.000333,0.28561,14,11995.62593,666.423663,856.830423,174.699764,7,0
0,0,29,29,25,35,60,145,116,261,0.000333,0.513899,36,55501.14404,3083.396891,1541.698445,295.62131,14,0
0,0,59,59,27,51,78,267,217,484,0.000333,1.014045,52,158191.003,8788.389058,3042.134674,417.675655,31,0
0,0,51,51,22,51,73,246,201,447,0.000333,0.922284,33,91306.10207,5072.561226,2766.851578,387.401188,29,0
0,0,52,52,24,51,75,258,205,463,0.000333,0.961314,48,138429.2666,7690.51481,2883.943054,399.332792,31,0
0,0,74,74,30,60,90,374,295,669,0.000333,1.447683,60,260582.9833,14476.83241,4343.049721,501.620154,39,0
0,0,66,66,25,60,85,353,279,632,0.000333,1.350245,48,194435.2834,10801.96019,4050.735072,470.50984,37,0
0,0,67,67,26,60,86,365,283,648,0.000333,1.388073,52,216539.4172,12029.96762,4164.219561,476.624868,39,0
0,0,78,78,29,65,94,403,316,719,0.000333,1.570916,56,263913.9655,14661.88697,4712.749384,532.335357,44,0
0,0,70,70,24,65,89,382,300,682,0.000333,1.47215,48,211989.6096,11777.20053,4416.4502,501.493008,42,0
0,0,71,71,25,65,90,394,304,698,0.000333,1.510438,48,217503.0461,12083.50256,4531.313461,507.550313,44,0
0,0,80,80,32,60,92,409,303,712,0.000333,1.548259,80,371582.089,20643.44939,4644.776113,514.413436,29,0
0,0,78,78,33,71,104,433,322,755,0.000333,1.686277,64,323765.2472,17986.95818,5058.831987,603.097051,29,0
0,0,79,79,33,71,104,438,326,764,0.000333,1.706379,64,327624.7005,18201.37225,5119.135945,603.097051,29,0
0,0,60,60,23,46,69,355,249,604,0.000333,1.22985,55,202925.1825,11273.62125,3689.548772,358.125775,27,0
0,0,25,25,16,25,41,116,96,212,0.000333,0.3786,24,27259.2246,1514.401367,1135.801025,180.096405,15,0
0,0,30,30,18,30,48,145,118,263,0.000333,0.489615,27,39658.81872,2203.267707,1468.845138,222.265368,20,0
0,0,25,25,16,26,42,115,93,208,0.000333,0.373867,24,26918.44858,1495.469365,1121.602024,186.211433,14,0
0,0,42,42,21,36,57,195,156,351,0.000333,0.682448,40,81893.7758,4549.654211,2047.344395,278.355966,23,0
0,0,79,79,24,55,79,455,318,773,0.000333,1.624274,60,292369.3511,16242.74173,4872.822518,428.013884,31,0
0,0,18,18,15,25,40,103,57,160,0.000333,0.283836,14,11921.11893,662.284385,851.508495,174.699764,7,0
0,0,18,18,15,25,40,104,57,161,0.000333,0.28561,14,11995.62593,666.423663,856.830423,174.699764,7,0
0,0,42,42,16,51,67,269,209,478,0.000333,0.96653,32,92786.90026,5154.827792,2899.590633,353.293692,9,0
0,0,36,36,19,44,63,261,194,455,0.000333,0.906554,36,97907.84515,5439.32473,2719.662365,320.925614,7,0
0,0,35,35,18,44,62,256,190,446,0.000333,0.885191,36,95600.57596,5311.143109,2655.571554,315.273641,6,0
0,0,14,14,17,17,34,87,68,155,0.000333,0.262852,32,25233.81569,1401.87865,788.55674,138.973737,5,0
0,0,12,12,14,17,31,76,57,133,0.000333,0.219636,21,13837.0703,768.726127,658.908109,122.789837,4,0
0,0,12,12,14,19,33,74,56,130,0.000333,0.21859,14,9180.797297,510.044294,655.771236,134.013592,4,0
0,0,19,19,19,25,44,101,78,179,0.000333,0.325746,27,26385.43301,1465.85739,977.23826,196.807027,6,0
0,0,13,13,14,17,31,76,55,131,0.000333,0.216333,21,13628.99405,757.166336,648.999717,122.789837,5,0
0,0,12,12,13,18,31,75,57,132,0.000333,0.217985,18,11771.17043,653.953913,653.953913,123.164366,4,0
0,0,25,25,25,30,55,167,132,299,0.000333,0.576209,48,82974.07461,4609.670812,1728.626554,263.303123,24,0
0,0,10,10,12,15,27,57,45,102,0.000333,0.161666,18,8729.973454,484.998525,484.998525,101.622909,3,0
0,0,19,19,23,24,47,118,89,207,0.000333,0.383267,33,37943.39645,2107.966469,1149.799892,214.081025,7,0
0,0,20,20,26,27,53,128,92,220,0.000333,0.420048,39,49145.5575,2730.30875,1260.1425,250.593395,8,0
0,0,21,21,20,24,44,124,94,218,0.000333,0.396719,30,35704.68279,1983.593488,1190.156093,196.477662,8,0
0,0,14,14,14,22,36,89,69,158,0.000333,0.272283,21,17153.81116,952.989509,816.84815,151.410465,4,0
0,0,14,14,15,23,38,89,70,159,0.000333,0.27814,21,17522.82997,973.490554,834.420475,162.645284,4,0
0,0,14,14,14,18,32,91,69,160,0.000333,0.266667,21,16800,933.333333,800,128.361619,4,0
0,0,14,14,14,22,36,89,69,158,0.000333,0.272283,21,17153.81116,952.989509,816.84815,151.410465,4,0
0,0,14,14,15,23,38,89,70,159,0.000333,0.27814,21,17522.82997,973.490554,834.420475,162.645284,4,0
0,0,14,14,14,22,36,90,70,160,0.000333,0.275729,21,17370.94801,965.052667,827.188,151.410465,4,0
0,0,14,14,14,23,37,90,71,161,0.000333,0.279574,21,17613.16183,978.508991,838.721992,157.344894,4,0
0,0,14,14,14,23,37,93,71,164,0.000333,0.284783,21,17941.35739,996.742077,854.350352,157.344894,4,0
0,0,14,14,15,24,39,93,72,165,0.000333,0.290697,21,18313.91869,1017.439927,872.091366,168.642459,4,0
0,0,14,14,14,20,34,90,69,159,0.000333,0.269636,21,16987.03843,943.724357,808.906592,139.741531,4,0
0,0,14,14,14,23,37,93,71,164,0.000333,0.284783,21,17941.35739,996.742077,854.350352,157.344894,4,0
0,0,14,14,15,24,39,93,72,165,0.000333,0.290697,21,18313.91869,1017.439927,872.091366,168.642459,4,0
0,0,14,14,14,23,37,93,71,164,0.000333,0.284783,21,17941.35739,996.742077,854.350352,157.344894,4,0
0,0,14,14,15,24,39,93,72,165,0.000333,0.290697,21,18313.91869,1017.439927,872.091366,168.642459,4,0
0,0,14,14,14,22,36,90,70,160,0.000333,0.275729,21,17370.94801,965.052667,827.188,151.410465,4,0
0,0,14,14,14,23,37,90,71,161,0.000333,0.279574,21,17613.16183,978.508991,838.721992,157.344894,4,0
0,0,14,14,14,23,37,93,71,164,0.000333,0.284783,21,17941.35739,996.742077,854.350352,157.344894,4,0
0,0,14,14,15,24,39,93,72,165,0.000333,0.290697,21,18313.91869,1017.439927,872.091366,168.642459,4,0
0,0,30,30,22,37,59,154,118,272,0.000333,0.53336,33,52802.60401,2933.478001,1600.078909,290.85727,9,0
0,0,30,30,23,39,62,159,123,282,0.000333,0.559694,33,55409.75086,3078.319492,1679.08336,310.172612,9,0
0,0,14,14,14,23,37,85,67,152,0.000333,0.263946,14,11085.71676,615.873153,791.836912,157.344894,4,0
0,0,14,14,14,21,35,84,69,153,0.000333,0.261593,21,16480.38633,915.577019,784.780302,145.541635,4,0
0,0,31,31,23,42,65,166,132,298,0.000333,0.598222,33,59223.96507,3290.220282,1794.665608,330.519257,9,0
0,0,30,30,22,38,60,155,118,273,0.000333,0.537527,33,53215.17738,2956.398743,1612.581133,297.528741,9,0
0,0,30,30,23,40,63,160,123,283,0.000333,0.563857,33,55821.81721,3101.212067,1691.570218,316.919049,9,0
0,0,14,14,15,22,37,86,67,153,0.000333,0.265682,21,16737.97366,929.887426,797.046365,156.710855,4,0
0,0,14,14,15,20,35,85,69,154,0.000333,0.263303,21,16588.10128,921.561182,789.909585,145.041921,4,0
0,0,31,31,23,43,66,167,132,299,0.000333,0.602425,33,59640.03678,3313.335376,1807.273842,337.371309,9,0
0,0,13,13,13,14,27,67,51,118,0.000333,0.187026,18,10099.38106,561.076725,561.076725,101.408685,4,0
0,0,14,14,17,21,38,86,65,151,0.000333,0.264146,24,19018.48931,1056.582739,792.437055,161.725534,5,0
0,0,15,15,20,25,45,96,68,164,0.000333,0.300221,20,18013.27816,1000.737675,900.663908,202.534967,6,0
0,0,16,16,15,22,37,92,70,162,0.000333,0.28131,21,17722.56035,984.586686,843.931445,156.710855,6,0
0,0,19,19,23,26,49,128,107,235,0.000333,0.439819,44,58056.09979,3225.338877,1319.456813,226.253358,22,0
0,0,16,16,22,21,43,88,79,167,0.000333,0.302062,33,29904.14506,1661.341392,906.186214,190.346161,11,0
0,0,17,17,22,25,47,119,98,217,0.000333,0.401782,33,39776.41077,2209.800598,1205.345781,214.2039,20,0
0,0,24,24,24,28,52,160,125,285,0.000333,0.541542,48,77982.01534,4332.334186,1624.62532,244.645038,22,0
0,0,20,20,22,27,49,147,113,260,0.000333,0.486608,44,64232.28062,3568.460034,1459.824559,226.489458,19,0
0,0,33,33,20,33,53,188,148,336,0.000333,0.641527,40,76983.25091,4276.847273,1924.581273,252.903568,17,0
0,0,49,49,23,35,58,259,199,458,0.000333,0.894318,55,147562.5413,8197.918959,2682.955296,283.566831,23,0
0,0,44,44,27,42,69,280,221,501,0.000333,1.020124,65,198924.0989,11051.33883,3060.370753,354.859294,35,0
0,0,44,44,20,34,54,231,175,406,0.000333,0.778828,50,116824.2163,6490.234239,2336.484326,259.412299,23,0
0,0,61,61,23,37,60,298,227,525,0.000333,1.033706,66,204673.7591,11370.7644,3101.117563,296.7917,29,0
0,0,32,32,22,33,55,179,141,320,0.000333,0.616678,44,81401.54477,4522.308043,1850.035108,264.572502,14,0
0,0,34,34,24,34,58,206,156,362,0.000333,0.706863,48,101788.2778,5654.904321,2120.58912,283.012837,17,0
0,0,32,32,22,33,55,176,138,314,0.000333,0.605116,44,79875.2658,4437.514767,1815.34695,264.572502,15,0
0,0,37,37,24,34,58,223,164,387,0.000333,0.75568,48,108817.855,6045.436387,2267.038645,283.012837,19,0
0,0,32,32,22,33,55,179,141,320,0.000333,0.616678,44,81401.54477,4522.308043,1850.035108,264.572502,14,0
0,0,32,32,22,34,56,182,142,324,0.000333,0.627194,44,82789.65177,4599.425098,1881.582995,271.081232,16,0
0,0,36,36,22,34,56,194,156,350,0.000333,0.677525,44,89433.2658,4968.514767,2032.574223,271.081232,14,0
0,0,35,35,22,34,56,190,153,343,0.000333,0.663974,44,87644.60048,4869.144471,1991.922738,271.081232,14,0
0,0,44,44,24,51,75,250,202,452,0.000333,0.938475,36,101355.3377,5630.852096,2815.426048,399.332792,20,0
0,0,35,35,22,33,55,190,153,343,0.000333,0.661002,44,87252.2808,4847.348933,1983.006382,264.572502,14,0
0,0,35,35,22,34,56,188,153,341,0.000333,0.660103,44,87133.55325,4840.752958,1980.308028,271.081232,14,0
0,0,34,34,21,34,55,184,150,334,0.000333,0.643658,40,77238.96577,4291.053654,1930.974144,265.212402,14,0
0,0,43,43,23,51,74,244,199,443,0.000333,0.916929,33,90775.99875,5043.111042,2750.787841,393.335617,20,0
0,0,34,34,21,33,54,184,150,334,0.000333,0.640711,40,76885.29703,4271.40539,1922.132426,258.703672,14,0
0,0,36,36,22,34,56,194,156,350,0.000333,0.677525,44,89433.2658,4968.514767,2032.574223,271.081232,14,0
0,0,44,44,24,51,75,250,202,452,0.000333,0.938475,36,101355.3377,5630.852096,2815.426048,399.332792,20,0
0,0,35,35,22,33,55,189,152,341,0.000333,0.657148,44,86743.52114,4819.084508,1971.443662,264.572502,14,0
0,0,35,35,22,33,55,189,152,341,0.000333,0.657148,44,86743.52114,4819.084508,1971.443662,264.572502,14,0
0,0,35,35,22,33,55,187,152,339,0.000333,0.653294,44,86234.76149,4790.820083,1959.880943,264.572502,14,0
0,0,43,43,23,50,73,243,198,441,0.000333,0.909904,33,90080.51681,5004.473156,2729.71263,386.234734,20,0
0,0,34,34,20,32,52,182,148,330,0.000333,0.627048,40,75245.80428,4180.32246,1881.145107,246.438562,14,0
0,0,34,34,20,32,52,182,148,330,0.000333,0.627048,40,75245.80428,4180.32246,1881.145107,246.438562,14,0
0,0,45,45,21,39,60,235,187,422,0.000333,0.830903,40,99708.31325,5539.350736,2492.707831,298.369352,19,0
0,0,47,47,23,35,58,243,186,429,0.000333,0.837691,55,138219.0616,7678.836754,2513.073847,283.566831,23,0
0,0,42,42,27,42,69,264,208,472,0.000333,0.961075,52,149927.6243,8329.312459,2883.223544,354.859294,35,0
0,0,42,42,20,34,54,215,162,377,0.000333,0.723198,40,86783.70353,4821.316863,2169.592588,259.412299,23,0
0,0,59,59,23,37,60,282,214,496,0.000333,0.976606,55,161139.9754,8952.220858,2929.817735,296.7917,29,0
0,0,30,30,22,33,55,163,128,291,0.000333,0.560792,33,55518.39733,3084.355407,1682.375677,264.572502,14,0
0,0,32,32,24,34,58,190,143,333,0.000333,0.650236,48,93633.96823,5201.887124,1950.707671,283.012837,17,0
0,0,30,30,22,33,55,160,125,285,0.000333,0.549229,33,54373.68811,3020.76045,1647.687518,264.572502,15,0
0,0,35,35,24,34,58,207,151,358,0.000333,0.699052,48,100663.5454,5592.41919,2097.157196,283.012837,19,0
0,0,30,30,22,33,55,163,128,291,0.000333,0.560792,33,55518.39733,3084.355407,1682.375677,264.572502,14,0
0,0,30,30,22,34,56,166,129,295,0.000333,0.571057,33,56534.60017,3140.81112,1713.169702,271.081232,16,0
0,0,34,34,22,34,56,178,143,321,0.000333,0.621387,44,82023.08092,4556.837829,1864.16093,271.081232,14,0
0,0,33,33,22,34,56,174,140,314,0.000333,0.607836,44,80234.4156,4457.467534,1823.509446,271.081232,14,0
0,0,42,42,24,51,75,234,189,423,0.000333,0.878263,36,94852.45102,5269.580612,2634.790306,399.332792,20,0
0,0,33,33,22,33,55,174,140,314,0.000333,0.605116,44,79875.2658,4437.514767,1815.34695,264.572502,14,0
0,0,33,33,22,34,56,172,140,312,0.000333,0.603965,44,79723.36837,4429.076021,1811.894736,271.081232,14,0
0,0,32,32,21,34,55,168,137,305,0.000333,0.587772,40,70532.58851,3918.477139,1763.314713,265.212402,14,0
0,0,41,41,23,51,74,228,186,414,0.000333,0.856905,33,84833.55188,4712.975105,2570.713693,393.335617,20,0
0,0,32,32,21,33,54,168,137,305,0.000333,0.58508,40,70209.62753,3900.534863,1755.240688,258.703672,14,0
0,0,34,34,22,34,56,178,143,321,0.000333,0.621387,44,82023.08092,4556.837829,1864.16093,271.081232,14,0
0,0,42,42,24,51,75,234,189,423,0.000333,0.878263,36,94852.45102,5269.580612,2634.790306,399.332792,20,0
0,0,33,33,22,33,55,173,139,312,0.000333,0.601261,44,79366.50615,4409.250342,1803.784231,264.572502,14,0
0,0,33,33,22,33,55,173,139,312,0.000333,0.601261,44,79366.50615,4409.250342,1803.784231,264.572502,14,0
0,0,33,33,22,33,55,171,139,310,0.000333,0.597407,44,78857.74649,4380.985916,1792.221511,264.572502,14,0
0,0,41,41,23,50,73,227,185,412,0.000333,0.850069,33,84156.8547,4675.380817,2550.207718,386.234734,20,0
0,0,32,32,20,32,52,166,135,301,0.000333,0.571944,40,68633.29421,3812.960789,1715.832355,246.438562,14,0
0,0,32,32,20,32,52,166,135,301,0.000333,0.571944,40,68633.29421,3812.960789,1715.832355,246.438562,14,0
0,0,4,4,9,11,20,35,23,58,0.000333,0.083557,8,2005.374636,111.409702,250.67183,66.583073,1,0
0,0,23,23,17,22,39,104,81,185,0.000333,0.325933,24,23467.18585,1303.732547,977.79941,167.594364,11,0
0,0,75,75,25,44,69,366,279,645,0.000333,1.313333,72,283679.8758,15759.9931,3939.998275,356.311396,31,0
0,0,61,61,22,42,64,310,236,546,0.000333,1.092,55,180180,10010,3276,324.584827,25,0
0,0,59,59,22,42,64,297,225,522,0.000333,1.044,55,172260,9570,3132,324.584827,25,0
0,0,32,32,19,35,54,179,147,326,0.000333,0.625364,36,67539.35973,3752.186651,1876.093326,260.235528,16,0
0,0,48,48,24,40,64,250,198,448,0.000333,0.896,48,129024,7168,2688,322.916224,22,0
0,0,41,41,26,42,68,261,208,469,0.000333,0.951673,52,148461.0438,8247.835765,2855.020073,348.688764,34,0
0,0,29,29,19,30,49,160,127,287,0.000333,0.537141,36,58011.18211,3222.843451,1611.421725,227.917341,14,0
0,0,27,27,19,29,48,155,125,280,0.000333,0.521263,36,56296.42201,3127.579,1563.7895,221.592072,13,0
0,0,26,26,16,36,52,197,152,349,0.000333,0.663151,32,63662.51077,3536.806154,1989.453462,250.1173,6,0
0,0,23,23,17,37,54,209,155,364,0.000333,0.69826,32,67032.92963,3724.051646,2094.779051,262.236643,5,0
0,0,24,24,15,28,43,115,92,207,0.000333,0.374412,21,23587.97289,1310.442938,1123.236804,193.209297,6,0
0,0,22,22,15,27,42,110,86,196,0.000333,0.352298,21,22194.77851,1233.043251,1056.894215,186.985321,6,0
0,0,21,21,15,27,42,109,84,193,0.000333,0.346906,21,21855.06252,1214.17014,1040.717263,186.985321,6,0
0,0,19,19,15,25,40,107,79,186,0.000333,0.32996,21,20787.45114,1154.858397,989.878626,174.699764,6,0
0,0,24,24,21,31,52,135,100,235,0.000333,0.446534,30,40188.10001,2232.672223,1339.603334,245.818752,9,0
0,0,22,22,20,31,51,125,94,219,0.000333,0.414087,30,37267.8345,2070.43525,1242.26115,240.018648,8,0
0,0,25,25,22,38,60,160,106,266,0.000333,0.523744,22,34567.12377,1920.395765,1571.232898,297.528741,12,0
0,0,23,23,22,37,59,129,96,225,0.000333,0.441198,22,29119.08309,1617.726839,1323.594686,290.85727,12,0
0,0,24,24,22,37,59,136,99,235,0.000333,0.460807,22,30413.26457,1689.625809,1382.421117,290.85727,13,0
0,0,23,23,22,37,59,129,96,225,0.000333,0.441198,22,29119.08309,1617.726839,1323.594686,290.85727,12,0
0,0,31,31,17,35,52,136,109,245,0.000333,0.465536,24,33518.58554,1862.143641,1396.607731,249.011774,8,0
0,0,27,27,15,34,49,117,94,211,0.000333,0.394901,14,16585.85288,921.436271,1184.703777,231.577096,9,0
0,0,26,26,15,34,49,110,91,201,0.000333,0.376186,14,15799.7935,877.766306,1128.556679,231.577096,8,0
0,0,18,18,15,25,40,103,57,160,0.000333,0.283836,14,11921.11893,662.284385,851.508495,174.699764,7,0
0,0,18,18,15,25,40,104,57,161,0.000333,0.28561,14,11995.62593,666.423663,856.830423,174.699764,7,0
0,0,50,50,34,50,84,401,338,739,0.000333,1.574641,102,481840.1027,26768.89459,4723.922575,455.166546,42,0
0,0,48,48,34,48,82,378,322,700,0.000333,1.483429,102,453929.2131,25218.28962,4450.286403,441.051937,37,0
0,0,47,47,33,48,81,377,318,695,0.000333,1.468732,96,422994.7922,23499.71068,4406.195752,434.543206,38,0
0,0,45,45,33,45,78,354,302,656,0.000333,1.374408,96,395829.4901,21990.52723,4123.223856,413.598395,33,0
0,0,53,53,36,77,113,475,339,814,0.000333,1.850542,72,399717.0486,22206.5027,5551.625675,668.659864,53,0
0,0,12,12,14,20,34,63,39,102,0.000333,0.172974,7,3632.448469,201.802693,518.92121,139.741531,9,0
0,0,26,26,18,34,52,141,80,221,0.000333,0.419932,18,22676.3492,1259.797178,1259.797178,248.032387,14,0
0,0,18,18,15,25,40,103,57,160,0.000333,0.283836,14,11921.11893,662.284385,851.508495,174.699764,7,0
0,0,18,18,15,25,40,104,57,161,0.000333,0.28561,14,11995.62593,666.423663,856.830423,174.699764,7,0
0,0,60,60,30,44,74,357,208,565,0.000333,1.169447,60,210500.4691,11694.47051,3508.341152,387.421709,42,0
0,0,30,30,27,45,72,191,122,313,0.000333,0.643729,26,50210.84966,2789.491648,1931.186525,375.515352,28,0
0,0,18,18,20,26,46,113,92,205,0.000333,0.377443,30,33969.90603,1887.217002,1132.330201,208.649995,8,0
0,0,10,10,15,14,29,47,38,85,0.000333,0.137643,14,5780.997384,321.166521,412.928385,111.906328,3,0
0,0,80,80,28,83,111,511,410,921,0.000333,2.085886,56,350428.7927,19468.26626,6257.657013,663.734211,58,0
0,0,86,86,28,83,111,540,432,972,0.000333,2.201391,70,462292.0555,25682.89198,6604.172222,663.734211,64,0
0,0,80,80,27,80,107,504,409,913,0.000333,2.051653,65,400072.3583,22226.24213,6154.959359,634.13621,60,0
0,0,57,57,30,50,80,286,233,519,0.000333,1.093694,60,196864.8409,10936.9356,3281.080681,429.399527,34,0
0,0,53,53,29,46,75,290,236,526,0.000333,1.09212,70,229345.1042,12741.39468,3276.358631,394.965299,36,0
0,0,45,45,29,41,70,223,187,410,0.000333,0.837669,56,140728.3381,7818.241004,2513.006037,360.541081,27,0
0,0,45,45,29,41,70,224,187,411,0.000333,0.839712,56,141071.5779,7837.309884,2519.13532,360.541081,27,0
0,0,54,54,28,54,82,328,269,597,0.000333,1.265153,56,212545.6786,11808.09326,3795.458547,445.369863,37,0
0,0,63,63,28,58,86,399,323,722,0.000333,1.546588,70,324783.4207,18043.52337,4639.763153,474.368836,44,0
0,0,26,26,21,18,39,150,64,214,0.000333,0.377025,30,33932.28225,1885.126791,1131.076075,167.297316,21,0
0,0,22,22,20,17,37,134,53,187,0.000333,0.324723,30,29225.03338,1623.612966,974.167779,155.92543,15,0
0,0,30,30,20,21,41,143,75,218,0.000333,0.389315,30,35038.39011,1946.577228,1167.946337,178.677228,14,0
0,0,12,12,14,20,34,63,39,102,0.000333,0.172974,7,3632.448469,201.802693,518.92121,139.741531,9,0
0,0,22,22,18,49,67,114,84,198,0.000333,0.400362,9,10809.77094,600.54283,1201.08566,350.179432,9,0
0,0,22,22,18,49,67,114,84,198,0.000333,0.400362,9,10809.77094,600.54283,1201.08566,350.179432,9,0
0,0,18,18,15,25,40,103,57,160,0.000333,0.283836,14,11921.11893,662.284385,851.508495,174.699764,7,0
0,0,18,18,15,25,40,104,57,161,0.000333,0.28561,14,11995.62593,666.423663,856.830423,174.699764,7,0
0,0,6,6,12,10,22,30,20,50,0.000333,0.074324,12,2675.658971,148.647721,222.971581,76.238831,4,0
0,0,15,15,16,18,34,72,55,127,0.000333,0.215369,24,15506.58674,861.477041,646.107781,139.05865,8,0
0,0,11,11,15,17,32,73,59,132,0.000333,0.22,21,13860,770,660,128.090227,11,0
0,0,18,18,20,31,51,104,87,191,0.000333,0.361144,20,21668.66481,1203.814711,1083.43324,240.018648,11,0
0,0,16,16,20,31,51,104,93,197,0.000333,0.372489,30,33524.03377,1862.446321,1117.467792,240.018648,9,0
0,0,12,12,16,24,40,81,67,148,0.000333,0.262548,16,12602.32573,700.129207,787.645358,174.0391,7,0
0,0,16,16,21,31,52,106,93,199,0.000333,0.378129,30,34031.62512,1890.64584,1134.387504,245.818752,9,0
0,0,31,31,23,29,52,175,105,280,0.000333,0.532041,33,52672.063,2926.225722,1596.123121,244.923374,9,0
0,0,25,25,22,28,50,138,88,226,0.000333,0.42517,33,42091.87946,2338.437748,1275.511499,232.713433,9,0
0,0,21,21,22,27,49,139,92,231,0.000333,0.432333,33,42800.93314,2377.829619,1296.997974,226.489458,12,0
0,0,28,28,24,41,65,170,120,290,0.000333,0.582162,24,41915.67998,2328.648888,1746.486666,329.698732,12,0
0,0,31,31,20,27,47,185,98,283,0.000333,0.523983,30,47158.45935,2619.914408,1571.948645,214.820524,19,0
0,0,25,25,19,25,44,153,83,236,0.000333,0.429475,27,34787.49827,1932.638793,1288.425862,196.807027,14,0
0,0,31,31,21,30,51,170,102,272,0.000333,0.5143,30,46286.99079,2571.499488,1542.899693,239.445384,13,0
0,0,26,26,26,41,67,170,126,296,0.000333,0.598521,39,70026.93362,3890.385201,1795.5624,341.871065,10,0
0,0,22,22,21,34,55,147,100,247,0.000333,0.475999,20,28559.91699,1586.662055,1427.995849,265.212402,8,0
0,0,26,26,26,41,67,172,126,298,0.000333,0.602565,39,70500.08857,3916.671587,1807.694579,341.871065,10,0
0,0,27,27,16,21,37,159,94,253,0.000333,0.439331,32,42175.73445,2343.096358,1317.991702,156.238666,18,0
0,0,48,48,29,52,81,309,201,510,0.000333,1.077775,42,135799.5871,7544.421503,3233.323501,437.304314,18,0
0,0,47,47,30,50,80,300,194,494,0.000333,1.041011,45,140536.4615,7807.581197,3123.032479,429.399527,19,0
0,0,48,48,30,53,83,311,201,512,0.000333,1.088007,45,146880.9085,8160.050472,3264.020189,450.786502,18,0
0,0,47,47,31,50,81,302,194,496,0.000333,1.048189,45,141505.4521,7861.414004,3144.565601,435.772895,19,0
0,0,18,18,15,25,40,103,57,160,0.000333,0.283836,14,11921.11893,662.284385,851.508495,174.699764,7,0
0,0,18,18,15,25,40,104,57,161,0.000333,0.28561,14,11995.62593,666.423663,856.830423,174.699764,7,0
0,0,18,18,15,25,40,103,57,160,0.000333,0.283836,14,11921.11893,662.284385,851.508495,174.699764,7,0
0,0,18,18,15,25,40,104,57,161,0.000333,0.28561,14,11995.62593,666.423663,856.830423,174.699764,7,0
0,0,42,42,24,77,101,267,208,475,0.000333,1.054217,24,75903.6109,4216.867272,3162.650454,592.581664,27,0
0,0,48,48,24,57,81,203,157,360,0.000333,0.760782,24,54776.30403,3043.128001,2282.346001,442.513831,25,0
0,0,48,48,27,67,94,276,199,475,0.000333,1.03781,26,80949.17232,4497.17624,3113.429705,534.809938,23,0
0,0,42,42,28,66,94,253,178,431,0.000333,0.941676,28,79100.77826,4394.487681,2825.027795,533.53595,20,0
0,0,44,44,28,67,95,258,184,442,0.000333,0.967959,28,81308.53301,4517.140723,2903.876179,541.033914,20,0
0,0,37,37,26,61,87,280,178,458,0.000333,0.983623,26,76722.57115,4262.365064,2950.868121,483.98641,12,0
0,0,91,91,29,89,118,494,350,844,0.000333,1.936317,42,243975.9308,13554.21838,5808.950734,717.221724,56,0
0,0,29,29,22,47,69,314,169,483,0.000333,0.983472,33,97363.77132,5409.098406,2950.417313,359.173172,6,0
0,0,29,29,22,47,69,314,169,483,0.000333,0.983472,33,97363.77132,5409.098406,2950.417313,359.173172,6,0
0,0,28,28,22,48,70,308,167,475,0.000333,0.97047,33,96076.51129,5337.583961,2911.409433,366.185696,6,0
0,0,28,28,22,48,70,308,167,475,0.000333,0.97047,33,96076.51129,5337.583961,2911.409433,366.185696,6,0
0,0,18,18,15,25,40,103,57,160,0.000333,0.283836,14,11921.11893,662.284385,851.508495,174.699764,7,0
0,0,18,18,15,25,40,104,57,161,0.000333,0.28561,14,11995.62593,666.423663,856.830423,174.699764,7,0
0,0,12,12,14,20,34,63,39,102,0.000333,0.172974,7,3632.448469,201.802693,518.92121,139.741531,9,0
0,0,13,13,19,22,41,79,54,133,0.000333,0.237518,18,12825.9795,712.554417,712.554417,178.818118,6,0
0,0,34,34,24,54,78,255,173,428,0.000333,0.896717,36,96845.47739,5380.304299,2690.15215,420.803025,11,0
0,0,45,45,24,54,78,249,161,410,0.000333,0.859005,24,61848.35783,3436.01988,2577.01491,420.803025,20,0
0,0,33,33,24,52,76,259,171,430,0.000333,0.895536,36,96717.91791,5373.217662,2686.608831,406.461965,11,0
0,0,19,19,23,34,57,121,86,207,0.000333,0.402469,22,26562.98113,1475.721174,1207.408233,277.015662,7,0
0,0,92,92,22,65,87,507,304,811,0.000333,1.741742,44,229909.9957,12772.77754,5225.227175,489.561403,40,0
0,0,15,15,19,26,45,105,76,181,0.000333,0.331342,18,17892.45739,994.02541,994.02541,202.922055,6,0
0,0,23,23,23,37,60,146,103,249,0.000333,0.490272,22,32357.94668,1797.663705,1470.815758,296.7917,9,0
0,0,18,18,22,38,60,144,91,235,0.000333,0.462706,22,30538.62438,1696.590243,1388.11929,297.528741,6,0
0,0,39,39,25,67,92,320,210,530,0.000333,1.152496,36,124469.5621,6914.975673,3457.487837,522.524381,11,0
0,0,50,50,26,68,94,314,198,512,0.000333,1.11865,26,87254.68679,4847.4826,3355.949492,536.158906,20,0
0,0,38,38,25,65,90,324,208,532,0.000333,1.151222,36,124331.9705,6907.331694,3453.665847,507.550313,11,0
0,0,24,24,25,50,75,186,123,309,0.000333,0.641568,24,46192.91941,2566.2733,1924.704975,398.289214,7,0
0,0,97,97,25,78,103,572,341,913,0.000333,2.034925,48,293029.1991,16279.39995,6104.774981,606.357778,40,0
0,0,20,20,22,42,64,170,113,283,0.000333,0.566,22,37356,2075.333333,1698,324.584827,6,0
0,0,28,28,25,53,78,211,140,351,0.000333,0.735392,24,52948.22829,2941.568238,2206.176179,419.676189,9,0
0,0,15,15,22,38,60,137,85,222,0.000333,0.43711,22,28849.25367,1602.736315,1311.329712,297.528741,6,0
0,0,36,36,25,67,92,313,204,517,0.000333,1.124227,36,121416.5351,6745.363063,3372.681531,522.524381,11,0
0,0,47,47,26,68,94,307,192,499,0.000333,1.090247,26,85039.23576,4724.401987,3270.739837,536.158906,20,0
0,0,35,35,25,65,90,317,202,519,0.000333,1.123091,36,121293.7833,6738.543514,3369.271757,507.550313,11,0
0,0,21,21,25,50,75,179,117,296,0.000333,0.614577,24,44249.52798,2458.30711,1843.730332,398.289214,7,0
0,0,94,94,25,78,103,565,335,900,0.000333,2.00595,48,288856.8228,16047.60127,6017.850474,606.357778,40,0
0,0,17,17,22,42,64,163,107,270,0.000333,0.54,22,35640,1980,1620,324.584827,6,0
0,0,25,25,25,53,78,204,134,338,0.000333,0.708155,24,50987.1828,2832.621267,2124.46595,419.676189,9,0
0,0,18,18,15,25,40,103,57,160,0.000333,0.283836,14,11921.11893,662.284385,851.508495,174.699764,7,0
0,0,18,18,15,25,40,104,57,161,0.000333,0.28561,14,11995.62593,666.423663,856.830423,174.699764,7,0
0,0,9,9,13,15,28,59,39,98,0.000333,0.15704,12,5653.449388,314.080522,471.120782,106.709075,4,0
0,0,25,25,26,27,53,164,111,275,0.000333,0.525059,52,81909.2625,4550.514583,1575.178125,250.593395,9,0
0,0,19,19,24,26,50,134,90,224,0.000333,0.421408,36,45512.05631,2528.447573,1264.223787,232.250533,8,0
0,0,15,15,15,29,44,89,56,145,0.000333,0.263873,7,5541.323093,307.851283,791.617585,199.484808,4,0
0,0,18,18,15,25,40,103,57,160,0.000333,0.283836,14,11921.11893,662.284385,851.508495,174.699764,7,0
0,0,18,18,15,25,40,104,57,161,0.000333,0.28561,14,11995.62593,666.423663,856.830423,174.699764,7,0
0,0,12,12,14,20,34,63,39,102,0.000333,0.172974,7,3632.448469,201.802693,518.92121,139.741531,9,0
0,0,20,20,18,45,63,104,74,178,0.000333,0.354652,9,9575.602437,531.977913,1063.955826,322.192039,8,0
0,0,20,20,18,45,63,104,74,178,0.000333,0.354652,9,9575.602437,531.977913,1063.955826,322.192039,8,0
0,0,22,22,20,45,65,109,77,186,0.000333,0.373387,10,11201.60413,622.311341,1120.160413,333.571951,8,0
0,0,20,20,18,46,64,104,75,179,0.000333,0.358,9,9666,537,1074,329.1425,8,0
0,0,20,20,18,46,64,104,75,179,0.000333,0.358,9,9666,537,1074,329.1425,8,0
0,0,20,20,18,45,63,104,74,178,0.000333,0.354652,9,9575.602437,531.977913,1063.955826,322.192039,8,0
0,0,18,18,15,25,40,103,57,160,0.000333,0.283836,14,11921.11893,662.284385,851.508495,174.699764,7,0
0,0,18,18,15,25,40,104,57,161,0.000333,0.28561,14,11995.62593,666.423663,856.830423,174.699764,7,0
0,0,18,18,15,25,40,103,57,160,0.000333,0.283836,14,11921.11893,662.284385,851.508495,174.699764,7,0
0,0,18,18,15,25,40,104,57,161,0.000333,0.28561,14,11995.62593,666.423663,856.830423,174.699764,7,0
0,0,6,6,7,9,16,13,15,28,0.000333,0.037333,3,336,18.666667,112,48.180809,1,0
0,0,6,6,8,10,18,19,20,39,0.000333,0.054209,8,1301.0166,72.2787,162.627075,57.219281,1,0
0,0,7,7,8,13,21,31,32,63,0.000333,0.092239,8,2213.727981,122.984888,276.715998,72.105716,1,0
0,0,3,3,7,6,13,8,11,19,0.000333,0.023436,3,210.925064,11.718059,70.308355,35.161259,1,0
0,0,3,3,7,6,13,8,11,19,0.000333,0.023436,3,210.925064,11.718059,70.308355,35.161259,1,0
0,0,7,7,9,9,18,19,17,36,0.000333,0.050039,4,600.4692,33.3594,150.1173,57.05865,2,0
0,0,5,5,8,11,19,24,35,59,0.000333,0.083543,12,3007.53268,167.085149,250.627723,62.053748,1,0
0,0,2,2,8,9,17,9,13,22,0.000333,0.029975,4,359.69673,19.983152,89.924183,52.529325,1,0
0,0,2,2,8,9,17,9,13,22,0.000333,0.029975,4,359.69673,19.983152,89.924183,52.529325,1,0
0,0,55,55,29,47,76,276,152,428,0.000333,0.891371,42,112312.745,6239.596943,2674.112976,401.947125,42,0
0,0,34,34,22,30,52,175,97,272,0.000333,0.51684,33,51167.14691,2842.619273,1550.519603,245.314213,28,0
0,0,77,77,37,106,143,544,420,964,0.000333,2.300705,54,372714.2623,20706.34791,6902.115969,905.909343,28,0
0,0,18,18,15,25,40,103,57,160,0.000333,0.283836,14,11921.11893,662.284385,851.508495,174.699764,7,0
0,0,18,18,15,25,40,104,57,161,0.000333,0.28561,14,11995.62593,666.423663,856.830423,174.699764,7,0
0,0,18,18,15,25,40,103,57,160,0.000333,0.283836,14,11921.11893,662.284385,851.508495,174.699764,7,0
0,0,18,18,15,25,40,104,57,161,0.000333,0.28561,14,11995.62593,666.423663,856.830423,174.699764,7,0
0,0,9,9,13,15,28,59,39,98,0.000333,0.15704,12,5653.449388,314.080522,471.120782,106.709075,4,0
0,0,25,25,26,27,53,164,111,275,0.000333,0.525059,52,81909.2625,4550.514583,1575.178125,250.593395,9,0
0,0,19,19,24,26,50,134,90,224,0.000333,0.421408,36,45512.05631,2528.447573,1264.223787,232.250533,8,0
0,0,18,18,15,25,40,103,57,160,0.000333,0.283836,14,11921.11893,662.284385,851.508495,174.699764,7,0
0,0,18,18,15,25,40,104,57,161,0.000333,0.28561,14,11995.62593,666.423663,856.830423,174.699764,7,0
0,0,10,10,11,16,27,73,44,117,0.000333,0.185441,10,5563.218378,309.067688,556.321838,102.053748,4,0
0,0,10,10,10,16,26,67,41,108,0.000333,0.169216,10,5076.474896,282.026383,507.64749,97.219281,3,0
0,0,10,10,10,16,26,71,41,112,0.000333,0.175483,10,5264.492484,292.471805,526.449248,97.219281,3,0
0,0,10,10,10,16,26,67,41,108,0.000333,0.169216,10,5076.474896,282.026383,507.64749,97.219281,3,0
0,0,10,10,10,16,26,71,41,112,0.000333,0.175483,10,5264.492484,292.471805,526.449248,97.219281,3,0
0,0,10,10,10,16,26,67,41,108,0.000333,0.169216,10,5076.474896,282.026383,507.64749,97.219281,3,0
0,0,10,10,10,16,26,67,41,108,0.000333,0.169216,10,5076.474896,282.026383,507.64749,97.219281,3,0
0,0,10,10,10,16,26,67,41,108,0.000333,0.169216,10,5076.474896,282.026383,507.64749,97.219281,3,0
0,0,47,47,33,48,81,377,318,695,0.000333,1.468732,96,422994.7922,23499.71068,4406.195752,434.543206,38,0
0,0,45,45,33,45,78,354,302,656,0.000333,1.374408,96,395829.4901,21990.52723,4123.223856,413.598395,33,0
0,0,50,50,34,50,84,401,338,739,0.000333,1.574641,102,481840.1027,26768.89459,4723.922575,455.166546,42,0
0,0,48,48,34,48,82,378,322,700,0.000333,1.483429,102,453929.2131,25218.28962,4450.286403,441.051937,37,0
0,0,53,53,36,77,113,475,339,814,0.000333,1.850542,72,399717.0486,22206.5027,5551.625675,668.659864,53,0
0,0,37,37,30,62,92,459,359,818,0.000333,1.778758,75,400220.526,22234.47367,5336.27368,516.366889,33,0
0,0,11,11,18,30,48,168,116,284,0.000333,0.52871,27,42825.49246,2379.194025,1586.12935,222.265368,5,0
0,0,29,29,21,48,69,149,97,246,0.000333,0.500899,20,30053.94033,1669.663352,1502.697016,360.316866,9,0
0,0,12,12,14,20,34,63,39,102,0.000333,0.172974,7,3632.448469,201.802693,518.92121,139.741531,9,0
0,0,18,18,15,25,40,103,57,160,0.000333,0.283836,14,11921.11893,662.284385,851.508495,174.699764,7,0
0,0,18,18,15,25,40,104,57,161,0.000333,0.28561,14,11995.62593,666.423663,856.830423,174.699764,7,0
0,0,13,13,18,23,41,60,41,101,0.000333,0.180371,9,4870.014772,270.556376,541.112752,179.100575,4,0
0,0,77,77,37,106,143,544,420,964,0.000333,2.300705,54,372714.2623,20706.34791,6902.115969,905.909343,28,0
0,0,44,44,26,34,60,226,120,346,0.000333,0.681261,39,79707.5817,4428.198983,2043.784146,295.185169,26,0
0,0,18,18,15,25,40,103,57,160,0.000333,0.283836,14,11921.11893,662.284385,851.508495,174.699764,7,0
0,0,18,18,15,25,40,104,57,161,0.000333,0.28561,14,11995.62593,666.423663,856.830423,174.699764,7,0
0,0,12,12,14,20,34,63,39,102,0.000333,0.172974,7,3632.448469,201.802693,518.92121,139.741531,9,0
0,0,18,18,15,25,40,103,57,160,0.000333,0.283836,14,11921.11893,662.284385,851.508495,174.699764,7,0
0,0,18,18,15,25,40,104,57,161,0.000333,0.28561,14,11995.62593,666.423663,856.830423,174.699764,7,0
0,0,23,23,22,37,59,129,96,225,0.000333,0.441198,22,29119.08309,1617.726839,1323.594686,290.85727,12,0
0,0,23,23,22,37,59,129,96,225,0.000333,0.441198,22,29119.08309,1617.726839,1323.594686,290.85727,12,0
0,0,24,24,22,37,59,136,99,235,0.000333,0.460807,22,30413.26457,1689.625809,1382.421117,290.85727,13,0
0,0,31,31,17,35,52,136,109,245,0.000333,0.465536,24,33518.58554,1862.143641,1396.607731,249.011774,8,0
0,0,26,26,15,34,49,110,91,201,0.000333,0.376186,14,15799.7935,877.766306,1128.556679,231.577096,8,0
0,0,27,27,15,34,49,117,94,211,0.000333,0.394901,14,16585.85288,921.436271,1184.703777,231.577096,9,0
0,0,18,18,16,44,60,98,70,168,0.000333,0.330786,8,7938.86096,441.047831,992.35762,304.214991,7,0
0,0,27,27,20,47,67,144,95,239,0.000333,0.483265,20,28995.90633,1610.883685,1449.795317,347.504238,11,0
0,0,27,27,20,48,68,144,97,241,0.000333,0.489026,20,29341.5709,1630.087272,1467.078545,354.516762,11,0
0,0,18,18,15,25,40,103,57,160,0.000333,0.283836,14,11921.11893,662.284385,851.508495,174.699764,7,0
0,0,18,18,15,25,40,104,57,161,0.000333,0.28561,14,11995.62593,666.423663,856.830423,174.699764,7,0
0,0,48,48,29,66,95,285,181,466,0.000333,1.020518,28,85723.47598,4762.415332,3061.552713,539.811461,21,0
0,0,30,30,21,43,64,157,104,261,0.000333,0.522,20,31320,1740,1566,325.56805,16,0
0,0,30,30,21,43,64,160,108,268,0.000333,0.536,20,32160,1786.666667,1608,325.56805,20,0
0,0,56,56,27,60,87,372,227,599,0.000333,1.286441,39,150513.603,8361.866834,3859.323154,482.795398,13,0
0,0,60,60,27,60,87,404,247,651,0.000333,1.398119,52,218106.5232,12117.02907,4194.356216,482.795398,14,0
0,0,55,55,27,57,84,390,229,619,0.000333,1.318948,52,205755.9132,11430.88407,3956.844485,460.856693,15,0
0,0,59,59,26,57,83,422,249,671,0.000333,1.425884,52,222437.8758,12357.65977,4277.651458,454.686163,16,0
0,0,13,13,13,19,32,70,40,110,0.000333,0.183333,12,6600,366.666667,550,128.816339,4,0
0,0,11,11,17,21,38,55,40,95,0.000333,0.166184,8,3988.42491,221.579162,498.553114,161.725534,7,0
0,0,22,22,18,48,66,114,83,197,0.000333,0.396915,9,10716.71077,595.372821,1190.745642,343.13685,9,0
0,0,22,22,18,48,66,114,83,197,0.000333,0.396915,9,10716.71077,595.372821,1190.745642,343.13685,9,0
0,0,24,24,21,50,71,124,91,215,0.000333,0.440732,10,13221.95631,734.553128,1322.195631,374.431475,10,0
0,0,23,23,19,49,68,117,84,201,0.000333,0.40786,9,11012.22028,611.790016,1223.580031,355.831405,10,0
0,0,23,23,18,48,66,117,84,201,0.000333,0.404974,9,10934.30896,607.461609,1214.923218,343.13685,10,0
0,0,23,23,18,50,68,117,85,202,0.000333,0.409889,9,11067.00745,614.833747,1229.667494,357.25146,10,0
0,0,23,23,18,50,68,117,85,202,0.000333,0.409889,9,11067.00745,614.833747,1229.667494,357.25146,10,0
0,0,22,22,18,48,66,114,83,197,0.000333,0.396915,9,10716.71077,595.372821,1190.745642,343.13685,9,0
0,0,24,24,18,49,67,123,89,212,0.000333,0.42867,9,11574.09818,643.005454,1286.010908,350.179432,9,0
0,0,9,9,16,14,30,49,35,84,0.000333,0.137393,16,6594.86096,366.381164,412.17881,117.302969,3,0
0,0,18,18,15,25,40,103,57,160,0.000333,0.283836,14,11921.11893,662.284385,851.508495,174.699764,7,0
0,0,18,18,15,25,40,104,57,161,0.000333,0.28561,14,11995.62593,666.423663,856.830423,174.699764,7,0
0,0,42,42,16,51,67,269,209,478,0.000333,0.96653,32,92786.90026,5154.827792,2899.590633,353.293692,9,0
0,0,36,36,19,44,63,261,194,455,0.000333,0.906554,36,97907.84515,5439.32473,2719.662365,320.925614,7,0
0,0,35,35,18,44,62,256,190,446,0.000333,0.885191,36,95600.57596,5311.143109,2655.571554,315.273641,6,0
0,0,14,14,17,17,34,87,68,155,0.000333,0.262852,32,25233.81569,1401.87865,788.55674,138.973737,5,0
0,0,19,19,19,25,44,101,78,179,0.000333,0.325746,27,26385.43301,1465.85739,977.23826,196.807027,6,0
0,0,12,12,13,18,31,75,57,132,0.000333,0.217985,18,11771.17043,653.953913,653.953913,123.164366,4,0
0,0,12,12,14,19,33,74,56,130,0.000333,0.21859,14,9180.797297,510.044294,655.771236,134.013592,4,0
0,0,13,13,14,17,31,76,55,131,0.000333,0.216333,21,13628.99405,757.166336,648.999717,122.789837,5,0
0,0,12,12,14,17,31,76,57,133,0.000333,0.219636,21,13837.0703,768.726127,658.908109,122.789837,4,0
0,0,25,25,25,30,55,167,132,299,0.000333,0.576209,48,82974.07461,4609.670812,1728.626554,263.303123,24,0
0,0,10,10,12,15,27,57,45,102,0.000333,0.161666,18,8729.973454,484.998525,484.998525,101.622909,3,0
0,0,19,19,23,24,47,118,89,207,0.000333,0.383267,33,37943.39645,2107.966469,1149.799892,214.081025,7,0
0,0,21,21,20,24,44,124,94,218,0.000333,0.396719,30,35704.68279,1983.593488,1190.156093,196.477662,8,0
0,0,20,20,26,27,53,128,92,220,0.000333,0.420048,39,49145.5575,2730.30875,1260.1425,250.593395,8,0
0,0,30,30,22,37,59,154,118,272,0.000333,0.53336,33,52802.60401,2933.478001,1600.078909,290.85727,9,0
0,0,14,14,14,23,37,85,67,152,0.000333,0.263946,14,11085.71676,615.873153,791.836912,157.344894,4,0
0,0,30,30,23,39,62,159,123,282,0.000333,0.559694,33,55409.75086,3078.319492,1679.08336,310.172612,9,0
0,0,14,14,14,21,35,84,69,153,0.000333,0.261593,21,16480.38633,915.577019,784.780302,145.541635,4,0
0,0,31,31,23,42,65,166,132,298,0.000333,0.598222,33,59223.96507,3290.220282,1794.665608,330.519257,9,0
0,0,14,14,14,22,36,89,69,158,0.000333,0.272283,21,17153.81116,952.989509,816.84815,151.410465,4,0
0,0,14,14,15,23,38,89,70,159,0.000333,0.27814,21,17522.82997,973.490554,834.420475,162.645284,4,0
0,0,14,14,14,18,32,91,69,160,0.000333,0.266667,21,16800,933.333333,800,128.361619,4,0
0,0,14,14,14,23,37,93,71,164,0.000333,0.284783,21,17941.35739,996.742077,854.350352,157.344894,4,0
0,0,14,14,15,24,39,93,72,165,0.000333,0.290697,21,18313.91869,1017.439927,872.091366,168.642459,4,0
0,0,14,14,14,20,34,90,69,159,0.000333,0.269636,21,16987.03843,943.724357,808.906592,139.741531,4,0
0,0,14,14,14,23,37,93,71,164,0.000333,0.284783,21,17941.35739,996.742077,854.350352,157.344894,4,0
0,0,14,14,15,24,39,93,72,165,0.000333,0.290697,21,18313.91869,1017.439927,872.091366,168.642459,4,0
0,0,14,14,14,22,36,90,70,160,0.000333,0.275729,21,17370.94801,965.052667,827.188,151.410465,4,0
0,0,14,14,14,23,37,90,71,161,0.000333,0.279574,21,17613.16183,978.508991,838.721992,157.344894,4,0
0,0,30,30,22,38,60,155,118,273,0.000333,0.537527,33,53215.17738,2956.398743,1612.581133,297.528741,9,0
0,0,14,14,15,22,37,86,67,153,0.000333,0.265682,21,16737.97366,929.887426,797.046365,156.710855,4,0
0,0,30,30,23,40,63,160,123,283,0.000333,0.563857,33,55821.81721,3101.212067,1691.570218,316.919049,9,0
0,0,14,14,15,20,35,85,69,154,0.000333,0.263303,21,16588.10128,921.561182,789.909585,145.041921,4,0
0,0,31,31,23,43,66,167,132,299,0.000333,0.602425,33,59640.03678,3313.335376,1807.273842,337.371309,9,0
0,0,14,14,14,23,37,90,71,161,0.000333,0.279574,21,17613.16183,978.508991,838.721992,157.344894,4,0
0,0,14,14,14,22,36,90,70,160,0.000333,0.275729,21,17370.94801,965.052667,827.188,151.410465,4,0
0,0,14,14,15,23,38,89,70,159,0.000333,0.27814,21,17522.82997,973.490554,834.420475,162.645284,4,0
0,0,14,14,14,22,36,89,69,158,0.000333,0.272283,21,17153.81116,952.989509,816.84815,151.410465,4,0
0,0,14,14,15,24,39,93,72,165,0.000333,0.290697,21,18313.91869,1017.439927,872.091366,168.642459,4,0
0,0,14,14,14,23,37,93,71,164,0.000333,0.284783,21,17941.35739,996.742077,854.350352,157.344894,4,0
0,0,14,14,15,24,39,93,72,165,0.000333,0.290697,21,18313.91869,1017.439927,872.091366,168.642459,4,0
0,0,14,14,14,23,37,93,71,164,0.000333,0.284783,21,17941.35739,996.742077,854.350352,157.344894,4,0
0,0,13,13,13,14,27,67,51,118,0.000333,0.187026,18,10099.38106,561.076725,561.076725,101.408685,4,0
0,0,14,14,17,21,38,86,65,151,0.000333,0.264146,24,19018.48931,1056.582739,792.437055,161.725534,5,0
0,0,16,16,15,22,37,92,70,162,0.000333,0.28131,21,17722.56035,984.586686,843.931445,156.710855,6,0
0,0,15,15,20,25,45,96,68,164,0.000333,0.300221,20,18013.27816,1000.737675,900.663908,202.534967,6,0
0,0,19,19,23,26,49,128,107,235,0.000333,0.439819,44,58056.09979,3225.338877,1319.456813,226.253358,22,0
0,0,16,16,22,21,43,88,79,167,0.000333,0.302062,33,29904.14506,1661.341392,906.186214,190.346161,11,0
0,0,17,17,22,25,47,119,98,217,0.000333,0.401782,33,39776.41077,2209.800598,1205.345781,214.2039,20,0
0,0,24,24,24,28,52,160,125,285,0.000333,0.541542,48,77982.01534,4332.334186,1624.62532,244.645038,22,0
0,0,20,20,22,27,49,147,113,260,0.000333,0.486608,44,64232.28062,3568.460034,1459.824559,226.489458,19,0
0,0,33,33,20,33,53,188,148,336,0.000333,0.641527,40,76983.25091,4276.847273,1924.581273,252.903568,17,0
0,0,49,49,23,35,58,259,199,458,0.000333,0.894318,55,147562.5413,8197.918959,2682.955296,283.566831,23,0
0,0,32,32,22,33,55,179,141,320,0.000333,0.616678,44,81401.54477,4522.308043,1850.035108,264.572502,14,0
0,0,37,37,24,34,58,223,164,387,0.000333,0.75568,48,108817.855,6045.436387,2267.038645,283.012837,19,0
0,0,34,34,24,34,58,206,156,362,0.000333,0.706863,48,101788.2778,5654.904321,2120.58912,283.012837,17,0
0,0,32,32,22,33,55,176,138,314,0.000333,0.605116,44,79875.2658,4437.514767,1815.34695,264.572502,15,0
0,0,32,32,22,34,56,182,142,324,0.000333,0.627194,44,82789.65177,4599.425098,1881.582995,271.081232,16,0
0,0,32,32,22,33,55,179,141,320,0.000333,0.616678,44,81401.54477,4522.308043,1850.035108,264.572502,14,0
0,0,44,44,20,34,54,231,175,406,0.000333,0.778828,50,116824.2163,6490.234239,2336.484326,259.412299,23,0
0,0,61,61,23,37,60,298,227,525,0.000333,1.033706,66,204673.7591,11370.7644,3101.117563,296.7917,29,0
0,0,44,44,27,42,69,280,221,501,0.000333,1.020124,65,198924.0989,11051.33883,3060.370753,354.859294,35,0
0,0,36,36,22,34,56,194,156,350,0.000333,0.677525,44,89433.2658,4968.514767,2032.574223,271.081232,14,0
0,0,35,35,22,33,55,189,152,341,0.000333,0.657148,44,86743.52114,4819.084508,1971.443662,264.572502,14,0
0,0,35,35,22,33,55,189,152,341,0.000333,0.657148,44,86743.52114,4819.084508,1971.443662,264.572502,14,0
0,0,44,44,24,51,75,250,202,452,0.000333,0.938475,36,101355.3377,5630.852096,2815.426048,399.332792,20,0
0,0,35,35,22,33,55,187,152,339,0.000333,0.653294,44,86234.76149,4790.820083,1959.880943,264.572502,14,0
0,0,34,34,20,32,52,182,148,330,0.000333,0.627048,40,75245.80428,4180.32246,1881.145107,246.438562,14,0
0,0,34,34,20,32,52,182,148,330,0.000333,0.627048,40,75245.80428,4180.32246,1881.145107,246.438562,14,0
0,0,43,43,23,50,73,243,198,441,0.000333,0.909904,33,90080.51681,5004.473156,2729.71263,386.234734,20,0
0,0,36,36,22,34,56,194,156,350,0.000333,0.677525,44,89433.2658,4968.514767,2032.574223,271.081232,14,0
0,0,35,35,22,33,55,190,153,343,0.000333,0.661002,44,87252.2808,4847.348933,1983.006382,264.572502,14,0
0,0,44,44,24,51,75,250,202,452,0.000333,0.938475,36,101355.3377,5630.852096,2815.426048,399.332792,20,0
0,0,35,35,22,34,56,190,153,343,0.000333,0.663974,44,87644.60048,4869.144471,1991.922738,271.081232,14,0
0,0,35,35,22,34,56,188,153,341,0.000333,0.660103,44,87133.55325,4840.752958,1980.308028,271.081232,14,0
0,0,34,34,21,33,54,184,150,334,0.000333,0.640711,40,76885.29703,4271.40539,1922.132426,258.703672,14,0
0,0,43,43,23,51,74,244,199,443,0.000333,0.916929,33,90775.99875,5043.111042,2750.787841,393.335617,20,0
0,0,34,34,21,34,55,184,150,334,0.000333,0.643658,40,77238.96577,4291.053654,1930.974144,265.212402,14,0
0,0,45,45,21,39,60,235,187,422,0.000333,0.830903,40,99708.31325,5539.350736,2492.707831,298.369352,19,0
0,0,47,47,23,35,58,243,186,429,0.000333,0.837691,55,138219.0616,7678.836754,2513.073847,283.566831,23,0
0,0,30,30,22,33,55,163,128,291,0.000333,0.560792,33,55518.39733,3084.355407,1682.375677,264.572502,14,0
0,0,35,35,24,34,58,207,151,358,0.000333,0.699052,48,100663.5454,5592.41919,2097.157196,283.012837,19,0
0,0,32,32,24,34,58,190,143,333,0.000333,0.650236,48,93633.96823,5201.887124,1950.707671,283.012837,17,0
0,0,30,30,22,33,55,160,125,285,0.000333,0.549229,33,54373.68811,3020.76045,1647.687518,264.572502,15,0
0,0,30,30,22,34,56,166,129,295,0.000333,0.571057,33,56534.60017,3140.81112,1713.169702,271.081232,16,0
0,0,30,30,22,33,55,163,128,291,0.000333,0.560792,33,55518.39733,3084.355407,1682.375677,264.572502,14,0
0,0,42,42,20,34,54,215,162,377,0.000333,0.723198,40,86783.70353,4821.316863,2169.592588,259.412299,23,0
0,0,59,59,23,37,60,282,214,496,0.000333,0.976606,55,161139.9754,8952.220858,2929.817735,296.7917,29,0
0,0,42,42,27,42,69,264,208,472,0.000333,0.961075,52,149927.6243,8329.312459,2883.223544,354.859294,35,0
0,0,34,34,22,34,56,178,143,321,0.000333,0.621387,44,82023.08092,4556.837829,1864.16093,271.081232,14,0
0,0,33,33,22,33,55,173,139,312,0.000333,0.601261,44,79366.50615,4409.250342,1803.784231,264.572502,14,0
0,0,33,33,22,33,55,173,139,312,0.000333,0.601261,44,79366.50615,4409.250342,1803.784231,264.572502,14,0
0,0,42,42,24,51,75,234,189,423,0.000333,0.878263,36,94852.45102,5269.580612,2634.790306,399.332792,20,0
0,0,33,33,22,33,55,171,139,310,0.000333,0.597407,44,78857.74649,4380.985916,1792.221511,264.572502,14,0
0,0,32,32,20,32,52,166,135,301,0.000333,0.571944,40,68633.29421,3812.960789,1715.832355,246.438562,14,0
0,0,32,32,20,32,52,166,135,301,0.000333,0.571944,40,68633.29421,3812.960789,1715.832355,246.438562,14,0
0,0,41,41,23,50,73,227,185,412,0.000333,0.850069,33,84156.8547,4675.380817,2550.207718,386.234734,20,0
0,0,34,34,22,34,56,178,143,321,0.000333,0.621387,44,82023.08092,4556.837829,1864.16093,271.081232,14,0
0,0,33,33,22,33,55,174,140,314,0.000333,0.605116,44,79875.2658,4437.514767,1815.34695,264.572502,14,0
0,0,42,42,24,51,75,234,189,423,0.000333,0.878263,36,94852.45102,5269.580612,2634.790306,399.332792,20,0
0,0,33,33,22,34,56,174,140,314,0.000333,0.607836,44,80234.4156,4457.467534,1823.509446,271.081232,14,0
0,0,33,33,22,34,56,172,140,312,0.000333,0.603965,44,79723.36837,4429.076021,1811.894736,271.081232,14,0
0,0,32,32,21,33,54,168,137,305,0.000333,0.58508,40,70209.62753,3900.534863,1755.240688,258.703672,14,0
0,0,41,41,23,51,74,228,186,414,0.000333,0.856905,33,84833.55188,4712.975105,2570.713693,393.335617,20,0
0,0,32,32,21,34,55,168,137,305,0.000333,0.587772,40,70532.58851,3918.477139,1763.314713,265.212402,14,0
0,0,4,4,9,11,20,35,23,58,0.000333,0.083557,8,2005.374636,111.409702,250.67183,66.583073,1,0
0,0,23,23,17,22,39,104,81,185,0.000333,0.325933,24,23467.18585,1303.732547,977.79941,167.594364,11,0
0,0,75,75,25,44,69,366,279,645,0.000333,1.313333,72,283679.8758,15759.9931,3939.998275,356.311396,31,0
0,0,61,61,22,42,64,310,236,546,0.000333,1.092,55,180180,10010,3276,324.584827,25,0
0,0,59,59,22,42,64,297,225,522,0.000333,1.044,55,172260,9570,3132,324.584827,25,0
0,0,27,27,19,29,48,155,125,280,0.000333,0.521263,36,56296.42201,3127.579,1563.7895,221.592072,13,0
0,0,32,32,19,35,54,179,147,326,0.000333,0.625364,36,67539.35973,3752.186651,1876.093326,260.235528,16,0
0,0,29,29,19,30,49,160,127,287,0.000333,0.537141,36,58011.18211,3222.843451,1611.421725,227.917341,14,0
0,0,41,41,26,42,68,261,208,469,0.000333,0.951673,52,148461.0438,8247.835765,2855.020073,348.688764,34,0
0,0,48,48,24,40,64,250,198,448,0.000333,0.896,48,129024,7168,2688,322.916224,22,0
0,0,26,26,16,36,52,197,152,349,0.000333,0.663151,32,63662.51077,3536.806154,1989.453462,250.1173,6,0
0,0,23,23,17,37,54,209,155,364,0.000333,0.69826,32,67032.92963,3724.051646,2094.779051,262.236643,5,0
0,0,24,24,15,28,43,115,92,207,0.000333,0.374412,21,23587.97289,1310.442938,1123.236804,193.209297,6,0
0,0,22,22,15,27,42,110,86,196,0.000333,0.352298,21,22194.77851,1233.043251,1056.894215,186.985321,6,0
0,0,21,21,15,27,42,109,84,193,0.000333,0.346906,21,21855.06252,1214.17014,1040.717263,186.985321,6,0
0,0,19,19,15,25,40,107,79,186,0.000333,0.32996,21,20787.45114,1154.858397,989.878626,174.699764,6,0
0,0,25,25,18,51,69,266,144,410,0.000333,0.834832,18,45080.91049,2504.495027,2504.495027,364.352342,12,0
0,0,24,24,21,31,52,135,100,235,0.000333,0.446534,30,40188.10001,2232.672223,1339.603334,245.818752,9,0
0,0,22,22,20,31,51,125,94,219,0.000333,0.414087,30,37267.8345,2070.43525,1242.26115,240.018648,8,0
0,0,12,12,14,20,34,63,39,102,0.000333,0.172974,7,3632.448469,201.802693,518.92121,139.741531,9,0
0,0,27,27,18,33,51,140,86,226,0.000333,0.427323,18,23075.42629,1281.968127,1281.968127,241.523656,16,0
0,0,35,35,18,44,62,256,190,446,0.000333,0.885191,36,95600.57596,5311.143109,2655.571554,315.273641,6,0
0,0,36,36,19,44,63,261,194,455,0.000333,0.906554,36,97907.84515,5439.32473,2719.662365,320.925614,7,0
0,0,42,42,16,51,67,269,209,478,0.000333,0.96653,32,92786.90026,5154.827792,2899.590633,353.293692,9,0
0,0,14,14,17,17,34,87,68,155,0.000333,0.262852,32,25233.81569,1401.87865,788.55674,138.973737,5,0
0,0,25,25,25,30,55,167,132,299,0.000333,0.576209,48,82974.07461,4609.670812,1728.626554,263.303123,24,0
0,0,19,19,19,25,44,101,78,179,0.000333,0.325746,27,26385.43301,1465.85739,977.23826,196.807027,6,0
0,0,12,12,13,18,31,75,57,132,0.000333,0.217985,18,11771.17043,653.953913,653.953913,123.164366,4,0
0,0,12,12,14,17,31,76,57,133,0.000333,0.219636,21,13837.0703,768.726127,658.908109,122.789837,4,0
0,0,12,12,14,19,33,74,56,130,0.000333,0.21859,14,9180.797297,510.044294,655.771236,134.013592,4,0
0,0,13,13,14,17,31,76,55,131,0.000333,0.216333,21,13628.99405,757.166336,648.999717,122.789837,5,0
0,0,21,21,20,24,44,124,94,218,0.000333,0.396719,30,35704.68279,1983.593488,1190.156093,196.477662,8,0
0,0,20,20,26,27,53,128,92,220,0.000333,0.420048,39,49145.5575,2730.30875,1260.1425,250.593395,8,0
0,0,19,19,23,24,47,118,89,207,0.000333,0.383267,33,37943.39645,2107.966469,1149.799892,214.081025,7,0
0,0,10,10,12,15,27,57,45,102,0.000333,0.161666,18,8729.973454,484.998525,484.998525,101.622909,3,0
0,0,14,14,14,21,35,84,69,153,0.000333,0.261593,21,16480.38633,915.577019,784.780302,145.541635,4,0
0,0,30,30,22,37,59,154,118,272,0.000333,0.53336,33,52802.60401,2933.478001,1600.078909,290.85727,9,0
0,0,30,30,23,39,62,159,123,282,0.000333,0.559694,33,55409.75086,3078.319492,1679.08336,310.172612,9,0
0,0,31,31,23,42,65,166,132,298,0.000333,0.598222,33,59223.96507,3290.220282,1794.665608,330.519257,9,0
0,0,14,14,14,23,37,85,67,152,0.000333,0.263946,14,11085.71676,615.873153,791.836912,157.344894,4,0
0,0,14,14,14,23,37,93,71,164,0.000333,0.284783,21,17941.35739,996.742077,854.350352,157.344894,4,0
0,0,14,14,15,24,39,93,72,165,0.000333,0.290697,21,18313.91869,1017.439927,872.091366,168.642459,4,0
0,0,14,14,14,22,36,90,70,160,0.000333,0.275729,21,17370.94801,965.052667,827.188,151.410465,4,0
0,0,14,14,14,23,37,90,71,161,0.000333,0.279574,21,17613.16183,978.508991,838.721992,157.344894,4,0
0,0,14,14,14,22,36,89,69,158,0.000333,0.272283,21,17153.81116,952.989509,816.84815,151.410465,4,0
0,0,14,14,15,23,38,89,70,159,0.000333,0.27814,21,17522.82997,973.490554,834.420475,162.645284,4,0
0,0,14,14,14,20,34,90,69,159,0.000333,0.269636,21,16987.03843,943.724357,808.906592,139.741531,4,0
0,0,14,14,14,23,37,93,71,164,0.000333,0.284783,21,17941.35739,996.742077,854.350352,157.344894,4,0
0,0,14,14,15,24,39,93,72,165,0.000333,0.290697,21,18313.91869,1017.439927,872.091366,168.642459,4,0
0,0,14,14,14,22,36,89,69,158,0.000333,0.272283,21,17153.81116,952.989509,816.84815,151.410465,4,0
0,0,14,14,15,23,38,89,70,159,0.000333,0.27814,21,17522.82997,973.490554,834.420475,162.645284,4,0
0,0,14,14,14,23,37,93,71,164,0.000333,0.284783,21,17941.35739,996.742077,854.350352,157.344894,4,0
0,0,14,14,15,24,39,93,72,165,0.000333,0.290697,21,18313.91869,1017.439927,872.091366,168.642459,4,0
0,0,14,14,14,18,32,91,69,160,0.000333,0.266667,21,16800,933.333333,800,128.361619,4,0
0,0,14,14,14,22,36,90,70,160,0.000333,0.275729,21,17370.94801,965.052667,827.188,151.410465,4,0
0,0,14,14,14,23,37,90,71,161,0.000333,0.279574,21,17613.16183,978.508991,838.721992,157.344894,4,0
0,0,14,14,15,20,35,85,69,154,0.000333,0.263303,21,16588.10128,921.561182,789.909585,145.041921,4,0
0,0,30,30,22,38,60,155,118,273,0.000333,0.537527,33,53215.17738,2956.398743,1612.581133,297.528741,9,0
0,0,30,30,23,40,63,160,123,283,0.000333,0.563857,33,55821.81721,3101.212067,1691.570218,316.919049,9,0
0,0,31,31,23,43,66,167,132,299,0.000333,0.602425,33,59640.03678,3313.335376,1807.273842,337.371309,9,0
0,0,14,14,15,22,37,86,67,153,0.000333,0.265682,21,16737.97366,929.887426,797.046365,156.710855,4,0
0,0,14,14,14,23,37,93,71,164,0.000333,0.284783,21,17941.35739,996.742077,854.350352,157.344894,4,0
0,0,14,14,15,24,39,93,72,165,0.000333,0.290697,21,18313.91869,1017.439927,872.091366,168.642459,4,0
0,0,16,16,15,22,37,92,70,162,0.000333,0.28131,21,17722.56035,984.586686,843.931445,156.710855,6,0
0,0,15,15,20,25,45,96,68,164,0.000333,0.300221,20,18013.27816,1000.737675,900.663908,202.534967,6,0
0,0,14,14,17,21,38,86,65,151,0.000333,0.264146,24,19018.48931,1056.582739,792.437055,161.725534,5,0
0,0,13,13,13,14,27,67,51,118,0.000333,0.187026,18,10099.38106,561.076725,561.076725,101.408685,4,0
0,0,19,19,23,26,49,128,107,235,0.000333,0.439819,44,58056.09979,3225.338877,1319.456813,226.253358,22,0
0,0,16,16,22,21,43,88,79,167,0.000333,0.302062,33,29904.14506,1661.341392,906.186214,190.346161,11,0
0,0,17,17,22,25,47,119,98,217,0.000333,0.401782,33,39776.41077,2209.800598,1205.345781,214.2039,20,0
0,0,24,24,24,28,52,160,125,285,0.000333,0.541542,48,77982.01534,4332.334186,1624.62532,244.645038,22,0
0,0,20,20,22,27,49,147,113,260,0.000333,0.486608,44,64232.28062,3568.460034,1459.824559,226.489458,19,0
0,0,33,33,20,33,53,188,148,336,0.000333,0.641527,40,76983.25091,4276.847273,1924.581273,252.903568,17,0
0,0,49,49,23,35,58,259,199,458,0.000333,0.894318,55,147562.5413,8197.918959,2682.955296,283.566831,23,0
0,0,44,44,27,42,69,280,221,501,0.000333,1.020124,65,198924.0989,11051.33883,3060.370753,354.859294,35,0
0,0,61,61,23,37,60,298,227,525,0.000333,1.033706,66,204673.7591,11370.7644,3101.117563,296.7917,29,0
0,0,44,44,20,34,54,231,175,406,0.000333,0.778828,50,116824.2163,6490.234239,2336.484326,259.412299,23,0
0,0,32,32,22,33,55,179,141,320,0.000333,0.616678,44,81401.54477,4522.308043,1850.035108,264.572502,14,0
0,0,32,32,22,33,55,176,138,314,0.000333,0.605116,44,79875.2658,4437.514767,1815.34695,264.572502,15,0
0,0,34,34,24,34,58,206,156,362,0.000333,0.706863,48,101788.2778,5654.904321,2120.58912,283.012837,17,0
0,0,37,37,24,34,58,223,164,387,0.000333,0.75568,48,108817.855,6045.436387,2267.038645,283.012837,19,0
0,0,32,32,22,33,55,179,141,320,0.000333,0.616678,44,81401.54477,4522.308043,1850.035108,264.572502,14,0
0,0,32,32,22,34,56,182,142,324,0.000333,0.627194,44,82789.65177,4599.425098,1881.582995,271.081232,16,0
0,0,35,35,22,33,55,190,153,343,0.000333,0.661002,44,87252.2808,4847.348933,1983.006382,264.572502,14,0
0,0,35,35,22,34,56,190,153,343,0.000333,0.663974,44,87644.60048,4869.144471,1991.922738,271.081232,14,0
0,0,44,44,24,51,75,250,202,452,0.000333,0.938475,36,101355.3377,5630.852096,2815.426048,399.332792,20,0
0,0,36,36,22,34,56,194,156,350,0.000333,0.677525,44,89433.2658,4968.514767,2032.574223,271.081232,14,0
0,0,36,36,22,34,56,194,156,350,0.000333,0.677525,44,89433.2658,4968.514767,2032.574223,271.081232,14,0
0,0,35,35,22,33,55,189,152,341,0.000333,0.657148,44,86743.52114,4819.084508,1971.443662,264.572502,14,0
0,0,35,35,22,33,55,189,152,341,0.000333,0.657148,44,86743.52114,4819.084508,1971.443662,264.572502,14,0
0,0,44,44,24,51,75,250,202,452,0.000333,0.938475,36,101355.3377,5630.852096,2815.426048,399.332792,20,0
0,0,34,34,21,33,54,184,150,334,0.000333,0.640711,40,76885.29703,4271.40539,1922.132426,258.703672,14,0
0,0,34,34,21,34,55,184,150,334,0.000333,0.643658,40,77238.96577,4291.053654,1930.974144,265.212402,14,0
0,0,43,43,23,51,74,244,199,443,0.000333,0.916929,33,90775.99875,5043.111042,2750.787841,393.335617,20,0
0,0,35,35,22,34,56,188,153,341,0.000333,0.660103,44,87133.55325,4840.752958,1980.308028,271.081232,14,0
0,0,35,35,22,33,55,187,152,339,0.000333,0.653294,44,86234.76149,4790.820083,1959.880943,264.572502,14,0
0,0,34,34,20,32,52,182,148,330,0.000333,0.627048,40,75245.80428,4180.32246,1881.145107,246.438562,14,0
0,0,34,34,20,32,52,182,148,330,0.000333,0.627048,40,75245.80428,4180.32246,1881.145107,246.438562,14,0
0,0,43,43,23,50,73,243,198,441,0.000333,0.909904,33,90080.51681,5004.473156,2729.71263,386.234734,20,0
0,0,45,45,21,39,60,235,187,422,0.000333,0.830903,40,99708.31325,5539.350736,2492.707831,298.369352,19,0
0,0,47,47,23,35,58,243,186,429,0.000333,0.837691,55,138219.0616,7678.836754,2513.073847,283.566831,23,0
0,0,42,42,27,42,69,264,208,472,0.000333,0.961075,52,149927.6243,8329.312459,2883.223544,354.859294,35,0
0,0,59,59,23,37,60,282,214,496,0.000333,0.976606,55,161139.9754,8952.220858,2929.817735,296.7917,29,0
0,0,42,42,20,34,54,215,162,377,0.000333,0.723198,40,86783.70353,4821.316863,2169.592588,259.412299,23,0
0,0,30,30,22,33,55,163,128,291,0.000333,0.560792,33,55518.39733,3084.355407,1682.375677,264.572502,14,0
0,0,30,30,22,33,55,160,125,285,0.000333,0.549229,33,54373.68811,3020.76045,1647.687518,264.572502,15,0
0,0,32,32,24,34,58,190,143,333,0.000333,0.650236,48,93633.96823,5201.887124,1950.707671,283.012837,17,0
0,0,35,35,24,34,58,207,151,358,0.000333,0.699052,48,100663.5454,5592.41919,2097.157196,283.012837,19,0
0,0,30,30,22,33,55,163,128,291,0.000333,0.560792,33,55518.39733,3084.355407,1682.375677,264.572502,14,0
0,0,30,30,22,34,56,166,129,295,0.000333,0.571057,33,56534.60017,3140.81112,1713.169702,271.081232,16,0
0,0,33,33,22,33,55,174,140,314,0.000333,0.605116,44,79875.2658,4437.514767,1815.34695,264.572502,14,0
0,0,33,33,22,34,56,174,140,314,0.000333,0.607836,44,80234.4156,4457.467534,1823.509446,271.081232,14,0
0,0,42,42,24,51,75,234,189,423,0.000333,0.878263,36,94852.45102,5269.580612,2634.790306,399.332792,20,0
0,0,34,34,22,34,56,178,143,321,0.000333,0.621387,44,82023.08092,4556.837829,1864.16093,271.081232,14,0
0,0,34,34,22,34,56,178,143,321,0.000333,0.621387,44,82023.08092,4556.837829,1864.16093,271.081232,14,0
0,0,33,33,22,33,55,173,139,312,0.000333,0.601261,44,79366.50615,4409.250342,1803.784231,264.572502,14,0
0,0,33,33,22,33,55,173,139,312,0.000333,0.601261,44,79366.50615,4409.250342,1803.784231,264.572502,14,0
0,0,42,42,24,51,75,234,189,423,0.000333,0.878263,36,94852.45102,5269.580612,2634.790306,399.332792,20,0
0,0,32,32,21,33,54,168,137,305,0.000333,0.58508,40,70209.62753,3900.534863,1755.240688,258.703672,14,0
0,0,32,32,21,34,55,168,137,305,0.000333,0.587772,40,70532.58851,3918.477139,1763.314713,265.212402,14,0
0,0,41,41,23,51,74,228,186,414,0.000333,0.856905,33,84833.55188,4712.975105,2570.713693,393.335617,20,0
0,0,33,33,22,34,56,172,140,312,0.000333,0.603965,44,79723.36837,4429.076021,1811.894736,271.081232,14,0
0,0,33,33,22,33,55,171,139,310,0.000333,0.597407,44,78857.74649,4380.985916,1792.221511,264.572502,14,0
0,0,32,32,20,32,52,166,135,301,0.000333,0.571944,40,68633.29421,3812.960789,1715.832355,246.438562,14,0
0,0,32,32,20,32,52,166,135,301,0.000333,0.571944,40,68633.29421,3812.960789,1715.832355,246.438562,14,0
0,0,41,41,23,50,73,227,185,412,0.000333,0.850069,33,84156.8547,4675.380817,2550.207718,386.234734,20,0
0,0,4,4,9,11,20,35,23,58,0.000333,0.083557,8,2005.374636,111.409702,250.67183,66.583073,1,0
0,0,23,23,17,22,39,104,81,185,0.000333,0.325933,24,23467.18585,1303.732547,977.79941,167.594364,11,0
0,0,75,75,25,44,69,366,279,645,0.000333,1.313333,72,283679.8758,15759.9931,3939.998275,356.311396,31,0
0,0,61,61,22,42,64,310,236,546,0.000333,1.092,55,180180,10010,3276,324.584827,25,0
0,0,59,59,22,42,64,297,225,522,0.000333,1.044,55,172260,9570,3132,324.584827,25,0
0,0,23,23,17,37,54,209,155,364,0.000333,0.69826,32,67032.92963,3724.051646,2094.779051,262.236643,5,0
0,0,26,26,16,36,52,197,152,349,0.000333,0.663151,32,63662.51077,3536.806154,1989.453462,250.1173,6,0
0,0,41,41,26,42,68,261,208,469,0.000333,0.951673,52,148461.0438,8247.835765,2855.020073,348.688764,34,0
0,0,29,29,19,30,49,160,127,287,0.000333,0.537141,36,58011.18211,3222.843451,1611.421725,227.917341,14,0
0,0,32,32,19,35,54,179,147,326,0.000333,0.625364,36,67539.35973,3752.186651,1876.093326,260.235528,16,0
0,0,48,48,24,40,64,250,198,448,0.000333,0.896,48,129024,7168,2688,322.916224,22,0
0,0,27,27,19,29,48,155,125,280,0.000333,0.521263,36,56296.42201,3127.579,1563.7895,221.592072,13,0
0,0,24,24,15,28,43,115,92,207,0.000333,0.374412,21,23587.97289,1310.442938,1123.236804,193.209297,6,0
0,0,22,22,15,27,42,110,86,196,0.000333,0.352298,21,22194.77851,1233.043251,1056.894215,186.985321,6,0
0,0,21,21,15,27,42,109,84,193,0.000333,0.346906,21,21855.06252,1214.17014,1040.717263,186.985321,6,0
0,0,19,19,15,25,40,107,79,186,0.000333,0.32996,21,20787.45114,1154.858397,989.878626,174.699764,6,0
0,0,24,24,21,31,52,135,100,235,0.000333,0.446534,30,40188.10001,2232.672223,1339.603334,245.818752,9,0
0,0,22,22,20,31,51,125,94,219,0.000333,0.414087,30,37267.8345,2070.43525,1242.26115,240.018648,8,0
0,0,23,23,18,50,68,118,85,203,0.000333,0.411918,9,11121.79461,617.877478,1235.754957,357.25146,10,0
0,0,25,25,20,49,69,123,87,210,0.000333,0.427597,10,12827.90136,712.661187,1282.790136,361.559344,10,0
0,0,23,23,18,49,67,118,84,202,0.000333,0.40845,9,11028.15015,612.675008,1225.350016,350.179432,10,0
0,0,23,23,18,48,66,118,84,202,0.000333,0.406989,9,10988.70851,610.483806,1220.967612,343.13685,10,0
0,0,23,23,18,49,67,118,85,203,0.000333,0.410472,9,11082.74495,615.708053,1231.416106,350.179432,10,0
0,0,23,23,18,49,67,118,84,202,0.000333,0.40845,9,11028.15015,612.675008,1225.350016,350.179432,10,0
0,0,23,23,18,49,67,118,84,202,0.000333,0.40845,9,11028.15015,612.675008,1225.350016,350.179432,10,0
0,0,23,23,18,49,67,118,84,202,0.000333,0.40845,9,11028.15015,612.675008,1225.350016,350.179432,10,0
0,0,18,18,15,25,40,103,57,160,0.000333,0.283836,14,11921.11893,662.284385,851.508495,174.699764,7,0
0,0,18,18,15,25,40,104,57,161,0.000333,0.28561,14,11995.62593,666.423663,856.830423,174.699764,7,0
0,0,42,42,16,51,67,269,209,478,0.000333,0.96653,32,92786.90026,5154.827792,2899.590633,353.293692,9,0
0,0,35,35,18,44,62,256,190,446,0.000333,0.885191,36,95600.57596,5311.143109,2655.571554,315.273641,6,0
0,0,36,36,19,44,63,261,194,455,0.000333,0.906554,36,97907.84515,5439.32473,2719.662365,320.925614,7,0
0,0,14,14,17,17,34,87,68,155,0.000333,0.262852,32,25233.81569,1401.87865,788.55674,138.973737,5,0
0,0,10,10,12,15,27,57,45,102,0.000333,0.161666,18,8729.973454,484.998525,484.998525,101.622909,3,0
0,0,25,25,25,30,55,167,132,299,0.000333,0.576209,48,82974.07461,4609.670812,1728.626554,263.303123,24,0
0,0,21,21,20,24,44,124,94,218,0.000333,0.396719,30,35704.68279,1983.593488,1190.156093,196.477662,8,0
0,0,19,19,23,24,47,118,89,207,0.000333,0.383267,33,37943.39645,2107.966469,1149.799892,214.081025,7,0
0,0,20,20,26,27,53,128,92,220,0.000333,0.420048,39,49145.5575,2730.30875,1260.1425,250.593395,8,0
0,0,12,12,13,18,31,75,57,132,0.000333,0.217985,18,11771.17043,653.953913,653.953913,123.164366,4,0
0,0,12,12,14,19,33,74,56,130,0.000333,0.21859,14,9180.797297,510.044294,655.771236,134.013592,4,0
0,0,13,13,14,17,31,76,55,131,0.000333,0.216333,21,13628.99405,757.166336,648.999717,122.789837,5,0
0,0,19,19,19,25,44,101,78,179,0.000333,0.325746,27,26385.43301,1465.85739,977.23826,196.807027,6,0
0,0,12,12,14,17,31,76,57,133,0.000333,0.219636,21,13837.0703,768.726127,658.908109,122.789837,4,0
0,0,13,13,13,14,27,67,51,118,0.000333,0.187026,18,10099.38106,561.076725,561.076725,101.408685,4,0
0,0,16,16,15,22,37,92,70,162,0.000333,0.28131,21,17722.56035,984.586686,843.931445,156.710855,6,0
0,0,14,14,17,21,38,86,65,151,0.000333,0.264146,24,19018.48931,1056.582739,792.437055,161.725534,5,0
0,0,15,15,20,25,45,96,68,164,0.000333,0.300221,20,18013.27816,1000.737675,900.663908,202.534967,6,0
0,0,30,30,22,38,60,155,118,273,0.000333,0.537527,33,53215.17738,2956.398743,1612.581133,297.528741,9,0
0,0,14,14,15,20,35,85,69,154,0.000333,0.263303,21,16588.10128,921.561182,789.909585,145.041921,4,0
0,0,30,30,23,40,63,160,123,283,0.000333,0.563857,33,55821.81721,3101.212067,1691.570218,316.919049,9,0
0,0,14,14,15,22,37,86,67,153,0.000333,0.265682,21,16737.97366,929.887426,797.046365,156.710855,4,0
0,0,31,31,23,43,66,167,132,299,0.000333,0.602425,33,59640.03678,3313.335376,1807.273842,337.371309,9,0
0,0,30,30,22,37,59,154,118,272,0.000333,0.53336,33,52802.60401,2933.478001,1600.078909,290.85727,9,0
0,0,14,14,14,21,35,84,69,153,0.000333,0.261593,21,16480.38633,915.577019,784.780302,145.541635,4,0
0,0,30,30,23,39,62,159,123,282,0.000333,0.559694,33,55409.75086,3078.319492,1679.08336,310.172612,9,0
0,0,14,14,14,23,37,85,67,152,0.000333,0.263946,14,11085.71676,615.873153,791.836912,157.344894,4,0
0,0,31,31,23,42,65,166,132,298,0.000333,0.598222,33,59223.96507,3290.220282,1794.665608,330.519257,9,0
0,0,14,14,14,18,32,91,69,160,0.000333,0.266667,21,16800,933.333333,800,128.361619,4,0
0,0,14,14,15,23,38,89,70,159,0.000333,0.27814,21,17522.82997,973.490554,834.420475,162.645284,4,0
0,0,14,14,14,22,36,89,69,158,0.000333,0.272283,21,17153.81116,952.989509,816.84815,151.410465,4,0
0,0,14,14,14,22,36,90,70,160,0.000333,0.275729,21,17370.94801,965.052667,827.188,151.410465,4,0
0,0,14,14,14,23,37,90,71,161,0.000333,0.279574,21,17613.16183,978.508991,838.721992,157.344894,4,0
0,0,14,14,15,24,39,93,72,165,0.000333,0.290697,21,18313.91869,1017.439927,872.091366,168.642459,4,0
0,0,14,14,14,23,37,93,71,164,0.000333,0.284783,21,17941.35739,996.742077,854.350352,157.344894,4,0
0,0,14,14,14,22,36,89,69,158,0.000333,0.272283,21,17153.81116,952.989509,816.84815,151.410465,4,0
0,0,14,14,15,23,38,89,70,159,0.000333,0.27814,21,17522.82997,973.490554,834.420475,162.645284,4,0
0,0,14,14,15,24,39,93,72,165,0.000333,0.290697,21,18313.91869,1017.439927,872.091366,168.642459,4,0
0,0,14,14,14,23,37,93,71,164,0.000333,0.284783,21,17941.35739,996.742077,854.350352,157.344894,4,0
0,0,14,14,14,23,37,93,71,164,0.000333,0.284783,21,17941.35739,996.742077,854.350352,157.344894,4,0
0,0,14,14,15,24,39,93,72,165,0.000333,0.290697,21,18313.91869,1017.439927,872.091366,168.642459,4,0
0,0,14,14,14,20,34,90,69,159,0.000333,0.269636,21,16987.03843,943.724357,808.906592,139.741531,4,0
0,0,14,14,14,23,37,90,71,161,0.000333,0.279574,21,17613.16183,978.508991,838.721992,157.344894,4,0
0,0,14,14,14,22,36,90,70,160,0.000333,0.275729,21,17370.94801,965.052667,827.188,151.410465,4,0
0,0,14,14,14,23,37,93,71,164,0.000333,0.284783,21,17941.35739,996.742077,854.350352,157.344894,4,0
0,0,14,14,15,24,39,93,72,165,0.000333,0.290697,21,18313.91869,1017.439927,872.091366,168.642459,4,0
0,0,19,19,23,26,49,128,107,235,0.000333,0.439819,44,58056.09979,3225.338877,1319.456813,226.253358,22,0
0,0,16,16,22,21,43,88,79,167,0.000333,0.302062,33,29904.14506,1661.341392,906.186214,190.346161,11,0
0,0,17,17,22,25,47,119,98,217,0.000333,0.401782,33,39776.41077,2209.800598,1205.345781,214.2039,20,0
0,0,24,24,24,28,52,160,125,285,0.000333,0.541542,48,77982.01534,4332.334186,1624.62532,244.645038,22,0
0,0,20,20,22,27,49,147,113,260,0.000333,0.486608,44,64232.28062,3568.460034,1459.824559,226.489458,19,0
0,0,33,33,20,33,53,188,148,336,0.000333,0.641527,40,76983.25091,4276.847273,1924.581273,252.903568,17,0
0,0,49,49,23,35,58,259,199,458,0.000333,0.894318,55,147562.5413,8197.918959,2682.955296,283.566831,23,0
0,0,61,61,23,37,60,298,227,525,0.000333,1.033706,66,204673.7591,11370.7644,3101.117563,296.7917,29,0
0,0,44,44,20,34,54,231,175,406,0.000333,0.778828,50,116824.2163,6490.234239,2336.484326,259.412299,23,0
0,0,44,44,27,42,69,280,221,501,0.000333,1.020124,65,198924.0989,11051.33883,3060.370753,354.859294,35,0
0,0,34,34,24,34,58,206,156,362,0.000333,0.706863,48,101788.2778,5654.904321,2120.58912,283.012837,17,0
0,0,32,32,22,34,56,182,142,324,0.000333,0.627194,44,82789.65177,4599.425098,1881.582995,271.081232,16,0
0,0,32,32,22,33,55,179,141,320,0.000333,0.616678,44,81401.54477,4522.308043,1850.035108,264.572502,14,0
0,0,32,32,22,33,55,179,141,320,0.000333,0.616678,44,81401.54477,4522.308043,1850.035108,264.572502,14,0
0,0,37,37,24,34,58,223,164,387,0.000333,0.75568,48,108817.855,6045.436387,2267.038645,283.012837,19,0
0,0,32,32,22,33,55,176,138,314,0.000333,0.605116,44,79875.2658,4437.514767,1815.34695,264.572502,15,0
0,0,35,35,22,33,55,189,152,341,0.000333,0.657148,44,86743.52114,4819.084508,1971.443662,264.572502,14,0
0,0,44,44,24,51,75,250,202,452,0.000333,0.938475,36,101355.3377,5630.852096,2815.426048,399.332792,20,0
0,0,36,36,22,34,56,194,156,350,0.000333,0.677525,44,89433.2658,4968.514767,2032.574223,271.081232,14,0
0,0,35,35,22,33,55,189,152,341,0.000333,0.657148,44,86743.52114,4819.084508,1971.443662,264.572502,14,0
0,0,35,35,22,34,56,190,153,343,0.000333,0.663974,44,87644.60048,4869.144471,1991.922738,271.081232,14,0
0,0,36,36,22,34,56,194,156,350,0.000333,0.677525,44,89433.2658,4968.514767,2032.574223,271.081232,14,0
0,0,35,35,22,33,55,190,153,343,0.000333,0.661002,44,87252.2808,4847.348933,1983.006382,264.572502,14,0
0,0,44,44,24,51,75,250,202,452,0.000333,0.938475,36,101355.3377,5630.852096,2815.426048,399.332792,20,0
0,0,34,34,21,34,55,184,150,334,0.000333,0.643658,40,77238.96577,4291.053654,1930.974144,265.212402,14,0
0,0,35,35,22,34,56,188,153,341,0.000333,0.660103,44,87133.55325,4840.752958,1980.308028,271.081232,14,0
0,0,34,34,21,33,54,184,150,334,0.000333,0.640711,40,76885.29703,4271.40539,1922.132426,258.703672,14,0
0,0,43,43,23,51,74,244,199,443,0.000333,0.916929,33,90775.99875,5043.111042,2750.787841,393.335617,20,0
0,0,34,34,20,32,52,182,148,330,0.000333,0.627048,40,75245.80428,4180.32246,1881.145107,246.438562,14,0
0,0,43,43,23,50,73,243,198,441,0.000333,0.909904,33,90080.51681,5004.473156,2729.71263,386.234734,20,0
0,0,35,35,22,33,55,187,152,339,0.000333,0.653294,44,86234.76149,4790.820083,1959.880943,264.572502,14,0
0,0,34,34,20,32,52,182,148,330,0.000333,0.627048,40,75245.80428,4180.32246,1881.145107,246.438562,14,0
0,0,45,45,21,39,60,235,187,422,0.000333,0.830903,40,99708.31325,5539.350736,2492.707831,298.369352,19,0
0,0,47,47,23,35,58,243,186,429,0.000333,0.837691,55,138219.0616,7678.836754,2513.073847,283.566831,23,0
0,0,59,59,23,37,60,282,214,496,0.000333,0.976606,55,161139.9754,8952.220858,2929.817735,296.7917,29,0
0,0,42,42,20,34,54,215,162,377,0.000333,0.723198,40,86783.70353,4821.316863,2169.592588,259.412299,23,0
0,0,42,42,27,42,69,264,208,472,0.000333,0.961075,52,149927.6243,8329.312459,2883.223544,354.859294,35,0
0,0,32,32,24,34,58,190,143,333,0.000333,0.650236,48,93633.96823,5201.887124,1950.707671,283.012837,17,0
0,0,30,30,22,34,56,166,129,295,0.000333,0.571057,33,56534.60017,3140.81112,1713.169702,271.081232,16,0
0,0,30,30,22,33,55,163,128,291,0.000333,0.560792,33,55518.39733,3084.355407,1682.375677,264.572502,14,0
0,0,30,30,22,33,55,163,128,291,0.000333,0.560792,33,55518.39733,3084.355407,1682.375677,264.572502,14,0
0,0,35,35,24,34,58,207,151,358,0.000333,0.699052,48,100663.5454,5592.41919,2097.157196,283.012837,19,0
0,0,30,30,22,33,55,160,125,285,0.000333,0.549229,33,54373.68811,3020.76045,1647.687518,264.572502,15,0
0,0,33,33,22,33,55,173,139,312,0.000333,0.601261,44,79366.50615,4409.250342,1803.784231,264.572502,14,0
0,0,42,42,24,51,75,234,189,423,0.000333,0.878263,36,94852.45102,5269.580612,2634.790306,399.332792,20,0
0,0,34,34,22,34,56,178,143,321,0.000333,0.621387,44,82023.08092,4556.837829,1864.16093,271.081232,14,0
0,0,33,33,22,33,55,173,139,312,0.000333,0.601261,44,79366.50615,4409.250342,1803.784231,264.572502,14,0
0,0,33,33,22,34,56,174,140,314,0.000333,0.607836,44,80234.4156,4457.467534,1823.509446,271.081232,14,0
0,0,34,34,22,34,56,178,143,321,0.000333,0.621387,44,82023.08092,4556.837829,1864.16093,271.081232,14,0
0,0,33,33,22,33,55,174,140,314,0.000333,0.605116,44,79875.2658,4437.514767,1815.34695,264.572502,14,0
0,0,42,42,24,51,75,234,189,423,0.000333,0.878263,36,94852.45102,5269.580612,2634.790306,399.332792,20,0
0,0,32,32,21,34,55,168,137,305,0.000333,0.587772,40,70532.58851,3918.477139,1763.314713,265.212402,14,0
0,0,33,33,22,34,56,172,140,312,0.000333,0.603965,44,79723.36837,4429.076021,1811.894736,271.081232,14,0
0,0,32,32,21,33,54,168,137,305,0.000333,0.58508,40,70209.62753,3900.534863,1755.240688,258.703672,14,0
0,0,41,41,23,51,74,228,186,414,0.000333,0.856905,33,84833.55188,4712.975105,2570.713693,393.335617,20,0
0,0,32,32,20,32,52,166,135,301,0.000333,0.571944,40,68633.29421,3812.960789,1715.832355,246.438562,14,0
0,0,41,41,23,50,73,227,185,412,0.000333,0.850069,33,84156.8547,4675.380817,2550.207718,386.234734,20,0
0,0,33,33,22,33,55,171,139,310,0.000333,0.597407,44,78857.74649,4380.985916,1792.221511,264.572502,14,0
0,0,32,32,20,32,52,166,135,301,0.000333,0.571944,40,68633.29421,3812.960789,1715.832355,246.438562,14,0
0,0,4,4,9,11,20,35,23,58,0.000333,0.083557,8,2005.374636,111.409702,250.67183,66.583073,1,0
0,0,23,23,17,22,39,104,81,185,0.000333,0.325933,24,23467.18585,1303.732547,977.79941,167.594364,11,0
0,0,75,75,25,44,69,366,279,645,0.000333,1.313333,72,283679.8758,15759.9931,3939.998275,356.311396,31,0
0,0,61,61,22,42,64,310,236,546,0.000333,1.092,55,180180,10010,3276,324.584827,25,0
0,0,59,59,22,42,64,297,225,522,0.000333,1.044,55,172260,9570,3132,324.584827,25,0
0,0,29,29,19,30,49,160,127,287,0.000333,0.537141,36,58011.18211,3222.843451,1611.421725,227.917341,14,0
0,0,32,32,19,35,54,179,147,326,0.000333,0.625364,36,67539.35973,3752.186651,1876.093326,260.235528,16,0
0,0,48,48,24,40,64,250,198,448,0.000333,0.896,48,129024,7168,2688,322.916224,22,0
0,0,41,41,26,42,68,261,208,469,0.000333,0.951673,52,148461.0438,8247.835765,2855.020073,348.688764,34,0
0,0,27,27,19,29,48,155,125,280,0.000333,0.521263,36,56296.42201,3127.579,1563.7895,221.592072,13,0
0,0,26,26,16,36,52,197,152,349,0.000333,0.663151,32,63662.51077,3536.806154,1989.453462,250.1173,6,0
0,0,23,23,17,37,54,209,155,364,0.000333,0.69826,32,67032.92963,3724.051646,2094.779051,262.236643,5,0
0,0,24,24,15,28,43,115,92,207,0.000333,0.374412,21,23587.97289,1310.442938,1123.236804,193.209297,6,0
0,0,22,22,15,27,42,110,86,196,0.000333,0.352298,21,22194.77851,1233.043251,1056.894215,186.985321,6,0
0,0,21,21,15,27,42,109,84,193,0.000333,0.346906,21,21855.06252,1214.17014,1040.717263,186.985321,6,0
0,0,19,19,15,25,40,107,79,186,0.000333,0.32996,21,20787.45114,1154.858397,989.878626,174.699764,6,0
0,0,24,24,21,31,52,135,100,235,0.000333,0.446534,30,40188.10001,2232.672223,1339.603334,245.818752,9,0
0,0,22,22,20,31,51,125,94,219,0.000333,0.414087,30,37267.8345,2070.43525,1242.26115,240.018648,8,0
0,0,12,12,14,20,34,63,39,102,0.000333,0.172974,7,3632.448469,201.802693,518.92121,139.741531,9,0
0,0,20,20,16,29,45,87,59,146,0.000333,0.26727,16,12828.96883,712.720491,801.810552,204.881449,15,0
0,0,20,20,18,46,64,104,75,179,0.000333,0.358,9,9666,537,1074,329.1425,8,0
0,0,20,20,19,45,64,105,74,179,0.000333,0.358,9,9666,537,1074,327.844012,8,0
0,0,20,20,19,45,64,105,74,179,0.000333,0.358,9,9666,537,1074,327.844012,8,0
0,0,31,31,22,50,72,158,101,259,0.000333,0.53267,22,35156.23266,1953.124037,1598.010575,380.300305,12,0
0,0,31,31,22,50,72,158,101,259,0.000333,0.53267,22,35156.23266,1953.124037,1598.010575,380.300305,12,0
0,0,31,31,21,49,70,158,101,259,0.000333,0.529161,20,31749.68603,1763.871446,1587.484301,367.359448,12,0
0,0,32,32,24,51,75,165,108,273,0.000333,0.566823,24,40811.22006,2267.290003,1700.467503,399.332792,12,0
0,0,30,30,21,49,70,155,100,255,0.000333,0.520989,20,31259.34339,1736.630188,1562.967169,367.359448,11,0
0,0,32,32,21,50,71,162,110,272,0.000333,0.557577,20,33454.62433,1858.590241,1672.731217,374.431475,11,0
0,0,32,32,21,50,71,162,110,272,0.000333,0.557577,20,33454.62433,1858.590241,1672.731217,374.431475,11,0
0,0,32,32,19,51,70,158,111,269,0.000333,0.549592,18,29677.98837,1648.777132,1648.777132,370.004315,11,0
0,0,32,32,21,53,74,161,114,275,0.000333,0.5692,20,34151.99351,1897.332973,1707.599676,395.81845,11,0
0,0,32,32,21,53,74,161,114,275,0.000333,0.5692,20,34151.99351,1897.332973,1707.599676,395.81845,11,0
0,0,32,32,21,50,71,161,106,267,0.000333,0.547327,20,32839.64962,1824.424979,1641.982481,374.431475,11,0
0,0,33,33,21,50,71,167,108,275,0.000333,0.563727,20,33823.60916,1879.089398,1691.180458,374.431475,11,0
0,0,32,32,21,52,73,162,107,269,0.000333,0.555021,20,33301.25613,1850.069785,1665.062806,388.661531,11,0
0,0,12,12,14,20,34,63,39,102,0.000333,0.172974,7,3632.448469,201.802693,518.92121,139.741531,9,0
0,0,25,25,20,51,71,127,99,226,0.000333,0.463281,10,13898.42849,772.134916,1389.842849,375.732254,9,0
0,0,18,18,15,25,40,103,57,160,0.000333,0.283836,14,11921.11893,662.284385,851.508495,174.699764,7,0
0,0,18,18,15,25,40,104,57,161,0.000333,0.28561,14,11995.62593,666.423663,856.830423,174.699764,7,0
0,0,22,22,18,48,66,114,83,197,0.000333,0.396915,9,10716.71077,595.372821,1190.745642,343.13685,9,0
0,0,24,24,21,50,71,124,91,215,0.000333,0.440732,10,13221.95631,734.553128,1322.195631,374.431475,10,0
0,0,22,22,18,48,66,114,83,197,0.000333,0.396915,9,10716.71077,595.372821,1190.745642,343.13685,9,0
0,0,12,12,14,20,34,63,39,102,0.000333,0.172974,7,3632.448469,201.802693,518.92121,139.741531,9,0
0,0,26,26,18,33,51,137,82,219,0.000333,0.414087,18,22360.7007,1242.26115,1242.26115,241.523656,12,0
0,0,16,16,16,27,43,170,88,258,0.000333,0.466659,24,33599.43136,1866.635076,1399.976307,192.381963,8,0
0,0,15,15,16,25,41,166,84,250,0.000333,0.446463,24,32145.31203,1785.850668,1339.388001,180.096405,8,0
0,0,24,24,18,49,67,123,89,212,0.000333,0.42867,9,11574.09818,643.005454,1286.010908,350.179432,9,0
0,0,22,22,18,48,66,114,83,197,0.000333,0.396915,9,10716.71077,595.372821,1190.745642,343.13685,9,0
0,0,22,22,18,48,66,114,83,197,0.000333,0.396915,9,10716.71077,595.372821,1190.745642,343.13685,9,0
0,0,22,22,18,48,66,114,83,197,0.000333,0.396915,9,10716.71077,595.372821,1190.745642,343.13685,9,0
0,0,21,21,16,47,63,111,79,190,0.000333,0.378561,8,9085.465484,504.748082,1135.683185,325.065676,9,0
0,0,22,22,18,48,66,114,83,197,0.000333,0.396915,9,10716.71077,595.372821,1190.745642,343.13685,9,0
0,0,22,22,18,48,66,114,83,197,0.000333,0.396915,9,10716.71077,595.372821,1190.745642,343.13685,9,0
0,0,24,24,18,49,67,122,94,216,0.000333,0.436758,9,11792.47739,655.137633,1310.275265,350.179432,9,0
0,0,24,24,19,51,70,123,95,218,0.000333,0.445395,9,12025.65328,668.091849,1336.183698,370.004315,9,0
0,0,22,22,18,48,66,114,83,197,0.000333,0.396915,9,10716.71077,595.372821,1190.745642,343.13685,9,0
0,0,20,20,18,46,64,104,75,179,0.000333,0.358,9,9666,537,1074,329.1425,8,0
0,0,22,22,18,46,64,115,81,196,0.000333,0.392,9,10584,588,1176,329.1425,9,0
0,0,18,18,15,25,40,103,57,160,0.000333,0.283836,14,11921.11893,662.284385,851.508495,174.699764,7,0
0,0,18,18,15,25,40,104,57,161,0.000333,0.28561,14,11995.62593,666.423663,856.830423,174.699764,7,0
0,0,22,22,20,46,66,113,78,191,0.000333,0.384826,10,11544.79277,641.377376,1154.479277,340.522412,8,0
0,0,22,22,19,45,64,108,77,185,0.000333,0.37,9,9990,555,1110,327.844012,8,0
0,0,18,18,15,25,40,103,57,160,0.000333,0.283836,14,11921.11893,662.284385,851.508495,174.699764,7,0
0,0,18,18,15,25,40,104,57,161,0.000333,0.28561,14,11995.62593,666.423663,856.830423,174.699764,7,0
0,0,13,13,19,22,41,79,54,133,0.000333,0.237518,18,12825.9795,712.554417,712.554417,178.818118,6,0
0,0,46,46,24,53,77,252,162,414,0.000333,0.864817,36,93400.1866,5188.899256,2594.449628,413.618884,20,0
0,0,33,33,24,52,76,259,171,430,0.000333,0.895536,36,96717.91791,5373.217662,2686.608831,406.461965,11,0
0,0,19,19,23,35,58,121,87,208,0.000333,0.406153,22,26806.12103,1489.228946,1218.460047,283.566831,7,0
0,0,34,34,24,54,78,255,173,428,0.000333,0.896717,36,96845.47739,5380.304299,2690.15215,420.803025,11,0
0,0,93,93,22,65,87,510,306,816,0.000333,1.752481,44,231327.4433,12851.52463,5257.441893,489.561403,40,0
0,0,15,15,19,26,45,105,76,181,0.000333,0.331342,18,17892.45739,994.02541,994.02541,202.922055,6,0
0,0,23,23,23,37,60,146,103,249,0.000333,0.490272,22,32357.94668,1797.663705,1470.815758,296.7917,9,0
0,0,18,18,22,38,60,144,91,235,0.000333,0.462706,22,30538.62438,1696.590243,1388.11929,297.528741,6,0
0,0,51,51,26,67,93,317,199,516,0.000333,1.124735,26,87729.35461,4873.853034,3374.205947,528.639408,20,0
0,0,38,38,25,65,90,324,208,532,0.000333,1.151222,36,124331.9705,6907.331694,3453.665847,507.550313,11,0
0,0,24,24,25,51,76,186,124,310,0.000333,0.645619,24,46484.5807,2582.476706,1936.857529,405.390097,7,0
0,0,39,39,25,67,92,320,210,530,0.000333,1.152496,36,124469.5621,6914.975673,3457.487837,522.524381,11,0
0,0,98,98,25,78,103,575,343,918,0.000333,2.046069,48,294633.9592,16368.55329,6138.207484,606.357778,40,0
0,0,20,20,22,42,64,170,113,283,0.000333,0.566,22,37356,2075.333333,1698,324.584827,6,0
0,0,28,28,25,53,78,211,140,351,0.000333,0.735392,24,52948.22829,2941.568238,2206.176179,419.676189,9,0
0,0,15,15,22,38,60,137,85,222,0.000333,0.43711,22,28849.25367,1602.736315,1311.329712,297.528741,6,0
0,0,48,48,26,67,93,310,193,503,0.000333,1.096399,26,85519.11893,4751.062163,3289.196882,528.639408,20,0
0,0,35,35,25,65,90,317,202,519,0.000333,1.123091,36,121293.7833,6738.543514,3369.271757,507.550313,11,0
0,0,21,21,25,51,76,179,118,297,0.000333,0.618545,24,44535.22732,2474.179295,1855.634471,405.390097,7,0
0,0,36,36,25,67,92,313,204,517,0.000333,1.124227,36,121416.5351,6745.363063,3372.681531,522.524381,11,0
0,0,95,95,25,78,103,568,337,905,0.000333,2.017094,48,290461.5829,16136.75461,6051.282977,606.357778,40,0
0,0,17,17,22,42,64,163,107,270,0.000333,0.54,22,35640,1980,1620,324.584827,6,0
0,0,25,25,25,53,78,204,134,338,0.000333,0.708155,24,50987.1828,2832.621267,2124.46595,419.676189,9,0
0,0,18,18,15,25,40,103,57,160,0.000333,0.283836,14,11921.11893,662.284385,851.508495,174.699764,7,0
0,0,18,18,15,25,40,104,57,161,0.000333,0.28561,14,11995.62593,666.423663,856.830423,174.699764,7,0
0,0,14,14,14,19,33,73,50,123,0.000333,0.20682,14,8686.446674,482.580371,620.460477,134.013592,1,0
0,0,14,14,14,20,34,78,56,134,0.000333,0.22724,14,9544.08029,530.226683,681.720021,139.741531,1,0
0,0,14,14,14,19,33,80,56,136,0.000333,0.228679,14,9604.526403,533.5848,686.0376,134.013592,1,0
0,0,14,14,14,20,34,78,55,133,0.000333,0.225544,14,9472.85581,526.269767,676.632558,139.741531,1,0
0,0,6,6,9,16,25,34,30,64,0.000333,0.099069,4,1188.827185,66.045955,297.206796,92.529325,1,0
0,0,6,6,9,15,24,36,31,67,0.000333,0.102397,8,2457.5399,136.529994,307.192488,87.132684,1,0
0,0,22,22,17,31,48,113,85,198,0.000333,0.368608,16,17693.1612,982.9534,1105.822575,223.066954,2,0
0,0,10,10,14,27,41,69,50,119,0.000333,0.212516,7,4462.84082,247.935601,637.548689,181.684931,2,0
0,0,9,9,12,18,30,46,41,87,0.000333,0.1423,12,5122.793782,284.599655,426.899482,118.0782,2,0
0,0,29,29,26,33,59,161,126,287,0.000333,0.562773,39,65844.42365,3658.023536,1688.318555,288.676439,8,0
0,0,8,8,11,15,26,40,36,76,0.000333,0.119078,10,3572.334186,198.46301,357.233419,96.657107,1,0
0,0,24,24,17,31,48,117,90,207,0.000333,0.385362,16,18497.3958,1027.6331,1156.087238,223.066954,2,0
0,0,12,12,14,27,41,73,55,128,0.000333,0.228589,14,9600.733192,533.374066,685.766657,181.684931,2,0
0,0,11,11,14,18,32,50,46,96,0.000333,0.16,14,6720,373.333333,480,128.361619,2,0
0,0,7,7,12,11,23,44,38,82,0.000333,0.123644,18,6676.777447,370.93208,370.93208,81.073298,3,0
0,0,46,46,25,34,59,340,265,605,0.000333,1.186333,84,298955.9198,16608.66221,3558.999045,289.070141,20,0
0,0,20,20,17,28,45,132,86,218,0.000333,0.399075,24,28733.3754,1596.298633,1197.223975,204.092806,8,0
0,0,22,22,18,28,46,141,91,232,0.000333,0.427155,27,34599.59209,1922.199561,1281.466374,209.664588,9,0
0,0,30,30,23,33,56,175,134,309,0.000333,0.598158,44,78956.79752,4386.488751,1794.472671,270.506931,4,0
0,0,18,18,15,25,40,103,57,160,0.000333,0.283836,14,11921.11893,662.284385,851.508495,174.699764,7,0
0,0,18,18,15,25,40,104,57,161,0.000333,0.28561,14,11995.62593,666.423663,856.830423,174.699764,7,0
0,0,55,55,21,39,60,266,186,452,0.000333,0.889972,40,106796.582,5933.143443,2669.914549,298.369352,6,0
0,0,21,21,20,32,52,143,86,229,0.000333,0.435134,20,26108.01391,1450.445217,1305.400695,246.438562,4,0
0,0,53,53,29,47,76,267,183,450,0.000333,0.937189,42,118085.83,6560.323889,2811.567381,401.947125,20,0
0,0,12,12,20,13,33,72,55,127,0.000333,0.213546,40,25625.52213,1423.640118,640.638053,134.544278,5,0
0,0,44,44,32,46,78,279,187,466,0.000333,0.976332,64,187455.8358,10414.2131,2928.997434,414.08385,17,0
0,0,15,15,19,20,39,96,72,168,0.000333,0.295983,27,23974.58447,1331.921359,887.947573,167.149185,8,0
0,0,13,13,18,19,37,89,68,157,0.000333,0.272628,27,22082.87282,1226.826268,817.884178,155.769273,7,0
0,0,47,47,33,53,86,303,204,507,0.000333,1.086039,48,156389.5791,8688.309948,3258.116231,470.04479,20,0
0,0,12,12,19,20,39,87,66,153,0.000333,0.269556,27,21833.99657,1212.999809,808.666539,167.149185,7,0
0,0,28,28,21,46,67,145,92,237,0.000333,0.479221,20,28753.26276,1597.403487,1437.663138,346.322516,10,0
0,0,28,28,21,46,67,145,92,237,0.000333,0.479221,20,28753.26276,1597.403487,1437.663138,346.322516,10,0
0,0,18,18,15,25,40,103,57,160,0.000333,0.283836,14,11921.11893,662.284385,851.508495,174.699764,7,0
0,0,18,18,15,25,40,104,57,161,0.000333,0.28561,14,11995.62593,666.423663,856.830423,174.699764,7,0
0,0,18,18,15,25,40,103,57,160,0.000333,0.283836,14,11921.11893,662.284385,851.508495,174.699764,7,0
0,0,18,18,15,25,40,104,57,161,0.000333,0.28561,14,11995.62593,666.423663,856.830423,174.699764,7,0
0,0,62,62,30,39,69,447,277,724,0.000333,1.474191,105,464370.0292,25798.33496,4422.571707,353.337404,39,0
0,0,37,37,29,44,73,272,177,449,0.000333,0.92641,56,155636.9487,8646.49715,2779.231227,381.09644,14,0
0,0,21,21,20,25,45,101,83,184,0.000333,0.336834,30,30315.02909,1684.168283,1010.50097,202.534967,13,0
0,0,46,46,28,39,67,413,205,618,0.000333,1.249614,70,262419.0184,14578.83435,3748.84312,340.736624,13,0
0,0,78,78,29,59,88,472,312,784,0.000333,1.688065,70,354493.6072,19694.08929,5064.194389,487.957389,31,0
0,0,71,71,29,53,82,426,282,708,0.000333,1.500382,70,315080.2773,17504.45985,4501.146819,444.461233,30,0
0,0,67,67,29,55,84,408,271,679,0.000333,1.446795,56,243061.4777,13503.41543,4340.38353,458.856233,27,0
0,0,60,60,29,49,78,362,241,603,0.000333,1.263366,56,212245.4621,11791.41456,3790.097538,416.002231,26,0
0,0,63,63,28,54,82,388,254,642,0.000333,1.360516,56,228566.7097,12698.15054,4081.548387,445.369863,27,0
0,0,63,63,28,53,81,392,256,648,0.000333,1.369408,56,230060.4769,12781.13761,4108.222802,438.185722,27,0
0,0,54,54,26,45,71,315,201,516,0.000333,1.057757,52,165010.0147,9167.223039,3173.269514,369.344822,25,0
0,0,26,26,23,29,52,167,114,281,0.000333,0.533941,33,52860.17751,2936.676528,1601.823561,244.923374,10,0
0,0,28,28,23,29,52,175,120,295,0.000333,0.560543,44,73991.70754,4110.650419,1681.629717,244.923374,10,0
0,0,11,11,21,26,47,92,56,148,0.000333,0.274026,20,16441.583,913.421278,822.07915,214.450099,6,0
0,0,11,11,21,26,47,92,56,148,0.000333,0.274026,20,16441.583,913.421278,822.07915,214.450099,6,0
0,0,18,18,15,25,40,103,57,160,0.000333,0.283836,14,11921.11893,662.284385,851.508495,174.699764,7,0
0,0,18,18,15,25,40,104,57,161,0.000333,0.28561,14,11995.62593,666.423663,856.830423,174.699764,7,0
0,0,12,12,14,20,34,63,39,102,0.000333,0.172974,7,3632.448469,201.802693,518.92121,139.741531,9,0
0,0,20,20,17,29,46,92,59,151,0.000333,0.278019,16,13344.92569,741.38476,834.057855,210.368317,12,0
0,0,77,77,37,106,143,544,420,964,0.000333,2.300705,54,372714.2623,20706.34791,6902.115969,905.909343,28,0
0,0,18,18,15,25,40,103,57,160,0.000333,0.283836,14,11921.11893,662.284385,851.508495,174.699764,7,0
0,0,18,18,15,25,40,104,57,161,0.000333,0.28561,14,11995.62593,666.423663,856.830423,174.699764,7,0
0,0,36,36,26,49,75,208,142,350,0.000333,0.726696,26,56682.25008,3149.013894,2180.086542,397.332215,21,0
0,0,31,31,21,34,55,174,128,302,0.000333,0.58199,30,52379.11901,2909.951056,1745.970633,265.212402,25,0
0,0,42,42,26,52,78,230,163,393,0.000333,0.823388,39,96336.35981,5352.019989,2470.163072,418.634298,30,0
0,0,18,18,15,25,40,103,57,160,0.000333,0.283836,14,11921.11893,662.284385,851.508495,174.699764,7,0
0,0,18,18,15,25,40,104,57,161,0.000333,0.28561,14,11995.62593,666.423663,856.830423,174.699764,7,0
0,0,27,27,21,45,66,142,90,232,0.000333,0.467433,20,28045.98871,1558.110484,1402.299436,339.372055,9,0
0,0,29,29,21,47,68,145,102,247,0.000333,0.501201,20,30072.06644,1670.670358,1503.603322,353.304342,9,0
0,0,29,29,22,48,70,146,108,254,0.000333,0.518946,22,34250.4335,1902.801861,1556.837886,366.185696,9,0
0,0,20,20,18,46,64,104,75,179,0.000333,0.358,9,9666,537,1074,329.1425,8,0
0,0,18,18,15,25,40,103,57,160,0.000333,0.283836,14,11921.11893,662.284385,851.508495,174.699764,7,0
0,0,18,18,15,25,40,104,57,161,0.000333,0.28561,14,11995.62593,666.423663,856.830423,174.699764,7,0
0,0,21,21,17,24,41,101,78,179,0.000333,0.319667,24,23016.04341,1278.669078,959.001809,179.525968,9,0
0,0,40,40,27,48,75,237,163,400,0.000333,0.830509,39,97169.57157,5398.309532,2491.527476,396.460163,21,0
0,0,22,22,19,26,45,114,86,200,0.000333,0.366124,27,29656.00672,1647.555929,1098.370619,202.922055,11,0
0,0,41,41,29,49,78,250,171,421,0.000333,0.882051,42,111138.482,6174.360113,2646.154334,416.002231,23,0
0,0,10,10,18,21,39,90,61,151,0.000333,0.266032,18,14365.72323,798.095735,798.095735,167.297316,4,0
0,0,27,27,17,30,47,86,66,152,0.000333,0.281433,16,13508.76009,750.486672,844.297505,216.693586,7,0
0,0,33,33,21,49,70,189,139,328,0.000333,0.670135,20,40208.09659,2233.783144,2010.40483,367.359448,20,0
0,0,37,37,21,51,72,196,150,346,0.000333,0.711598,20,42695.88101,2371.993389,2134.79405,381.532358,17,0
0,0,25,25,19,41,60,148,106,254,0.000333,0.500117,18,27006.3038,1500.350211,1500.350211,300.370255,19,0
0,0,31,31,20,45,65,163,123,286,0.000333,0.574132,20,34447.94389,1913.774661,1722.397195,333.571951,16,0
0,0,15,15,29,25,54,127,94,221,0.000333,0.423943,42,53416.8658,2967.603655,1271.830138,256.977854,14,0
0,0,22,22,18,48,66,114,83,197,0.000333,0.396915,9,10716.71077,595.372821,1190.745642,343.13685,9,0
0,0,19,19,18,45,63,101,74,175,0.000333,0.348675,9,9414.21588,523.011993,1046.023987,322.192039,7,0
0,0,19,19,18,45,63,101,74,175,0.000333,0.348675,9,9414.21588,523.011993,1046.023987,322.192039,7,0
0,0,19,19,18,44,62,101,73,174,0.000333,0.345343,9,9324.271422,518.015079,1036.030158,315.273641,7,0
0,0,19,19,18,45,63,101,74,175,0.000333,0.348675,9,9414.21588,523.011993,1046.023987,322.192039,7,0
0,0,21,21,18,46,64,109,87,196,0.000333,0.392,9,10584,588,1176,329.1425,7,0
0,0,21,21,19,48,67,110,87,197,0.000333,0.39834,9,10755.17614,597.509785,1195.019571,348.788823,7,0
0,0,18,18,15,25,40,103,57,160,0.000333,0.283836,14,11921.11893,662.284385,851.508495,174.699764,7,0
0,0,18,18,15,25,40,104,57,161,0.000333,0.28561,14,11995.62593,666.423663,856.830423,174.699764,7,0
0,0,27,27,20,33,53,150,99,249,0.000333,0.475417,30,42787.5658,2377.086989,1426.252193,252.903568,9,0
0,0,62,62,30,39,69,447,277,724,0.000333,1.474191,105,464370.0292,25798.33496,4422.571707,353.337404,39,0
0,0,37,37,29,44,73,272,177,449,0.000333,0.92641,56,155636.9487,8646.49715,2779.231227,381.09644,14,0
0,0,21,21,20,25,45,101,83,184,0.000333,0.336834,30,30315.02909,1684.168283,1010.50097,202.534967,13,0
0,0,46,46,28,39,67,413,205,618,0.000333,1.249614,70,262419.0184,14578.83435,3748.84312,340.736624,13,0
0,0,74,74,29,54,83,438,291,729,0.000333,1.549135,70,325318.2622,18073.23679,4647.403745,451.645374,30,0
0,0,81,81,29,60,89,484,321,805,0.000333,1.737655,70,364907.5788,20272.64327,5212.965412,495.294885,31,0
0,0,63,63,29,50,79,374,250,624,0.000333,1.311186,70,275349.1431,15297.17462,3933.559187,423.074258,26,0
0,0,70,70,29,56,85,420,280,700,0.000333,1.495525,70,314060.1559,17447.78644,4486.573655,466.093324,27,0
0,0,66,66,28,55,83,400,263,663,0.000333,1.408884,56,236692.464,13149.58133,4226.651143,452.580722,27,0
0,0,66,66,28,54,82,404,265,669,0.000333,1.417734,56,238179.3283,13232.18491,4253.202291,445.369863,27,0
0,0,57,57,26,46,72,327,210,537,0.000333,1.104417,52,172288.9857,9571.610319,3313.249726,376.295283,25,0
0,0,26,26,23,29,52,167,114,281,0.000333,0.533941,33,52860.17751,2936.676528,1601.823561,244.923374,10,0
0,0,28,28,23,29,52,175,120,295,0.000333,0.560543,44,73991.70754,4110.650419,1681.629717,244.923374,10,0
0,0,11,11,21,26,47,92,56,148,0.000333,0.274026,20,16441.583,913.421278,822.07915,214.450099,6,0
0,0,11,11,21,26,47,92,56,148,0.000333,0.274026,20,16441.583,913.421278,822.07915,214.450099,6,0
0,0,12,12,14,20,34,63,39,102,0.000333,0.172974,7,3632.448469,201.802693,518.92121,139.741531,9,0
0,0,18,18,15,25,40,103,57,160,0.000333,0.283836,14,11921.11893,662.284385,851.508495,174.699764,7,0
0,0,18,18,15,25,40,104,57,161,0.000333,0.28561,14,11995.62593,666.423663,856.830423,174.699764,7,0
0,0,36,36,19,44,63,261,194,455,0.000333,0.906554,36,97907.84515,5439.32473,2719.662365,320.925614,7,0
0,0,35,35,18,44,62,256,190,446,0.000333,0.885191,36,95600.57596,5311.143109,2655.571554,315.273641,6,0
0,0,42,42,16,51,67,269,209,478,0.000333,0.96653,32,92786.90026,5154.827792,2899.590633,353.293692,9,0
0,0,14,14,17,17,34,87,68,155,0.000333,0.262852,32,25233.81569,1401.87865,788.55674,138.973737,5,0
0,0,10,10,12,15,27,57,45,102,0.000333,0.161666,18,8729.973454,484.998525,484.998525,101.622909,3,0
0,0,19,19,19,25,44,101,78,179,0.000333,0.325746,27,26385.43301,1465.85739,977.23826,196.807027,6,0
0,0,12,12,14,17,31,76,57,133,0.000333,0.219636,21,13837.0703,768.726127,658.908109,122.789837,4,0
0,0,12,12,14,19,33,74,56,130,0.000333,0.21859,14,9180.797297,510.044294,655.771236,134.013592,4,0
0,0,13,13,14,17,31,76,55,131,0.000333,0.216333,21,13628.99405,757.166336,648.999717,122.789837,5,0
0,0,12,12,13,18,31,75,57,132,0.000333,0.217985,18,11771.17043,653.953913,653.953913,123.164366,4,0
0,0,25,25,25,30,55,167,132,299,0.000333,0.576209,48,82974.07461,4609.670812,1728.626554,263.303123,24,0
0,0,20,20,26,27,53,128,92,220,0.000333,0.420048,39,49145.5575,2730.30875,1260.1425,250.593395,8,0
0,0,19,19,23,24,47,118,89,207,0.000333,0.383267,33,37943.39645,2107.966469,1149.799892,214.081025,7,0
0,0,21,21,20,24,44,124,94,218,0.000333,0.396719,30,35704.68279,1983.593488,1190.156093,196.477662,8,0
0,0,13,13,13,14,27,67,51,118,0.000333,0.187026,18,10099.38106,561.076725,561.076725,101.408685,4,0
0,0,15,15,20,25,45,96,68,164,0.000333,0.300221,20,18013.27816,1000.737675,900.663908,202.534967,6,0
0,0,14,14,17,21,38,86,65,151,0.000333,0.264146,24,19018.48931,1056.582739,792.437055,161.725534,5,0
0,0,16,16,15,22,37,92,70,162,0.000333,0.28131,21,17722.56035,984.586686,843.931445,156.710855,6,0
0,0,14,14,15,24,39,93,72,165,0.000333,0.290697,21,18313.91869,1017.439927,872.091366,168.642459,4,0
0,0,14,14,14,23,37,93,71,164,0.000333,0.284783,21,17941.35739,996.742077,854.350352,157.344894,4,0
0,0,14,14,15,24,39,93,72,165,0.000333,0.290697,21,18313.91869,1017.439927,872.091366,168.642459,4,0
0,0,14,14,14,23,37,93,71,164,0.000333,0.284783,21,17941.35739,996.742077,854.350352,157.344894,4,0
0,0,14,14,15,24,39,93,72,165,0.000333,0.290697,21,18313.91869,1017.439927,872.091366,168.642459,4,0
0,0,14,14,14,23,37,93,71,164,0.000333,0.284783,21,17941.35739,996.742077,854.350352,157.344894,4,0
0,0,14,14,14,18,32,91,69,160,0.000333,0.266667,21,16800,933.333333,800,128.361619,4,0
0,0,14,14,14,20,34,90,69,159,0.000333,0.269636,21,16987.03843,943.724357,808.906592,139.741531,4,0
0,0,14,14,15,24,39,93,72,165,0.000333,0.290697,21,18313.91869,1017.439927,872.091366,168.642459,4,0
0,0,14,14,14,23,37,93,71,164,0.000333,0.284783,21,17941.35739,996.742077,854.350352,157.344894,4,0
0,0,14,14,15,23,38,89,70,159,0.000333,0.27814,21,17522.82997,973.490554,834.420475,162.645284,4,0
0,0,14,14,14,22,36,89,69,158,0.000333,0.272283,21,17153.81116,952.989509,816.84815,151.410465,4,0
0,0,14,14,14,23,37,90,71,161,0.000333,0.279574,21,17613.16183,978.508991,838.721992,157.344894,4,0
0,0,14,14,14,22,36,90,70,160,0.000333,0.275729,21,17370.94801,965.052667,827.188,151.410465,4,0
0,0,30,30,22,38,60,155,118,273,0.000333,0.537527,33,53215.17738,2956.398743,1612.581133,297.528741,9,0
0,0,14,14,15,22,37,86,67,153,0.000333,0.265682,21,16737.97366,929.887426,797.046365,156.710855,4,0
0,0,14,14,15,20,35,85,69,154,0.000333,0.263303,21,16588.10128,921.561182,789.909585,145.041921,4,0
0,0,30,30,23,40,63,160,123,283,0.000333,0.563857,33,55821.81721,3101.212067,1691.570218,316.919049,9,0
0,0,31,31,23,43,66,167,132,299,0.000333,0.602425,33,59640.03678,3313.335376,1807.273842,337.371309,9,0
0,0,14,14,15,23,38,89,70,159,0.000333,0.27814,21,17522.82997,973.490554,834.420475,162.645284,4,0
0,0,14,14,14,22,36,89,69,158,0.000333,0.272283,21,17153.81116,952.989509,816.84815,151.410465,4,0
0,0,14,14,14,23,37,90,71,161,0.000333,0.279574,21,17613.16183,978.508991,838.721992,157.344894,4,0
0,0,14,14,14,22,36,90,70,160,0.000333,0.275729,21,17370.94801,965.052667,827.188,151.410465,4,0
0,0,30,30,22,37,59,154,118,272,0.000333,0.53336,33,52802.60401,2933.478001,1600.078909,290.85727,9,0
0,0,14,14,14,23,37,85,67,152,0.000333,0.263946,14,11085.71676,615.873153,791.836912,157.344894,4,0
0,0,14,14,14,21,35,84,69,153,0.000333,0.261593,21,16480.38633,915.577019,784.780302,145.541635,4,0
0,0,30,30,23,39,62,159,123,282,0.000333,0.559694,33,55409.75086,3078.319492,1679.08336,310.172612,9,0
0,0,31,31,23,42,65,166,132,298,0.000333,0.598222,33,59223.96507,3290.220282,1794.665608,330.519257,9,0
0,0,19,19,23,26,49,128,107,235,0.000333,0.439819,44,58056.09979,3225.338877,1319.456813,226.253358,22,0
0,0,16,16,22,21,43,88,79,167,0.000333,0.302062,33,29904.14506,1661.341392,906.186214,190.346161,11,0
0,0,17,17,22,25,47,119,98,217,0.000333,0.401782,33,39776.41077,2209.800598,1205.345781,214.2039,20,0
0,0,24,24,24,28,52,160,125,285,0.000333,0.541542,48,77982.01534,4332.334186,1624.62532,244.645038,22,0
0,0,20,20,22,27,49,147,113,260,0.000333,0.486608,44,64232.28062,3568.460034,1459.824559,226.489458,19,0
0,0,49,49,23,35,58,259,199,458,0.000333,0.894318,55,147562.5413,8197.918959,2682.955296,283.566831,23,0
0,0,33,33,20,33,53,188,148,336,0.000333,0.641527,40,76983.25091,4276.847273,1924.581273,252.903568,17,0
0,0,44,44,27,42,69,280,221,501,0.000333,1.020124,65,198924.0989,11051.33883,3060.370753,354.859294,35,0
0,0,32,32,22,33,55,176,138,314,0.000333,0.605116,44,79875.2658,4437.514767,1815.34695,264.572502,15,0
0,0,32,32,22,33,55,179,141,320,0.000333,0.616678,44,81401.54477,4522.308043,1850.035108,264.572502,14,0
0,0,32,32,22,34,56,182,142,324,0.000333,0.627194,44,82789.65177,4599.425098,1881.582995,271.081232,16,0
0,0,32,32,22,33,55,179,141,320,0.000333,0.616678,44,81401.54477,4522.308043,1850.035108,264.572502,14,0
0,0,34,34,24,34,58,206,156,362,0.000333,0.706863,48,101788.2778,5654.904321,2120.58912,283.012837,17,0
0,0,37,37,24,34,58,223,164,387,0.000333,0.75568,48,108817.855,6045.436387,2267.038645,283.012837,19,0
0,0,44,44,20,34,54,231,175,406,0.000333,0.778828,50,116824.2163,6490.234239,2336.484326,259.412299,23,0
0,0,61,61,23,37,60,298,227,525,0.000333,1.033706,66,204673.7591,11370.7644,3101.117563,296.7917,29,0
0,0,35,35,22,33,55,189,152,341,0.000333,0.657148,44,86743.52114,4819.084508,1971.443662,264.572502,14,0
0,0,36,36,22,34,56,194,156,350,0.000333,0.677525,44,89433.2658,4968.514767,2032.574223,271.081232,14,0
0,0,44,44,24,51,75,250,202,452,0.000333,0.938475,36,101355.3377,5630.852096,2815.426048,399.332792,20,0
0,0,35,35,22,33,55,189,152,341,0.000333,0.657148,44,86743.52114,4819.084508,1971.443662,264.572502,14,0
0,0,34,34,20,32,52,182,148,330,0.000333,0.627048,40,75245.80428,4180.32246,1881.145107,246.438562,14,0
0,0,35,35,22,33,55,187,152,339,0.000333,0.653294,44,86234.76149,4790.820083,1959.880943,264.572502,14,0
0,0,43,43,23,50,73,243,198,441,0.000333,0.909904,33,90080.51681,5004.473156,2729.71263,386.234734,20,0
0,0,34,34,20,32,52,182,148,330,0.000333,0.627048,40,75245.80428,4180.32246,1881.145107,246.438562,14,0
0,0,35,35,22,34,56,190,153,343,0.000333,0.663974,44,87644.60048,4869.144471,1991.922738,271.081232,14,0
0,0,36,36,22,34,56,194,156,350,0.000333,0.677525,44,89433.2658,4968.514767,2032.574223,271.081232,14,0
0,0,35,35,22,33,55,190,153,343,0.000333,0.661002,44,87252.2808,4847.348933,1983.006382,264.572502,14,0
0,0,44,44,24,51,75,250,202,452,0.000333,0.938475,36,101355.3377,5630.852096,2815.426048,399.332792,20,0
0,0,34,34,21,34,55,184,150,334,0.000333,0.643658,40,77238.96577,4291.053654,1930.974144,265.212402,14,0
0,0,35,35,22,34,56,188,153,341,0.000333,0.660103,44,87133.55325,4840.752958,1980.308028,271.081232,14,0
0,0,34,34,21,33,54,184,150,334,0.000333,0.640711,40,76885.29703,4271.40539,1922.132426,258.703672,14,0
0,0,43,43,23,51,74,244,199,443,0.000333,0.916929,33,90775.99875,5043.111042,2750.787841,393.335617,20,0
0,0,61,61,24,41,65,306,238,544,0.000333,1.092056,60,196570.0854,10920.5603,3276.16809,329.698732,25,0
0,0,31,31,20,33,53,172,135,307,0.000333,0.586157,40,70338.86318,3907.714621,1758.47158,252.903568,17,0
0,0,42,42,27,42,69,264,208,472,0.000333,0.961075,52,149927.6243,8329.312459,2883.223544,354.859294,35,0
0,0,30,30,22,33,55,160,125,285,0.000333,0.549229,33,54373.68811,3020.76045,1647.687518,264.572502,15,0
0,0,30,30,22,33,55,163,128,291,0.000333,0.560792,33,55518.39733,3084.355407,1682.375677,264.572502,14,0
0,0,30,30,22,34,56,166,129,295,0.000333,0.571057,33,56534.60017,3140.81112,1713.169702,271.081232,16,0
0,0,30,30,22,33,55,163,128,291,0.000333,0.560792,33,55518.39733,3084.355407,1682.375677,264.572502,14,0
0,0,32,32,24,34,58,190,143,333,0.000333,0.650236,48,93633.96823,5201.887124,1950.707671,283.012837,17,0
0,0,35,35,24,34,58,207,151,358,0.000333,0.699052,48,100663.5454,5592.41919,2097.157196,283.012837,19,0
0,0,42,42,20,34,54,215,162,377,0.000333,0.723198,40,86783.70353,4821.316863,2169.592588,259.412299,23,0
0,0,59,59,23,37,60,282,214,496,0.000333,0.976606,55,161139.9754,8952.220858,2929.817735,296.7917,29,0
0,0,33,33,22,33,55,173,139,312,0.000333,0.601261,44,79366.50615,4409.250342,1803.784231,264.572502,14,0
0,0,34,34,22,34,56,178,143,321,0.000333,0.621387,44,82023.08092,4556.837829,1864.16093,271.081232,14,0
0,0,42,42,24,51,75,234,189,423,0.000333,0.878263,36,94852.45102,5269.580612,2634.790306,399.332792,20,0
0,0,33,33,22,33,55,173,139,312,0.000333,0.601261,44,79366.50615,4409.250342,1803.784231,264.572502,14,0
0,0,32,32,20,32,52,166,135,301,0.000333,0.571944,40,68633.29421,3812.960789,1715.832355,246.438562,14,0
0,0,33,33,22,33,55,171,139,310,0.000333,0.597407,44,78857.74649,4380.985916,1792.221511,264.572502,14,0
0,0,41,41,23,50,73,227,185,412,0.000333,0.850069,33,84156.8547,4675.380817,2550.207718,386.234734,20,0
0,0,32,32,20,32,52,166,135,301,0.000333,0.571944,40,68633.29421,3812.960789,1715.832355,246.438562,14,0
0,0,33,33,22,34,56,174,140,314,0.000333,0.607836,44,80234.4156,4457.467534,1823.509446,271.081232,14,0
0,0,34,34,22,34,56,178,143,321,0.000333,0.621387,44,82023.08092,4556.837829,1864.16093,271.081232,14,0
0,0,33,33,22,33,55,174,140,314,0.000333,0.605116,44,79875.2658,4437.514767,1815.34695,264.572502,14,0
0,0,42,42,24,51,75,234,189,423,0.000333,0.878263,36,94852.45102,5269.580612,2634.790306,399.332792,20,0
0,0,32,32,21,34,55,168,137,305,0.000333,0.587772,40,70532.58851,3918.477139,1763.314713,265.212402,14,0
0,0,33,33,22,34,56,172,140,312,0.000333,0.603965,44,79723.36837,4429.076021,1811.894736,271.081232,14,0
0,0,32,32,21,33,54,168,137,305,0.000333,0.58508,40,70209.62753,3900.534863,1755.240688,258.703672,14,0
0,0,41,41,23,51,74,228,186,414,0.000333,0.856905,33,84833.55188,4712.975105,2570.713693,393.335617,20,0
0,0,4,4,9,11,20,35,23,58,0.000333,0.083557,8,2005.374636,111.409702,250.67183,66.583073,1,0
0,0,23,23,17,22,39,104,81,185,0.000333,0.325933,24,23467.18585,1303.732547,977.79941,167.594364,11,0
0,0,75,75,25,44,69,366,279,645,0.000333,1.313333,72,283679.8758,15759.9931,3939.998275,356.311396,31,0
0,0,61,61,22,42,64,310,236,546,0.000333,1.092,55,180180,10010,3276,324.584827,25,0
0,0,59,59,22,42,64,297,225,522,0.000333,1.044,55,172260,9570,3132,324.584827,25,0
0,0,48,48,24,40,64,250,198,448,0.000333,0.896,48,129024,7168,2688,322.916224,22,0
0,0,41,41,26,42,68,261,208,469,0.000333,0.951673,52,148461.0438,8247.835765,2855.020073,348.688764,34,0
0,0,32,32,19,35,54,179,147,326,0.000333,0.625364,36,67539.35973,3752.186651,1876.093326,260.235528,16,0
0,0,27,27,19,29,48,155,125,280,0.000333,0.521263,36,56296.42201,3127.579,1563.7895,221.592072,13,0
0,0,29,29,19,30,49,160,127,287,0.000333,0.537141,36,58011.18211,3222.843451,1611.421725,227.917341,14,0
0,0,23,23,17,37,54,209,155,364,0.000333,0.69826,32,67032.92963,3724.051646,2094.779051,262.236643,5,0
0,0,26,26,16,36,52,197,152,349,0.000333,0.663151,32,63662.51077,3536.806154,1989.453462,250.1173,6,0
0,0,24,24,15,28,43,115,92,207,0.000333,0.374412,21,23587.97289,1310.442938,1123.236804,193.209297,6,0
0,0,22,22,15,27,42,110,86,196,0.000333,0.352298,21,22194.77851,1233.043251,1056.894215,186.985321,6,0
0,0,21,21,15,27,42,109,84,193,0.000333,0.346906,21,21855.06252,1214.17014,1040.717263,186.985321,6,0
0,0,19,19,15,25,40,107,79,186,0.000333,0.32996,21,20787.45114,1154.858397,989.878626,174.699764,6,0
0,0,22,22,20,31,51,125,94,219,0.000333,0.414087,30,37267.8345,2070.43525,1242.26115,240.018648,8,0
0,0,24,24,21,31,52,135,100,235,0.000333,0.446534,30,40188.10001,2232.672223,1339.603334,245.818752,9,0
0,0,19,19,18,45,63,101,74,175,0.000333,0.348675,9,9414.21588,523.011993,1046.023987,322.192039,7,0
0,0,18,18,15,25,40,103,57,160,0.000333,0.283836,14,11921.11893,662.284385,851.508495,174.699764,7,0
0,0,18,18,15,25,40,104,57,161,0.000333,0.28561,14,11995.62593,666.423663,856.830423,174.699764,7,0
0,0,57,57,31,46,77,409,237,646,0.000333,1.349448,75,303625.8079,16868.10044,4048.344105,407.663936,35,0
0,0,35,35,30,42,72,236,170,406,0.000333,0.834997,60,150299.373,8349.965169,2504.989551,373.68405,21,0
0,0,41,41,31,44,75,283,199,482,0.000333,1.000764,60,180137.4365,10007.63536,3002.290609,393.795077,25,0
0,0,30,30,19,49,68,148,100,248,0.000333,0.50323,18,27174.43412,1509.690785,1509.690785,355.831405,11,0
0,0,30,30,20,51,71,149,100,249,0.000333,0.510429,10,15312.87033,850.715018,1531.287033,375.732254,11,0
0,0,34,34,19,54,73,164,120,284,0.000333,0.58597,18,31642.38315,1757.910175,1757.910175,391.474548,11,0
0,0,34,34,21,56,77,167,121,288,0.000333,0.601612,20,36096.69047,2005.371693,1804.834524,417.450542,11,0
0,0,34,34,19,53,72,173,118,291,0.000333,0.598483,18,32318.06716,1795.448175,1795.448175,384.290407,11,0
0,0,34,34,21,55,76,176,119,295,0.000333,0.61438,20,36862.77233,2047.931796,1843.138616,410.21345,11,0
0,0,33,33,19,52,71,164,114,278,0.000333,0.569877,18,30773.33459,1709.629699,1709.629699,377.133488,11,0
0,0,33,33,21,54,75,167,115,282,0.000333,0.585509,20,35130.53741,1951.696523,1756.526871,403.002591,11,0
0,0,12,12,14,20,34,63,39,102,0.000333,0.172974,7,3632.448469,201.802693,518.92121,139.741531,9,0
0,0,21,21,18,30,48,100,65,165,0.000333,0.307173,18,16587.33863,921.518813,921.518813,222.265368,11,0
0,0,18,18,13,30,43,99,79,178,0.000333,0.321958,12,11590.50152,643.916751,965.875126,195.312434,5,0
0,0,32,32,21,51,72,158,112,270,0.000333,0.555293,20,33317.59501,1850.9775,1665.87975,381.532358,11,0
0,0,32,32,22,52,74,159,118,277,0.000333,0.57334,22,37840.40881,2102.244934,1720.018582,394.530361,11,0
0,0,22,22,18,48,66,114,83,197,0.000333,0.396915,9,10716.71077,595.372821,1190.745642,343.13685,9,0
0,0,22,22,18,48,66,114,83,197,0.000333,0.396915,9,10716.71077,595.372821,1190.745642,343.13685,9,0
0,0,18,18,15,25,40,103,57,160,0.000333,0.283836,14,11921.11893,662.284385,851.508495,174.699764,7,0
0,0,18,18,15,25,40,104,57,161,0.000333,0.28561,14,11995.62593,666.423663,856.830423,174.699764,7,0
0,0,19,19,23,44,67,199,104,303,0.000333,0.612675,22,40436.55054,2246.47503,1838.025025,344.256916,6,0
0,0,27,27,27,49,76,278,141,419,0.000333,0.872627,26,68064.92233,3781.384574,2617.881628,403.502745,8,0
0,0,24,24,19,34,53,142,94,236,0.000333,0.450596,18,24332.20609,1351.789227,1351.789227,253.684359,8,0
0,0,16,16,13,27,40,63,57,120,0.000333,0.212877,12,7663.576457,425.754248,638.631371,176.487679,6,0
0,0,36,36,16,42,58,267,167,434,0.000333,0.847455,24,61016.73005,3389.818336,2542.363752,290.477332,4,0
0,0,35,35,16,42,58,263,165,428,0.000333,0.835739,24,60173.18078,3342.954488,2507.215866,290.477332,3,0
0,0,34,34,16,42,58,259,163,422,0.000333,0.824023,24,59329.63152,3296.09064,2472.06798,290.477332,2,0
0,0,17,17,14,34,48,126,80,206,0.000333,0.383501,14,16107.03185,894.835103,1150.502275,226.276706,1,0
0,0,28,28,27,55,82,268,148,416,0.000333,0.881581,26,68763.28248,3820.18236,2644.741634,446.356747,8,0
0,0,25,25,27,54,81,249,138,387,0.000333,0.817841,26,63791.57073,3543.976152,2453.521951,439.145888,8,0
0,0,22,22,27,54,81,241,131,372,0.000333,0.786141,26,61319.02923,3406.612735,2358.424201,439.145888,8,0
0,0,34,34,30,69,99,705,290,995,0.000333,2.198737,60,395772.5902,21987.36612,6596.209837,568.694905,18,0
0,0,34,34,30,69,99,705,290,995,0.000333,2.198737,60,395772.5902,21987.36612,6596.209837,568.694905,18,0
0,0,18,18,15,25,40,103,57,160,0.000333,0.283836,14,11921.11893,662.284385,851.508495,174.699764,7,0
0,0,18,18,15,25,40,104,57,161,0.000333,0.28561,14,11995.62593,666.423663,856.830423,174.699764,7,0
0,0,6,6,12,10,22,30,20,50,0.000333,0.074324,12,2675.658971,148.647721,222.971581,76.238831,4,0
0,0,18,18,20,31,51,104,87,191,0.000333,0.361144,20,21668.66481,1203.814711,1083.43324,240.018648,11,0
0,0,11,11,15,17,32,73,59,132,0.000333,0.22,21,13860,770,660,128.090227,11,0
0,0,15,15,16,18,34,72,55,127,0.000333,0.215369,24,15506.58674,861.477041,646.107781,139.05865,8,0
0,0,16,16,20,31,51,104,93,197,0.000333,0.372489,30,33524.03377,1862.446321,1117.467792,240.018648,9,0
0,0,12,12,16,24,40,81,67,148,0.000333,0.262548,16,12602.32573,700.129207,787.645358,174.0391,7,0
0,0,16,16,21,31,52,106,93,199,0.000333,0.378129,30,34031.62512,1890.64584,1134.387504,245.818752,9,0
0,0,31,31,23,29,52,175,105,280,0.000333,0.532041,33,52672.063,2926.225722,1596.123121,244.923374,9,0
0,0,28,28,24,41,65,170,120,290,0.000333,0.582162,24,41915.67998,2328.648888,1746.486666,329.698732,12,0
0,0,21,21,22,27,49,139,92,231,0.000333,0.432333,33,42800.93314,2377.829619,1296.997974,226.489458,12,0
0,0,25,25,22,28,50,138,88,226,0.000333,0.42517,33,42091.87946,2338.437748,1275.511499,232.713433,9,0
0,0,31,31,21,30,51,170,102,272,0.000333,0.5143,30,46286.99079,2571.499488,1542.899693,239.445384,13,0
0,0,25,25,19,25,44,153,83,236,0.000333,0.429475,27,34787.49827,1932.638793,1288.425862,196.807027,14,0
0,0,31,31,20,27,47,185,98,283,0.000333,0.523983,30,47158.45935,2619.914408,1571.948645,214.820524,19,0
0,0,26,26,26,41,67,170,126,296,0.000333,0.598521,39,70026.93362,3890.385201,1795.5624,341.871065,10,0
0,0,22,22,21,34,55,147,100,247,0.000333,0.475999,20,28559.91699,1586.662055,1427.995849,265.212402,8,0
0,0,26,26,26,41,67,172,126,298,0.000333,0.602565,39,70500.08857,3916.671587,1807.694579,341.871065,10,0
0,0,27,27,16,21,37,159,94,253,0.000333,0.439331,32,42175.73445,2343.096358,1317.991702,156.238666,18,0
0,0,48,48,29,52,81,309,201,510,0.000333,1.077775,42,135799.5871,7544.421503,3233.323501,437.304314,18,0
0,0,47,47,30,50,80,300,194,494,0.000333,1.041011,45,140536.4615,7807.581197,3123.032479,429.399527,19,0
0,0,48,48,30,53,83,311,201,512,0.000333,1.088007,45,146880.9085,8160.050472,3264.020189,450.786502,18,0
0,0,47,47,31,50,81,302,194,496,0.000333,1.048189,45,141505.4521,7861.414004,3144.565601,435.772895,19,0
0,0,18,18,15,25,40,103,57,160,0.000333,0.283836,14,11921.11893,662.284385,851.508495,174.699764,7,0
0,0,18,18,15,25,40,104,57,161,0.000333,0.28561,14,11995.62593,666.423663,856.830423,174.699764,7,0
0,0,8,8,16,14,30,52,34,86,0.000333,0.140664,16,6751.88146,375.104526,421.992591,117.302969,2,0
0,0,52,52,28,56,84,438,256,694,0.000333,1.478756,56,248431.0243,13801.72357,4436.268291,459.817813,29,0
0,0,29,29,22,47,69,314,169,483,0.000333,0.983472,33,97363.77132,5409.098406,2950.417313,359.173172,6,0
0,0,29,29,22,47,69,314,169,483,0.000333,0.983472,33,97363.77132,5409.098406,2950.417313,359.173172,6,0
0,0,28,28,22,48,70,308,167,475,0.000333,0.97047,33,96076.51129,5337.583961,2911.409433,366.185696,6,0
0,0,28,28,22,48,70,308,167,475,0.000333,0.97047,33,96076.51129,5337.583961,2911.409433,366.185696,6,0
0,0,22,22,18,48,66,114,83,197,0.000333,0.396915,9,10716.71077,595.372821,1190.745642,343.13685,9,0
0,0,22,22,18,48,66,114,83,197,0.000333,0.396915,9,10716.71077,595.372821,1190.745642,343.13685,9,0
0,0,22,22,19,47,66,115,82,197,0.000333,0.396915,9,10716.71077,595.372821,1190.745642,341.776299,9,0
0,0,24,24,18,49,67,123,89,212,0.000333,0.42867,9,11574.09818,643.005454,1286.010908,350.179432,9,0
0,0,24,24,19,48,67,124,88,212,0.000333,0.42867,9,11574.09818,643.005454,1286.010908,348.788823,9,0
0,0,21,21,16,47,63,111,79,190,0.000333,0.378561,8,9085.465484,504.748082,1135.683185,325.065676,9,0
0,0,24,24,19,49,68,123,90,213,0.000333,0.43221,9,11669.66627,648.314793,1296.629585,355.831405,9,0
0,0,24,24,18,49,67,122,94,216,0.000333,0.436758,9,11792.47739,655.137633,1310.275265,350.179432,9,0
0,0,24,24,19,51,70,123,95,218,0.000333,0.445395,9,12025.65328,668.091849,1336.183698,370.004315,9,0
0,0,22,22,18,48,66,114,83,197,0.000333,0.396915,9,10716.71077,595.372821,1190.745642,343.13685,9,0
0,0,22,22,18,48,66,114,83,197,0.000333,0.396915,9,10716.71077,595.372821,1190.745642,343.13685,9,0
0,0,22,22,18,48,66,114,83,197,0.000333,0.396915,9,10716.71077,595.372821,1190.745642,343.13685,9,0
0,0,22,22,19,47,66,115,82,197,0.000333,0.396915,9,10716.71077,595.372821,1190.745642,341.776299,9,0
0,0,22,22,18,48,66,114,83,197,0.000333,0.396915,9,10716.71077,595.372821,1190.745642,343.13685,9,0
0,0,22,22,18,48,66,114,83,197,0.000333,0.396915,9,10716.71077,595.372821,1190.745642,343.13685,9,0
0,0,22,22,19,47,66,115,82,197,0.000333,0.396915,9,10716.71077,595.372821,1190.745642,341.776299,9,0
0,0,21,21,16,47,63,111,79,190,0.000333,0.378561,8,9085.465484,504.748082,1135.683185,325.065676,9,0
0,0,21,21,17,46,63,112,78,190,0.000333,0.378561,8,9085.465484,504.748082,1135.683185,323.570718,9,0
0,0,20,20,18,44,62,104,74,178,0.000333,0.353282,9,9538.622489,529.923472,1059.846943,315.273641,8,0
0,0,20,20,18,45,63,104,74,178,0.000333,0.354652,9,9575.602437,531.977913,1063.955826,322.192039,8,0
0,0,20,20,19,44,63,105,73,178,0.000333,0.354652,9,9575.602437,531.977913,1063.955826,320.925614,8,0
0,0,20,20,19,44,63,105,73,178,0.000333,0.354652,9,9575.602437,531.977913,1063.955826,320.925614,8,0
0,0,20,20,18,46,64,104,75,179,0.000333,0.358,9,9666,537,1074,329.1425,8,0
0,0,20,20,19,45,64,105,74,179,0.000333,0.358,9,9666,537,1074,327.844012,8,0
0,0,20,20,19,45,64,105,74,179,0.000333,0.358,9,9666,537,1074,327.844012,8,0
0,0,22,22,18,48,66,114,83,197,0.000333,0.396915,9,10716.71077,595.372821,1190.745642,343.13685,9,0
0,0,20,20,17,46,63,113,81,194,0.000333,0.386531,8,9276.738441,515.374358,1159.592305,323.570718,9,0
0,0,20,20,17,47,64,113,83,196,0.000333,0.392,8,9408,522.666667,1176,330.552544,9,0
0,0,25,25,20,51,71,126,99,225,0.000333,0.461231,10,13836.93102,768.71839,1383.693102,375.732254,9,0
0,0,25,25,21,52,73,127,105,232,0.000333,0.47868,20,28720.78595,1595.59922,1436.039298,388.661531,9,0
0,0,22,22,18,48,66,114,83,197,0.000333,0.396915,9,10716.71077,595.372821,1190.745642,343.13685,9,0
0,0,28,28,21,46,67,145,91,236,0.000333,0.477199,10,14315.97049,795.331694,1431.597049,346.322516,10,0
0,0,28,28,21,46,67,145,91,236,0.000333,0.477199,10,14315.97049,795.331694,1431.597049,346.322516,10,0
0,0,30,30,22,46,68,149,94,243,0.000333,0.493084,22,32543.57635,1807.976464,1479.25347,352.191346,10,0
0,0,30,30,22,46,68,149,94,243,0.000333,0.493084,22,32543.57635,1807.976464,1479.25347,352.191346,10,0
0,0,28,28,22,46,68,145,91,236,0.000333,0.47888,11,15803.05354,877.947419,1436.641231,352.191346,10,0
0,0,28,28,22,46,68,145,91,236,0.000333,0.47888,11,15803.05354,877.947419,1436.641231,352.191346,10,0
0,0,23,23,18,50,68,117,85,202,0.000333,0.409889,9,11067.00745,614.833747,1229.667494,357.25146,10,0
0,0,23,23,18,49,67,117,84,201,0.000333,0.406428,9,10973.55535,609.641964,1219.283927,350.179432,10,0
0,0,25,25,20,51,71,126,99,225,0.000333,0.461231,10,13836.93102,768.71839,1383.693102,375.732254,9,0
0,0,25,25,21,52,73,127,105,232,0.000333,0.47868,20,28720.78595,1595.59922,1436.039298,388.661531,9,0
0,0,20,20,17,46,63,113,81,194,0.000333,0.386531,8,9276.738441,515.374358,1159.592305,323.570718,9,0
0,0,20,20,17,47,64,113,83,196,0.000333,0.392,8,9408,522.666667,1176,330.552544,9,0
0,0,23,23,18,49,67,117,85,202,0.000333,0.40845,9,11028.15015,612.675008,1225.350016,350.179432,10,0
0,0,22,22,18,48,66,114,83,197,0.000333,0.396915,9,10716.71077,595.372821,1190.745642,343.13685,9,0
0,0,19,19,18,44,62,101,73,174,0.000333,0.345343,9,9324.271422,518.015079,1036.030158,315.273641,7,0
0,0,19,19,18,44,62,101,73,174,0.000333,0.345343,9,9324.271422,518.015079,1036.030158,315.273641,7,0
0,0,30,30,19,50,69,150,100,250,0.000333,0.509044,18,27488.36006,1527.131114,1527.131114,362.903432,11,0
0,0,30,30,20,48,68,150,97,247,0.000333,0.501201,20,30072.06644,1670.670358,1503.603322,354.516762,11,0
0,0,32,32,21,50,71,157,105,262,0.000333,0.537078,20,32224.67491,1790.259717,1611.233745,374.431475,11,0
0,0,32,32,21,48,69,158,105,263,0.000333,0.535514,20,32130.83864,1785.046591,1606.541932,360.316866,11,0
0,0,30,30,19,49,68,149,98,247,0.000333,0.501201,18,27064.85979,1503.603322,1503.603322,355.831405,11,0
0,0,34,34,19,53,72,171,116,287,0.000333,0.590256,18,31873.83256,1770.768475,1770.768475,384.290407,12,0
0,0,34,34,21,55,76,174,117,291,0.000333,0.606049,20,36362.93813,2020.163229,1818.146906,410.21345,12,0
0,0,33,33,19,52,71,162,112,274,0.000333,0.561677,18,30330.55279,1685.030711,1685.030711,377.133488,12,0
0,0,33,33,21,54,75,165,113,278,0.000333,0.577204,20,34632.23192,1924.012884,1731.611596,403.002591,12,0
0,0,32,32,20,49,69,156,108,264,0.000333,0.53755,20,32253.00913,1791.833841,1612.650457,361.559344,11,0
0,0,32,32,21,51,72,157,109,266,0.000333,0.547067,20,32824.00101,1823.555612,1641.20005,381.532358,11,0
0,0,38,38,19,54,73,174,139,313,0.000333,0.645805,18,34873.47157,1937.415087,1937.415087,391.474548,12,0
0,0,38,38,21,56,77,177,146,323,0.000333,0.674724,20,40483.44105,2249.080058,2024.172053,417.450542,12,0
0,0,36,36,19,53,72,168,129,297,0.000333,0.610823,18,32984.41906,1832.467725,1832.467725,384.290407,12,0
0,0,36,36,21,55,76,171,134,305,0.000333,0.635206,20,38112.35783,2117.353213,1905.617892,410.21345,12,0
0,0,34,34,19,52,71,162,119,281,0.000333,0.576026,18,31105.42093,1728.078941,1728.078941,377.133488,12,0
0,0,34,34,21,54,75,165,122,287,0.000333,0.59589,20,35753.41928,1986.301071,1787.670964,403.002591,12,0
0,0,34,34,19,54,73,162,118,280,0.000333,0.577717,18,31196.71578,1733.150876,1733.150876,391.474548,12,0
0,0,34,34,21,56,77,165,119,284,0.000333,0.593256,20,35595.34755,1977.519308,1779.767378,417.450542,12,0
0,0,34,34,19,52,71,167,116,283,0.000333,0.580126,18,31326.81183,1740.378435,1740.378435,377.133488,12,0
0,0,34,34,21,54,75,170,117,287,0.000333,0.59589,20,35753.41928,1986.301071,1787.670964,403.002591,12,0
0,0,35,35,22,51,73,169,113,282,0.000333,0.581844,22,38401.67156,2133.426198,1745.530526,387.401188,12,0
0,0,35,35,22,51,73,169,113,282,0.000333,0.581844,22,38401.67156,2133.426198,1745.530526,387.401188,12,0
0,0,33,33,21,52,73,164,111,275,0.000333,0.567401,20,34044.03507,1891.335282,1702.201754,388.661531,12,0
0,0,33,33,21,52,73,164,111,275,0.000333,0.567401,20,34044.03507,1891.335282,1702.201754,388.661531,12,0
0,0,33,33,22,51,73,164,110,274,0.000333,0.565337,22,37312.26244,2072.903469,1696.011929,387.401188,12,0
0,0,33,33,22,51,73,164,110,274,0.000333,0.565337,22,37312.26244,2072.903469,1696.011929,387.401188,12,0
0,0,21,21,21,46,67,111,81,192,0.000333,0.38823,10,11646.89125,647.049514,1164.689125,346.322516,8,0
0,0,20,20,18,46,64,104,75,179,0.000333,0.358,9,9666,537,1074,329.1425,8,0
0,0,32,32,21,49,70,157,104,261,0.000333,0.533248,20,31994.85735,1777.492075,1599.742867,367.359448,11,0
0,0,30,30,20,49,69,151,104,255,0.000333,0.519225,20,31153.47473,1730.748596,1557.673736,361.559344,10,0
0,0,29,29,21,49,70,147,103,250,0.000333,0.510774,20,30646.41509,1702.578616,1532.320754,367.359448,9,0
0,0,29,29,21,49,70,147,103,250,0.000333,0.510774,20,30646.41509,1702.578616,1532.320754,367.359448,9,0
0,0,30,30,19,49,68,150,99,249,0.000333,0.505259,18,27284.00845,1515.778247,1515.778247,355.831405,11,0
0,0,19,19,18,44,62,101,73,174,0.000333,0.345343,9,9324.271422,518.015079,1036.030158,315.273641,7,0
0,0,19,19,18,44,62,101,73,174,0.000333,0.345343,9,9324.271422,518.015079,1036.030158,315.273641,7,0
0,0,19,19,18,44,62,101,73,174,0.000333,0.345343,9,9324.271422,518.015079,1036.030158,315.273641,7,0
0,0,18,18,16,43,59,98,69,167,0.000333,0.327467,8,7859.211114,436.62284,982.401389,297.329384,7,0
0,0,18,18,17,42,59,99,68,167,0.000333,0.327467,8,7859.211114,436.62284,982.401389,295.9642,7,0
0,0,19,19,18,44,62,101,73,174,0.000333,0.345343,9,9324.271422,518.015079,1036.030158,315.273641,7,0
0,0,19,19,19,43,62,102,72,174,0.000333,0.345343,9,9324.271422,518.015079,1036.030158,314.040007,7,0
0,0,30,30,19,47,66,148,101,249,0.000333,0.501685,18,27090.97444,1505.054136,1505.054136,341.776299,9,0
0,0,30,30,21,49,70,151,102,253,0.000333,0.516903,20,31014.17207,1723.009559,1550.708603,367.359448,9,0
0,0,27,27,19,45,64,136,88,224,0.000333,0.448,9,12096,672,1344,327.844012,9,0
0,0,32,32,19,51,70,156,109,265,0.000333,0.54142,18,29236.67999,1624.259999,1624.259999,370.004315,12,0
0,0,32,32,21,53,74,159,112,271,0.000333,0.560921,20,33655.23724,1869.735402,1682.761862,395.81845,12,0
0,0,32,32,21,53,74,159,112,271,0.000333,0.560921,20,33655.23724,1869.735402,1682.761862,395.81845,12,0
0,0,32,32,21,50,71,160,108,268,0.000333,0.549377,20,32962.64456,1831.258031,1648.132228,374.431475,12,0
0,0,32,32,21,50,71,160,108,268,0.000333,0.549377,20,32962.64456,1831.258031,1648.132228,374.431475,12,0
0,0,27,27,19,45,64,135,90,225,0.000333,0.45,18,24300,1350,1350,327.844012,9,0
0,0,27,27,20,47,67,136,90,226,0.000333,0.456979,10,13709.36157,761.631198,1370.936157,347.504238,9,0
0,0,31,31,21,49,70,156,99,255,0.000333,0.520989,20,31259.34339,1736.630188,1562.967169,367.359448,13,0
0,0,31,31,22,50,72,156,99,255,0.000333,0.524444,11,17306.63963,961.479979,1573.330875,380.300305,13,0
0,0,31,31,22,50,72,156,99,255,0.000333,0.524444,11,17306.63963,961.479979,1573.330875,380.300305,13,0
0,0,30,30,21,49,70,153,98,251,0.000333,0.512817,20,30769.00075,1709.38893,1538.450037,367.359448,12,0
0,0,33,33,22,50,72,160,102,262,0.000333,0.53884,22,35563.44771,1975.747095,1616.52035,380.300305,13,0
0,0,33,33,22,50,72,160,102,262,0.000333,0.53884,22,35563.44771,1975.747095,1616.52035,380.300305,13,0
0,0,20,20,18,46,64,104,75,179,0.000333,0.358,9,9666,537,1074,329.1425,8,0
0,0,20,20,19,45,64,105,74,179,0.000333,0.358,9,9666,537,1074,327.844012,8,0
0,0,20,20,19,45,64,105,74,179,0.000333,0.358,9,9666,537,1074,327.844012,8,0
0,0,22,22,18,48,66,114,83,197,0.000333,0.396915,9,10716.71077,595.372821,1190.745642,343.13685,9,0
0,0,24,24,19,49,68,123,90,213,0.000333,0.43221,9,11669.66627,648.314793,1296.629585,355.831405,9,0
0,0,22,22,18,48,66,114,83,197,0.000333,0.396915,9,10716.71077,595.372821,1190.745642,343.13685,9,0
0,0,18,18,16,43,59,98,69,167,0.000333,0.327467,8,7859.211114,436.62284,982.401389,297.329384,7,0
0,0,21,21,18,46,64,110,80,190,0.000333,0.38,9,10260,570,1140,329.1425,7,0
0,0,21,21,19,44,63,111,78,189,0.000333,0.376569,9,10167.35315,564.852953,1129.705906,320.925614,7,0
0,0,19,19,18,45,63,101,74,175,0.000333,0.348675,9,9414.21588,523.011993,1046.023987,322.192039,7,0
0,0,19,19,19,43,62,102,72,174,0.000333,0.345343,9,9324.271422,518.015079,1036.030158,314.040007,7,0
0,0,25,25,19,49,68,121,87,208,0.000333,0.422064,9,11395.73044,633.096135,1266.192271,355.831405,10,0
0,0,20,20,18,47,65,104,76,180,0.000333,0.361342,9,9756.235857,542.013103,1084.026206,336.124326,8,0
0,0,20,20,19,45,64,105,74,179,0.000333,0.358,9,9666,537,1074,327.844012,8,0
0,0,20,20,19,45,64,105,74,179,0.000333,0.358,9,9666,537,1074,327.844012,8,0
0,0,20,20,19,46,65,104,75,179,0.000333,0.359335,9,9702.034547,539.001919,1078.003839,334.794473,8,0
0,0,20,20,20,44,64,105,73,178,0.000333,0.356,10,10680,593.333333,1068,326.653553,8,0
0,0,20,20,20,44,64,105,73,178,0.000333,0.356,10,10680,593.333333,1068,326.653553,8,0
0,0,19,19,18,45,63,101,74,175,0.000333,0.348675,9,9414.21588,523.011993,1046.023987,322.192039,7,0
0,0,19,19,19,43,62,102,72,174,0.000333,0.345343,9,9324.271422,518.015079,1036.030158,314.040007,7,0
0,0,21,21,21,47,68,111,82,193,0.000333,0.391627,10,11748.80328,652.711294,1174.880328,353.304342,8,0
0,0,21,21,22,45,67,112,80,192,0.000333,0.38823,11,12811.58037,711.754465,1164.689125,345.240885,8,0
0,0,19,19,18,45,63,101,74,175,0.000333,0.348675,9,9414.21588,523.011993,1046.023987,322.192039,7,0
0,0,19,19,18,45,63,101,74,175,0.000333,0.348675,9,9414.21588,523.011993,1046.023987,322.192039,7,0
0,0,19,19,19,43,62,102,72,174,0.000333,0.345343,9,9324.271422,518.015079,1036.030158,314.040007,7,0
0,0,19,19,19,43,62,102,72,174,0.000333,0.345343,9,9324.271422,518.015079,1036.030158,314.040007,7,0
0,0,32,32,20,49,69,156,108,264,0.000333,0.53755,20,32253.00913,1791.833841,1612.650457,361.559344,11,0
0,0,32,32,21,51,72,157,109,266,0.000333,0.547067,20,32824.00101,1823.555612,1641.20005,381.532358,11,0
0,0,39,39,21,56,77,183,140,323,0.000333,0.674724,20,40483.44105,2249.080058,2024.172053,417.450542,12,0
0,0,38,38,21,56,77,179,143,322,0.000333,0.672635,20,40358.10532,2242.116962,2017.905266,417.450542,11,0
0,0,35,35,21,54,75,171,120,291,0.000333,0.604195,20,36251.72478,2013.98471,1812.586239,403.002591,12,0
0,0,34,34,21,54,75,167,119,286,0.000333,0.593814,20,35628.84291,1979.380162,1781.442145,403.002591,11,0
0,0,30,30,19,49,68,148,100,248,0.000333,0.50323,18,27174.43412,1509.690785,1509.690785,355.831405,11,0
0,0,30,30,20,51,71,149,100,249,0.000333,0.510429,10,15312.87033,850.715018,1531.287033,375.732254,11,0
0,0,30,30,19,49,68,150,99,249,0.000333,0.505259,18,27284.00845,1515.778247,1515.778247,355.831405,11,0
0,0,30,30,20,48,68,150,97,247,0.000333,0.501201,20,30072.06644,1670.670358,1503.603322,354.516762,11,0
0,0,36,36,21,55,76,177,123,300,0.000333,0.624793,20,37487.56508,2082.642504,1874.378254,410.21345,12,0
0,0,35,35,21,55,76,173,122,295,0.000333,0.61438,20,36862.77233,2047.931796,1843.138616,410.21345,11,0
0,0,31,31,19,48,67,151,111,262,0.000333,0.529772,18,28607.67662,1589.315368,1589.315368,348.788823,9,0
0,0,31,31,21,50,71,154,114,268,0.000333,0.549377,20,32962.64456,1831.258031,1648.132228,374.431475,9,0
0,0,29,29,20,45,65,143,98,241,0.000333,0.483797,20,29027.81286,1612.65627,1451.390643,333.571951,9,0
0,0,29,29,21,47,68,144,99,243,0.000333,0.493084,20,29585.06941,1643.614967,1479.25347,353.304342,9,0
0,0,23,23,18,49,67,117,84,201,0.000333,0.406428,9,10973.55535,609.641964,1219.283927,350.179432,10,0
0,0,23,23,19,48,67,118,83,201,0.000333,0.406428,9,10973.55535,609.641964,1219.283927,348.788823,10,0
0,0,23,23,19,48,67,118,83,201,0.000333,0.406428,9,10973.55535,609.641964,1219.283927,348.788823,10,0
0,0,19,19,18,44,62,101,73,174,0.000333,0.345343,9,9324.271422,518.015079,1036.030158,315.273641,7,0
0,0,19,19,19,43,62,102,72,174,0.000333,0.345343,9,9324.271422,518.015079,1036.030158,314.040007,7,0
0,0,23,23,18,50,68,117,85,202,0.000333,0.409889,9,11067.00745,614.833747,1229.667494,357.25146,10,0
0,0,23,23,19,49,68,118,84,202,0.000333,0.409889,9,11067.00745,614.833747,1229.667494,355.831405,10,0
0,0,23,23,19,49,68,118,84,202,0.000333,0.409889,9,11067.00745,614.833747,1229.667494,355.831405,10,0
0,0,21,21,21,46,67,111,81,192,0.000333,0.38823,10,11646.89125,647.049514,1164.689125,346.322516,8,0
0,0,21,21,22,45,67,112,80,192,0.000333,0.38823,11,12811.58037,711.754465,1164.689125,345.240885,8,0
0,0,19,19,18,44,62,101,73,174,0.000333,0.345343,9,9324.271422,518.015079,1036.030158,315.273641,7,0
0,0,19,19,19,43,62,102,72,174,0.000333,0.345343,9,9324.271422,518.015079,1036.030158,314.040007,7,0
0,0,19,19,18,44,62,101,73,174,0.000333,0.345343,9,9324.271422,518.015079,1036.030158,315.273641,7,0
0,0,19,19,19,43,62,102,72,174,0.000333,0.345343,9,9324.271422,518.015079,1036.030158,314.040007,7,0
0,0,19,19,19,43,62,102,72,174,0.000333,0.345343,9,9324.271422,518.015079,1036.030158,314.040007,7,0
0,0,19,19,18,44,62,101,73,174,0.000333,0.345343,9,9324.271422,518.015079,1036.030158,315.273641,7,0
0,0,19,19,18,44,62,101,73,174,0.000333,0.345343,9,9324.271422,518.015079,1036.030158,315.273641,7,0
0,0,19,19,19,43,62,102,72,174,0.000333,0.345343,9,9324.271422,518.015079,1036.030158,314.040007,7,0
0,0,21,21,18,45,63,110,79,189,0.000333,0.376569,9,10167.35315,564.852953,1129.705906,322.192039,7,0
0,0,21,21,19,44,63,111,78,189,0.000333,0.376569,9,10167.35315,564.852953,1129.705906,320.925614,7,0
0,0,19,19,18,44,62,101,73,174,0.000333,0.345343,9,9324.271422,518.015079,1036.030158,315.273641,7,0
0,0,19,19,19,43,62,102,72,174,0.000333,0.345343,9,9324.271422,518.015079,1036.030158,314.040007,7,0
0,0,27,27,19,45,64,137,89,226,0.000333,0.452,9,12204,678,1356,327.844012,9,0
0,0,20,20,18,45,63,104,75,179,0.000333,0.356644,9,9629.397957,534.966553,1069.933106,322.192039,8,0
0,0,20,20,19,43,62,105,73,178,0.000333,0.353282,9,9538.622489,529.923472,1059.846943,314.040007,8,0
0,0,20,20,19,43,62,105,73,178,0.000333,0.353282,9,9538.622489,529.923472,1059.846943,314.040007,8,0
0,0,19,19,18,45,63,101,74,175,0.000333,0.348675,9,9414.21588,523.011993,1046.023987,322.192039,7,0
0,0,19,19,19,43,62,102,72,174,0.000333,0.345343,9,9324.271422,518.015079,1036.030158,314.040007,7,0
0,0,19,19,18,44,62,101,73,174,0.000333,0.345343,9,9324.271422,518.015079,1036.030158,315.273641,7,0
0,0,19,19,18,44,62,101,73,174,0.000333,0.345343,9,9324.271422,518.015079,1036.030158,315.273641,7,0
0,0,19,19,18,44,62,101,73,174,0.000333,0.345343,9,9324.271422,518.015079,1036.030158,315.273641,7,0
0,0,22,22,20,47,67,113,89,202,0.000333,0.40845,10,12253.50017,680.750009,1225.350016,347.504238,7,0
0,0,22,22,21,48,69,114,95,209,0.000333,0.425561,10,12766.81612,709.267562,1276.681611,360.316866,7,0
0,0,17,17,17,42,59,100,71,171,0.000333,0.335311,8,8047.455692,447.080872,1005.931961,295.9642,7,0
0,0,17,17,17,43,60,100,73,173,0.000333,0.340631,8,8175.136584,454.174255,1021.892073,302.816253,7,0
0,0,21,21,16,47,63,111,79,190,0.000333,0.378561,8,9085.465484,504.748082,1135.683185,325.065676,9,0
0,0,29,29,20,45,65,143,98,241,0.000333,0.483797,20,29027.81286,1612.65627,1451.390643,333.571951,9,0
0,0,29,29,21,47,68,144,99,243,0.000333,0.493084,20,29585.06941,1643.614967,1479.25347,353.304342,9,0
0,0,21,21,16,48,64,111,80,191,0.000333,0.382,8,9168,509.333333,1146,332.0782,9,0
0,0,35,35,19,49,68,160,128,288,0.000333,0.584396,18,31557.40737,1753.189298,1753.189298,355.831405,9,0
0,0,35,35,21,51,72,163,135,298,0.000333,0.612879,20,36772.75301,2042.930723,1838.63765,381.532358,9,0
0,0,22,22,18,49,67,114,84,198,0.000333,0.400362,9,10809.77094,600.54283,1201.08566,350.179432,9,0
0,0,25,25,20,49,69,122,87,209,0.000333,0.425561,10,12766.81612,709.267562,1276.681611,361.559344,10,0
0,0,25,25,20,48,68,123,86,209,0.000333,0.424093,10,12722.79734,706.822074,1272.279734,354.516762,10,0
0,0,25,25,20,48,68,123,86,209,0.000333,0.424093,10,12722.79734,706.822074,1272.279734,354.516762,10,0
0,0,23,23,18,49,67,117,84,201,0.000333,0.406428,9,10973.55535,609.641964,1219.283927,350.179432,10,0
0,0,23,23,19,48,67,118,83,201,0.000333,0.406428,9,10973.55535,609.641964,1219.283927,348.788823,10,0
0,0,23,23,19,48,67,118,83,201,0.000333,0.406428,9,10973.55535,609.641964,1219.283927,348.788823,10,0
0,0,23,23,18,50,68,117,85,202,0.000333,0.409889,9,11067.00745,614.833747,1229.667494,357.25146,10,0
0,0,23,23,19,49,68,118,84,202,0.000333,0.409889,9,11067.00745,614.833747,1229.667494,355.831405,10,0
0,0,23,23,19,49,68,118,84,202,0.000333,0.409889,9,11067.00745,614.833747,1229.667494,355.831405,10,0
0,0,25,25,19,49,68,121,87,208,0.000333,0.422064,9,11395.73044,633.096135,1266.192271,355.831405,10,0
0,0,25,25,20,48,68,122,86,208,0.000333,0.422064,10,12661.92271,703.440151,1266.192271,354.516762,10,0
0,0,25,25,20,48,68,122,86,208,0.000333,0.422064,10,12661.92271,703.440151,1266.192271,354.516762,10,0
0,0,22,22,18,49,67,114,84,198,0.000333,0.400362,9,10809.77094,600.54283,1201.08566,350.179432,9,0
0,0,24,24,18,50,68,122,97,219,0.000333,0.444385,9,11998.38926,666.577181,1333.154362,357.25146,9,0
0,0,24,24,19,52,71,123,97,220,0.000333,0.450981,9,12176.4993,676.472183,1352.944366,377.133488,9,0
0,0,23,23,18,49,67,117,84,201,0.000333,0.406428,9,10973.55535,609.641964,1219.283927,350.179432,10,0
0,0,23,23,19,48,67,118,83,201,0.000333,0.406428,9,10973.55535,609.641964,1219.283927,348.788823,10,0
0,0,23,23,19,48,67,118,83,201,0.000333,0.406428,9,10973.55535,609.641964,1219.283927,348.788823,10,0
0,0,19,19,18,44,62,101,73,174,0.000333,0.345343,9,9324.271422,518.015079,1036.030158,315.273641,7,0
0,0,23,23,18,50,68,117,85,202,0.000333,0.409889,9,11067.00745,614.833747,1229.667494,357.25146,10,0
0,0,23,23,19,49,68,118,84,202,0.000333,0.409889,9,11067.00745,614.833747,1229.667494,355.831405,10,0
0,0,23,23,19,49,68,118,84,202,0.000333,0.409889,9,11067.00745,614.833747,1229.667494,355.831405,10,0
0,0,22,22,18,49,67,114,84,198,0.000333,0.400362,9,10809.77094,600.54283,1201.08566,350.179432,9,0
0,0,22,22,18,49,67,114,84,198,0.000333,0.400362,9,10809.77094,600.54283,1201.08566,350.179432,9,0
0,0,31,31,21,49,70,156,99,255,0.000333,0.520989,20,31259.34339,1736.630188,1562.967169,367.359448,13,0
0,0,31,31,21,49,70,156,99,255,0.000333,0.520989,20,31259.34339,1736.630188,1562.967169,367.359448,13,0
0,0,23,23,18,50,68,117,85,202,0.000333,0.409889,9,11067.00745,614.833747,1229.667494,357.25146,10,0
0,0,23,23,19,49,68,118,84,202,0.000333,0.409889,9,11067.00745,614.833747,1229.667494,355.831405,10,0
0,0,23,23,19,49,68,118,84,202,0.000333,0.409889,9,11067.00745,614.833747,1229.667494,355.831405,10,0
0,0,29,29,21,47,68,145,102,247,0.000333,0.501201,20,30072.06644,1670.670358,1503.603322,353.304342,9,0
0,0,29,29,22,48,70,146,108,254,0.000333,0.518946,22,34250.4335,1902.801861,1556.837886,366.185696,9,0
0,0,24,24,20,43,63,131,85,216,0.000333,0.430364,10,12910.92464,717.273591,1291.092463,319.767946,9,0
0,0,24,24,20,44,64,131,87,218,0.000333,0.436,10,13080,726.666667,1308,326.653553,9,0
0,0,19,19,18,44,62,101,73,174,0.000333,0.345343,9,9324.271422,518.015079,1036.030158,315.273641,7,0
0,0,19,19,18,44,62,101,73,174,0.000333,0.345343,9,9324.271422,518.015079,1036.030158,315.273641,7,0
0,0,18,18,16,43,59,98,69,167,0.000333,0.327467,8,7859.211114,436.62284,982.401389,297.329384,7,0
0,0,19,19,18,44,62,101,73,174,0.000333,0.345343,9,9324.271422,518.015079,1036.030158,315.273641,7,0
0,0,19,19,19,43,62,102,72,174,0.000333,0.345343,9,9324.271422,518.015079,1036.030158,314.040007,7,0
0,0,19,19,18,44,62,101,73,174,0.000333,0.345343,9,9324.271422,518.015079,1036.030158,315.273641,7,0
0,0,22,22,18,49,67,114,84,198,0.000333,0.400362,9,10809.77094,600.54283,1201.08566,350.179432,9,0
0,0,22,22,18,48,66,114,83,197,0.000333,0.396915,9,10716.71077,595.372821,1190.745642,343.13685,9,0
0,0,19,19,18,44,62,101,73,174,0.000333,0.345343,9,9324.271422,518.015079,1036.030158,315.273641,7,0
0,0,32,32,21,51,72,158,112,270,0.000333,0.555293,20,33317.59501,1850.9775,1665.87975,381.532358,11,0
0,0,32,32,22,52,74,159,118,277,0.000333,0.57334,22,37840.40881,2102.244934,1720.018582,394.530361,11,0
0,0,31,31,21,47,68,155,105,260,0.000333,0.52758,20,31654.80678,1758.600376,1582.740339,353.304342,9,0
0,0,34,34,21,51,72,169,117,286,0.000333,0.5882,20,35291.97101,1960.665056,1764.59855,381.532358,10,0
0,0,33,33,21,51,72,165,116,281,0.000333,0.577916,20,34674.97851,1926.387695,1733.748925,381.532358,9,0
0,0,20,20,18,45,63,104,74,178,0.000333,0.354652,9,9575.602437,531.977913,1063.955826,322.192039,8,0
0,0,45,45,23,61,84,207,171,378,0.000333,0.805432,22,53158.51169,2953.250649,2416.295986,465.816903,12,0
0,0,40,40,21,58,79,185,163,348,0.000333,0.731239,20,43874.31401,2437.461889,2193.7157,432.001564,11,0
0,0,19,19,18,44,62,101,73,174,0.000333,0.345343,9,9324.271422,518.015079,1036.030158,315.273641,7,0
0,0,19,19,18,44,62,101,73,174,0.000333,0.345343,9,9324.271422,518.015079,1036.030158,315.273641,7,0
0,0,19,19,18,44,62,101,73,174,0.000333,0.345343,9,9324.271422,518.015079,1036.030158,315.273641,7,0
0,0,20,20,18,45,63,104,74,178,0.000333,0.354652,9,9575.602437,531.977913,1063.955826,322.192039,8,0
0,0,18,18,16,43,59,98,69,167,0.000333,0.327467,8,7859.211114,436.62284,982.401389,297.329384,7,0
0,0,19,19,18,44,62,101,73,174,0.000333,0.345343,9,9324.271422,518.015079,1036.030158,315.273641,7,0
0,0,20,20,18,46,64,104,75,179,0.000333,0.358,9,9666,537,1074,329.1425,8,0
0,0,20,20,18,45,63,104,74,178,0.000333,0.354652,9,9575.602437,531.977913,1063.955826,322.192039,8,0
0,0,20,20,18,45,63,104,74,178,0.000333,0.354652,9,9575.602437,531.977913,1063.955826,322.192039,8,0
0,0,20,20,18,45,63,104,75,179,0.000333,0.356644,9,9629.397957,534.966553,1069.933106,322.192039,8,0
0,0,19,19,18,44,62,101,73,174,0.000333,0.345343,9,9324.271422,518.015079,1036.030158,315.273641,7,0
0,0,23,23,18,49,67,117,85,202,0.000333,0.40845,9,11028.15015,612.675008,1225.350016,350.179432,10,0
0,0,23,23,19,47,66,118,83,201,0.000333,0.404974,9,10934.30896,607.461609,1214.923218,341.776299,10,0
0,0,22,22,18,49,67,114,84,198,0.000333,0.400362,9,10809.77094,600.54283,1201.08566,350.179432,9,0
0,0,22,22,19,47,66,115,82,197,0.000333,0.396915,9,10716.71077,595.372821,1190.745642,341.776299,9,0
0,0,22,22,19,47,66,115,82,197,0.000333,0.396915,9,10716.71077,595.372821,1190.745642,341.776299,9,0
0,0,30,30,21,48,69,151,101,252,0.000333,0.513116,20,30786.96326,1710.386848,1539.348163,360.316866,10,0
0,0,30,30,21,48,69,151,101,252,0.000333,0.513116,20,30786.96326,1710.386848,1539.348163,360.316866,10,0
0,0,29,29,21,47,68,145,92,237,0.000333,0.48091,10,14427.28693,801.515941,1442.728693,353.304342,10,0
0,0,35,35,23,48,71,174,114,288,0.000333,0.590376,22,38964.79775,2164.710986,1771.12717,372.120125,10,0
0,0,29,29,22,45,67,146,90,236,0.000333,0.477199,22,31495.13508,1749.729726,1431.597049,345.240885,10,0
0,0,43,43,23,60,83,201,159,360,0.000333,0.765005,22,50490.3123,2805.01735,2295.014195,458.455361,12,0
0,0,38,38,21,57,78,179,149,328,0.000333,0.687204,20,41232.23856,2290.67992,2061.611928,424.713397,11,0
0,0,31,31,19,48,67,157,105,262,0.000333,0.529772,18,28607.67662,1589.315368,1589.315368,348.788823,9,0
0,0,31,31,21,50,71,160,106,266,0.000333,0.545278,20,32716.65468,1817.591926,1635.832734,374.431475,9,0
0,0,32,32,22,47,69,156,103,259,0.000333,0.527369,22,34806.37236,1933.687353,1582.107834,359.173172,10,0
0,0,32,32,22,47,69,156,103,259,0.000333,0.527369,22,34806.37236,1933.687353,1582.107834,359.173172,10,0
0,0,31,31,19,47,66,153,105,258,0.000333,0.519818,18,28070.16629,1559.453683,1559.453683,341.776299,9,0
0,0,31,31,21,49,70,156,106,262,0.000333,0.535291,20,32117.44301,1784.302389,1605.87215,367.359448,9,0
0,0,31,31,19,49,68,148,107,255,0.000333,0.517434,18,27941.45444,1552.303025,1552.303025,355.831405,9,0
0,0,31,31,21,51,72,151,108,259,0.000333,0.53267,20,31960.21151,1775.567306,1598.010575,381.532358,9,0
0,0,20,20,18,45,63,104,74,178,0.000333,0.354652,9,9575.602437,531.977913,1063.955826,322.192039,8,0
0,0,20,20,19,44,63,105,73,178,0.000333,0.354652,9,9575.602437,531.977913,1063.955826,320.925614,8,0
0,0,20,20,19,44,63,105,73,178,0.000333,0.354652,9,9575.602437,531.977913,1063.955826,320.925614,8,0
0,0,30,30,21,47,68,151,100,251,0.000333,0.509318,20,30559.06346,1697.725748,1527.953173,353.304342,10,0
0,0,30,30,21,47,68,151,100,251,0.000333,0.509318,20,30559.06346,1697.725748,1527.953173,353.304342,10,0
0,0,22,22,19,45,64,108,77,185,0.000333,0.37,9,9990,555,1110,327.844012,8,0
0,0,22,22,20,44,64,109,76,185,0.000333,0.37,10,11100,616.666667,1110,326.653553,8,0
0,0,22,22,20,44,64,109,76,185,0.000333,0.37,10,11100,616.666667,1110,326.653553,8,0
0,0,22,22,20,45,65,109,77,186,0.000333,0.373387,10,11201.60413,622.311341,1120.160413,333.571951,8,0
0,0,20,20,18,45,63,104,74,178,0.000333,0.354652,9,9575.602437,531.977913,1063.955826,322.192039,8,0
0,0,20,20,19,44,63,105,73,178,0.000333,0.354652,9,9575.602437,531.977913,1063.955826,320.925614,8,0
0,0,20,20,19,44,63,105,73,178,0.000333,0.354652,9,9575.602437,531.977913,1063.955826,320.925614,8,0
0,0,40,40,23,59,82,195,138,333,0.000333,0.705688,22,46575.42599,2587.523666,2117.064818,451.117865,12,0
0,0,35,35,21,56,77,173,124,297,0.000333,0.620412,20,37224.71205,2068.039558,1861.235603,417.450542,11,0
0,0,37,37,21,56,77,176,128,304,0.000333,0.635034,20,38102.06217,2116.781232,1905.103108,417.450542,11,0
0,0,36,36,21,57,78,173,128,301,0.000333,0.630635,20,37838.12136,2102.117853,1891.906068,424.713397,11,0
0,0,25,25,20,51,71,126,99,225,0.000333,0.461231,10,13836.93102,768.71839,1383.693102,375.732254,9,0
0,0,25,25,21,52,73,127,105,232,0.000333,0.47868,20,28720.78595,1595.59922,1436.039298,388.661531,9,0
0,0,23,23,18,51,69,117,86,203,0.000333,0.413343,9,11160.27418,620.015232,1240.030465,364.352342,10,0
0,0,23,23,19,49,68,118,84,202,0.000333,0.409889,9,11067.00745,614.833747,1229.667494,355.831405,10,0
0,0,23,23,19,49,68,118,84,202,0.000333,0.409889,9,11067.00745,614.833747,1229.667494,355.831405,10,0
0,0,25,25,20,51,71,126,89,215,0.000333,0.440732,10,13221.95631,734.553128,1322.195631,375.732254,10,0
0,0,25,25,21,49,70,127,87,214,0.000333,0.437222,10,13116.66566,728.703648,1311.666566,367.359448,10,0
0,0,25,25,21,49,70,127,87,214,0.000333,0.437222,10,13116.66566,728.703648,1311.666566,367.359448,10,0
0,0,22,22,18,49,67,114,84,198,0.000333,0.400362,9,10809.77094,600.54283,1201.08566,350.179432,9,0
0,0,22,22,19,47,66,115,82,197,0.000333,0.396915,9,10716.71077,595.372821,1190.745642,341.776299,9,0
0,0,24,24,21,51,72,124,92,216,0.000333,0.444235,10,13327.038,740.391,1332.7038,381.532358,10,0
0,0,24,24,22,49,71,125,90,215,0.000333,0.440732,11,14544.15194,808.008441,1322.195631,373.228278,10,0
0,0,23,23,19,50,69,117,85,202,0.000333,0.411307,9,11105.29746,616.96097,1233.92194,362.903432,10,0
0,0,23,23,20,48,68,118,83,201,0.000333,0.40786,10,12235.80031,679.766684,1223.580031,354.516762,10,0
0,0,23,23,20,48,68,118,83,201,0.000333,0.40786,10,12235.80031,679.766684,1223.580031,354.516762,10,0
0,0,22,22,18,48,66,114,83,197,0.000333,0.396915,9,10716.71077,595.372821,1190.745642,343.13685,9,0
0,0,22,22,18,49,67,114,84,198,0.000333,0.400362,9,10809.77094,600.54283,1201.08566,350.179432,9,0
0,0,22,22,18,48,66,114,83,197,0.000333,0.396915,9,10716.71077,595.372821,1190.745642,343.13685,9,0
0,0,41,41,23,59,82,195,147,342,0.000333,0.724761,22,47834.22128,2657.456738,2174.282786,451.117865,12,0
0,0,36,36,21,56,77,173,135,308,0.000333,0.64339,20,38603.40509,2144.633616,1930.170255,417.450542,11,0
0,0,23,23,18,51,69,117,86,203,0.000333,0.413343,9,11160.27418,620.015232,1240.030465,364.352342,10,0
0,0,23,23,19,49,68,118,84,202,0.000333,0.409889,9,11067.00745,614.833747,1229.667494,355.831405,10,0
0,0,23,23,19,49,68,118,84,202,0.000333,0.409889,9,11067.00745,614.833747,1229.667494,355.831405,10,0
0,0,29,29,21,47,68,145,102,247,0.000333,0.501201,20,30072.06644,1670.670358,1503.603322,353.304342,9,0
0,0,29,29,22,48,70,146,108,254,0.000333,0.518946,22,34250.4335,1902.801861,1556.837886,366.185696,9,0
0,0,24,24,20,43,63,131,85,216,0.000333,0.430364,10,12910.92464,717.273591,1291.092463,319.767946,9,0
0,0,24,24,20,44,64,131,87,218,0.000333,0.436,10,13080,726.666667,1308,326.653553,9,0
0,0,20,20,18,46,64,104,75,179,0.000333,0.358,9,9666,537,1074,329.1425,8,0
0,0,20,20,17,46,63,113,81,194,0.000333,0.386531,8,9276.738441,515.374358,1159.592305,323.570718,9,0
0,0,20,20,17,47,64,113,83,196,0.000333,0.392,8,9408,522.666667,1176,330.552544,9,0
0,0,27,27,19,46,65,137,90,227,0.000333,0.455692,9,12303.69744,683.538747,1367.077494,334.794473,9,0
0,0,27,27,20,44,64,137,87,224,0.000333,0.448,10,13440,746.666667,1344,326.653553,9,0
0,0,27,27,19,45,64,135,90,225,0.000333,0.45,18,24300,1350,1350,327.844012,9,0
0,0,27,27,20,47,67,136,90,226,0.000333,0.456979,10,13709.36157,761.631198,1370.936157,347.504238,9,0
0,0,34,34,21,53,74,164,119,283,0.000333,0.585758,20,35145.50605,1952.528114,1757.275302,395.81845,10,0
0,0,33,33,21,53,74,160,118,278,0.000333,0.575409,20,34524.56071,1918.031151,1726.228036,395.81845,9,0
0,0,32,32,21,50,71,161,107,268,0.000333,0.549377,20,32962.64456,1831.258031,1648.132228,374.431475,11,0
0,0,30,30,19,50,69,150,100,250,0.000333,0.509044,18,27488.36006,1527.131114,1527.131114,362.903432,11,0
0,0,30,30,21,47,68,151,100,251,0.000333,0.509318,20,30559.06346,1697.725748,1527.953173,353.304342,10,0
0,0,30,30,21,47,68,151,100,251,0.000333,0.509318,20,30559.06346,1697.725748,1527.953173,353.304342,10,0
0,0,41,41,23,59,82,200,142,342,0.000333,0.724761,22,47834.22128,2657.456738,2174.282786,451.117865,12,0
0,0,36,36,21,56,77,178,128,306,0.000333,0.639212,20,38352.73363,2130.707424,1917.636681,417.450542,11,0
0,0,41,41,23,61,84,195,145,340,0.000333,0.724463,22,47814.53432,2656.363018,2173.387924,465.816903,12,0
0,0,36,36,21,58,79,173,131,304,0.000333,0.638783,20,38326.98695,2129.277053,1916.349347,432.001564,11,0
0,0,38,38,23,56,79,182,137,319,0.000333,0.670302,22,44239.93329,2457.774072,2010.906059,429.253801,10,0
0,0,33,33,21,52,73,160,125,285,0.000333,0.588033,20,35281.99999,1960.11111,1764.099999,388.661531,9,0
0,0,30,30,21,47,68,151,101,252,0.000333,0.511347,20,30680.81272,1704.489596,1534.040636,353.304342,10,0
0,0,30,30,21,47,68,151,101,252,0.000333,0.511347,20,30680.81272,1704.489596,1534.040636,353.304342,10,0
0,0,32,32,20,50,70,156,111,267,0.000333,0.545506,20,32730.37131,1818.353962,1636.518566,368.631371,11,0
0,0,32,32,21,52,73,157,111,268,0.000333,0.552958,20,33177.45964,1843.192202,1658.872982,388.661531,11,0
0,0,27,27,19,46,65,135,92,227,0.000333,0.455692,18,24607.39488,1367.077494,1367.077494,334.794473,9,0
0,0,27,27,20,48,68,136,91,227,0.000333,0.460618,10,13818.54065,767.696703,1381.854065,354.516762,9,0
0,0,36,36,23,55,78,176,125,301,0.000333,0.630635,22,41621.93349,2312.329639,1891.906068,422.016709,10,0
0,0,31,31,21,51,72,154,111,265,0.000333,0.54501,20,32700.60251,1816.700139,1635.030125,381.532358,9,0
0,0,41,41,23,60,83,204,142,346,0.000333,0.735255,22,48526.80015,2695.933342,2205.763643,458.455361,12,0
0,0,36,36,21,57,78,182,128,310,0.000333,0.649492,20,38969.49376,2164.971875,1948.474688,424.713397,11,0
0,0,31,31,21,49,70,155,104,259,0.000333,0.529161,20,31749.68603,1763.871446,1587.484301,367.359448,9,0
0,0,32,32,22,47,69,155,103,258,0.000333,0.525333,22,34671.98482,1926.221379,1575.99931,359.173172,10,0
0,0,32,32,22,47,69,155,103,258,0.000333,0.525333,22,34671.98482,1926.221379,1575.99931,359.173172,10,0
0,0,29,29,21,46,67,144,95,239,0.000333,0.483265,20,28995.90633,1610.883685,1449.795317,346.322516,9,0
0,0,29,29,21,44,65,145,95,240,0.000333,0.481789,20,28907.3655,1605.96475,1445.368275,332.453657,9,0
0,0,11,11,10,18,28,40,42,82,0.000333,0.131401,10,3942.031036,219.001724,394.203104,108.277931,4,0
0,0,11,11,10,18,28,40,42,82,0.000333,0.131401,10,3942.031036,219.001724,394.203104,108.277931,4,0
0,0,11,11,10,21,31,39,48,87,0.000333,0.143672,10,4310.15079,239.452822,431.015079,125.457947,4,0
0,0,11,11,10,21,31,39,48,87,0.000333,0.143672,10,4310.15079,239.452822,431.015079,125.457947,4,0
0,0,11,11,9,17,26,27,40,67,0.000333,0.104976,8,2519.435689,139.968649,314.929461,98.016193,2,0
0,0,24,24,20,43,63,131,85,216,0.000333,0.430364,10,12910.92464,717.273591,1291.092463,319.767946,9,0
0,0,24,24,20,44,64,131,87,218,0.000333,0.436,10,13080,726.666667,1308,326.653553,9,0
0,0,29,29,21,47,68,145,102,247,0.000333,0.501201,20,30072.06644,1670.670358,1503.603322,353.304342,9,0
0,0,29,29,22,48,70,146,108,254,0.000333,0.518946,22,34250.4335,1902.801861,1556.837886,366.185696,9,0
0,0,28,28,21,44,65,142,88,230,0.000333,0.461715,20,27702.89194,1539.049552,1385.144597,332.453657,10,0
0,0,28,28,21,44,65,142,88,230,0.000333,0.461715,20,27702.89194,1539.049552,1385.144597,332.453657,10,0
0,0,6,6,11,18,29,31,29,60,0.000333,0.09716,5,1457.394299,80.96635,291.47886,113.112398,3,0
0,0,5,5,9,13,22,17,22,39,0.000333,0.057973,4,695.671333,38.648407,173.917833,76.635041,1,0
0,0,5,5,8,9,17,16,17,33,0.000333,0.044962,4,539.545095,29.974728,134.886274,52.529325,1,0
0,0,6,6,10,14,24,30,24,54,0.000333,0.082529,5,1237.939875,68.774438,247.587975,86.52225,3,0
0,0,11,11,9,12,21,28,31,59,0.000333,0.086382,8,2073.173824,115.176324,259.146728,71.548875,1,0
0,0,31,31,21,53,74,141,107,248,0.000333,0.513315,20,30798.88869,1711.049372,1539.944435,395.81845,11,0
0,0,6,6,11,17,28,31,27,58,0.000333,0.092942,5,1394.132927,77.451829,278.826585,107.540616,3,0
0,0,5,5,9,12,21,17,20,37,0.000333,0.054172,4,650.062979,36.11461,162.515745,71.548875,1,0
0,0,11,11,9,17,26,26,32,58,0.000333,0.090875,4,1090.502015,60.583445,272.625504,98.016193,1,0
0,0,31,31,20,58,78,139,108,247,0.000333,0.517498,10,15524.94348,862.49686,1552.494348,426.20146,11,0
0,0,6,6,11,16,27,29,27,56,0.000333,0.088758,5,1331.368501,73.964917,266.2737,102.053748,3,0
0,0,5,5,9,11,20,15,20,35,0.000333,0.050422,4,605.069933,33.614996,151.267483,66.583073,1,0
0,0,31,31,20,57,77,140,116,256,0.000333,0.534766,20,32085.94709,1782.552616,1604.297354,418.913293,12,0
0,0,31,31,20,57,77,140,116,256,0.000333,0.534766,20,32085.94709,1782.552616,1604.297354,418.913293,12,0
0,0,11,11,9,16,25,27,37,64,0.000333,0.099069,8,2377.654369,132.091909,297.206796,92.529325,2,0
0,0,31,31,20,54,74,141,110,251,0.000333,0.519524,20,31171.4559,1731.74755,1558.572795,397.202487,12,0
0,0,31,31,20,54,74,141,110,251,0.000333,0.519524,20,31171.4559,1731.74755,1558.572795,397.202487,12,0
0,0,11,11,9,13,22,28,31,59,0.000333,0.087702,8,2104.851724,116.936207,263.106465,76.635041,2,0
0,0,33,33,19,51,70,161,111,272,0.000333,0.555722,18,30008.96965,1667.164981,1667.164981,370.004315,11,0
0,0,33,33,21,53,74,164,112,276,0.000333,0.57127,20,34276.18258,1904.232365,1713.809129,395.81845,11,0
0,0,32,32,20,49,69,156,108,264,0.000333,0.53755,20,32253.00913,1791.833841,1612.650457,361.559344,11,0
0,0,32,32,21,51,72,157,109,266,0.000333,0.547067,20,32824.00101,1823.555612,1641.20005,381.532358,11,0
0,0,38,38,19,53,72,173,138,311,0.000333,0.639616,18,34539.24016,1918.846675,1918.846675,384.290407,11,0
0,0,38,38,21,55,76,176,145,321,0.000333,0.668528,20,40111.69464,2228.42748,2005.584732,410.21345,11,0
0,0,34,34,19,51,70,166,115,281,0.000333,0.57411,18,31001.9135,1722.328528,1722.328528,370.004315,11,0
0,0,34,34,21,53,74,169,116,285,0.000333,0.589898,20,35393.88418,1966.326899,1769.694209,395.81845,11,0
0,0,34,34,19,52,71,170,115,285,0.000333,0.584226,18,31548.20272,1752.677929,1752.677929,377.133488,11,0
0,0,34,34,21,54,75,173,116,289,0.000333,0.600043,20,36002.57203,2000.142891,1800.128602,403.002591,11,0
0,0,21,21,16,47,63,111,79,190,0.000333,0.378561,8,9085.465484,504.748082,1135.683185,325.065676,9,0
0,0,22,22,18,48,66,114,83,197,0.000333,0.396915,9,10716.71077,595.372821,1190.745642,343.13685,9,0
0,0,30,30,19,49,68,148,100,248,0.000333,0.50323,18,27174.43412,1509.690785,1509.690785,355.831405,11,0
0,0,30,30,20,51,71,149,100,249,0.000333,0.510429,10,15312.87033,850.715018,1531.287033,375.732254,11,0
0,0,22,22,18,48,66,114,83,197,0.000333,0.396915,9,10716.71077,595.372821,1190.745642,343.13685,9,0
0,0,22,22,18,48,66,114,83,197,0.000333,0.396915,9,10716.71077,595.372821,1190.745642,343.13685,9,0
0,0,22,22,18,48,66,114,83,197,0.000333,0.396915,9,10716.71077,595.372821,1190.745642,343.13685,9,0
0,0,29,29,21,47,68,146,94,240,0.000333,0.486997,20,29219.82164,1623.323424,1460.991082,353.304342,9,0
0,0,23,23,18,49,67,117,84,201,0.000333,0.406428,9,10973.55535,609.641964,1219.283927,350.179432,10,0
0,0,23,23,19,48,67,118,83,201,0.000333,0.406428,9,10973.55535,609.641964,1219.283927,348.788823,10,0
0,0,23,23,19,48,67,118,83,201,0.000333,0.406428,9,10973.55535,609.641964,1219.283927,348.788823,10,0
0,0,23,23,18,50,68,117,85,202,0.000333,0.409889,9,11067.00745,614.833747,1229.667494,357.25146,10,0
0,0,23,23,19,49,68,118,84,202,0.000333,0.409889,9,11067.00745,614.833747,1229.667494,355.831405,10,0
0,0,23,23,19,49,68,118,84,202,0.000333,0.409889,9,11067.00745,614.833747,1229.667494,355.831405,10,0
0,0,23,23,18,49,67,117,85,202,0.000333,0.40845,9,11028.15015,612.675008,1225.350016,350.179432,10,0
0,0,23,23,19,48,67,118,84,202,0.000333,0.40845,9,11028.15015,612.675008,1225.350016,348.788823,10,0
0,0,23,23,19,48,67,118,84,202,0.000333,0.40845,9,11028.15015,612.675008,1225.350016,348.788823,10,0
0,0,22,22,18,48,66,114,83,197,0.000333,0.396915,9,10716.71077,595.372821,1190.745642,343.13685,9,0
0,0,22,22,19,47,66,115,82,197,0.000333,0.396915,9,10716.71077,595.372821,1190.745642,341.776299,9,0
0,0,23,23,18,48,66,117,84,201,0.000333,0.404974,9,10934.30896,607.461609,1214.923218,343.13685,10,0
0,0,23,23,19,47,66,118,83,201,0.000333,0.404974,9,10934.30896,607.461609,1214.923218,341.776299,10,0
0,0,23,23,19,47,66,118,83,201,0.000333,0.404974,9,10934.30896,607.461609,1214.923218,341.776299,10,0
0,0,20,20,17,46,63,113,81,194,0.000333,0.386531,8,9276.738441,515.374358,1159.592305,323.570718,9,0
0,0,20,20,17,47,64,113,83,196,0.000333,0.392,8,9408,522.666667,1176,330.552544,9,0
0,0,23,23,18,50,68,117,85,202,0.000333,0.409889,9,11067.00745,614.833747,1229.667494,357.25146,10,0
0,0,25,25,20,49,69,122,87,209,0.000333,0.425561,10,12766.81612,709.267562,1276.681611,361.559344,10,0
0,0,34,34,21,50,71,163,119,282,0.000333,0.578076,20,34684.57375,1926.920764,1734.228688,374.431475,9,0
0,0,33,33,21,51,72,160,121,281,0.000333,0.577916,20,34674.97851,1926.387695,1733.748925,381.532358,9,0
0,0,36,36,21,51,72,169,129,298,0.000333,0.612879,20,36772.75301,2042.930723,1838.63765,381.532358,9,0
0,0,35,35,21,52,73,166,133,299,0.000333,0.616919,20,37015.15086,2056.39727,1850.757543,388.661531,9,0
0,0,38,38,21,52,73,175,139,314,0.000333,0.647868,20,38872.09823,2159.561013,1943.604911,388.661531,9,0
0,0,37,37,21,53,74,172,145,317,0.000333,0.656132,20,39367.93434,2187.107463,1968.396717,395.81845,9,0
0,0,33,33,21,50,71,163,112,275,0.000333,0.563727,20,33823.60916,1879.089398,1691.180458,374.431475,9,0
0,0,32,32,21,51,72,160,112,272,0.000333,0.559407,20,33564.39201,1864.688445,1678.2196,381.532358,9,0
0,0,34,34,21,51,72,172,116,288,0.000333,0.592313,20,35538.76801,1974.376,1776.9384,381.532358,9,0
0,0,33,33,21,52,73,169,116,285,0.000333,0.588033,20,35281.99999,1960.11111,1764.099999,388.661531,9,0
0,0,27,27,19,45,64,137,89,226,0.000333,0.452,9,12204,678,1356,327.844012,9,0
0,0,34,34,21,50,71,168,116,284,0.000333,0.582176,20,34930.56364,1940.586869,1746.528182,374.431475,9,0
0,0,33,33,21,51,72,165,116,281,0.000333,0.577916,20,34674.97851,1926.387695,1733.748925,381.532358,9,0
0,0,34,34,21,52,73,163,118,281,0.000333,0.57978,20,34786.81402,1932.600779,1739.340701,388.661531,9,0
0,0,33,33,21,53,74,160,118,278,0.000333,0.575409,20,34524.56071,1918.031151,1726.228036,395.81845,9,0
0,0,27,27,21,44,65,139,87,226,0.000333,0.453685,10,13610.55126,756.141737,1361.055126,332.453657,9,0
0,0,19,19,18,44,62,101,73,174,0.000333,0.345343,9,9324.271422,518.015079,1036.030158,315.273641,7,0
0,0,19,19,19,43,62,102,72,174,0.000333,0.345343,9,9324.271422,518.015079,1036.030158,314.040007,7,0
0,0,22,22,20,47,67,113,89,202,0.000333,0.40845,10,12253.50017,680.750009,1225.350016,347.504238,7,0
0,0,22,22,21,48,69,114,95,209,0.000333,0.425561,10,12766.81612,709.267562,1276.681611,360.316866,7,0
0,0,17,17,17,42,59,100,71,171,0.000333,0.335311,8,8047.455692,447.080872,1005.931961,295.9642,7,0
0,0,17,17,17,43,60,100,73,173,0.000333,0.340631,8,8175.136584,454.174255,1021.892073,302.816253,7,0
0,0,20,20,18,45,63,104,74,178,0.000333,0.354652,9,9575.602437,531.977913,1063.955826,322.192039,8,0
0,0,20,20,19,44,63,105,73,178,0.000333,0.354652,9,9575.602437,531.977913,1063.955826,320.925614,8,0
0,0,20,20,19,44,63,105,73,178,0.000333,0.354652,9,9575.602437,531.977913,1063.955826,320.925614,8,0
0,0,20,20,18,45,63,104,75,179,0.000333,0.356644,9,9629.397957,534.966553,1069.933106,322.192039,8,0
0,0,20,20,19,44,63,105,74,179,0.000333,0.356644,9,9629.397957,534.966553,1069.933106,320.925614,8,0
0,0,20,20,19,44,63,105,74,179,0.000333,0.356644,9,9629.397957,534.966553,1069.933106,320.925614,8,0
0,0,22,22,20,45,65,109,77,186,0.000333,0.373387,10,11201.60413,622.311341,1120.160413,333.571951,8,0
0,0,22,22,20,44,64,110,76,186,0.000333,0.372,10,11160,620,1116,326.653553,8,0
0,0,22,22,20,44,64,110,76,186,0.000333,0.372,10,11160,620,1116,326.653553,8,0
0,0,20,20,18,46,64,104,75,179,0.000333,0.358,9,9666,537,1074,329.1425,8,0
0,0,20,20,19,45,64,105,74,179,0.000333,0.358,9,9666,537,1074,327.844012,8,0
0,0,20,20,19,45,64,105,74,179,0.000333,0.358,9,9666,537,1074,327.844012,8,0
0,0,11,11,13,22,35,41,48,89,0.000333,0.152169,12,5478.074262,304.337459,456.506189,146.213212,3,0
0,0,11,11,11,18,29,29,43,72,0.000333,0.116592,10,3497.746316,194.31924,349.774632,113.112398,1,0
0,0,32,32,24,50,74,162,105,267,0.000333,0.552641,24,39790.17717,2210.565398,1657.924049,392.23191,12,0
0,0,10,10,8,12,20,25,29,54,0.000333,0.077795,8,1867.072937,103.726274,233.384117,67.01955,1,0
0,0,30,30,20,53,73,138,105,243,0.000333,0.501376,10,15041.27368,835.626315,1504.127368,390.018346,11,0
0,0,32,32,21,49,70,159,107,266,0.000333,0.543463,20,32607.78565,1811.543647,1630.389283,367.359448,11,0
0,0,32,32,21,49,70,159,107,266,0.000333,0.543463,20,32607.78565,1811.543647,1630.389283,367.359448,11,0
0,0,29,29,21,46,67,147,96,243,0.000333,0.491353,20,29481.19347,1637.844081,1474.059673,346.322516,10,0
0,0,29,29,21,48,69,147,95,242,0.000333,0.492754,10,14782.62919,821.257177,1478.262919,360.316866,10,0
0,0,27,27,19,45,64,135,90,225,0.000333,0.45,18,24300,1350,1350,327.844012,9,0
0,0,27,27,20,47,67,136,90,226,0.000333,0.456979,10,13709.36157,761.631198,1370.936157,347.504238,9,0
0,0,29,29,19,47,66,143,99,242,0.000333,0.487581,18,26329.38078,1462.743377,1462.743377,341.776299,10,0
0,0,29,29,21,49,70,146,100,246,0.000333,0.502601,20,30156.07244,1675.337358,1507.803622,367.359448,10,0
0,0,11,11,9,17,26,26,32,58,0.000333,0.090875,4,1090.502015,60.583445,272.625504,98.016193,1,0
0,0,12,12,11,22,33,42,39,81,0.000333,0.136199,5,2042.979618,113.498868,408.595924,136.161243,3,0
0,0,31,31,19,48,67,149,109,258,0.000333,0.521684,18,28170.9182,1565.051011,1565.051011,348.788823,10,0
0,0,31,31,21,50,71,152,112,264,0.000333,0.541178,20,32470.66479,1803.925822,1623.53324,374.431475,10,0
0,0,12,12,11,17,28,44,38,82,0.000333,0.131401,10,3942.031036,219.001724,394.203104,107.540616,3,0
0,0,31,31,21,51,72,158,102,260,0.000333,0.534727,20,32083.61001,1782.422778,1604.1805,381.532358,12,0
0,0,31,31,21,51,72,158,102,260,0.000333,0.534727,20,32083.61001,1782.422778,1604.1805,381.532358,12,0
0,0,31,31,21,51,72,158,102,260,0.000333,0.534727,20,32083.61001,1782.422778,1604.1805,381.532358,12,0
0,0,31,31,21,51,72,158,102,260,0.000333,0.534727,20,32083.61001,1782.422778,1604.1805,381.532358,12,0
0,0,31,31,21,51,72,158,102,260,0.000333,0.534727,20,32083.61001,1782.422778,1604.1805,381.532358,12,0
0,0,31,31,21,51,72,158,102,260,0.000333,0.534727,20,32083.61001,1782.422778,1604.1805,381.532358,12,0
0,0,33,33,22,50,72,163,104,267,0.000333,0.549123,22,36242.13946,2013.452192,1647.369975,380.300305,12,0
0,0,33,33,22,50,72,163,104,267,0.000333,0.549123,22,36242.13946,2013.452192,1647.369975,380.300305,12,0
0,0,31,31,21,51,72,158,102,260,0.000333,0.534727,20,32083.61001,1782.422778,1604.1805,381.532358,12,0
0,0,31,31,21,51,72,158,102,260,0.000333,0.534727,20,32083.61001,1782.422778,1604.1805,381.532358,12,0
0,0,31,31,21,50,71,158,101,259,0.000333,0.530928,20,31855.69008,1769.76056,1592.784504,374.431475,12,0
0,0,31,31,21,50,71,158,101,259,0.000333,0.530928,20,31855.69008,1769.76056,1592.784504,374.431475,12,0
0,0,31,31,21,50,71,158,101,259,0.000333,0.530928,20,31855.69008,1769.76056,1592.784504,374.431475,12,0
0,0,31,31,21,50,71,158,101,259,0.000333,0.530928,20,31855.69008,1769.76056,1592.784504,374.431475,12,0
0,0,32,32,21,50,71,158,101,259,0.000333,0.530928,20,31855.69008,1769.76056,1592.784504,374.431475,12,0
0,0,34,34,22,51,73,175,110,285,0.000333,0.588033,22,38810.19998,2156.122221,1764.099999,387.401188,12,0
0,0,32,32,22,49,71,159,100,259,0.000333,0.530928,22,35041.25909,1946.736616,1592.784504,373.228278,12,0
0,0,33,33,22,50,72,162,104,266,0.000333,0.547067,22,36106.40111,2005.911173,1641.20005,380.300305,12,0
0,0,33,33,22,50,72,162,104,266,0.000333,0.547067,22,36106.40111,2005.911173,1641.20005,380.300305,12,0
0,0,24,24,19,49,68,123,90,213,0.000333,0.43221,9,11669.66627,648.314793,1296.629585,355.831405,9,0
0,0,24,24,19,48,67,124,91,215,0.000333,0.434736,9,11737.88258,652.104588,1304.209176,348.788823,9,0
0,0,22,22,18,48,66,114,83,197,0.000333,0.396915,9,10716.71077,595.372821,1190.745642,343.13685,9,0
0,0,22,22,19,47,66,115,82,197,0.000333,0.396915,9,10716.71077,595.372821,1190.745642,341.776299,9,0
0,0,24,24,18,49,67,123,89,212,0.000333,0.42867,9,11574.09818,643.005454,1286.010908,350.179432,9,0
0,0,24,24,19,48,67,124,88,212,0.000333,0.42867,9,11574.09818,643.005454,1286.010908,348.788823,9,0
0,0,22,22,18,48,66,114,83,197,0.000333,0.396915,9,10716.71077,595.372821,1190.745642,343.13685,9,0
0,0,22,22,19,47,66,115,82,197,0.000333,0.396915,9,10716.71077,595.372821,1190.745642,341.776299,9,0
0,0,22,22,18,48,66,114,83,197,0.000333,0.396915,9,10716.71077,595.372821,1190.745642,343.13685,9,0
0,0,22,22,19,47,66,115,82,197,0.000333,0.396915,9,10716.71077,595.372821,1190.745642,341.776299,9,0
0,0,22,22,19,47,66,115,82,197,0.000333,0.396915,9,10716.71077,595.372821,1190.745642,341.776299,9,0
0,0,22,22,18,48,66,114,83,197,0.000333,0.396915,9,10716.71077,595.372821,1190.745642,343.13685,9,0
0,0,22,22,19,47,66,115,82,197,0.000333,0.396915,9,10716.71077,595.372821,1190.745642,341.776299,9,0
0,0,22,22,19,47,66,115,82,197,0.000333,0.396915,9,10716.71077,595.372821,1190.745642,341.776299,9,0
0,0,11,11,10,18,28,43,31,74,0.000333,0.118581,5,1778.721321,98.817851,355.744264,108.277931,5,0
0,0,11,11,10,17,27,43,31,74,0.000333,0.117287,5,1759.308376,97.739354,351.861675,102.706149,5,0
0,0,23,23,18,49,67,117,84,201,0.000333,0.406428,9,10973.55535,609.641964,1219.283927,350.179432,10,0
0,0,23,23,18,49,67,117,84,201,0.000333,0.406428,9,10973.55535,609.641964,1219.283927,350.179432,10,0
0,0,25,25,20,49,69,122,87,209,0.000333,0.425561,10,12766.81612,709.267562,1276.681611,361.559344,10,0
0,0,23,23,18,50,68,117,85,202,0.000333,0.409889,9,11067.00745,614.833747,1229.667494,357.25146,10,0
0,0,23,23,18,50,68,117,85,202,0.000333,0.409889,9,11067.00745,614.833747,1229.667494,357.25146,10,0
0,0,23,23,18,49,67,117,84,201,0.000333,0.406428,9,10973.55535,609.641964,1219.283927,350.179432,10,0
0,0,23,23,18,49,67,117,84,201,0.000333,0.406428,9,10973.55535,609.641964,1219.283927,350.179432,10,0
0,0,23,23,18,49,67,117,85,202,0.000333,0.40845,9,11028.15015,612.675008,1225.350016,350.179432,10,0
0,0,23,23,18,48,66,117,84,201,0.000333,0.404974,9,10934.30896,607.461609,1214.923218,343.13685,10,0
0,0,22,22,18,48,66,114,83,197,0.000333,0.396915,9,10716.71077,595.372821,1190.745642,343.13685,9,0
0,0,35,35,22,51,73,168,113,281,0.000333,0.57978,22,38265.49542,2125.860857,1739.340701,387.401188,12,0
0,0,35,35,22,51,73,168,113,281,0.000333,0.57978,22,38265.49542,2125.860857,1739.340701,387.401188,12,0
0,0,33,33,21,52,73,164,111,275,0.000333,0.567401,20,34044.03507,1891.335282,1702.201754,388.661531,12,0
0,0,33,33,21,52,73,164,111,275,0.000333,0.567401,20,34044.03507,1891.335282,1702.201754,388.661531,12,0
0,0,33,33,21,52,73,164,111,275,0.000333,0.567401,20,34044.03507,1891.335282,1702.201754,388.661531,12,0
0,0,33,33,21,52,73,164,111,275,0.000333,0.567401,20,34044.03507,1891.335282,1702.201754,388.661531,12,0
0,0,34,34,24,52,76,171,115,286,0.000333,0.595636,24,42885.77445,2382.543025,1786.907269,406.461965,12,0
0,0,32,32,21,50,71,161,109,270,0.000333,0.553477,20,33208.63445,1844.924136,1660.431722,374.431475,11,0
0,0,32,32,21,50,71,161,109,270,0.000333,0.553477,20,33208.63445,1844.924136,1660.431722,374.431475,11,0
0,0,37,37,22,57,79,182,129,311,0.000333,0.653492,22,43130.46788,2396.137104,1960.475813,430.582226,12,0
0,0,32,32,21,54,75,160,115,275,0.000333,0.570975,20,34258.5028,1903.250155,1712.92514,403.002591,11,0
0,0,32,32,21,54,75,160,115,275,0.000333,0.570975,20,34258.5028,1903.250155,1712.92514,403.002591,11,0
0,0,19,19,18,44,62,101,73,174,0.000333,0.345343,9,9324.271422,518.015079,1036.030158,315.273641,7,0
0,0,15,15,11,22,33,50,43,93,0.000333,0.156376,5,2345.643266,130.313515,469.128653,136.161243,5,0
0,0,15,15,11,21,32,50,43,93,0.000333,0.155,10,4650,258.333333,465,130.292414,5,0
0,0,11,11,10,20,30,42,37,79,0.000333,0.129215,5,1938.221785,107.678988,387.644357,119.657843,5,0
0,0,11,11,10,19,29,42,37,79,0.000333,0.127927,5,1918.902493,106.605694,383.780499,113.929904,5,0
0,0,11,11,11,20,31,43,39,82,0.000333,0.135415,5,2031.220487,112.845583,406.244097,124.49231,5,0
0,0,11,11,10,20,30,42,39,81,0.000333,0.132486,5,1987.290691,110.405038,397.458138,119.657843,5,0
0,0,20,20,18,45,63,104,74,178,0.000333,0.354652,9,9575.602437,531.977913,1063.955826,322.192039,8,0
0,0,20,20,19,44,63,105,73,178,0.000333,0.354652,9,9575.602437,531.977913,1063.955826,320.925614,8,0
0,0,20,20,19,44,63,105,73,178,0.000333,0.354652,9,9575.602437,531.977913,1063.955826,320.925614,8,0
0,0,29,29,21,45,66,144,94,238,0.000333,0.479522,20,28771.31601,1598.406445,1438.5658,339.372055,9,0
0,0,11,11,10,17,27,39,30,69,0.000333,0.109362,5,1640.436188,91.135344,328.087238,102.706149,5,0
0,0,11,11,10,16,26,39,30,69,0.000333,0.10811,5,1621.651703,90.091761,324.330341,97.219281,5,0
0,0,10,10,9,12,21,26,27,53,0.000333,0.077598,8,1862.342587,103.463477,232.792823,71.548875,1,0
0,0,30,30,20,53,73,139,103,242,0.000333,0.499313,10,14979.37543,832.187524,1497.937543,390.018346,11,0
0,0,10,10,8,12,20,23,27,50,0.000333,0.072032,8,1728.771238,96.042847,216.096405,67.01955,1,0
0,0,30,30,20,53,73,136,103,239,0.000333,0.493123,10,14793.6807,821.87115,1479.36807,390.018346,11,0
0,0,6,6,11,18,29,31,27,58,0.000333,0.093921,5,1408.814489,78.267472,281.762898,113.112398,3,0
0,0,5,5,9,13,22,17,20,37,0.000333,0.055,4,659.99588,36.666438,164.99897,76.635041,1,0
0,0,11,11,13,22,35,41,45,86,0.000333,0.147039,12,5293.420073,294.078893,441.118339,146.213212,3,0
0,0,11,11,11,18,29,29,40,69,0.000333,0.111734,10,3352.006887,186.222605,335.200689,113.112398,1,0
0,0,12,12,9,18,27,37,40,77,0.000333,0.122042,8,2929.010701,162.722817,366.126338,103.587975,1,0
0,0,12,12,11,22,33,49,45,94,0.000333,0.158058,10,4741.730472,263.429471,474.173047,136.161243,3,0
0,0,13,13,10,18,28,37,43,80,0.000333,0.128196,10,3845.883938,213.660219,384.588394,108.277931,1,0
0,0,13,13,12,23,35,49,48,97,0.000333,0.165847,12,5970.485432,331.693635,497.540453,147.061475,3,0
0,0,6,6,7,14,21,15,23,38,0.000333,0.055636,3,500.724186,27.81801,166.908062,72.954453,1,0
0,0,7,7,9,19,28,29,30,59,0.000333,0.094545,4,1134.535762,63.029765,283.63394,109.239948,3,0
0,0,15,15,10,20,30,56,41,97,0.000333,0.158656,10,4759.683878,264.426882,475.968388,119.657843,5,0
0,0,11,11,11,19,30,43,33,76,0.000333,0.124308,5,1864.618426,103.589913,372.923685,118.764371,4,0
0,0,11,11,11,19,30,43,33,76,0.000333,0.124308,5,1864.618426,103.589913,372.923685,118.764371,4,0
0,0,15,15,10,14,24,45,35,80,0.000333,0.122266,10,3667.970001,203.776111,366.797,86.52225,3,0
0,0,15,15,10,14,24,45,35,80,0.000333,0.122266,10,3667.970001,203.776111,366.797,86.52225,3,0
0,0,29,29,21,46,67,145,91,236,0.000333,0.477199,10,14315.97049,795.331694,1431.597049,346.322516,10,0
0,0,31,31,22,46,68,156,94,250,0.000333,0.507289,22,33481.04563,1860.05809,1521.86571,352.191346,10,0
0,0,6,6,11,17,28,29,28,57,0.000333,0.09134,5,1370.096153,76.116453,274.019231,107.540616,3,0
0,0,5,5,9,12,21,15,21,36,0.000333,0.052708,4,632.493709,35.138539,158.123427,71.548875,1,0
0,0,14,14,15,22,37,52,62,114,0.000333,0.197959,14,8314.287572,461.904865,593.877684,156.710855,3,0
0,0,13,13,12,16,28,33,54,87,0.000333,0.139413,18,7528.317808,418.239878,418.239878,107.01955,1,0
0,0,6,6,11,18,29,31,28,59,0.000333,0.09554,5,1433.104394,79.616911,286.620879,113.112398,3,0
0,0,5,5,9,13,22,17,21,38,0.000333,0.056486,4,677.833606,37.657423,169.458402,76.635041,1,0
0,0,11,11,11,19,30,43,39,82,0.000333,0.134122,10,4023.650288,223.536127,402.365029,118.764371,5,0
0,0,11,11,10,19,29,42,39,81,0.000333,0.131165,10,3934.964606,218.609145,393.496461,113.929904,5,0
0,0,11,11,10,20,30,42,37,79,0.000333,0.129215,5,1938.221785,107.678988,387.644357,119.657843,5,0
0,0,11,11,10,19,29,42,37,79,0.000333,0.127927,5,1918.902493,106.605694,383.780499,113.929904,5,0
0,0,28,28,21,45,66,142,88,230,0.000333,0.463404,10,13902.10648,772.339249,1390.210647,339.372055,10,0
0,0,28,28,21,45,66,142,88,230,0.000333,0.463404,10,13902.10648,772.339249,1390.210647,339.372055,10,0
0,0,30,30,22,45,67,146,91,237,0.000333,0.479221,22,31628.58904,1757.143836,1437.663138,345.240885,10,0
0,0,30,30,22,45,67,146,91,237,0.000333,0.479221,22,31628.58904,1757.143836,1437.663138,345.240885,10,0
0,0,33,33,21,50,71,164,108,272,0.000333,0.557577,20,33454.62433,1858.590241,1672.731217,374.431475,12,0
0,0,9,9,11,17,28,35,28,63,0.000333,0.100954,5,1514.3168,84.128711,302.86336,107.540616,4,0
0,0,9,9,10,17,27,34,28,62,0.000333,0.098268,5,1474.015126,81.889729,294.803025,102.706149,4,0
0,0,11,11,11,17,28,39,32,71,0.000333,0.113774,5,1706.610997,94.811722,341.322199,107.540616,4,0
0,0,11,11,11,18,29,39,32,71,0.000333,0.114972,5,1724.583253,95.810181,344.916651,113.112398,4,0
0,0,9,9,11,18,29,35,30,65,0.000333,0.105256,5,1578.843823,87.713546,315.768765,113.112398,4,0
0,0,9,9,10,18,28,34,30,64,0.000333,0.102557,5,1538.353575,85.464088,307.670715,108.277931,4,0
0,0,9,9,11,18,29,35,30,65,0.000333,0.105256,5,1578.843823,87.713546,315.768765,113.112398,4,0
0,0,9,9,10,18,28,34,30,64,0.000333,0.102557,5,1538.353575,85.464088,307.670715,108.277931,4,0
0,0,9,9,10,17,27,34,29,63,0.000333,0.099853,5,1497.789563,83.210531,299.557913,102.706149,4,0
0,0,9,9,10,17,27,34,29,63,0.000333,0.099853,5,1497.789563,83.210531,299.557913,102.706149,4,0
0,0,9,9,10,16,26,37,29,66,0.000333,0.10341,5,1551.145107,86.174728,310.229021,97.219281,3,0
0,0,11,11,11,17,28,38,32,70,0.000333,0.112172,5,1682.574223,93.476346,336.514845,107.540616,4,0
0,0,11,11,11,18,29,38,32,70,0.000333,0.113353,5,1700.293348,94.460742,340.05867,113.112398,4,0
0,0,14,14,10,15,25,33,31,64,0.000333,0.099069,10,2972.067961,165.114887,297.206796,91.82264,3,0
0,0,14,14,10,14,24,33,31,64,0.000333,0.097813,10,2934.376,163.020889,293.4376,86.52225,3,0
0,0,9,9,10,17,27,34,29,63,0.000333,0.099853,5,1497.789563,83.210531,299.557913,102.706149,4,0
0,0,9,9,10,17,27,34,29,63,0.000333,0.099853,5,1497.789563,83.210531,299.557913,102.706149,4,0
0,0,9,9,10,17,27,34,29,63,0.000333,0.099853,5,1497.789563,83.210531,299.557913,102.706149,4,0
0,0,9,9,10,17,27,34,29,63,0.000333,0.099853,5,1497.789563,83.210531,299.557913,102.706149,4,0
0,0,10,10,9,14,23,25,25,50,0.000333,0.075393,4,904.712391,50.2618,226.178098,81.832294,3,0
0,0,10,10,9,13,22,25,25,50,0.000333,0.074324,4,891.886324,49.54924,222.971581,76.635041,3,0
0,0,11,11,11,18,29,44,33,77,0.000333,0.124688,5,1870.322683,103.906816,374.064537,113.112398,5,0
0,0,11,11,10,18,28,43,33,76,0.000333,0.121786,5,1826.79487,101.488604,365.358974,108.277931,5,0
0,0,9,9,11,18,29,35,30,65,0.000333,0.105256,5,1578.843823,87.713546,315.768765,113.112398,4,0
0,0,9,9,10,18,28,34,30,64,0.000333,0.102557,5,1538.353575,85.464088,307.670715,108.277931,4,0
0,0,10,10,10,14,24,26,27,53,0.000333,0.081001,5,1215.015063,67.500837,243.003013,86.52225,3,0
0,0,10,10,9,14,23,25,27,52,0.000333,0.078408,4,940.900887,52.272271,235.225222,81.832294,3,0
0,0,9,9,11,18,29,35,30,65,0.000333,0.105256,5,1578.843823,87.713546,315.768765,113.112398,4,0
0,0,9,9,10,18,28,34,30,64,0.000333,0.102557,5,1538.353575,85.464088,307.670715,108.277931,4,0
0,0,10,10,10,14,24,26,27,53,0.000333,0.081001,5,1215.015063,67.500837,243.003013,86.52225,3,0
0,0,10,10,9,14,23,25,27,52,0.000333,0.078408,4,940.900887,52.272271,235.225222,81.832294,3,0
0,0,8,8,8,11,19,19,21,40,0.000333,0.056639,4,679.668402,37.759356,169.917101,62.053748,1,0
0,0,28,28,20,52,72,132,97,229,0.000333,0.470971,10,14129.12825,784.95157,1412.912825,382.861427,11,0
0,0,9,9,10,15,25,34,27,61,0.000333,0.094425,5,1416.376138,78.687563,283.275228,91.82264,4,0
0,0,9,9,10,16,26,34,27,61,0.000333,0.095576,5,1433.634114,79.64634,286.726823,97.219281,4,0
0,0,11,11,10,18,28,43,31,74,0.000333,0.118581,5,1778.721321,98.817851,355.744264,108.277931,5,0
0,0,11,11,10,17,27,43,31,74,0.000333,0.117287,5,1759.308376,97.739354,351.861675,102.706149,5,0
0,0,19,19,18,44,62,101,73,174,0.000333,0.345343,9,9324.271422,518.015079,1036.030158,315.273641,7,0
0,0,30,30,20,54,74,138,99,237,0.000333,0.490547,10,14716.40448,817.578026,1471.640448,397.202487,13,0
0,0,30,30,20,53,73,138,99,237,0.000333,0.488996,10,14669.88421,814.993567,1466.98842,390.018346,13,0
0,0,10,10,9,13,22,25,23,48,0.000333,0.071351,4,856.210871,47.567271,214.052718,76.635041,3,0
0,0,10,10,9,12,21,25,23,48,0.000333,0.070277,4,843.324945,46.851386,210.831236,71.548875,3,0
0,0,30,30,20,53,73,139,101,240,0.000333,0.495186,10,14855.57894,825.309941,1485.557894,390.018346,13,0
0,0,30,30,20,53,73,138,101,239,0.000333,0.493123,10,14793.6807,821.87115,1479.36807,390.018346,13,0
0,0,10,10,10,12,22,26,25,51,0.000333,0.07581,10,2274.310126,126.350563,227.431013,76.238831,3,0
0,0,10,10,9,12,21,25,25,50,0.000333,0.073205,8,1756.926969,97.607054,219.615871,71.548875,3,0
0,0,30,30,20,54,74,139,101,240,0.000333,0.496756,10,14902.68808,827.927115,1490.268808,397.202487,13,0
0,0,30,30,20,54,74,138,101,239,0.000333,0.494686,10,14840.59354,824.477419,1484.059354,397.202487,13,0
0,0,10,10,10,13,23,26,25,51,0.000333,0.076901,5,1153.508299,64.083794,230.70166,81.324997,3,0
0,0,10,10,9,13,22,25,25,50,0.000333,0.074324,4,891.886324,49.54924,222.971581,76.635041,3,0
0,0,30,30,20,54,74,138,99,237,0.000333,0.490547,10,14716.40448,817.578026,1471.640448,397.202487,13,0
0,0,30,30,20,53,73,138,99,237,0.000333,0.488996,10,14669.88421,814.993567,1466.98842,390.018346,13,0
0,0,10,10,9,13,22,25,23,48,0.000333,0.071351,4,856.210871,47.567271,214.052718,76.635041,3,0
0,0,10,10,9,12,21,25,23,48,0.000333,0.070277,4,843.324945,46.851386,210.831236,71.548875,3,0
0,0,33,33,21,49,70,164,105,269,0.000333,0.549592,20,32975.54263,1831.974591,1648.777132,367.359448,11,0
0,0,23,23,18,49,67,117,84,201,0.000333,0.406428,9,10973.55535,609.641964,1219.283927,350.179432,10,0
0,0,32,32,19,50,69,155,108,263,0.000333,0.535514,18,28917.75478,1606.541932,1606.541932,362.903432,11,0
0,0,32,32,21,52,73,158,111,269,0.000333,0.555021,20,33301.25613,1850.069785,1665.062806,388.661531,11,0
0,0,32,32,21,52,73,158,111,269,0.000333,0.555021,20,33301.25613,1850.069785,1665.062806,388.661531,11,0
0,0,31,31,21,50,71,155,99,254,0.000333,0.520679,10,15620.35768,867.797649,1562.035768,374.431475,12,0
0,0,31,31,21,50,71,155,99,254,0.000333,0.520679,10,15620.35768,867.797649,1562.035768,374.431475,12,0
0,0,23,23,18,50,68,117,85,202,0.000333,0.409889,9,11067.00745,614.833747,1229.667494,357.25146,10,0
0,0,31,31,21,48,69,155,98,253,0.000333,0.515152,20,30909.13375,1717.174097,1545.456688,360.316866,12,0
0,0,31,31,22,49,71,155,98,253,0.000333,0.518629,22,34229.49247,1901.63847,1555.886021,373.228278,12,0
0,0,31,31,22,49,71,155,98,253,0.000333,0.518629,22,34229.49247,1901.63847,1555.886021,373.228278,12,0
0,0,29,29,21,45,66,146,97,243,0.000333,0.489596,20,29375.75542,1631.986412,1468.787771,339.372055,9,0
0,0,29,29,21,45,66,146,97,243,0.000333,0.489596,20,29375.75542,1631.986412,1468.787771,339.372055,9,0
0,0,29,29,24,46,70,149,95,244,0.000333,0.498515,24,35893.08135,1994.060075,1495.545056,364.12295,10,0
0,0,32,32,21,49,70,158,103,261,0.000333,0.533248,20,31994.85735,1777.492075,1599.742867,367.359448,11,0
0,0,28,28,22,45,67,142,88,230,0.000333,0.465067,11,15347.20565,852.622536,1395.200514,345.240885,10,0
0,0,28,28,22,45,67,142,88,230,0.000333,0.465067,11,15347.20565,852.622536,1395.200514,345.240885,10,0
0,0,28,28,21,44,65,142,88,230,0.000333,0.461715,20,27702.89194,1539.049552,1385.144597,332.453657,10,0
0,0,14,14,15,25,40,51,74,125,0.000333,0.221747,14,9313.374166,517.409676,665.241012,174.699764,3,0
0,0,13,13,12,19,31,32,66,98,0.000333,0.161837,18,8739.202292,485.511238,485.511238,123.730173,1,0
0,0,6,6,11,18,29,29,31,60,0.000333,0.09716,5,1457.394299,80.96635,291.47886,113.112398,3,0
0,0,5,5,9,13,22,15,24,39,0.000333,0.057973,4,695.671333,38.648407,173.917833,76.635041,1,0
0,0,6,6,11,17,28,29,28,57,0.000333,0.09134,5,1370.096153,76.116453,274.019231,107.540616,3,0
0,0,5,5,9,12,21,15,21,36,0.000333,0.052708,4,632.493709,35.138539,158.123427,71.548875,1,0
0,0,14,14,15,23,38,52,65,117,0.000333,0.204669,14,8596.105267,477.561404,614.007519,162.645284,3,0
0,0,13,13,12,17,29,33,57,90,0.000333,0.145739,18,7869.929212,437.21829,437.21829,112.506418,1,0
0,0,11,11,13,24,37,40,54,94,0.000333,0.16323,12,5876.263396,326.459078,489.688616,158.144816,3,0
0,0,11,11,11,20,31,28,49,77,0.000333,0.127158,10,3814.731159,211.929509,381.473116,124.49231,1,0
0,0,6,6,11,19,30,31,31,62,0.000333,0.101409,5,1521.136085,84.50756,304.227217,118.764371,3,0
0,0,5,5,9,14,23,17,24,41,0.000333,0.061822,4,741.864161,41.214676,185.46604,81.832294,1,0
0,0,11,11,11,17,28,44,33,77,0.000333,0.123389,5,1850.831645,102.82398,370.166329,107.540616,5,0
0,0,11,11,10,17,27,43,33,76,0.000333,0.120457,5,1806.857251,100.380958,361.37145,102.706149,5,0
0,0,30,30,22,45,67,147,91,238,0.000333,0.481243,22,31762.043,1764.557945,1443.729227,345.240885,10,0
0,0,30,30,22,45,67,147,91,238,0.000333,0.481243,22,31762.043,1764.557945,1443.729227,345.240885,10,0
0,0,6,6,8,13,21,16,21,37,0.000333,0.054172,4,650.062979,36.11461,162.515745,72.105716,1,0
0,0,7,7,10,18,28,30,28,58,0.000333,0.092942,5,1394.132927,77.451829,278.826585,108.277931,3,0
0,0,23,23,18,50,68,117,85,202,0.000333,0.409889,9,11067.00745,614.833747,1229.667494,357.25146,10,0
0,0,28,28,21,46,67,142,89,231,0.000333,0.467089,10,14012.66603,778.481446,1401.266603,346.322516,10,0
0,0,28,28,21,46,67,142,89,231,0.000333,0.467089,10,14012.66603,778.481446,1401.266603,346.322516,10,0
0,0,28,28,21,45,66,142,88,230,0.000333,0.463404,10,13902.10648,772.339249,1390.210647,339.372055,10,0
0,0,28,28,21,45,66,142,88,230,0.000333,0.463404,10,13902.10648,772.339249,1390.210647,339.372055,10,0
0,0,11,11,7,16,23,30,68,98,0.000333,0.14777,12,5319.70886,295.539381,443.309072,83.651484,1,0
0,0,12,12,9,21,30,44,75,119,0.000333,0.19464,12,7007.039771,389.279987,583.919981,120.767991,3,0
0,0,11,11,9,18,27,26,44,70,0.000333,0.110947,8,2662.737001,147.929833,332.842125,103.587975,1,0
0,0,11,11,11,22,33,38,49,87,0.000333,0.146287,10,4388.622884,243.812382,438.862288,136.161243,3,0
0,0,11,11,9,19,28,28,45,73,0.000333,0.116979,8,2807.495274,155.97196,350.936909,109.239948,1,0
0,0,11,11,11,23,34,40,50,90,0.000333,0.152624,10,4578.716557,254.373142,457.871656,142.095673,3,0
0,0,12,12,9,20,29,36,50,86,0.000333,0.139262,8,3342.290925,185.682829,417.786366,114.967887,1,0
0,0,12,12,11,24,35,48,55,103,0.000333,0.176105,10,5283.161507,293.508973,528.316151,148.092848,3,0
0,0,13,13,10,20,30,36,53,89,0.000333,0.145571,10,4367.13263,242.618479,436.713263,119.657843,1,0
0,0,13,13,12,25,37,48,58,106,0.000333,0.184067,12,6626.424681,368.134705,552.202057,159.115955,3,0
0,0,29,29,21,46,67,148,99,247,0.000333,0.499441,20,29966.4806,1664.804478,1498.32403,346.322516,9,0
0,0,29,29,21,46,67,148,99,247,0.000333,0.499441,20,29966.4806,1664.804478,1498.32403,346.322516,9,0
0,0,11,11,11,16,27,40,32,72,0.000333,0.114117,10,3423.519002,190.1955,342.3519,102.053748,5,0
0,0,11,11,10,16,26,39,32,71,0.000333,0.111244,10,3337.3122,185.406233,333.73122,97.219281,5,0
0,0,29,29,21,46,67,145,91,236,0.000333,0.477199,10,14315.97049,795.331694,1431.597049,346.322516,10,0
0,0,11,11,11,17,28,42,34,76,0.000333,0.121786,10,3653.589741,202.977208,365.358974,107.540616,3,0
0,0,23,23,18,50,68,117,85,202,0.000333,0.409889,9,11067.00745,614.833747,1229.667494,357.25146,10,0
0,0,23,23,19,49,68,118,84,202,0.000333,0.409889,9,11067.00745,614.833747,1229.667494,355.831405,10,0
0,0,23,23,19,49,68,118,84,202,0.000333,0.409889,9,11067.00745,614.833747,1229.667494,355.831405,10,0
0,0,9,9,11,17,28,35,28,63,0.000333,0.100954,5,1514.3168,84.128711,302.86336,107.540616,4,0
0,0,9,9,10,17,27,34,28,62,0.000333,0.098268,5,1474.015126,81.889729,294.803025,102.706149,4,0
0,0,9,9,11,17,28,35,28,63,0.000333,0.100954,5,1514.3168,84.128711,302.86336,107.540616,4,0
0,0,9,9,10,17,27,34,28,62,0.000333,0.098268,5,1474.015126,81.889729,294.803025,102.706149,4,0
0,0,21,21,16,47,63,111,79,190,0.000333,0.378561,8,9085.465484,504.748082,1135.683185,325.065676,9,0
0,0,21,21,17,46,63,112,78,190,0.000333,0.378561,8,9085.465484,504.748082,1135.683185,323.570718,9,0
0,0,12,12,10,21,31,41,50,91,0.000333,0.150277,10,4508.318642,250.462147,450.831864,125.457947,4,0
0,0,12,12,10,21,31,41,50,91,0.000333,0.150277,10,4508.318642,250.462147,450.831864,125.457947,4,0
0,0,11,11,9,17,26,27,40,67,0.000333,0.104976,8,2519.435689,139.968649,314.929461,98.016193,2,0
0,0,10,10,10,16,26,37,34,71,0.000333,0.111244,10,3337.3122,185.406233,333.73122,97.219281,3,0
0,0,11,11,11,16,27,40,36,76,0.000333,0.120457,10,3613.714502,200.761917,361.37145,102.053748,3,0
0,0,6,6,8,14,22,16,22,38,0.000333,0.056486,4,677.833606,37.657423,169.458402,77.302969,1,0
0,0,7,7,10,19,29,30,29,59,0.000333,0.09554,5,1433.104394,79.616911,286.620879,113.929904,3,0
0,0,12,12,8,16,24,29,45,74,0.000333,0.113096,8,2714.2978,150.794322,339.287225,88,1,0
0,0,12,12,10,20,30,41,50,91,0.000333,0.148842,10,4465.270442,248.07058,446.527044,119.657843,3,0
0,0,11,11,7,15,22,30,56,86,0.000333,0.127837,9,3451.600073,191.75556,383.511119,78.254843,1,0
0,0,12,12,9,20,29,44,63,107,0.000333,0.173268,12,6237.647598,346.535978,519.803966,114.967887,3,0
0,0,11,11,9,15,24,27,35,62,0.000333,0.094756,8,2274.1414,126.341189,284.267675,87.132684,1,0
0,0,11,11,11,19,30,39,40,79,0.000333,0.129215,10,3876.443571,215.357976,387.644357,118.764371,3,0
0,0,25,25,20,49,69,122,87,209,0.000333,0.425561,10,12766.81612,709.267562,1276.681611,361.559344,10,0
0,0,25,25,20,48,68,123,86,209,0.000333,0.424093,10,12722.79734,706.822074,1272.279734,354.516762,10,0
0,0,25,25,20,48,68,123,86,209,0.000333,0.424093,10,12722.79734,706.822074,1272.279734,354.516762,10,0
0,0,6,6,7,14,21,15,23,38,0.000333,0.055636,3,500.724186,27.81801,166.908062,72.954453,1,0
0,0,7,7,9,19,28,29,30,59,0.000333,0.094545,4,1134.535762,63.029765,283.63394,109.239948,3,0
0,0,23,23,18,49,67,117,84,201,0.000333,0.406428,9,10973.55535,609.641964,1219.283927,350.179432,10,0
0,0,23,23,19,48,67,118,83,201,0.000333,0.406428,9,10973.55535,609.641964,1219.283927,348.788823,10,0
0,0,23,23,19,48,67,118,83,201,0.000333,0.406428,9,10973.55535,609.641964,1219.283927,348.788823,10,0
0,0,23,23,18,49,67,117,84,201,0.000333,0.406428,9,10973.55535,609.641964,1219.283927,350.179432,10,0
0,0,23,23,19,48,67,118,83,201,0.000333,0.406428,9,10973.55535,609.641964,1219.283927,348.788823,10,0
0,0,23,23,19,48,67,118,83,201,0.000333,0.406428,9,10973.55535,609.641964,1219.283927,348.788823,10,0
0,0,23,23,18,49,67,117,85,202,0.000333,0.40845,9,11028.15015,612.675008,1225.350016,350.179432,10,0
0,0,23,23,19,48,67,118,84,202,0.000333,0.40845,9,11028.15015,612.675008,1225.350016,348.788823,10,0
0,0,23,23,19,48,67,118,84,202,0.000333,0.40845,9,11028.15015,612.675008,1225.350016,348.788823,10,0
0,0,23,23,18,50,68,117,85,202,0.000333,0.409889,9,11067.00745,614.833747,1229.667494,357.25146,10,0
0,0,23,23,19,49,68,118,84,202,0.000333,0.409889,9,11067.00745,614.833747,1229.667494,355.831405,10,0
0,0,23,23,19,49,68,118,84,202,0.000333,0.409889,9,11067.00745,614.833747,1229.667494,355.831405,10,0
0,0,23,23,18,49,67,117,84,201,0.000333,0.406428,9,10973.55535,609.641964,1219.283927,350.179432,10,0
0,0,23,23,19,48,67,118,83,201,0.000333,0.406428,9,10973.55535,609.641964,1219.283927,348.788823,10,0
0,0,23,23,19,48,67,118,83,201,0.000333,0.406428,9,10973.55535,609.641964,1219.283927,348.788823,10,0
0,0,25,25,20,50,70,126,88,214,0.000333,0.437222,10,13116.66566,728.703648,1311.666566,368.631371,10,0
0,0,25,25,19,49,68,121,87,208,0.000333,0.422064,9,11395.73044,633.096135,1266.192271,355.831405,10,0
0,0,36,36,19,53,72,170,131,301,0.000333,0.619049,18,33428.65366,1857.147425,1857.147425,384.290407,11,0
0,0,36,36,21,55,76,173,136,309,0.000333,0.643537,20,38612.19203,2145.12178,1930.609602,410.21345,11,0
0,0,34,34,19,52,71,164,121,285,0.000333,0.584226,18,31548.20272,1752.677929,1752.677929,377.133488,11,0
0,0,34,34,21,54,75,167,124,291,0.000333,0.604195,20,36251.72478,2013.98471,1812.586239,403.002591,11,0
0,0,20,20,18,45,63,104,75,179,0.000333,0.356644,9,9629.397957,534.966553,1069.933106,322.192039,8,0
0,0,20,20,18,45,63,104,74,178,0.000333,0.354652,9,9575.602437,531.977913,1063.955826,322.192039,8,0
0,0,17,17,17,42,59,100,71,171,0.000333,0.335311,8,8047.455692,447.080872,1005.931961,295.9642,7,0
0,0,17,17,17,43,60,100,73,173,0.000333,0.340631,8,8175.136584,454.174255,1021.892073,302.816253,7,0
0,0,22,22,20,47,67,113,89,202,0.000333,0.40845,10,12253.50017,680.750009,1225.350016,347.504238,7,0
0,0,22,22,21,48,69,114,95,209,0.000333,0.425561,10,12766.81612,709.267562,1276.681611,360.316866,7,0
0,0,19,19,18,44,62,101,73,174,0.000333,0.345343,9,9324.271422,518.015079,1036.030158,315.273641,7,0
0,0,20,20,18,44,62,104,74,178,0.000333,0.353282,9,9538.622489,529.923472,1059.846943,315.273641,8,0
0,0,11,11,9,17,26,29,40,69,0.000333,0.10811,8,2594.642724,144.146818,324.330341,98.016193,1,0
0,0,12,12,11,22,33,47,49,96,0.000333,0.161421,10,4842.618355,269.034353,484.261835,136.161243,3,0
0,0,11,11,9,16,25,27,39,66,0.000333,0.102165,8,2451.956068,136.219782,306.494509,92.529325,1,0
0,0,12,12,11,21,32,45,48,93,0.000333,0.155,10,4650,258.333333,465,130.292414,3,0
0,0,11,11,7,15,22,30,60,90,0.000333,0.133783,12,4816.186148,267.565897,401.348846,78.254843,1,0
0,0,12,12,9,20,29,44,67,111,0.000333,0.179745,12,6470.830686,359.490594,539.23589,114.967887,3,0
0,0,14,14,8,18,26,34,62,96,0.000333,0.150414,12,5414.906555,300.828142,451.242213,99.05865,1,0
0,0,15,15,10,23,33,52,71,123,0.000333,0.20682,15,9306.90715,517.050397,620.460477,137.261206,3,0
0,0,12,12,8,17,25,29,49,78,0.000333,0.12074,8,2897.766262,160.987015,362.220783,93.486868,1,0
0,0,13,13,10,22,32,47,58,105,0.000333,0.175,10,5250,291.666667,525,131.326777,3,0
0,0,10,10,8,16,24,24,36,60,0.000333,0.091699,8,2200.782,122.265667,275.09775,88,1,0
0,0,11,11,10,21,31,42,45,87,0.000333,0.143672,10,4310.15079,239.452822,431.015079,125.457947,3,0
0,0,6,6,8,14,22,16,23,39,0.000333,0.057973,4,695.671333,38.648407,173.917833,77.302969,1,0
0,0,7,7,10,19,29,30,30,60,0.000333,0.09716,5,1457.394299,80.96635,291.47886,113.929904,3,0
0,0,13,13,9,19,28,31,46,77,0.000333,0.123389,8,2961.330632,164.518368,370.166329,109.239948,1,0
0,0,14,14,11,23,34,45,53,98,0.000333,0.16619,10,4985.713584,276.984088,498.571358,142.095673,3,0
0,0,13,13,10,18,28,37,43,80,0.000333,0.128196,10,3845.883938,213.660219,384.588394,108.277931,1,0
0,0,14,14,12,23,35,51,50,101,0.000333,0.172686,12,6216.691017,345.371723,518.057585,147.061475,3,0
0,0,28,28,21,46,67,143,89,232,0.000333,0.469111,10,14073.32692,781.851496,1407.332692,346.322516,11,0
0,0,28,28,21,46,67,143,89,232,0.000333,0.469111,10,14073.32692,781.851496,1407.332692,346.322516,11,0
0,0,12,12,9,18,27,37,40,77,0.000333,0.122042,8,2929.010701,162.722817,366.126338,103.587975,1,0
0,0,13,13,11,22,33,51,47,98,0.000333,0.164784,10,4943.506237,274.639235,494.350624,136.161243,3,0
0,0,28,28,21,47,68,143,90,233,0.000333,0.472793,10,14183.78842,787.988246,1418.378842,353.304342,11,0
0,0,28,28,21,47,68,143,90,233,0.000333,0.472793,10,14183.78842,787.988246,1418.378842,353.304342,11,0
0,0,28,28,21,46,67,143,89,232,0.000333,0.469111,10,14073.32692,781.851496,1407.332692,346.322516,11,0
0,0,28,28,21,46,67,143,89,232,0.000333,0.469111,10,14073.32692,781.851496,1407.332692,346.322516,11,0
0,0,30,30,22,46,68,147,92,239,0.000333,0.484968,22,32007.87962,1778.215534,1454.903619,352.191346,11,0
0,0,30,30,22,46,68,147,92,239,0.000333,0.484968,22,32007.87962,1778.215534,1454.903619,352.191346,11,0
0,0,29,29,21,46,67,145,91,236,0.000333,0.477199,10,14315.97049,795.331694,1431.597049,346.322516,10,0
0,0,31,31,22,47,69,158,96,254,0.000333,0.517188,22,34134.43466,1896.357481,1551.565212,359.173172,12,0
0,0,29,29,22,45,67,146,90,236,0.000333,0.477199,22,31495.13508,1749.729726,1431.597049,345.240885,10,0
0,0,32,32,19,51,70,158,111,269,0.000333,0.549592,18,29677.98837,1648.777132,1648.777132,370.004315,11,0
0,0,32,32,21,53,74,161,112,273,0.000333,0.56506,20,33903.61538,1883.534188,1695.180769,395.81845,11,0
0,0,30,30,19,49,68,148,100,248,0.000333,0.50323,18,27174.43412,1509.690785,1509.690785,355.831405,11,0
0,0,30,30,20,51,71,149,100,249,0.000333,0.510429,10,15312.87033,850.715018,1531.287033,375.732254,11,0
0,0,30,30,19,49,68,149,98,247,0.000333,0.501201,18,27064.85979,1503.603322,1503.603322,355.831405,11,0
0,0,30,30,20,48,68,150,97,247,0.000333,0.501201,20,30072.06644,1670.670358,1503.603322,354.516762,11,0
0,0,32,32,21,50,71,162,108,270,0.000333,0.553477,20,33208.63445,1844.924136,1660.431722,374.431475,11,0
0,0,28,28,21,46,67,143,90,233,0.000333,0.471133,10,14133.98781,785.221545,1413.398781,346.322516,11,0
0,0,28,28,21,46,67,143,90,233,0.000333,0.471133,10,14133.98781,785.221545,1413.398781,346.322516,11,0
0,0,28,28,21,46,67,143,89,232,0.000333,0.469111,10,14073.32692,781.851496,1407.332692,346.322516,11,0
0,0,28,28,21,46,67,143,89,232,0.000333,0.469111,10,14073.32692,781.851496,1407.332692,346.322516,11,0
0,0,28,28,21,47,68,143,90,233,0.000333,0.472793,10,14183.78842,787.988246,1418.378842,353.304342,11,0
0,0,28,28,21,47,68,143,90,233,0.000333,0.472793,10,14183.78842,787.988246,1418.378842,353.304342,11,0
0,0,30,30,22,46,68,148,92,240,0.000333,0.486997,22,32141.8038,1785.655767,1460.991082,352.191346,11,0
0,0,30,30,22,46,68,148,92,240,0.000333,0.486997,22,32141.8038,1785.655767,1460.991082,352.191346,11,0
0,0,32,32,20,49,69,156,108,264,0.000333,0.53755,20,32253.00913,1791.833841,1612.650457,361.559344,11,0
0,0,32,32,21,51,72,157,109,266,0.000333,0.547067,20,32824.00101,1823.555612,1641.20005,381.532358,11,0
0,0,38,38,19,54,73,176,141,317,0.000333,0.654058,18,35319.13893,1962.174385,1962.174385,391.474548,11,0
0,0,38,38,21,56,77,179,148,327,0.000333,0.68308,20,40984.78398,2276.932443,2049.239199,417.450542,11,0
0,0,24,24,19,49,68,123,90,213,0.000333,0.43221,9,11669.66627,648.314793,1296.629585,355.831405,9,0
0,0,24,24,19,48,67,124,91,215,0.000333,0.434736,9,11737.88258,652.104588,1304.209176,348.788823,9,0
0,0,22,22,18,48,66,114,83,197,0.000333,0.396915,9,10716.71077,595.372821,1190.745642,343.13685,9,0
0,0,22,22,18,48,66,114,83,197,0.000333,0.396915,9,10716.71077,595.372821,1190.745642,343.13685,9,0
0,0,9,9,10,18,28,36,35,71,0.000333,0.113774,5,1706.610997,94.811722,341.322199,108.277931,3,0
0,0,11,11,10,19,29,42,37,79,0.000333,0.127927,5,1918.902493,106.605694,383.780499,113.929904,5,0
0,0,11,11,10,19,29,42,37,79,0.000333,0.127927,5,1918.902493,106.605694,383.780499,113.929904,5,0
0,0,22,22,18,48,66,114,83,197,0.000333,0.396915,9,10716.71077,595.372821,1190.745642,343.13685,9,0
0,0,22,22,18,48,66,114,83,197,0.000333,0.396915,9,10716.71077,595.372821,1190.745642,343.13685,9,0
0,0,5,5,7,11,18,15,19,34,0.000333,0.047259,3,425.33235,23.629575,141.77745,57.705232,1,0
0,0,6,6,9,16,25,29,26,55,0.000333,0.085137,4,1021.648362,56.758242,255.41209,92.529325,3,0
0,0,14,14,8,17,25,34,57,91,0.000333,0.140864,12,5071.090959,281.727276,422.590913,93.486868,1,0
0,0,31,31,20,54,74,134,123,257,0.000333,0.531943,20,31916.5903,1773.143906,1595.829515,397.202487,9,0
0,0,12,12,8,16,24,29,45,74,0.000333,0.113096,8,2714.2978,150.794322,339.287225,88,1,0
0,0,29,29,20,53,73,129,111,240,0.000333,0.495186,20,29711.15788,1650.619882,1485.557894,390.018346,9,0
0,0,11,11,9,15,24,27,35,62,0.000333,0.094756,8,2274.1414,126.341189,284.267675,87.132684,1,0
0,0,28,28,21,52,73,127,101,228,0.000333,0.470427,10,14112.79999,784.044444,1411.279999,388.661531,9,0
0,0,11,11,7,14,21,30,55,85,0.000333,0.124449,9,3360.122828,186.67349,373.346981,72.954453,1,0
0,0,12,12,9,19,28,44,62,106,0.000333,0.16986,12,6114.955461,339.719748,509.579622,109.239948,3,0
0,0,13,13,9,18,27,31,46,77,0.000333,0.122042,8,2929.010701,162.722817,366.126338,103.587975,1,0
0,0,30,30,20,55,75,131,112,243,0.000333,0.504534,20,30272.05884,1681.781046,1513.602942,404.413346,9,0
0,0,13,13,10,17,27,37,43,80,0.000333,0.126797,10,3803.910002,211.328333,380.391,102.706149,1,0
0,0,30,30,20,54,74,137,109,246,0.000333,0.509175,20,30550.51056,1697.250587,1527.525528,397.202487,9,0
0,0,11,11,9,17,26,26,32,58,0.000333,0.090875,4,1090.502015,60.583445,272.625504,98.016193,1,0
0,0,12,12,11,21,32,40,39,79,0.000333,0.131667,5,1975,109.722222,395,130.292414,3,0
0,0,12,12,10,17,27,42,41,83,0.000333,0.131552,10,3946.556627,219.253146,394.655663,102.706149,4,0
0,0,12,12,10,17,27,42,41,83,0.000333,0.131552,10,3946.556627,219.253146,394.655663,102.706149,4,0
0,0,12,12,10,20,30,41,47,88,0.000333,0.143935,10,4318.063724,239.892429,431.806372,119.657843,4,0
0,0,12,12,10,20,30,41,47,88,0.000333,0.143935,10,4318.063724,239.892429,431.806372,119.657843,4,0
0,0,11,11,9,16,25,27,37,64,0.000333,0.099069,8,2377.654369,132.091909,297.206796,92.529325,2,0
0,0,10,10,8,12,20,23,27,50,0.000333,0.072032,8,1728.771238,96.042847,216.096405,67.01955,1,0
0,0,11,11,10,16,26,37,34,71,0.000333,0.111244,10,3337.3122,185.406233,333.73122,97.219281,3,0
0,0,10,10,9,12,21,26,27,53,0.000333,0.077598,8,1862.342587,103.463477,232.792823,71.548875,1,0
0,0,11,11,11,16,27,40,34,74,0.000333,0.117287,10,3518.616752,195.478708,351.861675,102.053748,3,0
0,0,11,11,11,17,28,39,30,69,0.000333,0.110569,5,1658.537448,92.140969,331.70749,107.540616,5,0
0,0,11,11,11,17,28,39,30,69,0.000333,0.110569,5,1658.537448,92.140969,331.70749,107.540616,5,0
0,0,11,11,11,16,27,39,30,69,0.000333,0.109362,5,1640.436188,91.135344,328.087238,102.053748,5,0
0,0,12,12,13,18,31,51,41,92,0.000333,0.151929,12,5469.432727,303.857374,455.786061,123.164366,5,0
0,0,9,9,10,15,25,33,28,61,0.000333,0.094425,5,1416.376138,78.687563,283.275228,91.82264,3,0
0,0,11,11,9,16,25,27,35,62,0.000333,0.095973,8,2303.35267,127.964037,287.919084,92.529325,1,0
0,0,12,12,11,20,31,41,42,83,0.000333,0.137066,10,4111.982938,228.443497,411.198294,124.49231,3,0
0,0,18,18,16,44,60,98,70,168,0.000333,0.330786,8,7938.86096,441.047831,992.35762,304.214991,7,0
0,0,18,18,17,42,59,99,68,167,0.000333,0.327467,8,7859.211114,436.62284,982.401389,295.9642,7,0
0,0,19,19,18,45,63,101,74,175,0.000333,0.348675,9,9414.21588,523.011993,1046.023987,322.192039,7,0
0,0,19,19,18,45,63,101,74,175,0.000333,0.348675,9,9414.21588,523.011993,1046.023987,322.192039,7,0
0,0,19,19,19,43,62,102,72,174,0.000333,0.345343,9,9324.271422,518.015079,1036.030158,314.040007,7,0
0,0,19,19,18,45,63,101,74,175,0.000333,0.348675,9,9414.21588,523.011993,1046.023987,322.192039,7,0
0,0,19,19,19,43,62,102,72,174,0.000333,0.345343,9,9324.271422,518.015079,1036.030158,314.040007,7,0
0,0,21,21,19,46,65,110,81,191,0.000333,0.383424,9,10352.45027,575.136126,1150.272252,334.794473,7,0
0,0,21,21,19,44,63,111,81,192,0.000333,0.382546,9,10328.73971,573.818873,1147.637745,320.925614,7,0
0,0,19,19,18,45,63,101,74,175,0.000333,0.348675,9,9414.21588,523.011993,1046.023987,322.192039,7,0
0,0,19,19,19,43,62,102,72,174,0.000333,0.345343,9,9324.271422,518.015079,1036.030158,314.040007,7,0
0,0,19,19,18,45,63,101,74,175,0.000333,0.348675,9,9414.21588,523.011993,1046.023987,322.192039,7,0
0,0,19,19,18,45,63,101,74,175,0.000333,0.348675,9,9414.21588,523.011993,1046.023987,322.192039,7,0
0,0,14,14,8,17,25,34,57,91,0.000333,0.140864,12,5071.090959,281.727276,422.590913,93.486868,1,0
0,0,14,14,10,21,31,46,62,108,0.000333,0.178351,10,5350.532015,297.251779,535.053202,125.457947,3,0
0,0,22,22,20,48,68,113,93,206,0.000333,0.418006,10,12540.17345,696.676303,1254.017345,354.516762,7,0
0,0,22,22,21,49,70,114,99,213,0.000333,0.435179,20,26110.74565,1450.596981,1305.537283,367.359448,7,0
0,0,17,17,17,43,60,100,73,173,0.000333,0.340631,8,8175.136584,454.174255,1021.892073,302.816253,7,0
0,0,17,17,17,44,61,100,75,175,0.000333,0.34596,8,8303.032273,461.279571,1037.879034,309.70186,7,0
0,0,21,21,16,47,63,111,79,190,0.000333,0.378561,8,9085.465484,504.748082,1135.683185,325.065676,9,0
0,0,21,21,17,46,63,112,78,190,0.000333,0.378561,8,9085.465484,504.748082,1135.683185,323.570718,9,0
0,0,22,22,18,48,66,114,83,197,0.000333,0.396915,9,10716.71077,595.372821,1190.745642,343.13685,9,0
0,0,22,22,18,48,66,114,83,197,0.000333,0.396915,9,10716.71077,595.372821,1190.745642,343.13685,9,0
0,0,24,24,18,49,67,122,94,216,0.000333,0.436758,9,11792.47739,655.137633,1310.275265,350.179432,9,0
0,0,24,24,19,51,70,123,95,218,0.000333,0.445395,9,12025.65328,668.091849,1336.183698,370.004315,9,0
0,0,22,22,18,48,66,114,83,197,0.000333,0.396915,9,10716.71077,595.372821,1190.745642,343.13685,9,0
0,0,19,19,18,44,62,101,73,174,0.000333,0.345343,9,9324.271422,518.015079,1036.030158,315.273641,7,0
0,0,19,19,19,43,62,102,72,174,0.000333,0.345343,9,9324.271422,518.015079,1036.030158,314.040007,7,0
0,0,20,20,18,44,62,104,74,178,0.000333,0.353282,9,9538.622489,529.923472,1059.846943,315.273641,8,0
0,0,20,20,19,43,62,105,73,178,0.000333,0.353282,9,9538.622489,529.923472,1059.846943,314.040007,8,0
0,0,20,20,19,43,62,105,73,178,0.000333,0.353282,9,9538.622489,529.923472,1059.846943,314.040007,8,0
0,0,17,17,17,42,59,100,71,171,0.000333,0.335311,8,8047.455692,447.080872,1005.931961,295.9642,7,0
0,0,17,17,17,43,60,100,73,173,0.000333,0.340631,8,8175.136584,454.174255,1021.892073,302.816253,7,0
0,0,6,6,7,13,20,15,23,38,0.000333,0.054744,3,492.699803,27.372211,164.233268,67.757201,1,0
0,0,7,7,9,18,27,29,30,59,0.000333,0.093513,4,1122.153451,62.341858,280.538363,103.587975,3,0
0,0,22,22,18,48,66,114,83,197,0.000333,0.396915,9,10716.71077,595.372821,1190.745642,343.13685,9,0
0,0,22,22,19,47,66,115,82,197,0.000333,0.396915,9,10716.71077,595.372821,1190.745642,341.776299,9,0
0,0,22,22,18,48,66,114,83,197,0.000333,0.396915,9,10716.71077,595.372821,1190.745642,343.13685,9,0
0,0,22,22,19,47,66,115,82,197,0.000333,0.396915,9,10716.71077,595.372821,1190.745642,341.776299,9,0
0,0,11,11,10,17,27,39,30,69,0.000333,0.109362,5,1640.436188,91.135344,328.087238,102.706149,5,0
0,0,11,11,10,16,26,39,30,69,0.000333,0.10811,5,1621.651703,90.091761,324.330341,97.219281,5,0
0,0,11,11,10,17,27,39,30,69,0.000333,0.109362,5,1640.436188,91.135344,328.087238,102.706149,5,0
0,0,11,11,10,16,26,39,30,69,0.000333,0.10811,5,1621.651703,90.091761,324.330341,97.219281,5,0
0,0,9,9,10,15,25,33,28,61,0.000333,0.094425,5,1416.376138,78.687563,283.275228,91.82264,3,0
0,0,15,15,11,20,31,49,36,85,0.000333,0.140369,5,2105.533432,116.97408,421.106686,124.49231,5,0
0,0,15,15,11,18,29,49,36,85,0.000333,0.137643,10,4129.283846,229.404658,412.928385,113.112398,5,0
0,0,11,11,10,17,27,39,30,69,0.000333,0.109362,5,1640.436188,91.135344,328.087238,102.706149,5,0
0,0,11,11,10,16,26,39,30,69,0.000333,0.10811,5,1621.651703,90.091761,324.330341,97.219281,5,0
0,0,11,11,10,17,27,39,30,69,0.000333,0.109362,5,1640.436188,91.135344,328.087238,102.706149,5,0
0,0,11,11,10,16,26,39,30,69,0.000333,0.10811,5,1621.651703,90.091761,324.330341,97.219281,5,0
0,0,12,12,11,17,28,42,42,84,0.000333,0.134606,10,4038.178135,224.34323,403.817813,107.540616,3,0
0,0,11,11,10,17,27,39,39,78,0.000333,0.123627,10,3708.812252,206.045125,370.881225,102.706149,3,0
0,0,11,11,11,17,28,40,38,78,0.000333,0.124991,10,3749.736839,208.318713,374.973684,107.540616,3,0
0,0,11,11,10,17,27,37,38,75,0.000333,0.118872,10,3566.165627,198.120313,356.616563,102.706149,3,0
0,0,11,11,9,18,27,26,35,61,0.000333,0.096683,4,1160.192551,64.455142,290.048138,103.587975,1,0
0,0,12,12,11,22,33,40,42,82,0.000333,0.13788,5,2068.201589,114.900088,413.640318,136.161243,3,0
0,0,22,22,18,48,66,114,83,197,0.000333,0.396915,9,10716.71077,595.372821,1190.745642,343.13685,9,0
0,0,22,22,19,47,66,115,82,197,0.000333,0.396915,9,10716.71077,595.372821,1190.745642,341.776299,9,0
0,0,22,22,18,48,66,114,83,197,0.000333,0.396915,9,10716.71077,595.372821,1190.745642,343.13685,9,0
0,0,22,22,19,47,66,115,82,197,0.000333,0.396915,9,10716.71077,595.372821,1190.745642,341.776299,9,0
0,0,24,24,18,49,67,123,89,212,0.000333,0.42867,9,11574.09818,643.005454,1286.010908,350.179432,9,0
0,0,24,24,19,48,67,124,88,212,0.000333,0.42867,9,11574.09818,643.005454,1286.010908,348.788823,9,0
0,0,22,22,18,48,66,114,83,197,0.000333,0.396915,9,10716.71077,595.372821,1190.745642,343.13685,9,0
0,0,22,22,19,47,66,115,82,197,0.000333,0.396915,9,10716.71077,595.372821,1190.745642,341.776299,9,0
0,0,22,22,19,47,66,115,82,197,0.000333,0.396915,9,10716.71077,595.372821,1190.745642,341.776299,9,0
0,0,22,22,18,48,66,114,83,197,0.000333,0.396915,9,10716.71077,595.372821,1190.745642,343.13685,9,0
0,0,24,24,21,50,71,124,91,215,0.000333,0.440732,10,13221.95631,734.553128,1322.195631,374.431475,10,0
0,0,24,24,22,49,71,125,90,215,0.000333,0.440732,11,14544.15194,808.008441,1322.195631,373.228278,10,0
0,0,22,22,18,48,66,114,83,197,0.000333,0.396915,9,10716.71077,595.372821,1190.745642,343.13685,9,0
0,0,22,22,19,47,66,115,82,197,0.000333,0.396915,9,10716.71077,595.372821,1190.745642,341.776299,9,0
0,0,23,23,19,49,68,117,84,201,0.000333,0.40786,9,11012.22028,611.790016,1223.580031,355.831405,10,0
0,0,23,23,20,48,68,118,83,201,0.000333,0.40786,10,12235.80031,679.766684,1223.580031,354.516762,10,0
0,0,23,23,20,48,68,118,83,201,0.000333,0.40786,10,12235.80031,679.766684,1223.580031,354.516762,10,0
0,0,19,19,18,44,62,101,73,174,0.000333,0.345343,9,9324.271422,518.015079,1036.030158,315.273641,7,0
0,0,21,21,21,46,67,111,81,192,0.000333,0.38823,10,11646.89125,647.049514,1164.689125,346.322516,8,0
0,0,20,20,18,44,62,104,74,178,0.000333,0.353282,9,9538.622489,529.923472,1059.846943,315.273641,8,0
0,0,20,20,19,45,64,104,74,178,0.000333,0.356,9,9612,534,1068,327.844012,8,0
0,0,21,21,18,45,63,110,79,189,0.000333,0.376569,9,10167.35315,564.852953,1129.705906,322.192039,7,0
0,0,19,19,18,44,62,101,73,174,0.000333,0.345343,9,9324.271422,518.015079,1036.030158,315.273641,7,0
0,0,19,19,18,44,62,101,73,174,0.000333,0.345343,9,9324.271422,518.015079,1036.030158,315.273641,7,0
0,0,12,12,8,17,25,29,49,78,0.000333,0.12074,8,2897.766262,160.987015,362.220783,93.486868,1,0
0,0,13,13,10,21,31,43,56,99,0.000333,0.163488,10,4904.654347,272.480797,490.465435,125.457947,3,0
0,0,14,14,8,18,26,34,62,96,0.000333,0.150414,12,5414.906555,300.828142,451.242213,99.05865,1,0
0,0,15,15,10,22,32,48,69,117,0.000333,0.195,15,8775,487.5,585,131.326777,3,0
0,0,11,11,7,15,22,30,60,90,0.000333,0.133783,12,4816.186148,267.565897,401.348846,78.254843,1,0
0,0,12,12,9,20,29,44,67,111,0.000333,0.179745,12,6470.830686,359.490594,539.23589,114.967887,3,0
0,0,12,12,9,18,27,37,45,82,0.000333,0.129967,8,3119.206201,173.289233,389.900775,103.587975,1,0
0,0,13,13,11,22,33,51,52,103,0.000333,0.173191,10,5195.725943,288.651441,519.572594,136.161243,3,0
0,0,5,5,7,12,19,15,21,36,0.000333,0.050975,3,458.776171,25.487565,152.92539,62.671034,1,0
0,0,6,6,9,17,26,29,28,57,0.000333,0.089308,4,1071.700256,59.538903,267.925064,98.016193,3,0
0,0,6,6,11,17,28,29,28,57,0.000333,0.09134,5,1370.096153,76.116453,274.019231,107.540616,3,0
0,0,5,5,9,12,21,15,21,36,0.000333,0.052708,4,632.493709,35.138539,158.123427,71.548875,1,0
0,0,14,14,14,22,36,51,66,117,0.000333,0.201627,21,12702.50573,705.694763,604.881225,151.410465,3,0
0,0,13,13,12,17,29,33,57,90,0.000333,0.145739,18,7869.929212,437.21829,437.21829,112.506418,1,0
0,0,19,19,18,44,62,101,73,174,0.000333,0.345343,9,9324.271422,518.015079,1036.030158,315.273641,7,0
0,0,19,19,18,44,62,101,73,174,0.000333,0.345343,9,9324.271422,518.015079,1036.030158,315.273641,7,0
0,0,19,19,19,43,62,102,72,174,0.000333,0.345343,9,9324.271422,518.015079,1036.030158,314.040007,7,0
0,0,21,21,18,45,63,110,79,189,0.000333,0.376569,9,10167.35315,564.852953,1129.705906,322.192039,7,0
0,0,19,19,18,44,62,101,73,174,0.000333,0.345343,9,9324.271422,518.015079,1036.030158,315.273641,7,0
0,0,33,33,22,51,73,164,110,274,0.000333,0.565337,22,37312.26244,2072.903469,1696.011929,387.401188,12,0
0,0,33,33,22,51,73,164,110,274,0.000333,0.565337,22,37312.26244,2072.903469,1696.011929,387.401188,12,0
0,0,33,33,21,50,71,164,108,272,0.000333,0.557577,20,33454.62433,1858.590241,1672.731217,374.431475,12,0
0,0,33,33,21,52,73,164,111,275,0.000333,0.567401,20,34044.03507,1891.335282,1702.201754,388.661531,12,0
0,0,33,33,21,52,73,164,111,275,0.000333,0.567401,20,34044.03507,1891.335282,1702.201754,388.661531,12,0
0,0,33,33,21,52,73,164,111,275,0.000333,0.567401,20,34044.03507,1891.335282,1702.201754,388.661531,12,0
0,0,33,33,21,52,73,164,111,275,0.000333,0.567401,20,34044.03507,1891.335282,1702.201754,388.661531,12,0
0,0,35,35,22,51,73,168,113,281,0.000333,0.57978,22,38265.49542,2125.860857,1739.340701,387.401188,12,0
0,0,35,35,22,51,73,168,113,281,0.000333,0.57978,22,38265.49542,2125.860857,1739.340701,387.401188,12,0
0,0,32,32,21,50,71,158,101,259,0.000333,0.530928,20,31855.69008,1769.76056,1592.784504,374.431475,12,0
0,0,38,38,23,52,75,187,124,311,0.000333,0.645721,22,42617.57748,2367.643193,1937.162613,400.46479,12,0
0,0,32,32,22,49,71,159,100,259,0.000333,0.530928,22,35041.25909,1946.736616,1592.784504,373.228278,12,0
0,0,33,33,21,51,72,164,110,274,0.000333,0.56352,20,33811.18901,1878.399389,1690.55945,381.532358,12,0
0,0,33,33,21,51,72,164,110,274,0.000333,0.56352,20,33811.18901,1878.399389,1690.55945,381.532358,12,0
0,0,33,33,21,51,72,164,110,274,0.000333,0.56352,20,33811.18901,1878.399389,1690.55945,381.532358,12,0
0,0,33,33,21,51,72,164,110,274,0.000333,0.56352,20,33811.18901,1878.399389,1690.55945,381.532358,12,0
0,0,11,11,10,18,28,39,32,71,0.000333,0.113774,5,1706.610997,94.811722,341.322199,108.277931,5,0
0,0,11,11,10,17,27,39,32,71,0.000333,0.112532,5,1687.985063,93.776948,337.597013,102.706149,5,0
0,0,11,11,11,17,28,40,34,74,0.000333,0.118581,10,3557.442642,197.635702,355.744264,107.540616,5,0
0,0,11,11,10,17,27,39,34,73,0.000333,0.115702,10,3471.067877,192.837104,347.106788,102.706149,5,0
0,0,11,11,10,17,27,39,32,71,0.000333,0.112532,5,1687.985063,93.776948,337.597013,102.706149,5,0
0,0,11,11,10,17,27,39,32,71,0.000333,0.112532,5,1687.985063,93.776948,337.597013,102.706149,5,0
0,0,9,9,10,16,26,33,30,63,0.000333,0.098709,5,1480.638511,82.257695,296.127702,97.219281,3,0
0,0,15,15,11,19,30,49,38,87,0.000333,0.1423,10,4268.994818,237.166379,426.899482,118.764371,5,0
0,0,15,15,11,18,29,49,38,87,0.000333,0.140881,10,4226.443466,234.802415,422.644347,113.112398,5,0
0,0,14,14,10,15,25,35,31,66,0.000333,0.102165,10,3064.945085,170.274727,306.494509,91.82264,3,0
0,0,14,14,10,14,24,35,31,66,0.000333,0.100869,10,3026.07525,168.115292,302.607525,86.52225,3,0
0,0,11,11,11,18,29,40,34,74,0.000333,0.11983,5,1797.452968,99.858498,359.490594,113.112398,5,0
0,0,11,11,10,18,28,39,34,73,0.000333,0.116979,5,1754.684547,97.482475,350.936909,108.277931,5,0
0,0,10,10,10,14,24,26,27,53,0.000333,0.081001,5,1215.015063,67.500837,243.003013,86.52225,3,0
0,0,10,10,9,14,23,25,27,52,0.000333,0.078408,4,940.900887,52.272271,235.225222,81.832294,3,0
0,0,11,11,11,18,29,40,34,74,0.000333,0.11983,5,1797.452968,99.858498,359.490594,113.112398,5,0
0,0,11,11,10,18,28,39,34,73,0.000333,0.116979,5,1754.684547,97.482475,350.936909,108.277931,5,0
0,0,6,6,7,13,20,15,23,38,0.000333,0.054744,3,492.699803,27.372211,164.233268,67.757201,1,0
0,0,7,7,9,18,27,29,30,59,0.000333,0.093513,4,1122.153451,62.341858,280.538363,103.587975,3,0
0,0,22,22,18,48,66,114,83,197,0.000333,0.396915,9,10716.71077,595.372821,1190.745642,343.13685,9,0
0,0,22,22,19,47,66,115,82,197,0.000333,0.396915,9,10716.71077,595.372821,1190.745642,341.776299,9,0
0,0,22,22,19,47,66,115,82,197,0.000333,0.396915,9,10716.71077,595.372821,1190.745642,341.776299,9,0
0,0,19,19,18,44,62,101,73,174,0.000333,0.345343,9,9324.271422,518.015079,1036.030158,315.273641,7,0
0,0,20,20,19,45,64,104,74,178,0.000333,0.356,9,9612,534,1068,327.844012,8,0
0,0,11,11,9,16,25,29,36,65,0.000333,0.100617,8,2414.805219,134.155845,301.850652,92.529325,1,0
0,0,11,11,11,20,31,41,41,82,0.000333,0.135415,10,4062.440975,225.691165,406.244097,124.49231,3,0
0,0,20,20,18,46,64,104,75,179,0.000333,0.358,9,9666,537,1074,329.1425,8,0
0,0,13,13,10,17,27,37,43,80,0.000333,0.126797,10,3803.910002,211.328333,380.391,102.706149,1,0
0,0,13,13,12,22,34,49,48,97,0.000333,0.164495,12,5921.806747,328.989264,493.483896,141.127046,3,0
0,0,13,13,9,18,27,31,46,77,0.000333,0.122042,8,2929.010701,162.722817,366.126338,103.587975,1,0
0,0,13,13,11,22,33,43,51,94,0.000333,0.158058,10,4741.730472,263.429471,474.173047,136.161243,3,0
0,0,30,30,19,49,68,148,100,248,0.000333,0.50323,18,27174.43412,1509.690785,1509.690785,355.831405,11,0
0,0,30,30,20,51,71,149,100,249,0.000333,0.510429,10,15312.87033,850.715018,1531.287033,375.732254,11,0
0,0,12,12,13,22,35,45,47,92,0.000333,0.157298,12,5662.728451,314.596025,471.894038,146.213212,3,0
0,0,11,11,11,17,28,29,40,69,0.000333,0.110569,10,3317.074896,184.281939,331.70749,107.540616,1,0
0,0,27,27,20,47,67,144,95,239,0.000333,0.483265,20,28995.90633,1610.883685,1449.795317,347.504238,11,0
0,0,27,27,20,48,68,144,97,241,0.000333,0.489026,20,29341.5709,1630.087272,1467.078545,354.516762,11,0
0,0,32,32,21,51,72,158,112,270,0.000333,0.555293,20,33317.59501,1850.9775,1665.87975,381.532358,11,0
0,0,32,32,22,52,74,159,118,277,0.000333,0.57334,22,37840.40881,2102.244934,1720.018582,394.530361,11,0
0,0,30,30,21,48,69,152,97,249,0.000333,0.507008,20,30420.4518,1690.0251,1521.02259,360.316866,11,0
0,0,14,14,14,21,35,49,61,110,0.000333,0.188074,14,7899.095846,438.838658,564.221132,145.541635,3,0
0,0,13,13,12,16,28,33,54,87,0.000333,0.139413,18,7528.317808,418.239878,418.239878,107.01955,1,0
0,0,22,22,18,48,66,114,83,197,0.000333,0.396915,9,10716.71077,595.372821,1190.745642,343.13685,9,0
0,0,22,22,19,47,66,115,82,197,0.000333,0.396915,9,10716.71077,595.372821,1190.745642,341.776299,9,0
0,0,22,22,19,47,66,115,82,197,0.000333,0.396915,9,10716.71077,595.372821,1190.745642,341.776299,9,0
0,0,23,23,18,48,66,117,84,201,0.000333,0.404974,9,10934.30896,607.461609,1214.923218,343.13685,10,0
0,0,23,23,19,47,66,118,83,201,0.000333,0.404974,9,10934.30896,607.461609,1214.923218,341.776299,10,0
0,0,6,6,11,17,28,31,27,58,0.000333,0.092942,5,1394.132927,77.451829,278.826585,107.540616,3,0
0,0,5,5,9,12,21,17,20,37,0.000333,0.054172,4,650.062979,36.11461,162.515745,71.548875,1,0
0,0,11,11,13,21,34,41,45,86,0.000333,0.145841,12,5250.261652,291.681203,437.521804,140.344382,3,0
0,0,11,11,11,17,28,29,40,69,0.000333,0.110569,10,3317.074896,184.281939,331.70749,107.540616,1,0
0,0,6,6,11,16,27,29,27,56,0.000333,0.088758,5,1331.368501,73.964917,266.2737,102.053748,3,0
0,0,5,5,9,11,20,15,20,35,0.000333,0.050422,4,605.069933,33.614996,151.267483,66.583073,1,0
0,0,14,14,15,22,37,52,62,114,0.000333,0.197959,14,8314.287572,461.904865,593.877684,156.710855,3,0
0,0,13,13,12,16,28,33,54,87,0.000333,0.139413,18,7528.317808,418.239878,418.239878,107.01955,1,0
0,0,37,37,21,55,76,185,126,311,0.000333,0.647702,20,38862.10913,2159.006063,1943.105457,410.21345,11,0
0,0,36,36,21,56,77,182,126,308,0.000333,0.64339,20,38603.40509,2144.633616,1930.170255,417.450542,11,0
0,0,30,30,19,49,68,150,99,249,0.000333,0.505259,18,27284.00845,1515.778247,1515.778247,355.831405,11,0
0,0,32,32,20,49,69,156,108,264,0.000333,0.53755,20,32253.00913,1791.833841,1612.650457,361.559344,11,0
0,0,32,32,21,51,72,157,109,266,0.000333,0.547067,20,32824.00101,1823.555612,1641.20005,381.532358,11,0
0,0,35,35,21,53,74,170,119,289,0.000333,0.598177,20,35890.64045,1993.92447,1794.532023,395.81845,11,0
0,0,34,34,21,54,75,167,119,286,0.000333,0.593814,20,35628.84291,1979.380162,1781.442145,403.002591,11,0
0,0,37,37,21,54,75,176,129,305,0.000333,0.633263,20,37995.79401,2110.877445,1899.789701,403.002591,11,0
0,0,36,36,21,55,76,173,131,304,0.000333,0.633123,20,37987.39928,2110.411071,1899.369964,410.21345,11,0
0,0,39,39,21,55,76,182,139,321,0.000333,0.668528,20,40111.69464,2228.42748,2005.584732,410.21345,11,0
0,0,38,38,21,56,77,179,143,322,0.000333,0.672635,20,40358.10532,2242.116962,2017.905266,417.450542,11,0
0,0,14,14,15,23,38,52,62,114,0.000333,0.199421,14,8375.692311,465.31624,598.263737,162.645284,3,0
0,0,13,13,12,17,29,33,54,87,0.000333,0.140881,18,7607.598238,422.644347,422.644347,112.506418,1,0
0,0,11,11,9,15,24,27,35,62,0.000333,0.094756,8,2274.1414,126.341189,284.267675,87.132684,1,0
0,0,11,11,11,19,30,39,40,79,0.000333,0.129215,10,3876.443571,215.357976,387.644357,118.764371,3,0
0,0,33,33,19,48,67,154,118,272,0.000333,0.549992,18,29699.57268,1649.97626,1649.97626,348.788823,9,0
0,0,33,33,21,50,71,157,123,280,0.000333,0.573976,20,34438.58387,1913.254659,1721.929193,374.431475,9,0
0,0,27,27,21,45,66,140,88,228,0.000333,0.459374,10,13781.21859,765.623255,1378.121859,339.372055,10,0
0,0,23,23,19,49,68,117,84,201,0.000333,0.40786,9,11012.22028,611.790016,1223.580031,355.831405,10,0
0,0,23,23,20,48,68,118,83,201,0.000333,0.40786,10,12235.80031,679.766684,1223.580031,354.516762,10,0
0,0,23,23,20,48,68,118,83,201,0.000333,0.40786,10,12235.80031,679.766684,1223.580031,354.516762,10,0
0,0,33,33,21,52,73,164,111,275,0.000333,0.567401,20,34044.03507,1891.335282,1702.201754,388.661531,12,0
0,0,33,33,21,52,73,164,111,275,0.000333,0.567401,20,34044.03507,1891.335282,1702.201754,388.661531,12,0
0,0,33,33,21,51,72,164,110,274,0.000333,0.56352,20,33811.18901,1878.399389,1690.55945,381.532358,12,0
0,0,33,33,21,51,72,164,110,274,0.000333,0.56352,20,33811.18901,1878.399389,1690.55945,381.532358,12,0
0,0,33,33,21,50,71,164,110,274,0.000333,0.561677,20,33700.61422,1872.256345,1685.030711,374.431475,12,0
0,0,33,33,21,50,71,164,110,274,0.000333,0.561677,20,33700.61422,1872.256345,1685.030711,374.431475,12,0
0,0,33,33,21,51,72,164,110,274,0.000333,0.56352,20,33811.18901,1878.399389,1690.55945,381.532358,12,0
0,0,33,33,21,51,72,164,110,274,0.000333,0.56352,20,33811.18901,1878.399389,1690.55945,381.532358,12,0
0,0,32,32,21,51,72,158,112,270,0.000333,0.555293,20,33317.59501,1850.9775,1665.87975,381.532358,11,0
0,0,32,32,22,52,74,159,118,277,0.000333,0.57334,22,37840.40881,2102.244934,1720.018582,394.530361,11,0
0,0,11,11,9,12,21,28,31,59,0.000333,0.086382,8,2073.173824,115.176324,259.146728,71.548875,1,0
0,0,12,12,11,16,27,42,38,80,0.000333,0.126797,10,3803.910002,211.328333,380.391,102.053748,3,0
0,0,10,10,8,12,20,25,29,54,0.000333,0.077795,8,1867.072937,103.726274,233.384117,67.01955,1,0
0,0,11,11,10,16,26,39,36,75,0.000333,0.117511,10,3525.329789,195.851655,352.532979,97.219281,3,0
0,0,10,10,9,12,21,26,27,53,0.000333,0.077598,8,1862.342587,103.463477,232.792823,71.548875,1,0
0,0,11,11,11,16,27,40,34,74,0.000333,0.117287,10,3518.616752,195.478708,351.861675,102.053748,3,0
0,0,11,11,9,17,26,26,32,58,0.000333,0.090875,4,1090.502015,60.583445,272.625504,98.016193,1,0
0,0,12,12,11,21,32,40,39,79,0.000333,0.131667,5,1975,109.722222,395,130.292414,3,0
0,0,25,25,19,49,68,121,87,208,0.000333,0.422064,9,11395.73044,633.096135,1266.192271,355.831405,10,0
0,0,25,25,20,48,68,122,86,208,0.000333,0.422064,10,12661.92271,703.440151,1266.192271,354.516762,10,0
0,0,25,25,20,48,68,122,86,208,0.000333,0.422064,10,12661.92271,703.440151,1266.192271,354.516762,10,0
0,0,23,23,18,50,68,117,85,202,0.000333,0.409889,9,11067.00745,614.833747,1229.667494,357.25146,10,0
0,0,23,23,19,49,68,118,84,202,0.000333,0.409889,9,11067.00745,614.833747,1229.667494,355.831405,10,0
0,0,23,23,19,49,68,118,84,202,0.000333,0.409889,9,11067.00745,614.833747,1229.667494,355.831405,10,0
0,0,23,23,18,50,68,117,85,202,0.000333,0.409889,9,11067.00745,614.833747,1229.667494,357.25146,10,0
0,0,23,23,19,49,68,118,84,202,0.000333,0.409889,9,11067.00745,614.833747,1229.667494,355.831405,10,0
0,0,23,23,19,49,68,118,84,202,0.000333,0.409889,9,11067.00745,614.833747,1229.667494,355.831405,10,0
0,0,10,10,8,15,23,24,33,57,0.000333,0.085948,8,2062.744252,114.596903,257.843031,82.603359,1,0
0,0,11,11,10,19,29,38,40,78,0.000333,0.126308,10,3789.225176,210.51251,378.922518,113.929904,3,0
0,0,6,6,8,14,22,16,22,38,0.000333,0.056486,4,677.833606,37.657423,169.458402,77.302969,1,0
0,0,7,7,10,19,29,30,29,59,0.000333,0.09554,5,1433.104394,79.616911,286.620879,113.929904,3,0
0,0,22,22,18,48,66,114,83,197,0.000333,0.396915,9,10716.71077,595.372821,1190.745642,343.13685,9,0
0,0,22,22,19,47,66,115,82,197,0.000333,0.396915,9,10716.71077,595.372821,1190.745642,341.776299,9,0
0,0,24,24,21,50,71,124,91,215,0.000333,0.440732,10,13221.95631,734.553128,1322.195631,374.431475,10,0
0,0,24,24,22,49,71,125,90,215,0.000333,0.440732,11,14544.15194,808.008441,1322.195631,373.228278,10,0
0,0,10,10,8,16,24,24,36,60,0.000333,0.091699,8,2200.782,122.265667,275.09775,88,1,0
0,0,11,11,10,20,30,38,43,81,0.000333,0.132486,10,3974.581382,220.810077,397.458138,119.657843,3,0
0,0,6,6,8,14,22,16,23,39,0.000333,0.057973,4,695.671333,38.648407,173.917833,77.302969,1,0
0,0,7,7,10,19,29,30,30,60,0.000333,0.09716,5,1457.394299,80.96635,291.47886,113.929904,3,0
0,0,11,11,11,17,28,40,40,80,0.000333,0.128196,10,3845.883938,213.660219,384.588394,107.540616,3,0
0,0,10,10,10,17,27,37,37,74,0.000333,0.117287,10,3518.616752,195.478708,351.861675,102.706149,3,0
0,0,5,5,8,10,18,16,19,35,0.000333,0.048649,4,583.7895,32.43275,145.947375,57.219281,1,0
0,0,6,6,10,15,25,30,26,56,0.000333,0.086685,5,1300.279733,72.237763,260.055947,91.82264,3,0
0,0,10,10,8,16,24,24,36,60,0.000333,0.091699,8,2200.782,122.265667,275.09775,88,1,0
0,0,10,10,10,20,30,36,41,77,0.000333,0.125944,10,3778.305759,209.905875,377.830576,119.657843,3,0
0,0,29,29,21,48,69,145,106,251,0.000333,0.51108,20,30664.79277,1703.599599,1533.239639,360.316866,9,0
0,0,29,29,22,49,71,146,112,258,0.000333,0.528878,22,34905.96465,1939.220258,1586.634757,373.228278,9,0
0,0,11,11,9,16,25,27,39,66,0.000333,0.102165,8,2451.956068,136.219782,306.494509,92.529325,1,0
0,0,11,11,11,20,31,39,44,83,0.000333,0.137066,10,4111.982938,228.443497,411.198294,124.49231,3,0
0,0,11,11,7,15,22,30,60,90,0.000333,0.133783,12,4816.186148,267.565897,401.348846,78.254843,1,0
0,0,12,12,9,20,29,44,67,111,0.000333,0.179745,12,6470.830686,359.490594,539.23589,114.967887,3,0
0,0,19,19,18,44,62,101,73,174,0.000333,0.345343,9,9324.271422,518.015079,1036.030158,315.273641,7,0
0,0,22,22,18,49,67,114,84,198,0.000333,0.400362,9,10809.77094,600.54283,1201.08566,350.179432,9,0
0,0,37,37,21,56,77,186,127,313,0.000333,0.653835,20,39230.08375,2179.449097,1961.504187,417.450542,12,0
0,0,36,36,21,56,77,182,126,308,0.000333,0.64339,20,38603.40509,2144.633616,1930.170255,417.450542,11,0
0,0,30,30,19,49,68,150,99,249,0.000333,0.505259,18,27284.00845,1515.778247,1515.778247,355.831405,11,0
0,0,30,30,20,48,68,150,97,247,0.000333,0.501201,20,30072.06644,1670.670358,1503.603322,354.516762,11,0
0,0,37,37,21,55,76,182,127,309,0.000333,0.643537,20,38612.19203,2145.12178,1930.609602,410.21345,12,0
0,0,36,36,21,55,76,178,126,304,0.000333,0.633123,20,37987.39928,2110.411071,1899.369964,410.21345,11,0
0,0,37,37,21,57,78,177,129,306,0.000333,0.641111,20,38466.66158,2137.036754,1923.333079,424.713397,12,0
0,0,36,36,21,57,78,173,128,301,0.000333,0.630635,20,37838.12136,2102.117853,1891.906068,424.713397,11,0
0,0,30,30,19,49,68,148,100,248,0.000333,0.50323,18,27174.43412,1509.690785,1509.690785,355.831405,11,0
0,0,30,30,20,51,71,149,100,249,0.000333,0.510429,10,15312.87033,850.715018,1531.287033,375.732254,11,0
0,0,13,13,10,17,27,37,43,80,0.000333,0.126797,10,3803.910002,211.328333,380.391,102.706149,1,0
0,0,14,14,12,23,35,55,51,106,0.000333,0.181235,12,6524.447998,362.469333,543.704,147.061475,3,0
0,0,22,22,20,47,67,113,89,202,0.000333,0.40845,10,12253.50017,680.750009,1225.350016,347.504238,7,0
0,0,22,22,21,48,69,114,95,209,0.000333,0.425561,10,12766.81612,709.267562,1276.681611,360.316866,7,0
0,0,22,22,18,48,66,114,83,197,0.000333,0.396915,9,10716.71077,595.372821,1190.745642,343.13685,9,0
0,0,31,31,19,50,69,151,110,261,0.000333,0.531442,18,28697.8479,1594.324883,1594.324883,362.903432,9,0
0,0,31,31,21,52,73,154,111,265,0.000333,0.546768,20,32806.07016,1822.559453,1640.303508,388.661531,9,0
0,0,31,31,19,49,68,160,108,268,0.000333,0.543813,18,29365.92075,1631.440041,1631.440041,355.831405,9,0
0,0,31,31,21,51,72,163,109,272,0.000333,0.559407,20,33564.39201,1864.688445,1678.2196,381.532358,9,0
0,0,9,9,11,17,28,35,28,63,0.000333,0.100954,5,1514.3168,84.128711,302.86336,107.540616,4,0
0,0,9,9,10,17,27,34,28,62,0.000333,0.098268,5,1474.015126,81.889729,294.803025,102.706149,4,0
0,0,11,11,11,18,29,39,30,69,0.000333,0.111734,5,1676.003443,93.111302,335.200689,113.112398,4,0
0,0,11,11,11,18,29,39,30,69,0.000333,0.111734,5,1676.003443,93.111302,335.200689,113.112398,4,0
0,0,11,11,11,18,29,38,30,68,0.000333,0.110114,5,1651.713538,91.761863,330.342708,113.112398,4,0
0,0,11,11,11,18,29,38,30,68,0.000333,0.110114,5,1651.713538,91.761863,330.342708,113.112398,4,0
0,0,15,15,10,20,30,56,39,95,0.000333,0.155385,5,2330.773033,129.487391,466.154607,119.657843,5,0
0,0,11,11,11,19,30,43,31,74,0.000333,0.121037,5,1815.54952,100.863862,363.109904,118.764371,4,0
0,0,11,11,11,19,30,43,31,74,0.000333,0.121037,5,1815.54952,100.863862,363.109904,118.764371,4,0
0,0,34,34,21,51,72,168,115,283,0.000333,0.58203,20,34921.77551,1940.098639,1746.088775,381.532358,11,0
0,0,10,10,8,12,20,25,29,54,0.000333,0.077795,8,1867.072937,103.726274,233.384117,67.01955,1,0
0,0,13,13,13,23,36,53,45,98,0.000333,0.168884,6,3039.915901,168.884217,506.65265,152.147641,4,0
0,0,13,13,10,20,30,36,53,89,0.000333,0.145571,10,4367.13263,242.618479,436.713263,119.657843,1,0
0,0,14,14,12,25,37,50,60,110,0.000333,0.191013,12,6876.478443,382.02658,573.03987,159.115955,3,0
0,0,23,23,19,49,68,117,84,201,0.000333,0.40786,9,11012.22028,611.790016,1223.580031,355.831405,10,0
0,0,32,32,21,50,71,161,107,268,0.000333,0.549377,20,32962.64456,1831.258031,1648.132228,374.431475,11,0
0,0,23,23,18,48,66,117,84,201,0.000333,0.404974,9,10934.30896,607.461609,1214.923218,343.13685,10,0
0,0,23,23,19,47,66,118,83,201,0.000333,0.404974,9,10934.30896,607.461609,1214.923218,341.776299,10,0
0,0,23,23,19,47,66,118,83,201,0.000333,0.404974,9,10934.30896,607.461609,1214.923218,341.776299,10,0
0,0,11,11,9,16,25,29,36,65,0.000333,0.100617,8,2414.805219,134.155845,301.850652,92.529325,1,0
0,0,12,12,11,21,32,45,43,88,0.000333,0.146667,10,4400,244.444444,440,130.292414,3,0
0,0,11,11,9,15,24,27,35,62,0.000333,0.094756,8,2274.1414,126.341189,284.267675,87.132684,1,0
0,0,12,12,11,20,31,43,42,85,0.000333,0.140369,10,4211.066864,233.948159,421.106686,124.49231,3,0
0,0,11,11,11,18,29,44,33,77,0.000333,0.124688,5,1870.322683,103.906816,374.064537,113.112398,5,0
0,0,11,11,10,18,28,43,33,76,0.000333,0.121786,5,1826.79487,101.488604,365.358974,108.277931,5,0
0,0,10,10,10,13,23,26,25,51,0.000333,0.076901,5,1153.508299,64.083794,230.70166,81.324997,3,0
0,0,10,10,9,13,22,25,25,50,0.000333,0.074324,4,891.886324,49.54924,222.971581,76.635041,3,0
0,0,11,11,11,18,29,44,33,77,0.000333,0.124688,5,1870.322683,103.906816,374.064537,113.112398,5,0
0,0,11,11,10,18,28,43,33,76,0.000333,0.121786,5,1826.79487,101.488604,365.358974,108.277931,5,0
0,0,10,10,10,13,23,26,25,51,0.000333,0.076901,5,1153.508299,64.083794,230.70166,81.324997,3,0
0,0,10,10,9,13,22,25,25,50,0.000333,0.074324,4,891.886324,49.54924,222.971581,76.635041,3,0
0,0,11,11,9,12,21,28,31,59,0.000333,0.086382,8,2073.173824,115.176324,259.146728,71.548875,1,0
0,0,14,14,14,23,37,56,47,103,0.000333,0.178858,14,7512.031753,417.335097,536.573697,157.344894,4,0
0,0,16,16,10,21,31,62,42,104,0.000333,0.171745,10,5152.364163,286.242453,515.236416,125.457947,5,0
0,0,16,16,11,20,31,67,42,109,0.000333,0.180002,10,5400.073978,300.00411,540.007398,124.49231,5,0
0,0,16,16,11,20,31,67,42,109,0.000333,0.180002,10,5400.073978,300.00411,540.007398,124.49231,5,0
0,0,15,15,10,14,24,45,33,78,0.000333,0.119209,10,3576.270751,198.681708,357.627075,86.52225,3,0
0,0,15,15,10,14,24,45,33,78,0.000333,0.119209,10,3576.270751,198.681708,357.627075,86.52225,3,0
0,0,11,11,10,18,28,43,31,74,0.000333,0.118581,5,1778.721321,98.817851,355.744264,108.277931,5,0
0,0,11,11,10,17,27,43,31,74,0.000333,0.117287,5,1759.308376,97.739354,351.861675,102.706149,5,0
0,0,11,11,10,18,28,43,31,74,0.000333,0.118581,5,1778.721321,98.817851,355.744264,108.277931,5,0
0,0,11,11,10,17,27,43,31,74,0.000333,0.117287,5,1759.308376,97.739354,351.861675,102.706149,5,0
0,0,11,11,11,18,29,44,33,77,0.000333,0.124688,5,1870.322683,103.906816,374.064537,113.112398,5,0
0,0,11,11,10,18,28,43,33,76,0.000333,0.121786,5,1826.79487,101.488604,365.358974,108.277931,5,0
0,0,15,15,11,21,32,53,37,90,0.000333,0.15,5,2250,125,450,130.292414,5,0
0,0,15,15,11,19,30,53,37,90,0.000333,0.147207,5,2208.100768,122.672265,441.620154,118.764371,5,0
0,0,14,14,10,16,26,35,29,64,0.000333,0.100276,5,1504.14071,83.563373,300.828142,97.219281,3,0
0,0,14,14,10,14,24,35,29,64,0.000333,0.097813,10,2934.376,163.020889,293.4376,86.52225,3,0
0,0,14,14,13,27,40,55,56,111,0.000333,0.196911,12,7088.808222,393.822679,590.734019,176.487679,5,0
0,0,14,14,13,27,40,55,56,111,0.000333,0.196911,12,7088.808222,393.822679,590.734019,176.487679,5,0
0,0,11,11,9,16,25,27,37,64,0.000333,0.099069,8,2377.654369,132.091909,297.206796,92.529325,2,0
0,0,14,14,13,24,37,56,50,106,0.000333,0.184067,12,6626.424681,368.134705,552.202057,158.144816,5,0
0,0,14,14,13,24,37,56,50,106,0.000333,0.184067,12,6626.424681,368.134705,552.202057,158.144816,5,0
0,0,11,11,9,13,22,28,31,59,0.000333,0.087702,8,2104.851724,116.936207,263.106465,76.635041,2,0
0,0,11,11,13,22,35,47,37,84,0.000333,0.14362,6,2585.158641,143.619924,430.859773,146.213212,4,0
0,0,8,8,8,11,19,19,21,40,0.000333,0.056639,4,679.668402,37.759356,169.917101,62.053748,1,0
0,0,14,14,16,25,41,65,50,115,0.000333,0.205373,16,9857.895688,547.660872,616.118481,180.096405,6,0
0,0,11,11,11,14,25,37,34,71,0.000333,0.109905,10,3297.137895,183.174327,329.713789,91.356717,3,0
0,0,10,10,9,12,21,26,27,53,0.000333,0.077598,8,1862.342587,103.463477,232.792823,71.548875,1,0
0,0,13,13,14,23,37,54,43,97,0.000333,0.168439,7,3537.218835,196.512158,505.316976,157.344894,4,0
0,0,10,10,8,12,20,23,27,50,0.000333,0.072032,8,1728.771238,96.042847,216.096405,67.01955,1,0
0,0,13,13,13,23,36,51,43,94,0.000333,0.161991,6,2915.837701,161.990983,485.97295,152.147641,4,0
0,0,35,35,21,51,72,173,115,288,0.000333,0.592313,20,35538.76801,1974.376,1776.9384,381.532358,11,0
0,0,34,34,21,51,72,167,113,280,0.000333,0.57586,20,34551.58001,1919.532223,1727.579,381.532358,11,0
0,0,11,11,10,17,27,39,30,69,0.000333,0.109362,5,1640.436188,91.135344,328.087238,102.706149,5,0
0,0,11,11,10,16,26,39,30,69,0.000333,0.10811,5,1621.651703,90.091761,324.330341,97.219281,5,0
0,0,11,11,10,17,27,39,30,69,0.000333,0.109362,5,1640.436188,91.135344,328.087238,102.706149,5,0
0,0,11,11,10,16,26,39,30,69,0.000333,0.10811,5,1621.651703,90.091761,324.330341,97.219281,5,0
0,0,12,12,9,17,26,37,40,77,0.000333,0.120645,8,2895.470866,160.859493,361.933858,98.016193,1,0
0,0,13,13,11,22,33,55,48,103,0.000333,0.173191,10,5195.725943,288.651441,519.572594,136.161243,3,0
0,0,29,29,21,46,67,149,98,247,0.000333,0.499441,20,29966.4806,1664.804478,1498.32403,346.322516,9,0
0,0,29,29,21,45,66,144,94,238,0.000333,0.479522,20,28771.31601,1598.406445,1438.5658,339.372055,9,0
0,0,29,29,21,44,65,145,95,240,0.000333,0.481789,20,28907.3655,1605.96475,1445.368275,332.453657,9,0
0,0,15,15,11,18,29,49,36,85,0.000333,0.137643,10,4129.283846,229.404658,412.928385,113.112398,5,0
0,0,15,15,11,17,28,49,36,85,0.000333,0.136208,10,4086.251684,227.013982,408.625168,107.540616,5,0
0,0,29,29,21,46,67,148,96,244,0.000333,0.493375,20,29602.51525,1644.584181,1480.125762,346.322516,9,0
0,0,30,30,21,46,67,154,98,252,0.000333,0.509551,20,30573.08952,1698.504973,1528.654476,346.322516,9,0
0,0,29,29,24,47,71,152,98,250,0.000333,0.512479,24,36898.48272,2049.915707,1537.43678,371.104776,10,0
0,0,27,27,21,45,66,142,90,232,0.000333,0.467433,20,28045.98871,1558.110484,1402.299436,339.372055,9,0
0,0,29,29,19,47,66,145,101,246,0.000333,0.49564,18,26764.57716,1486.920953,1486.920953,341.776299,9,0
0,0,29,29,21,49,70,148,104,252,0.000333,0.51486,20,30891.58641,1716.199245,1544.57932,367.359448,9,0
0,0,29,29,21,49,70,148,104,252,0.000333,0.51486,20,30891.58641,1716.199245,1544.57932,367.359448,9,0
0,0,18,18,16,43,59,98,69,167,0.000333,0.327467,8,7859.211114,436.62284,982.401389,297.329384,7,0
0,0,18,18,17,42,59,99,68,167,0.000333,0.327467,8,7859.211114,436.62284,982.401389,295.9642,7,0
0,0,19,19,18,44,62,101,73,174,0.000333,0.345343,9,9324.271422,518.015079,1036.030158,315.273641,7,0
0,0,19,19,18,44,62,101,73,174,0.000333,0.345343,9,9324.271422,518.015079,1036.030158,315.273641,7,0
0,0,19,19,19,43,62,102,72,174,0.000333,0.345343,9,9324.271422,518.015079,1036.030158,314.040007,7,0
0,0,21,21,18,45,63,109,84,193,0.000333,0.384538,9,10382.53523,576.807513,1153.615025,322.192039,7,0
0,0,21,21,19,47,66,110,85,195,0.000333,0.392886,9,10607.91168,589.328427,1178.656853,341.776299,7,0
0,0,19,19,18,44,62,101,73,174,0.000333,0.345343,9,9324.271422,518.015079,1036.030158,315.273641,7,0
0,0,34,34,21,53,74,168,114,282,0.000333,0.583689,20,35021.31698,1945.628721,1751.065849,395.81845,11,0
0,0,5,5,7,11,18,15,19,34,0.000333,0.047259,3,425.33235,23.629575,141.77745,57.705232,1,0
0,0,6,6,9,16,25,29,26,55,0.000333,0.085137,4,1021.648362,56.758242,255.41209,92.529325,3,0
0,0,13,13,9,18,27,31,46,77,0.000333,0.122042,8,2929.010701,162.722817,366.126338,103.587975,1,0
0,0,16,16,14,29,43,59,62,121,0.000333,0.218859,14,9192.092494,510.671805,656.578035,194.184418,4,0
0,0,13,13,10,17,27,37,43,80,0.000333,0.126797,10,3803.910002,211.328333,380.391,102.706149,1,0
0,0,16,16,13,29,42,65,59,124,0.000333,0.222882,12,8023.768325,445.764907,668.64736,188.987165,4,0
0,0,6,6,7,13,20,15,23,38,0.000333,0.054744,3,492.699803,27.372211,164.233268,67.757201,1,0
0,0,7,7,9,18,27,29,30,59,0.000333,0.093513,4,1122.153451,62.341858,280.538363,103.587975,3,0
0,0,15,15,11,21,32,48,41,89,0.000333,0.148333,5,2225,123.611111,445,130.292414,5,0
0,0,15,15,11,20,31,48,41,89,0.000333,0.146974,10,4409.234716,244.957484,440.923472,124.49231,5,0
0,0,14,14,10,17,27,34,34,68,0.000333,0.107777,10,3233.323501,179.629083,323.33235,102.706149,3,0
0,0,14,14,10,16,26,34,34,68,0.000333,0.106543,10,3196.299008,177.572167,319.629901,97.219281,3,0
0,0,14,14,16,28,44,57,56,113,0.000333,0.205639,16,9870.652366,548.369576,616.915773,198.605938,4,0
0,0,11,11,11,17,28,29,40,69,0.000333,0.110569,10,3317.074896,184.281939,331.70749,107.540616,1,0
0,0,6,6,11,17,28,31,27,58,0.000333,0.092942,5,1394.132927,77.451829,278.826585,107.540616,3,0
0,0,5,5,9,12,21,17,20,37,0.000333,0.054172,4,650.062979,36.11461,162.515745,71.548875,1,0
0,0,22,22,19,45,64,108,77,185,0.000333,0.37,9,9990,555,1110,327.844012,8,0
0,0,22,22,20,46,66,113,78,191,0.000333,0.384826,10,11544.79277,641.377376,1154.479277,340.522412,8,0
0,0,11,11,9,16,25,29,36,65,0.000333,0.100617,8,2414.805219,134.155845,301.850652,92.529325,1,0
0,0,12,12,11,21,32,47,44,91,0.000333,0.151667,10,4550,252.777778,455,130.292414,3,0
0,0,12,12,8,16,24,29,45,74,0.000333,0.113096,8,2714.2978,150.794322,339.287225,88,1,0
0,0,13,13,10,21,31,47,53,100,0.000333,0.16514,10,4954.19631,275.233128,495.419631,125.457947,3,0
0,0,14,14,8,17,25,34,57,91,0.000333,0.140864,12,5071.090959,281.727276,422.590913,93.486868,1,0
0,0,15,15,10,22,32,52,65,117,0.000333,0.195,10,5850,325,585,131.326777,3,0
0,0,11,11,11,17,28,43,31,74,0.000333,0.118581,5,1778.721321,98.817851,355.744264,107.540616,5,0
0,0,10,10,9,12,21,25,23,48,0.000333,0.070277,4,843.324945,46.851386,210.831236,71.548875,3,0
0,0,11,11,10,17,27,39,30,69,0.000333,0.109362,5,1640.436188,91.135344,328.087238,102.706149,5,0
0,0,11,11,10,16,26,39,30,69,0.000333,0.10811,5,1621.651703,90.091761,324.330341,97.219281,5,0
0,0,5,5,7,13,20,15,23,38,0.000333,0.054744,3,492.699803,27.372211,164.233268,67.757201,1,0
0,0,6,6,9,18,27,29,30,59,0.000333,0.093513,4,1122.153451,62.341858,280.538363,103.587975,3,0
0,0,11,11,9,19,28,28,45,73,0.000333,0.116979,8,2807.495274,155.97196,350.936909,109.239948,1,0
0,0,12,12,11,23,34,42,52,94,0.000333,0.159407,10,4782.215071,265.678615,478.221507,142.095673,3,0
0,0,6,6,8,15,23,16,25,41,0.000333,0.061822,4,741.864161,41.214676,185.46604,82.603359,1,0
0,0,7,7,10,20,30,30,32,62,0.000333,0.101409,5,1521.136085,84.50756,304.227217,119.657843,3,0
0,0,10,10,8,18,26,23,41,64,0.000333,0.100276,8,2406.625136,133.701396,300.828142,99.05865,1,0
0,0,11,11,10,22,32,37,48,85,0.000333,0.141667,10,4250,236.111111,425,131.326777,3,0
0,0,14,14,8,20,28,33,71,104,0.000333,0.166655,12,5999.578943,333.309941,499.964912,110.438562,1,0
0,0,15,15,10,24,34,47,78,125,0.000333,0.211978,15,9538.992827,529.944046,635.932855,143.258381,3,0
0,0,32,32,21,49,70,157,104,261,0.000333,0.533248,20,31994.85735,1777.492075,1599.742867,367.359448,11,0
0,0,9,9,10,18,28,33,32,65,0.000333,0.104159,5,1562.39035,86.799464,312.47807,108.277931,4,0
0,0,9,9,10,18,28,33,32,65,0.000333,0.104159,5,1562.39035,86.799464,312.47807,108.277931,4,0
0,0,9,9,11,18,29,34,33,67,0.000333,0.108495,5,1627.423633,90.412424,325.484727,113.112398,4,0
0,0,9,9,10,18,28,33,33,66,0.000333,0.105762,5,1586.427124,88.13484,317.285425,108.277931,4,0
0,0,9,9,11,19,30,34,33,67,0.000333,0.109587,5,1643.80835,91.322686,328.76167,118.764371,4,0
0,0,9,9,10,19,29,33,33,66,0.000333,0.106876,5,1603.133728,89.062985,320.626746,113.929904,4,0
0,0,9,9,10,18,28,33,32,65,0.000333,0.104159,5,1562.39035,86.799464,312.47807,108.277931,4,0
0,0,9,9,10,18,28,33,32,65,0.000333,0.104159,5,1562.39035,86.799464,312.47807,108.277931,4,0
0,0,9,9,10,18,28,33,32,65,0.000333,0.104159,5,1562.39035,86.799464,312.47807,108.277931,4,0
0,0,9,9,10,18,28,33,32,65,0.000333,0.104159,5,1562.39035,86.799464,312.47807,108.277931,4,0
0,0,10,10,9,15,24,24,28,52,0.000333,0.079473,4,953.6722,52.981789,238.41805,87.132684,3,0
0,0,10,10,9,14,23,24,28,52,0.000333,0.078408,8,1881.801774,104.544543,235.225222,81.832294,3,0
0,0,15,15,10,23,33,55,45,100,0.000333,0.168146,5,2522.19706,140.122059,504.439412,137.261206,5,0
0,0,11,11,11,21,32,42,36,78,0.000333,0.13,5,1950,108.333333,390,130.292414,4,0
0,0,11,11,11,21,32,42,36,78,0.000333,0.13,5,1950,108.333333,390,130.292414,4,0
0,0,15,15,10,16,26,44,38,82,0.000333,0.128479,10,3854.360569,214.131143,385.436057,97.219281,3,0
0,0,15,15,10,16,26,44,38,82,0.000333,0.128479,10,3854.360569,214.131143,385.436057,97.219281,3,0
0,0,11,11,11,19,30,37,35,72,0.000333,0.117765,5,1766.480614,98.137812,353.296123,118.764371,4,0
0,0,11,11,11,20,31,37,35,72,0.000333,0.118901,5,1783.510672,99.083926,356.702134,124.49231,4,0
0,0,14,14,10,17,27,32,34,66,0.000333,0.104608,10,3138.225751,174.345875,313.822575,102.706149,3,0
0,0,14,14,10,16,26,32,34,66,0.000333,0.10341,10,3102.290214,172.349456,310.229021,97.219281,3,0
0,0,22,22,18,48,66,114,83,197,0.000333,0.396915,9,10716.71077,595.372821,1190.745642,343.13685,9,0
0,0,22,22,19,47,66,115,82,197,0.000333,0.396915,9,10716.71077,595.372821,1190.745642,341.776299,9,0
0,0,22,22,18,48,66,114,83,197,0.000333,0.396915,9,10716.71077,595.372821,1190.745642,343.13685,9,0
0,0,22,22,19,47,66,115,82,197,0.000333,0.396915,9,10716.71077,595.372821,1190.745642,341.776299,9,0
0,0,22,22,18,48,66,114,83,197,0.000333,0.396915,9,10716.71077,595.372821,1190.745642,343.13685,9,0
0,0,34,34,21,52,73,173,117,290,0.000333,0.59835,20,35900.98244,1994.499025,1795.049122,388.661531,10,0
0,0,33,33,21,52,73,169,116,285,0.000333,0.588033,20,35281.99999,1960.11111,1764.099999,388.661531,9,0
0,0,27,27,19,45,64,137,89,226,0.000333,0.452,9,12204,678,1356,327.844012,9,0
0,0,22,22,18,48,66,114,83,197,0.000333,0.396915,9,10716.71077,595.372821,1190.745642,343.13685,9,0
0,0,34,34,21,51,72,164,120,284,0.000333,0.584086,20,35045.17401,1946.954112,1752.2587,381.532358,10,0
0,0,33,33,21,51,72,160,121,281,0.000333,0.577916,20,34674.97851,1926.387695,1733.748925,381.532358,9,0
0,0,36,36,21,52,73,170,130,300,0.000333,0.618982,20,37138.94735,2063.274853,1856.947368,388.661531,10,0
0,0,35,35,21,52,73,166,133,299,0.000333,0.616919,20,37015.15086,2056.39727,1850.757543,388.661531,9,0
0,0,27,27,19,45,64,135,90,225,0.000333,0.45,18,24300,1350,1350,327.844012,9,0
0,0,27,27,20,47,67,136,90,226,0.000333,0.456979,10,13709.36157,761.631198,1370.936157,347.504238,9,0
0,0,32,32,21,50,71,158,110,268,0.000333,0.549377,20,32962.64456,1831.258031,1648.132228,374.431475,10,0
0,0,31,31,21,50,71,154,109,263,0.000333,0.539128,20,32347.66985,1797.092769,1617.383492,374.431475,9,0
0,0,33,33,21,51,72,164,113,277,0.000333,0.56969,20,34181.38451,1898.965806,1709.069225,381.532358,10,0
0,0,32,32,21,51,72,160,112,272,0.000333,0.559407,20,33564.39201,1864.688445,1678.2196,381.532358,9,0
0,0,38,38,21,53,74,176,140,316,0.000333,0.654062,20,39243.74527,2180.208071,1962.187264,395.81845,10,0
0,0,37,37,21,53,74,172,145,317,0.000333,0.656132,20,39367.93434,2187.107463,1968.396717,395.81845,9,0
0,0,11,11,11,19,30,39,37,76,0.000333,0.124308,5,1864.618426,103.589913,372.923685,118.764371,5,0
0,0,11,11,10,19,29,38,37,75,0.000333,0.12145,5,1821.742873,101.207937,364.348575,113.929904,5,0
0,0,11,11,10,18,28,43,31,74,0.000333,0.118581,5,1778.721321,98.817851,355.744264,108.277931,5,0
0,0,11,11,10,18,28,43,31,74,0.000333,0.118581,5,1778.721321,98.817851,355.744264,108.277931,5,0
0,0,10,10,9,13,22,25,23,48,0.000333,0.071351,4,856.210871,47.567271,214.052718,76.635041,3,0
0,0,10,10,9,13,22,25,23,48,0.000333,0.071351,4,856.210871,47.567271,214.052718,76.635041,3,0
0,0,11,11,11,18,29,39,37,76,0.000333,0.123069,10,3692.065556,205.114753,369.206556,113.112398,5,0
0,0,11,11,10,18,28,38,37,75,0.000333,0.120184,10,3605.516192,200.306455,360.551619,108.277931,5,0
0,0,10,10,10,14,24,25,30,55,0.000333,0.084058,10,2521.729375,140.096076,252.172938,86.52225,3,0
0,0,10,10,9,14,23,24,30,54,0.000333,0.081424,8,1954.178765,108.565487,244.272346,81.832294,3,0
0,0,11,11,10,19,29,38,35,73,0.000333,0.118211,5,1773.163063,98.509059,354.632613,113.929904,5,0
0,0,11,11,10,18,28,38,35,73,0.000333,0.116979,5,1754.684547,97.482475,350.936909,108.277931,5,0
0,0,10,10,9,15,24,24,28,52,0.000333,0.079473,4,953.6722,52.981789,238.41805,87.132684,3,0
0,0,10,10,9,14,23,24,28,52,0.000333,0.078408,8,1881.801774,104.544543,235.225222,81.832294,3,0
0,0,11,11,10,19,29,38,35,73,0.000333,0.118211,5,1773.163063,98.509059,354.632613,113.929904,5,0
0,0,11,11,10,18,28,38,35,73,0.000333,0.116979,5,1754.684547,97.482475,350.936909,108.277931,5,0
0,0,10,10,9,15,24,24,28,52,0.000333,0.079473,4,953.6722,52.981789,238.41805,87.132684,3,0
0,0,10,10,9,14,23,24,28,52,0.000333,0.078408,8,1881.801774,104.544543,235.225222,81.832294,3,0
0,0,8,8,8,12,20,19,21,40,0.000333,0.057626,4,691.508495,38.417139,172.877124,67.01955,1,0
0,0,9,9,10,17,27,37,29,66,0.000333,0.104608,5,1569.112876,87.172938,313.822575,102.706149,3,0
0,0,8,8,8,13,21,18,26,44,0.000333,0.064421,8,1546.095733,85.894207,193.261967,72.105716,1,0
0,0,9,9,10,17,27,32,33,65,0.000333,0.103023,5,1545.338438,85.852135,309.067688,102.706149,3,0
0,0,11,11,10,18,28,38,35,73,0.000333,0.116979,5,1754.684547,97.482475,350.936909,108.277931,5,0
0,0,11,11,10,18,28,38,35,73,0.000333,0.116979,5,1754.684547,97.482475,350.936909,108.277931,5,0
0,0,10,10,9,14,23,24,28,52,0.000333,0.078408,8,1881.801774,104.544543,235.225222,81.832294,3,0
0,0,10,10,9,14,23,24,28,52,0.000333,0.078408,8,1881.801774,104.544543,235.225222,81.832294,3,0
0,0,20,20,18,44,62,104,74,178,0.000333,0.353282,9,9538.622489,529.923472,1059.846943,315.273641,8,0
0,0,20,20,19,43,62,105,73,178,0.000333,0.353282,9,9538.622489,529.923472,1059.846943,314.040007,8,0
0,0,20,20,19,45,64,104,74,178,0.000333,0.356,9,9612,534,1068,327.844012,8,0
0,0,20,20,20,44,64,105,73,178,0.000333,0.356,10,10680,593.333333,1068,326.653553,8,0
0,0,20,20,20,44,64,105,73,178,0.000333,0.356,10,10680,593.333333,1068,326.653553,8,0
0,0,22,22,20,46,66,113,78,191,0.000333,0.384826,10,11544.79277,641.377376,1154.479277,340.522412,8,0
0,0,22,22,21,45,66,114,77,191,0.000333,0.384826,10,11544.79277,641.377376,1154.479277,339.372055,8,0
0,0,22,22,21,45,66,114,77,191,0.000333,0.384826,10,11544.79277,641.377376,1154.479277,339.372055,8,0
0,0,22,22,19,45,64,108,77,185,0.000333,0.37,9,9990,555,1110,327.844012,8,0
0,0,22,22,20,44,64,109,76,185,0.000333,0.37,10,11100,616.666667,1110,326.653553,8,0
0,0,22,22,20,44,64,109,76,185,0.000333,0.37,10,11100,616.666667,1110,326.653553,8,0
0,0,20,20,18,45,63,104,74,178,0.000333,0.354652,9,9575.602437,531.977913,1063.955826,322.192039,8,0
0,0,20,20,19,44,63,105,73,178,0.000333,0.354652,9,9575.602437,531.977913,1063.955826,320.925614,8,0
0,0,20,20,19,44,63,105,73,178,0.000333,0.354652,9,9575.602437,531.977913,1063.955826,320.925614,8,0
0,0,20,20,18,45,63,104,74,178,0.000333,0.354652,9,9575.602437,531.977913,1063.955826,322.192039,8,0
0,0,20,20,19,44,63,105,73,178,0.000333,0.354652,9,9575.602437,531.977913,1063.955826,320.925614,8,0
0,0,20,20,19,44,63,105,73,178,0.000333,0.354652,9,9575.602437,531.977913,1063.955826,320.925614,8,0
0,0,22,22,20,45,65,109,77,186,0.000333,0.373387,10,11201.60413,622.311341,1120.160413,333.571951,8,0
0,0,22,22,20,44,64,110,76,186,0.000333,0.372,10,11160,620,1116,326.653553,8,0
0,0,22,22,20,44,64,110,76,186,0.000333,0.372,10,11160,620,1116,326.653553,8,0
0,0,20,20,18,46,64,104,75,179,0.000333,0.358,9,9666,537,1074,329.1425,8,0
0,0,20,20,19,45,64,105,74,179,0.000333,0.358,9,9666,537,1074,327.844012,8,0
0,0,20,20,19,45,64,105,74,179,0.000333,0.358,9,9666,537,1074,327.844012,8,0
0,0,30,30,19,49,68,148,100,248,0.000333,0.50323,18,27174.43412,1509.690785,1509.690785,355.831405,11,0
0,0,30,30,20,51,71,149,100,249,0.000333,0.510429,10,15312.87033,850.715018,1531.287033,375.732254,11,0
0,0,32,32,19,51,70,156,109,265,0.000333,0.54142,18,29236.67999,1624.259999,1624.259999,370.004315,12,0
0,0,32,32,21,53,74,159,110,269,0.000333,0.556781,20,33406.85911,1855.936617,1670.342955,395.81845,12,0
0,0,30,30,19,49,68,149,98,247,0.000333,0.501201,18,27064.85979,1503.603322,1503.603322,355.831405,11,0
0,0,32,32,21,50,71,160,106,266,0.000333,0.545278,20,32716.65468,1817.591926,1635.832734,374.431475,12,0
0,0,29,29,20,45,65,143,98,241,0.000333,0.483797,20,29027.81286,1612.65627,1451.390643,333.571951,9,0
0,0,29,29,21,47,68,144,99,243,0.000333,0.493084,20,29585.06941,1643.614967,1479.25347,353.304342,9,0
0,0,32,32,21,52,73,160,105,265,0.000333,0.546768,20,32806.07016,1822.559453,1640.303508,388.661531,12,0
0,0,32,32,21,50,71,159,104,263,0.000333,0.539128,20,32347.66985,1797.092769,1617.383492,374.431475,12,0
0,0,33,33,21,50,71,165,106,271,0.000333,0.555527,20,33331.62939,1851.757188,1666.581469,374.431475,12,0
0,0,15,15,11,19,30,47,36,83,0.000333,0.135757,5,2036.359597,113.131089,407.271919,118.764371,5,0
0,0,15,15,11,18,29,47,36,83,0.000333,0.134404,10,4032.124226,224.006901,403.212423,113.112398,5,0
0,0,11,11,10,18,28,39,30,69,0.000333,0.110569,5,1658.537448,92.140969,331.70749,108.277931,5,0
0,0,11,11,10,17,27,39,30,69,0.000333,0.109362,5,1640.436188,91.135344,328.087238,102.706149,5,0
0,0,10,10,9,14,23,25,23,48,0.000333,0.072377,4,868.523896,48.251328,217.130974,81.832294,3,0
0,0,10,10,9,13,22,25,23,48,0.000333,0.071351,4,856.210871,47.567271,214.052718,76.635041,3,0
0,0,11,11,11,17,28,40,32,72,0.000333,0.115377,5,1730.647772,96.147098,346.129554,107.540616,5,0
0,0,11,11,10,17,27,39,32,71,0.000333,0.112532,5,1687.985063,93.776948,337.597013,102.706149,5,0
0,0,11,11,11,18,29,40,32,72,0.000333,0.116592,5,1748.873158,97.15962,349.774632,113.112398,5,0
0,0,11,11,10,18,28,39,32,71,0.000333,0.113774,5,1706.610997,94.811722,341.322199,108.277931,5,0
0,0,10,10,10,14,24,26,25,51,0.000333,0.077944,5,1169.165438,64.953635,233.833088,86.52225,3,0
0,0,10,10,9,14,23,25,25,50,0.000333,0.075393,4,904.712391,50.2618,226.178098,81.832294,3,0
0,0,11,11,10,18,28,39,30,69,0.000333,0.110569,5,1658.537448,92.140969,331.70749,108.277931,5,0
0,0,11,11,10,17,27,39,30,69,0.000333,0.109362,5,1640.436188,91.135344,328.087238,102.706149,5,0
0,0,10,10,9,14,23,25,23,48,0.000333,0.072377,4,868.523896,48.251328,217.130974,81.832294,3,0
0,0,10,10,9,13,22,25,23,48,0.000333,0.071351,4,856.210871,47.567271,214.052718,76.635041,3,0
0,0,15,15,11,19,30,49,36,85,0.000333,0.139029,5,2085.428503,115.857139,417.085701,118.764371,5,0
0,0,15,15,11,18,29,49,36,85,0.000333,0.137643,10,4129.283846,229.404658,412.928385,113.112398,5,0
0,0,11,11,11,18,29,40,32,72,0.000333,0.116592,5,1748.873158,97.15962,349.774632,113.112398,5,0
0,0,11,11,10,18,28,39,32,71,0.000333,0.113774,5,1706.610997,94.811722,341.322199,108.277931,5,0
0,0,11,11,10,18,28,39,30,69,0.000333,0.110569,5,1658.537448,92.140969,331.70749,108.277931,5,0
0,0,11,11,10,17,27,39,30,69,0.000333,0.109362,5,1640.436188,91.135344,328.087238,102.706149,5,0
0,0,11,11,10,18,28,39,30,69,0.000333,0.110569,5,1658.537448,92.140969,331.70749,108.277931,5,0
0,0,11,11,10,17,27,39,30,69,0.000333,0.109362,5,1640.436188,91.135344,328.087238,102.706149,5,0
0,0,25,25,20,51,71,126,99,225,0.000333,0.461231,10,13836.93102,768.71839,1383.693102,375.732254,9,0
0,0,25,25,21,52,73,127,105,232,0.000333,0.47868,20,28720.78595,1595.59922,1436.039298,388.661531,9,0
0,0,20,20,17,46,63,113,81,194,0.000333,0.386531,8,9276.738441,515.374358,1159.592305,323.570718,9,0
0,0,20,20,17,47,64,113,83,196,0.000333,0.392,8,9408,522.666667,1176,330.552544,9,0
0,0,23,23,18,48,66,117,84,201,0.000333,0.404974,9,10934.30896,607.461609,1214.923218,343.13685,10,0
0,0,23,23,19,47,66,118,83,201,0.000333,0.404974,9,10934.30896,607.461609,1214.923218,341.776299,10,0
0,0,23,23,19,47,66,118,83,201,0.000333,0.404974,9,10934.30896,607.461609,1214.923218,341.776299,10,0
0,0,22,22,18,48,66,114,83,197,0.000333,0.396915,9,10716.71077,595.372821,1190.745642,343.13685,9,0
0,0,22,22,19,47,66,115,82,197,0.000333,0.396915,9,10716.71077,595.372821,1190.745642,341.776299,9,0
0,0,23,23,18,49,67,117,84,201,0.000333,0.406428,9,10973.55535,609.641964,1219.283927,350.179432,10,0
0,0,23,23,19,48,67,118,83,201,0.000333,0.406428,9,10973.55535,609.641964,1219.283927,348.788823,10,0
0,0,23,23,19,48,67,118,83,201,0.000333,0.406428,9,10973.55535,609.641964,1219.283927,348.788823,10,0
0,0,23,23,18,49,67,117,85,202,0.000333,0.40845,9,11028.15015,612.675008,1225.350016,350.179432,10,0
0,0,23,23,19,48,67,118,84,202,0.000333,0.40845,9,11028.15015,612.675008,1225.350016,348.788823,10,0
0,0,23,23,19,48,67,118,84,202,0.000333,0.40845,9,11028.15015,612.675008,1225.350016,348.788823,10,0
0,0,11,11,11,18,29,44,33,77,0.000333,0.124688,5,1870.322683,103.906816,374.064537,113.112398,5,0
0,0,11,11,10,18,28,43,33,76,0.000333,0.121786,5,1826.79487,101.488604,365.358974,108.277931,5,0
0,0,10,10,10,13,23,26,25,51,0.000333,0.076901,5,1153.508299,64.083794,230.70166,81.324997,3,0
0,0,10,10,9,13,22,25,25,50,0.000333,0.074324,4,891.886324,49.54924,222.971581,76.635041,3,0
0,0,14,14,8,20,28,33,71,104,0.000333,0.166655,12,5999.578943,333.309941,499.964912,110.438562,1,0
0,0,14,14,10,24,34,45,76,121,0.000333,0.205194,15,9233.745057,512.985836,615.583004,143.258381,3,0
0,0,12,12,8,19,27,28,56,84,0.000333,0.133137,8,3195.284401,177.5158,399.41055,104.710623,1,0
0,0,12,12,10,23,33,40,61,101,0.000333,0.169828,10,5094.838061,283.046559,509.483806,137.261206,3,0
0,0,6,6,8,15,23,16,25,41,0.000333,0.061822,4,741.864161,41.214676,185.46604,82.603359,1,0
0,0,7,7,10,20,30,30,32,62,0.000333,0.101409,5,1521.136085,84.50756,304.227217,119.657843,3,0
0,0,23,23,18,50,68,117,85,202,0.000333,0.409889,9,11067.00745,614.833747,1229.667494,357.25146,10,0
0,0,23,23,19,49,68,118,84,202,0.000333,0.409889,9,11067.00745,614.833747,1229.667494,355.831405,10,0
0,0,23,23,19,49,68,118,84,202,0.000333,0.409889,9,11067.00745,614.833747,1229.667494,355.831405,10,0
0,0,32,32,21,49,70,157,104,261,0.000333,0.533248,20,31994.85735,1777.492075,1599.742867,367.359448,11,0
0,0,32,32,21,48,69,158,105,263,0.000333,0.535514,20,32130.83864,1785.046591,1606.541932,360.316866,11,0
0,0,32,32,21,50,71,161,109,270,0.000333,0.553477,20,33208.63445,1844.924136,1660.431722,374.431475,11,0
0,0,32,32,21,50,71,161,109,270,0.000333,0.553477,20,33208.63445,1844.924136,1660.431722,374.431475,11,0
0,0,33,33,20,53,73,164,114,278,0.000333,0.57359,20,34415.42455,1911.96803,1720.771227,390.018346,12,0
0,0,32,32,21,53,74,160,113,273,0.000333,0.56506,20,33903.61538,1883.534188,1695.180769,395.81845,11,0
0,0,32,32,21,53,74,160,113,273,0.000333,0.56506,20,33903.61538,1883.534188,1695.180769,395.81845,11,0
0,0,34,34,24,52,76,171,115,286,0.000333,0.595636,24,42885.77445,2382.543025,1786.907269,406.461965,12,0
0,0,23,23,18,48,66,117,84,201,0.000333,0.404974,9,10934.30896,607.461609,1214.923218,343.13685,10,0
0,0,11,11,11,18,29,43,31,74,0.000333,0.11983,5,1797.452968,99.858498,359.490594,113.112398,5,0
0,0,11,11,11,18,29,43,31,74,0.000333,0.11983,5,1797.452968,99.858498,359.490594,113.112398,5,0
0,0,10,10,9,13,22,25,23,48,0.000333,0.071351,4,856.210871,47.567271,214.052718,76.635041,3,0
0,0,10,10,9,13,22,25,23,48,0.000333,0.071351,4,856.210871,47.567271,214.052718,76.635041,3,0
0,0,35,35,21,51,72,173,115,288,0.000333,0.592313,20,35538.76801,1974.376,1776.9384,381.532358,11,0
0,0,11,11,11,19,30,39,37,76,0.000333,0.124308,5,1864.618426,103.589913,372.923685,118.764371,5,0
0,0,11,11,10,19,29,38,37,75,0.000333,0.12145,5,1821.742873,101.207937,364.348575,113.929904,5,0
0,0,10,10,10,15,25,25,30,55,0.000333,0.085137,10,2554.120904,141.895606,255.41209,91.82264,3,0
0,0,10,10,9,15,24,24,30,54,0.000333,0.082529,8,1980.7038,110.0391,247.587975,87.132684,3,0
0,0,12,12,9,17,26,37,40,77,0.000333,0.120645,8,2895.470866,160.859493,361.933858,98.016193,1,0
0,0,13,13,11,21,32,51,47,98,0.000333,0.163333,10,4900,272.222222,490,130.292414,3,0
0,0,20,20,18,46,64,104,75,179,0.000333,0.358,9,9666,537,1074,329.1425,8,0
0,0,20,20,19,44,63,105,73,178,0.000333,0.354652,9,9575.602437,531.977913,1063.955826,320.925614,8,0
0,0,20,20,19,44,63,105,73,178,0.000333,0.354652,9,9575.602437,531.977913,1063.955826,320.925614,8,0
0,0,6,6,7,13,20,15,23,38,0.000333,0.054744,3,492.699803,27.372211,164.233268,67.757201,1,0
0,0,7,7,9,18,27,29,30,59,0.000333,0.093513,4,1122.153451,62.341858,280.538363,103.587975,3,0
0,0,13,13,10,17,27,37,43,80,0.000333,0.126797,10,3803.910002,211.328333,380.391,102.706149,1,0
0,0,14,14,12,22,34,51,50,101,0.000333,0.171278,12,6166.004964,342.555831,513.833747,141.127046,3,0
0,0,13,13,9,18,27,31,46,77,0.000333,0.122042,8,2929.010701,162.722817,366.126338,103.587975,1,0
0,0,14,14,11,22,33,45,53,98,0.000333,0.164784,10,4943.506237,274.639235,494.350624,136.161243,3,0
0,0,20,20,18,46,64,104,76,180,0.000333,0.36,9,9720,540,1080,329.1425,8,0
0,0,20,20,19,44,63,105,74,179,0.000333,0.356644,9,9629.397957,534.966553,1069.933106,320.925614,8,0
0,0,20,20,19,44,63,105,74,179,0.000333,0.356644,9,9629.397957,534.966553,1069.933106,320.925614,8,0
0,0,31,31,21,50,71,156,99,255,0.000333,0.522729,10,15681.85516,871.214175,1568.185515,374.431475,13,0
0,0,31,31,21,50,71,156,99,255,0.000333,0.522729,10,15681.85516,871.214175,1568.185515,374.431475,13,0
0,0,31,31,21,51,72,156,100,256,0.000333,0.5265,10,15795.008,877.500445,1579.5008,381.532358,13,0
0,0,31,31,21,51,72,156,100,256,0.000333,0.5265,10,15795.008,877.500445,1579.5008,381.532358,13,0
0,0,31,31,21,51,72,156,100,256,0.000333,0.5265,10,15795.008,877.500445,1579.5008,381.532358,13,0
0,0,31,31,21,51,72,156,100,256,0.000333,0.5265,10,15795.008,877.500445,1579.5008,381.532358,13,0
0,0,33,33,22,50,72,161,102,263,0.000333,0.540897,22,35699.18606,1983.288114,1622.690275,380.300305,13,0
0,0,33,33,22,50,72,161,102,263,0.000333,0.540897,22,35699.18606,1983.288114,1622.690275,380.300305,13,0
0,0,30,30,21,49,70,153,98,251,0.000333,0.512817,20,30769.00075,1709.38893,1538.450037,367.359448,12,0
0,0,20,20,18,46,64,104,75,179,0.000333,0.358,9,9666,537,1074,329.1425,8,0
0,0,20,20,19,44,63,105,73,178,0.000333,0.354652,9,9575.602437,531.977913,1063.955826,320.925614,8,0
0,0,20,20,19,44,63,105,73,178,0.000333,0.354652,9,9575.602437,531.977913,1063.955826,320.925614,8,0
0,0,31,31,21,50,71,156,100,256,0.000333,0.524778,20,31486.70525,1749.261403,1574.335263,374.431475,13,0
0,0,31,31,21,50,71,156,100,256,0.000333,0.524778,20,31486.70525,1749.261403,1574.335263,374.431475,13,0
0,0,31,31,21,50,71,156,99,255,0.000333,0.522729,10,15681.85516,871.214175,1568.185515,374.431475,13,0
0,0,31,31,21,50,71,156,99,255,0.000333,0.522729,10,15681.85516,871.214175,1568.185515,374.431475,13,0
0,0,31,31,21,50,71,156,99,255,0.000333,0.522729,10,15681.85516,871.214175,1568.185515,374.431475,13,0
0,0,31,31,21,50,71,156,99,255,0.000333,0.522729,10,15681.85516,871.214175,1568.185515,374.431475,13,0
0,0,31,31,21,50,71,156,99,255,0.000333,0.522729,10,15681.85516,871.214175,1568.185515,374.431475,13,0
0,0,31,31,21,50,71,156,99,255,0.000333,0.522729,10,15681.85516,871.214175,1568.185515,374.431475,13,0
0,0,13,13,13,24,37,54,41,95,0.000333,0.164966,6,2969.388418,164.966023,494.89807,158.144816,6,0
0,0,13,13,13,24,37,53,41,94,0.000333,0.16323,6,2938.131698,163.229539,489.688616,158.144816,6,0
0,0,10,10,10,13,23,26,25,51,0.000333,0.076901,5,1153.508299,64.083794,230.70166,81.324997,3,0
0,0,10,10,9,13,22,25,25,50,0.000333,0.074324,4,891.886324,49.54924,222.971581,76.635041,3,0
0,0,13,13,13,23,36,53,39,92,0.000333,0.158544,6,2853.798601,158.544367,475.6331,152.147641,6,0
0,0,13,13,13,23,36,53,39,92,0.000333,0.158544,6,2853.798601,158.544367,475.6331,152.147641,6,0
0,0,10,10,9,12,21,25,23,48,0.000333,0.070277,4,843.324945,46.851386,210.831236,71.548875,3,0
0,0,10,10,9,12,21,25,23,48,0.000333,0.070277,4,843.324945,46.851386,210.831236,71.548875,3,0
0,0,8,8,8,11,19,19,21,40,0.000333,0.056639,4,679.668402,37.759356,169.917101,62.053748,1,0
0,0,11,11,13,22,35,47,37,84,0.000333,0.14362,6,2585.158641,143.619924,430.859773,146.213212,4,0
0,0,13,13,13,24,37,53,39,92,0.000333,0.159757,6,2875.618258,159.75657,479.26971,158.144816,6,0
0,0,13,13,13,23,36,53,39,92,0.000333,0.158544,6,2853.798601,158.544367,475.6331,152.147641,6,0
0,0,10,10,9,13,22,25,23,48,0.000333,0.071351,4,856.210871,47.567271,214.052718,76.635041,3,0
0,0,10,10,9,12,21,25,23,48,0.000333,0.070277,4,843.324945,46.851386,210.831236,71.548875,3,0
0,0,13,13,13,23,36,54,41,95,0.000333,0.163714,6,2946.857251,163.714292,491.142875,152.147641,6,0
0,0,13,13,13,23,36,53,41,94,0.000333,0.161991,6,2915.837701,161.990983,485.97295,152.147641,6,0
0,0,10,10,10,12,22,26,25,51,0.000333,0.07581,10,2274.310126,126.350563,227.431013,76.238831,3,0
0,0,10,10,9,12,21,25,25,50,0.000333,0.073205,8,1756.926969,97.607054,219.615871,71.548875,3,0
0,0,20,20,18,46,64,104,75,179,0.000333,0.358,9,9666,537,1074,329.1425,8,0
0,0,20,20,19,44,63,105,73,178,0.000333,0.354652,9,9575.602437,531.977913,1063.955826,320.925614,8,0
0,0,20,20,19,44,63,105,73,178,0.000333,0.354652,9,9575.602437,531.977913,1063.955826,320.925614,8,0
0,0,20,20,18,46,64,104,75,179,0.000333,0.358,9,9666,537,1074,329.1425,8,0
0,0,20,20,19,44,63,105,73,178,0.000333,0.354652,9,9575.602437,531.977913,1063.955826,320.925614,8,0
0,0,20,20,19,44,63,105,73,178,0.000333,0.354652,9,9575.602437,531.977913,1063.955826,320.925614,8,0
0,0,20,20,18,47,65,104,76,180,0.000333,0.361342,9,9756.235857,542.013103,1084.026206,336.124326,8,0
0,0,20,20,19,45,64,105,74,179,0.000333,0.358,9,9666,537,1074,327.844012,8,0
0,0,20,20,19,45,64,105,74,179,0.000333,0.358,9,9666,537,1074,327.844012,8,0
0,0,22,22,20,46,66,109,78,187,0.000333,0.376767,10,11303.017,627.945389,1130.3017,340.522412,8,0
0,0,22,22,20,44,64,110,76,186,0.000333,0.372,10,11160,620,1116,326.653553,8,0
0,0,22,22,20,44,64,110,76,186,0.000333,0.372,10,11160,620,1116,326.653553,8,0
0,0,20,20,17,47,64,113,83,196,0.000333,0.392,8,9408,522.666667,1176,330.552544,9,0
0,0,20,20,17,48,65,113,85,198,0.000333,0.397476,8,9539.430616,529.968368,1192.428827,337.565068,9,0
0,0,22,22,18,49,67,114,84,198,0.000333,0.400362,9,10809.77094,600.54283,1201.08566,350.179432,9,0
0,0,22,22,19,47,66,115,82,197,0.000333,0.396915,9,10716.71077,595.372821,1190.745642,341.776299,9,0
0,0,22,22,18,49,67,114,84,198,0.000333,0.400362,9,10809.77094,600.54283,1201.08566,350.179432,9,0
0,0,22,22,19,47,66,115,82,197,0.000333,0.396915,9,10716.71077,595.372821,1190.745642,341.776299,9,0
0,0,24,24,19,50,69,123,91,214,0.000333,0.435741,9,11765.0181,653.612117,1307.224234,362.903432,9,0
0,0,24,24,19,48,67,124,91,215,0.000333,0.434736,9,11737.88258,652.104588,1304.209176,348.788823,9,0
0,0,22,22,18,49,67,114,84,198,0.000333,0.400362,9,10809.77094,600.54283,1201.08566,350.179432,9,0
0,0,22,22,19,47,66,115,82,197,0.000333,0.396915,9,10716.71077,595.372821,1190.745642,341.776299,9,0
0,0,22,22,18,49,67,114,84,198,0.000333,0.400362,9,10809.77094,600.54283,1201.08566,350.179432,9,0
0,0,22,22,19,47,66,115,82,197,0.000333,0.396915,9,10716.71077,595.372821,1190.745642,341.776299,9,0
0,0,20,20,18,44,62,104,74,178,0.000333,0.353282,9,9538.622489,529.923472,1059.846943,315.273641,8,0
0,0,20,20,19,43,62,105,73,178,0.000333,0.353282,9,9538.622489,529.923472,1059.846943,314.040007,8,0
0,0,20,20,19,43,62,105,73,178,0.000333,0.353282,9,9538.622489,529.923472,1059.846943,314.040007,8,0
0,0,19,19,18,44,62,101,73,174,0.000333,0.345343,9,9324.271422,518.015079,1036.030158,315.273641,7,0
0,0,11,11,11,17,28,39,30,69,0.000333,0.110569,5,1658.537448,92.140969,331.70749,107.540616,4,0
0,0,11,11,11,18,29,39,30,69,0.000333,0.111734,5,1676.003443,93.111302,335.200689,113.112398,4,0
0,0,14,14,10,15,25,35,29,64,0.000333,0.099069,5,1486.033981,82.557443,297.206796,91.82264,3,0
0,0,14,14,10,14,24,35,29,64,0.000333,0.097813,10,2934.376,163.020889,293.4376,86.52225,3,0
0,0,9,9,11,18,29,35,28,63,0.000333,0.102018,5,1530.264013,85.014667,306.052803,113.112398,4,0
0,0,9,9,10,18,28,34,28,62,0.000333,0.099352,5,1490.280026,82.793335,298.056005,108.277931,4,0
0,0,10,10,10,14,24,26,25,51,0.000333,0.077944,5,1169.165438,64.953635,233.833088,86.52225,3,0
0,0,10,10,9,14,23,25,25,50,0.000333,0.075393,4,904.712391,50.2618,226.178098,81.832294,3,0
0,0,9,9,10,17,27,34,27,61,0.000333,0.096683,5,1450.240688,80.568927,290.048138,102.706149,4,0
0,0,9,9,10,17,27,34,27,61,0.000333,0.096683,5,1450.240688,80.568927,290.048138,102.706149,4,0
0,0,10,10,9,14,23,25,23,48,0.000333,0.072377,4,868.523896,48.251328,217.130974,81.832294,3,0
0,0,10,10,9,13,22,25,23,48,0.000333,0.071351,4,856.210871,47.567271,214.052718,76.635041,3,0
0,0,9,9,10,17,27,34,27,61,0.000333,0.096683,5,1450.240688,80.568927,290.048138,102.706149,4,0
0,0,9,9,10,17,27,34,27,61,0.000333,0.096683,5,1450.240688,80.568927,290.048138,102.706149,4,0
0,0,10,10,9,14,23,25,23,48,0.000333,0.072377,4,868.523896,48.251328,217.130974,81.832294,3,0
0,0,10,10,9,13,22,25,23,48,0.000333,0.071351,4,856.210871,47.567271,214.052718,76.635041,3,0
0,0,11,11,11,17,28,38,30,68,0.000333,0.108967,5,1634.500673,90.805593,326.900135,107.540616,4,0
0,0,11,11,11,18,29,38,30,68,0.000333,0.110114,5,1651.713538,91.761863,330.342708,113.112398,4,0
0,0,14,14,10,15,25,33,29,62,0.000333,0.095973,5,1439.595419,79.977523,287.919084,91.82264,3,0
0,0,14,14,10,14,24,33,29,62,0.000333,0.094756,10,2842.67675,157.926486,284.267675,86.52225,3,0
0,0,9,9,11,18,29,35,28,63,0.000333,0.102018,5,1530.264013,85.014667,306.052803,113.112398,4,0
0,0,9,9,10,18,28,34,28,62,0.000333,0.099352,5,1490.280026,82.793335,298.056005,108.277931,4,0
0,0,10,10,10,14,24,26,25,51,0.000333,0.077944,5,1169.165438,64.953635,233.833088,86.52225,3,0
0,0,10,10,9,14,23,25,25,50,0.000333,0.075393,4,904.712391,50.2618,226.178098,81.832294,3,0
0,0,9,9,11,17,28,34,27,61,0.000333,0.09775,5,1466.243251,81.457958,293.24865,107.540616,4,0
0,0,10,10,9,13,22,25,23,48,0.000333,0.071351,4,856.210871,47.567271,214.052718,76.635041,3,0
0,0,19,19,18,44,62,101,73,174,0.000333,0.345343,9,9324.271422,518.015079,1036.030158,315.273641,7,0
0,0,19,19,19,43,62,102,72,174,0.000333,0.345343,9,9324.271422,518.015079,1036.030158,314.040007,7,0
0,0,30,30,21,48,69,151,101,252,0.000333,0.513116,20,30786.96326,1710.386848,1539.348163,360.316866,10,0
0,0,30,30,21,48,69,151,101,252,0.000333,0.513116,20,30786.96326,1710.386848,1539.348163,360.316866,10,0
0,0,30,30,21,48,69,151,101,252,0.000333,0.513116,20,30786.96326,1710.386848,1539.348163,360.316866,10,0
0,0,30,30,21,48,69,151,101,252,0.000333,0.513116,20,30786.96326,1710.386848,1539.348163,360.316866,10,0
0,0,32,32,22,47,69,156,103,259,0.000333,0.527369,22,34806.37236,1933.687353,1582.107834,359.173172,10,0
0,0,32,32,22,47,69,156,103,259,0.000333,0.527369,22,34806.37236,1933.687353,1582.107834,359.173172,10,0
0,0,29,29,21,46,67,148,97,245,0.000333,0.495397,20,29723.83703,1651.32428,1486.191852,346.322516,9,0
0,0,30,30,21,47,68,151,101,252,0.000333,0.511347,20,30680.81272,1704.489596,1534.040636,353.304342,10,0
0,0,30,30,21,47,68,151,101,252,0.000333,0.511347,20,30680.81272,1704.489596,1534.040636,353.304342,10,0
0,0,30,30,21,47,68,151,100,251,0.000333,0.509318,20,30559.06346,1697.725748,1527.953173,353.304342,10,0
0,0,30,30,21,47,68,151,100,251,0.000333,0.509318,20,30559.06346,1697.725748,1527.953173,353.304342,10,0
0,0,30,30,21,47,68,151,100,251,0.000333,0.509318,20,30559.06346,1697.725748,1527.953173,353.304342,10,0
0,0,30,30,21,47,68,151,100,251,0.000333,0.509318,20,30559.06346,1697.725748,1527.953173,353.304342,10,0
0,0,33,33,19,49,68,157,121,278,0.000333,0.564105,18,30461.66406,1692.31467,1692.31467,355.831405,9,0
0,0,33,33,21,51,72,160,126,286,0.000333,0.5882,20,35291.97101,1960.665056,1764.59855,381.532358,9,0
0,0,27,27,19,45,64,136,88,224,0.000333,0.448,9,12096,672,1344,327.844012,9,0
0,0,29,29,21,46,67,148,97,245,0.000333,0.495397,20,29723.83703,1651.32428,1486.191852,346.322516,9,0
0,0,29,29,21,46,67,148,99,247,0.000333,0.499441,20,29966.4806,1664.804478,1498.32403,346.322516,9,0
0,0,29,29,21,46,67,148,99,247,0.000333,0.499441,20,29966.4806,1664.804478,1498.32403,346.322516,9,0
0,0,30,30,21,48,69,151,101,252,0.000333,0.513116,20,30786.96326,1710.386848,1539.348163,360.316866,10,0
0,0,30,30,21,48,69,151,101,252,0.000333,0.513116,20,30786.96326,1710.386848,1539.348163,360.316866,10,0
0,0,30,30,21,48,69,151,101,252,0.000333,0.513116,20,30786.96326,1710.386848,1539.348163,360.316866,10,0
0,0,30,30,21,48,69,151,101,252,0.000333,0.513116,20,30786.96326,1710.386848,1539.348163,360.316866,10,0
0,0,30,30,21,46,67,151,98,249,0.000333,0.503485,20,30209.12417,1678.284676,1510.456208,346.322516,10,0
0,0,30,30,22,47,69,151,100,251,0.000333,0.51108,22,33731.27205,1873.959558,1533.239639,359.173172,10,0
0,0,30,30,22,47,69,151,100,251,0.000333,0.51108,22,33731.27205,1873.959558,1533.239639,359.173172,10,0
0,0,32,32,21,47,68,160,105,265,0.000333,0.537726,20,32263.55306,1792.419614,1613.177653,353.304342,9,0
0,0,31,31,21,47,68,154,103,257,0.000333,0.521493,20,31289.559,1738.308834,1564.47795,353.304342,9,0
0,0,11,11,11,16,27,39,30,69,0.000333,0.109362,5,1640.436188,91.135344,328.087238,102.053748,4,0
0,0,11,11,11,17,28,39,30,69,0.000333,0.110569,5,1658.537448,92.140969,331.70749,107.540616,4,0
0,0,9,9,11,17,28,35,28,63,0.000333,0.100954,5,1514.3168,84.128711,302.86336,107.540616,4,0
0,0,9,9,10,17,27,34,28,62,0.000333,0.098268,5,1474.015126,81.889729,294.803025,102.706149,4,0
0,0,9,9,10,16,26,34,27,61,0.000333,0.095576,5,1433.634114,79.64634,286.726823,97.219281,4,0
0,0,9,9,10,16,26,34,27,61,0.000333,0.095576,5,1433.634114,79.64634,286.726823,97.219281,4,0
0,0,9,9,10,16,26,34,27,61,0.000333,0.095576,5,1433.634114,79.64634,286.726823,97.219281,4,0
0,0,9,9,10,16,26,34,27,61,0.000333,0.095576,5,1433.634114,79.64634,286.726823,97.219281,4,0
0,0,9,9,11,16,27,35,28,63,0.000333,0.099853,5,1497.789563,83.210531,299.557913,102.053748,4,0
0,0,9,9,10,16,26,34,28,62,0.000333,0.097142,5,1457.136313,80.952017,291.427263,97.219281,4,0
0,0,9,9,11,17,28,35,28,63,0.000333,0.100954,5,1514.3168,84.128711,302.86336,107.540616,4,0
0,0,9,9,10,17,27,34,28,62,0.000333,0.098268,5,1474.015126,81.889729,294.803025,102.706149,4,0
0,0,15,15,10,19,29,56,39,95,0.000333,0.153836,10,4615.081945,256.393441,461.508195,113.929904,5,0
0,0,11,11,11,18,29,43,31,74,0.000333,0.11983,5,1797.452968,99.858498,359.490594,113.112398,4,0
0,0,11,11,11,18,29,43,31,74,0.000333,0.11983,5,1797.452968,99.858498,359.490594,113.112398,4,0
0,0,11,11,11,16,27,38,30,68,0.000333,0.107777,5,1616.661751,89.814542,323.33235,102.053748,4,0
0,0,11,11,11,17,28,38,30,68,0.000333,0.108967,5,1634.500673,90.805593,326.900135,107.540616,4,0
0,0,19,19,18,44,62,101,73,174,0.000333,0.345343,9,9324.271422,518.015079,1036.030158,315.273641,7,0
0,0,19,19,18,44,62,101,73,174,0.000333,0.345343,9,9324.271422,518.015079,1036.030158,315.273641,7,0
0,0,20,20,18,44,62,104,74,178,0.000333,0.353282,9,9538.622489,529.923472,1059.846943,315.273641,8,0
0,0,9,9,10,15,25,33,28,61,0.000333,0.094425,5,1416.376138,78.687563,283.275228,91.82264,3,0
0,0,11,11,10,16,26,39,30,69,0.000333,0.10811,5,1621.651703,90.091761,324.330341,97.219281,5,0
0,0,11,11,10,16,26,39,30,69,0.000333,0.10811,5,1621.651703,90.091761,324.330341,97.219281,5,0
0,0,28,28,21,45,66,145,91,236,0.000333,0.475492,20,28529.54024,1584.974458,1426.477012,339.372055,10,0
0,0,28,28,21,45,66,145,91,236,0.000333,0.475492,20,28529.54024,1584.974458,1426.477012,339.372055,10,0
0,0,24,24,20,43,63,131,85,216,0.000333,0.430364,10,12910.92464,717.273591,1291.092463,319.767946,9,0
0,0,24,24,20,44,64,131,87,218,0.000333,0.436,10,13080,726.666667,1308,326.653553,9,0
0,0,31,31,21,48,69,155,98,253,0.000333,0.515152,20,30909.13375,1717.174097,1545.456688,360.316866,12,0
0,0,31,31,21,48,69,155,98,253,0.000333,0.515152,20,30909.13375,1717.174097,1545.456688,360.316866,12,0
0,0,11,11,7,15,22,30,56,86,0.000333,0.127837,9,3451.600073,191.75556,383.511119,78.254843,1,0
0,0,12,12,9,20,29,44,63,107,0.000333,0.173268,12,6237.647598,346.535978,519.803966,114.967887,3,0
0,0,11,11,9,15,24,27,35,62,0.000333,0.094756,8,2274.1414,126.341189,284.267675,87.132684,1,0
0,0,12,12,11,20,31,45,43,88,0.000333,0.145323,10,4359.692753,242.205153,435.969275,124.49231,3,0
0,0,5,5,8,10,18,16,18,34,0.000333,0.047259,4,567.1098,31.5061,141.77745,57.219281,1,0
0,0,6,6,10,15,25,30,25,55,0.000333,0.085137,5,1277.060452,70.947803,255.41209,91.82264,3,0
0,0,28,28,21,47,68,145,92,237,0.000333,0.48091,10,14427.28693,801.515941,1442.728693,353.304342,10,0
0,0,28,28,21,47,68,145,92,237,0.000333,0.48091,10,14427.28693,801.515941,1442.728693,353.304342,10,0
0,0,28,28,21,46,67,145,91,236,0.000333,0.477199,10,14315.97049,795.331694,1431.597049,346.322516,10,0
0,0,28,28,21,46,67,145,91,236,0.000333,0.477199,10,14315.97049,795.331694,1431.597049,346.322516,10,0
0,0,10,10,8,18,26,23,41,64,0.000333,0.100276,8,2406.625136,133.701396,300.828142,99.05865,1,0
0,0,11,11,10,23,33,41,50,91,0.000333,0.153013,10,4590.398649,255.022147,459.039865,137.261206,3,0
0,0,6,6,8,15,23,16,25,41,0.000333,0.061822,4,741.864161,41.214676,185.46604,82.603359,1,0
0,0,7,7,10,20,30,30,32,62,0.000333,0.101409,5,1521.136085,84.50756,304.227217,119.657843,3,0
0,0,14,14,8,20,28,33,71,104,0.000333,0.166655,12,5999.578943,333.309941,499.964912,110.438562,1,0
0,0,15,15,10,25,35,51,80,131,0.000333,0.223979,15,10079.04113,559.946729,671.936075,149.315686,3,0
0,0,12,12,8,19,27,28,56,84,0.000333,0.133137,8,3195.284401,177.5158,399.41055,104.710623,1,0
0,0,13,13,10,24,34,46,65,111,0.000333,0.188236,10,5647.083754,313.726875,564.708375,143.258381,3,0
0,0,12,12,11,19,30,45,47,92,0.000333,0.150478,10,4514.339348,250.79663,451.433935,118.764371,3,0
0,0,11,11,10,19,29,42,44,86,0.000333,0.139262,10,4177.863656,232.103536,417.786366,113.929904,3,0
0,0,11,11,9,18,27,26,44,70,0.000333,0.110947,8,2662.737001,147.929833,332.842125,103.587975,1,0
0,0,12,12,11,23,34,44,53,97,0.000333,0.164495,10,4934.838956,274.15772,493.483896,142.095673,3,0
0,0,11,11,7,16,23,30,68,98,0.000333,0.14777,12,5319.70886,295.539381,443.309072,83.651484,1,0
0,0,12,12,9,21,30,44,75,119,0.000333,0.19464,12,7007.039771,389.279987,583.919981,120.767991,3,0
0,0,14,14,14,20,34,47,61,108,0.000333,0.183149,21,11538.36572,641.020318,549.445987,139.741531,3,0
0,0,13,13,12,16,28,33,54,87,0.000333,0.139413,18,7528.317808,418.239878,418.239878,107.01955,1,0
0,0,6,6,11,17,28,29,28,57,0.000333,0.09134,5,1370.096153,76.116453,274.019231,107.540616,3,0
0,0,5,5,9,12,21,15,21,36,0.000333,0.052708,4,632.493709,35.138539,158.123427,71.548875,1,0
0,0,12,12,13,21,34,43,47,90,0.000333,0.152624,12,5494.459869,305.24777,457.871656,140.344382,3,0
0,0,11,11,11,17,28,29,40,69,0.000333,0.110569,10,3317.074896,184.281939,331.70749,107.540616,1,0
0,0,6,6,11,18,29,31,28,59,0.000333,0.09554,5,1433.104394,79.616911,286.620879,113.112398,3,0
0,0,5,5,9,13,22,17,21,38,0.000333,0.056486,4,677.833606,37.657423,169.458402,76.635041,1,0
0,0,6,6,7,14,21,15,24,39,0.000333,0.0571,3,513.901138,28.550063,171.300379,72.954453,1,0
0,0,7,7,9,19,28,29,31,60,0.000333,0.096147,4,1153.765181,64.098066,288.441295,109.239948,3,0
0,0,14,14,14,22,36,51,62,113,0.000333,0.194734,14,8178.821352,454.378964,584.201525,151.410465,3,0
0,0,13,13,12,17,29,33,54,87,0.000333,0.140881,18,7607.598238,422.644347,422.644347,112.506418,1,0
0,0,6,6,11,17,28,29,27,56,0.000333,0.089737,5,1346.059378,74.781077,269.211876,107.540616,3,0
0,0,5,5,9,12,21,15,20,35,0.000333,0.051244,4,614.924439,34.162469,153.73111,71.548875,1,0
0,0,18,18,16,43,59,98,69,167,0.000333,0.327467,8,7859.211114,436.62284,982.401389,297.329384,7,0
0,0,18,18,17,42,59,99,68,167,0.000333,0.327467,8,7859.211114,436.62284,982.401389,295.9642,7,0
0,0,19,19,18,44,62,101,73,174,0.000333,0.345343,9,9324.271422,518.015079,1036.030158,315.273641,7,0
0,0,19,19,18,44,62,101,73,174,0.000333,0.345343,9,9324.271422,518.015079,1036.030158,315.273641,7,0
0,0,21,21,18,45,63,109,84,193,0.000333,0.384538,9,10382.53523,576.807513,1153.615025,322.192039,7,0
0,0,21,21,19,47,66,110,85,195,0.000333,0.392886,9,10607.91168,589.328427,1178.656853,341.776299,7,0
0,0,19,19,18,44,62,101,73,174,0.000333,0.345343,9,9324.271422,518.015079,1036.030158,315.273641,7,0
0,0,19,19,18,44,62,101,73,174,0.000333,0.345343,9,9324.271422,518.015079,1036.030158,315.273641,7,0
0,0,19,19,19,43,62,102,72,174,0.000333,0.345343,9,9324.271422,518.015079,1036.030158,314.040007,7,0
0,0,13,13,9,19,28,31,46,77,0.000333,0.123389,8,2961.330632,164.518368,370.166329,109.239948,1,0
0,0,14,14,11,24,35,49,54,103,0.000333,0.176105,10,5283.161507,293.508973,528.316151,148.092848,3,0
0,0,13,13,10,18,28,37,43,80,0.000333,0.128196,10,3845.883938,213.660219,384.588394,108.277931,1,0
0,0,14,14,12,24,36,55,51,106,0.000333,0.182671,12,6576.144602,365.341367,548.01205,153.05865,3,0
0,0,6,6,7,14,21,15,23,38,0.000333,0.055636,3,500.724186,27.81801,166.908062,72.954453,1,0
0,0,7,7,9,19,28,29,30,59,0.000333,0.094545,4,1134.535762,63.029765,283.63394,109.239948,3,0
0,0,19,19,18,44,62,101,73,174,0.000333,0.345343,9,9324.271422,518.015079,1036.030158,315.273641,7,0
0,0,12,12,13,23,36,47,48,95,0.000333,0.163714,12,5893.714502,327.428583,491.142875,152.147641,3,0
0,0,11,11,11,18,29,29,40,69,0.000333,0.111734,10,3352.006887,186.222605,335.200689,113.112398,1,0
0,0,6,6,11,18,29,31,27,58,0.000333,0.093921,5,1408.814489,78.267472,281.762898,113.112398,3,0
0,0,5,5,9,13,22,17,20,37,0.000333,0.055,4,659.99588,36.666438,164.99897,76.635041,1,0
0,0,11,11,9,18,27,26,35,61,0.000333,0.096683,4,1160.192551,64.455142,290.048138,103.587975,1,0
0,0,12,12,11,23,34,44,44,88,0.000333,0.149232,5,2238.48365,124.360203,447.69673,142.095673,3,0
0,0,10,10,8,13,21,23,31,54,0.000333,0.079062,8,1897.481127,105.415618,237.185141,72.105716,1,0
0,0,11,11,10,18,28,41,40,81,0.000333,0.129799,10,3893.957487,216.330971,389.395749,108.277931,3,0
0,0,10,10,9,13,22,26,31,57,0.000333,0.084729,8,2033.500818,112.972268,254.187602,76.635041,1,0
0,0,11,11,11,18,29,44,40,84,0.000333,0.136023,10,4080.704036,226.70578,408.070404,113.112398,3,0
0,0,12,12,10,19,29,46,46,92,0.000333,0.148978,10,4469.342516,248.296806,446.934252,113.929904,4,0
0,0,12,12,10,19,29,46,46,92,0.000333,0.148978,10,4469.342516,248.296806,446.934252,113.929904,4,0
0,0,11,11,9,14,23,28,34,62,0.000333,0.093487,8,2243.68673,124.649263,280.460841,81.832294,2,0
0,0,12,12,10,22,32,45,52,97,0.000333,0.161667,10,4850,269.444444,485,131.326777,4,0
0,0,12,12,10,22,32,45,52,97,0.000333,0.161667,10,4850,269.444444,485,131.326777,4,0
0,0,11,11,9,17,26,27,40,67,0.000333,0.104976,8,2519.435689,139.968649,314.929461,98.016193,2,0
0,0,12,12,13,20,33,55,45,100,0.000333,0.168146,12,6053.272943,336.292941,504.439412,134.544278,5,0
0,0,11,11,11,15,26,37,36,73,0.000333,0.114377,10,3431.320994,190.628944,343.132099,96.657107,3,0
0,0,9,9,10,17,27,37,32,69,0.000333,0.109362,5,1640.436188,91.135344,328.087238,102.706149,3,0
0,0,8,8,8,12,20,19,23,42,0.000333,0.060507,4,726.08392,40.337996,181.52098,67.01955,1,0
0,0,11,11,9,13,22,28,35,63,0.000333,0.093648,8,2247.553536,124.864085,280.944192,76.635041,1,0
0,0,12,12,11,18,29,46,44,90,0.000333,0.145739,10,4372.182896,242.89905,437.21829,113.112398,3,0
0,0,19,19,18,44,62,101,73,174,0.000333,0.345343,9,9324.271422,518.015079,1036.030158,315.273641,7,0
0,0,18,18,16,43,59,98,69,167,0.000333,0.327467,8,7859.211114,436.62284,982.401389,297.329384,7,0
0,0,18,18,17,42,59,99,68,167,0.000333,0.327467,8,7859.211114,436.62284,982.401389,295.9642,7,0
0,0,19,19,18,44,62,101,73,174,0.000333,0.345343,9,9324.271422,518.015079,1036.030158,315.273641,7,0
0,0,19,19,18,44,62,101,73,174,0.000333,0.345343,9,9324.271422,518.015079,1036.030158,315.273641,7,0
0,0,30,30,21,47,68,151,100,251,0.000333,0.509318,20,30559.06346,1697.725748,1527.953173,353.304342,10,0
0,0,30,30,21,47,68,151,100,251,0.000333,0.509318,20,30559.06346,1697.725748,1527.953173,353.304342,10,0
0,0,25,25,20,52,72,126,103,229,0.000333,0.470971,10,14129.12825,784.95157,1412.912825,382.861427,9,0
0,0,25,25,21,53,74,127,109,236,0.000333,0.488477,20,29308.61989,1628.25666,1465.430994,395.81845,9,0
0,0,22,22,19,47,66,115,82,197,0.000333,0.396915,9,10716.71077,595.372821,1190.745642,341.776299,9,0
0,0,6,6,11,18,29,29,31,60,0.000333,0.09716,5,1457.394299,80.96635,291.47886,113.112398,3,0
0,0,5,5,9,13,22,15,24,39,0.000333,0.057973,4,695.671333,38.648407,173.917833,76.635041,1,0
0,0,33,33,21,51,72,164,110,274,0.000333,0.56352,20,33811.18901,1878.399389,1690.55945,381.532358,12,0
0,0,33,33,21,51,72,164,110,274,0.000333,0.56352,20,33811.18901,1878.399389,1690.55945,381.532358,12,0
0,0,18,18,16,43,59,98,69,167,0.000333,0.327467,8,7859.211114,436.62284,982.401389,297.329384,7,0
0,0,18,18,17,42,59,99,68,167,0.000333,0.327467,8,7859.211114,436.62284,982.401389,295.9642,7,0
0,0,33,33,21,51,72,164,111,275,0.000333,0.565576,20,33934.58751,1885.254862,1696.729375,381.532358,12,0
0,0,33,33,21,51,72,164,111,275,0.000333,0.565576,20,33934.58751,1885.254862,1696.729375,381.532358,12,0
0,0,32,32,21,50,71,161,107,268,0.000333,0.549377,20,32962.64456,1831.258031,1648.132228,374.431475,11,0
0,0,33,33,21,50,71,164,110,274,0.000333,0.561677,20,33700.61422,1872.256345,1685.030711,374.431475,12,0
0,0,33,33,21,50,71,164,110,274,0.000333,0.561677,20,33700.61422,1872.256345,1685.030711,374.431475,12,0
0,0,33,33,21,52,73,164,111,275,0.000333,0.567401,20,34044.03507,1891.335282,1702.201754,388.661531,12,0
0,0,33,33,21,52,73,164,111,275,0.000333,0.567401,20,34044.03507,1891.335282,1702.201754,388.661531,12,0
0,0,22,22,18,49,67,114,84,198,0.000333,0.400362,9,10809.77094,600.54283,1201.08566,350.179432,9,0
0,0,33,33,21,52,73,164,111,275,0.000333,0.567401,20,34044.03507,1891.335282,1702.201754,388.661531,12,0
0,0,33,33,21,52,73,164,111,275,0.000333,0.567401,20,34044.03507,1891.335282,1702.201754,388.661531,12,0
0,0,33,33,21,51,72,164,110,274,0.000333,0.56352,20,33811.18901,1878.399389,1690.55945,381.532358,12,0
0,0,33,33,21,51,72,164,110,274,0.000333,0.56352,20,33811.18901,1878.399389,1690.55945,381.532358,12,0
0,0,33,33,21,51,72,164,110,274,0.000333,0.56352,20,33811.18901,1878.399389,1690.55945,381.532358,12,0
0,0,33,33,21,51,72,164,110,274,0.000333,0.56352,20,33811.18901,1878.399389,1690.55945,381.532358,12,0
0,0,30,30,21,47,68,151,100,251,0.000333,0.509318,20,30559.06346,1697.725748,1527.953173,353.304342,10,0
0,0,30,30,21,47,68,151,100,251,0.000333,0.509318,20,30559.06346,1697.725748,1527.953173,353.304342,10,0
0,0,32,32,22,47,69,155,103,258,0.000333,0.525333,22,34671.98482,1926.221379,1575.99931,359.173172,10,0
0,0,32,32,22,47,69,155,103,258,0.000333,0.525333,22,34671.98482,1926.221379,1575.99931,359.173172,10,0
0,0,29,29,21,46,67,145,91,236,0.000333,0.477199,10,14315.97049,795.331694,1431.597049,346.322516,10,0
0,0,35,35,23,48,71,174,114,288,0.000333,0.590376,22,38964.79775,2164.710986,1771.12717,372.120125,10,0
0,0,29,29,22,45,67,146,90,236,0.000333,0.477199,22,31495.13508,1749.729726,1431.597049,345.240885,10,0
0,0,30,30,21,48,69,151,101,252,0.000333,0.513116,20,30786.96326,1710.386848,1539.348163,360.316866,10,0
0,0,30,30,21,48,69,151,101,252,0.000333,0.513116,20,30786.96326,1710.386848,1539.348163,360.316866,10,0
0,0,30,30,21,48,69,151,101,252,0.000333,0.513116,20,30786.96326,1710.386848,1539.348163,360.316866,10,0
0,0,30,30,21,48,69,151,101,252,0.000333,0.513116,20,30786.96326,1710.386848,1539.348163,360.316866,10,0
0,0,30,30,21,46,67,151,98,249,0.000333,0.503485,20,30209.12417,1678.284676,1510.456208,346.322516,10,0
0,0,29,29,21,46,67,148,97,245,0.000333,0.495397,20,29723.83703,1651.32428,1486.191852,346.322516,9,0
0,0,20,20,18,44,62,104,74,178,0.000333,0.353282,9,9538.622489,529.923472,1059.846943,315.273641,8,0
0,0,20,20,19,43,62,105,73,178,0.000333,0.353282,9,9538.622489,529.923472,1059.846943,314.040007,8,0
0,0,20,20,19,45,64,104,74,178,0.000333,0.356,9,9612,534,1068,327.844012,8,0
0,0,20,20,20,44,64,105,73,178,0.000333,0.356,10,10680,593.333333,1068,326.653553,8,0
0,0,20,20,20,44,64,105,73,178,0.000333,0.356,10,10680,593.333333,1068,326.653553,8,0
0,0,20,20,18,46,64,104,75,179,0.000333,0.358,9,9666,537,1074,329.1425,8,0
0,0,20,20,19,45,64,105,74,179,0.000333,0.358,9,9666,537,1074,327.844012,8,0
0,0,20,20,19,45,64,105,74,179,0.000333,0.358,9,9666,537,1074,327.844012,8,0
0,0,19,19,18,44,62,101,73,174,0.000333,0.345343,9,9324.271422,518.015079,1036.030158,315.273641,7,0
0,0,19,19,19,43,62,102,72,174,0.000333,0.345343,9,9324.271422,518.015079,1036.030158,314.040007,7,0
0,0,19,19,19,43,62,102,72,174,0.000333,0.345343,9,9324.271422,518.015079,1036.030158,314.040007,7,0
0,0,19,19,18,44,62,101,73,174,0.000333,0.345343,9,9324.271422,518.015079,1036.030158,315.273641,7,0
0,0,19,19,19,43,62,102,72,174,0.000333,0.345343,9,9324.271422,518.015079,1036.030158,314.040007,7,0
0,0,19,19,19,43,62,102,72,174,0.000333,0.345343,9,9324.271422,518.015079,1036.030158,314.040007,7,0
0,0,19,19,18,44,62,101,73,174,0.000333,0.345343,9,9324.271422,518.015079,1036.030158,315.273641,7,0
0,0,19,19,19,43,62,102,72,174,0.000333,0.345343,9,9324.271422,518.015079,1036.030158,314.040007,7,0
0,0,20,20,18,47,65,104,76,180,0.000333,0.361342,9,9756.235857,542.013103,1084.026206,336.124326,8,0
0,0,20,20,19,45,64,105,74,179,0.000333,0.358,9,9666,537,1074,327.844012,8,0
0,0,20,20,19,45,64,105,74,179,0.000333,0.358,9,9666,537,1074,327.844012,8,0
0,0,21,21,18,45,63,110,79,189,0.000333,0.376569,9,10167.35315,564.852953,1129.705906,322.192039,7,0
0,0,21,21,19,44,63,111,78,189,0.000333,0.376569,9,10167.35315,564.852953,1129.705906,320.925614,7,0
0,0,19,19,18,44,62,101,73,174,0.000333,0.345343,9,9324.271422,518.015079,1036.030158,315.273641,7,0
0,0,19,19,19,43,62,102,72,174,0.000333,0.345343,9,9324.271422,518.015079,1036.030158,314.040007,7,0
0,0,11,11,9,13,22,28,31,59,0.000333,0.087702,8,2104.851724,116.936207,263.106465,76.635041,1,0
0,0,12,12,11,18,29,46,39,85,0.000333,0.137643,10,4129.283846,229.404658,412.928385,113.112398,3,0
0,0,11,11,10,19,29,43,34,77,0.000333,0.124688,5,1870.322683,103.906816,374.064537,113.929904,5,0
0,0,11,11,10,18,28,43,34,77,0.000333,0.123389,5,1850.831645,102.82398,370.166329,108.277931,5,0
0,0,10,10,9,14,23,25,25,50,0.000333,0.075393,4,904.712391,50.2618,226.178098,81.832294,3,0
0,0,10,10,9,13,22,25,25,50,0.000333,0.074324,4,891.886324,49.54924,222.971581,76.635041,3,0
0,0,11,11,11,19,30,44,36,80,0.000333,0.13085,5,1962.756238,109.042013,392.551248,118.764371,5,0
0,0,11,11,10,19,29,43,36,79,0.000333,0.127927,5,1918.902493,106.605694,383.780499,113.929904,5,0
0,0,10,10,10,14,24,26,27,53,0.000333,0.081001,5,1215.015063,67.500837,243.003013,86.52225,3,0
0,0,10,10,9,14,23,25,27,52,0.000333,0.078408,4,940.900887,52.272271,235.225222,81.832294,3,0
0,0,9,9,10,17,27,37,32,69,0.000333,0.109362,5,1640.436188,91.135344,328.087238,102.706149,3,0
0,0,11,11,10,18,28,43,34,77,0.000333,0.123389,5,1850.831645,102.82398,370.166329,108.277931,5,0
0,0,11,11,10,18,28,43,34,77,0.000333,0.123389,5,1850.831645,102.82398,370.166329,108.277931,5,0
0,0,11,11,11,18,29,44,36,80,0.000333,0.129546,10,3886.384796,215.910266,388.63848,113.112398,5,0
0,0,11,11,10,18,28,43,36,79,0.000333,0.126594,10,3797.810388,210.989466,379.781039,108.277931,5,0
0,0,11,11,10,19,29,43,34,77,0.000333,0.124688,5,1870.322683,103.906816,374.064537,113.929904,5,0
0,0,11,11,10,18,28,43,34,77,0.000333,0.123389,5,1850.831645,102.82398,370.166329,108.277931,5,0
0,0,11,11,9,18,27,26,32,58,0.000333,0.091928,4,1103.133901,61.285217,275.783475,103.587975,1,0
0,0,12,12,11,23,34,44,40,84,0.000333,0.142449,5,2136.734393,118.707466,427.346879,142.095673,3,0
0,0,10,10,9,13,22,26,27,53,0.000333,0.078783,8,1890.799006,105.044389,236.349876,76.635041,1,0
0,0,11,11,11,18,29,44,35,79,0.000333,0.127927,5,1918.902493,106.605694,383.780499,113.112398,3,0
0,0,10,10,8,13,21,23,27,50,0.000333,0.073205,8,1756.926969,97.607054,219.615871,72.105716,1,0
0,0,11,11,10,18,28,41,35,76,0.000333,0.121786,5,1826.79487,101.488604,365.358974,108.277931,3,0
0,0,12,12,10,22,32,45,48,93,0.000333,0.155,10,4650,258.333333,465,131.326777,4,0
0,0,12,12,10,22,32,45,48,93,0.000333,0.155,10,4650,258.333333,465,131.326777,4,0
0,0,11,11,9,17,26,27,37,64,0.000333,0.100276,8,2406.625136,133.701396,300.828142,98.016193,2,0
0,0,12,12,10,19,29,46,42,88,0.000333,0.142501,10,4275.023276,237.501293,427.502328,113.929904,4,0
0,0,12,12,10,19,29,46,42,88,0.000333,0.142501,10,4275.023276,237.501293,427.502328,113.929904,4,0
0,0,11,11,9,14,23,28,31,59,0.000333,0.088963,8,2135.121243,118.617847,266.890155,81.832294,2,0
0,0,9,9,11,16,27,35,28,63,0.000333,0.099853,5,1497.789563,83.210531,299.557913,102.053748,4,0
0,0,9,9,10,16,26,34,28,62,0.000333,0.097142,5,1457.136313,80.952017,291.427263,97.219281,4,0
0,0,10,10,10,12,22,26,25,51,0.000333,0.07581,10,2274.310126,126.350563,227.431013,76.238831,3,0
0,0,10,10,9,12,21,25,25,50,0.000333,0.073205,8,1756.926969,97.607054,219.615871,71.548875,3,0
0,0,35,35,19,50,69,163,131,294,0.000333,0.598635,18,32326.31143,1795.90619,1795.90619,362.903432,9,0
0,0,35,35,21,52,73,166,138,304,0.000333,0.627236,20,37634.13332,2090.785184,1881.706666,388.661531,9,0
0,0,6,6,8,14,22,16,22,38,0.000333,0.056486,4,677.833606,37.657423,169.458402,77.302969,1,0
0,0,7,7,10,19,29,30,29,59,0.000333,0.09554,5,1433.104394,79.616911,286.620879,113.929904,3,0
0,0,29,29,19,47,66,145,101,246,0.000333,0.49564,18,26764.57716,1486.920953,1486.920953,341.776299,9,0
0,0,29,29,21,49,70,148,102,250,0.000333,0.510774,20,30646.41509,1702.578616,1532.320754,367.359448,9,0
0,0,10,10,8,15,23,24,33,57,0.000333,0.085948,8,2062.744252,114.596903,257.843031,82.603359,1,0
0,0,11,11,10,20,30,42,41,83,0.000333,0.135757,10,4072.719194,226.262177,407.271919,119.657843,3,0
0,0,29,29,21,47,68,145,102,247,0.000333,0.501201,20,30072.06644,1670.670358,1503.603322,353.304342,9,0
0,0,29,29,22,48,70,146,108,254,0.000333,0.518946,22,34250.4335,1902.801861,1556.837886,366.185696,9,0
0,0,27,27,19,44,63,137,87,224,0.000333,0.446304,9,12050.19633,669.455351,1338.910703,320.925614,9,0
0,0,27,27,20,45,65,138,88,226,0.000333,0.453685,10,13610.55126,756.141737,1361.055126,333.571951,9,0
0,0,27,27,19,45,64,135,90,225,0.000333,0.45,18,24300,1350,1350,327.844012,9,0
0,0,27,27,20,47,67,136,90,226,0.000333,0.456979,10,13709.36157,761.631198,1370.936157,347.504238,9,0
0,0,29,29,21,46,67,148,97,245,0.000333,0.495397,20,29723.83703,1651.32428,1486.191852,346.322516,9,0
0,0,27,27,19,45,64,135,90,225,0.000333,0.45,18,24300,1350,1350,327.844012,9,0
0,0,27,27,20,47,67,136,90,226,0.000333,0.456979,10,13709.36157,761.631198,1370.936157,347.504238,9,0
0,0,31,31,19,48,67,156,108,264,0.000333,0.533816,18,28826.05583,1601.447546,1601.447546,348.788823,9,0
0,0,31,31,21,50,71,159,109,268,0.000333,0.549377,20,32962.64456,1831.258031,1648.132228,374.431475,9,0
0,0,9,9,10,16,26,34,27,61,0.000333,0.095576,5,1433.634114,79.64634,286.726823,97.219281,4,0
0,0,9,9,10,16,26,34,27,61,0.000333,0.095576,5,1433.634114,79.64634,286.726823,97.219281,4,0
0,0,10,10,9,13,22,25,23,48,0.000333,0.071351,4,856.210871,47.567271,214.052718,76.635041,3,0
0,0,10,10,9,12,21,25,23,48,0.000333,0.070277,4,843.324945,46.851386,210.831236,71.548875,3,0
0,0,9,9,10,16,26,34,27,61,0.000333,0.095576,5,1433.634114,79.64634,286.726823,97.219281,4,0
0,0,9,9,10,16,26,34,27,61,0.000333,0.095576,5,1433.634114,79.64634,286.726823,97.219281,4,0
0,0,10,10,9,13,22,25,23,48,0.000333,0.071351,4,856.210871,47.567271,214.052718,76.635041,3,0
0,0,10,10,9,12,21,25,23,48,0.000333,0.070277,4,843.324945,46.851386,210.831236,71.548875,3,0
0,0,24,24,18,49,67,122,94,216,0.000333,0.436758,9,11792.47739,655.137633,1310.275265,350.179432,9,0
0,0,24,24,19,51,70,123,95,218,0.000333,0.445395,9,12025.65328,668.091849,1336.183698,370.004315,9,0
0,0,17,17,17,42,59,100,71,171,0.000333,0.335311,8,8047.455692,447.080872,1005.931961,295.9642,7,0
0,0,17,17,17,43,60,100,73,173,0.000333,0.340631,8,8175.136584,454.174255,1021.892073,302.816253,7,0
0,0,22,22,20,47,67,113,89,202,0.000333,0.40845,10,12253.50017,680.750009,1225.350016,347.504238,7,0
0,0,22,22,21,48,69,114,95,209,0.000333,0.425561,10,12766.81612,709.267562,1276.681611,360.316866,7,0
0,0,19,19,18,44,62,101,73,174,0.000333,0.345343,9,9324.271422,518.015079,1036.030158,315.273641,7,0
0,0,19,19,19,43,62,102,72,174,0.000333,0.345343,9,9324.271422,518.015079,1036.030158,314.040007,7,0
0,0,19,19,18,44,62,101,73,174,0.000333,0.345343,9,9324.271422,518.015079,1036.030158,315.273641,7,0
0,0,19,19,19,43,62,102,72,174,0.000333,0.345343,9,9324.271422,518.015079,1036.030158,314.040007,7,0
0,0,31,31,21,49,70,155,104,259,0.000333,0.529161,20,31749.68603,1763.871446,1587.484301,367.359448,9,0
0,0,19,19,19,43,62,102,72,174,0.000333,0.345343,9,9324.271422,518.015079,1036.030158,314.040007,7,0
0,0,12,12,9,17,26,37,40,77,0.000333,0.120645,8,2895.470866,160.859493,361.933858,98.016193,1,0
0,0,13,13,11,22,33,53,47,100,0.000333,0.168146,10,5044.394119,280.244118,504.439412,136.161243,3,0
0,0,23,23,18,50,68,117,85,202,0.000333,0.409889,9,11067.00745,614.833747,1229.667494,357.25146,10,0
0,0,23,23,19,48,67,118,83,201,0.000333,0.406428,9,10973.55535,609.641964,1219.283927,348.788823,10,0
0,0,23,23,19,48,67,118,83,201,0.000333,0.406428,9,10973.55535,609.641964,1219.283927,348.788823,10,0
0,0,23,23,18,50,68,117,86,203,0.000333,0.411918,9,11121.79461,617.877478,1235.754957,357.25146,10,0
0,0,23,23,19,48,67,118,84,202,0.000333,0.40845,9,11028.15015,612.675008,1225.350016,348.788823,10,0
0,0,23,23,19,48,67,118,84,202,0.000333,0.40845,9,11028.15015,612.675008,1225.350016,348.788823,10,0
0,0,23,23,18,50,68,117,85,202,0.000333,0.409889,9,11067.00745,614.833747,1229.667494,357.25146,10,0
0,0,23,23,19,48,67,118,83,201,0.000333,0.406428,9,10973.55535,609.641964,1219.283927,348.788823,10,0
0,0,23,23,19,48,67,118,83,201,0.000333,0.406428,9,10973.55535,609.641964,1219.283927,348.788823,10,0
0,0,22,22,18,49,67,114,84,198,0.000333,0.400362,9,10809.77094,600.54283,1201.08566,350.179432,9,0
0,0,22,22,19,47,66,115,82,197,0.000333,0.396915,9,10716.71077,595.372821,1190.745642,341.776299,9,0
0,0,23,23,18,49,67,117,85,202,0.000333,0.40845,9,11028.15015,612.675008,1225.350016,350.179432,10,0
0,0,23,23,19,47,66,118,83,201,0.000333,0.404974,9,10934.30896,607.461609,1214.923218,341.776299,10,0
0,0,23,23,19,47,66,118,83,201,0.000333,0.404974,9,10934.30896,607.461609,1214.923218,341.776299,10,0
0,0,23,23,18,51,69,117,86,203,0.000333,0.413343,9,11160.27418,620.015232,1240.030465,364.352342,10,0
0,0,23,23,19,49,68,118,84,202,0.000333,0.409889,9,11067.00745,614.833747,1229.667494,355.831405,10,0
0,0,23,23,19,49,68,118,84,202,0.000333,0.409889,9,11067.00745,614.833747,1229.667494,355.831405,10,0
0,0,25,25,20,50,70,122,88,210,0.000333,0.42905,10,12871.49434,715.083019,1287.149434,368.631371,10,0
0,0,25,25,20,48,68,123,86,209,0.000333,0.424093,10,12722.79734,706.822074,1272.279734,354.516762,10,0
0,0,25,25,20,48,68,123,86,209,0.000333,0.424093,10,12722.79734,706.822074,1272.279734,354.516762,10,0
0,0,23,23,18,50,68,117,85,202,0.000333,0.409889,9,11067.00745,614.833747,1229.667494,357.25146,10,0
0,0,23,23,19,48,67,118,83,201,0.000333,0.406428,9,10973.55535,609.641964,1219.283927,348.788823,10,0
0,0,23,23,19,48,67,118,83,201,0.000333,0.406428,9,10973.55535,609.641964,1219.283927,348.788823,10,0
0,0,23,23,18,51,69,117,86,203,0.000333,0.413343,9,11160.27418,620.015232,1240.030465,364.352342,10,0
0,0,23,23,19,49,68,118,84,202,0.000333,0.409889,9,11067.00745,614.833747,1229.667494,355.831405,10,0
0,0,23,23,19,49,68,118,84,202,0.000333,0.409889,9,11067.00745,614.833747,1229.667494,355.831405,10,0
0,0,34,34,21,53,74,168,114,282,0.000333,0.583689,20,35021.31698,1945.628721,1751.065849,395.81845,11,0
0,0,39,39,23,58,81,189,135,324,0.000333,0.684704,22,45190.45082,2510.580601,2054.111401,443.804823,12,0
0,0,34,34,21,55,76,167,121,288,0.000333,0.599801,20,35988.06248,1999.336804,1799.403124,410.21345,11,0
0,0,30,30,19,50,69,148,102,250,0.000333,0.509044,18,27488.36006,1527.131114,1527.131114,362.903432,11,0
0,0,30,30,20,52,72,149,101,250,0.000333,0.51416,10,15424.8125,856.934028,1542.48125,382.861427,11,0
0,0,10,10,9,14,23,25,34,59,0.000333,0.088963,8,2135.121243,118.617847,266.890155,81.832294,1,0
0,0,11,11,11,18,29,39,41,80,0.000333,0.129546,10,3886.384796,215.910266,388.63848,113.112398,3,0
0,0,12,12,10,23,33,40,56,96,0.000333,0.161421,10,4842.618355,269.034353,484.261835,137.261206,4,0
0,0,12,12,10,23,33,40,56,96,0.000333,0.161421,10,4842.618355,269.034353,484.261835,137.261206,4,0
0,0,11,11,9,19,28,26,46,72,0.000333,0.115377,8,2769.036435,153.835358,346.129554,109.239948,2,0
0,0,12,12,10,19,29,41,47,88,0.000333,0.142501,10,4275.023276,237.501293,427.502328,113.929904,4,0
0,0,12,12,10,19,29,41,47,88,0.000333,0.142501,10,4275.023276,237.501293,427.502328,113.929904,4,0
0,0,11,11,9,15,24,27,37,64,0.000333,0.097813,8,2347.5008,130.416711,293.4376,87.132684,2,0
0,0,11,11,9,14,23,27,38,65,0.000333,0.098011,8,2352.252217,130.680679,294.031527,81.832294,1,0
0,0,12,12,11,18,29,41,45,86,0.000333,0.139262,10,4177.863656,232.103536,417.786366,113.112398,3,0
0,0,10,10,8,14,22,24,35,59,0.000333,0.087702,8,2104.851724,116.936207,263.106465,77.302969,1,0
0,0,11,11,10,18,28,38,42,80,0.000333,0.128196,10,3845.883938,213.660219,384.588394,108.277931,3,0
0,0,19,19,18,44,62,101,73,174,0.000333,0.345343,9,9324.271422,518.015079,1036.030158,315.273641,7,0
0,0,19,19,19,43,62,102,72,174,0.000333,0.345343,9,9324.271422,518.015079,1036.030158,314.040007,7,0
0,0,11,11,9,16,25,27,35,62,0.000333,0.095973,8,2303.35267,127.964037,287.919084,92.529325,1,0
0,0,11,11,11,20,31,39,40,79,0.000333,0.130461,10,3913.815085,217.434171,391.381509,124.49231,3,0
0,0,6,6,8,14,22,16,21,37,0.000333,0.055,4,659.99588,36.666438,164.99897,77.302969,1,0
0,0,7,7,10,19,29,30,28,58,0.000333,0.093921,5,1408.814489,78.267472,281.762898,113.929904,3,0
0,0,31,31,19,47,66,148,108,256,0.000333,0.515788,18,27852.5681,1547.364895,1547.364895,341.776299,9,0
0,0,31,31,21,49,70,151,111,262,0.000333,0.535291,20,32117.44301,1784.302389,1605.87215,367.359448,9,0
0,0,11,11,10,20,30,42,37,79,0.000333,0.129215,5,1938.221785,107.678988,387.644357,119.657843,5,0
0,0,11,11,10,19,29,42,37,79,0.000333,0.127927,5,1918.902493,106.605694,383.780499,113.929904,5,0
0,0,10,10,9,15,24,24,28,52,0.000333,0.079473,4,953.6722,52.981789,238.41805,87.132684,3,0
0,0,10,10,9,14,23,24,28,52,0.000333,0.078408,8,1881.801774,104.544543,235.225222,81.832294,3,0
0,0,6,6,7,14,21,15,24,39,0.000333,0.0571,3,513.901138,28.550063,171.300379,72.954453,1,0
0,0,7,7,9,19,28,29,31,60,0.000333,0.096147,4,1153.765181,64.098066,288.441295,109.239948,3,0
0,0,11,11,9,16,25,29,36,65,0.000333,0.100617,8,2414.805219,134.155845,301.850652,92.529325,1,0
0,0,11,11,11,20,31,41,41,82,0.000333,0.135415,10,4062.440975,225.691165,406.244097,124.49231,3,0
0,0,11,11,11,20,31,43,39,82,0.000333,0.135415,5,2031.220487,112.845583,406.244097,124.49231,5,0
0,0,11,11,10,20,30,42,39,81,0.000333,0.132486,5,1987.290691,110.405038,397.458138,119.657843,5,0
0,0,10,10,10,15,25,25,30,55,0.000333,0.085137,10,2554.120904,141.895606,255.41209,91.82264,3,0
0,0,10,10,9,15,24,24,30,54,0.000333,0.082529,8,1980.7038,110.0391,247.587975,87.132684,3,0
0,0,5,5,7,12,19,15,20,35,0.000333,0.049559,3,446.032389,24.779577,148.677463,62.671034,1,0
0,0,6,6,9,17,26,29,27,56,0.000333,0.087742,4,1052.898497,58.494361,263.224624,98.016193,3,0
0,0,12,12,9,17,26,37,40,77,0.000333,0.120645,8,2895.470866,160.859493,361.933858,98.016193,1,0
0,0,12,12,11,21,32,49,45,94,0.000333,0.156667,10,4700,261.111111,470,130.292414,3,0
0,0,11,11,11,20,31,43,39,82,0.000333,0.135415,5,2031.220487,112.845583,406.244097,124.49231,5,0
0,0,11,11,10,20,30,42,39,81,0.000333,0.132486,5,1987.290691,110.405038,397.458138,119.657843,5,0
0,0,10,10,10,15,25,25,30,55,0.000333,0.085137,10,2554.120904,141.895606,255.41209,91.82264,3,0
0,0,10,10,9,15,24,24,30,54,0.000333,0.082529,8,1980.7038,110.0391,247.587975,87.132684,3,0
0,0,11,11,11,20,31,43,39,82,0.000333,0.135415,5,2031.220487,112.845583,406.244097,124.49231,5,0
0,0,11,11,10,20,30,42,39,81,0.000333,0.132486,5,1987.290691,110.405038,397.458138,119.657843,5,0
0,0,10,10,10,15,25,25,30,55,0.000333,0.085137,10,2554.120904,141.895606,255.41209,91.82264,3,0
0,0,10,10,9,15,24,24,30,54,0.000333,0.082529,8,1980.7038,110.0391,247.587975,87.132684,3,0
0,0,22,22,18,48,66,114,83,197,0.000333,0.396915,9,10716.71077,595.372821,1190.745642,343.13685,9,0
0,0,22,22,19,47,66,115,82,197,0.000333,0.396915,9,10716.71077,595.372821,1190.745642,341.776299,9,0
0,0,22,22,18,48,66,114,83,197,0.000333,0.396915,9,10716.71077,595.372821,1190.745642,343.13685,9,0
0,0,22,22,18,48,66,114,83,197,0.000333,0.396915,9,10716.71077,595.372821,1190.745642,343.13685,9,0
0,0,22,22,18,48,66,114,83,197,0.000333,0.396915,9,10716.71077,595.372821,1190.745642,343.13685,9,0
0,0,24,24,18,49,67,122,94,216,0.000333,0.436758,9,11792.47739,655.137633,1310.275265,350.179432,9,0
0,0,24,24,19,51,70,123,95,218,0.000333,0.445395,9,12025.65328,668.091849,1336.183698,370.004315,9,0
0,0,22,22,18,48,66,114,83,197,0.000333,0.396915,9,10716.71077,595.372821,1190.745642,343.13685,9,0
0,0,21,21,16,47,63,111,79,190,0.000333,0.378561,8,9085.465484,504.748082,1135.683185,325.065676,9,0
0,0,21,21,17,46,63,112,78,190,0.000333,0.378561,8,9085.465484,504.748082,1135.683185,323.570718,9,0
0,0,27,27,21,50,71,125,89,214,0.000333,0.438682,10,13160.45884,731.136602,1316.045884,374.431475,11,0
0,0,27,27,21,50,71,125,89,214,0.000333,0.438682,10,13160.45884,731.136602,1316.045884,374.431475,11,0
0,0,10,10,9,13,22,25,23,48,0.000333,0.071351,4,856.210871,47.567271,214.052718,76.635041,3,0
0,0,10,10,9,13,22,25,23,48,0.000333,0.071351,4,856.210871,47.567271,214.052718,76.635041,3,0
0,0,27,27,20,48,68,125,89,214,0.000333,0.434239,10,13027.17048,723.731693,1302.717048,354.516762,11,0
0,0,10,10,9,12,21,25,23,48,0.000333,0.070277,4,843.324945,46.851386,210.831236,71.548875,3,0
0,0,28,28,23,50,73,137,100,237,0.000333,0.488996,22,32273.74525,1792.985847,1466.98842,386.234734,11,0
0,0,11,11,11,14,25,37,34,71,0.000333,0.109905,10,3297.137895,183.174327,329.713789,91.356717,3,0
0,0,25,25,20,48,68,119,87,206,0.000333,0.418006,10,12540.17345,696.676303,1254.017345,354.516762,9,0
0,0,8,8,8,11,19,19,21,40,0.000333,0.056639,4,679.668402,37.759356,169.917101,62.053748,1,0
0,0,31,31,21,50,71,133,95,228,0.000333,0.467381,10,14021.42343,778.967968,1402.142343,374.431475,11,0
0,0,31,31,21,49,70,133,95,228,0.000333,0.465826,10,13974.76528,776.375849,1397.476528,367.359448,11,0
0,0,14,14,10,14,24,33,29,62,0.000333,0.094756,10,2842.67675,157.926486,284.267675,86.52225,3,0
0,0,14,14,10,13,23,33,29,62,0.000333,0.093487,10,2804.608413,155.811578,280.460841,81.324997,3,0
0,0,27,27,20,50,70,126,91,217,0.000333,0.443351,10,13300.54415,738.919119,1330.054415,368.631371,11,0
0,0,27,27,20,50,70,125,91,216,0.000333,0.441308,10,13239.25132,735.513962,1323.925132,368.631371,11,0
0,0,10,10,10,13,23,26,25,51,0.000333,0.076901,5,1153.508299,64.083794,230.70166,81.324997,3,0
0,0,10,10,9,13,22,25,25,50,0.000333,0.074324,4,891.886324,49.54924,222.971581,76.635041,3,0
0,0,28,28,20,50,70,128,100,228,0.000333,0.465826,20,27949.53056,1552.751698,1397.476528,368.631371,10,0
0,0,28,28,20,50,70,128,100,228,0.000333,0.465826,20,27949.53056,1552.751698,1397.476528,368.631371,10,0
0,0,11,11,9,13,22,28,31,59,0.000333,0.087702,8,2104.851724,116.936207,263.106465,76.635041,2,0
0,0,37,37,23,56,79,182,128,310,0.000333,0.651391,22,42991.7847,2388.432483,1954.172032,429.253801,10,0
0,0,32,32,21,52,73,160,114,274,0.000333,0.565337,20,33920.23858,1884.457699,1696.011929,388.661531,9,0
0,0,42,42,23,58,81,194,161,355,0.000333,0.750216,22,49514.22852,2750.790473,2250.646751,443.804823,10,0
0,0,37,37,21,54,75,172,153,325,0.000333,0.674789,20,40487.32149,2249.295638,2024.366074,403.002591,9,0
0,0,38,38,23,56,79,187,132,319,0.000333,0.670302,22,44239.93329,2457.774072,2010.906059,429.253801,10,0
0,0,33,33,21,52,73,165,118,283,0.000333,0.583907,20,35034.407,1946.355945,1751.72035,388.661531,9,0
0,0,27,27,19,46,65,137,90,227,0.000333,0.455692,9,12303.69744,683.538747,1367.077494,334.794473,9,0
0,0,27,27,20,44,64,137,87,224,0.000333,0.448,10,13440,746.666667,1344,326.653553,9,0
0,0,38,38,23,57,80,191,132,323,0.000333,0.680661,22,44923.62104,2495.756725,2041.982775,436.516656,10,0
0,0,33,33,21,53,74,169,118,287,0.000333,0.594038,20,35642.26232,1980.125684,1782.113116,395.81845,9,0
0,0,27,27,19,46,65,135,92,227,0.000333,0.455692,18,24607.39488,1367.077494,1367.077494,334.794473,9,0
0,0,27,27,20,48,68,136,91,227,0.000333,0.460618,10,13818.54065,767.696703,1381.854065,354.516762,9,0
0,0,22,22,18,48,66,114,83,197,0.000333,0.396915,9,10716.71077,595.372821,1190.745642,343.13685,9,0
0,0,12,12,9,17,26,37,40,77,0.000333,0.120645,8,2895.470866,160.859493,361.933858,98.016193,1,0
0,0,29,29,20,54,74,137,106,243,0.000333,0.502966,10,15088.97168,838.276204,1508.897168,397.202487,9,0
0,0,20,20,18,46,64,104,75,179,0.000333,0.358,9,9666,537,1074,329.1425,8,0
0,0,20,20,19,45,64,105,74,179,0.000333,0.358,9,9666,537,1074,327.844012,8,0
0,0,20,20,19,45,64,105,74,179,0.000333,0.358,9,9666,537,1074,327.844012,8,0
0,0,19,19,18,44,62,101,73,174,0.000333,0.345343,9,9324.271422,518.015079,1036.030158,315.273641,7,0
0,0,19,19,18,44,62,101,73,174,0.000333,0.345343,9,9324.271422,518.015079,1036.030158,315.273641,7,0
0,0,19,19,18,44,62,101,73,174,0.000333,0.345343,9,9324.271422,518.015079,1036.030158,315.273641,7,0
0,0,19,19,18,44,62,101,73,174,0.000333,0.345343,9,9324.271422,518.015079,1036.030158,315.273641,7,0
0,0,21,21,18,45,63,109,84,193,0.000333,0.384538,9,10382.53523,576.807513,1153.615025,322.192039,7,0
0,0,21,21,19,47,66,110,85,195,0.000333,0.392886,9,10607.91168,589.328427,1178.656853,341.776299,7,0
0,0,28,28,21,45,66,142,88,230,0.000333,0.463404,10,13902.10648,772.339249,1390.210647,339.372055,10,0
0,0,28,28,21,45,66,142,88,230,0.000333,0.463404,10,13902.10648,772.339249,1390.210647,339.372055,10,0
0,0,29,29,19,46,65,142,98,240,0.000333,0.481789,18,26016.62895,1445.368275,1445.368275,334.794473,9,0
0,0,29,29,21,48,69,145,99,244,0.000333,0.496827,20,29809.59935,1656.088853,1490.479967,360.316866,9,0
0,0,27,27,19,45,64,135,90,225,0.000333,0.45,18,24300,1350,1350,327.844012,9,0
0,0,27,27,20,47,67,136,90,226,0.000333,0.456979,10,13709.36157,761.631198,1370.936157,347.504238,9,0
0,0,6,6,11,17,28,29,28,57,0.000333,0.09134,5,1370.096153,76.116453,274.019231,107.540616,3,0
0,0,5,5,9,12,21,15,21,36,0.000333,0.052708,4,632.493709,35.138539,158.123427,71.548875,1,0
0,0,9,9,10,16,26,34,27,61,0.000333,0.095576,5,1433.634114,79.64634,286.726823,97.219281,4,0
0,0,9,9,10,16,26,34,27,61,0.000333,0.095576,5,1433.634114,79.64634,286.726823,97.219281,4,0
0,0,10,10,9,13,22,25,23,48,0.000333,0.071351,4,856.210871,47.567271,214.052718,76.635041,3,0
0,0,10,10,9,12,21,25,23,48,0.000333,0.070277,4,843.324945,46.851386,210.831236,71.548875,3,0
0,0,29,29,21,45,66,144,94,238,0.000333,0.479522,20,28771.31601,1598.406445,1438.5658,339.372055,9,0
0,0,29,29,21,44,65,145,95,240,0.000333,0.481789,20,28907.3655,1605.96475,1445.368275,332.453657,9,0
0,0,29,29,21,45,66,146,95,241,0.000333,0.485566,20,29133.97966,1618.554425,1456.698983,339.372055,9,0
0,0,27,27,19,45,64,136,88,224,0.000333,0.448,9,12096,672,1344,327.844012,9,0
0,0,27,27,20,44,64,137,87,224,0.000333,0.448,10,13440,746.666667,1344,326.653553,9,0
0,0,13,13,10,18,28,37,48,85,0.000333,0.136208,10,4086.251684,227.013982,408.625168,108.277931,1,0
0,0,13,13,12,23,35,49,53,102,0.000333,0.174396,12,6278.242413,348.791245,523.186868,147.061475,3,0
0,0,6,6,7,14,21,15,25,40,0.000333,0.058564,3,527.078091,29.282116,175.692697,72.954453,1,0
0,0,7,7,9,19,28,29,32,61,0.000333,0.09775,4,1172.994601,65.166367,293.24865,109.239948,3,0
0,0,11,11,9,17,26,29,40,69,0.000333,0.10811,8,2594.642724,144.146818,324.330341,98.016193,1,0
0,0,11,11,11,21,32,41,45,86,0.000333,0.143333,10,4300,238.888889,430,130.292414,3,0
0,0,5,5,7,12,19,15,21,36,0.000333,0.050975,3,458.776171,25.487565,152.92539,62.671034,1,0
0,0,6,6,9,17,26,29,28,57,0.000333,0.089308,4,1071.700256,59.538903,267.925064,98.016193,3,0
0,0,13,13,10,17,27,37,43,80,0.000333,0.126797,10,3803.910002,211.328333,380.391,102.706149,1,0
0,0,13,13,12,22,34,49,48,97,0.000333,0.164495,12,5921.806747,328.989264,493.483896,141.127046,3,0
0,0,32,32,21,49,70,157,109,266,0.000333,0.543463,20,32607.78565,1811.543647,1630.389283,367.359448,9,0
0,0,31,31,21,50,71,154,109,263,0.000333,0.539128,20,32347.66985,1797.092769,1617.383492,374.431475,9,0
0,0,28,28,21,46,67,142,89,231,0.000333,0.467089,10,14012.66603,778.481446,1401.266603,346.322516,10,0
0,0,28,28,21,46,67,142,89,231,0.000333,0.467089,10,14012.66603,778.481446,1401.266603,346.322516,10,0
0,0,9,9,11,17,28,35,30,65,0.000333,0.104159,5,1562.39035,86.799464,312.47807,107.540616,4,0
0,0,9,9,10,17,27,34,30,64,0.000333,0.101438,5,1521.564001,84.531333,304.3128,102.706149,4,0
0,0,10,10,10,13,23,26,27,53,0.000333,0.079916,10,2397.487837,133.193769,239.748784,81.324997,3,0
0,0,10,10,9,13,22,25,27,52,0.000333,0.077297,8,1855.123553,103.06242,231.890444,76.635041,3,0
0,0,32,32,21,47,68,160,105,265,0.000333,0.537726,20,32263.55306,1792.419614,1613.177653,353.304342,9,0
0,0,31,31,21,47,68,154,103,257,0.000333,0.521493,20,31289.559,1738.308834,1564.47795,353.304342,9,0
0,0,9,9,10,16,26,34,29,63,0.000333,0.098709,5,1480.638511,82.257695,296.127702,97.219281,4,0
0,0,9,9,10,17,27,34,29,63,0.000333,0.099853,5,1497.789563,83.210531,299.557913,102.706149,4,0
0,0,10,10,9,13,22,25,25,50,0.000333,0.074324,4,891.886324,49.54924,222.971581,76.635041,3,0
0,0,10,10,9,13,22,25,25,50,0.000333,0.074324,4,891.886324,49.54924,222.971581,76.635041,3,0
0,0,29,29,21,45,66,144,94,238,0.000333,0.479522,20,28771.31601,1598.406445,1438.5658,339.372055,9,0
0,0,29,29,21,44,65,145,95,240,0.000333,0.481789,20,28907.3655,1605.96475,1445.368275,332.453657,9,0
0,0,27,27,19,45,64,137,89,226,0.000333,0.452,9,12204,678,1356,327.844012,9,0
0,0,27,27,20,44,64,137,87,224,0.000333,0.448,10,13440,746.666667,1344,326.653553,9,0
0,0,19,19,18,44,62,101,73,174,0.000333,0.345343,9,9324.271422,518.015079,1036.030158,315.273641,7,0
0,0,19,19,19,43,62,102,72,174,0.000333,0.345343,9,9324.271422,518.015079,1036.030158,314.040007,7,0
0,0,21,21,18,45,63,110,79,189,0.000333,0.376569,9,10167.35315,564.852953,1129.705906,322.192039,7,0
0,0,21,21,19,44,63,111,78,189,0.000333,0.376569,9,10167.35315,564.852953,1129.705906,320.925614,7,0
0,0,19,19,18,44,62,101,73,174,0.000333,0.345343,9,9324.271422,518.015079,1036.030158,315.273641,7,0
0,0,19,19,19,43,62,102,72,174,0.000333,0.345343,9,9324.271422,518.015079,1036.030158,314.040007,7,0
0,0,19,19,19,43,62,102,72,174,0.000333,0.345343,9,9324.271422,518.015079,1036.030158,314.040007,7,0
0,0,19,19,18,44,62,101,73,174,0.000333,0.345343,9,9324.271422,518.015079,1036.030158,315.273641,7,0
0,0,19,19,19,43,62,102,72,174,0.000333,0.345343,9,9324.271422,518.015079,1036.030158,314.040007,7,0
0,0,19,19,19,43,62,102,72,174,0.000333,0.345343,9,9324.271422,518.015079,1036.030158,314.040007,7,0
0,0,21,21,19,45,64,110,80,190,0.000333,0.38,9,10260,570,1140,327.844012,7,0
0,0,21,21,19,44,63,111,81,192,0.000333,0.382546,9,10328.73971,573.818873,1147.637745,320.925614,7,0
0,0,19,19,18,44,62,101,73,174,0.000333,0.345343,9,9324.271422,518.015079,1036.030158,315.273641,7,0
0,0,19,19,19,43,62,102,72,174,0.000333,0.345343,9,9324.271422,518.015079,1036.030158,314.040007,7,0
0,0,34,34,21,54,75,146,105,251,0.000333,0.521144,10,15634.33491,868.574162,1563.433491,403.002591,13,0
0,0,34,34,21,53,74,146,105,251,0.000333,0.519524,10,15585.72795,865.873775,1558.572795,395.81845,13,0
0,0,14,14,10,14,24,33,29,62,0.000333,0.094756,10,2842.67675,157.926486,284.267675,86.52225,3,0
0,0,14,14,10,13,23,33,29,62,0.000333,0.093487,10,2804.608413,155.811578,280.460841,81.324997,3,0
0,0,35,35,20,55,75,157,110,267,0.000333,0.554365,20,33261.89181,1847.882878,1663.09459,404.413346,13,0
0,0,54,54,21,54,75,257,178,435,0.000333,0.903179,30,81286.08391,4515.893551,2709.53613,403.002591,21,0
0,0,54,54,21,54,75,257,178,435,0.000333,0.903179,30,81286.08391,4515.893551,2709.53613,403.002591,21,0
0,0,15,15,10,13,23,45,33,78,0.000333,0.117613,10,3528.378326,196.021018,352.837833,81.324997,3,0
0,0,15,15,10,13,23,45,33,78,0.000333,0.117613,10,3528.378326,196.021018,352.837833,81.324997,3,0
0,0,30,30,20,54,74,138,99,237,0.000333,0.490547,10,14716.40448,817.578026,1471.640448,397.202487,13,0
0,0,30,30,20,53,73,138,99,237,0.000333,0.488996,10,14669.88421,814.993567,1466.98842,390.018346,13,0
0,0,10,10,9,13,22,25,23,48,0.000333,0.071351,4,856.210871,47.567271,214.052718,76.635041,3,0
0,0,10,10,9,12,21,25,23,48,0.000333,0.070277,4,843.324945,46.851386,210.831236,71.548875,3,0
0,0,30,30,20,54,74,138,99,237,0.000333,0.490547,10,14716.40448,817.578026,1471.640448,397.202487,13,0
0,0,30,30,20,53,73,138,99,237,0.000333,0.488996,10,14669.88421,814.993567,1466.98842,390.018346,13,0
0,0,10,10,9,13,22,25,23,48,0.000333,0.071351,4,856.210871,47.567271,214.052718,76.635041,3,0
0,0,10,10,9,12,21,25,23,48,0.000333,0.070277,4,843.324945,46.851386,210.831236,71.548875,3,0
0,0,30,30,21,54,75,138,99,237,0.000333,0.492077,10,14762.3003,820.127794,1476.23003,403.002591,13,0
0,0,30,30,21,54,75,138,99,237,0.000333,0.492077,10,14762.3003,820.127794,1476.23003,403.002591,13,0
0,0,10,10,9,13,22,25,23,48,0.000333,0.071351,4,856.210871,47.567271,214.052718,76.635041,3,0
0,0,10,10,9,13,22,25,23,48,0.000333,0.071351,4,856.210871,47.567271,214.052718,76.635041,3,0
0,0,30,30,20,52,72,138,99,237,0.000333,0.487424,10,14622.72225,812.373459,1462.272225,382.861427,13,0
0,0,10,10,9,12,21,25,23,48,0.000333,0.070277,4,843.324945,46.851386,210.831236,71.548875,3,0
0,0,30,30,20,54,74,139,101,240,0.000333,0.496756,10,14902.68808,827.927115,1490.268808,397.202487,13,0
0,0,30,30,20,54,74,138,101,239,0.000333,0.494686,10,14840.59354,824.477419,1484.059354,397.202487,13,0
0,0,10,10,10,13,23,26,25,51,0.000333,0.076901,5,1153.508299,64.083794,230.70166,81.324997,3,0
0,0,10,10,9,13,22,25,25,50,0.000333,0.074324,4,891.886324,49.54924,222.971581,76.635041,3,0
0,0,30,30,20,54,74,139,101,240,0.000333,0.496756,10,14902.68808,827.927115,1490.268808,397.202487,13,0
0,0,30,30,20,54,74,138,101,239,0.000333,0.494686,10,14840.59354,824.477419,1484.059354,397.202487,13,0
0,0,10,10,10,13,23,26,25,51,0.000333,0.076901,5,1153.508299,64.083794,230.70166,81.324997,3,0
0,0,10,10,9,13,22,25,25,50,0.000333,0.074324,4,891.886324,49.54924,222.971581,76.635041,3,0
0,0,31,31,23,54,77,150,110,260,0.000333,0.543122,22,35846.01901,1991.445501,1629.364501,414.80585,13,0
0,0,11,11,11,14,25,37,34,71,0.000333,0.109905,10,3297.137895,183.174327,329.713789,91.356717,3,0
0,0,28,28,20,52,72,132,97,229,0.000333,0.470971,10,14129.12825,784.95157,1412.912825,382.861427,11,0
0,0,8,8,8,11,19,19,21,40,0.000333,0.056639,4,679.668402,37.759356,169.917101,62.053748,1,0
0,0,31,31,21,49,70,155,98,253,0.000333,0.516903,20,31014.17207,1723.009559,1550.708603,367.359448,12,0
0,0,31,31,21,49,70,155,98,253,0.000333,0.516903,20,31014.17207,1723.009559,1550.708603,367.359448,12,0
0,0,31,31,21,50,71,155,99,254,0.000333,0.520679,10,15620.35768,867.797649,1562.035768,374.431475,12,0
0,0,31,31,21,50,71,155,99,254,0.000333,0.520679,10,15620.35768,867.797649,1562.035768,374.431475,12,0
0,0,31,31,21,49,70,155,98,253,0.000333,0.516903,20,31014.17207,1723.009559,1550.708603,367.359448,12,0
0,0,31,31,21,49,70,155,98,253,0.000333,0.516903,20,31014.17207,1723.009559,1550.708603,367.359448,12,0
0,0,31,31,21,50,71,155,99,254,0.000333,0.520679,10,15620.35768,867.797649,1562.035768,374.431475,12,0
0,0,31,31,21,50,71,155,99,254,0.000333,0.520679,10,15620.35768,867.797649,1562.035768,374.431475,12,0
0,0,31,31,21,49,70,155,99,254,0.000333,0.518946,20,31136.75773,1729.819874,1556.837886,367.359448,12,0
0,0,31,31,21,49,70,155,99,254,0.000333,0.518946,20,31136.75773,1729.819874,1556.837886,367.359448,12,0
0,0,31,31,21,49,70,155,98,253,0.000333,0.516903,20,31014.17207,1723.009559,1550.708603,367.359448,12,0
0,0,31,31,21,49,70,155,98,253,0.000333,0.516903,20,31014.17207,1723.009559,1550.708603,367.359448,12,0
0,0,20,20,18,45,63,104,74,178,0.000333,0.354652,9,9575.602437,531.977913,1063.955826,322.192039,8,0
0,0,20,20,19,44,63,105,73,178,0.000333,0.354652,9,9575.602437,531.977913,1063.955826,320.925614,8,0
0,0,20,20,19,44,63,105,73,178,0.000333,0.354652,9,9575.602437,531.977913,1063.955826,320.925614,8,0
0,0,20,20,18,45,63,104,75,179,0.000333,0.356644,9,9629.397957,534.966553,1069.933106,322.192039,8,0
0,0,20,20,19,44,63,105,74,179,0.000333,0.356644,9,9629.397957,534.966553,1069.933106,320.925614,8,0
0,0,20,20,19,44,63,105,74,179,0.000333,0.356644,9,9629.397957,534.966553,1069.933106,320.925614,8,0
0,0,33,33,22,49,71,159,101,260,0.000333,0.532978,22,35176.55352,1954.252974,1598.934251,373.228278,12,0
0,0,33,33,22,49,71,159,101,260,0.000333,0.532978,22,35176.55352,1954.252974,1598.934251,373.228278,12,0
0,0,32,32,21,50,71,158,101,259,0.000333,0.530928,20,31855.69008,1769.76056,1592.784504,374.431475,12,0
0,0,34,34,22,50,72,169,104,273,0.000333,0.561463,22,37056.56956,2058.698309,1684.389525,380.300305,12,0
0,0,32,32,22,49,71,159,100,259,0.000333,0.530928,22,35041.25909,1946.736616,1592.784504,373.228278,12,0
0,0,23,23,18,50,68,117,85,202,0.000333,0.409889,9,11067.00745,614.833747,1229.667494,357.25146,10,0
0,0,23,23,19,49,68,118,84,202,0.000333,0.409889,9,11067.00745,614.833747,1229.667494,355.831405,10,0
0,0,23,23,19,49,68,118,84,202,0.000333,0.409889,9,11067.00745,614.833747,1229.667494,355.831405,10,0
0,0,23,23,18,50,68,117,85,202,0.000333,0.409889,9,11067.00745,614.833747,1229.667494,357.25146,10,0
0,0,23,23,19,49,68,118,84,202,0.000333,0.409889,9,11067.00745,614.833747,1229.667494,355.831405,10,0
0,0,23,23,19,49,68,118,84,202,0.000333,0.409889,9,11067.00745,614.833747,1229.667494,355.831405,10,0
0,0,23,23,18,48,66,117,84,201,0.000333,0.404974,9,10934.30896,607.461609,1214.923218,343.13685,10,0
0,0,23,23,19,47,66,118,83,201,0.000333,0.404974,9,10934.30896,607.461609,1214.923218,341.776299,10,0
0,0,23,23,19,49,68,117,84,201,0.000333,0.40786,9,11012.22028,611.790016,1223.580031,355.831405,10,0
0,0,23,23,20,48,68,118,83,201,0.000333,0.40786,10,12235.80031,679.766684,1223.580031,354.516762,10,0
0,0,23,23,20,48,68,118,83,201,0.000333,0.40786,10,12235.80031,679.766684,1223.580031,354.516762,10,0
0,0,23,23,18,49,67,117,84,201,0.000333,0.406428,9,10973.55535,609.641964,1219.283927,350.179432,10,0
0,0,23,23,19,48,67,118,83,201,0.000333,0.406428,9,10973.55535,609.641964,1219.283927,348.788823,10,0
0,0,23,23,19,48,67,118,83,201,0.000333,0.406428,9,10973.55535,609.641964,1219.283927,348.788823,10,0
0,0,23,23,18,49,67,117,84,201,0.000333,0.406428,9,10973.55535,609.641964,1219.283927,350.179432,10,0
0,0,23,23,19,48,67,118,83,201,0.000333,0.406428,9,10973.55535,609.641964,1219.283927,348.788823,10,0
0,0,23,23,19,48,67,118,83,201,0.000333,0.406428,9,10973.55535,609.641964,1219.283927,348.788823,10,0
0,0,25,25,20,50,70,126,88,214,0.000333,0.437222,10,13116.66566,728.703648,1311.666566,368.631371,10,0
0,0,25,25,21,49,70,127,87,214,0.000333,0.437222,10,13116.66566,728.703648,1311.666566,367.359448,10,0
0,0,25,25,21,49,70,127,87,214,0.000333,0.437222,10,13116.66566,728.703648,1311.666566,367.359448,10,0
0,0,25,25,19,49,68,121,87,208,0.000333,0.422064,9,11395.73044,633.096135,1266.192271,355.831405,10,0
0,0,25,25,20,48,68,122,86,208,0.000333,0.422064,10,12661.92271,703.440151,1266.192271,354.516762,10,0
0,0,25,25,20,48,68,122,86,208,0.000333,0.422064,10,12661.92271,703.440151,1266.192271,354.516762,10,0
0,0,21,21,16,48,64,111,80,191,0.000333,0.382,8,9168,509.333333,1146,332.0782,9,0
0,0,21,21,17,46,63,112,78,190,0.000333,0.378561,8,9085.465484,504.748082,1135.683185,323.570718,9,0
0,0,22,22,18,48,66,114,83,197,0.000333,0.396915,9,10716.71077,595.372821,1190.745642,343.13685,9,0
0,0,22,22,19,47,66,115,82,197,0.000333,0.396915,9,10716.71077,595.372821,1190.745642,341.776299,9,0
0,0,12,12,13,22,35,43,50,93,0.000333,0.159008,12,5724.279847,318.015547,477.023321,146.213212,3,0
0,0,11,11,11,18,29,29,43,72,0.000333,0.116592,10,3497.746316,194.31924,349.774632,113.112398,1,0
0,0,30,30,19,50,69,148,102,250,0.000333,0.509044,18,27488.36006,1527.131114,1527.131114,362.903432,11,0
0,0,30,30,20,52,72,149,101,250,0.000333,0.51416,10,15424.8125,856.934028,1542.48125,382.861427,11,0
0,0,12,12,9,17,26,37,40,77,0.000333,0.120645,8,2895.470866,160.859493,361.933858,98.016193,1,0
0,0,32,32,20,58,78,150,116,266,0.000333,0.557306,20,33438.3398,1857.685545,1671.91699,426.20146,11,0
0,0,5,5,7,11,18,15,19,34,0.000333,0.047259,3,425.33235,23.629575,141.77745,57.705232,1,0
0,0,6,6,9,16,25,29,26,55,0.000333,0.085137,4,1021.648362,56.758242,255.41209,92.529325,3,0
0,0,29,29,20,45,65,143,98,241,0.000333,0.483797,20,29027.81286,1612.65627,1451.390643,333.571951,9,0
0,0,29,29,21,47,68,144,99,243,0.000333,0.493084,20,29585.06941,1643.614967,1479.25347,353.304342,9,0
0,0,35,35,19,50,69,161,129,290,0.000333,0.590491,18,31886.49766,1771.472092,1771.472092,362.903432,10,0
0,0,35,35,21,52,73,164,136,300,0.000333,0.618982,20,37138.94735,2063.274853,1856.947368,388.661531,10,0
0,0,30,30,19,48,67,149,102,251,0.000333,0.507529,18,27406.59096,1522.588387,1522.588387,348.788823,10,0
0,0,30,30,21,50,71,152,103,255,0.000333,0.522729,20,31363.71031,1742.428351,1568.185515,374.431475,10,0
0,0,27,27,19,45,64,136,88,224,0.000333,0.448,9,12096,672,1344,327.844012,9,0
0,0,27,27,20,44,64,137,87,224,0.000333,0.448,10,13440,746.666667,1344,326.653553,9,0
0,0,31,31,19,49,68,158,106,264,0.000333,0.535697,18,28927.62342,1607.09019,1607.09019,355.831405,10,0
0,0,31,31,21,51,72,161,107,268,0.000333,0.55118,20,33070.79801,1837.266556,1653.5399,381.532358,10,0
0,0,31,31,19,50,69,149,108,257,0.000333,0.523297,18,28258.03414,1569.890785,1569.890785,362.903432,10,0
0,0,31,31,21,52,73,152,109,261,0.000333,0.538515,20,32310.8842,1795.049122,1615.54421,388.661531,10,0
0,0,31,31,19,48,67,154,106,260,0.000333,0.525728,18,28389.29741,1577.18319,1577.18319,348.788823,10,0
0,0,31,31,21,50,71,157,107,264,0.000333,0.541178,20,32470.66479,1803.925822,1623.53324,374.431475,10,0
0,0,6,6,8,13,21,16,21,37,0.000333,0.054172,4,650.062979,36.11461,162.515745,72.105716,1,0
0,0,7,7,10,18,28,30,28,58,0.000333,0.092942,5,1394.132927,77.451829,278.826585,108.277931,3,0
0,0,12,12,8,16,24,29,45,74,0.000333,0.113096,8,2714.2978,150.794322,339.287225,88,1,0
0,0,32,32,20,57,77,142,121,263,0.000333,0.549388,20,32963.2972,1831.294289,1648.16486,418.913293,11,0
0,0,11,11,7,14,21,30,55,85,0.000333,0.124449,9,3360.122828,186.67349,373.346981,72.954453,1,0
0,0,12,12,9,19,28,44,62,106,0.000333,0.16986,12,6114.955461,339.719748,509.579622,109.239948,3,0
0,0,11,11,9,15,24,27,35,62,0.000333,0.094756,8,2274.1414,126.341189,284.267675,87.132684,1,0
0,0,31,31,21,56,77,140,111,251,0.000333,0.524321,10,15729.63422,873.868568,1572.963422,417.450542,11,0
0,0,28,28,21,46,67,145,91,236,0.000333,0.477199,10,14315.97049,795.331694,1431.597049,346.322516,10,0
0,0,28,28,21,46,67,145,91,236,0.000333,0.477199,10,14315.97049,795.331694,1431.597049,346.322516,10,0
0,0,30,30,22,46,68,150,94,244,0.000333,0.495114,22,32677.50053,1815.416696,1485.340933,352.191346,10,0
0,0,30,30,22,46,68,150,94,244,0.000333,0.495114,22,32677.50053,1815.416696,1485.340933,352.191346,10,0
0,0,28,28,21,47,68,145,92,237,0.000333,0.48091,10,14427.28693,801.515941,1442.728693,353.304342,10,0
0,0,28,28,21,47,68,145,92,237,0.000333,0.48091,10,14427.28693,801.515941,1442.728693,353.304342,10,0
0,0,28,28,21,47,68,145,92,237,0.000333,0.48091,10,14427.28693,801.515941,1442.728693,353.304342,10,0
0,0,28,28,21,47,68,145,92,237,0.000333,0.48091,10,14427.28693,801.515941,1442.728693,353.304342,10,0
0,0,29,29,21,46,67,145,91,236,0.000333,0.477199,10,14315.97049,795.331694,1431.597049,346.322516,10,0
0,0,31,31,22,47,69,162,100,262,0.000333,0.533478,22,35209.53497,1956.085276,1600.433408,359.173172,10,0
0,0,29,29,22,45,67,146,90,236,0.000333,0.477199,22,31495.13508,1749.729726,1431.597049,345.240885,10,0
0,0,10,10,8,15,23,24,33,57,0.000333,0.085948,8,2062.744252,114.596903,257.843031,82.603359,1,0
0,0,30,30,20,56,76,137,109,246,0.000333,0.51233,10,15369.90168,853.883427,1536.990168,411.650438,11,0
0,0,30,30,19,49,68,149,98,247,0.000333,0.501201,18,27064.85979,1503.603322,1503.603322,355.831405,11,0
0,0,30,30,20,48,68,150,97,247,0.000333,0.501201,20,30072.06644,1670.670358,1503.603322,354.516762,11,0
0,0,30,30,19,49,68,148,100,248,0.000333,0.50323,18,27174.43412,1509.690785,1509.690785,355.831405,11,0
0,0,30,30,20,51,71,149,100,249,0.000333,0.510429,10,15312.87033,850.715018,1531.287033,375.732254,11,0
0,0,11,11,10,18,28,41,30,71,0.000333,0.113774,5,1706.610997,94.811722,341.322199,108.277931,5,0
0,0,11,11,10,17,27,41,30,71,0.000333,0.112532,5,1687.985063,93.776948,337.597013,102.706149,5,0
0,0,10,10,9,13,22,25,23,48,0.000333,0.071351,4,856.210871,47.567271,214.052718,76.635041,3,0
0,0,10,10,9,12,21,25,23,48,0.000333,0.070277,4,843.324945,46.851386,210.831236,71.548875,3,0
0,0,11,11,11,18,29,42,32,74,0.000333,0.11983,5,1797.452968,99.858498,359.490594,113.112398,5,0
0,0,11,11,10,18,28,41,32,73,0.000333,0.116979,5,1754.684547,97.482475,350.936909,108.277931,5,0
0,0,10,10,10,13,23,26,25,51,0.000333,0.076901,5,1153.508299,64.083794,230.70166,81.324997,3,0
0,0,10,10,9,13,22,25,25,50,0.000333,0.074324,4,891.886324,49.54924,222.971581,76.635041,3,0
0,0,15,15,11,19,30,51,36,87,0.000333,0.1423,5,2134.497409,118.583189,426.899482,118.764371,5,0
0,0,15,15,11,18,29,51,36,87,0.000333,0.140881,10,4226.443466,234.802415,422.644347,113.112398,5,0
0,0,14,14,10,14,24,35,29,64,0.000333,0.097813,10,2934.376,163.020889,293.4376,86.52225,3,0
0,0,14,14,10,13,23,35,29,64,0.000333,0.096503,10,2895.079652,160.837758,289.507965,81.324997,3,0
0,0,11,11,10,17,27,41,30,71,0.000333,0.112532,5,1687.985063,93.776948,337.597013,102.706149,5,0
0,0,11,11,10,17,27,41,30,71,0.000333,0.112532,5,1687.985063,93.776948,337.597013,102.706149,5,0
0,0,10,10,9,12,21,25,23,48,0.000333,0.070277,4,843.324945,46.851386,210.831236,71.548875,3,0
0,0,10,10,9,12,21,25,23,48,0.000333,0.070277,4,843.324945,46.851386,210.831236,71.548875,3,0
0,0,11,11,10,18,28,41,30,71,0.000333,0.113774,5,1706.610997,94.811722,341.322199,108.277931,5,0
0,0,11,11,10,17,27,41,30,71,0.000333,0.112532,5,1687.985063,93.776948,337.597013,102.706149,5,0
0,0,10,10,9,13,22,25,23,48,0.000333,0.071351,4,856.210871,47.567271,214.052718,76.635041,3,0
0,0,10,10,9,12,21,25,23,48,0.000333,0.070277,4,843.324945,46.851386,210.831236,71.548875,3,0
0,0,11,11,10,18,28,41,30,71,0.000333,0.113774,5,1706.610997,94.811722,341.322199,108.277931,5,0
0,0,11,11,10,17,27,41,30,71,0.000333,0.112532,5,1687.985063,93.776948,337.597013,102.706149,5,0
0,0,10,10,9,13,22,25,23,48,0.000333,0.071351,4,856.210871,47.567271,214.052718,76.635041,3,0
0,0,10,10,9,12,21,25,23,48,0.000333,0.070277,4,843.324945,46.851386,210.831236,71.548875,3,0
0,0,16,16,11,18,29,59,40,99,0.000333,0.160313,10,4809.401185,267.188955,480.940119,113.112398,5,0
0,0,16,16,11,18,29,59,40,99,0.000333,0.160313,10,4809.401185,267.188955,480.940119,113.112398,5,0
0,0,15,15,11,18,29,47,36,83,0.000333,0.134404,10,4032.124226,224.006901,403.212423,113.112398,5,0
0,0,15,15,11,17,28,47,36,83,0.000333,0.133003,10,3990.104585,221.672477,399.010459,107.540616,5,0
0,0,21,21,21,46,67,111,81,192,0.000333,0.38823,10,11646.89125,647.049514,1164.689125,346.322516,8,0
0,0,21,21,22,45,67,112,80,192,0.000333,0.38823,11,12811.58037,711.754465,1164.689125,345.240885,8,0
0,0,19,19,18,44,62,101,73,174,0.000333,0.345343,9,9324.271422,518.015079,1036.030158,315.273641,7,0
0,0,19,19,19,43,62,102,72,174,0.000333,0.345343,9,9324.271422,518.015079,1036.030158,314.040007,7,0
0,0,20,20,18,46,64,104,75,179,0.000333,0.358,9,9666,537,1074,329.1425,8,0
0,0,20,20,19,45,64,105,74,179,0.000333,0.358,9,9666,537,1074,327.844012,8,0
0,0,20,20,19,45,64,105,74,179,0.000333,0.358,9,9666,537,1074,327.844012,8,0
0,0,20,20,19,45,64,104,74,178,0.000333,0.356,9,9612,534,1068,327.844012,8,0
0,0,20,20,20,44,64,105,73,178,0.000333,0.356,10,10680,593.333333,1068,326.653553,8,0
0,0,20,20,20,44,64,105,73,178,0.000333,0.356,10,10680,593.333333,1068,326.653553,8,0
0,0,20,20,18,44,62,104,74,178,0.000333,0.353282,9,9538.622489,529.923472,1059.846943,315.273641,8,0
0,0,20,20,19,43,62,105,73,178,0.000333,0.353282,9,9538.622489,529.923472,1059.846943,314.040007,8,0
0,0,20,20,18,45,63,104,74,178,0.000333,0.354652,9,9575.602437,531.977913,1063.955826,322.192039,8,0
0,0,20,20,19,44,63,105,73,178,0.000333,0.354652,9,9575.602437,531.977913,1063.955826,320.925614,8,0
0,0,20,20,19,44,63,105,73,178,0.000333,0.354652,9,9575.602437,531.977913,1063.955826,320.925614,8,0
0,0,20,20,18,45,63,104,74,178,0.000333,0.354652,9,9575.602437,531.977913,1063.955826,322.192039,8,0
0,0,20,20,19,44,63,105,73,178,0.000333,0.354652,9,9575.602437,531.977913,1063.955826,320.925614,8,0
0,0,20,20,19,44,63,105,73,178,0.000333,0.354652,9,9575.602437,531.977913,1063.955826,320.925614,8,0
0,0,22,22,19,45,64,108,77,185,0.000333,0.37,9,9990,555,1110,327.844012,8,0
0,0,22,22,20,44,64,109,76,185,0.000333,0.37,10,11100,616.666667,1110,326.653553,8,0
0,0,22,22,20,44,64,109,76,185,0.000333,0.37,10,11100,616.666667,1110,326.653553,8,0
0,0,22,22,20,46,66,113,78,191,0.000333,0.384826,10,11544.79277,641.377376,1154.479277,340.522412,8,0
0,0,22,22,21,45,66,114,77,191,0.000333,0.384826,10,11544.79277,641.377376,1154.479277,339.372055,8,0
0,0,22,22,21,45,66,114,77,191,0.000333,0.384826,10,11544.79277,641.377376,1154.479277,339.372055,8,0
0,0,12,12,13,19,32,53,41,94,0.000333,0.156667,12,5640,313.333333,470,128.816339,5,0
0,0,11,11,11,14,25,37,34,71,0.000333,0.109905,10,3297.137895,183.174327,329.713789,91.356717,3,0
0,0,15,15,11,19,30,49,36,85,0.000333,0.139029,5,2085.428503,115.857139,417.085701,118.764371,5,0
0,0,15,15,11,18,29,49,36,85,0.000333,0.137643,10,4129.283846,229.404658,412.928385,113.112398,5,0
0,0,14,14,10,14,24,33,29,62,0.000333,0.094756,10,2842.67675,157.926486,284.267675,86.52225,3,0
0,0,14,14,10,13,23,33,29,62,0.000333,0.093487,10,2804.608413,155.811578,280.460841,81.324997,3,0
0,0,16,16,10,20,30,60,41,101,0.000333,0.165199,10,4955.959502,275.331083,495.59595,119.657843,5,0
0,0,16,16,11,19,30,63,40,103,0.000333,0.16847,10,5054.097313,280.783184,505.409731,118.764371,5,0
0,0,16,16,11,19,30,63,40,103,0.000333,0.16847,10,5054.097313,280.783184,505.409731,118.764371,5,0
0,0,15,15,10,13,23,45,33,78,0.000333,0.117613,10,3528.378326,196.021018,352.837833,81.324997,3,0
0,0,15,15,10,13,23,45,33,78,0.000333,0.117613,10,3528.378326,196.021018,352.837833,81.324997,3,0
0,0,11,11,11,18,29,42,32,74,0.000333,0.11983,5,1797.452968,99.858498,359.490594,113.112398,5,0
0,0,11,11,10,18,28,41,32,73,0.000333,0.116979,5,1754.684547,97.482475,350.936909,108.277931,5,0
0,0,12,12,10,18,28,44,41,85,0.000333,0.136208,10,4086.251684,227.013982,408.625168,108.277931,4,0
0,0,12,12,10,18,28,44,41,85,0.000333,0.136208,10,4086.251684,227.013982,408.625168,108.277931,4,0
0,0,11,11,9,13,22,28,31,59,0.000333,0.087702,8,2104.851724,116.936207,263.106465,76.635041,2,0
0,0,11,11,11,18,29,41,30,71,0.000333,0.114972,5,1724.583253,95.810181,344.916651,113.112398,5,0
0,0,11,11,11,18,29,41,30,71,0.000333,0.114972,5,1724.583253,95.810181,344.916651,113.112398,5,0
0,0,10,10,9,13,22,25,23,48,0.000333,0.071351,4,856.210871,47.567271,214.052718,76.635041,3,0
0,0,10,10,9,13,22,25,23,48,0.000333,0.071351,4,856.210871,47.567271,214.052718,76.635041,3,0
0,0,32,32,19,50,69,155,108,263,0.000333,0.535514,18,28917.75478,1606.541932,1606.541932,362.903432,11,0
0,0,32,32,21,52,73,158,109,267,0.000333,0.550894,20,33053.66314,1836.314619,1652.683157,388.661531,11,0
0,0,29,29,19,47,66,143,99,242,0.000333,0.487581,18,26329.38078,1462.743377,1462.743377,341.776299,10,0
0,0,29,29,21,49,70,146,102,248,0.000333,0.506687,20,30401.24376,1688.957987,1520.062188,367.359448,10,0
0,0,29,29,21,49,70,146,102,248,0.000333,0.506687,20,30401.24376,1688.957987,1520.062188,367.359448,10,0
0,0,29,29,21,46,67,147,98,245,0.000333,0.495397,20,29723.83703,1651.32428,1486.191852,346.322516,10,0
0,0,29,29,21,46,67,147,98,245,0.000333,0.495397,20,29723.83703,1651.32428,1486.191852,346.322516,10,0
0,0,28,28,21,45,66,143,89,232,0.000333,0.467433,10,14022.99436,779.055242,1402.299436,339.372055,11,0
0,0,28,28,22,46,68,143,89,232,0.000333,0.470764,11,15535.20517,863.066954,1412.291379,352.191346,11,0
0,0,28,28,22,46,68,143,89,232,0.000333,0.470764,11,15535.20517,863.066954,1412.291379,352.191346,11,0
0,0,28,28,21,47,68,143,90,233,0.000333,0.472793,10,14183.78842,787.988246,1418.378842,353.304342,11,0
0,0,28,28,21,47,68,143,90,233,0.000333,0.472793,10,14183.78842,787.988246,1418.378842,353.304342,11,0
0,0,31,31,21,50,71,158,102,260,0.000333,0.532978,20,31978.68502,1776.593612,1598.934251,374.431475,12,0
0,0,31,31,21,50,71,158,102,260,0.000333,0.532978,20,31978.68502,1776.593612,1598.934251,374.431475,12,0
0,0,9,9,10,16,26,35,28,63,0.000333,0.098709,5,1480.638511,82.257695,296.127702,97.219281,3,0
0,0,8,8,8,11,19,19,21,40,0.000333,0.056639,4,679.668402,37.759356,169.917101,62.053748,1,0
0,0,32,32,21,49,70,159,105,264,0.000333,0.539377,20,32362.61433,1797.923018,1618.130716,367.359448,11,0
0,0,30,30,19,48,67,150,97,247,0.000333,0.499441,18,26969.83254,1498.32403,1498.32403,348.788823,11,0
0,0,30,30,20,49,69,151,98,249,0.000333,0.507008,20,30420.4518,1690.0251,1521.02259,361.559344,11,0
0,0,30,30,20,48,68,150,97,247,0.000333,0.501201,20,30072.06644,1670.670358,1503.603322,354.516762,11,0
0,0,30,30,21,49,70,151,98,249,0.000333,0.50873,20,30523.82942,1695.768301,1526.191471,367.359448,11,0
0,0,30,30,21,49,70,155,100,255,0.000333,0.520989,20,31259.34339,1736.630188,1562.967169,367.359448,11,0
0,0,31,31,21,49,70,158,101,259,0.000333,0.529161,20,31749.68603,1763.871446,1587.484301,367.359448,12,0
0,0,31,31,21,49,70,158,101,259,0.000333,0.529161,20,31749.68603,1763.871446,1587.484301,367.359448,12,0
0,0,27,27,20,47,67,144,95,239,0.000333,0.483265,20,28995.90633,1610.883685,1449.795317,347.504238,11,0
0,0,27,27,20,48,68,144,97,241,0.000333,0.489026,20,29341.5709,1630.087272,1467.078545,354.516762,11,0
0,0,32,32,21,51,72,158,112,270,0.000333,0.555293,20,33317.59501,1850.9775,1665.87975,381.532358,11,0
0,0,32,32,22,52,74,159,118,277,0.000333,0.57334,22,37840.40881,2102.244934,1720.018582,394.530361,11,0
0,0,11,11,7,16,23,30,68,98,0.000333,0.14777,12,5319.70886,295.539381,443.309072,83.651484,1,0
0,0,12,12,9,21,30,44,75,119,0.000333,0.19464,12,7007.039771,389.279987,583.919981,120.767991,3,0
0,0,11,11,9,18,27,26,44,70,0.000333,0.110947,8,2662.737001,147.929833,332.842125,103.587975,1,0
0,0,12,12,11,22,33,40,51,91,0.000333,0.153013,10,4590.398649,255.022147,459.039865,136.161243,3,0
0,0,11,11,11,18,29,42,32,74,0.000333,0.11983,5,1797.452968,99.858498,359.490594,113.112398,5,0
0,0,11,11,10,18,28,41,32,73,0.000333,0.116979,5,1754.684547,97.482475,350.936909,108.277931,5,0
0,0,12,12,13,25,38,46,58,104,0.000333,0.181928,12,6549.413537,363.856308,545.784461,164.202121,3,0
0,0,11,11,11,20,31,28,49,77,0.000333,0.127158,10,3814.731159,211.929509,381.473116,124.49231,1,0
0,0,19,19,18,42,60,101,71,172,0.000333,0.338662,9,9143.866642,507.992591,1015.985182,301.535982,7,0
0,0,19,19,19,43,62,102,72,174,0.000333,0.345343,9,9324.271422,518.015079,1036.030158,314.040007,7,0
0,0,11,11,9,12,21,28,31,59,0.000333,0.086382,8,2073.173824,115.176324,259.146728,71.548875,1,0
0,0,12,12,11,16,27,42,38,80,0.000333,0.126797,10,3803.910002,211.328333,380.391,102.053748,3,0
0,0,11,11,9,15,24,27,35,62,0.000333,0.094756,8,2274.1414,126.341189,284.267675,87.132684,1,0
0,0,12,12,11,19,30,41,42,83,0.000333,0.135757,10,4072.719194,226.262177,407.271919,118.764371,3,0
0,0,29,29,21,46,67,146,94,240,0.000333,0.485287,20,29117.22811,1617.623784,1455.861406,346.322516,10,0
0,0,34,34,19,51,70,161,118,279,0.000333,0.570023,18,30781.25931,1710.069962,1710.069962,370.004315,11,0
0,0,34,34,21,53,74,164,121,285,0.000333,0.589898,20,35393.88418,1966.326899,1769.694209,395.81845,11,0
0,0,6,6,11,16,27,29,27,56,0.000333,0.088758,5,1331.368501,73.964917,266.2737,102.053748,3,0
0,0,5,5,9,11,20,15,20,35,0.000333,0.050422,4,605.069933,33.614996,151.267483,66.583073,1,0
0,0,41,41,25,57,82,160,134,294,0.000333,0.62304,24,44858.88695,2492.160386,1869.120289,448.571136,11,0
0,0,13,13,12,16,28,33,54,87,0.000333,0.139413,18,7528.317808,418.239878,418.239878,107.01955,1,0
0,0,6,6,11,17,28,31,27,58,0.000333,0.092942,5,1394.132927,77.451829,278.826585,107.540616,3,0
0,0,5,5,9,12,21,17,20,37,0.000333,0.054172,4,650.062979,36.11461,162.515745,71.548875,1,0
0,0,28,28,23,54,77,129,106,235,0.000333,0.490898,11,16199.64321,899.980178,1472.694837,414.80585,9,0
0,0,11,11,11,17,28,29,40,69,0.000333,0.110569,10,3317.074896,184.281939,331.70749,107.540616,1,0
0,0,6,6,7,13,20,15,23,38,0.000333,0.054744,3,492.699803,27.372211,164.233268,67.757201,1,0
0,0,7,7,9,18,27,29,30,59,0.000333,0.093513,4,1122.153451,62.341858,280.538363,103.587975,3,0
0,0,36,36,19,52,71,167,128,295,0.000333,0.604725,18,32655.15721,1814.1754,1814.1754,377.133488,11,0
0,0,36,36,21,54,75,170,133,303,0.000333,0.629111,20,37746.64126,2097.035626,1887.332063,403.002591,11,0
0,0,19,19,18,44,62,101,73,174,0.000333,0.345343,9,9324.271422,518.015079,1036.030158,315.273641,7,0
0,0,21,21,18,45,63,109,84,193,0.000333,0.384538,9,10382.53523,576.807513,1153.615025,322.192039,7,0
0,0,21,21,19,47,66,110,85,195,0.000333,0.392886,9,10607.91168,589.328427,1178.656853,341.776299,7,0
0,0,19,19,18,44,62,101,73,174,0.000333,0.345343,9,9324.271422,518.015079,1036.030158,315.273641,7,0
0,0,19,19,19,43,62,102,72,174,0.000333,0.345343,9,9324.271422,518.015079,1036.030158,314.040007,7,0
0,0,28,28,21,47,68,143,90,233,0.000333,0.472793,10,14183.78842,787.988246,1418.378842,353.304342,11,0
0,0,28,28,21,47,68,143,90,233,0.000333,0.472793,10,14183.78842,787.988246,1418.378842,353.304342,11,0
0,0,27,27,19,45,64,135,90,225,0.000333,0.45,18,24300,1350,1350,327.844012,9,0
0,0,27,27,20,47,67,136,90,226,0.000333,0.456979,10,13709.36157,761.631198,1370.936157,347.504238,9,0
0,0,31,31,21,50,71,158,101,259,0.000333,0.530928,20,31855.69008,1769.76056,1592.784504,374.431475,12,0
0,0,31,31,21,50,71,158,101,259,0.000333,0.530928,20,31855.69008,1769.76056,1592.784504,374.431475,12,0
0,0,22,22,18,49,67,114,84,198,0.000333,0.400362,9,10809.77094,600.54283,1201.08566,350.179432,9,0
0,0,22,22,19,47,66,115,82,197,0.000333,0.396915,9,10716.71077,595.372821,1190.745642,341.776299,9,0
0,0,11,11,11,17,28,40,32,72,0.000333,0.115377,5,1730.647772,96.147098,346.129554,107.540616,5,0
0,0,11,11,10,17,27,39,32,71,0.000333,0.112532,5,1687.985063,93.776948,337.597013,102.706149,5,0
0,0,10,10,10,13,23,26,25,51,0.000333,0.076901,5,1153.508299,64.083794,230.70166,81.324997,3,0
0,0,10,10,9,13,22,25,25,50,0.000333,0.074324,4,891.886324,49.54924,222.971581,76.635041,3,0
0,0,12,12,10,21,31,43,47,90,0.000333,0.148626,10,4458.776679,247.709816,445.877668,125.457947,4,0
0,0,12,12,10,21,31,43,47,90,0.000333,0.148626,10,4458.776679,247.709816,445.877668,125.457947,4,0
0,0,11,11,9,16,25,27,37,64,0.000333,0.099069,8,2377.654369,132.091909,297.206796,92.529325,2,0
0,0,13,13,9,18,27,31,46,77,0.000333,0.122042,8,2929.010701,162.722817,366.126338,103.587975,1,0
0,0,14,14,11,23,34,47,53,100,0.000333,0.169582,10,5087.462841,282.636825,508.746284,142.095673,3,0
0,0,11,11,11,17,28,40,32,72,0.000333,0.115377,5,1730.647772,96.147098,346.129554,107.540616,5,0
0,0,11,11,10,17,27,39,32,71,0.000333,0.112532,5,1687.985063,93.776948,337.597013,102.706149,5,0
0,0,10,10,10,13,23,26,25,51,0.000333,0.076901,5,1153.508299,64.083794,230.70166,81.324997,3,0
0,0,10,10,9,13,22,25,25,50,0.000333,0.074324,4,891.886324,49.54924,222.971581,76.635041,3,0
0,0,22,22,18,46,64,114,81,195,0.000333,0.39,9,10530,585,1170,329.1425,9,0
0,0,22,22,19,47,66,115,82,197,0.000333,0.396915,9,10716.71077,595.372821,1190.745642,341.776299,9,0
0,0,22,22,18,48,66,114,83,197,0.000333,0.396915,9,10716.71077,595.372821,1190.745642,343.13685,9,0
0,0,22,22,19,47,66,115,82,197,0.000333,0.396915,9,10716.71077,595.372821,1190.745642,341.776299,9,0
0,0,9,9,10,16,26,34,27,61,0.000333,0.095576,5,1433.634114,79.64634,286.726823,97.219281,4,0
0,0,9,9,10,16,26,34,27,61,0.000333,0.095576,5,1433.634114,79.64634,286.726823,97.219281,4,0
0,0,10,10,9,13,22,25,23,48,0.000333,0.071351,4,856.210871,47.567271,214.052718,76.635041,3,0
0,0,10,10,9,12,21,25,23,48,0.000333,0.070277,4,843.324945,46.851386,210.831236,71.548875,3,0
0,0,8,8,8,11,19,19,21,40,0.000333,0.056639,4,679.668402,37.759356,169.917101,62.053748,1,0
0,0,8,8,10,15,25,31,26,57,0.000333,0.088233,5,1323.499014,73.527723,264.699803,91.82264,3,0
0,0,8,8,4,12,16,21,46,67,0.000333,0.089333,6,1608,89.333333,268,51.01955,1,0
0,0,9,9,6,13,19,25,48,73,0.000333,0.103366,9,2790.888376,155.049354,310.098708,63.615491,2,0
0,0,9,9,7,14,21,21,36,57,0.000333,0.083454,6,1502.172559,83.454031,250.362093,72.954453,1,0
0,0,9,9,9,14,23,23,36,59,0.000333,0.088963,8,2135.121243,118.617847,266.890155,81.832294,2,0
0,0,11,11,7,15,22,26,48,74,0.000333,0.109999,9,2969.981458,164.99897,329.99794,78.254843,1,0
0,0,11,11,9,15,24,28,48,76,0.000333,0.116152,12,4181.485801,232.304767,348.45715,87.132684,2,0
0,0,3,3,6,11,17,7,12,19,0.000333,0.025887,3,232.985382,12.943632,77.661794,53.563523,1,0
0,0,4,4,8,12,20,11,14,25,0.000333,0.036016,4,432.192809,24.010712,108.048202,67.01955,2,0
0,0,7,7,7,13,20,16,24,40,0.000333,0.057626,3,518.631371,28.812854,172.877124,67.757201,1,0
0,0,7,7,9,13,22,18,24,42,0.000333,0.062432,4,749.184512,41.621362,187.296128,76.635041,2,0
0,0,39,39,25,65,90,231,151,382,0.000333,0.826629,24,59517.30919,3306.517177,2479.887883,507.550313,14,0
0,0,37,37,25,64,89,222,144,366,0.000333,0.790039,24,56882.84246,3160.157914,2370.118436,500.096405,15,0
0,0,37,37,25,66,91,222,145,367,0.000333,0.79612,24,57320.65519,3184.480844,2388.360633,515.026417,15,0
0,0,37,37,25,66,91,222,145,367,0.000333,0.79612,24,57320.65519,3184.480844,2388.360633,515.026417,15,0
0,0,37,37,25,66,91,222,145,367,0.000333,0.79612,24,57320.65519,3184.480844,2388.360633,515.026417,15,0
0,0,37,37,25,66,91,222,145,367,0.000333,0.79612,24,57320.65519,3184.480844,2388.360633,515.026417,15,0
0,0,38,38,25,65,90,226,153,379,0.000333,0.820137,24,59049.89576,3280.549765,2460.412324,507.550313,14,0
0,0,38,38,25,65,90,226,153,379,0.000333,0.820137,24,59049.89576,3280.549765,2460.412324,507.550313,14,0
0,0,39,39,28,68,96,241,158,399,0.000333,0.8758,28,73567.20106,4087.066725,2627.400038,548.553411,16,0
0,0,36,36,25,64,89,219,143,362,0.000333,0.781405,24,56261.17205,3125.620669,2344.215502,500.096405,14,0
0,0,34,34,19,53,72,162,117,279,0.000333,0.573803,18,30985.36336,1721.409075,1721.409075,384.290407,11,0
0,0,25,25,21,53,74,127,109,236,0.000333,0.488477,20,29308.61989,1628.25666,1465.430994,395.81845,9,0
0,0,22,22,19,47,66,115,82,197,0.000333,0.396915,9,10716.71077,595.372821,1190.745642,341.776299,9,0
0,0,22,22,19,47,66,115,82,197,0.000333,0.396915,9,10716.71077,595.372821,1190.745642,341.776299,9,0
0,0,22,22,19,47,66,115,82,197,0.000333,0.396915,9,10716.71077,595.372821,1190.745642,341.776299,9,0
0,0,22,22,19,47,66,115,82,197,0.000333,0.396915,9,10716.71077,595.372821,1190.745642,341.776299,9,0
0,0,22,22,19,47,66,115,82,197,0.000333,0.396915,9,10716.71077,595.372821,1190.745642,341.776299,9,0
0,0,44,44,25,72,97,243,199,442,0.000333,0.972387,24,70011.87543,3889.548635,2917.161476,560.331005,14,0
0,0,29,29,21,48,69,144,101,245,0.000333,0.498863,20,29931.76984,1662.876102,1496.588492,360.316866,9,0
0,0,39,39,25,70,95,231,160,391,0.000333,0.856271,24,61651.52503,3425.084724,2568.813543,545.146216,14,0
0,0,40,40,25,71,96,240,164,404,0.000333,0.886775,24,63847.79641,3547.0998,2660.32485,552.72845,14,0
0,0,27,27,20,44,64,137,87,224,0.000333,0.448,10,13440,746.666667,1344,326.653553,9,0
0,0,40,40,25,70,95,236,164,400,0.000333,0.875981,24,63070.61384,3503.922991,2627.942243,545.146216,14,0
0,0,27,27,20,48,68,136,91,227,0.000333,0.460618,10,13818.54065,767.696703,1381.854065,354.516762,9,0
0,0,24,24,19,43,62,108,77,185,0.000333,0.367175,9,9913.736857,550.763159,1101.526317,314.040007,10,0
0,0,24,24,19,43,62,107,77,184,0.000333,0.365191,9,9860.14909,547.786061,1095.572121,314.040007,10,0
0,0,7,7,9,11,20,18,16,34,0.000333,0.048982,4,587.782221,32.654568,146.945555,66.583073,3,0
0,0,7,7,8,11,19,17,16,33,0.000333,0.046727,4,560.726432,31.151468,140.181608,62.053748,3,0
0,0,24,24,20,43,63,107,75,182,0.000333,0.362622,10,10878.64946,604.369414,1087.864946,319.767946,10,0
0,0,24,24,20,43,63,107,75,182,0.000333,0.362622,10,10878.64946,604.369414,1087.864946,319.767946,10,0
0,0,7,7,8,10,18,17,14,31,0.000333,0.043089,4,517.0707,28.72615,129.267675,57.219281,3,0
0,0,7,7,8,10,18,17,14,31,0.000333,0.043089,4,517.0707,28.72615,129.267675,57.219281,3,0
0,0,24,24,19,41,60,107,75,182,0.000333,0.358351,9,9675.486796,537.527044,1075.054088,300.370255,10,0
0,0,7,7,8,9,17,17,14,31,0.000333,0.042237,4,506.845392,28.158077,126.711348,52.529325,3,0
0,0,28,28,20,43,63,115,81,196,0.000333,0.390516,10,11715.46865,650.859369,1171.546865,319.767946,10,0
0,0,28,28,20,42,62,115,81,196,0.000333,0.389007,10,11670.22477,648.34582,1167.022477,312.915894,10,0
0,0,11,11,9,12,21,25,20,45,0.000333,0.065885,4,790.617136,43.923174,197.654284,71.548875,3,0
0,0,11,11,9,10,19,25,20,45,0.000333,0.063719,8,1529.253905,84.95855,191.156738,61.748606,3,0
0,0,29,29,20,45,65,126,86,212,0.000333,0.425581,10,12767.41976,709.301098,1276.741976,333.571951,10,0
0,0,45,45,21,43,64,213,144,357,0.000333,0.714,30,64260,3570,2142,325.56805,16,0
0,0,45,45,21,43,64,213,144,357,0.000333,0.714,30,64260,3570,2142,325.56805,16,0
0,0,12,12,10,12,22,37,24,61,0.000333,0.090675,10,2720.253287,151.125183,272.025329,76.238831,3,0
0,0,12,12,10,12,22,37,24,61,0.000333,0.090675,10,2720.253287,151.125183,272.025329,76.238831,3,0
0,0,23,23,18,50,68,118,85,203,0.000333,0.411918,9,11121.79461,617.877478,1235.754957,357.25146,10,0
0,0,19,19,18,42,60,102,71,173,0.000333,0.340631,9,9197.028657,510.946037,1021.892073,301.535982,7,0
0,0,22,22,20,47,67,114,89,203,0.000333,0.410472,10,12314.16106,684.120059,1231.416106,347.504238,11,0
0,0,17,17,17,42,59,100,71,171,0.000333,0.335311,8,8047.455692,447.080872,1005.931961,295.9642,9,0
0,0,7,7,13,11,24,23,20,43,0.000333,0.065718,6,1182.920325,65.717796,197.153388,86.159464,3,0
0,0,7,7,7,10,17,17,20,37,0.000333,0.050412,6,907.416751,50.412042,151.236125,52.870765,1,0
0,0,7,7,9,10,19,19,20,39,0.000333,0.055223,8,1325.353384,73.630744,165.669173,61.748606,2,0
0,0,22,22,18,46,64,115,81,196,0.000333,0.392,9,10584,588,1176,329.1425,9,0
0,0,8,8,9,11,20,22,18,40,0.000333,0.057626,4,691.508495,38.417139,172.877124,66.583073,4,0
0,0,8,8,9,11,20,21,18,39,0.000333,0.056185,4,674.220783,37.45671,168.555196,66.583073,4,0
0,0,7,7,9,11,20,18,16,34,0.000333,0.048982,4,587.782221,32.654568,146.945555,66.583073,3,0
0,0,7,7,8,11,19,17,16,33,0.000333,0.046727,4,560.726432,31.151468,140.181608,62.053748,3,0
0,0,8,8,9,11,20,21,16,37,0.000333,0.053304,4,639.645358,35.535853,159.91134,66.583073,4,0
0,0,8,8,9,10,19,21,16,37,0.000333,0.052391,4,628.693272,34.927404,157.173318,61.748606,4,0
0,0,7,7,8,11,19,17,14,31,0.000333,0.043895,4,526.743012,29.263501,131.685753,62.053748,3,0
0,0,7,7,8,10,18,17,14,31,0.000333,0.043089,4,517.0707,28.72615,129.267675,57.219281,3,0
0,0,6,6,9,11,20,17,14,31,0.000333,0.04466,4,535.919084,29.773282,133.979771,66.583073,3,0
0,0,6,6,9,11,20,16,14,30,0.000333,0.043219,4,518.631371,28.812854,129.657843,66.583073,3,0
0,0,7,7,9,11,20,18,16,34,0.000333,0.048982,4,587.782221,32.654568,146.945555,66.583073,3,0
0,0,7,7,8,11,19,17,16,33,0.000333,0.046727,4,560.726432,31.151468,140.181608,62.053748,3,0
0,0,8,8,10,10,20,21,16,37,0.000333,0.053304,5,799.556698,44.419817,159.91134,66.438562,3,0
0,0,8,8,10,10,20,21,16,37,0.000333,0.053304,5,799.556698,44.419817,159.91134,66.438562,3,0
0,0,11,11,9,12,21,27,20,47,0.000333,0.068813,4,825.755675,45.875315,206.438919,71.548875,3,0
0,0,11,11,9,10,19,27,20,47,0.000333,0.066551,8,1597.220745,88.734486,199.652593,61.748606,3,0
0,0,6,6,9,10,19,16,13,29,0.000333,0.041063,4,492.759592,27.375533,123.189898,61.748606,3,0
0,0,6,6,9,10,19,16,13,29,0.000333,0.041063,4,492.759592,27.375533,123.189898,61.748606,3,0
0,0,8,8,10,10,20,20,16,36,0.000333,0.051863,5,777.947057,43.219281,155.589411,66.438562,3,0
0,0,8,8,10,10,20,20,16,36,0.000333,0.051863,5,777.947057,43.219281,155.589411,66.438562,3,0
0,0,12,12,10,14,24,38,25,63,0.000333,0.096284,5,1444.263188,80.236844,288.852638,86.52225,4,0
0,0,8,8,11,12,23,25,17,42,0.000333,0.06333,5,949.948011,52.774889,189.989602,81.073298,3,0
0,0,8,8,11,12,23,25,17,42,0.000333,0.06333,5,949.948011,52.774889,189.989602,81.073298,3,0
0,0,6,6,9,11,20,17,14,31,0.000333,0.04466,4,535.919084,29.773282,133.979771,66.583073,3,0
0,0,6,6,9,11,20,16,14,30,0.000333,0.043219,4,518.631371,28.812854,129.657843,66.583073,3,0
0,0,6,6,9,11,20,17,14,31,0.000333,0.04466,4,535.919084,29.773282,133.979771,66.583073,3,0
0,0,6,6,9,11,20,16,14,30,0.000333,0.043219,4,518.631371,28.812854,129.657843,66.583073,3,0
0,0,6,6,10,10,20,16,13,29,0.000333,0.041779,5,626.679574,34.815532,125.335915,66.438562,3,0
0,0,6,6,10,10,20,16,13,29,0.000333,0.041779,5,626.679574,34.815532,125.335915,66.438562,3,0
0,0,6,6,10,9,19,16,13,29,0.000333,0.041063,5,615.949489,34.219416,123.189898,61.748606,3,0
0,0,48,48,26,78,104,268,216,484,0.000333,1.081004,26,84318.33341,4684.351856,3243.012824,612.472806,17,0
0,0,32,32,21,52,73,157,111,268,0.000333,0.552958,20,33177.45964,1843.192202,1658.872982,388.661531,11,0
0,0,30,30,20,52,72,149,101,250,0.000333,0.51416,10,15424.8125,856.934028,1542.48125,382.861427,11,0
0,0,43,43,25,74,99,244,181,425,0.000333,0.939159,24,67619.43753,3756.635418,2817.476564,575.595954,16,0
0,0,45,45,25,75,100,250,195,445,0.000333,0.985505,24,70956.38411,3942.021339,2956.516004,583.257807,16,0
0,0,41,41,25,69,94,239,161,400,0.000333,0.873945,24,62924.05298,3495.780721,2621.835541,537.584592,16,0
0,0,32,32,21,48,69,158,105,263,0.000333,0.535514,20,32130.83864,1785.046591,1606.541932,360.316866,11,0
0,0,30,30,20,48,68,150,97,247,0.000333,0.501201,20,30072.06644,1670.670358,1503.603322,354.516762,11,0
0,0,11,11,14,15,29,31,47,78,0.000333,0.126308,21,7957.37287,442.076271,378.922518,111.906328,2,0
0,0,10,10,12,14,26,25,45,70,0.000333,0.109677,18,5922.554045,329.03078,329.03078,96.322519,1,0
0,0,3,3,8,8,16,10,13,23,0.000333,0.030667,4,368,20.444444,92,48,2,0
0,0,2,2,6,7,13,6,11,17,0.000333,0.020969,3,188.722426,10.484579,62.907475,35.161259,1,0
0,0,9,9,13,16,29,27,33,60,0.000333,0.09716,12,3497.746316,194.31924,291.47886,112.105716,2,0
0,0,8,8,11,15,26,21,31,52,0.000333,0.081474,10,2444.228653,135.790481,244.422865,96.657107,1,0
0,0,29,29,20,45,65,144,98,242,0.000333,0.485804,20,29148.26022,1619.34779,1457.413011,333.571951,9,0
0,0,35,35,19,49,68,161,128,289,0.000333,0.586426,18,31666.9817,1759.276761,1759.276761,355.831405,9,0
0,0,33,33,19,48,67,155,118,273,0.000333,0.552014,18,29808.76228,1656.042349,1656.042349,348.788823,9,0
0,0,31,31,19,47,66,149,108,257,0.000333,0.517803,18,27961.3672,1553.409289,1553.409289,341.776299,9,0
0,0,29,29,19,46,65,143,98,241,0.000333,0.483797,18,26125.03157,1451.390643,1451.390643,334.794473,9,0
0,0,27,27,19,45,64,136,90,226,0.000333,0.452,18,24408,1356,1356,327.844012,9,0
0,0,27,27,19,45,64,137,88,225,0.000333,0.45,9,12150,675,1350,327.844012,9,0
0,0,29,29,21,45,66,145,94,239,0.000333,0.481537,20,28892.20389,1605.122438,1444.610195,339.372055,9,0
0,0,3,3,5,11,16,6,14,20,0.000333,0.026667,2,160,8.888889,80,49.663388,1,0
0,0,4,4,7,12,19,10,16,26,0.000333,0.036815,3,331.338346,18.407686,110.446115,62.671034,2,0
0,0,27,27,20,49,69,144,99,243,0.000333,0.49479,20,29687.42886,1649.301603,1484.371443,361.559344,11,0
0,0,32,32,22,53,75,159,122,281,0.000333,0.583433,22,38506.55715,2139.253175,1750.298052,401.68728,11,0
0,0,30,30,20,49,69,151,98,249,0.000333,0.507008,20,30420.4518,1690.0251,1521.02259,361.559344,11,0
0,0,30,30,21,49,70,151,98,249,0.000333,0.50873,20,30523.82942,1695.768301,1526.191471,367.359448,11,0
0,0,20,20,19,44,63,105,74,179,0.000333,0.356644,9,9629.397957,534.966553,1069.933106,320.925614,8,0
0,0,20,20,19,44,63,105,74,179,0.000333,0.356644,9,9629.397957,534.966553,1069.933106,320.925614,8,0
0,0,20,20,19,44,63,105,73,178,0.000333,0.354652,9,9575.602437,531.977913,1063.955826,320.925614,8,0
0,0,20,20,19,44,63,105,73,178,0.000333,0.354652,9,9575.602437,531.977913,1063.955826,320.925614,8,0
0,0,19,19,19,43,62,102,72,174,0.000333,0.345343,9,9324.271422,518.015079,1036.030158,314.040007,7,0
0,0,20,20,19,43,62,105,73,178,0.000333,0.353282,9,9538.622489,529.923472,1059.846943,314.040007,8,0
0,0,20,20,19,43,62,105,73,178,0.000333,0.353282,9,9538.622489,529.923472,1059.846943,314.040007,8,0
0,0,20,20,19,44,63,105,73,178,0.000333,0.354652,9,9575.602437,531.977913,1063.955826,320.925614,8,0
0,0,20,20,19,44,63,105,73,178,0.000333,0.354652,9,9575.602437,531.977913,1063.955826,320.925614,8,0
0,0,20,20,19,45,64,105,74,179,0.000333,0.358,9,9666,537,1074,327.844012,8,0
0,0,20,20,19,45,64,105,74,179,0.000333,0.358,9,9666,537,1074,327.844012,8,0
0,0,27,27,20,47,67,144,95,239,0.000333,0.483265,20,28995.90633,1610.883685,1449.795317,347.504238,11,0
0,0,32,32,21,52,73,158,113,271,0.000333,0.559147,20,33548.84911,1863.824951,1677.442455,388.661531,11,0
0,0,30,30,19,49,68,150,98,248,0.000333,0.50323,18,27174.43412,1509.690785,1509.690785,355.831405,11,0
0,0,30,30,20,49,69,150,98,248,0.000333,0.504971,20,30298.28131,1683.23785,1514.914065,361.559344,11,0
0,0,29,29,21,46,67,146,91,237,0.000333,0.479221,10,14376.63138,798.701743,1437.663138,346.322516,10,0
0,0,22,22,21,49,70,114,99,213,0.000333,0.435179,20,26110.74565,1450.596981,1305.537283,367.359448,7,0
0,0,32,32,21,49,70,158,104,262,0.000333,0.535291,20,32117.44301,1784.302389,1605.87215,367.359448,11,0
0,0,30,30,19,49,68,150,98,248,0.000333,0.50323,18,27174.43412,1509.690785,1509.690785,355.831405,11,0
0,0,32,32,19,50,69,156,108,264,0.000333,0.53755,18,29027.70822,1612.650457,1612.650457,362.903432,11,0
0,0,30,30,19,49,68,149,100,249,0.000333,0.505259,18,27284.00845,1515.778247,1515.778247,355.831405,11,0
0,0,36,36,19,52,71,168,128,296,0.000333,0.606775,18,32765.85265,1820.325147,1820.325147,377.133488,11,0
0,0,34,34,19,51,70,162,118,280,0.000333,0.572066,18,30891.58641,1716.199245,1716.199245,370.004315,11,0
0,0,22,22,19,47,66,115,82,197,0.000333,0.396915,9,10716.71077,595.372821,1190.745642,341.776299,9,0
0,0,20,20,17,46,63,113,81,194,0.000333,0.386531,8,9276.738441,515.374358,1159.592305,323.570718,11,0
0,0,25,25,20,51,71,127,99,226,0.000333,0.463281,10,13898.42849,772.134916,1389.842849,375.732254,13,0
0,0,32,32,21,50,71,159,101,260,0.000333,0.532978,20,31978.68502,1776.593612,1598.934251,374.431475,12,0
0,0,25,25,20,49,69,123,87,210,0.000333,0.427597,10,12827.90136,712.661187,1282.790136,361.559344,10,0
0,0,23,23,18,50,68,118,85,203,0.000333,0.411918,9,11121.79461,617.877478,1235.754957,357.25146,10,0
0,0,23,23,18,49,67,118,84,202,0.000333,0.40845,9,11028.15015,612.675008,1225.350016,350.179432,10,0
0,0,9,9,9,15,24,29,31,60,0.000333,0.091699,8,2200.782,122.265667,275.09775,87.132684,1,0
0,0,10,10,11,15,26,33,33,66,0.000333,0.10341,10,3102.290214,172.349456,310.229021,96.657107,2,0
0,0,2,2,4,9,13,6,10,16,0.000333,0.019736,2,118.414071,6.578559,59.207035,36.529325,1,0
0,0,3,3,6,10,16,10,12,22,0.000333,0.029333,3,264,14.666667,88,48.729056,2,0
0,0,23,23,19,49,68,118,84,202,0.000333,0.409889,9,11067.00745,614.833747,1229.667494,355.831405,10,0
0,0,23,23,19,49,68,118,84,202,0.000333,0.409889,9,11067.00745,614.833747,1229.667494,355.831405,10,0
0,0,25,25,20,48,68,123,86,209,0.000333,0.424093,10,12722.79734,706.822074,1272.279734,354.516762,10,0
0,0,25,25,20,48,68,123,86,209,0.000333,0.424093,10,12722.79734,706.822074,1272.279734,354.516762,10,0
0,0,23,23,19,48,67,118,83,201,0.000333,0.406428,9,10973.55535,609.641964,1219.283927,348.788823,10,0
0,0,23,23,19,48,67,118,83,201,0.000333,0.406428,9,10973.55535,609.641964,1219.283927,348.788823,10,0
0,0,23,23,19,49,68,118,84,202,0.000333,0.409889,9,11067.00745,614.833747,1229.667494,355.831405,10,0
0,0,23,23,19,49,68,118,84,202,0.000333,0.409889,9,11067.00745,614.833747,1229.667494,355.831405,10,0
0,0,23,23,19,48,67,118,84,202,0.000333,0.40845,9,11028.15015,612.675008,1225.350016,348.788823,10,0
0,0,23,23,19,48,67,118,84,202,0.000333,0.40845,9,11028.15015,612.675008,1225.350016,348.788823,10,0
0,0,23,23,19,48,67,118,83,201,0.000333,0.406428,9,10973.55535,609.641964,1219.283927,348.788823,10,0
0,0,23,23,19,48,67,118,83,201,0.000333,0.406428,9,10973.55535,609.641964,1219.283927,348.788823,10,0
0,0,22,22,19,47,66,115,82,197,0.000333,0.396915,9,10716.71077,595.372821,1190.745642,341.776299,9,0
0,0,23,23,19,47,66,118,83,201,0.000333,0.404974,9,10934.30896,607.461609,1214.923218,341.776299,10,0
0,0,23,23,19,47,66,118,83,201,0.000333,0.404974,9,10934.30896,607.461609,1214.923218,341.776299,10,0
0,0,17,17,17,44,61,100,75,175,0.000333,0.34596,8,8303.032273,461.279571,1037.879034,309.70186,7,0
0,0,18,18,16,43,59,98,69,167,0.000333,0.327467,8,7859.211114,436.62284,982.401389,297.329384,7,0
0,0,9,9,7,14,21,21,36,57,0.000333,0.083454,6,1502.172559,83.454031,250.362093,72.954453,1,0
0,0,12,12,12,21,33,39,47,86,0.000333,0.144606,12,5205.814731,289.21193,433.817894,135.258216,3,0
0,0,30,30,19,47,66,149,101,250,0.000333,0.5037,18,27199.77354,1511.09853,1511.09853,341.776299,9,0
0,0,27,27,19,45,64,137,88,225,0.000333,0.45,9,12150,675,1350,327.844012,9,0
0,0,31,31,19,47,66,154,105,259,0.000333,0.521833,18,28178.96538,1565.498077,1565.498077,341.776299,9,0
0,0,27,27,19,45,64,136,90,226,0.000333,0.452,18,24408,1356,1356,327.844012,9,0
0,0,12,12,15,19,34,53,40,93,0.000333,0.157711,14,6623.876619,367.993146,473.134044,139.313982,4,0
0,0,11,11,15,16,31,52,36,88,0.000333,0.145323,14,6103.569854,339.087214,435.969275,122.603359,4,0
0,0,11,11,15,16,31,51,36,87,0.000333,0.143672,14,6034.211106,335.23395,431.015079,122.603359,4,0
0,0,20,20,17,46,63,113,81,194,0.000333,0.386531,8,9276.738441,515.374358,1159.592305,323.570718,9,0
0,0,25,25,20,51,71,126,99,225,0.000333,0.461231,10,13836.93102,768.71839,1383.693102,375.732254,9,0
0,0,22,22,18,48,66,115,83,198,0.000333,0.39893,9,10771.11032,598.395018,1196.790036,343.13685,9,0
0,0,9,9,13,11,24,33,27,60,0.000333,0.091699,12,3301.173001,183.3985,275.09775,86.159464,4,0
0,0,8,8,11,12,23,29,25,54,0.000333,0.081424,10,2442.723456,135.706859,244.272346,81.073298,3,0
0,0,6,6,9,9,18,15,14,29,0.000333,0.040309,4,483.7113,26.87285,120.927825,57.05865,2,0
0,0,5,5,7,9,16,11,12,23,0.000333,0.030667,3,276,15.333333,92,48.180809,1,0
0,0,24,24,19,48,67,124,91,215,0.000333,0.434736,9,11737.88258,652.104588,1304.209176,348.788823,9,0
0,0,22,22,19,47,66,115,82,197,0.000333,0.396915,9,10716.71077,595.372821,1190.745642,341.776299,9,0
0,0,22,22,19,47,66,115,82,197,0.000333,0.396915,9,10716.71077,595.372821,1190.745642,341.776299,9,0
0,0,22,22,19,47,66,115,82,197,0.000333,0.396915,9,10716.71077,595.372821,1190.745642,341.776299,9,0
0,0,24,24,19,48,67,124,88,212,0.000333,0.42867,9,11574.09818,643.005454,1286.010908,348.788823,9,0
0,0,8,8,9,11,20,21,16,37,0.000333,0.053304,4,639.645358,35.535853,159.91134,66.583073,4,0
0,0,8,8,9,10,19,21,16,37,0.000333,0.052391,4,628.693272,34.927404,157.173318,61.748606,4,0
0,0,7,7,8,11,19,17,14,31,0.000333,0.043895,4,526.743012,29.263501,131.685753,62.053748,3,0
0,0,7,7,8,10,18,17,14,31,0.000333,0.043089,4,517.0707,28.72615,129.267675,57.219281,3,0
0,0,8,8,9,11,20,21,16,37,0.000333,0.053304,4,639.645358,35.535853,159.91134,66.583073,4,0
0,0,8,8,9,10,19,21,16,37,0.000333,0.052391,4,628.693272,34.927404,157.173318,61.748606,4,0
0,0,7,7,8,11,19,17,14,31,0.000333,0.043895,4,526.743012,29.263501,131.685753,62.053748,3,0
0,0,7,7,8,10,18,17,14,31,0.000333,0.043089,4,517.0707,28.72615,129.267675,57.219281,3,0
0,0,12,12,10,11,21,29,22,51,0.000333,0.074669,10,2240.081886,124.448994,224.008189,71.273029,4,0
0,0,12,12,10,10,20,29,22,51,0.000333,0.073473,10,2204.183328,122.454629,220.418333,66.438562,4,0
0,0,11,11,9,12,21,25,20,45,0.000333,0.065885,4,790.617136,43.923174,197.654284,71.548875,3,0
0,0,11,11,9,10,19,25,20,45,0.000333,0.063719,8,1529.253905,84.95855,191.156738,61.748606,3,0
0,0,13,13,10,14,24,40,27,67,0.000333,0.102397,5,1535.962438,85.331247,307.192488,86.52225,4,0
0,0,13,13,11,12,23,41,26,67,0.000333,0.101026,10,3030.786511,168.377028,303.078651,81.073298,4,0
0,0,13,13,11,12,23,41,26,67,0.000333,0.101026,10,3030.786511,168.377028,303.078651,81.073298,4,0
0,0,12,12,10,12,22,37,24,61,0.000333,0.090675,10,2720.253287,151.125183,272.025329,76.238831,3,0
0,0,12,12,10,12,22,37,24,61,0.000333,0.090675,10,2720.253287,151.125183,272.025329,76.238831,3,0
0,0,8,8,9,11,20,22,18,40,0.000333,0.057626,4,691.508495,38.417139,172.877124,66.583073,4,0
0,0,8,8,9,11,20,21,18,39,0.000333,0.056185,4,674.220783,37.45671,168.555196,66.583073,4,0
0,0,7,7,9,11,20,18,16,34,0.000333,0.048982,4,587.782221,32.654568,146.945555,66.583073,3,0
0,0,7,7,8,11,19,17,16,33,0.000333,0.046727,4,560.726432,31.151468,140.181608,62.053748,3,0
0,0,21,21,17,46,63,112,78,190,0.000333,0.378561,8,9085.465484,504.748082,1135.683185,323.570718,9,0
0,0,8,8,10,11,21,21,16,37,0.000333,0.054172,5,812.578723,45.143262,162.515745,71.273029,4,0
0,0,8,8,10,11,21,21,16,37,0.000333,0.054172,5,812.578723,45.143262,162.515745,71.273029,4,0
0,0,7,7,8,10,18,17,14,31,0.000333,0.043089,4,517.0707,28.72615,129.267675,57.219281,3,0
0,0,7,7,8,10,18,17,14,31,0.000333,0.043089,4,517.0707,28.72615,129.267675,57.219281,3,0
0,0,8,8,10,9,19,21,16,37,0.000333,0.052391,5,785.86659,43.659255,157.173318,61.748606,4,0
0,0,7,7,8,9,17,17,14,31,0.000333,0.042237,4,506.845392,28.158077,126.711348,52.529325,3,0
0,0,22,22,20,47,67,113,89,202,0.000333,0.40845,10,12253.50017,680.750009,1225.350016,347.504238,7,0
0,0,17,17,17,42,59,100,71,171,0.000333,0.335311,8,8047.455692,447.080872,1005.931961,295.9642,7,0
0,0,19,19,18,42,60,101,71,172,0.000333,0.338662,9,9143.866642,507.992591,1015.985182,301.535982,7,0
0,0,27,27,20,47,67,144,95,239,0.000333,0.483265,20,28995.90633,1610.883685,1449.795317,347.504238,11,0
0,0,3,3,5,11,16,6,14,20,0.000333,0.026667,2,160,8.888889,80,49.663388,1,0
0,0,4,4,7,12,19,10,16,26,0.000333,0.036815,3,331.338346,18.407686,110.446115,62.671034,2,0
0,0,30,30,20,48,68,150,97,247,0.000333,0.501201,20,30072.06644,1670.670358,1503.603322,354.516762,11,0
0,0,32,32,21,51,72,158,112,270,0.000333,0.555293,20,33317.59501,1850.9775,1665.87975,381.532358,11,0
0,0,27,27,20,47,67,144,95,239,0.000333,0.483265,20,28995.90633,1610.883685,1449.795317,347.504238,11,0
0,0,22,22,18,46,64,115,81,196,0.000333,0.392,9,10584,588,1176,329.1425,9,0
0,0,20,20,17,46,63,113,81,194,0.000333,0.386531,8,9276.738441,515.374358,1159.592305,323.570718,9,0
0,0,25,25,20,51,71,127,99,226,0.000333,0.463281,10,13898.42849,772.134916,1389.842849,375.732254,9,0
0,0,29,29,21,49,70,145,107,252,0.000333,0.51486,20,30891.58641,1716.199245,1544.57932,367.359448,9,0
0,0,24,24,20,44,64,131,87,218,0.000333,0.436,10,13080,726.666667,1308,326.653553,9,0
0,0,18,18,16,43,59,98,69,167,0.000333,0.327467,8,7859.211114,436.62284,982.401389,297.329384,7,0
0,0,22,22,18,48,66,115,83,198,0.000333,0.39893,9,10771.11032,598.395018,1196.790036,343.13685,9,0
0,0,23,23,18,48,66,118,84,202,0.000333,0.406989,9,10988.70851,610.483806,1220.967612,343.13685,10,0
0,0,25,25,20,51,71,126,99,225,0.000333,0.461231,10,13836.93102,768.71839,1383.693102,375.732254,9,0
0,0,20,20,17,46,63,113,81,194,0.000333,0.386531,8,9276.738441,515.374358,1159.592305,323.570718,9,0
0,0,20,20,19,44,63,105,73,178,0.000333,0.354652,9,9575.602437,531.977913,1063.955826,320.925614,8,0
0,0,20,20,19,44,63,105,73,178,0.000333,0.354652,9,9575.602437,531.977913,1063.955826,320.925614,8,0
0,0,29,29,21,47,68,145,102,247,0.000333,0.501201,20,30072.06644,1670.670358,1503.603322,353.304342,9,0
0,0,31,31,20,47,67,128,91,219,0.000333,0.442825,10,13284.73533,738.040852,1328.473533,347.504238,12,0
0,0,31,31,20,46,66,128,91,219,0.000333,0.441241,10,13237.22312,735.401285,1323.722312,340.522412,12,0
0,0,11,11,9,12,21,25,20,45,0.000333,0.065885,4,790.617136,43.923174,197.654284,71.548875,3,0
0,0,11,11,9,10,19,25,20,45,0.000333,0.063719,8,1529.253905,84.95855,191.156738,61.748606,3,0
0,0,20,20,20,44,64,105,73,178,0.000333,0.356,10,10680,593.333333,1068,326.653553,8,0
0,0,20,20,20,44,64,105,73,178,0.000333,0.356,10,10680,593.333333,1068,326.653553,8,0
0,0,20,20,19,44,63,105,73,178,0.000333,0.354652,9,9575.602437,531.977913,1063.955826,320.925614,8,0
0,0,20,20,19,44,63,105,73,178,0.000333,0.354652,9,9575.602437,531.977913,1063.955826,320.925614,8,0
0,0,20,20,19,45,64,105,74,179,0.000333,0.358,9,9666,537,1074,327.844012,8,0
0,0,20,20,19,45,64,105,74,179,0.000333,0.358,9,9666,537,1074,327.844012,8,0
0,0,22,22,20,44,64,110,76,186,0.000333,0.372,10,11160,620,1116,326.653553,8,0
0,0,22,22,20,44,64,110,76,186,0.000333,0.372,10,11160,620,1116,326.653553,8,0
0,0,20,20,19,45,64,105,74,179,0.000333,0.358,9,9666,537,1074,327.844012,8,0
0,0,20,20,19,45,64,105,74,179,0.000333,0.358,9,9666,537,1074,327.844012,8,0
0,0,20,20,19,45,64,105,74,179,0.000333,0.358,9,9666,537,1074,327.844012,8,0
0,0,20,20,19,45,64,105,74,179,0.000333,0.358,9,9666,537,1074,327.844012,8,0
0,0,22,22,20,44,64,109,76,185,0.000333,0.37,10,11100,616.666667,1110,326.653553,8,0
0,0,22,22,20,44,64,109,76,185,0.000333,0.37,10,11100,616.666667,1110,326.653553,8,0
0,0,18,18,17,42,59,99,68,167,0.000333,0.327467,8,7859.211114,436.62284,982.401389,295.9642,7,0
0,0,19,19,19,43,62,102,72,174,0.000333,0.345343,9,9324.271422,518.015079,1036.030158,314.040007,7,0
0,0,20,20,19,43,62,105,73,178,0.000333,0.353282,9,9538.622489,529.923472,1059.846943,314.040007,8,0
0,0,29,29,21,48,69,145,103,248,0.000333,0.504971,20,30298.28131,1683.23785,1514.914065,360.316866,9,0
0,0,24,24,20,43,63,131,85,216,0.000333,0.430364,10,12910.92464,717.273591,1291.092463,319.767946,9,0
0,0,19,19,18,44,62,102,73,175,0.000333,0.347328,9,9377.859189,520.992177,1041.984354,315.273641,7,0
0,0,27,27,19,45,64,137,88,225,0.000333,0.45,9,12150,675,1350,327.844012,9,0
0,0,19,19,18,44,62,102,73,175,0.000333,0.347328,9,9377.859189,520.992177,1041.984354,315.273641,7,0
0,0,27,27,20,45,65,137,88,225,0.000333,0.451678,10,13550.32758,752.795977,1355.032758,333.571951,9,0
0,0,22,22,19,46,65,114,81,195,0.000333,0.391454,9,10569.25551,587.180862,1174.361724,334.794473,8,0
0,0,22,22,18,46,64,113,87,200,0.000333,0.4,9,10800,600,1200,329.1425,8,0
0,0,19,19,18,44,62,102,73,175,0.000333,0.347328,9,9377.859189,520.992177,1041.984354,315.273641,7,0
0,0,10,10,9,16,25,29,34,63,0.000333,0.097521,8,2340.50352,130.027973,292.56294,92.529325,1,0
0,0,10,10,11,16,27,31,34,65,0.000333,0.103023,10,3090.676876,171.704271,309.067688,102.053748,2,0
0,0,21,21,21,45,66,111,80,191,0.000333,0.384826,10,11544.79277,641.377376,1154.479277,339.372055,8,0
0,0,24,24,20,43,63,131,85,216,0.000333,0.430364,10,12910.92464,717.273591,1291.092463,319.767946,9,0
0,0,20,20,19,45,64,105,74,179,0.000333,0.358,9,9666,537,1074,327.844012,8,0
0,0,17,17,17,42,59,100,71,171,0.000333,0.335311,8,8047.455692,447.080872,1005.931961,295.9642,7,0
0,0,22,22,20,47,67,113,89,202,0.000333,0.40845,10,12253.50017,680.750009,1225.350016,347.504238,7,0
0,0,21,21,18,45,63,110,84,194,0.000333,0.386531,9,10436.33075,579.796153,1159.592305,322.192039,7,0
0,0,21,21,19,48,67,110,87,197,0.000333,0.39834,9,10755.17614,597.509785,1195.019571,348.788823,7,0
0,0,24,24,19,43,62,108,77,185,0.000333,0.367175,9,9913.736857,550.763159,1101.526317,314.040007,10,0
0,0,24,24,19,43,62,107,77,184,0.000333,0.365191,9,9860.14909,547.786061,1095.572121,314.040007,10,0
0,0,7,7,9,11,20,18,16,34,0.000333,0.048982,4,587.782221,32.654568,146.945555,66.583073,3,0
0,0,7,7,8,11,19,17,16,33,0.000333,0.046727,4,560.726432,31.151468,140.181608,62.053748,3,0
0,0,27,27,20,47,67,144,95,239,0.000333,0.483265,20,28995.90633,1610.883685,1449.795317,347.504238,11,0
0,0,32,32,21,52,73,158,113,271,0.000333,0.559147,20,33548.84911,1863.824951,1677.442455,388.661531,11,0
0,0,19,19,19,43,62,102,72,174,0.000333,0.345343,9,9324.271422,518.015079,1036.030158,314.040007,7,0
0,0,21,21,18,45,63,111,79,190,0.000333,0.378561,9,10221.14867,567.841593,1135.683185,322.192039,7,0
0,0,5,5,13,14,27,42,26,68,0.000333,0.107777,6,1939.994101,107.77745,323.33235,101.408685,2,0
0,0,24,24,20,44,64,131,87,218,0.000333,0.436,10,13080,726.666667,1308,326.653553,9,0
0,0,21,21,16,48,64,111,80,191,0.000333,0.382,8,9168,509.333333,1146,332.0782,9,0
0,0,29,29,21,48,69,145,106,251,0.000333,0.51108,20,30664.79277,1703.599599,1533.239639,360.316866,9,0
0,0,22,22,18,49,67,114,84,198,0.000333,0.400362,9,10809.77094,600.54283,1201.08566,350.179432,9,0
0,0,22,22,18,49,67,114,84,198,0.000333,0.400362,9,10809.77094,600.54283,1201.08566,350.179432,9,0
0,0,24,24,18,50,68,122,97,219,0.000333,0.444385,9,11998.38926,666.577181,1333.154362,357.25146,9,0
0,0,22,22,18,49,67,114,84,198,0.000333,0.400362,9,10809.77094,600.54283,1201.08566,350.179432,9,0
0,0,21,21,18,46,64,110,80,190,0.000333,0.38,9,10260,570,1140,329.1425,7,0
0,0,20,20,18,45,63,104,75,179,0.000333,0.356644,9,9629.397957,534.966553,1069.933106,322.192039,8,0
0,0,20,20,19,46,65,104,75,179,0.000333,0.359335,9,9702.034547,539.001919,1078.003839,334.794473,8,0
0,0,30,30,21,47,68,147,96,243,0.000333,0.493084,20,29585.06941,1643.614967,1479.25347,353.304342,10,0
0,0,30,30,20,47,67,146,105,251,0.000333,0.507529,20,30451.76774,1691.764874,1522.588387,347.504238,10,0
0,0,29,29,21,47,68,145,92,237,0.000333,0.48091,10,14427.28693,801.515941,1442.728693,353.304342,10,0
0,0,24,24,16,37,53,102,77,179,0.000333,0.341766,16,16404.76418,911.375788,1025.297761,256.749775,3,0
0,0,28,28,16,36,52,117,84,201,0.000333,0.381929,16,18332.61413,1018.478563,1145.788383,250.1173,3,0
0,0,32,32,21,50,71,157,105,262,0.000333,0.537078,20,32224.67491,1790.259717,1611.233745,374.431475,11,0
0,0,33,33,20,51,71,159,115,274,0.000333,0.561677,20,33700.61422,1872.256345,1685.030711,375.732254,12,0
0,0,30,30,19,50,69,149,99,248,0.000333,0.504971,9,13634.22659,757.457033,1514.914065,362.903432,11,0
0,0,32,32,21,52,73,158,116,274,0.000333,0.565337,20,33920.23858,1884.457699,1696.011929,388.661531,11,0
0,0,27,27,20,48,68,144,97,241,0.000333,0.489026,20,29341.5709,1630.087272,1467.078545,354.516762,11,0
0,0,36,36,19,56,75,169,126,295,0.000333,0.612501,18,33075.02725,1837.501514,1837.501514,405.922498,12,0
0,0,36,36,19,54,73,174,123,297,0.000333,0.612793,18,33090.80209,1838.377894,1838.377894,391.474548,12,0
0,0,30,30,19,50,69,148,102,250,0.000333,0.509044,18,27488.36006,1527.131114,1527.131114,362.903432,11,0
0,0,35,35,19,52,71,162,130,292,0.000333,0.598575,18,32323.07086,1795.726159,1795.726159,377.133488,10,0
0,0,22,22,18,49,67,114,84,198,0.000333,0.400362,9,10809.77094,600.54283,1201.08566,350.179432,9,0
0,0,33,33,19,53,72,156,116,272,0.000333,0.559407,18,30207.95281,1678.2196,1678.2196,384.290407,10,0
0,0,33,33,19,51,70,161,113,274,0.000333,0.559808,18,30229.62384,1679.423547,1679.423547,370.004315,10,0
0,0,22,22,18,49,67,114,84,198,0.000333,0.400362,9,10809.77094,600.54283,1201.08566,350.179432,9,0
0,0,22,22,18,49,67,114,84,198,0.000333,0.400362,9,10809.77094,600.54283,1201.08566,350.179432,9,0
0,0,24,24,18,50,68,123,90,213,0.000333,0.43221,9,11669.66627,648.314793,1296.629585,357.25146,9,0
0,0,22,22,18,49,67,114,84,198,0.000333,0.400362,9,10809.77094,600.54283,1201.08566,350.179432,9,0
0,0,22,22,18,49,67,114,84,198,0.000333,0.400362,9,10809.77094,600.54283,1201.08566,350.179432,9,0
0,0,25,25,20,52,72,126,103,229,0.000333,0.470971,10,14129.12825,784.95157,1412.912825,382.861427,9,0
0,0,20,20,17,47,64,113,83,196,0.000333,0.392,8,9408,522.666667,1176,330.552544,9,0
0,0,24,24,19,50,69,123,91,214,0.000333,0.435741,9,11765.0181,653.612117,1307.224234,362.903432,9,0
0,0,17,17,17,43,60,100,73,173,0.000333,0.340631,8,8175.136584,454.174255,1021.892073,302.816253,7,0
0,0,22,22,20,48,68,113,93,206,0.000333,0.418006,10,12540.17345,696.676303,1254.017345,354.516762,7,0
0,0,19,19,18,45,63,101,74,175,0.000333,0.348675,9,9414.21588,523.011993,1046.023987,322.192039,7,0
0,0,19,19,18,45,63,101,74,175,0.000333,0.348675,9,9414.21588,523.011993,1046.023987,322.192039,7,0
0,0,18,18,16,44,60,98,70,168,0.000333,0.330786,8,7938.86096,441.047831,992.35762,304.214991,7,0
0,0,19,19,18,45,63,101,74,175,0.000333,0.348675,9,9414.21588,523.011993,1046.023987,322.192039,7,0
0,0,19,19,18,45,63,101,74,175,0.000333,0.348675,9,9414.21588,523.011993,1046.023987,322.192039,7,0
0,0,19,19,18,45,63,101,74,175,0.000333,0.348675,9,9414.21588,523.011993,1046.023987,322.192039,7,0
0,0,19,19,18,45,63,101,74,175,0.000333,0.348675,9,9414.21588,523.011993,1046.023987,322.192039,7,0
0,0,21,21,19,46,65,110,81,191,0.000333,0.383424,9,10352.45027,575.136126,1150.272252,334.794473,7,0
0,0,22,22,19,46,65,108,78,186,0.000333,0.373387,9,10081.44372,560.080207,1120.160413,334.794473,8,0
0,0,22,22,20,47,67,113,79,192,0.000333,0.38823,10,11646.89125,647.049514,1164.689125,347.504238,8,0
0,0,23,23,18,50,68,117,85,202,0.000333,0.409889,9,11067.00745,614.833747,1229.667494,357.25146,10,0
0,0,23,23,18,50,68,117,85,202,0.000333,0.409889,9,11067.00745,614.833747,1229.667494,357.25146,10,0
0,0,20,20,18,46,64,104,75,179,0.000333,0.358,9,9666,537,1074,329.1425,8,0
0,0,20,20,18,47,65,104,76,180,0.000333,0.361342,9,9756.235857,542.013103,1084.026206,336.124326,8,0
0,0,20,20,18,46,64,104,75,179,0.000333,0.358,9,9666,537,1074,329.1425,8,0
0,0,20,20,18,46,64,104,75,179,0.000333,0.358,9,9666,537,1074,329.1425,8,0
0,0,20,20,18,46,64,104,75,179,0.000333,0.358,9,9666,537,1074,329.1425,8,0
0,0,22,22,18,49,67,114,84,198,0.000333,0.400362,9,10809.77094,600.54283,1201.08566,350.179432,9,0
0,0,25,25,20,50,70,122,88,210,0.000333,0.42905,10,12871.49434,715.083019,1287.149434,368.631371,10,0
0,0,23,23,18,49,67,117,85,202,0.000333,0.40845,9,11028.15015,612.675008,1225.350016,350.179432,10,0
0,0,23,23,18,51,69,117,86,203,0.000333,0.413343,9,11160.27418,620.015232,1240.030465,364.352342,10,0
0,0,22,22,18,49,67,114,84,198,0.000333,0.400362,9,10809.77094,600.54283,1201.08566,350.179432,9,0
0,0,22,22,20,46,66,109,78,187,0.000333,0.376767,10,11303.017,627.945389,1130.3017,340.522412,8,0
0,0,23,23,18,50,68,117,86,203,0.000333,0.411918,9,11121.79461,617.877478,1235.754957,357.25146,10,0
0,0,23,23,18,51,69,117,86,203,0.000333,0.413343,9,11160.27418,620.015232,1240.030465,364.352342,10,0
0,0,23,23,18,50,68,117,85,202,0.000333,0.409889,9,11067.00745,614.833747,1229.667494,357.25146,10,0
0,0,8,8,12,15,27,34,29,63,0.000333,0.099853,6,1797.347476,99.852638,299.557913,101.622909,1,0
0,0,23,23,18,50,68,117,85,202,0.000333,0.409889,9,11067.00745,614.833747,1229.667494,357.25146,10,0
0,0,33,33,19,51,70,156,118,274,0.000333,0.559808,18,30229.62384,1679.423547,1679.423547,370.004315,10,0
0,0,16,16,12,22,34,58,69,127,0.000333,0.215369,18,11629.94006,646.107781,646.107781,141.127046,3,0
0,0,16,16,14,23,37,60,71,131,0.000333,0.227479,21,14331.20621,796.178123,682.438391,157.344894,4,0
0,0,16,16,14,23,37,55,49,104,0.000333,0.180594,14,7584.9641,421.386894,541.78315,157.344894,3,0
0,0,32,32,24,57,81,145,112,257,0.000333,0.543114,12,19552.09741,1086.227634,1629.341451,442.513831,10,0
0,0,10,10,13,17,30,44,31,75,0.000333,0.122672,6,2208.100768,122.672265,368.016795,117.592585,3,0
0,0,10,10,15,18,33,46,33,79,0.000333,0.132836,7,2789.549948,154.974997,398.507135,133.662009,4,0
0,0,11,11,13,21,34,44,35,79,0.000333,0.13397,6,2411.457387,133.969855,401.909564,140.344382,3,0
0,0,11,11,15,22,37,46,37,83,0.000333,0.144128,7,3026.692405,168.149578,432.384629,156.710855,4,0
0,0,15,15,13,23,36,52,47,99,0.000333,0.170608,12,6141.870902,341.21505,511.822575,152.147641,3,0
0,0,31,31,23,57,80,142,110,252,0.000333,0.531042,11,17524.38468,973.576927,1593.12588,436.516656,10,0
0,0,17,17,13,24,37,57,59,116,0.000333,0.201432,12,7251.559085,402.864394,604.29659,158.144816,3,0
0,0,33,33,23,58,81,147,122,269,0.000333,0.568473,22,37519.23232,2084.401795,1705.419651,443.804823,10,0
0,0,16,16,14,24,38,57,50,107,0.000333,0.187176,14,7861.395415,436.74419,561.528244,163.342069,3,0
0,0,32,32,23,58,81,147,113,260,0.000333,0.549454,11,18131.97101,1007.331723,1648.361001,443.804823,10,0
0,0,17,17,14,25,39,65,54,119,0.000333,0.209654,14,8805.480097,489.193339,628.962864,169.399374,3,0
0,0,33,33,23,59,82,155,117,272,0.000333,0.576418,11,19021.7956,1056.766422,1729.254145,451.117865,10,0
0,0,30,30,19,49,68,149,97,246,0.000333,0.499172,9,13477.64273,748.757929,1497.515859,355.831405,12,0
0,0,16,16,16,20,36,53,63,116,0.000333,0.199904,24,14393.0712,799.615067,599.7113,150.438562,1,0
0,0,9,9,14,27,41,56,46,102,0.000333,0.182157,7,3825.292131,212.51623,546.470304,181.684931,2,0
0,0,52,52,23,58,81,295,201,496,0.000333,1.048189,33,103770.6648,5765.036936,3144.565601,443.804823,2,0
0,0,77,77,25,77,102,430,297,727,0.000333,1.616951,36,174630.7161,9701.706447,4850.853224,598.638968,6,0
0,0,53,53,21,64,85,302,217,519,0.000333,1.108825,30,99794.21688,5544.12316,3326.473896,476.238666,8,0
0,0,30,30,19,49,68,149,97,246,0.000333,0.499172,9,13477.64273,748.757929,1497.515859,355.831405,12,0
0,0,35,35,26,45,71,177,117,294,0.000333,0.602675,26,47008.66698,2611.59261,1808.025653,369.344822,10,0
0,0,36,36,27,53,80,187,130,317,0.000333,0.668017,26,52105.33136,2894.740631,2004.051206,431.961747,10,0
0,0,37,37,27,53,80,193,133,326,0.000333,0.686983,26,53584.66253,2976.925696,2060.948559,431.961747,10,0
0,0,36,36,26,53,79,187,131,318,0.000333,0.668201,26,52119.65923,2895.536624,2004.602278,425.791217,7,0
0,0,25,25,22,42,64,143,100,243,0.000333,0.486,22,32076,1782,1458,324.584827,4,0
0,0,57,57,26,61,87,324,219,543,0.000333,1.166173,39,136442.2144,7580.123023,3498.518318,483.98641,6,0
0,0,66,66,26,78,104,385,270,655,0.000333,1.462929,39,171162.7326,9509.0407,4388.788015,612.472806,9,0
0,0,9,9,13,28,41,52,44,96,0.000333,0.171442,6,3085.949955,171.441664,514.324992,182.711654,2,0
0,0,52,52,23,60,83,297,203,500,0.000333,1.062507,33,105188.1506,5843.786145,3187.519716,458.455361,2,0
0,0,86,86,28,88,116,494,347,841,0.000333,1.922521,42,242237.6047,13457.64471,5767.562017,703.03592,11,0
0,0,62,62,24,74,98,366,267,633,0.000333,1.395704,36,150736.0079,8374.222663,4187.111331,569.538649,13,0
0,0,34,34,25,44,69,170,114,284,0.000333,0.578274,24,41635.7027,2313.094594,1734.820946,356.311396,9,0
0,0,35,35,26,52,78,180,127,307,0.000333,0.643206,26,50170.08051,2787.226695,1929.618481,418.634298,9,0
0,0,36,36,26,52,78,186,130,316,0.000333,0.662062,26,51640.86463,2868.936924,1986.187101,418.634298,9,0
0,0,35,35,25,52,77,180,128,308,0.000333,0.64339,24,46324.08611,2573.560339,1930.170255,412.51927,6,0
0,0,24,24,21,41,62,136,97,233,0.000333,0.462443,20,27746.55481,1541.475267,1387.32774,311.898298,3,0
0,0,32,32,21,50,71,157,105,262,0.000333,0.537078,20,32224.67491,1790.259717,1611.233745,374.431475,11,0
0,0,22,22,20,47,67,113,89,202,0.000333,0.40845,10,12253.50017,680.750009,1225.350016,347.504238,7,0
0,0,19,19,18,44,62,102,73,175,0.000333,0.347328,9,9377.859189,520.992177,1041.984354,315.273641,7,0
0,0,29,29,19,49,68,146,97,243,0.000333,0.493084,9,13313.28123,739.626735,1479.25347,355.831405,11,0
0,0,18,18,14,25,39,60,59,119,0.000333,0.209654,14,8805.480097,489.193339,628.962864,169.399374,3,0
0,0,20,20,18,30,48,78,72,150,0.000333,0.279248,18,15079.39875,837.744375,837.744375,222.265368,5,0
0,0,33,33,20,51,71,159,115,274,0.000333,0.561677,20,33700.61422,1872.256345,1685.030711,375.732254,12,0
0,0,31,31,19,50,69,152,103,255,0.000333,0.519225,18,28038.12726,1557.673736,1557.673736,362.903432,11,0
0,0,32,32,19,50,69,158,105,263,0.000333,0.535514,18,28917.75478,1606.541932,1606.541932,362.903432,11,0
0,0,11,11,12,20,32,44,36,80,0.000333,0.133333,6,2400,133.333333,400,129.458112,3,0
0,0,11,11,14,21,35,46,38,84,0.000333,0.14362,7,3016.018414,167.556579,430.859773,145.541635,4,0
0,0,30,30,19,49,68,149,98,247,0.000333,0.501201,18,27064.85979,1503.603322,1503.603322,355.831405,12,0
0,0,19,19,13,25,38,62,71,133,0.000333,0.232658,12,8375.692311,465.31624,697.974359,164.202121,3,0
0,0,35,35,23,59,82,152,134,286,0.000333,0.606087,22,40001.71721,2222.317623,1818.259873,451.117865,10,0
0,0,29,29,21,47,68,145,92,237,0.000333,0.48091,10,14427.28693,801.515941,1442.728693,353.304342,10,0
0,0,29,29,19,48,67,146,96,242,0.000333,0.489331,18,26423.88451,1467.993584,1467.993584,348.788823,11,0
0,0,30,30,19,51,70,149,99,248,0.000333,0.506687,9,13680.55969,760.031094,1520.062188,370.004315,12,0
0,0,30,30,19,50,69,149,98,247,0.000333,0.502935,9,13579.24987,754.40277,1508.805541,362.903432,12,0
0,0,32,32,21,50,71,154,101,255,0.000333,0.522729,20,31363.71031,1742.428351,1568.185515,374.431475,12,0
0,0,30,30,19,50,69,149,99,248,0.000333,0.504971,9,13634.22659,757.457033,1514.914065,362.903432,12,0
0,0,9,9,12,13,25,28,22,50,0.000333,0.077398,6,1393.156857,77.397603,232.192809,91.125266,2,0
0,0,10,10,13,15,28,33,26,59,0.000333,0.094545,6,1701.803642,94.544647,283.63394,106.709075,2,0
0,0,19,19,18,44,62,101,73,174,0.000333,0.345343,9,9324.271422,518.015079,1036.030158,315.273641,7,0
0,0,19,19,19,43,62,102,72,174,0.000333,0.345343,9,9324.271422,518.015079,1036.030158,314.040007,7,0
0,0,29,29,20,46,66,143,101,244,0.000333,0.491611,20,29496.6433,1638.702406,1474.832165,340.522412,9,0
0,0,27,27,20,48,68,144,97,241,0.000333,0.489026,20,29341.5709,1630.087272,1467.078545,354.516762,11,0
0,0,30,30,19,47,66,150,106,256,0.000333,0.515788,18,27852.5681,1547.364895,1547.364895,341.776299,9,0
0,0,27,27,19,46,65,135,92,227,0.000333,0.455692,18,24607.39488,1367.077494,1367.077494,334.794473,9,0
0,0,19,19,18,44,62,101,73,174,0.000333,0.345343,9,9324.271422,518.015079,1036.030158,315.273641,7,0
0,0,21,21,18,45,63,110,79,189,0.000333,0.376569,9,10167.35315,564.852953,1129.705906,322.192039,7,0
0,0,21,21,19,44,63,111,78,189,0.000333,0.376569,9,10167.35315,564.852953,1129.705906,320.925614,7,0
0,0,29,29,19,49,68,146,97,243,0.000333,0.493084,9,13313.28123,739.626735,1479.25347,355.831405,11,0
0,0,18,18,16,43,59,98,69,167,0.000333,0.327467,8,7859.211114,436.62284,982.401389,297.329384,7,0
0,0,18,18,17,42,59,99,68,167,0.000333,0.327467,8,7859.211114,436.62284,982.401389,295.9642,7,0
0,0,13,13,15,19,34,52,36,88,0.000333,0.149232,7,3133.87711,174.104284,447.69673,139.313982,4,0
0,0,53,53,28,63,91,205,161,366,0.000333,0.793951,28,66691.87947,3705.104415,2381.852838,511.174573,15,0
0,0,18,18,17,23,40,62,67,129,0.000333,0.228843,16,10984.45959,610.247755,686.528724,173.528793,3,0
0,0,15,15,15,20,35,59,40,99,0.000333,0.169266,14,7109.186261,394.954792,507.799019,145.041921,6,0
0,0,15,15,15,20,35,58,40,98,0.000333,0.167557,14,7037.376299,390.96535,502.669736,145.041921,6,0
0,0,15,15,15,20,35,58,38,96,0.000333,0.164137,7,3446.878187,191.493233,492.41117,145.041921,6,0
0,0,15,15,15,20,35,58,38,96,0.000333,0.164137,7,3446.878187,191.493233,492.41117,145.041921,6,0
0,0,10,10,16,18,34,46,35,81,0.000333,0.137361,8,3296.675921,183.148662,412.08449,139.05865,4,0
0,0,10,10,14,17,31,44,33,77,0.000333,0.127158,7,2670.311811,148.350656,381.473116,122.789837,3,0
0,0,35,35,26,60,86,161,126,287,0.000333,0.614779,26,47952.7876,2664.043756,1844.337985,476.624868,12,0
0,0,16,16,16,24,40,58,53,111,0.000333,0.196911,16,9451.744297,525.096905,590.734019,174.0391,3,0
0,0,30,30,19,50,69,149,98,247,0.000333,0.502935,9,13579.24987,754.40277,1508.805541,362.903432,12,0
0,0,15,15,15,21,36,58,38,96,0.000333,0.165438,7,3474.189601,193.010533,496.3128,150.842025,6,0
0,0,15,15,15,20,35,58,38,96,0.000333,0.164137,7,3446.878187,191.493233,492.41117,145.041921,6,0
0,0,15,15,15,21,36,58,38,96,0.000333,0.165438,7,3474.189601,193.010533,496.3128,150.842025,6,0
0,0,15,15,15,20,35,58,38,96,0.000333,0.164137,7,3446.878187,191.493233,492.41117,145.041921,6,0
0,0,29,29,19,49,68,146,97,243,0.000333,0.493084,9,13313.28123,739.626735,1479.25347,355.831405,11,0
0,0,9,9,10,17,27,34,32,66,0.000333,0.104608,5,1569.112876,87.172938,313.822575,102.706149,1,0
0,0,10,10,12,18,30,44,32,76,0.000333,0.124308,6,2237.542112,124.307895,372.923685,118.0782,3,0
0,0,10,10,14,19,33,46,34,80,0.000333,0.134517,7,2824.860707,156.936706,403.55153,134.013592,4,0
0,0,9,9,14,16,30,37,31,68,0.000333,0.111223,7,2335.679924,129.759996,333.668561,117.302969,1,0
0,0,17,17,16,21,37,56,65,121,0.000333,0.210115,24,15128.25257,840.458476,630.343857,156.238666,1,0
0,0,19,19,18,44,62,101,73,174,0.000333,0.345343,9,9324.271422,518.015079,1036.030158,315.273641,7,0
0,0,15,15,13,22,35,53,46,99,0.000333,0.169266,12,6093.588224,338.532679,507.799019,146.213212,3,0
0,0,17,17,17,27,44,71,59,130,0.000333,0.236575,16,11355.61777,630.867654,709.72611,197.868831,5,0
0,0,17,17,17,42,59,100,71,171,0.000333,0.335311,8,8047.455692,447.080872,1005.931961,295.9642,7,0
0,0,16,16,14,22,36,56,48,104,0.000333,0.179224,14,7527.410802,418.189489,537.6722,151.410465,3,0
0,0,18,18,18,27,45,74,61,135,0.000333,0.247133,18,13345.20302,741.400168,741.400168,203.440613,5,0
0,0,31,31,23,47,70,168,106,274,0.000333,0.559808,22,36947.31803,2052.628779,1679.423547,365.107601,11,0
0,0,31,31,23,49,72,168,105,273,0.000333,0.561463,22,37056.56956,2058.698309,1684.389525,379.162707,11,0
0,0,15,15,14,18,32,53,37,90,0.000333,0.15,14,6300,350,450,128.361619,2,0
0,0,22,22,19,47,66,113,82,195,0.000333,0.392886,9,10607.91168,589.328427,1178.656853,341.776299,8,0
0,0,9,9,10,17,27,34,32,66,0.000333,0.104608,5,1569.112876,87.172938,313.822575,102.706149,1,0
0,0,16,16,13,22,35,51,55,106,0.000333,0.181235,12,6524.447998,362.469333,543.704,146.213212,1,0
0,0,8,8,10,15,25,34,28,62,0.000333,0.095973,5,1439.595419,79.977523,287.919084,91.82264,1,0
0,0,15,15,13,21,34,57,49,106,0.000333,0.179757,12,6471.252734,359.514041,539.271061,140.344382,1,0
0,0,14,14,13,20,33,49,45,94,0.000333,0.158058,12,5690.076567,316.115365,474.173047,134.544278,1,0
0,0,19,19,18,44,62,101,73,174,0.000333,0.345343,9,9324.271422,518.015079,1036.030158,315.273641,7,0
0,0,21,21,19,46,65,110,81,191,0.000333,0.383424,9,10352.45027,575.136126,1150.272252,334.794473,7,0
0,0,19,19,18,45,63,101,74,175,0.000333,0.348675,9,9414.21588,523.011993,1046.023987,322.192039,7,0
0,0,30,30,19,48,67,154,106,260,0.000333,0.525728,18,28389.29741,1577.18319,1577.18319,348.788823,9,0
0,0,28,28,19,46,65,139,99,238,0.000333,0.477775,18,25799.82371,1433.32354,1433.32354,334.794473,9,0
0,0,29,29,19,47,66,145,102,247,0.000333,0.497655,18,26873.37626,1492.965347,1492.965347,341.776299,9,0
0,0,32,32,19,48,67,151,123,274,0.000333,0.554036,18,29917.95189,1662.108438,1662.108438,348.788823,9,0
0,0,22,22,20,48,68,113,93,206,0.000333,0.418006,10,12540.17345,696.676303,1254.017345,354.516762,7,0
0,0,32,32,20,50,70,153,101,254,0.000333,0.518946,20,31136.75773,1729.819874,1556.837886,368.631371,12,0
0,0,17,17,17,43,60,100,73,173,0.000333,0.340631,8,8175.136584,454.174255,1021.892073,302.816253,7,0
0,0,15,15,14,20,34,50,51,101,0.000333,0.171278,14,7193.672458,399.64847,513.833747,139.741531,2,0
0,0,15,15,14,20,34,50,51,101,0.000333,0.171278,14,7193.672458,399.64847,513.833747,139.741531,2,0
0,0,14,14,13,21,34,46,41,87,0.000333,0.147536,6,2655.655603,147.536422,442.609267,140.344382,1,0
0,0,13,13,12,19,31,44,42,86,0.000333,0.14202,12,5112.730592,284.040588,426.060883,123.730173,1,0
0,0,10,10,13,15,28,33,26,59,0.000333,0.094545,6,1701.803642,94.544647,283.63394,106.709075,2,0
0,0,10,10,13,15,28,33,26,59,0.000333,0.094545,6,1701.803642,94.544647,283.63394,106.709075,2,0
0,0,19,19,18,44,62,110,75,185,0.000333,0.367175,9,9913.736857,550.763159,1101.526317,315.273641,7,0
0,0,19,19,19,43,62,111,74,185,0.000333,0.367175,9,9913.736857,550.763159,1101.526317,314.040007,7,0
0,0,19,19,18,44,62,110,75,185,0.000333,0.367175,9,9913.736857,550.763159,1101.526317,315.273641,7,0
0,0,19,19,19,43,62,111,74,185,0.000333,0.367175,9,9913.736857,550.763159,1101.526317,314.040007,7,0
0,0,32,32,21,52,73,158,116,274,0.000333,0.565337,20,33920.23858,1884.457699,1696.011929,388.661531,11,0
0,0,30,30,19,50,69,149,98,247,0.000333,0.502935,9,13579.24987,754.40277,1508.805541,362.903432,12,0
0,0,27,27,19,45,64,144,92,236,0.000333,0.472,18,25488,1416,1416,327.844012,9,0
0,0,27,27,20,47,67,145,92,237,0.000333,0.479221,10,14376.63138,798.701743,1437.663138,347.504238,9,0
0,0,30,30,19,48,67,149,97,246,0.000333,0.497419,18,26860.64294,1492.257941,1492.257941,348.788823,12,0
0,0,22,22,18,48,66,114,83,197,0.000333,0.396915,9,10716.71077,595.372821,1190.745642,343.13685,9,0
0,0,22,22,19,47,66,115,82,197,0.000333,0.396915,9,10716.71077,595.372821,1190.745642,341.776299,9,0
0,0,22,22,18,48,66,114,83,197,0.000333,0.396915,9,10716.71077,595.372821,1190.745642,343.13685,9,0
0,0,22,22,19,47,66,115,82,197,0.000333,0.396915,9,10716.71077,595.372821,1190.745642,341.776299,9,0
0,0,22,22,18,48,66,114,83,197,0.000333,0.396915,9,10716.71077,595.372821,1190.745642,343.13685,9,0
0,0,20,20,17,46,63,113,81,194,0.000333,0.386531,8,9276.738441,515.374358,1159.592305,323.570718,9,0
0,0,20,20,17,47,64,113,83,196,0.000333,0.392,8,9408,522.666667,1176,330.552544,9,0
0,0,25,25,20,51,71,126,99,225,0.000333,0.461231,10,13836.93102,768.71839,1383.693102,375.732254,9,0
0,0,25,25,21,52,73,127,105,232,0.000333,0.47868,20,28720.78595,1595.59922,1436.039298,388.661531,9,0
0,0,27,27,19,46,65,136,89,225,0.000333,0.451678,9,12195.29482,677.516379,1355.032758,334.794473,10,0
0,0,32,32,23,47,70,173,106,279,0.000333,0.570023,22,37621.53916,2090.085509,1710.069962,365.107601,11,0
0,0,14,14,14,16,30,47,34,81,0.000333,0.132486,14,5564.413935,309.134108,397.458138,117.302969,2,0
0,0,14,14,14,16,30,47,34,81,0.000333,0.132486,14,5564.413935,309.134108,397.458138,117.302969,2,0
0,0,19,19,18,45,63,101,74,175,0.000333,0.348675,9,9414.21588,523.011993,1046.023987,322.192039,7,0
0,0,19,19,18,45,63,101,74,175,0.000333,0.348675,9,9414.21588,523.011993,1046.023987,322.192039,7,0
0,0,28,28,19,46,65,139,99,238,0.000333,0.477775,18,25799.82371,1433.32354,1433.32354,334.794473,9,0
0,0,12,12,14,17,31,38,29,67,0.000333,0.110644,7,2323.51807,129.084337,331.931153,122.789837,2,0
0,0,12,12,14,17,31,38,29,67,0.000333,0.110644,7,2323.51807,129.084337,331.931153,122.789837,2,0
0,0,12,12,13,16,29,42,31,73,0.000333,0.118211,6,2127.795676,118.210871,354.632613,112.105716,2,0
0,0,12,12,13,16,29,42,31,73,0.000333,0.118211,6,2127.795676,118.210871,354.632613,112.105716,2,0
0,0,12,12,13,15,28,42,31,73,0.000333,0.116979,12,4211.242912,233.95794,350.936909,106.709075,2,0
0,0,10,10,14,15,29,34,27,61,0.000333,0.098779,7,2074.357885,115.242105,296.336841,111.906328,2,0
0,0,10,10,13,15,28,33,27,60,0.000333,0.096147,6,1730.647772,96.147098,288.441295,106.709075,2,0
0,0,9,9,13,14,27,29,23,52,0.000333,0.082418,6,1483.524901,82.41805,247.25415,101.408685,2,0
0,0,10,10,13,16,29,33,27,60,0.000333,0.09716,6,1748.873158,97.15962,291.47886,112.105716,2,0
0,0,9,9,12,13,25,28,22,50,0.000333,0.077398,6,1393.156857,77.397603,232.192809,91.125266,2,0
0,0,10,10,13,15,28,33,26,59,0.000333,0.094545,6,1701.803642,94.544647,283.63394,106.709075,2,0
0,0,12,12,13,16,29,42,31,73,0.000333,0.118211,6,2127.795676,118.210871,354.632613,112.105716,2,0
0,0,12,12,13,16,29,42,31,73,0.000333,0.118211,6,2127.795676,118.210871,354.632613,112.105716,2,0
0,0,12,12,14,17,31,43,32,75,0.000333,0.123855,7,2600.953063,144.497392,371.564723,122.789837,2,0
0,0,12,12,13,17,30,42,32,74,0.000333,0.121037,6,2178.659424,121.036635,363.109904,117.592585,2,0
0,0,12,12,14,17,31,43,32,75,0.000333,0.123855,7,2600.953063,144.497392,371.564723,122.789837,2,0
0,0,12,12,13,17,30,42,32,74,0.000333,0.121037,6,2178.659424,121.036635,363.109904,117.592585,2,0
0,0,14,14,14,16,30,46,34,80,0.000333,0.13085,14,5495.717467,305.317637,392.551248,117.302969,2,0
0,0,14,14,14,16,30,46,34,80,0.000333,0.13085,14,5495.717467,305.317637,392.551248,117.302969,2,0
0,0,22,22,20,46,66,114,78,192,0.000333,0.386841,10,11605.23671,644.735373,1160.523671,340.522412,8,0
0,0,27,27,19,45,64,136,88,224,0.000333,0.448,9,12096,672,1344,327.844012,10,0
0,0,29,29,21,48,69,145,106,251,0.000333,0.51108,20,30664.79277,1703.599599,1533.239639,360.316866,9,0
0,0,32,32,21,50,71,158,101,259,0.000333,0.530928,20,31855.69008,1769.76056,1592.784504,374.431475,12,0
0,0,30,30,19,50,69,149,98,247,0.000333,0.502935,9,13579.24987,754.40277,1508.805541,362.903432,12,0
0,0,33,33,19,53,72,158,119,277,0.000333,0.56969,18,30763.24606,1709.069225,1709.069225,384.290407,11,0
0,0,30,30,19,50,69,148,102,250,0.000333,0.509044,18,27488.36006,1527.131114,1527.131114,362.903432,11,0
0,0,30,30,19,50,69,149,99,248,0.000333,0.504971,9,13634.22659,757.457033,1514.914065,362.903432,11,0
0,0,33,33,19,51,70,163,116,279,0.000333,0.570023,18,30781.25931,1710.069962,1710.069962,370.004315,11,0
0,0,22,22,18,46,64,112,87,199,0.000333,0.398,9,10746,597,1194,329.1425,8,0
0,0,21,21,18,45,63,110,79,189,0.000333,0.376569,9,10167.35315,564.852953,1129.705906,322.192039,7,0
0,0,27,27,20,48,68,144,97,241,0.000333,0.489026,20,29341.5709,1630.087272,1467.078545,354.516762,11,0
0,0,19,19,18,44,62,101,73,174,0.000333,0.345343,9,9324.271422,518.015079,1036.030158,315.273641,7,0
0,0,19,19,18,45,63,101,74,175,0.000333,0.348675,9,9414.21588,523.011993,1046.023987,322.192039,7,0
0,0,29,29,21,47,68,145,102,247,0.000333,0.501201,20,30072.06644,1670.670358,1503.603322,353.304342,9,0
0,0,15,15,16,21,37,58,38,96,0.000333,0.166703,8,4000.860185,222.27001,500.107523,156.238666,6,0
0,0,15,15,16,21,37,58,38,96,0.000333,0.166703,8,4000.860185,222.27001,500.107523,156.238666,6,0
0,0,22,22,18,48,66,123,85,208,0.000333,0.419078,9,11315.10579,628.616988,1257.233977,343.13685,9,0
0,0,22,22,18,48,66,123,85,208,0.000333,0.419078,9,11315.10579,628.616988,1257.233977,343.13685,9,0
0,0,22,22,19,47,66,124,84,208,0.000333,0.419078,9,11315.10579,628.616988,1257.233977,341.776299,9,0
0,0,22,22,18,48,66,123,85,208,0.000333,0.419078,9,11315.10579,628.616988,1257.233977,343.13685,9,0
0,0,22,22,19,47,66,124,84,208,0.000333,0.419078,9,11315.10579,628.616988,1257.233977,341.776299,9,0
0,0,18,18,14,26,40,59,60,119,0.000333,0.211103,14,8866.332206,492.574011,633.309443,175.514402,3,0
0,0,18,18,16,27,43,63,62,125,0.000333,0.226094,16,10852.52951,602.918306,678.283094,192.381963,4,0
0,0,11,11,12,21,33,43,37,80,0.000333,0.134517,6,2421.309177,134.517177,403.55153,135.258216,3,0
0,0,11,11,14,22,36,45,39,84,0.000333,0.144758,7,3039.915901,168.884217,434.2737,151.410465,4,0
0,0,10,10,12,19,31,43,33,76,0.000333,0.125506,6,2259.113518,125.506307,376.51892,123.730173,3,0
0,0,10,10,14,20,34,45,35,80,0.000333,0.135666,7,2848.979191,158.276622,406.997027,139.741531,4,0
0,0,17,17,14,25,39,65,54,119,0.000333,0.209654,14,8805.480097,489.193339,628.962864,169.399374,3,0
0,0,17,17,16,26,42,69,56,125,0.000333,0.22468,16,10784.63485,599.14638,674.039678,186.211433,4,0
0,0,37,37,19,53,72,170,145,315,0.000333,0.647842,18,34983.47476,1943.526375,1943.526375,384.290407,11,0
0,0,35,35,19,52,71,164,133,297,0.000333,0.608825,18,32876.5481,1826.474894,1826.474894,377.133488,11,0
0,0,33,33,19,51,70,158,121,279,0.000333,0.570023,18,30781.25931,1710.069962,1710.069962,370.004315,11,0
0,0,31,31,19,50,69,152,109,261,0.000333,0.531442,18,28697.8479,1594.324883,1594.324883,362.903432,11,0
0,0,32,32,21,50,71,157,105,262,0.000333,0.537078,20,32224.67491,1790.259717,1611.233745,374.431475,11,0
0,0,27,27,19,46,65,135,92,227,0.000333,0.455692,18,24607.39488,1367.077494,1367.077494,334.794473,9,0
0,0,27,27,19,46,65,136,89,225,0.000333,0.451678,9,12195.29482,677.516379,1355.032758,334.794473,9,0
0,0,27,27,19,45,64,145,90,235,0.000333,0.47,18,25380,1410,1410,327.844012,9,0
0,0,27,27,20,44,64,146,89,235,0.000333,0.47,20,28200,1566.666667,1410,326.653553,9,0
0,0,35,35,21,49,70,175,124,299,0.000333,0.610885,20,36653.11244,2036.284025,1832.655622,367.359448,11,0
0,0,35,35,23,52,75,179,134,313,0.000333,0.649873,22,42891.6455,2382.869195,1949.62025,400.46479,11,0
0,0,37,37,21,50,71,181,134,315,0.000333,0.645723,20,38743.40685,2152.411492,1937.170343,374.431475,11,0
0,0,37,37,23,53,76,185,146,331,0.000333,0.689355,22,45497.40815,2527.633786,2068.064007,407.621709,11,0
0,0,29,29,20,45,65,152,100,252,0.000333,0.505879,20,30352.73378,1686.262988,1517.636689,333.571951,9,0
0,0,29,29,21,47,68,153,101,254,0.000333,0.515405,20,30924.31123,1718.017291,1546.215562,353.304342,9,0
0,0,9,9,11,17,28,35,30,65,0.000333,0.104159,5,1562.39035,86.799464,312.47807,107.540616,1,0
0,0,14,14,13,20,33,49,45,94,0.000333,0.158058,12,5690.076567,316.115365,474.173047,134.544278,1,0
0,0,21,21,18,45,63,109,84,193,0.000333,0.384538,9,10382.53523,576.807513,1153.615025,322.192039,7,0
0,0,10,10,13,17,30,44,31,75,0.000333,0.122672,6,2208.100768,122.672265,368.016795,117.592585,3,0
0,0,10,10,15,18,33,46,33,79,0.000333,0.132836,7,2789.549948,154.974997,398.507135,133.662009,4,0
0,0,11,11,13,21,34,44,35,79,0.000333,0.13397,6,2411.457387,133.969855,401.909564,140.344382,3,0
0,0,11,11,15,22,37,46,37,83,0.000333,0.144128,7,3026.692405,168.149578,432.384629,156.710855,4,0
0,0,28,28,19,46,65,139,99,238,0.000333,0.477775,18,25799.82371,1433.32354,1433.32354,334.794473,9,0
0,0,15,15,13,20,33,49,40,89,0.000333,0.14965,12,5387.412919,299.300718,448.951077,134.544278,2,0
0,0,14,14,14,18,32,45,34,79,0.000333,0.131667,7,2765,153.611111,395,128.361619,2,0
0,0,14,14,13,16,29,47,34,81,0.000333,0.131165,12,4721.957527,262.330974,393.496461,112.105716,2,0
0,0,29,29,19,46,65,145,95,240,0.000333,0.481789,18,26016.62895,1445.368275,1445.368275,334.794473,9,0
0,0,18,18,17,30,47,73,67,140,0.000333,0.259214,16,12442.27903,691.237724,777.642439,216.693586,6,0
0,0,18,18,17,30,47,73,67,140,0.000333,0.259214,16,12442.27903,691.237724,777.642439,216.693586,6,0
0,0,16,16,13,24,37,55,51,106,0.000333,0.184067,12,6626.424681,368.134705,552.202057,158.144816,4,0
0,0,15,15,13,20,33,51,41,92,0.000333,0.154695,12,5569.011108,309.389506,464.084259,134.544278,3,0
0,0,17,17,17,26,43,69,54,123,0.000333,0.222477,16,10678.88904,593.271613,667.430565,191.698301,5,0
0,0,15,15,14,20,34,54,41,95,0.000333,0.161103,14,6766.325579,375.906977,483.30897,139.741531,3,0
0,0,17,17,18,26,44,72,54,126,0.000333,0.229296,18,12381.99091,687.888384,687.888384,197.270083,5,0
0,0,16,16,14,25,39,54,46,100,0.000333,0.17618,7,3699.781553,205.54342,528.540222,169.399374,3,0
0,0,18,18,18,31,49,72,59,131,0.000333,0.245176,9,6619.742906,367.763495,735.52699,228.638736,5,0
0,0,15,15,13,20,33,53,43,96,0.000333,0.161421,12,5811.142026,322.841224,484.261835,134.544278,3,0
0,0,17,17,17,26,43,71,56,127,0.000333,0.229712,16,11026.16998,612.564999,689.135624,191.698301,5,0
0,0,30,30,19,47,66,145,111,256,0.000333,0.515788,18,27852.5681,1547.364895,1547.364895,341.776299,9,0
0,0,33,33,21,48,69,169,114,283,0.000333,0.576237,20,34574.24843,1920.791579,1728.712421,360.316866,11,0
0,0,33,33,23,51,74,173,122,295,0.000333,0.610596,22,40299.35234,2238.852908,1831.788743,393.335617,11,0
0,0,31,31,21,47,68,163,104,267,0.000333,0.541784,20,32507.05157,1805.94731,1625.352579,353.304342,11,0
0,0,31,31,23,50,73,167,110,277,0.000333,0.571527,22,37720.79086,2095.599492,1714.581403,386.234734,11,0
0,0,12,12,14,17,31,37,29,66,0.000333,0.108992,7,2288.838695,127.157705,326.976956,122.789837,2,0
0,0,12,12,14,17,31,37,29,66,0.000333,0.108992,7,2288.838695,127.157705,326.976956,122.789837,2,0
0,0,33,33,21,51,72,160,106,266,0.000333,0.547067,20,32824.00101,1823.555612,1641.20005,381.532358,12,0
0,0,12,12,14,17,31,43,32,75,0.000333,0.123855,7,2600.953063,144.497392,371.564723,122.789837,2,0
0,0,12,12,13,17,30,42,32,74,0.000333,0.121037,6,2178.659424,121.036635,363.109904,117.592585,2,0
0,0,30,30,19,51,70,149,99,248,0.000333,0.506687,9,13680.55969,760.031094,1520.062188,370.004315,12,0
0,0,30,30,20,50,70,149,98,247,0.000333,0.504644,10,15139.32905,841.073836,1513.932905,368.631371,12,0
0,0,30,30,19,49,68,149,98,247,0.000333,0.501201,18,27064.85979,1503.603322,1503.603322,355.831405,12,0
0,0,31,31,22,50,72,155,104,259,0.000333,0.53267,22,35156.23266,1953.124037,1598.010575,380.300305,12,0
0,0,30,30,19,50,69,149,98,247,0.000333,0.502935,9,13579.24987,754.40277,1508.805541,362.903432,12,0
0,0,27,27,19,45,64,145,90,235,0.000333,0.47,18,25380,1410,1410,327.844012,9,0
0,0,27,27,20,44,64,146,89,235,0.000333,0.47,20,28200,1566.666667,1410,326.653553,9,0
0,0,32,32,21,51,72,158,102,260,0.000333,0.534727,20,32083.61001,1782.422778,1604.1805,381.532358,12,0
0,0,29,29,21,45,66,153,96,249,0.000333,0.501685,20,30101.08271,1672.282373,1505.054136,339.372055,9,0
0,0,29,29,21,44,65,154,97,251,0.000333,0.503871,20,30232.28642,1679.571468,1511.614321,332.453657,9,0
0,0,19,19,18,44,62,101,73,174,0.000333,0.345343,9,9324.271422,518.015079,1036.030158,315.273641,7,0
0,0,30,30,19,51,70,149,99,248,0.000333,0.506687,9,13680.55969,760.031094,1520.062188,370.004315,12,0
0,0,16,16,14,23,37,58,49,107,0.000333,0.185804,14,7803.761142,433.542286,557.41151,157.344894,3,0
0,0,18,18,18,28,46,76,62,138,0.000333,0.254084,18,13720.5279,762.25155,762.25155,209.664588,5,0
0,0,30,30,19,50,69,149,98,247,0.000333,0.502935,9,13579.24987,754.40277,1508.805541,362.903432,12,0
0,0,8,8,10,15,25,34,28,62,0.000333,0.095973,5,1439.595419,79.977523,287.919084,91.82264,1,0
0,0,17,17,13,23,36,58,58,116,0.000333,0.199904,12,7196.535602,399.807533,599.7113,152.147641,3,0
0,0,19,19,17,28,45,76,71,147,0.000333,0.269101,16,12916.83848,717.602138,807.302405,204.092806,5,0
0,0,31,31,22,49,71,155,103,258,0.000333,0.528878,22,34905.96465,1939.220258,1586.634757,373.228278,12,0
0,0,30,30,19,49,68,149,98,247,0.000333,0.501201,18,27064.85979,1503.603322,1503.603322,355.831405,12,0
0,0,31,31,23,53,76,145,101,246,0.000333,0.51233,11,16906.89185,939.27177,1536.990168,407.621709,12,0
0,0,31,31,23,53,76,144,101,245,0.000333,0.510247,11,16838.16465,935.453592,1530.742241,407.621709,12,0
0,0,15,15,13,20,33,55,38,93,0.000333,0.156376,6,2814.771919,156.376218,469.128653,134.544278,5,0
0,0,15,15,13,20,33,54,38,92,0.000333,0.154695,6,2784.505554,154.694753,464.084259,134.544278,5,0
0,0,24,24,18,49,67,132,91,223,0.000333,0.450913,9,12174.64101,676.368945,1352.737889,350.179432,9,0
0,0,24,24,19,48,67,133,90,223,0.000333,0.450913,9,12174.64101,676.368945,1352.737889,348.788823,9,0
0,0,9,9,14,17,31,39,31,70,0.000333,0.115598,7,2427.556192,134.864233,346.793742,122.789837,1,0
0,0,15,15,16,22,38,52,51,103,0.000333,0.180179,16,8648.584542,480.476919,540.536534,162.107496,1,0
0,0,9,9,14,16,30,37,31,68,0.000333,0.111223,7,2335.679924,129.759996,333.668561,117.302969,1,0
0,0,29,29,20,46,66,140,91,231,0.000333,0.465418,10,13962.55042,775.697245,1396.255042,340.522412,10,0
0,0,31,31,20,48,68,159,107,266,0.000333,0.539755,20,32385.30232,1799.183462,1619.265116,354.516762,10,0
0,0,31,31,21,50,71,160,108,268,0.000333,0.549377,20,32962.64456,1831.258031,1648.132228,374.431475,10,0
0,0,16,16,12,21,33,59,68,127,0.000333,0.213546,18,11531.48496,640.638053,640.638053,135.258216,3,0
0,0,16,16,14,22,36,61,70,131,0.000333,0.225753,21,14222.46368,790.136871,677.260175,151.410465,4,0
0,0,19,19,13,24,37,63,70,133,0.000333,0.230952,12,8314.287572,461.904865,692.857298,158.144816,3,0
0,0,21,21,17,29,46,81,83,164,0.000333,0.301955,16,14493.82657,805.212587,905.864161,210.368317,5,0
0,0,33,33,19,50,69,163,113,276,0.000333,0.561984,18,30347.1495,1685.95275,1685.95275,362.903432,11,0
0,0,29,29,20,45,65,143,98,241,0.000333,0.483797,20,29027.81286,1612.65627,1451.390643,333.571951,9,0
0,0,29,29,21,47,68,144,99,243,0.000333,0.493084,20,29585.06941,1643.614967,1479.25347,353.304342,9,0
0,0,31,31,20,48,68,154,110,264,0.000333,0.535697,20,32141.8038,1785.655767,1607.09019,354.516762,10,0
0,0,31,31,21,50,71,155,113,268,0.000333,0.549377,20,32962.64456,1831.258031,1648.132228,374.431475,10,0
0,0,33,33,20,49,69,160,120,280,0.000333,0.570129,20,34207.73696,1900.429831,1710.386848,361.559344,10,0
0,0,33,33,21,51,72,161,125,286,0.000333,0.5882,20,35291.97101,1960.665056,1764.59855,381.532358,10,0
0,0,32,32,21,52,73,158,116,274,0.000333,0.565337,20,33920.23858,1884.457699,1696.011929,388.661531,11,0
0,0,19,19,19,43,62,111,74,185,0.000333,0.367175,9,9913.736857,550.763159,1101.526317,314.040007,7,0
0,0,19,19,18,45,63,101,74,175,0.000333,0.348675,9,9414.21588,523.011993,1046.023987,322.192039,7,0
0,0,19,19,18,45,63,101,74,175,0.000333,0.348675,9,9414.21588,523.011993,1046.023987,322.192039,7,0
0,0,22,22,18,47,65,112,91,203,0.000333,0.407514,9,11002.86599,611.270333,1222.540666,336.124326,8,0
0,0,27,27,19,45,64,136,88,224,0.000333,0.448,9,12096,672,1344,327.844012,10,0
0,0,30,30,21,47,68,147,96,243,0.000333,0.493084,20,29585.06941,1643.614967,1479.25347,353.304342,10,0
0,0,26,26,19,45,64,133,87,220,0.000333,0.44,9,11880,660,1320,327.844012,9,0
0,0,27,27,19,47,66,136,89,225,0.000333,0.45333,9,12239.89809,679.994338,1359.988677,341.776299,10,0
0,0,29,29,21,47,68,145,92,237,0.000333,0.48091,10,14427.28693,801.515941,1442.728693,353.304342,10,0
0,0,27,27,20,46,66,136,88,224,0.000333,0.451315,10,13539.44283,752.191268,1353.944283,340.522412,10,0
0,0,27,27,19,47,66,136,89,225,0.000333,0.45333,9,12239.89809,679.994338,1359.988677,341.776299,10,0
0,0,28,28,19,46,65,139,93,232,0.000333,0.46573,18,25149.40799,1397.189333,1397.189333,334.794473,9,0
0,0,30,30,20,47,67,146,105,251,0.000333,0.507529,20,30451.76774,1691.764874,1522.588387,347.504238,10,0
0,0,33,33,19,51,70,158,121,279,0.000333,0.570023,18,30781.25931,1710.069962,1710.069962,370.004315,11,0
0,0,30,30,19,50,69,148,102,250,0.000333,0.509044,18,27488.36006,1527.131114,1527.131114,362.903432,11,0
0,0,30,30,19,50,69,149,99,248,0.000333,0.504971,9,13634.22659,757.457033,1514.914065,362.903432,11,0
0,0,19,19,18,44,62,101,73,174,0.000333,0.345343,9,9324.271422,518.015079,1036.030158,315.273641,7,0
0,0,31,31,19,50,69,152,109,261,0.000333,0.531442,18,28697.8479,1594.324883,1594.324883,362.903432,11,0
0,0,31,31,19,52,71,153,104,257,0.000333,0.526828,18,28448.73018,1580.48501,1580.48501,377.133488,11,0
0,0,32,32,19,50,69,158,105,263,0.000333,0.535514,18,28917.75478,1606.541932,1606.541932,362.903432,11,0
0,0,29,29,19,46,65,145,95,240,0.000333,0.481789,18,26016.62895,1445.368275,1445.368275,334.794473,9,0
0,0,28,28,22,46,68,142,94,236,0.000333,0.47888,22,31606.10707,1755.894837,1436.641231,352.191346,10,0
0,0,27,27,19,45,64,136,88,224,0.000333,0.448,9,12096,672,1344,327.844012,10,0
0,0,27,27,20,46,66,136,88,224,0.000333,0.451315,10,13539.44283,752.191268,1353.944283,340.522412,10,0
0,0,27,27,19,47,66,136,89,225,0.000333,0.45333,9,12239.89809,679.994338,1359.988677,341.776299,10,0
0,0,28,28,19,46,65,139,93,232,0.000333,0.46573,18,25149.40799,1397.189333,1397.189333,334.794473,9,0
0,0,30,30,20,47,67,146,105,251,0.000333,0.507529,20,30451.76774,1691.764874,1522.588387,347.504238,10,0
0,0,26,26,19,45,64,133,87,220,0.000333,0.44,9,11880,660,1320,327.844012,9,0
0,0,17,17,12,21,33,54,66,120,0.000333,0.201776,18,10895.8913,605.327294,605.327294,135.258216,1,0
0,0,16,16,12,21,33,59,68,127,0.000333,0.213546,18,11531.48496,640.638053,640.638053,135.258216,3,0
0,0,16,16,14,22,36,61,70,131,0.000333,0.225753,21,14222.46368,790.136871,677.260175,151.410465,4,0
0,0,17,17,13,23,36,58,58,116,0.000333,0.199904,12,7196.535602,399.807533,599.7113,152.147641,3,0
0,0,36,36,23,59,82,161,131,292,0.000333,0.618802,22,40840.91408,2268.939671,1856.405185,451.117865,12,0
0,0,15,15,13,22,35,53,46,99,0.000333,0.169266,12,6093.588224,338.532679,507.799019,146.213212,3,0
0,0,34,34,23,58,81,156,119,275,0.000333,0.581153,22,38356.09252,2130.894029,1743.458751,443.804823,12,0
0,0,11,11,13,20,33,45,34,79,0.000333,0.132836,6,2391.042813,132.835712,398.507135,134.544278,3,0
0,0,11,11,15,21,36,47,36,83,0.000333,0.143035,7,3003.726426,166.87369,429.103775,150.842025,4,0
0,0,10,10,13,16,29,45,30,75,0.000333,0.12145,6,2186.091448,121.449525,364.348575,112.105716,3,0
0,0,10,10,15,17,32,47,32,79,0.000333,0.131667,7,2765,153.611111,395,128.090227,4,0
0,0,15,15,13,19,32,54,42,96,0.000333,0.16,12,5760,320,480,128.816339,3,0
0,0,34,34,23,55,78,157,115,272,0.000333,0.569876,22,37611.84688,2089.547049,1709.629404,422.016709,12,0
0,0,16,16,14,24,38,55,45,100,0.000333,0.174931,7,3673.549259,204.08607,524.792751,163.342069,3,0
0,0,35,35,23,60,83,158,118,276,0.000333,0.586504,11,19354.61971,1075.256651,1759.510883,458.455361,12,0
0,0,14,14,10,18,28,49,64,113,0.000333,0.181077,15,8148.466593,452.692588,543.231106,108.277931,1,0
0,0,22,22,18,48,66,123,85,208,0.000333,0.419078,9,11315.10579,628.616988,1257.233977,343.13685,9,0
0,0,22,22,19,47,66,124,84,208,0.000333,0.419078,9,11315.10579,628.616988,1257.233977,341.776299,9,0
0,0,16,16,14,25,39,54,46,100,0.000333,0.17618,7,3699.781553,205.54342,528.540222,169.399374,3,0
0,0,32,32,23,59,82,144,109,253,0.000333,0.536154,11,17693.06723,982.948179,1608.460657,451.117865,10,0
0,0,19,19,18,45,63,101,74,175,0.000333,0.348675,9,9414.21588,523.011993,1046.023987,322.192039,7,0
0,0,22,22,18,48,66,123,85,208,0.000333,0.419078,9,11315.10579,628.616988,1257.233977,343.13685,9,0
0,0,22,22,19,47,66,124,84,208,0.000333,0.419078,9,11315.10579,628.616988,1257.233977,341.776299,9,0
0,0,16,16,14,20,34,56,45,101,0.000333,0.171278,14,7193.672458,399.64847,513.833747,139.741531,3,0
0,0,32,32,24,54,78,146,108,254,0.000333,0.532164,24,38315.81193,2128.656218,1596.492164,420.803025,10,0
0,0,22,22,18,48,66,123,85,208,0.000333,0.419078,9,11315.10579,628.616988,1257.233977,343.13685,9,0
0,0,22,22,18,48,66,123,85,208,0.000333,0.419078,9,11315.10579,628.616988,1257.233977,343.13685,9,0
0,0,22,22,19,47,66,124,84,208,0.000333,0.419078,9,11315.10579,628.616988,1257.233977,341.776299,9,0
0,0,22,22,18,48,66,123,85,208,0.000333,0.419078,9,11315.10579,628.616988,1257.233977,343.13685,9,0
0,0,14,14,13,19,32,47,44,91,0.000333,0.151667,12,5460,303.333333,455,128.816339,1,0
0,0,32,32,20,50,70,156,111,267,0.000333,0.545506,20,32730.37131,1818.353962,1636.518566,368.631371,11,0
0,0,8,8,11,13,24,35,26,61,0.000333,0.093228,10,2796.827125,155.379285,279.682713,86.159464,1,0
0,0,34,34,23,56,79,158,111,269,0.000333,0.565239,11,18652.88723,1036.271513,1695.717021,429.253801,14,0
0,0,34,34,23,56,79,157,111,268,0.000333,0.563138,11,18583.54565,1032.419203,1689.413241,429.253801,14,0
0,0,15,15,13,20,33,55,38,93,0.000333,0.156376,6,2814.771919,156.376218,469.128653,134.544278,5,0
0,0,15,15,13,20,33,54,38,92,0.000333,0.154695,6,2784.505554,154.694753,464.084259,134.544278,5,0
0,0,30,30,19,50,69,149,99,248,0.000333,0.504971,9,13634.22659,757.457033,1514.914065,362.903432,12,0
0,0,30,30,19,48,67,159,99,258,0.000333,0.521684,18,28170.9182,1565.051011,1565.051011,348.788823,11,0
0,0,30,30,20,49,69,160,100,260,0.000333,0.529405,20,31764.32718,1764.684843,1588.216359,361.559344,11,0
0,0,34,34,23,56,79,158,111,269,0.000333,0.565239,11,18652.88723,1036.271513,1695.717021,429.253801,14,0
0,0,34,34,23,56,79,157,111,268,0.000333,0.563138,11,18583.54565,1032.419203,1689.413241,429.253801,14,0
0,0,15,15,13,20,33,55,38,93,0.000333,0.156376,6,2814.771919,156.376218,469.128653,134.544278,5,0
0,0,15,15,13,20,33,54,38,92,0.000333,0.154695,6,2784.505554,154.694753,464.084259,134.544278,5,0
0,0,32,32,21,51,72,167,114,281,0.000333,0.577916,20,34674.97851,1926.387695,1733.748925,381.532358,11,0
0,0,32,32,22,52,74,168,120,288,0.000333,0.596108,22,39343.09653,2185.727585,1788.322569,394.530361,11,0
0,0,19,19,18,44,62,110,75,185,0.000333,0.367175,9,9913.736857,550.763159,1101.526317,315.273641,7,0
0,0,19,19,19,43,62,111,74,185,0.000333,0.367175,9,9913.736857,550.763159,1101.526317,314.040007,7,0
0,0,30,30,20,48,68,159,99,258,0.000333,0.523522,20,31411.30826,1745.072681,1570.565413,354.516762,11,0
0,0,30,30,21,49,70,160,100,260,0.000333,0.531205,20,31872.27169,1770.68176,1593.613584,367.359448,11,0
0,0,27,27,20,47,67,144,95,239,0.000333,0.483265,20,28995.90633,1610.883685,1449.795317,347.504238,11,0
0,0,27,27,20,48,68,144,97,241,0.000333,0.489026,20,29341.5709,1630.087272,1467.078545,354.516762,11,0
0,0,20,20,17,46,63,113,81,194,0.000333,0.386531,8,9276.738441,515.374358,1159.592305,323.570718,9,0
0,0,20,20,17,47,64,113,83,196,0.000333,0.392,8,9408,522.666667,1176,330.552544,9,0
0,0,27,27,20,48,68,144,97,241,0.000333,0.489026,20,29341.5709,1630.087272,1467.078545,354.516762,11,0
0,0,29,29,19,49,68,146,97,243,0.000333,0.493084,9,13313.28123,739.626735,1479.25347,355.831405,11,0
0,0,20,20,18,45,63,105,74,179,0.000333,0.356644,9,9629.397957,534.966553,1069.933106,322.192039,8,0
0,0,20,20,18,46,64,105,75,180,0.000333,0.36,9,9720,540,1080,329.1425,8,0
0,0,18,18,16,44,60,98,70,168,0.000333,0.330786,8,7938.86096,441.047831,992.35762,304.214991,7,0
0,0,22,22,18,48,66,123,85,208,0.000333,0.419078,9,11315.10579,628.616988,1257.233977,343.13685,9,0
0,0,22,22,19,47,66,124,84,208,0.000333,0.419078,9,11315.10579,628.616988,1257.233977,341.776299,9,0
0,0,22,22,18,48,66,114,83,197,0.000333,0.396915,9,10716.71077,595.372821,1190.745642,343.13685,9,0
0,0,22,22,18,48,66,114,83,197,0.000333,0.396915,9,10716.71077,595.372821,1190.745642,343.13685,9,0
0,0,20,20,18,46,64,105,75,180,0.000333,0.36,9,9720,540,1080,329.1425,8,0
0,0,22,22,18,48,66,114,83,197,0.000333,0.396915,9,10716.71077,595.372821,1190.745642,343.13685,9,0
0,0,22,22,19,47,66,115,82,197,0.000333,0.396915,9,10716.71077,595.372821,1190.745642,341.776299,9,0
0,0,22,22,18,48,66,114,83,197,0.000333,0.396915,9,10716.71077,595.372821,1190.745642,343.13685,9,0
0,0,24,24,20,44,64,131,87,218,0.000333,0.436,10,13080,726.666667,1308,326.653553,9,0
0,0,20,20,18,45,63,105,74,179,0.000333,0.356644,9,9629.397957,534.966553,1069.933106,322.192039,8,0
0,0,22,22,19,45,64,109,77,186,0.000333,0.372,9,10044,558,1116,327.844012,8,0
0,0,38,38,24,56,80,167,115,282,0.000333,0.594261,24,42786.80935,2377.044964,1782.783723,435.250976,14,0
0,0,38,38,24,55,79,167,115,282,0.000333,0.592555,24,42663.9881,2370.221561,1777.666171,428.013884,14,0
0,0,19,19,14,22,36,64,42,106,0.000333,0.182671,7,3836.084351,213.115797,548.01205,151.410465,5,0
0,0,19,19,14,21,35,64,42,106,0.000333,0.181235,14,7611.855997,422.880889,543.704,145.541635,5,0
0,0,22,22,18,48,66,114,83,197,0.000333,0.396915,9,10716.71077,595.372821,1190.745642,343.13685,9,0
0,0,22,22,18,48,66,123,85,208,0.000333,0.419078,9,11315.10579,628.616988,1257.233977,343.13685,9,0
0,0,22,22,19,47,66,124,84,208,0.000333,0.419078,9,11315.10579,628.616988,1257.233977,341.776299,9,0
0,0,22,22,19,47,66,124,84,208,0.000333,0.419078,9,11315.10579,628.616988,1257.233977,341.776299,9,0
0,0,31,31,23,53,76,145,101,246,0.000333,0.51233,11,16906.89185,939.27177,1536.990168,407.621709,12,0
0,0,31,31,23,53,76,144,101,245,0.000333,0.510247,11,16838.16465,935.453592,1530.742241,407.621709,12,0
0,0,15,15,13,20,33,55,38,93,0.000333,0.156376,6,2814.771919,156.376218,469.128653,134.544278,5,0
0,0,15,15,13,20,33,54,38,92,0.000333,0.154695,6,2784.505554,154.694753,464.084259,134.544278,5,0
0,0,32,32,26,59,85,147,117,264,0.000333,0.564026,13,21997.02969,1222.057205,1692.079207,469.287373,10,0
0,0,16,16,16,25,41,57,54,111,0.000333,0.198229,16,9515.01236,528.611798,594.688273,180.096405,3,0
0,0,31,31,23,53,76,144,99,243,0.000333,0.506082,11,16700.71024,927.817236,1518.246386,407.621709,12,0
0,0,31,31,23,52,75,144,99,243,0.000333,0.504534,11,16649.63236,924.979576,1513.602942,400.46479,12,0
0,0,15,15,13,20,33,54,36,90,0.000333,0.151332,6,2723.972824,151.331824,453.995471,134.544278,5,0
0,0,15,15,13,19,32,54,36,90,0.000333,0.15,6,2700,150,450,128.816339,5,0
0,0,31,31,23,53,76,144,99,243,0.000333,0.506082,11,16700.71024,927.817236,1518.246386,407.621709,12,0
0,0,31,31,23,52,75,144,99,243,0.000333,0.504534,11,16649.63236,924.979576,1513.602942,400.46479,12,0
0,0,15,15,13,20,33,54,36,90,0.000333,0.151332,6,2723.972824,151.331824,453.995471,134.544278,5,0
0,0,15,15,13,19,32,54,36,90,0.000333,0.15,6,2700,150,450,128.816339,5,0
0,0,31,31,23,52,75,145,101,246,0.000333,0.510763,11,16855.18338,936.399076,1532.289398,400.46479,12,0
0,0,31,31,23,52,75,144,101,245,0.000333,0.508687,11,16786.66637,932.592576,1526.060579,400.46479,12,0
0,0,15,15,13,19,32,55,38,93,0.000333,0.155,12,5580,310,465,128.816339,5,0
0,0,15,15,13,19,32,54,38,92,0.000333,0.153333,12,5520,306.666667,460,128.816339,5,0
0,0,13,13,13,18,31,48,34,82,0.000333,0.135415,6,2437.464585,135.414699,406.244097,123.164366,3,0
0,0,29,29,23,51,74,138,97,235,0.000333,0.486407,11,16051.43695,891.746497,1459.221541,393.335617,10,0
0,0,34,34,23,56,79,157,109,266,0.000333,0.558935,11,18444.86247,1024.714582,1676.805679,429.253801,14,0
0,0,34,34,23,55,78,157,109,266,0.000333,0.557306,11,18391.08689,1021.72705,1671.91699,422.016709,14,0
0,0,15,15,13,20,33,54,36,90,0.000333,0.151332,6,2723.972824,151.331824,453.995471,134.544278,5,0
0,0,15,15,13,19,32,54,36,90,0.000333,0.15,6,2700,150,450,128.816339,5,0
0,0,13,13,12,19,31,44,42,86,0.000333,0.14202,12,5112.730592,284.040588,426.060883,123.730173,1,0
0,0,16,16,12,22,34,58,69,127,0.000333,0.215369,18,11629.94006,646.107781,646.107781,141.127046,3,0
0,0,16,16,14,23,37,60,71,131,0.000333,0.227479,21,14331.20621,796.178123,682.438391,157.344894,4,0
0,0,22,22,20,45,65,110,77,187,0.000333,0.375394,10,11261.82781,625.657101,1126.182781,333.571951,8,0
0,0,19,19,13,25,38,62,71,133,0.000333,0.232658,12,8375.692311,465.31624,697.974359,164.202121,3,0
0,0,19,19,15,26,41,66,73,139,0.000333,0.248233,14,10425.7962,579.2109,744.699729,180.814792,4,0
0,0,16,16,16,21,37,60,47,107,0.000333,0.185804,16,8918.584162,495.476898,557.41151,156.238666,4,0
0,0,11,11,13,21,34,44,35,79,0.000333,0.13397,6,2411.457387,133.969855,401.909564,140.344382,3,0
0,0,11,11,15,22,37,46,37,83,0.000333,0.144128,7,3026.692405,168.149578,432.384629,156.710855,4,0
0,0,14,14,13,19,32,47,44,91,0.000333,0.151667,12,5460,303.333333,455,128.816339,1,0
0,0,14,14,10,18,28,49,64,113,0.000333,0.181077,15,8148.466593,452.692588,543.231106,108.277931,1,0
0,0,17,17,13,24,37,57,59,116,0.000333,0.201432,12,7251.559085,402.864394,604.29659,158.144816,3,0
0,0,17,17,15,25,40,61,61,122,0.000333,0.216425,14,9089.853186,504.991844,649.275228,174.699764,4,0
0,0,16,16,12,21,33,59,68,127,0.000333,0.213546,18,11531.48496,640.638053,640.638053,135.258216,3,0
0,0,16,16,14,22,36,61,70,131,0.000333,0.225753,21,14222.46368,790.136871,677.260175,151.410465,4,0
0,0,19,19,13,24,37,63,70,133,0.000333,0.230952,12,8314.287572,461.904865,692.857298,158.144816,3,0
0,0,18,18,15,24,39,63,70,133,0.000333,0.234319,14,9841.418932,546.745496,702.958495,168.642459,4,0
0,0,18,18,15,25,40,66,56,122,0.000333,0.216425,14,9089.853186,504.991844,649.275228,174.699764,3,0
0,0,17,17,17,25,42,66,56,122,0.000333,0.219288,16,10525.80361,584.766867,657.862726,185.583273,4,0
0,0,10,10,12,18,30,44,32,76,0.000333,0.124308,6,2237.542112,124.307895,372.923685,118.0782,3,0
0,0,10,10,14,19,33,46,34,80,0.000333,0.134517,7,2824.860707,156.936706,403.55153,134.013592,4,0
0,0,17,17,14,24,38,66,53,119,0.000333,0.208168,14,8743.047237,485.724847,624.503374,163.342069,3,0
0,0,16,16,16,24,40,66,53,119,0.000333,0.211103,16,10132.95109,562.941727,633.309443,174.0391,4,0
0,0,16,16,14,23,37,58,49,107,0.000333,0.185804,14,7803.761142,433.542286,557.41151,157.344894,3,0
0,0,15,15,16,23,39,58,49,107,0.000333,0.188513,16,9048.608599,502.700478,565.538037,168.041925,4,0
0,0,18,18,14,25,39,60,59,119,0.000333,0.209654,14,8805.480097,489.193339,628.962864,169.399374,3,0
0,0,17,17,16,25,41,60,59,119,0.000333,0.212516,16,10200.77902,566.709945,637.548689,180.096405,4,0
0,0,16,16,16,24,40,59,51,110,0.000333,0.195137,16,9366.593447,520.366303,585.41209,174.0391,4,0
0,0,22,22,18,48,66,114,83,197,0.000333,0.396915,9,10716.71077,595.372821,1190.745642,343.13685,9,0
0,0,22,22,19,47,66,115,82,197,0.000333,0.396915,9,10716.71077,595.372821,1190.745642,341.776299,9,0
0,0,15,15,12,20,32,49,54,103,0.000333,0.171667,12,6180,343.333333,515,129.458112,1,0
0,0,31,31,19,50,69,151,104,255,0.000333,0.519225,18,28038.12726,1557.673736,1557.673736,362.903432,10,0
0,0,33,33,19,51,70,157,114,271,0.000333,0.553679,18,29898.64256,1661.035698,1661.035698,370.004315,10,0
0,0,31,31,20,50,70,154,109,263,0.000333,0.537334,20,32240.02867,1791.112704,1612.001433,368.631371,10,0
0,0,31,31,21,52,73,155,110,265,0.000333,0.546768,20,32806.07016,1822.559453,1640.303508,388.661531,10,0
0,0,32,32,21,52,73,158,113,271,0.000333,0.559147,20,33548.84911,1863.824951,1677.442455,388.661531,11,0
0,0,27,27,20,47,67,144,95,239,0.000333,0.483265,20,28995.90633,1610.883685,1449.795317,347.504238,11,0
0,0,27,27,19,45,64,136,88,224,0.000333,0.448,9,12096,672,1344,327.844012,9,0
0,0,27,27,20,44,64,137,87,224,0.000333,0.448,10,13440,746.666667,1344,326.653553,9,0
0,0,9,9,14,16,30,37,31,68,0.000333,0.111223,7,2335.679924,129.759996,333.668561,117.302969,1,0
0,0,20,20,18,46,64,104,75,179,0.000333,0.358,9,9666,537,1074,329.1425,8,0
0,0,9,9,11,17,28,35,30,65,0.000333,0.104159,5,1562.39035,86.799464,312.47807,107.540616,1,0
0,0,27,27,20,48,68,144,97,241,0.000333,0.489026,20,29341.5709,1630.087272,1467.078545,354.516762,11,0
0,0,22,22,20,47,67,113,79,192,0.000333,0.38823,10,11646.89125,647.049514,1164.689125,347.504238,8,0
0,0,20,20,18,47,65,104,76,180,0.000333,0.361342,9,9756.235857,542.013103,1084.026206,336.124326,8,0
0,0,22,22,18,48,66,123,85,208,0.000333,0.419078,9,11315.10579,628.616988,1257.233977,343.13685,9,0
0,0,22,22,19,47,66,124,84,208,0.000333,0.419078,9,11315.10579,628.616988,1257.233977,341.776299,9,0
0,0,22,22,19,47,66,124,84,208,0.000333,0.419078,9,11315.10579,628.616988,1257.233977,341.776299,9,0
0,0,22,22,19,47,66,113,82,195,0.000333,0.392886,9,10607.91168,589.328427,1178.656853,341.776299,8,0
0,0,20,20,18,45,63,104,75,179,0.000333,0.356644,9,9629.397957,534.966553,1069.933106,322.192039,8,0
0,0,20,20,18,45,63,104,74,178,0.000333,0.354652,9,9575.602437,531.977913,1063.955826,322.192039,8,0
0,0,27,27,19,47,66,136,89,225,0.000333,0.45333,9,12239.89809,679.994338,1359.988677,341.776299,10,0
0,0,34,34,23,56,79,157,109,266,0.000333,0.558935,11,18444.86247,1024.714582,1676.805679,429.253801,14,0
0,0,34,34,23,55,78,157,109,266,0.000333,0.557306,11,18391.08689,1021.72705,1671.91699,422.016709,14,0
0,0,15,15,13,20,33,54,36,90,0.000333,0.151332,6,2723.972824,151.331824,453.995471,134.544278,5,0
0,0,15,15,13,19,32,54,36,90,0.000333,0.15,6,2700,150,450,128.816339,5,0
0,0,19,19,18,45,63,101,74,175,0.000333,0.348675,9,9414.21588,523.011993,1046.023987,322.192039,7,0
0,0,21,21,18,46,64,110,80,190,0.000333,0.38,9,10260,570,1140,329.1425,7,0
0,0,31,31,22,50,72,155,104,259,0.000333,0.53267,22,35156.23266,1953.124037,1598.010575,380.300305,12,0
0,0,30,30,19,49,68,149,98,247,0.000333,0.501201,18,27064.85979,1503.603322,1503.603322,355.831405,12,0
0,0,30,30,20,50,70,149,98,247,0.000333,0.504644,10,15139.32905,841.073836,1513.932905,368.631371,12,0
0,0,30,30,19,51,70,149,99,248,0.000333,0.506687,9,13680.55969,760.031094,1520.062188,370.004315,12,0
0,0,31,31,19,50,69,152,103,255,0.000333,0.519225,18,28038.12726,1557.673736,1557.673736,362.903432,11,0
0,0,33,33,20,51,71,159,115,274,0.000333,0.561677,20,33700.61422,1872.256345,1685.030711,375.732254,12,0
0,0,33,33,21,51,72,160,106,266,0.000333,0.547067,20,32824.00101,1823.555612,1641.20005,381.532358,12,0
0,0,29,29,19,49,68,146,97,243,0.000333,0.493084,9,13313.28123,739.626735,1479.25347,355.831405,11,0
0,0,32,32,19,50,69,158,105,263,0.000333,0.535514,18,28917.75478,1606.541932,1606.541932,362.903432,11,0
0,0,19,19,18,45,63,101,74,175,0.000333,0.348675,9,9414.21588,523.011993,1046.023987,322.192039,7,0
0,0,21,21,19,46,65,110,81,191,0.000333,0.383424,9,10352.45027,575.136126,1150.272252,334.794473,7,0
0,0,20,20,18,46,64,104,76,180,0.000333,0.36,9,9720,540,1080,329.1425,8,0
0,0,20,20,18,45,63,104,75,179,0.000333,0.356644,9,9629.397957,534.966553,1069.933106,322.192039,8,0
0,0,20,20,18,46,64,104,75,179,0.000333,0.358,9,9666,537,1074,329.1425,8,0
0,0,20,20,18,47,65,104,76,180,0.000333,0.361342,9,9756.235857,542.013103,1084.026206,336.124326,8,0
0,0,20,20,18,47,65,104,76,180,0.000333,0.361342,9,9756.235857,542.013103,1084.026206,336.124326,8,0
0,0,19,19,18,45,63,101,74,175,0.000333,0.348675,9,9414.21588,523.011993,1046.023987,322.192039,7,0
0,0,30,30,20,47,67,146,105,251,0.000333,0.507529,20,30451.76774,1691.764874,1522.588387,347.504238,10,0
0,0,19,19,18,45,63,101,74,175,0.000333,0.348675,9,9414.21588,523.011993,1046.023987,322.192039,7,0
0,0,19,19,18,44,62,110,75,185,0.000333,0.367175,9,9913.736857,550.763159,1101.526317,315.273641,7,0
0,0,19,19,18,44,62,110,75,185,0.000333,0.367175,9,9913.736857,550.763159,1101.526317,315.273641,7,0
0,0,19,19,19,43,62,111,74,185,0.000333,0.367175,9,9913.736857,550.763159,1101.526317,314.040007,7,0
0,0,18,18,19,25,44,65,70,135,0.000333,0.245674,18,13266.41883,737.023269,737.023269,196.807027,4,0
0,0,18,18,17,24,41,61,68,129,0.000333,0.230375,16,11057.98734,614.33263,691.124209,179.525968,3,0
0,0,10,10,16,19,35,45,36,81,0.000333,0.138491,8,3323.775395,184.654189,415.471924,144.710623,4,0
0,0,10,10,14,18,32,43,34,77,0.000333,0.128333,7,2695,149.722222,385,128.361619,3,0
0,0,16,16,18,26,44,61,56,117,0.000333,0.212918,18,11497.56299,638.753499,638.753499,197.270083,4,0
0,0,16,16,16,25,41,57,54,111,0.000333,0.198229,16,9515.01236,528.611798,594.688273,180.096405,3,0
0,0,19,19,18,45,63,101,74,175,0.000333,0.348675,9,9414.21588,523.011993,1046.023987,322.192039,7,0
0,0,19,19,18,45,63,101,74,175,0.000333,0.348675,9,9414.21588,523.011993,1046.023987,322.192039,7,0
0,0,27,27,19,45,64,136,88,224,0.000333,0.448,9,12096,672,1344,327.844012,10,0
0,0,19,19,18,45,63,101,74,175,0.000333,0.348675,9,9414.21588,523.011993,1046.023987,322.192039,7,0
0,0,19,19,18,45,63,101,74,175,0.000333,0.348675,9,9414.21588,523.011993,1046.023987,322.192039,7,0
0,0,30,30,19,51,70,149,99,248,0.000333,0.506687,9,13680.55969,760.031094,1520.062188,370.004315,12,0
0,0,30,30,19,51,70,149,99,248,0.000333,0.506687,9,13680.55969,760.031094,1520.062188,370.004315,12,0
0,0,30,30,19,50,69,149,98,247,0.000333,0.502935,9,13579.24987,754.40277,1508.805541,362.903432,12,0
0,0,32,32,21,50,71,154,101,255,0.000333,0.522729,20,31363.71031,1742.428351,1568.185515,374.431475,12,0
0,0,30,30,19,51,70,149,99,248,0.000333,0.506687,9,13680.55969,760.031094,1520.062188,370.004315,12,0
0,0,30,30,20,50,70,149,98,247,0.000333,0.504644,10,15139.32905,841.073836,1513.932905,368.631371,12,0
0,0,30,30,19,51,70,149,99,248,0.000333,0.506687,9,13680.55969,760.031094,1520.062188,370.004315,12,0
0,0,31,31,20,49,69,163,107,270,0.000333,0.549767,20,32986.03207,1832.557337,1649.301603,361.559344,10,0
0,0,31,31,21,51,72,164,108,272,0.000333,0.559407,20,33564.39201,1864.688445,1678.2196,381.532358,10,0
0,0,30,30,20,48,68,154,103,257,0.000333,0.521493,20,31289.559,1738.308834,1564.47795,354.516762,10,0
0,0,30,30,21,50,71,155,104,259,0.000333,0.530928,20,31855.69008,1769.76056,1592.784504,374.431475,10,0
0,0,16,16,12,22,34,57,52,109,0.000333,0.184844,12,6654.401396,369.688966,554.53345,141.127046,1,0
0,0,11,11,12,15,27,39,30,69,0.000333,0.109362,12,3937.046852,218.724825,328.087238,101.622909,1,0
0,0,12,12,13,15,28,42,31,73,0.000333,0.116979,12,4211.242912,233.95794,350.936909,106.709075,2,0
0,0,12,12,13,15,28,42,31,73,0.000333,0.116979,12,4211.242912,233.95794,350.936909,106.709075,2,0
0,0,12,12,14,16,30,43,32,75,0.000333,0.122672,14,5152.235125,286.235285,368.016795,117.302969,2,0
0,0,12,12,13,16,29,42,32,74,0.000333,0.11983,12,4313.887124,239.660396,359.490594,112.105716,2,0
0,0,12,12,13,16,29,42,31,73,0.000333,0.118211,6,2127.795676,118.210871,354.632613,112.105716,2,0
0,0,12,12,13,16,29,42,31,73,0.000333,0.118211,6,2127.795676,118.210871,354.632613,112.105716,2,0
0,0,12,12,13,16,29,42,31,73,0.000333,0.118211,6,2127.795676,118.210871,354.632613,112.105716,2,0
0,0,12,12,13,16,29,42,31,73,0.000333,0.118211,6,2127.795676,118.210871,354.632613,112.105716,2,0
0,0,12,12,14,17,31,43,32,75,0.000333,0.123855,7,2600.953063,144.497392,371.564723,122.789837,2,0
0,0,12,12,13,17,30,42,32,74,0.000333,0.121037,6,2178.659424,121.036635,363.109904,117.592585,2,0
0,0,12,12,14,17,31,43,32,75,0.000333,0.123855,7,2600.953063,144.497392,371.564723,122.789837,2,0
0,0,12,12,13,17,30,42,32,74,0.000333,0.121037,6,2178.659424,121.036635,363.109904,117.592585,2,0
0,0,14,14,14,16,30,47,34,81,0.000333,0.132486,14,5564.413935,309.134108,397.458138,117.302969,2,0
0,0,14,14,14,16,30,47,34,81,0.000333,0.132486,14,5564.413935,309.134108,397.458138,117.302969,2,0
0,0,16,16,14,24,38,57,50,107,0.000333,0.187176,14,7861.395415,436.74419,561.528244,163.342069,3,0
0,0,18,18,18,30,48,75,63,138,0.000333,0.256908,18,13873.04685,770.724825,770.724825,222.265368,5,0
0,0,17,17,14,25,39,65,54,119,0.000333,0.209654,14,8805.480097,489.193339,628.962864,169.399374,3,0
0,0,19,19,18,31,49,83,67,150,0.000333,0.280735,18,15159.71658,842.206477,842.206477,228.638736,5,0
0,0,16,16,14,23,37,55,49,104,0.000333,0.180594,14,7584.9641,421.386894,541.78315,157.344894,3,0
0,0,18,18,18,29,47,73,62,135,0.000333,0.249956,18,13497.65091,749.869495,749.869495,215.940099,5,0
0,0,16,16,12,22,34,58,69,127,0.000333,0.215369,18,11629.94006,646.107781,646.107781,141.127046,3,0
0,0,16,16,14,23,37,60,71,131,0.000333,0.227479,21,14331.20621,796.178123,682.438391,157.344894,4,0
0,0,15,15,13,23,36,52,47,99,0.000333,0.170608,12,6141.870902,341.21505,511.822575,152.147641,3,0
0,0,17,17,17,29,46,70,60,130,0.000333,0.239354,16,11489.00887,638.27827,718.063054,210.368317,5,0
0,0,31,31,20,48,68,156,107,263,0.000333,0.533668,20,32020.05455,1778.891919,1601.002727,354.516762,10,0
0,0,27,27,19,46,65,136,89,225,0.000333,0.451678,9,12195.29482,677.516379,1355.032758,334.794473,9,0
0,0,31,31,20,49,69,160,107,267,0.000333,0.543659,20,32619.5206,1812.195589,1630.97603,361.559344,10,0
0,0,30,30,20,48,68,151,103,254,0.000333,0.515405,20,30924.31123,1718.017291,1546.215562,354.516762,10,0
0,0,10,10,12,19,31,43,33,76,0.000333,0.125506,6,2259.113518,125.506307,376.51892,123.730173,3,0
0,0,10,10,14,20,34,45,35,80,0.000333,0.135666,7,2848.979191,158.276622,406.997027,139.741531,4,0
0,0,18,18,15,26,41,65,57,122,0.000333,0.217874,14,9150.698824,508.372157,653.621345,180.814792,3,0
0,0,20,20,17,32,49,83,70,153,0.000333,0.28635,16,13744.8097,763.600539,859.050606,229.486868,5,0
0,0,20,20,18,45,63,104,74,178,0.000333,0.354652,9,9575.602437,531.977913,1063.955826,322.192039,8,0
0,0,22,22,20,45,65,109,77,186,0.000333,0.373387,10,11201.60413,622.311341,1120.160413,333.571951,8,0
0,0,33,33,19,51,70,163,116,279,0.000333,0.570023,18,30781.25931,1710.069962,1710.069962,370.004315,11,0
0,0,33,33,19,53,72,158,119,277,0.000333,0.56969,18,30763.24606,1709.069225,1709.069225,384.290407,11,0
0,0,30,30,19,50,69,148,102,250,0.000333,0.509044,18,27488.36006,1527.131114,1527.131114,362.903432,11,0
0,0,33,33,19,53,72,158,119,277,0.000333,0.56969,18,30763.24606,1709.069225,1709.069225,384.290407,11,0
0,0,32,32,20,50,70,156,111,267,0.000333,0.545506,20,32730.37131,1818.353962,1636.518566,368.631371,11,0
0,0,33,33,19,52,71,167,116,283,0.000333,0.580126,18,31326.81183,1740.378435,1740.378435,377.133488,11,0
0,0,20,20,18,44,62,104,74,178,0.000333,0.353282,9,9538.622489,529.923472,1059.846943,315.273641,8,0
0,0,30,30,19,50,69,148,101,249,0.000333,0.507008,18,27378.40662,1521.02259,1521.02259,362.903432,11,0
0,0,36,36,19,56,75,170,123,293,0.000333,0.608348,18,32850.78977,1825.043876,1825.043876,405.922498,12,0
0,0,20,20,18,46,64,104,75,179,0.000333,0.358,9,9666,537,1074,329.1425,8,0
0,0,22,22,20,46,66,109,78,187,0.000333,0.376767,10,11303.017,627.945389,1130.3017,340.522412,8,0
0,0,20,20,18,46,64,104,75,179,0.000333,0.358,9,9666,537,1074,329.1425,8,0
0,0,20,20,18,47,65,104,76,180,0.000333,0.361342,9,9756.235857,542.013103,1084.026206,336.124326,8,0
0,0,40,40,19,56,75,182,144,326,0.000333,0.676865,18,36550.70808,2030.594893,2030.594893,405.922498,12,0
0,0,38,38,19,55,74,176,134,310,0.000333,0.641644,18,34648.74978,1924.930543,1924.930543,398.685407,12,0
0,0,32,32,20,50,70,156,109,265,0.000333,0.54142,20,32485.19999,1804.733333,1624.259999,368.631371,11,0
0,0,36,36,19,55,74,179,121,300,0.000333,0.620945,18,33531.04817,1862.83601,1862.83601,398.685407,12,0
0,0,35,35,19,54,73,170,117,287,0.000333,0.59216,18,31976.63367,1776.479648,1776.479648,391.474548,12,0
0,0,36,36,19,54,73,175,121,296,0.000333,0.610729,18,32979.38525,1832.188069,1832.188069,391.474548,12,0
0,0,30,30,19,50,69,149,99,248,0.000333,0.504971,9,13634.22659,757.457033,1514.914065,362.903432,11,0
0,0,32,32,19,47,66,151,116,267,0.000333,0.537951,18,29049.35814,1613.85323,1613.85323,341.776299,9,0
0,0,30,30,19,46,65,145,106,251,0.000333,0.503871,18,27209.05778,1511.614321,1511.614321,334.794473,9,0
0,0,29,29,19,46,65,145,99,244,0.000333,0.489819,18,26450.23944,1469.457746,1469.457746,334.794473,9,0
0,0,29,29,20,45,65,143,98,241,0.000333,0.483797,20,29027.81286,1612.65627,1451.390643,333.571951,9,0
0,0,27,27,19,45,64,136,88,224,0.000333,0.448,9,12096,672,1344,327.844012,9,0
0,0,29,29,20,46,66,143,99,242,0.000333,0.487581,20,29254.86754,1625.270419,1462.743377,340.522412,9,0
0,0,18,18,15,26,41,65,57,122,0.000333,0.217874,14,9150.698824,508.372157,653.621345,180.814792,3,0
0,0,37,37,23,62,85,168,130,298,0.000333,0.636666,22,42019.96698,2334.44261,1909.998499,473.202096,12,0
0,0,11,11,12,21,33,43,37,80,0.000333,0.134517,6,2421.309177,134.517177,403.55153,135.258216,3,0
0,0,11,11,14,22,36,45,39,84,0.000333,0.144758,7,3039.915901,168.884217,434.2737,151.410465,4,0
0,0,15,15,15,20,35,57,47,104,0.000333,0.177815,14,7468.236073,414.902004,533.445434,145.041921,5,0
0,0,15,15,15,20,35,57,47,104,0.000333,0.177815,14,7468.236073,414.902004,533.445434,145.041921,5,0
0,0,13,13,16,19,35,51,35,86,0.000333,0.147039,8,3528.946716,196.052595,441.118339,144.710623,5,0
0,0,14,14,17,22,39,58,42,100,0.000333,0.17618,8,4228.321775,234.906765,528.540222,167.594364,5,0
0,0,22,22,20,46,66,109,78,187,0.000333,0.376767,10,11303.017,627.945389,1130.3017,340.522412,8,0
0,0,13,13,16,19,35,51,35,86,0.000333,0.147039,8,3528.946716,196.052595,441.118339,144.710623,5,0
0,0,13,13,16,19,35,51,35,86,0.000333,0.147039,8,3528.946716,196.052595,441.118339,144.710623,5,0
0,0,15,15,14,20,34,54,36,90,0.000333,0.152624,7,3205.10159,178.061199,457.871656,139.741531,5,0
0,0,15,15,14,20,34,54,36,90,0.000333,0.152624,7,3205.10159,178.061199,457.871656,139.741531,5,0
0,0,20,20,15,24,39,75,49,124,0.000333,0.218463,14,9175.458252,509.747681,655.389875,168.642459,6,0
0,0,16,16,16,22,38,62,41,103,0.000333,0.180179,8,4324.292271,240.23846,540.536534,162.107496,5,0
0,0,21,21,16,22,38,83,54,137,0.000333,0.239655,16,11503.45711,639.080951,718.966069,162.107496,6,0
0,0,13,13,15,20,35,52,36,88,0.000333,0.150459,7,3159.638338,175.535463,451.376905,145.041921,5,0
0,0,13,13,15,20,35,51,36,87,0.000333,0.148749,7,3123.733357,173.540742,446.247622,145.041921,5,0
0,0,30,30,21,47,68,147,96,243,0.000333,0.493084,20,29585.06941,1643.614967,1479.25347,353.304342,10,0
0,0,22,22,20,48,68,113,93,206,0.000333,0.418006,10,12540.17345,696.676303,1254.017345,354.516762,7,0
0,0,19,19,18,45,63,101,74,175,0.000333,0.348675,9,9414.21588,523.011993,1046.023987,322.192039,7,0
0,0,15,15,15,23,38,56,53,109,0.000333,0.190675,14,8008.337386,444.907633,572.024099,162.645284,5,0
0,0,15,15,15,23,38,56,53,109,0.000333,0.190675,14,8008.337386,444.907633,572.024099,162.645284,5,0
0,0,16,16,13,23,36,56,50,106,0.000333,0.182671,12,6576.144602,365.341367,548.01205,152.147641,4,0
0,0,14,14,15,19,34,52,40,92,0.000333,0.156016,14,6552.65214,364.03623,468.046581,139.313982,4,0
0,0,22,22,18,46,64,113,87,200,0.000333,0.4,9,10800,600,1200,329.1425,8,0
0,0,20,20,18,47,65,104,76,180,0.000333,0.361342,9,9756.235857,542.013103,1084.026206,336.124326,8,0
0,0,22,22,20,47,67,113,79,192,0.000333,0.38823,10,11646.89125,647.049514,1164.689125,347.504238,8,0
0,0,33,33,20,52,72,164,113,277,0.000333,0.56969,20,34181.38451,1898.965806,1709.069225,382.861427,12,0
0,0,22,22,19,46,65,108,78,186,0.000333,0.373387,9,10081.44372,560.080207,1120.160413,334.794473,8,0
0,0,30,30,19,50,69,148,101,249,0.000333,0.507008,18,27378.40662,1521.02259,1521.02259,362.903432,11,0
0,0,20,20,18,46,64,104,75,179,0.000333,0.358,9,9666,537,1074,329.1425,8,0
0,0,30,30,19,50,69,149,99,248,0.000333,0.504971,9,13634.22659,757.457033,1514.914065,362.903432,11,0
0,0,29,29,21,47,68,149,96,245,0.000333,0.497143,20,29828.56792,1657.142662,1491.428396,353.304342,10,0
0,0,29,29,21,46,67,150,99,249,0.000333,0.503485,20,30209.12417,1678.284676,1510.456208,346.322516,10,0
0,0,29,29,21,46,67,150,99,249,0.000333,0.503485,20,30209.12417,1678.284676,1510.456208,346.322516,10,0
0,0,29,29,20,47,67,148,100,248,0.000333,0.501463,20,30087.80239,1671.544577,1504.390119,347.504238,10,0
0,0,29,29,21,49,70,149,103,252,0.000333,0.51486,20,30891.58641,1716.199245,1544.57932,367.359448,10,0
0,0,29,29,21,49,70,149,103,252,0.000333,0.51486,20,30891.58641,1716.199245,1544.57932,367.359448,10,0
0,0,19,19,18,44,62,101,73,174,0.000333,0.345343,9,9324.271422,518.015079,1036.030158,315.273641,7,0
0,0,19,19,18,44,62,101,73,174,0.000333,0.345343,9,9324.271422,518.015079,1036.030158,315.273641,7,0
0,0,30,30,21,47,68,149,94,243,0.000333,0.493084,20,29585.06941,1643.614967,1479.25347,353.304342,11,0
0,0,30,30,22,46,68,150,93,243,0.000333,0.493084,22,32543.57635,1807.976464,1479.25347,352.191346,11,0
0,0,30,30,22,46,68,150,93,243,0.000333,0.493084,22,32543.57635,1807.976464,1479.25347,352.191346,11,0
0,0,29,29,21,46,67,145,91,236,0.000333,0.477199,10,14315.97049,795.331694,1431.597049,346.322516,10,0
0,0,31,31,22,47,69,164,98,262,0.000333,0.533478,22,35209.53497,1956.085276,1600.433408,359.173172,12,0
0,0,29,29,22,45,67,146,90,236,0.000333,0.477199,22,31495.13508,1749.729726,1431.597049,345.240885,10,0
0,0,28,28,20,48,68,145,92,237,0.000333,0.48091,10,14427.28693,801.515941,1442.728693,354.516762,11,0
0,0,28,28,21,47,68,146,91,237,0.000333,0.48091,10,14427.28693,801.515941,1442.728693,353.304342,11,0
0,0,28,28,21,47,68,146,91,237,0.000333,0.48091,10,14427.28693,801.515941,1442.728693,353.304342,11,0
0,0,22,22,18,47,65,112,91,203,0.000333,0.407514,9,11002.86599,611.270333,1222.540666,336.124326,8,0
0,0,19,19,18,45,63,101,74,175,0.000333,0.348675,9,9414.21588,523.011993,1046.023987,322.192039,7,0
0,0,29,29,23,48,71,152,98,250,0.000333,0.512479,22,33823.60916,1879.089398,1537.43678,372.120125,11,0
0,0,29,29,24,47,71,153,97,250,0.000333,0.512479,24,36898.48272,2049.915707,1537.43678,371.104776,11,0
0,0,15,15,14,17,31,51,45,96,0.000333,0.158534,14,6658.439841,369.913325,475.602846,122.789837,2,0
0,0,15,15,14,17,31,51,45,96,0.000333,0.158534,14,6658.439841,369.913325,475.602846,122.789837,2,0
0,0,15,15,14,20,34,50,51,101,0.000333,0.171278,14,7193.672458,399.64847,513.833747,139.741531,2,0
0,0,15,15,14,20,34,50,51,101,0.000333,0.171278,14,7193.672458,399.64847,513.833747,139.741531,2,0
0,0,29,29,21,48,69,145,106,251,0.000333,0.51108,20,30664.79277,1703.599599,1533.239639,360.316866,9,0
0,0,12,12,14,17,31,43,32,75,0.000333,0.123855,7,2600.953063,144.497392,371.564723,122.789837,2,0
0,0,12,12,13,17,30,42,32,74,0.000333,0.121037,6,2178.659424,121.036635,363.109904,117.592585,2,0
0,0,12,12,14,17,31,43,32,75,0.000333,0.123855,7,2600.953063,144.497392,371.564723,122.789837,2,0
0,0,12,12,13,17,30,42,32,74,0.000333,0.121037,6,2178.659424,121.036635,363.109904,117.592585,2,0
0,0,14,14,14,16,30,46,34,80,0.000333,0.13085,14,5495.717467,305.317637,392.551248,117.302969,2,0
0,0,14,14,14,16,30,46,34,80,0.000333,0.13085,14,5495.717467,305.317637,392.551248,117.302969,2,0
0,0,13,13,15,16,31,48,37,85,0.000333,0.140369,14,5895.493609,327.527423,421.106686,122.603359,2,0
0,0,11,11,12,15,27,39,30,69,0.000333,0.109362,12,3937.046852,218.724825,328.087238,101.622909,1,0
0,0,12,12,13,16,29,42,31,73,0.000333,0.118211,6,2127.795676,118.210871,354.632613,112.105716,2,0
0,0,12,12,13,16,29,42,31,73,0.000333,0.118211,6,2127.795676,118.210871,354.632613,112.105716,2,0
0,0,12,12,13,15,28,42,31,73,0.000333,0.116979,12,4211.242912,233.95794,350.936909,106.709075,2,0
0,0,13,13,15,19,34,50,36,86,0.000333,0.145841,7,3062.65263,170.147368,437.521804,139.313982,5,0
0,0,13,13,15,20,35,50,36,86,0.000333,0.147039,7,3087.828376,171.546021,441.118339,145.041921,5,0
0,0,13,13,15,20,35,51,37,88,0.000333,0.150459,7,3159.638338,175.535463,451.376905,145.041921,5,0
0,0,13,13,15,20,35,50,37,87,0.000333,0.148749,7,3123.733357,173.540742,446.247622,145.041921,5,0
0,0,13,13,15,20,35,50,36,86,0.000333,0.147039,7,3087.828376,171.546021,441.118339,145.041921,5,0
0,0,13,13,15,20,35,50,36,86,0.000333,0.147039,7,3087.828376,171.546021,441.118339,145.041921,5,0
0,0,13,13,15,20,35,50,36,86,0.000333,0.147039,7,3087.828376,171.546021,441.118339,145.041921,5,0
0,0,13,13,15,20,35,50,36,86,0.000333,0.147039,7,3087.828376,171.546021,441.118339,145.041921,5,0
0,0,28,28,21,47,68,145,91,236,0.000333,0.47888,10,14366.41231,798.134017,1436.641231,353.304342,11,0
0,0,28,28,22,46,68,146,90,236,0.000333,0.47888,11,15803.05354,877.947419,1436.641231,352.191346,11,0
0,0,28,28,22,46,68,146,90,236,0.000333,0.47888,11,15803.05354,877.947419,1436.641231,352.191346,11,0
0,0,15,15,16,21,37,55,39,94,0.000333,0.16323,8,3917.508931,217.639385,489.688616,156.238666,5,0
0,0,15,15,16,22,38,55,39,94,0.000333,0.164435,8,3946.44149,219.246749,493.305186,162.107496,5,0
0,0,13,13,15,20,35,50,36,86,0.000333,0.147039,7,3087.828376,171.546021,441.118339,145.041921,5,0
0,0,13,13,15,20,35,50,36,86,0.000333,0.147039,7,3087.828376,171.546021,441.118339,145.041921,5,0
0,0,15,15,16,21,37,54,39,93,0.000333,0.161493,8,3875.833304,215.324072,484.479163,156.238666,5,0
0,0,15,15,16,22,38,54,39,93,0.000333,0.162686,8,3904.45807,216.914337,488.057259,162.107496,5,0
0,0,9,9,12,13,25,31,24,55,0.000333,0.085137,6,1532.472543,85.137363,255.41209,91.125266,1,0
0,0,10,10,14,15,29,35,26,61,0.000333,0.098779,7,2074.357885,115.242105,296.336841,111.906328,2,0
0,0,10,10,13,15,28,34,26,60,0.000333,0.096147,6,1730.647772,96.147098,288.441295,106.709075,2,0
0,0,10,10,13,14,27,34,25,59,0.000333,0.093513,6,1683.230176,93.512788,280.538363,101.408685,2,0
0,0,10,10,13,14,27,34,25,59,0.000333,0.093513,6,1683.230176,93.512788,280.538363,101.408685,2,0
0,0,19,19,18,44,62,101,73,174,0.000333,0.345343,9,9324.271422,518.015079,1036.030158,315.273641,7,0
0,0,21,21,21,45,66,110,80,190,0.000333,0.382812,10,11484.34883,638.019379,1148.434883,339.372055,8,0
0,0,22,22,18,48,66,123,85,208,0.000333,0.419078,9,11315.10579,628.616988,1257.233977,343.13685,9,0
0,0,15,15,15,22,37,57,39,96,0.000333,0.166703,7,3500.752662,194.486259,500.107523,156.710855,6,0
0,0,15,15,15,21,36,57,39,96,0.000333,0.165438,7,3474.189601,193.010533,496.3128,150.842025,6,0
0,0,15,15,13,21,34,53,37,90,0.000333,0.152624,6,2747.229934,152.623885,457.871656,140.344382,5,0
0,0,15,15,13,20,33,53,37,90,0.000333,0.151332,6,2723.972824,151.331824,453.995471,134.544278,5,0
0,0,19,19,16,24,40,67,45,112,0.000333,0.198685,8,4768.447573,264.913754,596.055947,174.0391,6,0
0,0,19,19,16,23,39,67,45,112,0.000333,0.197322,8,4735.720388,263.095577,591.965049,168.041925,6,0
0,0,19,19,14,23,37,63,43,106,0.000333,0.184067,7,3865.414397,214.745244,552.202057,157.344894,5,0
0,0,19,19,14,22,36,63,43,106,0.000333,0.182671,7,3836.084351,213.115797,548.01205,151.410465,5,0
0,0,18,18,16,44,60,98,70,168,0.000333,0.330786,8,7938.86096,441.047831,992.35762,304.214991,7,0
0,0,15,15,15,22,37,58,41,99,0.000333,0.171912,7,3610.151182,200.563955,515.735883,156.710855,6,0
0,0,15,15,15,22,37,57,41,98,0.000333,0.170175,7,3573.685009,198.538056,510.52643,156.710855,6,0
0,0,15,15,15,22,37,58,41,99,0.000333,0.171912,7,3610.151182,200.563955,515.735883,156.710855,6,0
0,0,15,15,15,22,37,57,41,98,0.000333,0.170175,7,3573.685009,198.538056,510.52643,156.710855,6,0
0,0,21,21,15,25,40,78,52,130,0.000333,0.230617,14,9685.909133,538.106063,691.850652,174.699764,6,0
0,0,21,21,16,23,39,81,51,132,0.000333,0.232558,16,11162.76949,620.15386,697.673093,168.041925,6,0
0,0,26,26,16,23,39,101,65,166,0.000333,0.292459,16,14038.02829,779.890461,877.376768,168.041925,7,0
0,0,19,19,16,24,40,65,45,110,0.000333,0.195137,8,4683.296724,260.183151,585.41209,174.0391,6,0
0,0,19,19,16,23,39,65,45,110,0.000333,0.193798,8,4651.153953,258.397442,581.394244,168.041925,6,0
0,0,19,19,14,23,37,61,43,104,0.000333,0.180594,7,3792.48205,210.693447,541.78315,157.344894,5,0
0,0,19,19,14,22,36,61,43,104,0.000333,0.179224,7,3763.705401,209.094745,537.6722,151.410465,5,0
0,0,15,15,15,22,37,57,39,96,0.000333,0.166703,7,3500.752662,194.486259,500.107523,156.710855,6,0
0,0,15,15,15,21,36,57,39,96,0.000333,0.165438,7,3474.189601,193.010533,496.3128,150.842025,6,0
0,0,15,15,13,21,34,53,37,90,0.000333,0.152624,6,2747.229934,152.623885,457.871656,140.344382,5,0
0,0,15,15,13,20,33,53,37,90,0.000333,0.151332,6,2723.972824,151.331824,453.995471,134.544278,5,0
0,0,22,22,19,47,66,124,84,208,0.000333,0.419078,9,11315.10579,628.616988,1257.233977,341.776299,9,0
0,0,15,15,15,22,37,58,41,99,0.000333,0.171912,7,3610.151182,200.563955,515.735883,156.710855,6,0
0,0,15,15,15,22,37,57,41,98,0.000333,0.170175,7,3573.685009,198.538056,510.52643,156.710855,6,0
0,0,30,30,19,46,65,150,103,253,0.000333,0.507886,18,27425.86302,1523.659057,1523.659057,334.794473,9,0
0,0,33,33,19,51,70,163,116,279,0.000333,0.570023,18,30781.25931,1710.069962,1710.069962,370.004315,11,0
0,0,26,26,19,44,63,133,86,219,0.000333,0.436341,9,11781.21873,654.512152,1309.024303,320.925614,9,0
0,0,30,30,19,50,69,148,102,250,0.000333,0.509044,18,27488.36006,1527.131114,1527.131114,362.903432,11,0
0,0,27,27,19,46,65,136,88,224,0.000333,0.44967,9,12141.09351,674.505195,1349.01039,334.794473,10,0
0,0,27,27,19,44,63,136,87,223,0.000333,0.444311,9,11996.40081,666.466711,1332.933423,320.925614,10,0
0,0,28,28,22,45,67,142,93,235,0.000333,0.475177,22,31361.68112,1742.315617,1425.53096,345.240885,10,0
0,0,29,29,20,45,65,140,90,230,0.000333,0.461715,20,27702.89194,1539.049552,1385.144597,333.571951,10,0
0,0,29,29,21,46,67,145,91,236,0.000333,0.477199,10,14315.97049,795.331694,1431.597049,346.322516,10,0
0,0,27,27,19,46,65,136,88,224,0.000333,0.44967,9,12141.09351,674.505195,1349.01039,334.794473,10,0
0,0,19,19,18,45,63,101,74,175,0.000333,0.348675,9,9414.21588,523.011993,1046.023987,322.192039,7,0
0,0,19,19,18,45,63,101,74,175,0.000333,0.348675,9,9414.21588,523.011993,1046.023987,322.192039,7,0
0,0,15,15,14,18,32,53,37,90,0.000333,0.15,14,6300,350,450,128.361619,2,0
0,0,21,21,18,46,64,109,87,196,0.000333,0.392,9,10584,588,1176,329.1425,7,0
0,0,19,19,18,45,63,101,74,175,0.000333,0.348675,9,9414.21588,523.011993,1046.023987,322.192039,7,0
0,0,19,19,18,44,62,101,73,174,0.000333,0.345343,9,9324.271422,518.015079,1036.030158,315.273641,7,0
0,0,19,19,18,44,62,101,73,174,0.000333,0.345343,9,9324.271422,518.015079,1036.030158,315.273641,7,0
0,0,21,21,19,45,64,110,80,190,0.000333,0.38,9,10260,570,1140,327.844012,7,0
0,0,19,19,18,44,62,101,73,174,0.000333,0.345343,9,9324.271422,518.015079,1036.030158,315.273641,7,0
0,0,19,19,18,45,63,101,74,175,0.000333,0.348675,9,9414.21588,523.011993,1046.023987,322.192039,7,0
0,0,34,34,20,54,74,164,119,283,0.000333,0.585758,20,35145.50605,1952.528114,1757.275302,397.202487,12,0
0,0,24,24,18,49,67,131,96,227,0.000333,0.459001,9,12393.02022,688.501123,1377.002246,350.179432,9,0
0,0,24,24,19,51,70,132,97,229,0.000333,0.467869,9,12632.4523,701.802905,1403.605811,370.004315,9,0
0,0,22,22,18,48,66,123,85,208,0.000333,0.419078,9,11315.10579,628.616988,1257.233977,343.13685,9,0
0,0,10,10,13,14,27,34,25,59,0.000333,0.093513,6,1683.230176,93.512788,280.538363,101.408685,2,0
0,0,10,10,13,14,27,34,25,59,0.000333,0.093513,6,1683.230176,93.512788,280.538363,101.408685,2,0
0,0,22,22,18,48,66,123,85,208,0.000333,0.419078,9,11315.10579,628.616988,1257.233977,343.13685,9,0
0,0,22,22,19,47,66,124,84,208,0.000333,0.419078,9,11315.10579,628.616988,1257.233977,341.776299,9,0
0,0,10,10,13,14,27,34,25,59,0.000333,0.093513,6,1683.230176,93.512788,280.538363,101.408685,2,0
0,0,10,10,13,14,27,34,25,59,0.000333,0.093513,6,1683.230176,93.512788,280.538363,101.408685,2,0
0,0,13,13,15,21,36,51,37,88,0.000333,0.151651,7,3184.673801,176.926322,454.9534,150.842025,5,0
0,0,13,13,15,21,36,50,37,87,0.000333,0.149928,7,3148.484326,174.915796,449.783475,150.842025,5,0
0,0,15,15,13,21,34,54,39,93,0.000333,0.157711,6,2838.804265,157.711348,473.134044,140.344382,5,0
0,0,15,15,13,21,34,53,39,92,0.000333,0.156016,6,2808.279488,156.015527,468.046581,140.344382,5,0
0,0,33,33,19,53,72,157,113,270,0.000333,0.555293,18,29985.83551,1665.87975,1665.87975,384.290407,10,0
0,0,9,9,10,17,27,34,32,66,0.000333,0.104608,5,1569.112876,87.172938,313.822575,102.706149,1,0
0,0,15,15,13,23,36,52,47,99,0.000333,0.170608,12,6141.870902,341.21505,511.822575,152.147641,3,0
0,0,14,14,15,23,38,52,47,99,0.000333,0.173182,14,7273.627534,404.090419,519.544824,162.645284,4,0
0,0,8,8,12,16,28,36,29,65,0.000333,0.104159,6,1874.86842,104.159357,312.47807,107.01955,1,0
0,0,14,14,15,21,36,49,49,98,0.000333,0.168884,14,7093.137102,394.063172,506.65265,150.842025,1,0
0,0,28,28,20,48,68,145,92,237,0.000333,0.48091,10,14427.28693,801.515941,1442.728693,354.516762,11,0
0,0,28,28,21,47,68,146,91,237,0.000333,0.48091,10,14427.28693,801.515941,1442.728693,353.304342,11,0
0,0,28,28,21,47,68,146,91,237,0.000333,0.48091,10,14427.28693,801.515941,1442.728693,353.304342,11,0
0,0,16,16,14,25,39,54,46,100,0.000333,0.17618,7,3699.781553,205.54342,528.540222,169.399374,3,0
0,0,15,15,16,25,41,54,46,100,0.000333,0.178585,8,4286.041604,238.113422,535.7552,180.096405,4,0
0,0,21,21,18,46,64,110,80,190,0.000333,0.38,9,10260,570,1140,329.1425,7,0
0,0,8,8,12,15,27,34,29,63,0.000333,0.099853,6,1797.347476,99.852638,299.557913,101.622909,1,0
0,0,10,10,13,17,30,44,31,75,0.000333,0.122672,6,2208.100768,122.672265,368.016795,117.592585,3,0
0,0,10,10,15,18,33,46,33,79,0.000333,0.132836,7,2789.549948,154.974997,398.507135,133.662009,4,0
0,0,32,32,21,49,70,157,104,261,0.000333,0.533248,20,31994.85735,1777.492075,1599.742867,367.359448,11,0
0,0,16,16,14,20,34,56,45,101,0.000333,0.171278,14,7193.672458,399.64847,513.833747,139.741531,3,0
0,0,15,15,16,20,36,56,45,101,0.000333,0.174054,16,8354.598802,464.144378,522.162425,150.438562,4,0
0,0,10,10,13,14,27,34,25,59,0.000333,0.093513,6,1683.230176,93.512788,280.538363,101.408685,2,0
0,0,10,10,13,14,27,34,25,59,0.000333,0.093513,6,1683.230176,93.512788,280.538363,101.408685,2,0
0,0,22,22,19,47,66,113,82,195,0.000333,0.392886,9,10607.91168,589.328427,1178.656853,341.776299,8,0
0,0,22,22,18,47,65,112,91,203,0.000333,0.407514,9,11002.86599,611.270333,1222.540666,336.124326,8,0
0,0,10,10,14,14,28,35,26,61,0.000333,0.09775,7,2052.740552,114.041142,293.24865,106.605938,2,0
0,0,10,10,13,14,27,34,26,60,0.000333,0.095098,6,1711.759501,95.09775,285.29325,101.408685,2,0
0,0,21,21,18,46,64,109,87,196,0.000333,0.392,9,10584,588,1176,329.1425,7,0
0,0,27,27,20,46,66,136,88,224,0.000333,0.451315,10,13539.44283,752.191268,1353.944283,340.522412,10,0
0,0,14,14,15,20,35,53,43,96,0.000333,0.164137,14,6893.756375,382.986465,492.41117,145.041921,4,0
0,0,19,19,18,44,62,110,75,185,0.000333,0.367175,9,9913.736857,550.763159,1101.526317,315.273641,7,0
0,0,19,19,19,43,62,111,74,185,0.000333,0.367175,9,9913.736857,550.763159,1101.526317,314.040007,7,0
0,0,10,10,14,15,29,35,26,61,0.000333,0.098779,7,2074.357885,115.242105,296.336841,111.906328,2,0
0,0,10,10,13,15,28,34,26,60,0.000333,0.096147,6,1730.647772,96.147098,288.441295,106.709075,2,0
0,0,17,17,14,25,39,65,54,119,0.000333,0.209654,14,8805.480097,489.193339,628.962864,169.399374,3,0
0,0,36,36,23,62,85,168,127,295,0.000333,0.630257,22,41596.94718,2310.94151,1890.770326,473.202096,12,0
0,0,16,16,14,24,38,57,50,107,0.000333,0.187176,14,7861.395415,436.74419,561.528244,163.342069,3,0
0,0,35,35,23,61,84,160,123,283,0.000333,0.603009,22,39798.56827,2211.031571,1809.025831,465.816903,12,0
0,0,30,30,21,46,67,147,95,242,0.000333,0.489331,20,29359.87168,1631.103982,1467.993584,346.322516,10,0
0,0,34,34,22,49,71,154,101,255,0.000333,0.522729,22,34500.08134,1916.671186,1568.185515,373.228278,13,0
0,0,34,34,22,49,71,154,101,255,0.000333,0.522729,22,34500.08134,1916.671186,1568.185515,373.228278,13,0
0,0,54,54,22,50,72,267,177,444,0.000333,0.913149,33,90401.74112,5022.318951,2739.446701,380.300305,21,0
0,0,48,48,22,50,72,223,142,365,0.000333,0.750674,22,49544.49776,2752.472098,2252.022626,380.300305,18,0
0,0,19,19,18,45,63,101,74,175,0.000333,0.348675,9,9414.21588,523.011993,1046.023987,322.192039,7,0
0,0,32,32,21,49,70,150,98,248,0.000333,0.506687,20,30401.24376,1688.957987,1520.062188,367.359448,13,0
0,0,32,32,21,49,70,150,98,248,0.000333,0.506687,20,30401.24376,1688.957987,1520.062188,367.359448,13,0
0,0,32,32,22,49,71,150,98,248,0.000333,0.508379,22,33553.02028,1864.056682,1525.137286,373.228278,13,0
0,0,32,32,22,49,71,150,98,248,0.000333,0.508379,22,33553.02028,1864.056682,1525.137286,373.228278,13,0
0,0,32,32,21,48,69,150,98,248,0.000333,0.504971,20,30298.28131,1683.23785,1514.914065,360.316866,13,0
0,0,19,19,18,44,62,110,75,185,0.000333,0.367175,9,9913.736857,550.763159,1101.526317,315.273641,7,0
0,0,19,19,19,43,62,111,74,185,0.000333,0.367175,9,9913.736857,550.763159,1101.526317,314.040007,7,0
0,0,32,32,21,50,71,151,99,250,0.000333,0.512479,10,15374.3678,854.131544,1537.43678,374.431475,13,0
0,0,32,32,21,50,71,150,99,249,0.000333,0.510429,10,15312.87033,850.715018,1531.287033,374.431475,13,0
0,0,32,32,19,50,69,158,109,267,0.000333,0.543659,18,29357.56854,1630.97603,1630.97603,362.903432,11,0
0,0,31,31,21,48,69,147,97,244,0.000333,0.496827,20,29809.59935,1656.088853,1490.479967,360.316866,12,0
0,0,17,17,13,24,37,57,59,116,0.000333,0.201432,12,7251.559085,402.864394,604.29659,158.144816,3,0
0,0,16,16,15,24,39,57,59,116,0.000333,0.204369,14,8583.493203,476.860734,613.106657,168.642459,4,0
0,0,19,19,18,45,63,101,74,175,0.000333,0.348675,9,9414.21588,523.011993,1046.023987,322.192039,7,0
0,0,19,19,18,45,63,101,74,175,0.000333,0.348675,9,9414.21588,523.011993,1046.023987,322.192039,7,0
0,0,22,22,19,46,65,114,81,195,0.000333,0.391454,9,10569.25551,587.180862,1174.361724,334.794473,8,0
0,0,20,20,18,47,65,104,76,180,0.000333,0.361342,9,9756.235857,542.013103,1084.026206,336.124326,8,0
0,0,30,30,19,49,68,149,98,247,0.000333,0.501201,18,27064.85979,1503.603322,1503.603322,355.831405,11,0
0,0,21,21,21,46,67,110,81,191,0.000333,0.386208,10,11586.23035,643.679464,1158.623035,346.322516,8,0
0,0,13,13,12,19,31,44,42,86,0.000333,0.14202,12,5112.730592,284.040588,426.060883,123.730173,1,0
0,0,14,14,13,16,29,48,40,88,0.000333,0.142501,12,5130.027931,285.001552,427.502328,112.105716,1,0
0,0,14,14,13,21,34,46,41,87,0.000333,0.147536,6,2655.655603,147.536422,442.609267,140.344382,1,0
0,0,13,13,12,16,28,43,36,79,0.000333,0.126594,12,4557.372466,253.187359,379.781039,107.01955,1,0
0,0,15,15,14,17,31,51,45,96,0.000333,0.158534,14,6658.439841,369.913325,475.602846,122.789837,2,0
0,0,15,15,14,17,31,51,45,96,0.000333,0.158534,14,6658.439841,369.913325,475.602846,122.789837,2,0
0,0,15,15,14,20,34,50,51,101,0.000333,0.171278,14,7193.672458,399.64847,513.833747,139.741531,2,0
0,0,15,15,14,20,34,50,51,101,0.000333,0.171278,14,7193.672458,399.64847,513.833747,139.741531,2,0
0,0,13,13,15,20,35,52,36,88,0.000333,0.150459,7,3159.638338,175.535463,451.376905,145.041921,5,0
0,0,13,13,15,20,35,51,36,87,0.000333,0.148749,7,3123.733357,173.540742,446.247622,145.041921,5,0
0,0,14,14,16,20,36,54,41,95,0.000333,0.163714,16,7858.286002,436.571445,491.142875,150.438562,4,0
0,0,20,20,18,46,64,104,75,179,0.000333,0.358,9,9666,537,1074,329.1425,8,0
0,0,30,30,20,47,67,146,102,248,0.000333,0.501463,20,30087.80239,1671.544577,1504.390119,347.504238,10,0
0,0,15,15,15,22,37,58,41,99,0.000333,0.171912,7,3610.151182,200.563955,515.735883,156.710855,6,0
0,0,15,15,15,22,37,57,41,98,0.000333,0.170175,7,3573.685009,198.538056,510.52643,156.710855,6,0
0,0,15,15,13,21,34,54,39,93,0.000333,0.157711,6,2838.804265,157.711348,473.134044,140.344382,5,0
0,0,15,15,13,21,34,53,39,92,0.000333,0.156016,6,2808.279488,156.015527,468.046581,140.344382,5,0
0,0,33,33,19,52,71,166,111,277,0.000333,0.567827,18,30662.63914,1703.479952,1703.479952,377.133488,10,0
0,0,32,32,19,51,70,157,107,264,0.000333,0.539377,18,29126.3529,1618.130716,1618.130716,370.004315,10,0
0,0,27,27,19,46,65,136,89,225,0.000333,0.451678,9,12195.29482,677.516379,1355.032758,334.794473,9,0
0,0,37,37,19,53,72,169,134,303,0.000333,0.623162,18,33650.77096,1869.487275,1869.487275,384.290407,10,0
0,0,35,35,19,52,71,163,124,287,0.000333,0.588326,18,31769.59362,1764.977423,1764.977423,377.133488,10,0
0,0,30,30,19,49,68,148,100,248,0.000333,0.50323,18,27174.43412,1509.690785,1509.690785,355.831405,11,0
0,0,33,33,19,50,69,163,113,276,0.000333,0.561984,18,30347.1495,1685.95275,1685.95275,362.903432,11,0
0,0,11,11,13,21,34,44,35,79,0.000333,0.13397,6,2411.457387,133.969855,401.909564,140.344382,3,0
0,0,11,11,15,22,37,46,37,83,0.000333,0.144128,7,3026.692405,168.149578,432.384629,156.710855,4,0
0,0,32,32,21,49,70,150,98,248,0.000333,0.506687,20,30401.24376,1688.957987,1520.062188,367.359448,13,0
0,0,32,32,21,49,70,150,98,248,0.000333,0.506687,20,30401.24376,1688.957987,1520.062188,367.359448,13,0
0,0,26,26,19,44,63,133,86,219,0.000333,0.436341,9,11781.21873,654.512152,1309.024303,320.925614,9,0
0,0,30,30,19,50,69,148,102,250,0.000333,0.509044,18,27488.36006,1527.131114,1527.131114,362.903432,11,0
0,0,33,33,19,53,72,158,119,277,0.000333,0.56969,18,30763.24606,1709.069225,1709.069225,384.290407,11,0
0,0,29,29,20,46,66,143,101,244,0.000333,0.491611,20,29496.6433,1638.702406,1474.832165,340.522412,9,0
0,0,31,31,19,50,69,152,109,261,0.000333,0.531442,18,28697.8479,1594.324883,1594.324883,362.903432,11,0
0,0,16,16,12,22,34,57,52,109,0.000333,0.184844,12,6654.401396,369.688966,554.53345,141.127046,1,0
0,0,30,30,19,48,67,154,106,260,0.000333,0.525728,18,28389.29741,1577.18319,1577.18319,348.788823,9,0
0,0,29,29,19,47,66,145,102,247,0.000333,0.497655,18,26873.37626,1492.965347,1492.965347,341.776299,9,0
0,0,34,34,19,49,68,157,135,292,0.000333,0.592513,18,31995.70469,1777.53915,1777.53915,355.831405,9,0
0,0,29,29,20,46,66,143,101,244,0.000333,0.491611,20,29496.6433,1638.702406,1474.832165,340.522412,9,0
0,0,27,27,19,46,65,135,92,227,0.000333,0.455692,18,24607.39488,1367.077494,1367.077494,334.794473,9,0
0,0,27,27,19,46,65,136,89,225,0.000333,0.451678,9,12195.29482,677.516379,1355.032758,334.794473,9,0
0,0,30,30,19,47,66,145,111,256,0.000333,0.515788,18,27852.5681,1547.364895,1547.364895,341.776299,9,0
0,0,30,30,19,50,69,149,98,247,0.000333,0.502935,9,13579.24987,754.40277,1508.805541,362.903432,12,0
0,0,19,19,18,45,63,101,74,175,0.000333,0.348675,9,9414.21588,523.011993,1046.023987,322.192039,7,0
0,0,18,18,16,44,60,98,70,168,0.000333,0.330786,8,7938.86096,441.047831,992.35762,304.214991,7,0
0,0,27,27,19,44,63,136,87,223,0.000333,0.444311,9,11996.40081,666.466711,1332.933423,320.925614,10,0
0,0,13,13,15,16,31,48,37,85,0.000333,0.140369,14,5895.493609,327.527423,421.106686,122.603359,2,0
0,0,21,21,18,45,63,111,79,190,0.000333,0.378561,9,10221.14867,567.841593,1135.683185,322.192039,7,0
0,0,19,19,18,44,62,110,75,185,0.000333,0.367175,9,9913.736857,550.763159,1101.526317,315.273641,7,0
0,0,21,21,21,45,66,111,80,191,0.000333,0.384826,10,11544.79277,641.377376,1154.479277,339.372055,8,0
0,0,20,20,18,46,64,105,75,180,0.000333,0.36,9,9720,540,1080,329.1425,8,0
0,0,15,15,14,20,34,50,51,101,0.000333,0.171278,14,7193.672458,399.64847,513.833747,139.741531,2,0
0,0,15,15,14,20,34,50,51,101,0.000333,0.171278,14,7193.672458,399.64847,513.833747,139.741531,2,0
0,0,19,19,18,44,62,110,75,185,0.000333,0.367175,9,9913.736857,550.763159,1101.526317,315.273641,7,0
0,0,19,19,18,44,62,110,75,185,0.000333,0.367175,9,9913.736857,550.763159,1101.526317,315.273641,7,0
0,0,19,19,19,43,62,111,74,185,0.000333,0.367175,9,9913.736857,550.763159,1101.526317,314.040007,7,0
0,0,19,19,19,43,62,111,74,185,0.000333,0.367175,9,9913.736857,550.763159,1101.526317,314.040007,7,0
0,0,12,12,13,15,28,42,31,73,0.000333,0.116979,12,4211.242912,233.95794,350.936909,106.709075,2,0
0,0,12,12,14,17,31,43,32,75,0.000333,0.123855,7,2600.953063,144.497392,371.564723,122.789837,2,0
0,0,12,12,13,17,30,42,32,74,0.000333,0.121037,6,2178.659424,121.036635,363.109904,117.592585,2,0
0,0,19,19,18,44,62,101,73,174,0.000333,0.345343,9,9324.271422,518.015079,1036.030158,315.273641,7,0
0,0,19,19,18,44,62,101,73,174,0.000333,0.345343,9,9324.271422,518.015079,1036.030158,315.273641,7,0
0,0,27,27,19,45,64,136,87,223,0.000333,0.446,9,12042,669,1338,327.844012,10,0
0,0,29,29,21,45,66,141,90,231,0.000333,0.465418,20,27925.10083,1551.394491,1396.255042,339.372055,10,0
0,0,16,16,16,20,36,53,63,116,0.000333,0.199904,24,14393.0712,799.615067,599.7113,150.438562,1,0
0,0,13,13,12,16,28,43,36,79,0.000333,0.126594,12,4557.372466,253.187359,379.781039,107.01955,1,0
0,0,19,19,18,44,62,102,73,175,0.000333,0.347328,9,9377.859189,520.992177,1041.984354,315.273641,7,0
0,0,27,27,19,46,65,135,92,227,0.000333,0.455692,18,24607.39488,1367.077494,1367.077494,334.794473,9,0
0,0,27,27,19,46,65,136,89,225,0.000333,0.451678,9,12195.29482,677.516379,1355.032758,334.794473,9,0
0,0,29,29,21,46,67,144,95,239,0.000333,0.483265,20,28995.90633,1610.883685,1449.795317,346.322516,9,0
0,0,34,34,19,49,68,157,135,292,0.000333,0.592513,18,31995.70469,1777.53915,1777.53915,355.831405,9,0
0,0,19,19,18,44,62,102,73,175,0.000333,0.347328,9,9377.859189,520.992177,1041.984354,315.273641,7,0
0,0,30,30,19,47,66,145,111,256,0.000333,0.515788,18,27852.5681,1547.364895,1547.364895,341.776299,9,0
0,0,32,32,20,50,70,156,111,267,0.000333,0.545506,20,32730.37131,1818.353962,1636.518566,368.631371,11,0
0,0,22,22,19,46,65,114,81,195,0.000333,0.391454,9,10569.25551,587.180862,1174.361724,334.794473,8,0
0,0,30,30,19,50,69,148,102,250,0.000333,0.509044,18,27488.36006,1527.131114,1527.131114,362.903432,11,0
0,0,30,30,19,50,69,149,99,248,0.000333,0.504971,9,13634.22659,757.457033,1514.914065,362.903432,11,0
0,0,20,20,18,46,64,104,75,179,0.000333,0.358,9,9666,537,1074,329.1425,8,0
0,0,32,32,21,52,73,158,116,274,0.000333,0.565337,20,33920.23858,1884.457699,1696.011929,388.661531,11,0
0,0,22,22,19,45,64,108,77,185,0.000333,0.37,9,9990,555,1110,327.844012,8,0
0,0,20,20,18,45,63,104,74,178,0.000333,0.354652,9,9575.602437,531.977913,1063.955826,322.192039,8,0
0,0,20,20,18,44,62,104,74,178,0.000333,0.353282,9,9538.622489,529.923472,1059.846943,315.273641,8,0
0,0,20,20,19,45,64,104,74,178,0.000333,0.356,9,9612,534,1068,327.844012,8,0
0,0,30,30,19,51,70,149,99,248,0.000333,0.506687,9,13680.55969,760.031094,1520.062188,370.004315,12,0
0,0,16,16,14,24,38,55,45,100,0.000333,0.174931,7,3673.549259,204.08607,524.792751,163.342069,3,0
0,0,16,16,16,25,41,59,47,106,0.000333,0.1893,8,4543.2041,252.400228,567.900512,180.096405,4,0
0,0,19,19,18,44,62,110,75,185,0.000333,0.367175,9,9913.736857,550.763159,1101.526317,315.273641,7,0
0,0,19,19,19,43,62,111,74,185,0.000333,0.367175,9,9913.736857,550.763159,1101.526317,314.040007,7,0
0,0,16,16,15,21,36,61,49,110,0.000333,0.189564,14,7961.684502,442.315806,568.69175,150.842025,5,0
0,0,16,16,15,21,36,61,49,110,0.000333,0.189564,14,7961.684502,442.315806,568.69175,150.842025,5,0
0,0,16,16,13,20,33,57,44,101,0.000333,0.169828,12,6113.805673,339.655871,509.483806,134.544278,4,0
0,0,13,13,15,19,34,52,36,88,0.000333,0.149232,7,3133.87711,174.104284,447.69673,139.313982,4,0
0,0,13,13,13,18,31,48,34,82,0.000333,0.135415,6,2437.464585,135.414699,406.244097,123.164366,3,0
0,0,15,15,16,20,36,58,38,96,0.000333,0.165438,8,3970.502401,220.583467,496.3128,150.438562,6,0
0,0,15,15,14,19,33,54,36,90,0.000333,0.151332,7,3177.968295,176.553794,453.995471,134.013592,5,0
0,0,26,26,19,44,63,133,86,219,0.000333,0.436341,9,11781.21873,654.512152,1309.024303,320.925614,9,0
0,0,16,16,15,24,39,60,55,115,0.000333,0.202607,14,8509.497572,472.749865,607.821255,168.642459,5,0
0,0,16,16,15,24,39,60,55,115,0.000333,0.202607,14,8509.497572,472.749865,607.821255,168.642459,5,0
0,0,16,16,13,23,36,56,50,106,0.000333,0.182671,12,6576.144602,365.341367,548.01205,152.147641,4,0
0,0,11,11,12,15,27,39,30,69,0.000333,0.109362,12,3937.046852,218.724825,328.087238,101.622909,1,0
0,0,27,27,19,46,65,136,88,224,0.000333,0.44967,9,12141.09351,674.505195,1349.01039,334.794473,10,0
0,0,20,20,19,45,64,105,74,179,0.000333,0.358,9,9666,537,1074,327.844012,8,0
0,0,27,27,19,46,65,136,88,224,0.000333,0.44967,9,12141.09351,674.505195,1349.01039,334.794473,10,0
0,0,17,17,17,43,60,100,73,173,0.000333,0.340631,8,8175.136584,454.174255,1021.892073,302.816253,7,0
0,0,19,19,18,45,63,101,74,175,0.000333,0.348675,9,9414.21588,523.011993,1046.023987,322.192039,7,0
0,0,27,27,19,45,64,136,87,223,0.000333,0.446,9,12042,669,1338,327.844012,10,0
0,0,19,19,18,44,62,110,75,185,0.000333,0.367175,9,9913.736857,550.763159,1101.526317,315.273641,7,0
0,0,19,19,19,43,62,111,74,185,0.000333,0.367175,9,9913.736857,550.763159,1101.526317,314.040007,7,0
0,0,19,19,19,43,62,111,74,185,0.000333,0.367175,9,9913.736857,550.763159,1101.526317,314.040007,7,0
0,0,20,20,18,46,64,104,75,179,0.000333,0.358,9,9666,537,1074,329.1425,8,0
0,0,20,20,18,46,64,104,75,179,0.000333,0.358,9,9666,537,1074,329.1425,8,0
0,0,27,27,19,45,64,136,87,223,0.000333,0.446,9,12042,669,1338,327.844012,10,0
0,0,19,19,18,44,62,110,75,185,0.000333,0.367175,9,9913.736857,550.763159,1101.526317,315.273641,7,0
0,0,15,15,18,25,43,57,54,111,0.000333,0.200772,18,10841.67698,602.315388,602.315388,191.155055,4,0
0,0,16,16,16,25,41,57,54,111,0.000333,0.198229,16,9515.01236,528.611798,594.688273,180.096405,3,0
0,0,10,10,16,19,35,45,36,81,0.000333,0.138491,8,3323.775395,184.654189,415.471924,144.710623,4,0
0,0,10,10,14,18,32,43,34,77,0.000333,0.128333,7,2695,149.722222,385,128.361619,3,0
0,0,18,18,20,26,46,68,71,139,0.000333,0.255925,20,15355.50224,853.083458,767.775112,208.649995,4,0
0,0,18,18,17,24,41,61,68,129,0.000333,0.230375,16,11057.98734,614.33263,691.124209,179.525968,3,0
0,0,13,13,13,19,32,47,35,82,0.000333,0.136667,6,2460,136.666667,410,128.816339,3,0
0,0,32,32,23,56,79,150,108,258,0.000333,0.542125,11,17890.12976,993.896098,1626.375433,429.253801,12,0
0,0,10,10,15,21,36,47,36,83,0.000333,0.143035,7,3003.726426,166.87369,429.103775,150.842025,4,0
0,0,10,10,13,20,33,45,34,79,0.000333,0.132836,6,2391.042813,132.835712,398.507135,134.544278,3,0
0,0,13,13,13,16,29,46,36,82,0.000333,0.132785,12,4780.253299,265.569628,398.354442,112.105716,1,0
0,0,34,34,23,56,79,156,110,266,0.000333,0.558935,11,18444.86247,1024.714582,1676.805679,429.253801,14,0
0,0,34,34,23,56,79,156,110,266,0.000333,0.558935,11,18444.86247,1024.714582,1676.805679,429.253801,14,0
0,0,15,15,13,20,33,53,37,90,0.000333,0.151332,6,2723.972824,151.331824,453.995471,134.544278,5,0
0,0,15,15,13,20,33,53,37,90,0.000333,0.151332,6,2723.972824,151.331824,453.995471,134.544278,5,0
0,0,34,34,23,57,80,157,112,269,0.000333,0.566866,11,18706.58523,1039.254735,1700.598658,436.516656,14,0
0,0,34,34,23,57,80,156,112,268,0.000333,0.564759,11,18637.04402,1035.391335,1694.276729,436.516656,14,0
0,0,15,15,13,20,33,54,39,93,0.000333,0.156376,6,2814.771919,156.376218,469.128653,134.544278,5,0
0,0,15,15,13,20,33,53,39,92,0.000333,0.154695,6,2784.505554,154.694753,464.084259,134.544278,5,0
0,0,22,22,20,48,68,113,93,206,0.000333,0.418006,10,12540.17345,696.676303,1254.017345,354.516762,7,0
0,0,19,19,18,44,62,110,75,185,0.000333,0.367175,9,9913.736857,550.763159,1101.526317,315.273641,7,0
0,0,20,20,18,46,64,104,76,180,0.000333,0.36,9,9720,540,1080,329.1425,8,0
0,0,15,15,16,20,36,59,42,101,0.000333,0.174054,16,8354.598802,464.144378,522.162425,150.438562,4,0
0,0,28,28,19,46,65,139,99,238,0.000333,0.477775,18,25799.82371,1433.32354,1433.32354,334.794473,9,0
0,0,30,30,19,49,68,149,98,247,0.000333,0.501201,18,27064.85979,1503.603322,1503.603322,355.831405,12,0
0,0,32,32,21,51,72,158,112,270,0.000333,0.555293,20,33317.59501,1850.9775,1665.87975,381.532358,11,0
0,0,31,31,19,49,68,152,106,258,0.000333,0.523522,18,28270.17744,1570.565413,1570.565413,355.831405,11,0
0,0,31,31,19,52,71,153,104,257,0.000333,0.526828,18,28448.73018,1580.48501,1580.48501,377.133488,11,0
0,0,32,32,19,50,69,158,109,267,0.000333,0.543659,18,29357.56854,1630.97603,1630.97603,362.903432,11,0
0,0,32,32,19,48,67,151,123,274,0.000333,0.554036,18,29917.95189,1662.108438,1662.108438,348.788823,9,0
0,0,29,29,23,46,69,161,98,259,0.000333,0.527369,22,34806.37236,1933.687353,1582.107834,358.125775,11,0
0,0,26,26,19,45,64,133,87,220,0.000333,0.44,9,11880,660,1320,327.844012,9,0
0,0,17,17,16,21,37,56,65,121,0.000333,0.210115,24,15128.25257,840.458476,630.343857,156.238666,1,0
0,0,9,9,14,17,31,39,31,70,0.000333,0.115598,7,2427.556192,134.864233,346.793742,122.789837,1,0
0,0,15,15,16,22,38,52,51,103,0.000333,0.180179,16,8648.584542,480.476919,540.536534,162.107496,1,0
0,0,20,20,18,44,62,105,74,179,0.000333,0.355267,9,9592.210256,532.90057,1065.80114,315.273641,8,0
0,0,18,18,16,44,60,98,70,168,0.000333,0.330786,8,7938.86096,441.047831,992.35762,304.214991,7,0
0,0,29,29,21,45,66,141,90,231,0.000333,0.465418,20,27925.10083,1551.394491,1396.255042,339.372055,10,0
0,0,27,27,20,45,65,136,87,223,0.000333,0.447663,10,13429.88022,746.104457,1342.988022,333.571951,10,0
0,0,19,19,18,45,63,101,74,175,0.000333,0.348675,9,9414.21588,523.011993,1046.023987,322.192039,7,0
0,0,24,24,20,43,63,131,85,216,0.000333,0.430364,10,12910.92464,717.273591,1291.092463,319.767946,9,0
0,0,29,29,21,48,69,145,103,248,0.000333,0.504971,20,30298.28131,1683.23785,1514.914065,360.316866,9,0
0,0,26,26,19,45,64,133,87,220,0.000333,0.44,9,11880,660,1320,327.844012,9,0
0,0,27,27,19,46,65,136,88,224,0.000333,0.44967,9,12141.09351,674.505195,1349.01039,334.794473,10,0
0,0,29,29,23,46,69,161,98,259,0.000333,0.527369,22,34806.37236,1933.687353,1582.107834,358.125775,11,0
0,0,21,21,19,46,65,110,81,191,0.000333,0.383424,9,10352.45027,575.136126,1150.272252,334.794473,7,0
0,0,19,19,18,45,63,101,74,175,0.000333,0.348675,9,9414.21588,523.011993,1046.023987,322.192039,7,0
0,0,32,32,23,50,73,174,108,282,0.000333,0.581844,22,38401.67156,2133.426198,1745.530526,386.234734,13,0
0,0,19,19,18,45,63,101,74,175,0.000333,0.348675,9,9414.21588,523.011993,1046.023987,322.192039,7,0
0,0,18,18,16,44,60,98,70,168,0.000333,0.330786,8,7938.86096,441.047831,992.35762,304.214991,7,0
0,0,31,31,20,52,72,158,102,260,0.000333,0.534727,10,16041.805,891.211389,1604.1805,382.861427,13,0
0,0,31,31,21,51,72,159,101,260,0.000333,0.534727,10,16041.805,891.211389,1604.1805,381.532358,13,0
0,0,31,31,21,51,72,159,101,260,0.000333,0.534727,10,16041.805,891.211389,1604.1805,381.532358,13,0
0,0,29,29,21,46,67,145,91,236,0.000333,0.477199,10,14315.97049,795.331694,1431.597049,346.322516,10,0
0,0,35,35,23,50,73,192,119,311,0.000333,0.641678,22,42350.77963,2352.821091,1925.035438,386.234734,15,0
0,0,30,30,19,50,69,149,99,248,0.000333,0.504971,9,13634.22659,757.457033,1514.914065,362.903432,11,0
0,0,20,20,18,46,64,105,75,180,0.000333,0.36,9,9720,540,1080,329.1425,8,0
0,0,16,16,12,22,34,57,52,109,0.000333,0.184844,12,6654.401396,369.688966,554.53345,141.127046,1,0
0,0,16,16,13,22,35,51,55,106,0.000333,0.181235,12,6524.447998,362.469333,543.704,146.213212,1,0
0,0,12,12,14,17,31,43,32,75,0.000333,0.123855,7,2600.953063,144.497392,371.564723,122.789837,2,0
0,0,12,12,13,17,30,42,32,74,0.000333,0.121037,6,2178.659424,121.036635,363.109904,117.592585,2,0
0,0,14,14,14,16,30,47,34,81,0.000333,0.132486,14,5564.413935,309.134108,397.458138,117.302969,2,0
0,0,14,14,14,16,30,47,34,81,0.000333,0.132486,14,5564.413935,309.134108,397.458138,117.302969,2,0
0,0,14,14,13,19,32,47,44,91,0.000333,0.151667,12,5460,303.333333,455,128.816339,1,0
0,0,14,14,13,20,33,49,45,94,0.000333,0.158058,12,5690.076567,316.115365,474.173047,134.544278,1,0
0,0,15,15,13,21,34,57,49,106,0.000333,0.179757,12,6471.252734,359.514041,539.271061,140.344382,1,0
0,0,8,8,10,15,25,34,28,62,0.000333,0.095973,5,1439.595419,79.977523,287.919084,91.82264,1,0
0,0,15,15,14,20,34,54,41,95,0.000333,0.161103,14,6766.325579,375.906977,483.30897,139.741531,3,0
0,0,34,34,23,57,80,157,114,271,0.000333,0.571081,22,37691.3353,2093.963072,1713.242514,436.516656,12,0
0,0,35,35,23,61,84,158,127,285,0.000333,0.60727,22,40079.83024,2226.657236,1821.810465,465.816903,13,0
0,0,35,35,23,61,84,158,127,285,0.000333,0.60727,22,40079.83024,2226.657236,1821.810465,465.816903,13,0
0,0,16,16,13,24,37,55,51,106,0.000333,0.184067,12,6626.424681,368.134705,552.202057,158.144816,4,0
0,0,15,15,13,20,33,51,41,92,0.000333,0.154695,12,5569.011108,309.389506,464.084259,134.544278,3,0
0,0,34,34,23,57,80,154,114,268,0.000333,0.564759,22,37274.08805,2070.782669,1694.276729,436.516656,12,0
0,0,32,32,23,56,79,150,108,258,0.000333,0.542125,11,17890.12976,993.896098,1626.375433,429.253801,12,0
0,0,13,13,13,19,32,47,35,82,0.000333,0.136667,6,2460,136.666667,410,128.816339,3,0
0,0,35,35,23,58,81,159,121,280,0.000333,0.591719,22,39053.47602,2169.637557,1775.158001,443.804823,13,0
0,0,35,35,23,58,81,159,121,280,0.000333,0.591719,22,39053.47602,2169.637557,1775.158001,443.804823,13,0
0,0,16,16,13,21,34,56,45,101,0.000333,0.171278,12,6166.004964,342.555831,513.833747,140.344382,4,0
0,0,34,34,23,56,79,156,110,266,0.000333,0.558935,11,18444.86247,1024.714582,1676.805679,429.253801,14,0
0,0,15,15,14,20,34,53,37,90,0.000333,0.152624,7,3205.10159,178.061199,457.871656,139.741531,5,0
0,0,35,35,25,58,83,168,121,289,0.000333,0.614129,24,44217.2735,2456.515194,1842.386396,455.859302,14,0
0,0,16,16,16,23,39,65,48,113,0.000333,0.199083,16,9556.007212,530.88929,597.250451,168.041925,5,0
0,0,34,34,23,58,81,157,112,269,0.000333,0.568473,11,18759.61616,1042.200898,1705.419651,443.804823,14,0
0,0,34,34,23,58,81,156,112,268,0.000333,0.56636,11,18689.87781,1038.326545,1699.079801,443.804823,14,0
0,0,15,15,13,21,34,54,39,93,0.000333,0.157711,6,2838.804265,157.711348,473.134044,140.344382,5,0
0,0,15,15,13,21,34,53,39,92,0.000333,0.156016,6,2808.279488,156.015527,468.046581,140.344382,5,0
0,0,34,34,24,58,82,156,110,266,0.000333,0.563703,12,20293.306,1127.405889,1691.108833,449.801998,14,0
0,0,34,34,24,58,82,156,110,266,0.000333,0.563703,12,20293.306,1127.405889,1691.108833,449.801998,14,0
0,0,15,15,14,21,35,53,37,90,0.000333,0.153878,7,3231.448301,179.524906,461.635472,145.541635,5,0
0,0,15,15,14,21,35,53,37,90,0.000333,0.153878,7,3231.448301,179.524906,461.635472,145.541635,5,0
0,0,32,32,21,51,72,158,102,260,0.000333,0.534727,20,32083.61001,1782.422778,1604.1805,381.532358,12,0
0,0,31,31,20,51,71,158,101,259,0.000333,0.530928,10,15927.84504,884.88028,1592.784504,375.732254,13,0
0,0,31,31,21,50,71,159,100,259,0.000333,0.530928,20,31855.69008,1769.76056,1592.784504,374.431475,13,0
0,0,31,31,21,50,71,159,100,259,0.000333,0.530928,20,31855.69008,1769.76056,1592.784504,374.431475,13,0
0,0,33,33,20,51,71,159,112,271,0.000333,0.555527,20,33331.62939,1851.757188,1666.581469,375.732254,12,0
0,0,19,19,18,44,62,102,73,175,0.000333,0.347328,9,9377.859189,520.992177,1041.984354,315.273641,7,0
0,0,19,19,18,44,62,102,73,175,0.000333,0.347328,9,9377.859189,520.992177,1041.984354,315.273641,7,0
0,0,21,21,18,45,63,110,84,194,0.000333,0.386531,9,10436.33075,579.796153,1159.592305,322.192039,7,0
0,0,19,19,18,44,62,102,73,175,0.000333,0.347328,9,9377.859189,520.992177,1041.984354,315.273641,7,0
0,0,19,19,18,44,62,102,73,175,0.000333,0.347328,9,9377.859189,520.992177,1041.984354,315.273641,7,0
0,0,30,30,19,50,69,149,99,248,0.000333,0.504971,9,13634.22659,757.457033,1514.914065,362.903432,11,0
0,0,27,27,19,46,65,135,92,227,0.000333,0.455692,18,24607.39488,1367.077494,1367.077494,334.794473,9,0
0,0,30,30,19,47,66,150,106,256,0.000333,0.515788,18,27852.5681,1547.364895,1547.364895,341.776299,9,0
0,0,27,27,19,46,65,136,89,225,0.000333,0.451678,9,12195.29482,677.516379,1355.032758,334.794473,9,0
0,0,30,30,19,48,67,154,106,260,0.000333,0.525728,18,28389.29741,1577.18319,1577.18319,348.788823,9,0
0,0,29,29,19,47,66,145,102,247,0.000333,0.497655,18,26873.37626,1492.965347,1492.965347,341.776299,9,0
0,0,23,23,19,49,68,117,84,201,0.000333,0.40786,9,11012.22028,611.790016,1223.580031,355.831405,10,0
0,0,23,23,20,48,68,118,83,201,0.000333,0.40786,10,12235.80031,679.766684,1223.580031,354.516762,10,0
0,0,23,23,20,48,68,118,83,201,0.000333,0.40786,10,12235.80031,679.766684,1223.580031,354.516762,10,0
0,0,23,23,18,48,66,117,84,201,0.000333,0.404974,9,10934.30896,607.461609,1214.923218,343.13685,10,0
0,0,23,23,19,47,66,118,83,201,0.000333,0.404974,9,10934.30896,607.461609,1214.923218,341.776299,10,0
0,0,23,23,18,49,67,117,84,201,0.000333,0.406428,9,10973.55535,609.641964,1219.283927,350.179432,10,0
0,0,23,23,19,48,67,118,83,201,0.000333,0.406428,9,10973.55535,609.641964,1219.283927,348.788823,10,0
0,0,23,23,19,48,67,118,83,201,0.000333,0.406428,9,10973.55535,609.641964,1219.283927,348.788823,10,0
0,0,16,16,14,23,37,58,49,107,0.000333,0.185804,14,7803.761142,433.542286,557.41151,157.344894,3,0
0,0,32,32,23,56,79,148,112,260,0.000333,0.546328,22,36057.62588,2003.201438,1638.982995,429.253801,10,0
0,0,17,17,14,24,38,66,53,119,0.000333,0.208168,14,8743.047237,485.724847,624.503374,163.342069,3,0
0,0,33,33,23,57,80,156,116,272,0.000333,0.573188,22,37830.41772,2101.689873,1719.564442,436.516656,10,0
0,0,16,16,14,22,36,56,48,104,0.000333,0.179224,14,7527.410802,418.189489,537.6722,151.410465,3,0
0,0,32,32,24,55,79,146,111,257,0.000333,0.540024,24,38881.71966,2160.095536,1620.071652,428.013884,10,0
0,0,30,30,19,47,66,154,103,257,0.000333,0.517803,18,27961.3672,1553.409289,1553.409289,341.776299,9,0
0,0,19,19,13,24,37,63,70,133,0.000333,0.230952,12,8314.287572,461.904865,692.857298,158.144816,3,0
0,0,35,35,23,57,80,153,133,286,0.000333,0.60269,22,39777.57157,2209.865087,1808.071435,436.516656,10,0
0,0,16,16,12,21,33,59,68,127,0.000333,0.213546,18,11531.48496,640.638053,640.638053,135.258216,3,0
0,0,16,16,14,22,36,61,70,131,0.000333,0.225753,21,14222.46368,790.136871,677.260175,151.410465,4,0
0,0,15,15,13,22,35,53,46,99,0.000333,0.169266,12,6093.588224,338.532679,507.799019,146.213212,3,0
0,0,31,31,23,55,78,143,109,252,0.000333,0.527974,11,17423.13495,967.951942,1583.921359,422.016709,10,0
0,0,17,17,13,23,36,58,58,116,0.000333,0.199904,12,7196.535602,399.807533,599.7113,152.147641,3,0
0,0,33,33,23,56,79,148,121,269,0.000333,0.565239,22,37305.77447,2072.543026,1695.717021,429.253801,10,0
0,0,10,10,13,16,29,45,30,75,0.000333,0.12145,6,2186.091448,121.449525,364.348575,112.105716,3,0
0,0,10,10,15,17,32,47,32,79,0.000333,0.131667,7,2765,153.611111,395,128.090227,4,0
0,0,11,11,13,20,33,45,34,79,0.000333,0.132836,6,2391.042813,132.835712,398.507135,134.544278,3,0
0,0,11,11,15,21,36,47,36,83,0.000333,0.143035,7,3003.726426,166.87369,429.103775,150.842025,4,0
0,0,32,32,23,50,73,174,108,282,0.000333,0.581844,22,38401.67156,2133.426198,1745.530526,386.234734,13,0
0,0,27,27,19,46,65,136,88,224,0.000333,0.44967,9,12141.09351,674.505195,1349.01039,334.794473,10,0
0,0,34,34,23,51,74,181,118,299,0.000333,0.618876,22,40845.78424,2269.210236,1856.626556,393.335617,13,0
0,0,34,34,23,51,74,181,118,299,0.000333,0.618876,22,40845.78424,2269.210236,1856.626556,393.335617,13,0
0,0,29,29,20,45,65,140,90,230,0.000333,0.461715,20,27702.89194,1539.049552,1385.144597,333.571951,10,0
0,0,27,27,19,45,64,136,87,223,0.000333,0.446,9,12042,669,1338,327.844012,10,0
0,0,32,32,23,50,73,174,108,282,0.000333,0.581844,22,38401.67156,2133.426198,1745.530526,386.234734,13,0
0,0,32,32,20,50,70,156,111,267,0.000333,0.545506,20,32730.37131,1818.353962,1636.518566,368.631371,11,0
0,0,34,34,21,51,72,176,114,290,0.000333,0.596426,20,35785.56501,1988.086945,1789.27825,381.532358,13,0
0,0,34,34,23,54,77,180,122,302,0.000333,0.630857,22,41636.52978,2313.140543,1892.569535,414.80585,13,0
0,0,34,34,23,54,77,180,122,302,0.000333,0.630857,22,41636.52978,2313.140543,1892.569535,414.80585,13,0
0,0,34,34,23,51,74,180,114,294,0.000333,0.608526,22,40162.74437,2231.263576,1825.579289,393.335617,13,0
0,0,28,28,22,45,67,142,93,235,0.000333,0.475177,22,31361.68112,1742.315617,1425.53096,345.240885,10,0
0,0,27,27,19,44,63,136,87,223,0.000333,0.444311,9,11996.40081,666.466711,1332.933423,320.925614,10,0
0,0,19,19,18,44,62,101,73,174,0.000333,0.345343,9,9324.271422,518.015079,1036.030158,315.273641,7,0
0,0,18,18,16,43,59,98,69,167,0.000333,0.327467,8,7859.211114,436.62284,982.401389,297.329384,7,0
0,0,19,19,18,44,62,110,75,185,0.000333,0.367175,9,9913.736857,550.763159,1101.526317,315.273641,7,0
0,0,19,19,18,45,63,101,74,175,0.000333,0.348675,9,9414.21588,523.011993,1046.023987,322.192039,7,0
0,0,17,17,17,42,59,100,71,171,0.000333,0.335311,8,8047.455692,447.080872,1005.931961,295.9642,7,0
0,0,27,27,19,47,66,136,89,225,0.000333,0.45333,9,12239.89809,679.994338,1359.988677,341.776299,10,0
0,0,27,27,19,46,65,136,88,224,0.000333,0.44967,9,12141.09351,674.505195,1349.01039,334.794473,10,0
0,0,27,27,19,46,65,136,88,224,0.000333,0.44967,9,12141.09351,674.505195,1349.01039,334.794473,10,0
0,0,27,27,19,46,65,136,89,225,0.000333,0.451678,9,12195.29482,677.516379,1355.032758,334.794473,10,0
0,0,27,27,19,45,64,136,88,224,0.000333,0.448,9,12096,672,1344,327.844012,10,0
0,0,19,19,18,44,62,101,73,174,0.000333,0.345343,9,9324.271422,518.015079,1036.030158,315.273641,7,0
0,0,22,22,19,46,65,108,78,186,0.000333,0.373387,9,10081.44372,560.080207,1120.160413,334.794473,8,0
0,0,27,27,19,46,65,136,88,224,0.000333,0.44967,9,12141.09351,674.505195,1349.01039,334.794473,10,0
0,0,29,29,21,46,67,141,91,232,0.000333,0.469111,10,14073.32692,781.851496,1407.332692,346.322516,10,0
0,0,29,29,19,48,67,146,96,242,0.000333,0.489331,18,26423.88451,1467.993584,1467.993584,348.788823,11,0
0,0,32,32,21,51,72,158,112,270,0.000333,0.555293,20,33317.59501,1850.9775,1665.87975,381.532358,11,0
0,0,30,30,19,49,68,149,98,247,0.000333,0.501201,18,27064.85979,1503.603322,1503.603322,355.831405,12,0
0,0,30,30,19,48,67,149,97,246,0.000333,0.497419,18,26860.64294,1492.257941,1492.257941,348.788823,12,0
0,0,30,30,19,49,68,149,97,246,0.000333,0.499172,9,13477.64273,748.757929,1497.515859,355.831405,12,0
0,0,30,30,19,49,68,149,97,246,0.000333,0.499172,9,13477.64273,748.757929,1497.515859,355.831405,12,0
0,0,30,30,19,50,69,149,98,247,0.000333,0.502935,9,13579.24987,754.40277,1508.805541,362.903432,12,0
0,0,30,30,19,50,69,149,98,247,0.000333,0.502935,9,13579.24987,754.40277,1508.805541,362.903432,12,0
0,0,30,30,19,49,68,149,97,246,0.000333,0.499172,9,13477.64273,748.757929,1497.515859,355.831405,12,0
0,0,32,32,21,49,70,154,100,254,0.000333,0.518946,20,31136.75773,1729.819874,1556.837886,367.359448,12,0
0,0,30,30,19,49,68,148,100,248,0.000333,0.50323,18,27174.43412,1509.690785,1509.690785,355.831405,11,0
0,0,30,30,20,51,71,149,100,249,0.000333,0.510429,10,15312.87033,850.715018,1531.287033,375.732254,11,0
0,0,31,31,19,50,69,152,109,261,0.000333,0.531442,18,28697.8479,1594.324883,1594.324883,362.903432,11,0
0,0,33,33,19,51,70,163,116,279,0.000333,0.570023,18,30781.25931,1710.069962,1710.069962,370.004315,11,0
0,0,27,27,19,46,65,135,92,227,0.000333,0.455692,18,24607.39488,1367.077494,1367.077494,334.794473,9,0
0,0,27,27,19,47,66,136,89,225,0.000333,0.45333,9,12239.89809,679.994338,1359.988677,341.776299,10,0
0,0,26,26,19,45,64,133,87,220,0.000333,0.44,9,11880,660,1320,327.844012,9,0
0,0,30,30,20,50,70,155,100,255,0.000333,0.520989,20,31259.34339,1736.630188,1562.967169,368.631371,12,0
0,0,30,30,21,49,70,156,99,255,0.000333,0.520989,20,31259.34339,1736.630188,1562.967169,367.359448,12,0
0,0,19,19,18,44,62,110,75,185,0.000333,0.367175,9,9913.736857,550.763159,1101.526317,315.273641,7,0
0,0,33,33,19,51,70,158,121,279,0.000333,0.570023,18,30781.25931,1710.069962,1710.069962,370.004315,11,0
0,0,21,21,18,27,45,82,55,137,0.000333,0.250795,18,13542.90974,752.383874,752.383874,203.440613,7,0
0,0,21,21,18,26,44,82,55,137,0.000333,0.249314,18,13462.95837,747.942132,747.942132,197.270083,7,0
0,0,19,19,14,22,36,64,42,106,0.000333,0.182671,7,3836.084351,213.115797,548.01205,151.410465,5,0
0,0,19,19,14,21,35,64,42,106,0.000333,0.181235,14,7611.855997,422.880889,543.704,145.541635,5,0
0,0,17,17,17,25,42,72,49,121,0.000333,0.21749,8,5219.763265,289.986848,652.470408,185.583273,7,0
0,0,17,17,17,24,41,72,49,121,0.000333,0.216088,16,10372.22068,576.234482,648.263793,179.525968,7,0
0,0,15,15,13,20,33,54,36,90,0.000333,0.151332,6,2723.972824,151.331824,453.995471,134.544278,5,0
0,0,15,15,13,19,32,54,36,90,0.000333,0.15,6,2700,150,450,128.816339,5,0
0,0,32,32,19,47,66,151,116,267,0.000333,0.537951,18,29049.35814,1613.85323,1613.85323,341.776299,9,0
0,0,45,45,28,60,88,179,144,323,0.000333,0.695465,28,58419.09956,3245.505531,2086.396413,489.019374,12,0
0,0,18,18,17,23,40,62,67,129,0.000333,0.228843,16,10984.45959,610.247755,686.528724,173.528793,3,0
0,0,13,13,13,18,31,48,34,82,0.000333,0.135415,6,2437.464585,135.414699,406.244097,123.164366,3,0
0,0,15,15,17,23,40,66,47,113,0.000333,0.200459,16,9622.045996,534.558111,601.377875,173.528793,5,0
0,0,17,17,17,24,41,72,49,121,0.000333,0.216088,16,10372.22068,576.234482,648.263793,179.525968,7,0
0,0,17,17,17,24,41,72,49,121,0.000333,0.216088,16,10372.22068,576.234482,648.263793,179.525968,7,0
0,0,15,15,13,19,32,54,36,90,0.000333,0.15,6,2700,150,450,128.816339,5,0
0,0,15,15,13,19,32,54,36,90,0.000333,0.15,6,2700,150,450,128.816339,5,0
0,0,17,17,17,25,42,72,49,121,0.000333,0.21749,8,5219.763265,289.986848,652.470408,185.583273,7,0
0,0,17,17,17,24,41,72,49,121,0.000333,0.216088,16,10372.22068,576.234482,648.263793,179.525968,7,0
0,0,15,15,13,20,33,54,36,90,0.000333,0.151332,6,2723.972824,151.331824,453.995471,134.544278,5,0
0,0,15,15,13,19,32,54,36,90,0.000333,0.15,6,2700,150,450,128.816339,5,0
0,0,17,17,17,25,42,72,49,121,0.000333,0.21749,8,5219.763265,289.986848,652.470408,185.583273,7,0
0,0,17,17,17,24,41,72,49,121,0.000333,0.216088,16,10372.22068,576.234482,648.263793,179.525968,7,0
0,0,15,15,13,20,33,54,36,90,0.000333,0.151332,6,2723.972824,151.331824,453.995471,134.544278,5,0
0,0,15,15,13,19,32,54,36,90,0.000333,0.15,6,2700,150,450,128.816339,5,0
0,0,17,17,17,25,42,73,51,124,0.000333,0.222882,16,10698.35777,594.353209,668.64736,185.583273,7,0
0,0,17,17,17,25,42,72,51,123,0.000333,0.221085,16,10612.08069,589.560038,663.255043,185.583273,7,0
0,0,15,15,13,20,33,55,38,93,0.000333,0.156376,6,2814.771919,156.376218,469.128653,134.544278,5,0
0,0,15,15,13,20,33,54,38,92,0.000333,0.154695,6,2784.505554,154.694753,464.084259,134.544278,5,0
0,0,17,17,17,25,42,73,51,124,0.000333,0.222882,16,10698.35777,594.353209,668.64736,185.583273,7,0
0,0,17,17,17,25,42,72,51,123,0.000333,0.221085,16,10612.08069,589.560038,663.255043,185.583273,7,0
0,0,15,15,13,20,33,55,38,93,0.000333,0.156376,6,2814.771919,156.376218,469.128653,134.544278,5,0
0,0,15,15,13,20,33,54,38,92,0.000333,0.154695,6,2784.505554,154.694753,464.084259,134.544278,5,0
0,0,32,32,21,52,73,158,116,274,0.000333,0.565337,20,33920.23858,1884.457699,1696.011929,388.661531,11,0
0,0,31,31,21,47,68,163,104,267,0.000333,0.541784,20,32507.05157,1805.94731,1625.352579,353.304342,11,0
0,0,31,31,23,50,73,167,112,279,0.000333,0.575654,22,37993.14314,2110.730175,1726.961052,386.234734,11,0
0,0,31,31,23,50,73,167,112,279,0.000333,0.575654,22,37993.14314,2110.730175,1726.961052,386.234734,11,0
0,0,24,24,20,44,64,131,87,218,0.000333,0.436,10,13080,726.666667,1308,326.653553,9,0
0,0,31,31,23,55,78,143,100,243,0.000333,0.509118,11,16800.88013,933.38223,1527.352739,422.016709,12,0
0,0,31,31,23,54,77,143,100,243,0.000333,0.50761,11,16751.12042,930.617801,1522.829129,414.80585,12,0
0,0,15,15,13,21,34,53,37,90,0.000333,0.152624,6,2747.229934,152.623885,457.871656,140.344382,5,0
0,0,15,15,13,20,33,53,37,90,0.000333,0.151332,6,2723.972824,151.331824,453.995471,134.544278,5,0
0,0,16,16,12,22,34,57,52,109,0.000333,0.184844,12,6654.401396,369.688966,554.53345,141.127046,1,0
0,0,30,30,19,51,70,149,99,248,0.000333,0.506687,9,13680.55969,760.031094,1520.062188,370.004315,12,0
0,0,30,30,20,50,70,149,98,247,0.000333,0.504644,10,15139.32905,841.073836,1513.932905,368.631371,12,0
0,0,14,14,13,20,33,49,45,94,0.000333,0.158058,12,5690.076567,316.115365,474.173047,134.544278,1,0
0,0,30,30,19,50,69,149,98,247,0.000333,0.502935,9,13579.24987,754.40277,1508.805541,362.903432,12,0
0,0,32,32,20,50,70,153,101,254,0.000333,0.518946,20,31136.75773,1729.819874,1556.837886,368.631371,12,0
0,0,30,30,19,51,70,149,99,248,0.000333,0.506687,9,13680.55969,760.031094,1520.062188,370.004315,12,0
0,0,9,9,10,17,27,34,32,66,0.000333,0.104608,5,1569.112876,87.172938,313.822575,102.706149,1,0
0,0,30,30,19,51,70,149,99,248,0.000333,0.506687,9,13680.55969,760.031094,1520.062188,370.004315,12,0
0,0,32,32,21,51,72,158,112,270,0.000333,0.555293,20,33317.59501,1850.9775,1665.87975,381.532358,11,0
0,0,32,32,22,52,74,159,118,277,0.000333,0.57334,22,37840.40881,2102.244934,1720.018582,394.530361,11,0
0,0,21,21,19,45,64,119,82,201,0.000333,0.402,9,10854,603,1206,327.844012,7,0
0,0,21,21,19,44,63,120,83,203,0.000333,0.404463,9,10920.49042,606.693912,1213.387824,320.925614,7,0
0,0,29,29,23,46,69,161,98,259,0.000333,0.527369,22,34806.37236,1933.687353,1582.107834,358.125775,11,0
0,0,33,33,22,51,73,163,104,267,0.000333,0.550894,22,36359.02946,2019.946081,1652.683157,387.401188,13,0
0,0,33,33,22,50,72,164,103,267,0.000333,0.549123,22,36242.13946,2013.452192,1647.369975,380.300305,13,0
0,0,33,33,22,50,72,164,103,267,0.000333,0.549123,22,36242.13946,2013.452192,1647.369975,380.300305,13,0
0,0,21,21,19,45,64,110,80,190,0.000333,0.38,9,10260,570,1140,327.844012,7,0
0,0,27,27,20,47,67,144,95,239,0.000333,0.483265,20,28995.90633,1610.883685,1449.795317,347.504238,11,0
0,0,27,27,20,48,68,144,97,241,0.000333,0.489026,20,29341.5709,1630.087272,1467.078545,354.516762,11,0
0,0,19,19,18,44,62,110,75,185,0.000333,0.367175,9,9913.736857,550.763159,1101.526317,315.273641,7,0
0,0,22,22,19,46,65,113,81,194,0.000333,0.389446,9,10515.0542,584.169678,1168.339356,334.794473,8,0
0,0,30,30,20,47,67,146,105,251,0.000333,0.507529,20,30451.76774,1691.764874,1522.588387,347.504238,10,0
0,0,28,28,19,46,65,139,99,238,0.000333,0.477775,18,25799.82371,1433.32354,1433.32354,334.794473,9,0
0,0,32,32,23,46,69,179,109,288,0.000333,0.586418,22,38703.61096,2150.200609,1759.255044,358.125775,13,0
0,0,29,29,21,46,67,144,95,239,0.000333,0.483265,20,28995.90633,1610.883685,1449.795317,346.322516,9,0
0,0,19,19,18,45,63,101,74,175,0.000333,0.348675,9,9414.21588,523.011993,1046.023987,322.192039,7,0
0,0,30,30,19,49,68,149,98,247,0.000333,0.501201,18,27064.85979,1503.603322,1503.603322,355.831405,11,0
0,0,30,30,20,48,68,150,97,247,0.000333,0.501201,20,30072.06644,1670.670358,1503.603322,354.516762,11,0
0,0,31,31,23,54,77,144,102,246,0.000333,0.513876,11,16957.92438,942.10691,1541.629489,414.80585,12,0
0,0,31,31,23,54,77,143,102,245,0.000333,0.511788,11,16888.98973,938.277207,1535.362702,414.80585,12,0
0,0,15,15,13,20,33,54,39,93,0.000333,0.156376,6,2814.771919,156.376218,469.128653,134.544278,5,0
0,0,15,15,13,20,33,53,39,92,0.000333,0.154695,6,2784.505554,154.694753,464.084259,134.544278,5,0
0,0,31,31,23,53,76,143,100,243,0.000333,0.506082,11,16700.71024,927.817236,1518.246386,407.621709,12,0
0,0,31,31,23,53,76,143,100,243,0.000333,0.506082,11,16700.71024,927.817236,1518.246386,407.621709,12,0
0,0,15,15,13,20,33,53,37,90,0.000333,0.151332,6,2723.972824,151.331824,453.995471,134.544278,5,0
0,0,15,15,13,20,33,53,37,90,0.000333,0.151332,6,2723.972824,151.331824,453.995471,134.544278,5,0
0,0,30,30,19,49,68,148,100,248,0.000333,0.50323,18,27174.43412,1509.690785,1509.690785,355.831405,11,0
0,0,31,31,23,55,78,143,100,243,0.000333,0.509118,11,16800.88013,933.38223,1527.352739,422.016709,12,0
0,0,31,31,23,54,77,143,100,243,0.000333,0.50761,11,16751.12042,930.617801,1522.829129,414.80585,12,0
0,0,15,15,13,21,34,53,37,90,0.000333,0.152624,6,2747.229934,152.623885,457.871656,140.344382,5,0
0,0,15,15,13,20,33,53,37,90,0.000333,0.151332,6,2723.972824,151.331824,453.995471,134.544278,5,0
0,0,10,10,16,18,34,46,35,81,0.000333,0.137361,8,3296.675921,183.148662,412.08449,139.05865,4,0
0,0,10,10,14,17,31,44,33,77,0.000333,0.127158,7,2670.311811,148.350656,381.473116,122.789837,3,0
0,0,19,19,18,45,63,101,74,175,0.000333,0.348675,9,9414.21588,523.011993,1046.023987,322.192039,7,0
0,0,13,13,13,19,32,47,35,82,0.000333,0.136667,6,2460,136.666667,410,128.816339,3,0
0,0,29,29,23,53,76,137,98,235,0.000333,0.489421,11,16150.89262,897.271812,1468.262966,407.621709,10,0
0,0,18,18,19,24,43,66,69,135,0.000333,0.244182,18,13185.82335,732.545742,732.545742,190.749723,4,0
0,0,18,18,17,23,40,62,67,129,0.000333,0.228843,16,10984.45959,610.247755,686.528724,173.528793,3,0
0,0,32,32,19,49,68,158,104,262,0.000333,0.531638,18,28708.47476,1594.915264,1594.915264,355.831405,11,0
0,0,12,12,14,17,31,43,32,75,0.000333,0.123855,7,2600.953063,144.497392,371.564723,122.789837,2,0
0,0,12,12,13,17,30,42,32,74,0.000333,0.121037,6,2178.659424,121.036635,363.109904,117.592585,2,0
0,0,33,33,20,50,70,159,111,270,0.000333,0.551635,20,33098.12829,1838.784905,1654.906415,368.631371,12,0
0,0,26,26,19,45,64,133,87,220,0.000333,0.44,9,11880,660,1320,327.844012,9,0
0,0,19,19,18,45,63,101,74,175,0.000333,0.348675,9,9414.21588,523.011993,1046.023987,322.192039,7,0
0,0,30,30,20,47,67,146,105,251,0.000333,0.507529,20,30451.76774,1691.764874,1522.588387,347.504238,10,0
0,0,28,28,19,46,65,139,93,232,0.000333,0.46573,18,25149.40799,1397.189333,1397.189333,334.794473,9,0
0,0,29,29,19,46,65,145,95,240,0.000333,0.481789,18,26016.62895,1445.368275,1445.368275,334.794473,9,0
0,0,34,34,20,52,72,172,117,289,0.000333,0.594369,20,35662.16651,1981.231473,1783.108325,382.861427,12,0
0,0,34,34,21,54,75,173,118,291,0.000333,0.604195,20,36251.72478,2013.98471,1812.586239,403.002591,12,0
0,0,28,28,19,48,67,140,94,234,0.000333,0.473155,9,12775.18384,709.732435,1419.464871,348.788823,9,0
0,0,20,20,18,45,63,104,75,179,0.000333,0.356644,9,9629.397957,534.966553,1069.933106,322.192039,8,0
0,0,32,32,21,50,71,157,105,262,0.000333,0.537078,20,32224.67491,1790.259717,1611.233745,374.431475,11,0
0,0,19,19,18,44,62,102,73,175,0.000333,0.347328,9,9377.859189,520.992177,1041.984354,315.273641,7,0
0,0,21,21,18,45,63,119,81,200,0.000333,0.398485,9,10759.10386,597.727992,1195.455985,322.192039,7,0
0,0,21,21,19,44,63,120,80,200,0.000333,0.398485,9,10759.10386,597.727992,1195.455985,320.925614,7,0
0,0,19,19,18,44,62,102,73,175,0.000333,0.347328,9,9377.859189,520.992177,1041.984354,315.273641,7,0
0,0,31,31,23,47,70,167,104,271,0.000333,0.553679,22,36542.78535,2030.154742,1661.035698,365.107601,11,0
0,0,29,29,23,46,69,161,98,259,0.000333,0.527369,22,34806.37236,1933.687353,1582.107834,358.125775,11,0
0,0,19,19,18,44,62,110,75,185,0.000333,0.367175,9,9913.736857,550.763159,1101.526317,315.273641,7,0
0,0,19,19,19,43,62,111,74,185,0.000333,0.367175,9,9913.736857,550.763159,1101.526317,314.040007,7,0
0,0,19,19,19,43,62,111,74,185,0.000333,0.367175,9,9913.736857,550.763159,1101.526317,314.040007,7,0
0,0,19,19,18,44,62,110,75,185,0.000333,0.367175,9,9913.736857,550.763159,1101.526317,315.273641,7,0
0,0,19,19,18,44,62,102,73,175,0.000333,0.347328,9,9377.859189,520.992177,1041.984354,315.273641,7,0
0,0,19,19,18,44,62,110,75,185,0.000333,0.367175,9,9913.736857,550.763159,1101.526317,315.273641,7,0
0,0,19,19,19,43,62,111,74,185,0.000333,0.367175,9,9913.736857,550.763159,1101.526317,314.040007,7,0
0,0,19,19,19,43,62,111,74,185,0.000333,0.367175,9,9913.736857,550.763159,1101.526317,314.040007,7,0
0,0,19,19,18,44,62,110,75,185,0.000333,0.367175,9,9913.736857,550.763159,1101.526317,315.273641,7,0
0,0,19,19,19,43,62,111,74,185,0.000333,0.367175,9,9913.736857,550.763159,1101.526317,314.040007,7,0
0,0,20,20,18,45,63,104,74,178,0.000333,0.354652,9,9575.602437,531.977913,1063.955826,322.192039,8,0
0,0,12,12,13,16,29,42,31,73,0.000333,0.118211,6,2127.795676,118.210871,354.632613,112.105716,2,0
0,0,12,12,13,16,29,42,31,73,0.000333,0.118211,6,2127.795676,118.210871,354.632613,112.105716,2,0
0,0,9,9,10,17,27,34,32,66,0.000333,0.104608,5,1569.112876,87.172938,313.822575,102.706149,1,0
0,0,20,20,18,46,64,104,75,179,0.000333,0.358,9,9666,537,1074,329.1425,8,0
0,0,22,22,18,47,65,112,91,203,0.000333,0.407514,9,11002.86599,611.270333,1222.540666,336.124326,8,0
0,0,32,32,23,50,73,174,108,282,0.000333,0.581844,22,38401.67156,2133.426198,1745.530526,386.234734,13,0
0,0,8,8,12,16,28,36,29,65,0.000333,0.104159,6,1874.86842,104.159357,312.47807,107.01955,1,0
0,0,14,14,15,21,36,49,49,98,0.000333,0.168884,14,7093.137102,394.063172,506.65265,150.842025,1,0
0,0,8,8,12,15,27,34,29,63,0.000333,0.099853,6,1797.347476,99.852638,299.557913,101.622909,1,0
0,0,16,16,16,20,36,53,63,116,0.000333,0.199904,24,14393.0712,799.615067,599.7113,150.438562,1,0
0,0,11,11,12,15,27,39,30,69,0.000333,0.109362,12,3937.046852,218.724825,328.087238,101.622909,1,0
0,0,12,12,13,15,28,42,31,73,0.000333,0.116979,12,4211.242912,233.95794,350.936909,106.709075,2,0
0,0,12,12,13,15,28,42,31,73,0.000333,0.116979,12,4211.242912,233.95794,350.936909,106.709075,2,0
0,0,19,19,18,44,62,110,75,185,0.000333,0.367175,9,9913.736857,550.763159,1101.526317,315.273641,7,0
0,0,19,19,19,43,62,111,74,185,0.000333,0.367175,9,9913.736857,550.763159,1101.526317,314.040007,7,0
0,0,19,19,18,44,62,110,75,185,0.000333,0.367175,9,9913.736857,550.763159,1101.526317,315.273641,7,0
0,0,19,19,19,43,62,111,74,185,0.000333,0.367175,9,9913.736857,550.763159,1101.526317,314.040007,7,0
0,0,20,20,18,44,62,104,74,178,0.000333,0.353282,9,9538.622489,529.923472,1059.846943,315.273641,8,0
0,0,19,19,18,44,62,110,75,185,0.000333,0.367175,9,9913.736857,550.763159,1101.526317,315.273641,7,0
0,0,19,19,18,44,62,110,75,185,0.000333,0.367175,9,9913.736857,550.763159,1101.526317,315.273641,7,0
0,0,19,19,19,43,62,111,74,185,0.000333,0.367175,9,9913.736857,550.763159,1101.526317,314.040007,7,0
0,0,19,19,18,44,62,110,75,185,0.000333,0.367175,9,9913.736857,550.763159,1101.526317,315.273641,7,0
0,0,19,19,19,43,62,111,74,185,0.000333,0.367175,9,9913.736857,550.763159,1101.526317,314.040007,7,0
0,0,26,26,19,45,64,133,87,220,0.000333,0.44,9,11880,660,1320,327.844012,9,0
0,0,29,29,21,48,69,145,106,251,0.000333,0.51108,20,30664.79277,1703.599599,1533.239639,360.316866,9,0
0,0,27,27,19,45,64,136,88,224,0.000333,0.448,9,12096,672,1344,327.844012,10,0
0,0,16,16,16,20,36,61,46,107,0.000333,0.184394,16,8850.911602,491.717311,553.181975,150.438562,4,0
0,0,27,27,19,45,64,136,88,224,0.000333,0.448,9,12096,672,1344,327.844012,10,0
0,0,27,27,19,46,65,136,88,224,0.000333,0.44967,9,12141.09351,674.505195,1349.01039,334.794473,10,0
0,0,30,30,19,49,68,145,109,254,0.000333,0.515405,18,27831.88011,1546.215562,1546.215562,355.831405,9,0
0,0,29,29,21,48,69,145,106,251,0.000333,0.51108,20,30664.79277,1703.599599,1533.239639,360.316866,9,0
0,0,31,31,20,52,72,158,102,260,0.000333,0.534727,10,16041.805,891.211389,1604.1805,382.861427,13,0
0,0,31,31,21,51,72,159,101,260,0.000333,0.534727,10,16041.805,891.211389,1604.1805,381.532358,13,0
0,0,31,31,21,51,72,159,101,260,0.000333,0.534727,10,16041.805,891.211389,1604.1805,381.532358,13,0
0,0,16,16,16,23,39,60,50,110,0.000333,0.193798,16,9302.307905,516.794884,581.394244,168.041925,4,0
0,0,19,19,13,24,37,63,70,133,0.000333,0.230952,12,8314.287572,461.904865,692.857298,158.144816,3,0
0,0,19,19,15,25,40,67,72,139,0.000333,0.246583,14,10356.47207,575.35956,739.748005,174.699764,4,0
0,0,17,17,13,23,36,58,58,116,0.000333,0.199904,12,7196.535602,399.807533,599.7113,152.147641,3,0
0,0,17,17,15,24,39,62,60,122,0.000333,0.21494,14,9027.46699,501.525944,644.819071,168.642459,4,0
0,0,11,11,13,20,33,45,34,79,0.000333,0.132836,6,2391.042813,132.835712,398.507135,134.544278,3,0
0,0,11,11,15,21,36,47,36,83,0.000333,0.143035,7,3003.726426,166.87369,429.103775,150.842025,4,0
0,0,16,16,18,25,43,62,55,117,0.000333,0.211624,18,11427.71357,634.872976,634.872976,191.155055,4,0
0,0,16,16,16,24,40,58,53,111,0.000333,0.196911,16,9451.744297,525.096905,590.734019,174.0391,3,0
0,0,35,35,19,51,70,164,126,290,0.000333,0.592497,18,31994.85735,1777.492075,1777.492075,370.004315,11,0
0,0,37,37,19,52,71,170,136,306,0.000333,0.627274,18,33872.80713,1881.822619,1881.822619,377.133488,11,0
0,0,32,32,20,49,69,156,108,264,0.000333,0.53755,20,32253.00913,1791.833841,1612.650457,361.559344,11,0
0,0,33,33,19,50,69,158,116,274,0.000333,0.557912,18,30127.24262,1673.735701,1673.735701,362.903432,11,0
0,0,27,27,19,46,65,136,89,225,0.000333,0.451678,9,12195.29482,677.516379,1355.032758,334.794473,10,0
0,0,31,31,22,50,72,155,104,259,0.000333,0.53267,22,35156.23266,1953.124037,1598.010575,380.300305,12,0
0,0,22,22,19,45,64,109,77,186,0.000333,0.372,9,10044,558,1116,327.844012,8,0
0,0,20,20,18,45,63,105,74,179,0.000333,0.356644,9,9629.397957,534.966553,1069.933106,322.192039,8,0
0,0,32,32,21,51,72,158,102,260,0.000333,0.534727,20,32083.61001,1782.422778,1604.1805,381.532358,12,0
0,0,18,18,20,29,49,76,66,142,0.000333,0.265763,20,15945.77596,885.876442,797.288798,227.320011,5,0
0,0,16,16,16,24,40,58,53,111,0.000333,0.196911,16,9451.744297,525.096905,590.734019,174.0391,3,0
0,0,32,32,21,50,71,154,101,255,0.000333,0.522729,20,31363.71031,1742.428351,1568.185515,374.431475,12,0
0,0,30,30,19,50,69,149,98,247,0.000333,0.502935,9,13579.24987,754.40277,1508.805541,362.903432,12,0
0,0,20,20,18,45,63,104,74,178,0.000333,0.354652,9,9575.602437,531.977913,1063.955826,322.192039,8,0
0,0,20,20,19,44,63,105,73,178,0.000333,0.354652,9,9575.602437,531.977913,1063.955826,320.925614,8,0
0,0,20,20,19,44,63,105,73,178,0.000333,0.354652,9,9575.602437,531.977913,1063.955826,320.925614,8,0
0,0,20,20,18,46,64,104,75,179,0.000333,0.358,9,9666,537,1074,329.1425,8,0
0,0,20,20,19,45,64,105,74,179,0.000333,0.358,9,9666,537,1074,327.844012,8,0
0,0,20,20,19,45,64,105,74,179,0.000333,0.358,9,9666,537,1074,327.844012,8,0
0,0,19,19,18,45,63,101,74,175,0.000333,0.348675,9,9414.21588,523.011993,1046.023987,322.192039,7,0
0,0,19,19,18,45,63,101,74,175,0.000333,0.348675,9,9414.21588,523.011993,1046.023987,322.192039,7,0
0,0,18,18,16,44,60,98,70,168,0.000333,0.330786,8,7938.86096,441.047831,992.35762,304.214991,7,0
0,0,19,19,18,45,63,101,74,175,0.000333,0.348675,9,9414.21588,523.011993,1046.023987,322.192039,7,0
0,0,21,21,18,46,64,109,87,196,0.000333,0.392,9,10584,588,1176,329.1425,7,0
0,0,19,19,18,45,63,101,74,175,0.000333,0.348675,9,9414.21588,523.011993,1046.023987,322.192039,7,0
0,0,19,19,18,45,63,101,74,175,0.000333,0.348675,9,9414.21588,523.011993,1046.023987,322.192039,7,0
0,0,19,19,18,45,63,101,74,175,0.000333,0.348675,9,9414.21588,523.011993,1046.023987,322.192039,7,0
0,0,19,19,18,45,63,101,74,175,0.000333,0.348675,9,9414.21588,523.011993,1046.023987,322.192039,7,0
0,0,31,31,19,49,68,152,102,254,0.000333,0.515405,18,27831.88011,1546.215562,1546.215562,355.831405,11,0
0,0,14,14,13,19,32,47,44,91,0.000333,0.151667,12,5460,303.333333,455,128.816339,1,0
0,0,10,10,15,20,35,48,35,83,0.000333,0.14191,7,2980.113433,165.561857,425.73049,145.041921,4,0
0,0,10,10,13,19,32,46,33,79,0.000333,0.131667,6,2370,131.666667,395,128.816339,3,0
0,0,13,13,12,19,31,44,42,86,0.000333,0.14202,12,5112.730592,284.040588,426.060883,123.730173,1,0
0,0,14,14,13,16,29,48,40,88,0.000333,0.142501,12,5130.027931,285.001552,427.502328,112.105716,1,0
0,0,8,8,11,13,24,35,26,61,0.000333,0.093228,10,2796.827125,155.379285,279.682713,86.159464,1,0
0,0,9,9,11,17,28,35,30,65,0.000333,0.104159,5,1562.39035,86.799464,312.47807,107.540616,1,0
0,0,30,30,20,50,70,149,98,247,0.000333,0.504644,10,15139.32905,841.073836,1513.932905,368.631371,12,0
0,0,15,15,12,20,32,49,54,103,0.000333,0.171667,12,6180,343.333333,515,129.458112,1,0
0,0,17,17,12,21,33,54,66,120,0.000333,0.201776,18,10895.8913,605.327294,605.327294,135.258216,1,0
0,0,20,20,19,45,64,104,74,178,0.000333,0.356,9,9612,534,1068,327.844012,8,0
0,0,20,20,20,44,64,105,73,178,0.000333,0.356,10,10680,593.333333,1068,326.653553,8,0
0,0,20,20,20,44,64,105,73,178,0.000333,0.356,10,10680,593.333333,1068,326.653553,8,0
0,0,16,16,13,22,35,51,55,106,0.000333,0.181235,12,6524.447998,362.469333,543.704,146.213212,1,0
0,0,16,16,12,22,34,57,52,109,0.000333,0.184844,12,6654.401396,369.688966,554.53345,141.127046,1,0
0,0,14,14,15,21,36,49,49,98,0.000333,0.168884,14,7093.137102,394.063172,506.65265,150.842025,1,0
0,0,8,8,12,16,28,36,29,65,0.000333,0.104159,6,1874.86842,104.159357,312.47807,107.01955,1,0
0,0,19,19,18,44,62,101,73,174,0.000333,0.345343,9,9324.271422,518.015079,1036.030158,315.273641,7,0
0,0,19,19,19,43,62,102,72,174,0.000333,0.345343,9,9324.271422,518.015079,1036.030158,314.040007,7,0
0,0,19,19,19,43,62,102,72,174,0.000333,0.345343,9,9324.271422,518.015079,1036.030158,314.040007,7,0
0,0,19,19,18,44,62,101,73,174,0.000333,0.345343,9,9324.271422,518.015079,1036.030158,315.273641,7,0
0,0,19,19,19,43,62,102,72,174,0.000333,0.345343,9,9324.271422,518.015079,1036.030158,314.040007,7,0
0,0,19,19,19,43,62,102,72,174,0.000333,0.345343,9,9324.271422,518.015079,1036.030158,314.040007,7,0
0,0,18,18,15,26,41,65,57,122,0.000333,0.217874,14,9150.698824,508.372157,653.621345,180.814792,3,0
0,0,34,34,23,59,82,155,120,275,0.000333,0.582776,22,38463.18963,2136.843868,1748.326801,451.117865,10,0
0,0,31,31,20,50,70,151,109,260,0.000333,0.531205,20,31872.27169,1770.68176,1593.613584,368.631371,10,0
0,0,11,11,12,21,33,43,37,80,0.000333,0.134517,6,2421.309177,134.517177,403.55153,135.258216,3,0
0,0,11,11,14,22,36,45,39,84,0.000333,0.144758,7,3039.915901,168.884217,434.2737,151.410465,4,0
0,0,18,18,14,26,40,59,60,119,0.000333,0.211103,14,8866.332206,492.574011,633.309443,175.514402,3,0
0,0,34,34,23,60,83,149,123,272,0.000333,0.578004,22,38148.23596,2119.346442,1734.010725,458.455361,10,0
0,0,27,27,19,46,65,135,91,226,0.000333,0.453685,9,12249.49613,680.527563,1361.055126,334.794473,9,0
0,0,20,20,18,46,64,104,76,180,0.000333,0.36,9,9720,540,1080,329.1425,8,0
0,0,30,30,19,50,69,149,98,247,0.000333,0.502935,9,13579.24987,754.40277,1508.805541,362.903432,12,0
0,0,30,30,20,49,69,149,97,246,0.000333,0.500899,10,15026.97016,834.831676,1502.697016,361.559344,12,0
0,0,17,17,17,43,60,100,73,173,0.000333,0.340631,8,8175.136584,454.174255,1021.892073,302.816253,7,0
0,0,30,30,19,49,68,149,97,246,0.000333,0.499172,9,13477.64273,748.757929,1497.515859,355.831405,12,0
0,0,32,32,20,49,69,153,100,253,0.000333,0.515152,20,30909.13375,1717.174097,1545.456688,361.559344,12,0
0,0,21,21,22,29,51,84,82,166,0.000333,0.313874,22,20715.69735,1150.872075,941.622607,238.988944,5,0
0,0,18,18,17,23,40,62,67,129,0.000333,0.228843,16,10984.45959,610.247755,686.528724,173.528793,3,0
0,0,30,30,19,49,68,149,97,246,0.000333,0.499172,9,13477.64273,748.757929,1497.515859,355.831405,12,0
0,0,19,19,18,44,62,101,73,174,0.000333,0.345343,9,9324.271422,518.015079,1036.030158,315.273641,7,0
0,0,18,18,16,43,59,98,69,167,0.000333,0.327467,8,7859.211114,436.62284,982.401389,297.329384,7,0
0,0,19,19,18,44,62,101,73,174,0.000333,0.345343,9,9324.271422,518.015079,1036.030158,315.273641,7,0
0,0,19,19,18,44,62,101,73,174,0.000333,0.345343,9,9324.271422,518.015079,1036.030158,315.273641,7,0
0,0,19,19,18,44,62,101,73,174,0.000333,0.345343,9,9324.271422,518.015079,1036.030158,315.273641,7,0
0,0,9,9,14,17,31,39,31,70,0.000333,0.115598,7,2427.556192,134.864233,346.793742,122.789837,1,0
0,0,21,21,18,45,63,109,84,193,0.000333,0.384538,9,10382.53523,576.807513,1153.615025,322.192039,7,0
0,0,19,19,18,44,62,101,73,174,0.000333,0.345343,9,9324.271422,518.015079,1036.030158,315.273641,7,0
0,0,19,19,18,44,62,101,73,174,0.000333,0.345343,9,9324.271422,518.015079,1036.030158,315.273641,7,0
0,0,30,30,19,47,66,150,106,256,0.000333,0.515788,18,27852.5681,1547.364895,1547.364895,341.776299,9,0
0,0,20,20,18,45,63,104,74,178,0.000333,0.354652,9,9575.602437,531.977913,1063.955826,322.192039,8,0
0,0,20,20,19,44,63,105,73,178,0.000333,0.354652,9,9575.602437,531.977913,1063.955826,320.925614,8,0
0,0,20,20,19,44,63,105,73,178,0.000333,0.354652,9,9575.602437,531.977913,1063.955826,320.925614,8,0
0,0,9,9,13,14,27,29,23,52,0.000333,0.082418,6,1483.524901,82.41805,247.25415,101.408685,2,0
0,0,10,10,13,16,29,33,27,60,0.000333,0.09716,6,1748.873158,97.15962,291.47886,112.105716,2,0
0,0,20,20,18,47,65,104,76,180,0.000333,0.361342,9,9756.235857,542.013103,1084.026206,336.124326,8,0
0,0,20,20,18,45,63,104,75,179,0.000333,0.356644,9,9629.397957,534.966553,1069.933106,322.192039,8,0
0,0,20,20,18,46,64,104,76,180,0.000333,0.36,9,9720,540,1080,329.1425,8,0
0,0,11,11,15,18,33,39,32,71,0.000333,0.119384,7,2507.063877,139.281327,358.151982,133.662009,2,0
0,0,9,9,12,14,26,30,25,55,0.000333,0.086175,6,1551.145107,86.174728,258.524184,96.322519,1,0
0,0,10,10,13,15,28,33,26,59,0.000333,0.094545,6,1701.803642,94.544647,283.63394,106.709075,2,0
0,0,10,10,13,15,28,33,26,59,0.000333,0.094545,6,1701.803642,94.544647,283.63394,106.709075,2,0
0,0,10,10,13,15,28,33,26,59,0.000333,0.094545,6,1701.803642,94.544647,283.63394,106.709075,2,0
0,0,9,9,13,14,27,29,23,52,0.000333,0.082418,6,1483.524901,82.41805,247.25415,101.408685,2,0
0,0,10,10,13,16,29,33,27,60,0.000333,0.09716,6,1748.873158,97.15962,291.47886,112.105716,2,0
0,0,12,12,14,17,31,43,32,75,0.000333,0.123855,7,2600.953063,144.497392,371.564723,122.789837,2,0
0,0,12,12,13,17,30,42,32,74,0.000333,0.121037,6,2178.659424,121.036635,363.109904,117.592585,2,0
0,0,12,12,14,17,31,43,32,75,0.000333,0.123855,7,2600.953063,144.497392,371.564723,122.789837,2,0
0,0,12,12,13,17,30,42,32,74,0.000333,0.121037,6,2178.659424,121.036635,363.109904,117.592585,2,0
0,0,15,15,14,18,32,53,37,90,0.000333,0.15,14,6300,350,450,128.361619,2,0
0,0,12,12,13,16,29,42,31,73,0.000333,0.118211,6,2127.795676,118.210871,354.632613,112.105716,2,0
0,0,12,12,13,16,29,42,31,73,0.000333,0.118211,6,2127.795676,118.210871,354.632613,112.105716,2,0
0,0,15,15,13,20,33,51,41,92,0.000333,0.154695,12,5569.011108,309.389506,464.084259,134.544278,3,0
0,0,31,31,23,54,77,141,104,245,0.000333,0.511788,11,16888.98973,938.277207,1535.362702,414.80585,10,0
0,0,32,32,23,58,81,145,117,262,0.000333,0.55368,22,36542.89542,2030.160856,1661.040701,443.804823,11,0
0,0,32,32,23,58,81,145,117,262,0.000333,0.55368,22,36542.89542,2030.160856,1661.040701,443.804823,11,0
0,0,16,16,13,24,37,55,51,106,0.000333,0.184067,12,6626.424681,368.134705,552.202057,158.144816,4,0
0,0,32,32,23,55,78,146,111,257,0.000333,0.538449,22,35537.66415,1974.314675,1615.34837,422.016709,11,0
0,0,32,32,23,55,78,146,111,257,0.000333,0.538449,22,35537.66415,1974.314675,1615.34837,422.016709,11,0
0,0,16,16,13,21,34,56,45,101,0.000333,0.171278,12,6166.004964,342.555831,513.833747,140.344382,4,0
0,0,15,15,13,20,33,53,43,96,0.000333,0.161421,12,5811.142026,322.841224,484.261835,134.544278,3,0
0,0,31,31,23,54,77,143,106,249,0.000333,0.520143,11,17164.72834,953.596019,1560.429849,414.80585,10,0
0,0,15,15,14,20,34,54,41,95,0.000333,0.161103,14,6766.325579,375.906977,483.30897,139.741531,3,0
0,0,31,31,23,54,77,144,104,248,0.000333,0.518054,11,17095.79368,949.766316,1554.163062,414.80585,10,0
0,0,16,16,14,24,38,55,45,100,0.000333,0.174931,7,3673.549259,204.08607,524.792751,163.342069,3,0
0,0,32,32,23,57,80,145,108,253,0.000333,0.533149,11,17593.92589,977.440327,1599.447808,436.516656,10,0
0,0,29,29,21,47,68,145,92,237,0.000333,0.48091,10,14427.28693,801.515941,1442.728693,353.304342,10,0
0,0,27,27,19,47,66,136,89,225,0.000333,0.45333,9,12239.89809,679.994338,1359.988677,341.776299,10,0
0,0,27,27,19,46,65,136,88,224,0.000333,0.44967,9,12141.09351,674.505195,1349.01039,334.794473,10,0
0,0,29,29,20,46,66,140,91,231,0.000333,0.465418,10,13962.55042,775.697245,1396.255042,340.522412,10,0
0,0,29,29,21,46,67,141,91,232,0.000333,0.469111,10,14073.32692,781.851496,1407.332692,346.322516,10,0
0,0,27,27,19,46,65,136,88,224,0.000333,0.44967,9,12141.09351,674.505195,1349.01039,334.794473,10,0
0,0,27,27,19,47,66,136,89,225,0.000333,0.45333,9,12239.89809,679.994338,1359.988677,341.776299,10,0
0,0,27,27,19,47,66,136,89,225,0.000333,0.45333,9,12239.89809,679.994338,1359.988677,341.776299,10,0
0,0,27,27,19,46,65,136,88,224,0.000333,0.44967,9,12141.09351,674.505195,1349.01039,334.794473,10,0
0,0,27,27,19,46,65,136,88,224,0.000333,0.44967,9,12141.09351,674.505195,1349.01039,334.794473,10,0
0,0,33,33,19,52,71,167,116,283,0.000333,0.580126,18,31326.81183,1740.378435,1740.378435,377.133488,11,0
0,0,37,37,19,53,72,170,145,315,0.000333,0.647842,18,34983.47476,1943.526375,1943.526375,384.290407,11,0
0,0,30,30,19,50,69,149,99,248,0.000333,0.504971,9,13634.22659,757.457033,1514.914065,362.903432,11,0
0,0,33,33,19,51,70,158,121,279,0.000333,0.570023,18,30781.25931,1710.069962,1710.069962,370.004315,11,0
0,0,32,32,21,49,70,154,100,254,0.000333,0.518946,20,31136.75773,1729.819874,1556.837886,367.359448,12,0
0,0,30,30,19,50,69,148,102,250,0.000333,0.509044,18,27488.36006,1527.131114,1527.131114,362.903432,11,0
0,0,30,30,19,50,69,149,99,248,0.000333,0.504971,9,13634.22659,757.457033,1514.914065,362.903432,11,0
0,0,33,33,19,52,71,167,116,283,0.000333,0.580126,18,31326.81183,1740.378435,1740.378435,377.133488,11,0
0,0,32,32,19,51,70,158,112,270,0.000333,0.551635,18,29788.31546,1654.906415,1654.906415,370.004315,11,0
0,0,15,15,14,19,33,55,40,95,0.000333,0.159739,14,6709.044179,372.724677,479.217441,134.013592,3,0
0,0,17,17,18,24,42,73,53,126,0.000333,0.226477,18,12229.77592,679.431995,679.431995,185.09775,5,0
0,0,22,22,18,46,64,123,83,206,0.000333,0.412,9,11124,618,1236,329.1425,9,0
0,0,22,22,19,47,66,124,84,208,0.000333,0.419078,9,11315.10579,628.616988,1257.233977,341.776299,9,0
0,0,25,25,20,51,71,135,101,236,0.000333,0.48378,10,14513.4032,806.300178,1451.34032,375.732254,9,0
0,0,25,25,21,52,73,136,107,243,0.000333,0.501376,20,30082.54736,1671.252631,1504.127368,388.661531,9,0
0,0,27,27,20,45,65,137,88,225,0.000333,0.451678,10,13550.32758,752.795977,1355.032758,333.571951,9,0
0,0,24,24,20,43,63,131,85,216,0.000333,0.430364,10,12910.92464,717.273591,1291.092463,319.767946,9,0
0,0,30,30,19,50,69,149,98,247,0.000333,0.502935,9,13579.24987,754.40277,1508.805541,362.903432,12,0
0,0,30,30,20,49,69,149,97,246,0.000333,0.500899,10,15026.97016,834.831676,1502.697016,361.559344,12,0
0,0,30,30,19,48,67,149,97,246,0.000333,0.497419,18,26860.64294,1492.257941,1492.257941,348.788823,12,0
0,0,15,15,13,19,32,54,42,96,0.000333,0.16,12,5760,320,480,128.816339,3,0
0,0,17,17,17,24,41,72,55,127,0.000333,0.226803,16,10886.54567,604.808093,680.409105,179.525968,5,0
0,0,30,30,19,49,68,149,97,246,0.000333,0.499172,9,13477.64273,748.757929,1497.515859,355.831405,12,0
0,0,32,32,20,49,69,153,100,253,0.000333,0.515152,20,30909.13375,1717.174097,1545.456688,361.559344,12,0
0,0,16,16,13,22,35,51,55,106,0.000333,0.181235,12,6524.447998,362.469333,543.704,146.213212,1,0
0,0,14,14,10,18,28,49,64,113,0.000333,0.181077,15,8148.466593,452.692588,543.231106,108.277931,1,0
0,0,36,36,21,54,75,182,123,305,0.000333,0.633263,20,37995.79401,2110.877445,1899.789701,403.002591,13,0
0,0,36,36,23,57,80,186,129,315,0.000333,0.663802,22,43810.9617,2433.942317,1991.40735,436.516656,13,0
0,0,30,30,19,49,68,157,102,259,0.000333,0.525551,18,28379.75177,1576.652876,1576.652876,355.831405,11,0
0,0,30,30,20,50,70,158,101,259,0.000333,0.529161,20,31749.68603,1763.871446,1587.484301,368.631371,11,0
0,0,30,30,19,49,68,158,100,258,0.000333,0.523522,18,28270.17744,1570.565413,1570.565413,355.831405,11,0
0,0,30,30,20,48,68,159,99,258,0.000333,0.523522,20,31411.30826,1745.072681,1570.565413,354.516762,11,0
0,0,36,36,21,52,73,187,121,308,0.000333,0.635489,20,38129.31928,2118.295516,1906.465964,388.661531,13,0
0,0,36,36,23,55,78,191,127,318,0.000333,0.666253,22,43972.67392,2442.926329,1998.757906,422.016709,13,0
0,0,35,35,21,52,73,182,117,299,0.000333,0.616919,20,37015.15086,2056.39727,1850.757543,388.661531,13,0
0,0,35,35,23,55,78,186,123,309,0.000333,0.647396,22,42728.16428,2373.786905,1942.189286,422.016709,13,0
0,0,36,36,21,53,74,191,121,312,0.000333,0.645783,20,38746.989,2152.6105,1937.34945,395.81845,13,0
0,0,36,36,23,56,79,195,127,322,0.000333,0.676606,22,44655.98282,2480.887934,2029.817401,429.253801,13,0
0,0,32,32,20,49,69,165,110,275,0.000333,0.559948,20,33596.88451,1866.493584,1679.844226,361.559344,11,0
0,0,32,32,21,51,72,166,111,277,0.000333,0.56969,20,34181.38451,1898.965806,1709.069225,381.532358,11,0
0,0,38,38,21,53,74,188,134,322,0.000333,0.666481,20,39988.87968,2221.604426,1999.443984,395.81845,13,0
0,0,38,38,23,56,79,192,144,336,0.000333,0.706023,22,46597.54729,2588.752627,2118.070331,429.253801,13,0
0,0,40,40,21,54,75,194,144,338,0.000333,0.70178,20,42106.81435,2339.267464,2105.340717,403.002591,13,0
0,0,40,40,23,57,80,198,156,354,0.000333,0.745988,22,49235.176,2735.287556,2237.962546,436.516656,13,0
0,0,8,8,12,16,28,36,29,65,0.000333,0.104159,6,1874.86842,104.159357,312.47807,107.01955,1,0
0,0,28,28,19,48,67,140,94,234,0.000333,0.473155,9,12775.18384,709.732435,1419.464871,348.788823,9,0
0,0,20,20,19,46,65,104,75,179,0.000333,0.359335,9,9702.034547,539.001919,1078.003839,334.794473,8,0
0,0,30,30,19,49,68,145,109,254,0.000333,0.515405,18,27831.88011,1546.215562,1546.215562,355.831405,9,0
0,0,32,32,19,48,67,151,123,274,0.000333,0.554036,18,29917.95189,1662.108438,1662.108438,348.788823,9,0
0,0,34,34,19,49,68,157,135,292,0.000333,0.592513,18,31995.70469,1777.53915,1777.53915,355.831405,9,0
0,0,29,29,20,46,66,143,101,244,0.000333,0.491611,20,29496.6433,1638.702406,1474.832165,340.522412,9,0
0,0,29,29,19,47,66,145,102,247,0.000333,0.497655,18,26873.37626,1492.965347,1492.965347,341.776299,9,0
0,0,30,30,19,48,67,154,106,260,0.000333,0.525728,18,28389.29741,1577.18319,1577.18319,348.788823,9,0
0,0,27,27,19,46,65,136,89,225,0.000333,0.451678,9,12195.29482,677.516379,1355.032758,334.794473,9,0
0,0,31,31,19,51,70,153,103,256,0.000333,0.523032,18,28243.73614,1569.096452,1569.096452,370.004315,11,0
0,0,32,32,21,48,69,169,107,276,0.000333,0.561984,20,33719.055,1873.280833,1685.95275,360.316866,11,0
0,0,32,32,23,51,74,173,113,286,0.000333,0.591968,22,39069.88058,2170.548921,1775.903663,393.335617,11,0
0,0,33,33,21,49,70,178,111,289,0.000333,0.590454,20,35427.25584,1968.18088,1771.362792,367.359448,11,0
0,0,33,33,23,52,75,182,117,299,0.000333,0.620806,22,40973.16935,2276.287186,1862.416788,400.46479,11,0
0,0,8,8,11,13,24,35,26,61,0.000333,0.093228,10,2796.827125,155.379285,279.682713,86.159464,1,0
0,0,19,19,18,44,62,101,73,174,0.000333,0.345343,9,9324.271422,518.015079,1036.030158,315.273641,7,0
0,0,19,19,19,43,62,102,72,174,0.000333,0.345343,9,9324.271422,518.015079,1036.030158,314.040007,7,0
0,0,18,18,17,28,45,74,66,140,0.000333,0.256286,16,12301.75094,683.430608,768.859433,204.092806,6,0
0,0,18,18,17,28,45,74,66,140,0.000333,0.256286,16,12301.75094,683.430608,768.859433,204.092806,6,0
0,0,16,16,13,23,36,56,50,106,0.000333,0.182671,12,6576.144602,365.341367,548.01205,152.147641,4,0
0,0,15,15,13,19,32,52,40,92,0.000333,0.153333,12,5520,306.666667,460,128.816339,3,0
0,0,17,17,17,24,41,70,53,123,0.000333,0.21966,16,10543.66235,585.759019,658.978897,179.525968,5,0
0,0,16,16,14,19,33,57,44,101,0.000333,0.169828,14,7132.773285,396.265182,509.483806,134.013592,3,0
0,0,18,18,18,24,42,75,57,132,0.000333,0.237262,18,12812.1462,711.7859,711.7859,185.09775,5,0
0,0,16,16,14,24,38,55,45,100,0.000333,0.174931,7,3673.549259,204.08607,524.792751,163.342069,3,0
0,0,18,18,18,29,47,73,58,131,0.000333,0.24255,18,13097.72051,727.65114,727.65114,215.940099,5,0
0,0,21,21,21,46,67,111,81,192,0.000333,0.38823,10,11646.89125,647.049514,1164.689125,346.322516,8,0
0,0,21,21,22,45,67,112,80,192,0.000333,0.38823,11,12811.58037,711.754465,1164.689125,345.240885,8,0
0,0,10,10,13,16,29,45,30,75,0.000333,0.12145,6,2186.091448,121.449525,364.348575,112.105716,3,0
0,0,10,10,15,17,32,47,32,79,0.000333,0.131667,7,2765,153.611111,395,128.090227,4,0
0,0,20,20,18,44,62,104,74,178,0.000333,0.353282,9,9538.622489,529.923472,1059.846943,315.273641,8,0
0,0,20,20,19,43,62,105,73,178,0.000333,0.353282,9,9538.622489,529.923472,1059.846943,314.040007,8,0
0,0,13,13,12,19,31,44,42,86,0.000333,0.14202,12,5112.730592,284.040588,426.060883,123.730173,1,0
0,0,20,20,18,46,64,104,75,179,0.000333,0.358,9,9666,537,1074,329.1425,8,0
0,0,20,20,19,45,64,105,74,179,0.000333,0.358,9,9666,537,1074,327.844012,8,0
0,0,20,20,19,45,64,105,74,179,0.000333,0.358,9,9666,537,1074,327.844012,8,0
0,0,20,20,18,46,64,104,75,179,0.000333,0.358,9,9666,537,1074,329.1425,8,0
0,0,20,20,19,45,64,105,74,179,0.000333,0.358,9,9666,537,1074,327.844012,8,0
0,0,20,20,19,45,64,105,74,179,0.000333,0.358,9,9666,537,1074,327.844012,8,0
0,0,27,27,19,46,65,135,91,226,0.000333,0.453685,9,12249.49613,680.527563,1361.055126,334.794473,9,0
0,0,22,22,19,45,64,108,77,185,0.000333,0.37,9,9990,555,1110,327.844012,8,0
0,0,22,22,20,44,64,109,76,185,0.000333,0.37,10,11100,616.666667,1110,326.653553,8,0
0,0,22,22,20,44,64,109,76,185,0.000333,0.37,10,11100,616.666667,1110,326.653553,8,0
0,0,20,20,18,47,65,104,76,180,0.000333,0.361342,9,9756.235857,542.013103,1084.026206,336.124326,8,0
0,0,35,35,19,52,71,164,133,297,0.000333,0.608825,18,32876.5481,1826.474894,1826.474894,377.133488,11,0
0,0,31,31,19,50,69,152,109,261,0.000333,0.531442,18,28697.8479,1594.324883,1594.324883,362.903432,11,0
0,0,18,18,19,27,46,84,60,144,0.000333,0.265131,18,14317.07259,795.392922,795.392922,209.092585,7,0
0,0,16,16,16,22,38,66,47,113,0.000333,0.197672,16,9488.252944,527.125164,593.015809,162.107496,5,0
0,0,29,29,23,46,69,161,98,259,0.000333,0.527369,22,34806.37236,1933.687353,1582.107834,358.125775,11,0
0,0,29,29,23,46,69,161,98,259,0.000333,0.527369,22,34806.37236,1933.687353,1582.107834,358.125775,11,0
0,0,33,33,19,51,70,158,121,279,0.000333,0.570023,18,30781.25931,1710.069962,1710.069962,370.004315,11,0
0,0,32,32,22,49,71,153,99,252,0.000333,0.516579,22,34094.19803,1894.122113,1549.736274,373.228278,13,0
0,0,32,32,22,49,71,153,99,252,0.000333,0.516579,22,34094.19803,1894.122113,1549.736274,373.228278,13,0
0,0,32,32,21,50,71,154,100,254,0.000333,0.520679,20,31240.71537,1735.595298,1562.035768,374.431475,13,0
0,0,32,32,21,50,71,153,100,253,0.000333,0.518629,20,31117.72043,1728.762246,1555.886021,374.431475,13,0
0,0,22,22,20,48,68,113,93,206,0.000333,0.418006,10,12540.17345,696.676303,1254.017345,354.516762,7,0
0,0,19,19,18,45,63,101,74,175,0.000333,0.348675,9,9414.21588,523.011993,1046.023987,322.192039,7,0
0,0,20,20,18,46,64,104,75,179,0.000333,0.358,9,9666,537,1074,329.1425,8,0
0,0,20,20,18,46,64,104,75,179,0.000333,0.358,9,9666,537,1074,329.1425,8,0
0,0,20,20,18,45,63,104,75,179,0.000333,0.356644,9,9629.397957,534.966553,1069.933106,322.192039,8,0
0,0,20,20,18,47,65,104,76,180,0.000333,0.361342,9,9756.235857,542.013103,1084.026206,336.124326,8,0
0,0,20,20,18,47,65,104,76,180,0.000333,0.361342,9,9756.235857,542.013103,1084.026206,336.124326,8,0
0,0,30,30,19,49,68,149,98,247,0.000333,0.501201,18,27064.85979,1503.603322,1503.603322,355.831405,12,0
0,0,30,30,19,50,69,149,98,247,0.000333,0.502935,9,13579.24987,754.40277,1508.805541,362.903432,12,0
0,0,27,27,19,46,65,135,92,227,0.000333,0.455692,18,24607.39488,1367.077494,1367.077494,334.794473,9,0
0,0,19,19,18,44,62,101,73,174,0.000333,0.345343,9,9324.271422,518.015079,1036.030158,315.273641,7,0
0,0,19,19,19,43,62,102,72,174,0.000333,0.345343,9,9324.271422,518.015079,1036.030158,314.040007,7,0
0,0,28,28,19,48,67,140,94,234,0.000333,0.473155,9,12775.18384,709.732435,1419.464871,348.788823,9,0
0,0,15,15,14,20,34,50,51,101,0.000333,0.171278,14,7193.672458,399.64847,513.833747,139.741531,2,0
0,0,15,15,14,20,34,50,51,101,0.000333,0.171278,14,7193.672458,399.64847,513.833747,139.741531,2,0
0,0,15,15,14,17,31,51,45,96,0.000333,0.158534,14,6658.439841,369.913325,475.602846,122.789837,2,0
0,0,15,15,14,17,31,51,45,96,0.000333,0.158534,14,6658.439841,369.913325,475.602846,122.789837,2,0
0,0,11,11,12,15,27,39,30,69,0.000333,0.109362,12,3937.046852,218.724825,328.087238,101.622909,1,0
0,0,13,13,15,16,31,48,37,85,0.000333,0.140369,14,5895.493609,327.527423,421.106686,122.603359,2,0
0,0,14,14,13,21,34,46,41,87,0.000333,0.147536,6,2655.655603,147.536422,442.609267,140.344382,1,0
0,0,13,13,13,16,29,46,36,82,0.000333,0.132785,12,4780.253299,265.569628,398.354442,112.105716,1,0
0,0,13,13,12,16,28,43,36,79,0.000333,0.126594,12,4557.372466,253.187359,379.781039,107.01955,1,0
0,0,14,14,13,16,29,48,40,88,0.000333,0.142501,12,5130.027931,285.001552,427.502328,112.105716,1,0
0,0,13,13,12,19,31,44,42,86,0.000333,0.14202,12,5112.730592,284.040588,426.060883,123.730173,1,0
0,0,35,35,19,52,71,164,133,297,0.000333,0.608825,18,32876.5481,1826.474894,1826.474894,377.133488,11,0
0,0,37,37,19,53,72,170,145,315,0.000333,0.647842,18,34983.47476,1943.526375,1943.526375,384.290407,11,0
0,0,32,32,20,50,70,156,111,267,0.000333,0.545506,20,32730.37131,1818.353962,1636.518566,368.631371,11,0
0,0,32,32,19,51,70,158,112,270,0.000333,0.551635,18,29788.31546,1654.906415,1654.906415,370.004315,11,0
0,0,33,33,19,52,71,167,116,283,0.000333,0.580126,18,31326.81183,1740.378435,1740.378435,377.133488,11,0
0,0,30,30,19,50,69,149,99,248,0.000333,0.504971,9,13634.22659,757.457033,1514.914065,362.903432,11,0
0,0,33,33,19,51,70,163,116,279,0.000333,0.570023,18,30781.25931,1710.069962,1710.069962,370.004315,11,0
0,0,15,15,12,20,32,49,54,103,0.000333,0.171667,12,6180,343.333333,515,129.458112,1,0
0,0,17,17,12,21,33,54,66,120,0.000333,0.201776,18,10895.8913,605.327294,605.327294,135.258216,1,0
0,0,32,32,19,48,67,151,123,274,0.000333,0.554036,18,29917.95189,1662.108438,1662.108438,348.788823,9,0
0,0,34,34,19,49,68,157,135,292,0.000333,0.592513,18,31995.70469,1777.53915,1777.53915,355.831405,9,0
0,0,27,27,19,46,65,136,89,225,0.000333,0.451678,9,12195.29482,677.516379,1355.032758,334.794473,9,0
0,0,22,22,20,47,67,122,91,213,0.000333,0.430692,10,12920.76998,717.820554,1292.076998,347.504238,7,0
0,0,22,22,21,48,69,123,97,220,0.000333,0.447958,20,26877.50761,1493.194867,1343.87538,360.316866,7,0
0,0,28,28,19,46,65,139,99,238,0.000333,0.477775,18,25799.82371,1433.32354,1433.32354,334.794473,9,0
0,0,30,30,19,47,66,145,111,256,0.000333,0.515788,18,27852.5681,1547.364895,1547.364895,341.776299,9,0
0,0,19,19,18,42,60,110,73,183,0.000333,0.36032,9,9728.648811,540.480489,1080.960979,301.535982,7,0
0,0,19,19,19,43,62,111,74,185,0.000333,0.367175,9,9913.736857,550.763159,1101.526317,314.040007,7,0
0,0,17,17,17,42,59,100,71,171,0.000333,0.335311,8,8047.455692,447.080872,1005.931961,295.9642,7,0
0,0,17,17,17,43,60,100,73,173,0.000333,0.340631,8,8175.136584,454.174255,1021.892073,302.816253,7,0
0,0,34,34,23,56,79,158,111,269,0.000333,0.565239,11,18652.88723,1036.271513,1695.717021,429.253801,14,0
0,0,34,34,23,56,79,157,111,268,0.000333,0.563138,11,18583.54565,1032.419203,1689.413241,429.253801,14,0
0,0,15,15,13,20,33,55,38,93,0.000333,0.156376,6,2814.771919,156.376218,469.128653,134.544278,5,0
0,0,15,15,13,20,33,54,38,92,0.000333,0.154695,6,2784.505554,154.694753,464.084259,134.544278,5,0
0,0,34,34,23,54,77,157,109,266,0.000333,0.555655,22,36673.23484,2037.401935,1666.96522,414.80585,14,0
0,0,15,15,14,19,33,54,36,90,0.000333,0.151332,7,3177.968295,176.553794,453.995471,134.013592,5,0
0,0,35,35,23,56,79,160,120,280,0.000333,0.588353,22,38831.28941,2157.293856,1765.058609,429.253801,13,0
0,0,35,35,23,56,79,160,120,280,0.000333,0.588353,22,38831.28941,2157.293856,1765.058609,429.253801,13,0
0,0,16,16,13,20,33,57,44,101,0.000333,0.169828,12,6113.805673,339.655871,509.483806,134.544278,4,0
0,0,15,15,13,19,32,52,40,92,0.000333,0.153333,12,5520,306.666667,460,128.816339,3,0
0,0,34,34,23,55,78,155,113,268,0.000333,0.561496,22,37058.73148,2058.818416,1684.487795,422.016709,12,0
0,0,15,15,14,19,33,55,40,95,0.000333,0.159739,14,6709.044179,372.724677,479.217441,134.013592,3,0
0,0,34,34,23,55,78,158,113,271,0.000333,0.567781,22,37473.56803,2081.86489,1703.344001,422.016709,12,0
0,0,22,22,18,48,66,123,85,208,0.000333,0.419078,9,11315.10579,628.616988,1257.233977,343.13685,9,0
0,0,22,22,18,48,66,123,85,208,0.000333,0.419078,9,11315.10579,628.616988,1257.233977,343.13685,9,0
0,0,22,22,18,48,66,123,85,208,0.000333,0.419078,9,11315.10579,628.616988,1257.233977,343.13685,9,0
0,0,22,22,18,48,66,123,85,208,0.000333,0.419078,9,11315.10579,628.616988,1257.233977,343.13685,9,0
0,0,22,22,19,47,66,124,84,208,0.000333,0.419078,9,11315.10579,628.616988,1257.233977,341.776299,9,0
0,0,22,22,19,47,66,124,84,208,0.000333,0.419078,9,11315.10579,628.616988,1257.233977,341.776299,9,0
0,0,22,22,18,48,66,123,85,208,0.000333,0.419078,9,11315.10579,628.616988,1257.233977,343.13685,9,0
0,0,22,22,18,48,66,123,85,208,0.000333,0.419078,9,11315.10579,628.616988,1257.233977,343.13685,9,0
0,0,22,22,18,48,66,123,85,208,0.000333,0.419078,9,11315.10579,628.616988,1257.233977,343.13685,9,0
0,0,22,22,18,48,66,123,85,208,0.000333,0.419078,9,11315.10579,628.616988,1257.233977,343.13685,9,0
0,0,22,22,19,47,66,124,84,208,0.000333,0.419078,9,11315.10579,628.616988,1257.233977,341.776299,9,0
0,0,22,22,19,47,66,124,84,208,0.000333,0.419078,9,11315.10579,628.616988,1257.233977,341.776299,9,0
0,0,24,24,21,50,71,124,91,215,0.000333,0.440732,10,13221.95631,734.553128,1322.195631,374.431475,10,0
0,0,24,24,22,49,71,125,90,215,0.000333,0.440732,11,14544.15194,808.008441,1322.195631,373.228278,10,0
0,0,22,22,18,48,66,114,83,197,0.000333,0.396915,9,10716.71077,595.372821,1190.745642,343.13685,9,0
0,0,22,22,19,47,66,115,82,197,0.000333,0.396915,9,10716.71077,595.372821,1190.745642,341.776299,9,0
0,0,17,17,18,26,44,71,50,121,0.000333,0.220197,9,5945.321033,330.295613,660.591226,197.270083,7,0
0,0,15,15,14,20,34,53,37,90,0.000333,0.152624,7,3205.10159,178.061199,457.871656,139.741531,5,0
0,0,32,32,20,51,71,158,110,268,0.000333,0.549377,20,32962.64456,1831.258031,1648.132228,375.732254,12,0
0,0,34,34,20,52,72,164,120,284,0.000333,0.584086,20,35045.17401,1946.954112,1752.2587,382.861427,12,0
0,0,30,30,19,50,69,149,99,248,0.000333,0.504971,9,13634.22659,757.457033,1514.914065,362.903432,11,0
0,0,30,30,19,50,69,148,101,249,0.000333,0.507008,18,27378.40662,1521.02259,1521.02259,362.903432,11,0
0,0,17,17,17,27,44,72,52,124,0.000333,0.225657,8,5415.756166,300.875343,676.969521,197.868831,7,0
0,0,17,17,17,27,44,71,52,123,0.000333,0.223837,8,5372.080713,298.448928,671.510089,197.868831,7,0
0,0,15,15,13,21,34,54,39,93,0.000333,0.157711,6,2838.804265,157.711348,473.134044,140.344382,5,0
0,0,15,15,13,21,34,53,39,92,0.000333,0.156016,6,2808.279488,156.015527,468.046581,140.344382,5,0
0,0,23,23,17,31,48,92,63,155,0.000333,0.288556,16,13850.707,769.483722,865.669188,223.066954,7,0
0,0,25,25,18,29,47,109,73,182,0.000333,0.336978,18,18196.83308,1010.935171,1010.935171,215.940099,8,0
0,0,30,30,18,29,47,129,87,216,0.000333,0.39993,27,32394.36218,1799.686788,1199.791192,215.940099,9,0
0,0,21,21,14,23,37,75,49,124,0.000333,0.215324,14,9043.611043,502.422836,645.972217,157.344894,5,0
0,0,26,26,14,23,37,95,63,158,0.000333,0.274365,14,11523.31085,640.183936,823.093632,157.344894,6,0
0,0,16,16,14,23,37,55,49,104,0.000333,0.180594,14,7584.9641,421.386894,541.78315,157.344894,3,0
0,0,35,35,24,60,84,158,122,280,0.000333,0.596616,24,42956.37308,2386.465171,1789.848878,464.452536,12,0
0,0,10,10,12,19,31,43,33,76,0.000333,0.125506,6,2259.113518,125.506307,376.51892,123.730173,3,0
0,0,10,10,14,20,34,45,35,80,0.000333,0.135666,7,2848.979191,158.276622,406.997027,139.741531,4,0
0,0,18,18,14,26,40,59,60,119,0.000333,0.211103,14,8866.332206,492.574011,633.309443,175.514402,3,0
0,0,37,37,23,63,86,162,133,295,0.000333,0.631916,22,41706.45826,2317.025459,1895.748103,480.61056,12,0
0,0,26,26,19,45,64,133,87,220,0.000333,0.44,9,11880,660,1320,327.844012,9,0
0,0,27,27,19,45,64,136,88,224,0.000333,0.448,9,12096,672,1344,327.844012,10,0
0,0,27,27,20,47,67,144,95,239,0.000333,0.483265,20,28995.90633,1610.883685,1449.795317,347.504238,11,0
0,0,29,29,19,46,65,145,95,240,0.000333,0.481789,18,26016.62895,1445.368275,1445.368275,334.794473,9,0
0,0,28,28,19,46,65,139,93,232,0.000333,0.46573,18,25149.40799,1397.189333,1397.189333,334.794473,9,0
0,0,30,30,19,50,69,149,98,247,0.000333,0.502935,9,13579.24987,754.40277,1508.805541,362.903432,12,0
0,0,20,20,18,46,64,104,75,179,0.000333,0.358,9,9666,537,1074,329.1425,8,0
0,0,22,22,20,46,66,109,78,187,0.000333,0.376767,10,11303.017,627.945389,1130.3017,340.522412,8,0
0,0,20,20,18,46,64,104,75,179,0.000333,0.358,9,9666,537,1074,329.1425,8,0
0,0,20,20,18,46,64,104,75,179,0.000333,0.358,9,9666,537,1074,329.1425,8,0
0,0,19,19,18,45,63,101,74,175,0.000333,0.348675,9,9414.21588,523.011993,1046.023987,322.192039,7,0
0,0,22,22,18,47,65,112,91,203,0.000333,0.407514,9,11002.86599,611.270333,1222.540666,336.124326,8,0
0,0,32,32,21,51,72,158,102,260,0.000333,0.534727,20,32083.61001,1782.422778,1604.1805,381.532358,12,0
0,0,30,30,19,51,70,149,99,248,0.000333,0.506687,9,13680.55969,760.031094,1520.062188,370.004315,12,0
0,0,27,27,19,46,65,136,89,225,0.000333,0.451678,9,12195.29482,677.516379,1355.032758,334.794473,10,0
0,0,30,30,19,51,70,149,99,248,0.000333,0.506687,9,13680.55969,760.031094,1520.062188,370.004315,12,0
0,0,30,30,19,51,70,149,99,248,0.000333,0.506687,9,13680.55969,760.031094,1520.062188,370.004315,12,0
0,0,30,30,19,50,69,149,98,247,0.000333,0.502935,9,13579.24987,754.40277,1508.805541,362.903432,12,0
0,0,30,30,19,50,69,149,98,247,0.000333,0.502935,9,13579.24987,754.40277,1508.805541,362.903432,12,0
0,0,32,32,20,50,70,153,101,254,0.000333,0.518946,20,31136.75773,1729.819874,1556.837886,368.631371,12,0
0,0,32,32,21,50,71,154,101,255,0.000333,0.522729,20,31363.71031,1742.428351,1568.185515,374.431475,12,0
0,0,30,30,19,50,69,149,98,247,0.000333,0.502935,9,13579.24987,754.40277,1508.805541,362.903432,12,0
0,0,34,34,23,54,77,157,109,266,0.000333,0.555655,22,36673.23484,2037.401935,1666.96522,414.80585,14,0
0,0,34,34,23,54,77,157,109,266,0.000333,0.555655,22,36673.23484,2037.401935,1666.96522,414.80585,14,0
0,0,15,15,13,19,32,54,36,90,0.000333,0.15,6,2700,150,450,128.816339,5,0
0,0,15,15,13,19,32,54,36,90,0.000333,0.15,6,2700,150,450,128.816339,5,0
0,0,10,10,15,20,35,48,35,83,0.000333,0.14191,7,2980.113433,165.561857,425.73049,145.041921,4,0
0,0,10,10,13,19,32,46,33,79,0.000333,0.131667,6,2370,131.666667,395,128.816339,3,0
0,0,18,18,20,25,45,69,70,139,0.000333,0.254456,20,15267.35161,848.1862,763.36758,202.534967,4,0
0,0,18,18,17,23,40,62,67,129,0.000333,0.228843,16,10984.45959,610.247755,686.528724,173.528793,3,0
0,0,13,13,13,18,31,48,34,82,0.000333,0.135415,6,2437.464585,135.414699,406.244097,123.164366,3,0
0,0,32,32,23,54,77,151,107,258,0.000333,0.538944,11,17785.1402,988.063345,1616.830927,414.80585,12,0
0,0,10,10,16,18,34,46,35,81,0.000333,0.137361,8,3296.675921,183.148662,412.08449,139.05865,4,0
0,0,10,10,14,17,31,44,33,77,0.000333,0.127158,7,2670.311811,148.350656,381.473116,122.789837,3,0
0,0,22,22,18,48,66,123,85,208,0.000333,0.419078,9,11315.10579,628.616988,1257.233977,343.13685,9,0
0,0,22,22,18,48,66,123,85,208,0.000333,0.419078,9,11315.10579,628.616988,1257.233977,343.13685,9,0
0,0,19,19,18,45,63,101,74,175,0.000333,0.348675,9,9414.21588,523.011993,1046.023987,322.192039,7,0
0,0,29,29,21,48,69,145,106,251,0.000333,0.51108,20,30664.79277,1703.599599,1533.239639,360.316866,9,0
0,0,17,17,17,24,41,73,51,124,0.000333,0.221445,16,10629.38318,590.521288,664.336449,179.525968,7,0
0,0,17,17,17,24,41,72,51,123,0.000333,0.21966,16,10543.66235,585.759019,658.978897,179.525968,7,0
0,0,15,15,13,19,32,55,38,93,0.000333,0.155,12,5580,310,465,128.816339,5,0
0,0,15,15,13,19,32,54,38,92,0.000333,0.153333,12,5520,306.666667,460,128.816339,5,0
0,0,27,27,19,46,65,136,88,224,0.000333,0.44967,9,12141.09351,674.505195,1349.01039,334.794473,10,0
0,0,15,15,13,21,34,57,49,106,0.000333,0.179757,12,6471.252734,359.514041,539.271061,140.344382,1,0
0,0,18,18,16,44,60,98,70,168,0.000333,0.330786,8,7938.86096,441.047831,992.35762,304.214991,7,0
0,0,23,23,18,50,68,117,85,202,0.000333,0.409889,9,11067.00745,614.833747,1229.667494,357.25146,10,0
0,0,23,23,19,49,68,118,84,202,0.000333,0.409889,9,11067.00745,614.833747,1229.667494,355.831405,10,0
0,0,23,23,19,49,68,118,84,202,0.000333,0.409889,9,11067.00745,614.833747,1229.667494,355.831405,10,0
0,0,21,21,19,46,65,110,81,191,0.000333,0.383424,9,10352.45027,575.136126,1150.272252,334.794473,7,0
0,0,19,19,18,45,63,101,74,175,0.000333,0.348675,9,9414.21588,523.011993,1046.023987,322.192039,7,0
0,0,32,32,21,50,71,154,101,255,0.000333,0.522729,20,31363.71031,1742.428351,1568.185515,374.431475,12,0
0,0,30,30,19,50,69,149,98,247,0.000333,0.502935,9,13579.24987,754.40277,1508.805541,362.903432,12,0
0,0,12,12,14,17,31,43,32,75,0.000333,0.123855,7,2600.953063,144.497392,371.564723,122.789837,2,0
0,0,12,12,13,17,30,42,32,74,0.000333,0.121037,6,2178.659424,121.036635,363.109904,117.592585,2,0
0,0,12,12,13,16,29,42,31,73,0.000333,0.118211,6,2127.795676,118.210871,354.632613,112.105716,2,0
0,0,12,12,13,16,29,42,31,73,0.000333,0.118211,6,2127.795676,118.210871,354.632613,112.105716,2,0
0,0,32,32,21,50,71,157,105,262,0.000333,0.537078,20,32224.67491,1790.259717,1611.233745,374.431475,11,0
0,0,16,16,16,20,36,53,63,116,0.000333,0.199904,24,14393.0712,799.615067,599.7113,150.438562,1,0
0,0,8,8,12,15,27,34,29,63,0.000333,0.099853,6,1797.347476,99.852638,299.557913,101.622909,1,0
0,0,12,12,13,15,28,42,31,73,0.000333,0.116979,12,4211.242912,233.95794,350.936909,106.709075,2,0
0,0,12,12,13,15,28,42,31,73,0.000333,0.116979,12,4211.242912,233.95794,350.936909,106.709075,2,0
0,0,11,11,12,15,27,39,30,69,0.000333,0.109362,12,3937.046852,218.724825,328.087238,101.622909,1,0
0,0,12,12,13,16,29,42,31,73,0.000333,0.118211,6,2127.795676,118.210871,354.632613,112.105716,2,0
0,0,12,12,13,16,29,42,31,73,0.000333,0.118211,6,2127.795676,118.210871,354.632613,112.105716,2,0
0,0,12,12,14,16,30,43,32,75,0.000333,0.122672,14,5152.235125,286.235285,368.016795,117.302969,2,0
0,0,12,12,13,16,29,42,32,74,0.000333,0.11983,12,4313.887124,239.660396,359.490594,112.105716,2,0
0,0,34,34,23,55,78,158,111,269,0.000333,0.563591,22,37197.01033,2066.500574,1690.773197,422.016709,14,0
0,0,34,34,23,55,78,157,111,268,0.000333,0.561496,22,37058.73148,2058.818416,1684.487795,422.016709,14,0
0,0,15,15,13,19,32,55,38,93,0.000333,0.155,12,5580,310,465,128.816339,5,0
0,0,15,15,13,19,32,54,38,92,0.000333,0.153333,12,5520,306.666667,460,128.816339,5,0
0,0,25,25,19,49,68,121,87,208,0.000333,0.422064,9,11395.73044,633.096135,1266.192271,355.831405,10,0
0,0,25,25,20,48,68,122,86,208,0.000333,0.422064,10,12661.92271,703.440151,1266.192271,354.516762,10,0
0,0,25,25,20,48,68,122,86,208,0.000333,0.422064,10,12661.92271,703.440151,1266.192271,354.516762,10,0
0,0,25,25,20,50,70,126,88,214,0.000333,0.437222,10,13116.66566,728.703648,1311.666566,368.631371,10,0
0,0,25,25,21,49,70,127,87,214,0.000333,0.437222,10,13116.66566,728.703648,1311.666566,367.359448,10,0
0,0,25,25,21,49,70,127,87,214,0.000333,0.437222,10,13116.66566,728.703648,1311.666566,367.359448,10,0
0,0,17,17,17,27,44,72,52,124,0.000333,0.225657,8,5415.756166,300.875343,676.969521,197.868831,7,0
0,0,17,17,17,27,44,71,52,123,0.000333,0.223837,8,5372.080713,298.448928,671.510089,197.868831,7,0
0,0,15,15,13,21,34,54,39,93,0.000333,0.157711,6,2838.804265,157.711348,473.134044,140.344382,5,0
0,0,15,15,13,21,34,53,39,92,0.000333,0.156016,6,2808.279488,156.015527,468.046581,140.344382,5,0
0,0,29,29,19,49,68,146,97,243,0.000333,0.493084,9,13313.28123,739.626735,1479.25347,355.831405,11,0
0,0,22,22,20,46,66,113,78,191,0.000333,0.384826,10,11544.79277,641.377376,1154.479277,340.522412,8,0
0,0,30,30,19,50,69,149,99,248,0.000333,0.504971,9,13634.22659,757.457033,1514.914065,362.903432,12,0
0,0,30,30,19,49,68,149,98,247,0.000333,0.501201,18,27064.85979,1503.603322,1503.603322,355.831405,12,0
0,0,30,30,19,50,69,149,98,247,0.000333,0.502935,9,13579.24987,754.40277,1508.805541,362.903432,12,0
0,0,30,30,19,50,69,149,98,247,0.000333,0.502935,9,13579.24987,754.40277,1508.805541,362.903432,12,0
0,0,30,30,19,51,70,149,99,248,0.000333,0.506687,9,13680.55969,760.031094,1520.062188,370.004315,12,0
0,0,30,30,19,50,69,149,98,247,0.000333,0.502935,9,13579.24987,754.40277,1508.805541,362.903432,12,0
0,0,22,22,19,46,65,113,81,194,0.000333,0.389446,9,10515.0542,584.169678,1168.339356,334.794473,8,0
0,0,19,19,18,44,62,101,73,174,0.000333,0.345343,9,9324.271422,518.015079,1036.030158,315.273641,7,0
0,0,15,15,13,23,36,52,47,99,0.000333,0.170608,12,6141.870902,341.21505,511.822575,152.147641,3,0
0,0,15,15,15,24,39,56,49,105,0.000333,0.184989,14,7769.541262,431.641181,554.967233,168.642459,4,0
0,0,34,34,19,49,68,157,135,292,0.000333,0.592513,18,31995.70469,1777.53915,1777.53915,355.831405,9,0
0,0,33,33,19,53,72,158,119,277,0.000333,0.56969,18,30763.24606,1709.069225,1709.069225,384.290407,11,0
0,0,30,30,19,50,69,148,102,250,0.000333,0.509044,18,27488.36006,1527.131114,1527.131114,362.903432,11,0
0,0,23,23,18,50,68,117,85,202,0.000333,0.409889,9,11067.00745,614.833747,1229.667494,357.25146,10,0
0,0,23,23,19,49,68,118,84,202,0.000333,0.409889,9,11067.00745,614.833747,1229.667494,355.831405,10,0
0,0,23,23,19,49,68,118,84,202,0.000333,0.409889,9,11067.00745,614.833747,1229.667494,355.831405,10,0
0,0,29,29,19,49,68,146,97,243,0.000333,0.493084,9,13313.28123,739.626735,1479.25347,355.831405,11,0
0,0,30,30,19,49,68,149,98,247,0.000333,0.501201,18,27064.85979,1503.603322,1503.603322,355.831405,12,0
0,0,31,31,22,50,72,155,104,259,0.000333,0.53267,22,35156.23266,1953.124037,1598.010575,380.300305,12,0
0,0,30,30,19,51,70,149,99,248,0.000333,0.506687,9,13680.55969,760.031094,1520.062188,370.004315,12,0
0,0,30,30,20,50,70,149,98,247,0.000333,0.504644,10,15139.32905,841.073836,1513.932905,368.631371,12,0
0,0,32,32,21,51,72,158,102,260,0.000333,0.534727,20,32083.61001,1782.422778,1604.1805,381.532358,12,0
0,0,30,30,19,51,70,149,99,248,0.000333,0.506687,9,13680.55969,760.031094,1520.062188,370.004315,12,0
0,0,29,29,23,46,69,161,98,259,0.000333,0.527369,22,34806.37236,1933.687353,1582.107834,358.125775,11,0
0,0,29,29,23,46,69,161,98,259,0.000333,0.527369,22,34806.37236,1933.687353,1582.107834,358.125775,11,0
0,0,29,29,23,46,69,161,98,259,0.000333,0.527369,22,34806.37236,1933.687353,1582.107834,358.125775,11,0
0,0,29,29,23,46,69,161,98,259,0.000333,0.527369,22,34806.37236,1933.687353,1582.107834,358.125775,11,0
0,0,33,33,20,51,71,159,115,274,0.000333,0.561677,20,33700.61422,1872.256345,1685.030711,375.732254,12,0
0,0,31,31,19,50,69,152,103,255,0.000333,0.519225,18,28038.12726,1557.673736,1557.673736,362.903432,11,0
0,0,24,24,20,44,64,131,87,218,0.000333,0.436,10,13080,726.666667,1308,326.653553,9,0
0,0,19,19,18,44,62,101,73,174,0.000333,0.345343,9,9324.271422,518.015079,1036.030158,315.273641,7,0
0,0,18,18,16,43,59,98,69,167,0.000333,0.327467,8,7859.211114,436.62284,982.401389,297.329384,7,0
0,0,18,18,17,42,59,99,68,167,0.000333,0.327467,8,7859.211114,436.62284,982.401389,295.9642,7,0
0,0,19,19,18,44,62,101,73,174,0.000333,0.345343,9,9324.271422,518.015079,1036.030158,315.273641,7,0
0,0,19,19,18,44,62,101,73,174,0.000333,0.345343,9,9324.271422,518.015079,1036.030158,315.273641,7,0
0,0,21,21,18,45,63,109,84,193,0.000333,0.384538,9,10382.53523,576.807513,1153.615025,322.192039,7,0
0,0,21,21,19,47,66,110,85,195,0.000333,0.392886,9,10607.91168,589.328427,1178.656853,341.776299,7,0
0,0,27,27,19,46,65,136,88,224,0.000333,0.44967,9,12141.09351,674.505195,1349.01039,334.794473,10,0
0,0,27,27,19,46,65,136,88,224,0.000333,0.44967,9,12141.09351,674.505195,1349.01039,334.794473,10,0
0,0,19,19,18,44,62,101,73,174,0.000333,0.345343,9,9324.271422,518.015079,1036.030158,315.273641,7,0
0,0,19,19,19,43,62,102,72,174,0.000333,0.345343,9,9324.271422,518.015079,1036.030158,314.040007,7,0
0,0,18,18,14,25,39,60,59,119,0.000333,0.209654,14,8805.480097,489.193339,628.962864,169.399374,3,0
0,0,37,37,23,61,84,163,132,295,0.000333,0.628578,22,41486.14007,2304.78556,1885.73364,465.816903,12,0
0,0,10,10,12,18,30,44,32,76,0.000333,0.124308,6,2237.542112,124.307895,372.923685,118.0782,3,0
0,0,10,10,14,19,33,46,34,80,0.000333,0.134517,7,2824.860707,156.936706,403.55153,134.013592,4,0
0,0,18,18,15,25,40,66,56,122,0.000333,0.216425,14,9089.853186,504.991844,649.275228,174.699764,3,0
0,0,37,37,23,60,83,169,129,298,0.000333,0.633254,22,41794.75851,2321.931028,1899.761751,458.455361,12,0
0,0,16,16,14,23,37,58,49,107,0.000333,0.185804,14,7803.761142,433.542286,557.41151,157.344894,3,0
0,0,35,35,23,59,82,161,122,283,0.000333,0.599729,22,39582.11878,2199.006599,1799.187217,451.117865,12,0
0,0,17,17,14,24,38,66,53,119,0.000333,0.208168,14,8743.047237,485.724847,624.503374,163.342069,3,0
0,0,36,36,23,60,83,169,126,295,0.000333,0.626879,22,41374.00591,2298.555884,1880.636632,458.455361,12,0
0,0,16,16,14,22,36,56,48,104,0.000333,0.179224,14,7527.410802,418.189489,537.6722,151.410465,3,0
0,0,35,35,24,58,82,159,121,280,0.000333,0.593372,24,42722.74947,2373.486082,1780.114561,449.801998,12,0
0,0,32,32,21,50,71,157,105,262,0.000333,0.537078,20,32224.67491,1790.259717,1611.233745,374.431475,11,0
0,0,30,30,19,50,69,148,102,250,0.000333,0.509044,18,27488.36006,1527.131114,1527.131114,362.903432,11,0
0,0,30,30,19,50,69,149,99,248,0.000333,0.504971,9,13634.22659,757.457033,1514.914065,362.903432,11,0
0,0,17,17,16,21,37,56,65,121,0.000333,0.210115,24,15128.25257,840.458476,630.343857,156.238666,1,0
0,0,15,15,16,22,38,52,51,103,0.000333,0.180179,16,8648.584542,480.476919,540.536534,162.107496,1,0
0,0,9,9,14,17,31,39,31,70,0.000333,0.115598,7,2427.556192,134.864233,346.793742,122.789837,1,0
0,0,32,32,19,50,69,158,105,263,0.000333,0.535514,18,28917.75478,1606.541932,1606.541932,362.903432,11,0
0,0,31,31,19,50,69,152,103,255,0.000333,0.519225,18,28038.12726,1557.673736,1557.673736,362.903432,11,0
0,0,33,33,20,51,71,159,115,274,0.000333,0.561677,20,33700.61422,1872.256345,1685.030711,375.732254,12,0
0,0,14,14,13,20,33,49,45,94,0.000333,0.158058,12,5690.076567,316.115365,474.173047,134.544278,1,0
0,0,31,31,19,50,69,152,109,261,0.000333,0.531442,18,28697.8479,1594.324883,1594.324883,362.903432,11,0
0,0,31,31,19,52,71,153,104,257,0.000333,0.526828,18,28448.73018,1580.48501,1580.48501,377.133488,11,0
0,0,20,20,18,46,64,104,75,179,0.000333,0.358,9,9666,537,1074,329.1425,8,0
0,0,20,20,18,46,64,104,75,179,0.000333,0.358,9,9666,537,1074,329.1425,8,0
0,0,22,22,20,46,66,109,78,187,0.000333,0.376767,10,11303.017,627.945389,1130.3017,340.522412,8,0
0,0,12,12,14,17,31,43,32,75,0.000333,0.123855,7,2600.953063,144.497392,371.564723,122.789837,2,0
0,0,12,12,13,17,30,42,32,74,0.000333,0.121037,6,2178.659424,121.036635,363.109904,117.592585,2,0
0,0,12,12,14,17,31,43,32,75,0.000333,0.123855,7,2600.953063,144.497392,371.564723,122.789837,2,0
0,0,12,12,13,17,30,42,32,74,0.000333,0.121037,6,2178.659424,121.036635,363.109904,117.592585,2,0
0,0,12,12,13,15,28,42,31,73,0.000333,0.116979,12,4211.242912,233.95794,350.936909,106.709075,2,0
0,0,12,12,13,16,29,42,31,73,0.000333,0.118211,6,2127.795676,118.210871,354.632613,112.105716,2,0
0,0,12,12,13,16,29,42,31,73,0.000333,0.118211,6,2127.795676,118.210871,354.632613,112.105716,2,0
0,0,12,12,13,16,29,42,31,73,0.000333,0.118211,6,2127.795676,118.210871,354.632613,112.105716,2,0
0,0,12,12,13,16,29,42,31,73,0.000333,0.118211,6,2127.795676,118.210871,354.632613,112.105716,2,0
0,0,15,15,14,18,32,53,37,90,0.000333,0.15,14,6300,350,450,128.361619,2,0
0,0,14,14,14,16,30,46,34,80,0.000333,0.13085,14,5495.717467,305.317637,392.551248,117.302969,2,0
0,0,14,14,14,16,30,46,34,80,0.000333,0.13085,14,5495.717467,305.317637,392.551248,117.302969,2,0
0,0,11,11,12,15,27,39,30,69,0.000333,0.109362,12,3937.046852,218.724825,328.087238,101.622909,1,0
0,0,13,13,15,16,31,48,37,85,0.000333,0.140369,14,5895.493609,327.527423,421.106686,122.603359,2,0
0,0,30,30,19,49,68,148,100,248,0.000333,0.50323,18,27174.43412,1509.690785,1509.690785,355.831405,11,0
0,0,30,30,20,51,71,149,100,249,0.000333,0.510429,10,15312.87033,850.715018,1531.287033,375.732254,11,0
0,0,27,27,19,46,65,136,88,224,0.000333,0.44967,9,12141.09351,674.505195,1349.01039,334.794473,10,0
0,0,13,13,15,20,35,51,37,88,0.000333,0.150459,7,3159.638338,175.535463,451.376905,145.041921,4,0
0,0,29,29,21,46,67,141,91,232,0.000333,0.469111,10,14073.32692,781.851496,1407.332692,346.322516,10,0
0,0,27,27,19,46,65,136,88,224,0.000333,0.44967,9,12141.09351,674.505195,1349.01039,334.794473,10,0
0,0,27,27,19,47,66,136,89,225,0.000333,0.45333,9,12239.89809,679.994338,1359.988677,341.776299,10,0
0,0,27,27,19,47,66,136,89,225,0.000333,0.45333,9,12239.89809,679.994338,1359.988677,341.776299,10,0
0,0,27,27,19,46,65,136,88,224,0.000333,0.44967,9,12141.09351,674.505195,1349.01039,334.794473,10,0
0,0,27,27,19,46,65,136,88,224,0.000333,0.44967,9,12141.09351,674.505195,1349.01039,334.794473,10,0
0,0,27,27,19,45,64,136,88,224,0.000333,0.448,9,12096,672,1344,327.844012,10,0
0,0,27,27,19,46,65,136,89,225,0.000333,0.451678,9,12195.29482,677.516379,1355.032758,334.794473,10,0
0,0,30,30,19,49,68,149,98,247,0.000333,0.501201,18,27064.85979,1503.603322,1503.603322,355.831405,12,0
0,0,30,30,19,50,69,149,99,248,0.000333,0.504971,9,13634.22659,757.457033,1514.914065,362.903432,12,0
0,0,32,32,21,52,73,158,116,274,0.000333,0.565337,20,33920.23858,1884.457699,1696.011929,388.661531,11,0
0,0,29,29,19,49,68,146,97,243,0.000333,0.493084,9,13313.28123,739.626735,1479.25347,355.831405,11,0
0,0,27,27,19,46,65,136,88,224,0.000333,0.44967,9,12141.09351,674.505195,1349.01039,334.794473,10,0
0,0,19,19,18,45,63,101,74,175,0.000333,0.348675,9,9414.21588,523.011993,1046.023987,322.192039,7,0
0,0,34,34,19,53,72,164,114,278,0.000333,0.571746,18,30874.30471,1715.23915,1715.23915,384.290407,12,0
0,0,30,30,19,50,69,149,99,248,0.000333,0.504971,9,13634.22659,757.457033,1514.914065,362.903432,11,0
0,0,20,20,18,45,63,105,75,180,0.000333,0.358637,9,9683.193476,537.955193,1075.910386,322.192039,8,0
0,0,32,32,21,50,71,157,105,262,0.000333,0.537078,20,32224.67491,1790.259717,1611.233745,374.431475,11,0
0,0,30,30,21,47,68,147,96,243,0.000333,0.493084,20,29585.06941,1643.614967,1479.25347,353.304342,10,0
0,0,29,29,21,47,68,145,92,237,0.000333,0.48091,10,14427.28693,801.515941,1442.728693,353.304342,10,0
0,0,35,35,26,62,88,160,127,287,0.000333,0.617952,26,48200.27874,2677.793263,1853.856875,491.371604,12,0
0,0,16,16,16,25,41,57,54,111,0.000333,0.198229,16,9515.01236,528.611798,594.688273,180.096405,3,0
0,0,10,10,16,19,35,45,36,81,0.000333,0.138491,8,3323.775395,184.654189,415.471924,144.710623,4,0
0,0,10,10,14,18,32,43,34,77,0.000333,0.128333,7,2695,149.722222,385,128.361619,3,0
0,0,10,10,15,21,36,47,36,83,0.000333,0.143035,7,3003.726426,166.87369,429.103775,150.842025,4,0
0,0,10,10,13,20,33,45,34,79,0.000333,0.132836,6,2391.042813,132.835712,398.507135,134.544278,3,0
0,0,15,15,15,21,36,57,39,96,0.000333,0.165438,7,3474.189601,193.010533,496.3128,150.842025,6,0
0,0,15,15,15,21,36,57,39,96,0.000333,0.165438,7,3474.189601,193.010533,496.3128,150.842025,6,0
0,0,15,15,13,20,33,53,37,90,0.000333,0.151332,6,2723.972824,151.331824,453.995471,134.544278,5,0
0,0,15,15,13,20,33,53,37,90,0.000333,0.151332,6,2723.972824,151.331824,453.995471,134.544278,5,0
0,0,30,30,20,47,67,146,102,248,0.000333,0.501463,20,30087.80239,1671.544577,1504.390119,347.504238,10,0
0,0,32,32,23,54,77,151,107,258,0.000333,0.538944,11,17785.1402,988.063345,1616.830927,414.80585,12,0
0,0,13,13,13,18,31,48,34,82,0.000333,0.135415,6,2437.464585,135.414699,406.244097,123.164366,3,0
0,0,32,32,20,49,69,156,108,264,0.000333,0.53755,20,32253.00913,1791.833841,1612.650457,361.559344,11,0
0,0,32,32,21,51,72,157,109,266,0.000333,0.547067,20,32824.00101,1823.555612,1641.20005,381.532358,11,0
0,0,20,20,18,44,62,105,74,179,0.000333,0.355267,9,9592.210256,532.90057,1065.80114,315.273641,8,0
0,0,35,35,24,53,77,152,105,257,0.000333,0.536855,12,19326.76969,1073.709427,1610.564141,413.618884,12,0
0,0,35,35,24,52,76,152,105,257,0.000333,0.535239,24,38537.2169,2140.956495,1605.717371,406.461965,12,0
0,0,19,19,14,22,36,62,42,104,0.000333,0.179224,7,3763.705401,209.094745,537.6722,151.410465,5,0
0,0,19,19,14,21,35,62,42,104,0.000333,0.177815,14,7468.236073,414.902004,533.445434,145.541635,5,0
0,0,20,20,18,45,63,104,75,179,0.000333,0.356644,9,9629.397957,534.966553,1069.933106,322.192039,8,0
0,0,32,32,21,52,73,158,113,271,0.000333,0.559147,20,33548.84911,1863.824951,1677.442455,388.661531,11,0
0,0,30,30,19,49,68,149,98,247,0.000333,0.501201,18,27064.85979,1503.603322,1503.603322,355.831405,12,0
0,0,30,30,19,49,68,150,98,248,0.000333,0.50323,18,27174.43412,1509.690785,1509.690785,355.831405,11,0
0,0,27,27,20,47,67,144,95,239,0.000333,0.483265,20,28995.90633,1610.883685,1449.795317,347.504238,11,0
0,0,31,31,23,53,76,145,101,246,0.000333,0.51233,11,16906.89185,939.27177,1536.990168,407.621709,12,0
0,0,31,31,23,53,76,144,101,245,0.000333,0.510247,11,16838.16465,935.453592,1530.742241,407.621709,12,0
0,0,15,15,13,20,33,55,38,93,0.000333,0.156376,6,2814.771919,156.376218,469.128653,134.544278,5,0
0,0,15,15,13,20,33,54,38,92,0.000333,0.154695,6,2784.505554,154.694753,464.084259,134.544278,5,0
0,0,29,29,21,47,68,145,102,247,0.000333,0.501201,20,30072.06644,1670.670358,1503.603322,353.304342,9,0
0,0,29,29,22,48,70,146,108,254,0.000333,0.518946,22,34250.4335,1902.801861,1556.837886,366.185696,9,0
0,0,27,27,19,45,64,135,90,225,0.000333,0.45,18,24300,1350,1350,327.844012,9,0
0,0,27,27,20,47,67,136,90,226,0.000333,0.456979,10,13709.36157,761.631198,1370.936157,347.504238,9,0
0,0,10,10,15,21,36,47,36,83,0.000333,0.143035,7,3003.726426,166.87369,429.103775,150.842025,4,0
0,0,10,10,13,20,33,45,34,79,0.000333,0.132836,6,2391.042813,132.835712,398.507135,134.544278,3,0
0,0,10,10,16,19,35,45,36,81,0.000333,0.138491,8,3323.775395,184.654189,415.471924,144.710623,4,0
0,0,10,10,14,18,32,43,34,77,0.000333,0.128333,7,2695,149.722222,385,128.361619,3,0
0,0,18,18,20,31,51,75,67,142,0.000333,0.268495,20,16109.68797,894.982665,805.484399,240.018648,5,0
0,0,16,16,16,25,41,57,54,111,0.000333,0.198229,16,9515.01236,528.611798,594.688273,180.096405,3,0
0,0,11,11,12,21,33,43,37,80,0.000333,0.134517,6,2421.309177,134.517177,403.55153,135.258216,3,0
0,0,11,11,14,22,36,45,39,84,0.000333,0.144758,7,3039.915901,168.884217,434.2737,151.410465,4,0
0,0,18,18,14,26,40,59,60,119,0.000333,0.211103,14,8866.332206,492.574011,633.309443,175.514402,3,0
0,0,20,20,18,32,50,77,73,150,0.000333,0.282193,18,15238.41171,846.578428,846.578428,235.05865,5,0
0,0,13,13,13,19,32,47,35,82,0.000333,0.136667,6,2460,136.666667,410,128.816339,3,0
0,0,12,12,15,19,34,47,35,82,0.000333,0.139057,7,2920.203671,162.233537,417.171953,139.313982,4,0
0,0,21,21,22,32,54,83,83,166,0.000333,0.318437,22,21016.84916,1167.602731,955.311325,258.107496,5,0
0,0,18,18,17,24,41,61,68,129,0.000333,0.230375,16,11057.98734,614.33263,691.124209,179.525968,3,0
0,0,31,31,19,52,71,153,104,257,0.000333,0.526828,18,28448.73018,1580.48501,1580.48501,377.133488,11,0
0,0,22,22,18,48,66,123,85,208,0.000333,0.419078,9,11315.10579,628.616988,1257.233977,343.13685,9,0
0,0,22,22,19,47,66,124,84,208,0.000333,0.419078,9,11315.10579,628.616988,1257.233977,341.776299,9,0
0,0,22,22,19,47,66,124,84,208,0.000333,0.419078,9,11315.10579,628.616988,1257.233977,341.776299,9,0
0,0,22,22,18,48,66,123,85,208,0.000333,0.419078,9,11315.10579,628.616988,1257.233977,343.13685,9,0
0,0,22,22,19,47,66,124,84,208,0.000333,0.419078,9,11315.10579,628.616988,1257.233977,341.776299,9,0
0,0,11,11,12,15,27,39,30,69,0.000333,0.109362,12,3937.046852,218.724825,328.087238,101.622909,1,0
0,0,16,16,15,25,40,59,56,115,0.000333,0.204007,14,8568.304233,476.016902,612.021731,174.699764,5,0
0,0,16,16,15,25,40,59,56,115,0.000333,0.204007,14,8568.304233,476.016902,612.021731,174.699764,5,0
0,0,16,16,13,24,37,55,51,106,0.000333,0.184067,12,6626.424681,368.134705,552.202057,158.144816,4,0
0,0,15,15,15,21,36,55,43,98,0.000333,0.168884,14,7093.137102,394.063172,506.65265,150.842025,4,0
0,0,23,23,18,48,66,117,84,201,0.000333,0.404974,9,10934.30896,607.461609,1214.923218,343.13685,10,0
0,0,23,23,19,47,66,118,83,201,0.000333,0.404974,9,10934.30896,607.461609,1214.923218,341.776299,10,0
0,0,23,23,19,47,66,118,83,201,0.000333,0.404974,9,10934.30896,607.461609,1214.923218,341.776299,10,0
0,0,15,15,13,20,33,53,43,96,0.000333,0.161421,12,5811.142026,322.841224,484.261835,134.544278,3,0
0,0,15,15,15,21,36,57,45,102,0.000333,0.175777,14,7382.652902,410.147383,527.33235,150.842025,4,0
0,0,20,20,18,47,65,104,76,180,0.000333,0.361342,9,9756.235857,542.013103,1084.026206,336.124326,8,0
0,0,30,30,19,49,68,149,98,247,0.000333,0.501201,18,27064.85979,1503.603322,1503.603322,355.831405,12,0
0,0,27,27,19,47,66,136,89,225,0.000333,0.45333,9,12239.89809,679.994338,1359.988677,341.776299,10,0
0,0,27,27,19,47,66,136,89,225,0.000333,0.45333,9,12239.89809,679.994338,1359.988677,341.776299,10,0
0,0,27,27,19,46,65,136,88,224,0.000333,0.44967,9,12141.09351,674.505195,1349.01039,334.794473,10,0
0,0,29,29,21,46,67,141,91,232,0.000333,0.469111,10,14073.32692,781.851496,1407.332692,346.322516,10,0
0,0,29,29,20,46,66,140,91,231,0.000333,0.465418,10,13962.55042,775.697245,1396.255042,340.522412,10,0
0,0,29,29,21,47,68,145,92,237,0.000333,0.48091,10,14427.28693,801.515941,1442.728693,353.304342,10,0
0,0,32,32,21,48,69,153,99,252,0.000333,0.513116,20,30786.96326,1710.386848,1539.348163,360.316866,13,0
0,0,31,31,21,48,69,150,98,248,0.000333,0.504971,20,30298.28131,1683.23785,1514.914065,360.316866,12,0
0,0,32,32,21,51,72,158,102,260,0.000333,0.534727,20,32083.61001,1782.422778,1604.1805,381.532358,12,0
0,0,35,35,24,53,77,154,105,259,0.000333,0.541033,12,19477.17257,1082.065143,1623.097714,413.618884,12,0
0,0,35,35,24,52,76,154,105,259,0.000333,0.539404,24,38837.11742,2157.617635,1618.213226,406.461965,12,0
0,0,19,19,14,22,36,64,42,106,0.000333,0.182671,7,3836.084351,213.115797,548.01205,151.410465,5,0
0,0,19,19,14,21,35,64,42,106,0.000333,0.181235,14,7611.855997,422.880889,543.704,145.541635,5,0
0,0,31,31,23,53,76,144,99,243,0.000333,0.506082,11,16700.71024,927.817236,1518.246386,407.621709,12,0
0,0,31,31,23,52,75,144,99,243,0.000333,0.504534,11,16649.63236,924.979576,1513.602942,400.46479,12,0
0,0,15,15,13,20,33,54,36,90,0.000333,0.151332,6,2723.972824,151.331824,453.995471,134.544278,5,0
0,0,15,15,13,19,32,54,36,90,0.000333,0.15,6,2700,150,450,128.816339,5,0
0,0,33,33,20,52,72,167,113,280,0.000333,0.57586,20,34551.58001,1919.532223,1727.579,382.861427,12,0
0,0,33,33,21,54,75,168,114,282,0.000333,0.585509,20,35130.53741,1951.696523,1756.526871,403.002591,12,0
0,0,37,37,23,55,78,165,112,277,0.000333,0.580352,22,38303.24112,2127.95784,1741.056415,422.016709,12,0
0,0,53,53,24,53,77,254,172,426,0.000333,0.889884,36,96107.43839,5339.302133,2669.651066,413.618884,18,0
0,0,58,58,24,53,77,275,185,460,0.000333,0.960907,36,103777.9851,5765.443617,2882.721809,413.618884,19,0
0,0,21,21,14,22,36,76,48,124,0.000333,0.21369,14,8974.989803,498.610545,641.0707,151.410465,5,0
0,0,26,26,14,22,36,97,61,158,0.000333,0.272283,14,11435.8741,635.326339,816.84815,151.410465,6,0
0,0,32,32,20,51,71,161,110,271,0.000333,0.555527,20,33331.62939,1851.757188,1666.581469,375.732254,12,0
0,0,32,32,21,53,74,162,111,273,0.000333,0.56506,20,33903.61538,1883.534188,1695.180769,395.81845,12,0
0,0,34,34,20,52,72,167,120,287,0.000333,0.590256,20,35415.36951,1967.520528,1770.768475,382.861427,12,0
0,0,34,34,21,54,75,168,123,291,0.000333,0.604195,20,36251.72478,2013.98471,1812.586239,403.002591,12,0
0,0,36,36,20,53,73,173,130,303,0.000333,0.625172,20,37510.33683,2083.907601,1875.516841,390.018346,12,0
0,0,36,36,21,55,76,174,135,309,0.000333,0.643537,20,38612.19203,2145.12178,1930.609602,410.21345,12,0
0,0,31,31,23,51,74,144,99,243,0.000333,0.502966,11,16597.86885,922.103825,1508.897168,393.335617,12,0
0,0,15,15,14,19,33,54,36,90,0.000333,0.151332,7,3177.968295,176.553794,453.995471,134.013592,5,0
0,0,32,32,25,53,78,156,110,266,0.000333,0.557306,24,40126.00777,2229.222654,1671.91699,419.676189,12,0
0,0,16,16,16,22,38,66,47,113,0.000333,0.197672,16,9488.252944,527.125164,593.015809,162.107496,5,0
0,0,31,31,23,53,76,145,101,246,0.000333,0.51233,11,16906.89185,939.27177,1536.990168,407.621709,12,0
0,0,31,31,23,53,76,144,101,245,0.000333,0.510247,11,16838.16465,935.453592,1530.742241,407.621709,12,0
0,0,15,15,13,20,33,55,38,93,0.000333,0.156376,6,2814.771919,156.376218,469.128653,134.544278,5,0
0,0,15,15,13,20,33,54,38,92,0.000333,0.154695,6,2784.505554,154.694753,464.084259,134.544278,5,0
0,0,33,33,20,50,70,159,111,270,0.000333,0.551635,20,33098.12829,1838.784905,1654.906415,368.631371,12,0
0,0,31,31,19,50,69,152,109,261,0.000333,0.531442,18,28697.8479,1594.324883,1594.324883,362.903432,11,0
0,0,24,24,20,43,63,131,85,216,0.000333,0.430364,10,12910.92464,717.273591,1291.092463,319.767946,9,0
0,0,24,24,20,44,64,131,87,218,0.000333,0.436,10,13080,726.666667,1308,326.653553,9,0
0,0,30,30,19,50,69,149,98,247,0.000333,0.502935,9,13579.24987,754.40277,1508.805541,362.903432,12,0
0,0,22,22,18,48,66,123,85,208,0.000333,0.419078,9,11315.10579,628.616988,1257.233977,343.13685,9,0
0,0,22,22,19,47,66,124,84,208,0.000333,0.419078,9,11315.10579,628.616988,1257.233977,341.776299,9,0
0,0,16,16,14,19,33,57,44,101,0.000333,0.169828,14,7132.773285,396.265182,509.483806,134.013592,3,0
0,0,15,15,16,19,35,57,44,101,0.000333,0.172686,16,8288.921355,460.495631,518.057585,144.710623,4,0
0,0,10,10,13,16,29,45,30,75,0.000333,0.12145,6,2186.091448,121.449525,364.348575,112.105716,3,0
0,0,10,10,15,17,32,47,32,79,0.000333,0.131667,7,2765,153.611111,395,128.090227,4,0
0,0,11,11,13,20,33,45,34,79,0.000333,0.132836,6,2391.042813,132.835712,398.507135,134.544278,3,0
0,0,11,11,15,21,36,47,36,83,0.000333,0.143035,7,3003.726426,166.87369,429.103775,150.842025,4,0
0,0,15,15,14,19,33,55,40,95,0.000333,0.159739,14,6709.044179,372.724677,479.217441,134.013592,3,0
0,0,14,14,16,19,35,55,40,95,0.000333,0.162427,16,7796.510186,433.139455,487.281887,144.710623,4,0
0,0,18,18,15,26,41,65,57,122,0.000333,0.217874,14,9150.698824,508.372157,653.621345,180.814792,3,0
0,0,18,18,17,27,44,69,59,128,0.000333,0.232936,16,11180.91596,621.161997,698.807247,197.868831,4,0
0,0,15,15,13,19,32,54,42,96,0.000333,0.16,12,5760,320,480,128.816339,3,0
0,0,14,14,15,19,34,54,42,96,0.000333,0.162799,14,6837.550059,379.863892,488.396433,139.313982,4,0
0,0,30,30,19,50,69,149,98,247,0.000333,0.502935,9,13579.24987,754.40277,1508.805541,362.903432,12,0
0,0,15,15,13,22,35,53,46,99,0.000333,0.169266,12,6093.588224,338.532679,507.799019,146.213212,3,0
0,0,14,14,15,22,37,53,46,99,0.000333,0.171912,14,7220.302365,401.127909,515.735883,156.710855,4,0
0,0,17,17,13,23,36,58,58,116,0.000333,0.199904,12,7196.535602,399.807533,599.7113,152.147641,3,0
0,0,16,16,15,23,38,58,58,116,0.000333,0.20292,14,8522.634282,473.479682,608.759592,162.645284,4,0
0,0,10,10,15,21,36,47,36,83,0.000333,0.143035,7,3003.726426,166.87369,429.103775,150.842025,4,0
0,0,10,10,13,20,33,45,34,79,0.000333,0.132836,6,2391.042813,132.835712,398.507135,134.544278,3,0
0,0,19,19,18,45,63,101,74,175,0.000333,0.348675,9,9414.21588,523.011993,1046.023987,322.192039,7,0
0,0,24,24,19,49,68,123,90,213,0.000333,0.43221,9,11669.66627,648.314793,1296.629585,355.831405,9,0
0,0,24,24,19,48,67,124,91,215,0.000333,0.434736,9,11737.88258,652.104588,1304.209176,348.788823,9,0
0,0,22,22,18,48,66,114,83,197,0.000333,0.396915,9,10716.71077,595.372821,1190.745642,343.13685,9,0
0,0,22,22,19,47,66,115,82,197,0.000333,0.396915,9,10716.71077,595.372821,1190.745642,341.776299,9,0
0,0,22,22,18,48,66,114,83,197,0.000333,0.396915,9,10716.71077,595.372821,1190.745642,343.13685,9,0
0,0,22,22,19,47,66,115,82,197,0.000333,0.396915,9,10716.71077,595.372821,1190.745642,341.776299,9,0
0,0,22,22,19,47,66,115,82,197,0.000333,0.396915,9,10716.71077,595.372821,1190.745642,341.776299,9,0
0,0,22,22,18,48,66,114,83,197,0.000333,0.396915,9,10716.71077,595.372821,1190.745642,343.13685,9,0
0,0,22,22,19,47,66,115,82,197,0.000333,0.396915,9,10716.71077,595.372821,1190.745642,341.776299,9,0
0,0,22,22,19,47,66,115,82,197,0.000333,0.396915,9,10716.71077,595.372821,1190.745642,341.776299,9,0
0,0,24,24,18,49,67,123,89,212,0.000333,0.42867,9,11574.09818,643.005454,1286.010908,350.179432,9,0
0,0,24,24,19,48,67,124,88,212,0.000333,0.42867,9,11574.09818,643.005454,1286.010908,348.788823,9,0
0,0,22,22,18,48,66,114,83,197,0.000333,0.396915,9,10716.71077,595.372821,1190.745642,343.13685,9,0
0,0,21,21,16,47,63,111,79,190,0.000333,0.378561,8,9085.465484,504.748082,1135.683185,325.065676,9,0
0,0,21,21,17,46,63,112,78,190,0.000333,0.378561,8,9085.465484,504.748082,1135.683185,323.570718,9,0
0,0,22,22,20,47,67,114,89,203,0.000333,0.410472,10,12314.16106,684.120059,1231.416106,347.504238,7,0
0,0,17,17,17,42,59,100,71,171,0.000333,0.335311,8,8047.455692,447.080872,1005.931961,295.9642,7,0
0,0,14,14,15,21,36,49,49,98,0.000333,0.168884,14,7093.137102,394.063172,506.65265,150.842025,1,0
0,0,8,8,12,16,28,36,29,65,0.000333,0.104159,6,1874.86842,104.159357,312.47807,107.01955,1,0
0,0,12,12,13,15,28,42,31,73,0.000333,0.116979,12,4211.242912,233.95794,350.936909,106.709075,2,0
0,0,12,12,13,15,28,42,31,73,0.000333,0.116979,12,4211.242912,233.95794,350.936909,106.709075,2,0
0,0,19,19,18,45,63,101,74,175,0.000333,0.348675,9,9414.21588,523.011993,1046.023987,322.192039,7,0
0,0,16,16,16,20,36,53,63,116,0.000333,0.199904,24,14393.0712,799.615067,599.7113,150.438562,1,0
0,0,8,8,12,15,27,34,29,63,0.000333,0.099853,6,1797.347476,99.852638,299.557913,101.622909,1,0
0,0,20,20,19,46,65,104,75,179,0.000333,0.359335,9,9702.034547,539.001919,1078.003839,334.794473,8,0
0,0,19,19,18,44,62,102,73,175,0.000333,0.347328,9,9377.859189,520.992177,1041.984354,315.273641,7,0
0,0,21,21,21,46,67,110,81,191,0.000333,0.386208,10,11586.23035,643.679464,1158.623035,346.322516,8,0
0,0,20,20,18,45,63,104,75,179,0.000333,0.356644,9,9629.397957,534.966553,1069.933106,322.192039,8,0
0,0,32,32,21,49,70,154,100,254,0.000333,0.518946,20,31136.75773,1729.819874,1556.837886,367.359448,13,0
0,0,32,32,21,49,70,153,100,253,0.000333,0.516903,20,31014.17207,1723.009559,1550.708603,367.359448,13,0
0,0,20,20,18,47,65,104,76,180,0.000333,0.361342,9,9756.235857,542.013103,1084.026206,336.124326,8,0
0,0,22,22,20,47,67,113,79,192,0.000333,0.38823,10,11646.89125,647.049514,1164.689125,347.504238,8,0
0,0,29,29,20,47,67,145,100,245,0.000333,0.495397,20,29723.83703,1651.32428,1486.191852,347.504238,10,0
0,0,31,31,20,48,68,151,110,261,0.000333,0.529609,20,31776.55603,1765.364224,1588.827802,354.516762,10,0
0,0,27,27,19,46,65,136,89,225,0.000333,0.451678,9,12195.29482,677.516379,1355.032758,334.794473,9,0
0,0,27,27,19,46,65,135,91,226,0.000333,0.453685,9,12249.49613,680.527563,1361.055126,334.794473,9,0
0,0,14,14,10,18,28,49,64,113,0.000333,0.181077,15,8148.466593,452.692588,543.231106,108.277931,1,0
0,0,32,32,21,48,69,153,99,252,0.000333,0.513116,20,30786.96326,1710.386848,1539.348163,360.316866,13,0
0,0,32,32,21,48,69,153,99,252,0.000333,0.513116,20,30786.96326,1710.386848,1539.348163,360.316866,13,0
0,0,15,15,13,21,34,57,49,106,0.000333,0.179757,12,6471.252734,359.514041,539.271061,140.344382,1,0
0,0,30,30,19,50,69,149,99,248,0.000333,0.504971,9,13634.22659,757.457033,1514.914065,362.903432,11,0
0,0,30,30,19,50,69,148,102,250,0.000333,0.509044,18,27488.36006,1527.131114,1527.131114,362.903432,11,0
0,0,31,31,19,50,69,152,109,261,0.000333,0.531442,18,28697.8479,1594.324883,1594.324883,362.903432,11,0
0,0,33,33,19,51,70,158,121,279,0.000333,0.570023,18,30781.25931,1710.069962,1710.069962,370.004315,11,0
0,0,31,31,19,52,71,153,104,257,0.000333,0.526828,18,28448.73018,1580.48501,1580.48501,377.133488,11,0
0,0,32,32,19,50,69,158,105,263,0.000333,0.535514,18,28917.75478,1606.541932,1606.541932,362.903432,11,0
0,0,35,35,19,52,71,164,133,297,0.000333,0.608825,18,32876.5481,1826.474894,1826.474894,377.133488,11,0
0,0,37,37,19,53,72,170,145,315,0.000333,0.647842,18,34983.47476,1943.526375,1943.526375,384.290407,11,0
0,0,13,13,12,19,31,44,42,86,0.000333,0.14202,12,5112.730592,284.040588,426.060883,123.730173,1,0
0,0,31,31,21,48,69,150,98,248,0.000333,0.504971,20,30298.28131,1683.23785,1514.914065,360.316866,12,0
0,0,30,30,19,50,69,148,101,249,0.000333,0.507008,18,27378.40662,1521.02259,1521.02259,362.903432,11,0
0,0,15,15,12,20,32,49,54,103,0.000333,0.171667,12,6180,343.333333,515,129.458112,1,0
0,0,19,19,18,44,62,101,73,174,0.000333,0.345343,9,9324.271422,518.015079,1036.030158,315.273641,7,0
0,0,15,15,15,22,37,57,39,96,0.000333,0.166703,7,3500.752662,194.486259,500.107523,156.710855,6,0
0,0,15,15,15,21,36,57,39,96,0.000333,0.165438,7,3474.189601,193.010533,496.3128,150.842025,6,0
0,0,15,15,13,21,34,53,37,90,0.000333,0.152624,6,2747.229934,152.623885,457.871656,140.344382,5,0
0,0,15,15,13,20,33,53,37,90,0.000333,0.151332,6,2723.972824,151.331824,453.995471,134.544278,5,0
0,0,29,29,20,46,66,143,99,242,0.000333,0.487581,20,29254.86754,1625.270419,1462.743377,340.522412,9,0
0,0,29,29,19,49,68,146,97,243,0.000333,0.493084,9,13313.28123,739.626735,1479.25347,355.831405,11,0
0,0,33,33,21,51,72,160,106,266,0.000333,0.547067,20,32824.00101,1823.555612,1641.20005,381.532358,12,0
0,0,30,30,19,49,68,149,98,247,0.000333,0.501201,18,27064.85979,1503.603322,1503.603322,355.831405,11,0
0,0,33,33,20,51,71,159,115,274,0.000333,0.561677,20,33700.61422,1872.256345,1685.030711,375.732254,12,0
0,0,31,31,19,50,69,152,103,255,0.000333,0.519225,18,28038.12726,1557.673736,1557.673736,362.903432,11,0
0,0,33,33,19,51,70,167,113,280,0.000333,0.572066,18,30891.58641,1716.199245,1716.199245,370.004315,11,0
0,0,19,19,18,44,62,102,73,175,0.000333,0.347328,9,9377.859189,520.992177,1041.984354,315.273641,7,0
0,0,14,14,13,19,32,45,35,80,0.000333,0.133333,6,2400,133.333333,400,128.816339,2,0
0,0,16,16,14,17,31,56,39,95,0.000333,0.156883,14,6589.081093,366.060061,470.648649,122.789837,2,0
0,0,15,15,14,17,31,53,37,90,0.000333,0.148626,14,6242.287351,346.793742,445.877668,122.789837,2,0
0,0,34,34,23,58,81,157,112,269,0.000333,0.568473,11,18759.61616,1042.200898,1705.419651,443.804823,14,0
0,0,34,34,23,58,81,156,112,268,0.000333,0.56636,11,18689.87781,1038.326545,1699.079801,443.804823,14,0
0,0,15,15,13,21,34,54,39,93,0.000333,0.157711,6,2838.804265,157.711348,473.134044,140.344382,5,0
0,0,15,15,13,21,34,53,39,92,0.000333,0.156016,6,2808.279488,156.015527,468.046581,140.344382,5,0
0,0,34,34,23,58,81,156,110,266,0.000333,0.562133,11,18550.40111,1030.577839,1686.400101,443.804823,14,0
0,0,34,34,23,57,80,156,110,266,0.000333,0.560544,11,18497.96161,1027.664534,1681.632873,436.516656,14,0
0,0,15,15,13,21,34,53,37,90,0.000333,0.152624,6,2747.229934,152.623885,457.871656,140.344382,5,0
0,0,15,15,13,20,33,53,37,90,0.000333,0.151332,6,2723.972824,151.331824,453.995471,134.544278,5,0
0,0,19,19,18,44,62,101,73,174,0.000333,0.345343,9,9324.271422,518.015079,1036.030158,315.273641,7,0
0,0,19,19,19,43,62,102,72,174,0.000333,0.345343,9,9324.271422,518.015079,1036.030158,314.040007,7,0
0,0,38,38,24,58,82,164,116,280,0.000333,0.593372,24,42722.74947,2373.486082,1780.114561,449.801998,14,0
0,0,38,38,24,57,81,164,116,280,0.000333,0.591719,24,42603.79202,2366.877334,1775.158001,442.513831,14,0
0,0,19,19,14,23,37,61,43,104,0.000333,0.180594,7,3792.48205,210.693447,541.78315,157.344894,5,0
0,0,19,19,14,22,36,61,43,104,0.000333,0.179224,7,3763.705401,209.094745,537.6722,151.410465,5,0
0,0,17,17,17,42,59,100,71,171,0.000333,0.335311,8,8047.455692,447.080872,1005.931961,295.9642,7,0
0,0,17,17,17,43,60,100,73,173,0.000333,0.340631,8,8175.136584,454.174255,1021.892073,302.816253,7,0
0,0,20,20,18,46,64,104,75,179,0.000333,0.358,9,9666,537,1074,329.1425,8,0
0,0,34,34,23,58,81,157,112,269,0.000333,0.568473,11,18759.61616,1042.200898,1705.419651,443.804823,14,0
0,0,34,34,23,58,81,156,112,268,0.000333,0.56636,11,18689.87781,1038.326545,1699.079801,443.804823,14,0
0,0,15,15,13,21,34,54,39,93,0.000333,0.157711,6,2838.804265,157.711348,473.134044,140.344382,5,0
0,0,15,15,13,21,34,53,39,92,0.000333,0.156016,6,2808.279488,156.015527,468.046581,140.344382,5,0
0,0,40,40,23,60,83,177,123,300,0.000333,0.637504,22,42075.26025,2337.514458,1912.511829,458.455361,14,0
0,0,59,59,24,58,82,279,193,472,0.000333,1.000255,36,108027.5237,6001.529092,3000.764546,449.801998,22,0
0,0,64,64,24,58,82,299,207,506,0.000333,1.072307,36,115809.1673,6433.842629,3216.921314,449.801998,23,0
0,0,21,21,14,23,37,75,49,124,0.000333,0.215324,14,9043.611043,502.422836,645.972217,157.344894,5,0
0,0,26,26,14,23,37,95,63,158,0.000333,0.274365,14,11523.31085,640.183936,823.093632,157.344894,6,0
0,0,28,28,19,45,64,139,92,231,0.000333,0.462,18,24948,1386,1386,327.844012,9,0
0,0,9,9,14,17,31,39,31,70,0.000333,0.115598,7,2427.556192,134.864233,346.793742,122.789837,1,0
0,0,19,19,18,44,62,101,73,174,0.000333,0.345343,9,9324.271422,518.015079,1036.030158,315.273641,7,0
0,0,20,20,18,45,63,104,74,178,0.000333,0.354652,9,9575.602437,531.977913,1063.955826,322.192039,8,0
0,0,29,29,21,46,67,144,95,239,0.000333,0.483265,20,28995.90633,1610.883685,1449.795317,346.322516,9,0
0,0,28,28,19,48,67,140,94,234,0.000333,0.473155,9,12775.18384,709.732435,1419.464871,348.788823,9,0
0,0,29,29,19,46,65,145,95,240,0.000333,0.481789,18,26016.62895,1445.368275,1445.368275,334.794473,9,0
0,0,20,20,18,45,63,104,74,178,0.000333,0.354652,9,9575.602437,531.977913,1063.955826,322.192039,8,0
0,0,30,30,20,47,67,146,105,251,0.000333,0.507529,20,30451.76774,1691.764874,1522.588387,347.504238,10,0
0,0,28,28,19,46,65,139,93,232,0.000333,0.46573,18,25149.40799,1397.189333,1397.189333,334.794473,9,0
0,0,26,26,19,45,64,133,87,220,0.000333,0.44,9,11880,660,1320,327.844012,9,0
0,0,30,30,21,47,68,147,96,243,0.000333,0.493084,20,29585.06941,1643.614967,1479.25347,353.304342,10,0
0,0,24,24,20,43,63,131,85,216,0.000333,0.430364,10,12910.92464,717.273591,1291.092463,319.767946,9,0
0,0,15,15,15,21,36,59,40,99,0.000333,0.170608,7,3582.758026,199.042113,511.822575,150.842025,6,0
0,0,15,15,15,21,36,58,40,98,0.000333,0.168884,7,3546.568551,197.031586,506.65265,150.842025,6,0
0,0,19,19,18,44,62,102,73,175,0.000333,0.347328,9,9377.859189,520.992177,1041.984354,315.273641,7,0
0,0,12,12,13,16,29,42,31,73,0.000333,0.118211,6,2127.795676,118.210871,354.632613,112.105716,2,0
0,0,12,12,13,16,29,42,31,73,0.000333,0.118211,6,2127.795676,118.210871,354.632613,112.105716,2,0
0,0,9,9,14,16,30,37,31,68,0.000333,0.111223,7,2335.679924,129.759996,333.668561,117.302969,1,0
0,0,19,19,18,45,63,101,74,175,0.000333,0.348675,9,9414.21588,523.011993,1046.023987,322.192039,7,0
0,0,12,12,13,16,29,42,31,73,0.000333,0.118211,6,2127.795676,118.210871,354.632613,112.105716,2,0
0,0,12,12,13,16,29,42,31,73,0.000333,0.118211,6,2127.795676,118.210871,354.632613,112.105716,2,0
0,0,10,10,13,15,28,33,26,59,0.000333,0.094545,6,1701.803642,94.544647,283.63394,106.709075,2,0
0,0,10,10,13,15,28,33,26,59,0.000333,0.094545,6,1701.803642,94.544647,283.63394,106.709075,2,0
0,0,34,34,22,49,71,155,101,256,0.000333,0.524778,22,34635.37578,1924.187543,1574.335263,373.228278,13,0
0,0,34,34,22,49,71,155,101,256,0.000333,0.524778,22,34635.37578,1924.187543,1574.335263,373.228278,13,0
0,0,19,19,16,23,39,68,44,112,0.000333,0.197322,8,4735.720388,263.095577,591.965049,168.041925,6,0
0,0,19,19,16,22,38,68,44,112,0.000333,0.195923,16,9404.286104,522.460339,587.767882,162.107496,6,0
0,0,19,19,18,45,63,101,74,175,0.000333,0.348675,9,9414.21588,523.011993,1046.023987,322.192039,7,0
0,0,32,32,21,50,71,151,99,250,0.000333,0.512479,10,15374.3678,854.131544,1537.43678,374.431475,13,0
0,0,32,32,21,50,71,150,99,249,0.000333,0.510429,10,15312.87033,850.715018,1531.287033,374.431475,13,0
0,0,16,16,15,22,37,60,50,110,0.000333,0.191013,14,8022.558183,445.697677,573.03987,156.710855,5,0
0,0,16,16,15,22,37,60,50,110,0.000333,0.191013,14,8022.558183,445.697677,573.03987,156.710855,5,0
0,0,22,22,20,47,67,113,79,192,0.000333,0.38823,10,11646.89125,647.049514,1164.689125,347.504238,8,0
0,0,20,20,18,47,65,104,76,180,0.000333,0.361342,9,9756.235857,542.013103,1084.026206,336.124326,8,0
0,0,34,34,23,58,81,156,110,266,0.000333,0.562133,11,18550.40111,1030.577839,1686.400101,443.804823,14,0
0,0,34,34,23,57,80,156,110,266,0.000333,0.560544,11,18497.96161,1027.664534,1681.632873,436.516656,14,0
0,0,15,15,13,21,34,53,37,90,0.000333,0.152624,6,2747.229934,152.623885,457.871656,140.344382,5,0
0,0,15,15,13,20,33,53,37,90,0.000333,0.151332,6,2723.972824,151.331824,453.995471,134.544278,5,0
0,0,22,22,20,47,67,113,79,192,0.000333,0.38823,10,11646.89125,647.049514,1164.689125,347.504238,8,0
0,0,20,20,18,47,65,104,76,180,0.000333,0.361342,9,9756.235857,542.013103,1084.026206,336.124326,8,0
0,0,38,38,24,58,82,166,116,282,0.000333,0.59761,24,43027.91197,2390.439554,1792.829665,449.801998,14,0
0,0,38,38,24,57,81,166,116,282,0.000333,0.595946,24,42908.10482,2383.783601,1787.837701,442.513831,14,0
0,0,19,19,14,23,37,63,43,106,0.000333,0.184067,7,3865.414397,214.745244,552.202057,157.344894,5,0
0,0,19,19,14,22,36,63,43,106,0.000333,0.182671,7,3836.084351,213.115797,548.01205,151.410465,5,0
0,0,21,21,21,46,67,110,81,191,0.000333,0.386208,10,11586.23035,643.679464,1158.623035,346.322516,8,0
0,0,30,30,21,47,68,147,96,243,0.000333,0.493084,20,29585.06941,1643.614967,1479.25347,353.304342,10,0
0,0,20,20,18,45,63,104,75,179,0.000333,0.356644,9,9629.397957,534.966553,1069.933106,322.192039,8,0
0,0,28,28,19,48,67,140,94,234,0.000333,0.473155,9,12775.18384,709.732435,1419.464871,348.788823,9,0
0,0,28,28,19,46,65,139,99,238,0.000333,0.477775,18,25799.82371,1433.32354,1433.32354,334.794473,9,0
0,0,9,9,12,14,26,30,25,55,0.000333,0.086175,6,1551.145107,86.174728,258.524184,96.322519,1,0
0,0,13,13,15,20,35,51,37,88,0.000333,0.150459,7,3159.638338,175.535463,451.376905,145.041921,4,0
0,0,19,19,13,24,37,63,70,133,0.000333,0.230952,12,8314.287572,461.904865,692.857298,158.144816,3,0
0,0,38,38,23,60,83,166,143,309,0.000333,0.656629,22,43337.51805,2407.639892,1969.887184,458.455361,12,0
0,0,10,10,13,14,27,34,25,59,0.000333,0.093513,6,1683.230176,93.512788,280.538363,101.408685,2,0
0,0,10,10,13,14,27,34,25,59,0.000333,0.093513,6,1683.230176,93.512788,280.538363,101.408685,2,0
0,0,11,11,15,17,32,40,31,71,0.000333,0.118333,7,2485,138.055556,355,128.090227,2,0
0,0,9,9,12,13,25,31,24,55,0.000333,0.085137,6,1532.472543,85.137363,255.41209,91.125266,1,0
0,0,12,12,14,16,30,38,28,66,0.000333,0.107952,7,2266.983455,125.943525,323.854779,117.302969,2,0
0,0,12,12,14,16,30,38,28,66,0.000333,0.107952,7,2266.983455,125.943525,323.854779,117.302969,2,0
0,0,16,16,14,19,33,57,44,101,0.000333,0.169828,14,7132.773285,396.265182,509.483806,134.013592,3,0
0,0,35,35,24,55,79,160,117,277,0.000333,0.582049,24,41907.53441,2328.196356,1746.147267,428.013884,12,0
0,0,10,10,14,15,29,35,26,61,0.000333,0.098779,7,2074.357885,115.242105,296.336841,111.906328,2,0
0,0,10,10,13,15,28,34,26,60,0.000333,0.096147,6,1730.647772,96.147098,288.441295,106.709075,2,0
0,0,15,15,14,20,34,54,41,95,0.000333,0.161103,14,6766.325579,375.906977,483.30897,139.741531,3,0
0,0,15,15,16,21,37,58,43,101,0.000333,0.175385,16,8418.476639,467.693147,526.15479,156.238666,4,0
0,0,21,21,18,46,64,110,80,190,0.000333,0.38,9,10260,570,1140,329.1425,7,0
0,0,15,15,16,21,37,57,39,96,0.000333,0.166703,8,4000.860185,222.27001,500.107523,156.238666,6,0
0,0,16,16,17,24,41,69,50,119,0.000333,0.212516,16,10200.77902,566.709945,637.548689,179.525968,6,0
0,0,22,22,19,47,66,113,82,195,0.000333,0.392886,9,10607.91168,589.328427,1178.656853,341.776299,8,0
0,0,19,19,18,45,63,101,74,175,0.000333,0.348675,9,9414.21588,523.011993,1046.023987,322.192039,7,0
0,0,29,29,20,47,67,148,96,244,0.000333,0.493375,20,29602.51525,1644.584181,1480.125762,347.504238,10,0
0,0,29,29,21,46,67,149,95,244,0.000333,0.493375,20,29602.51525,1644.584181,1480.125762,346.322516,10,0
0,0,19,19,18,45,63,101,74,175,0.000333,0.348675,9,9414.21588,523.011993,1046.023987,322.192039,7,0
0,0,27,27,19,45,64,135,90,225,0.000333,0.45,18,24300,1350,1350,327.844012,9,0
0,0,30,30,19,48,67,145,105,250,0.000333,0.505507,18,27297.40136,1516.522298,1516.522298,348.788823,9,0
0,0,24,24,20,43,63,131,85,216,0.000333,0.430364,10,12910.92464,717.273591,1291.092463,319.767946,9,0
0,0,29,29,21,47,68,145,102,247,0.000333,0.501201,20,30072.06644,1670.670358,1503.603322,353.304342,9,0
0,0,13,13,15,19,34,51,35,86,0.000333,0.145841,7,3062.65263,170.147368,437.521804,139.313982,5,0
0,0,13,13,15,19,34,51,35,86,0.000333,0.145841,7,3062.65263,170.147368,437.521804,139.313982,5,0
0,0,15,15,16,20,36,56,38,94,0.000333,0.161991,8,3887.783601,215.987978,485.97295,150.438562,5,0
0,0,15,15,16,21,37,56,38,94,0.000333,0.16323,8,3917.508931,217.639385,489.688616,156.238666,5,0
0,0,19,19,14,22,36,64,42,106,0.000333,0.182671,7,3836.084351,213.115797,548.01205,151.410465,5,0
0,0,19,19,14,21,35,64,42,106,0.000333,0.181235,14,7611.855997,422.880889,543.704,145.541635,5,0
0,0,13,13,15,19,34,52,36,88,0.000333,0.149232,7,3133.87711,174.104284,447.69673,139.313982,5,0
0,0,13,13,15,19,34,51,36,87,0.000333,0.147536,7,3098.26487,172.125826,442.609267,139.313982,5,0
0,0,15,15,13,19,32,55,38,93,0.000333,0.155,12,5580,310,465,128.816339,5,0
0,0,15,15,13,19,32,54,38,92,0.000333,0.153333,12,5520,306.666667,460,128.816339,5,0
0,0,13,13,15,18,33,51,35,86,0.000333,0.144606,7,3036.72526,168.706959,433.817894,133.662009,5,0
0,0,13,13,15,19,34,51,35,86,0.000333,0.145841,7,3062.65263,170.147368,437.521804,139.313982,5,0
0,0,15,15,13,19,32,54,36,90,0.000333,0.15,6,2700,150,450,128.816339,5,0
0,0,15,15,13,19,32,54,36,90,0.000333,0.15,6,2700,150,450,128.816339,5,0
0,0,13,13,15,19,34,51,35,86,0.000333,0.145841,7,3062.65263,170.147368,437.521804,139.313982,5,0
0,0,13,13,15,19,34,51,35,86,0.000333,0.145841,7,3062.65263,170.147368,437.521804,139.313982,5,0
0,0,15,15,13,20,33,54,36,90,0.000333,0.151332,6,2723.972824,151.331824,453.995471,134.544278,5,0
0,0,15,15,13,19,32,54,36,90,0.000333,0.15,6,2700,150,450,128.816339,5,0
0,0,13,13,15,19,34,51,35,86,0.000333,0.145841,7,3062.65263,170.147368,437.521804,139.313982,5,0
0,0,13,13,15,19,34,51,35,86,0.000333,0.145841,7,3062.65263,170.147368,437.521804,139.313982,5,0
0,0,15,15,13,20,33,54,36,90,0.000333,0.151332,6,2723.972824,151.331824,453.995471,134.544278,5,0
0,0,15,15,13,19,32,54,36,90,0.000333,0.15,6,2700,150,450,128.816339,5,0
0,0,15,15,15,24,39,55,54,109,0.000333,0.192036,14,8065.523786,448.084655,576.108842,168.642459,5,0
0,0,15,15,15,24,39,55,54,109,0.000333,0.192036,14,8065.523786,448.084655,576.108842,168.642459,5,0
0,0,16,16,13,24,37,55,51,106,0.000333,0.184067,12,6626.424681,368.134705,552.202057,158.144816,4,0
0,0,15,15,16,20,36,55,38,93,0.000333,0.160268,8,3846.424201,213.690233,480.803025,150.438562,5,0
0,0,15,15,16,21,37,55,38,93,0.000333,0.161493,8,3875.833304,215.324072,484.479163,156.238666,5,0
0,0,13,13,15,19,34,51,35,86,0.000333,0.145841,7,3062.65263,170.147368,437.521804,139.313982,5,0
0,0,13,13,15,19,34,51,35,86,0.000333,0.145841,7,3062.65263,170.147368,437.521804,139.313982,5,0
0,0,22,22,20,47,67,113,89,202,0.000333,0.40845,10,12253.50017,680.750009,1225.350016,347.504238,7,0
0,0,22,22,21,48,69,114,95,209,0.000333,0.425561,10,12766.81612,709.267562,1276.681611,360.316866,7,0
0,0,19,19,18,45,63,101,74,175,0.000333,0.348675,9,9414.21588,523.011993,1046.023987,322.192039,7,0
0,0,19,19,18,45,63,101,74,175,0.000333,0.348675,9,9414.21588,523.011993,1046.023987,322.192039,7,0
0,0,32,32,21,49,70,150,98,248,0.000333,0.506687,20,30401.24376,1688.957987,1520.062188,367.359448,13,0
0,0,32,32,21,49,70,150,98,248,0.000333,0.506687,20,30401.24376,1688.957987,1520.062188,367.359448,13,0
0,0,21,21,18,46,64,110,80,190,0.000333,0.38,9,10260,570,1140,329.1425,7,0
0,0,22,22,18,48,66,123,85,208,0.000333,0.419078,9,11315.10579,628.616988,1257.233977,343.13685,9,0
0,0,22,22,19,47,66,124,84,208,0.000333,0.419078,9,11315.10579,628.616988,1257.233977,341.776299,9,0
0,0,19,19,18,45,63,101,74,175,0.000333,0.348675,9,9414.21588,523.011993,1046.023987,322.192039,7,0
0,0,22,22,18,48,66,123,85,208,0.000333,0.419078,9,11315.10579,628.616988,1257.233977,343.13685,9,0
0,0,22,22,19,47,66,124,84,208,0.000333,0.419078,9,11315.10579,628.616988,1257.233977,341.776299,9,0
0,0,22,22,18,48,66,123,85,208,0.000333,0.419078,9,11315.10579,628.616988,1257.233977,343.13685,9,0
0,0,22,22,19,47,66,124,84,208,0.000333,0.419078,9,11315.10579,628.616988,1257.233977,341.776299,9,0
0,0,18,18,16,44,60,98,70,168,0.000333,0.330786,8,7938.86096,441.047831,992.35762,304.214991,7,0
0,0,19,19,18,45,63,101,74,175,0.000333,0.348675,9,9414.21588,523.011993,1046.023987,322.192039,7,0
0,0,20,20,18,44,62,104,74,178,0.000333,0.353282,9,9538.622489,529.923472,1059.846943,315.273641,8,0
0,0,19,19,18,44,62,101,73,174,0.000333,0.345343,9,9324.271422,518.015079,1036.030158,315.273641,7,0
0,0,20,20,18,46,64,104,75,179,0.000333,0.358,9,9666,537,1074,329.1425,8,0
0,0,27,27,19,45,64,135,90,225,0.000333,0.45,18,24300,1350,1350,327.844012,9,0
0,0,30,30,19,49,68,145,109,254,0.000333,0.515405,18,27831.88011,1546.215562,1546.215562,355.831405,9,0
0,0,27,27,19,46,65,135,92,227,0.000333,0.455692,18,24607.39488,1367.077494,1367.077494,334.794473,9,0
0,0,29,29,19,47,66,145,102,247,0.000333,0.497655,18,26873.37626,1492.965347,1492.965347,341.776299,9,0
0,0,30,30,19,48,67,154,106,260,0.000333,0.525728,18,28389.29741,1577.18319,1577.18319,348.788823,9,0
0,0,27,27,19,46,65,136,89,225,0.000333,0.451678,9,12195.29482,677.516379,1355.032758,334.794473,9,0
0,0,30,30,19,47,66,150,106,256,0.000333,0.515788,18,27852.5681,1547.364895,1547.364895,341.776299,9,0
0,0,12,12,13,15,28,42,31,73,0.000333,0.116979,12,4211.242912,233.95794,350.936909,106.709075,2,0
0,0,12,12,13,15,28,42,31,73,0.000333,0.116979,12,4211.242912,233.95794,350.936909,106.709075,2,0
0,0,11,11,12,15,27,39,30,69,0.000333,0.109362,12,3937.046852,218.724825,328.087238,101.622909,1,0
0,0,12,12,13,16,29,42,31,73,0.000333,0.118211,6,2127.795676,118.210871,354.632613,112.105716,2,0
0,0,12,12,13,16,29,42,31,73,0.000333,0.118211,6,2127.795676,118.210871,354.632613,112.105716,2,0
0,0,12,12,14,16,30,43,32,75,0.000333,0.122672,14,5152.235125,286.235285,368.016795,117.302969,2,0
0,0,12,12,13,16,29,42,32,74,0.000333,0.11983,12,4313.887124,239.660396,359.490594,112.105716,2,0
0,0,12,12,14,17,31,43,32,75,0.000333,0.123855,7,2600.953063,144.497392,371.564723,122.789837,2,0
0,0,12,12,13,17,30,42,32,74,0.000333,0.121037,6,2178.659424,121.036635,363.109904,117.592585,2,0
0,0,12,12,14,17,31,43,32,75,0.000333,0.123855,7,2600.953063,144.497392,371.564723,122.789837,2,0
0,0,12,12,13,17,30,42,32,74,0.000333,0.121037,6,2178.659424,121.036635,363.109904,117.592585,2,0
0,0,14,14,13,16,29,48,40,88,0.000333,0.142501,12,5130.027931,285.001552,427.502328,112.105716,1,0
0,0,15,15,13,20,33,51,41,92,0.000333,0.154695,12,5569.011108,309.389506,464.084259,134.544278,3,0
0,0,14,14,15,20,35,51,41,92,0.000333,0.157298,14,6606.516526,367.028696,471.894038,145.041921,4,0
0,0,15,15,15,21,36,56,48,104,0.000333,0.179224,14,7527.410802,418.189489,537.6722,150.842025,5,0
0,0,15,15,15,21,36,56,48,104,0.000333,0.179224,14,7527.410802,418.189489,537.6722,150.842025,5,0
0,0,16,16,13,21,34,56,45,101,0.000333,0.171278,12,6166.004964,342.555831,513.833747,140.344382,4,0
0,0,12,12,15,19,34,47,35,82,0.000333,0.139057,7,2920.203671,162.233537,417.171953,139.313982,4,0
0,0,13,13,13,19,32,47,35,82,0.000333,0.136667,6,2460,136.666667,410,128.816339,3,0
0,0,14,14,17,23,40,57,43,100,0.000333,0.177398,8,4257.542476,236.530138,532.192809,173.528793,5,0
0,0,16,16,16,23,39,65,48,113,0.000333,0.199083,16,9556.007212,530.88929,597.250451,168.041925,5,0
0,0,13,13,16,20,36,50,36,86,0.000333,0.148205,8,3556.908401,197.606022,444.61355,150.438562,5,0
0,0,15,15,14,20,34,53,37,90,0.000333,0.152624,7,3205.10159,178.061199,457.871656,139.741531,5,0
0,0,13,13,16,20,36,50,36,86,0.000333,0.148205,8,3556.908401,197.606022,444.61355,150.438562,5,0
0,0,13,13,16,20,36,50,36,86,0.000333,0.148205,8,3556.908401,197.606022,444.61355,150.438562,5,0
0,0,15,15,14,21,35,53,37,90,0.000333,0.153878,7,3231.448301,179.524906,461.635472,145.541635,5,0
0,0,15,15,14,21,35,53,37,90,0.000333,0.153878,7,3231.448301,179.524906,461.635472,145.541635,5,0
0,0,13,13,15,21,36,51,37,88,0.000333,0.151651,7,3184.673801,176.926322,454.9534,150.842025,5,0
0,0,13,13,15,21,36,50,37,87,0.000333,0.149928,7,3148.484326,174.915796,449.783475,150.842025,5,0
0,0,15,15,13,21,34,54,39,93,0.000333,0.157711,6,2838.804265,157.711348,473.134044,140.344382,5,0
0,0,15,15,13,21,34,53,39,92,0.000333,0.156016,6,2808.279488,156.015527,468.046581,140.344382,5,0
0,0,13,13,15,21,36,51,37,88,0.000333,0.151651,7,3184.673801,176.926322,454.9534,150.842025,5,0
0,0,13,13,15,21,36,50,37,87,0.000333,0.149928,7,3148.484326,174.915796,449.783475,150.842025,5,0
0,0,15,15,13,21,34,54,39,93,0.000333,0.157711,6,2838.804265,157.711348,473.134044,140.344382,5,0
0,0,15,15,13,21,34,53,39,92,0.000333,0.156016,6,2808.279488,156.015527,468.046581,140.344382,5,0
0,0,19,19,18,44,62,101,73,174,0.000333,0.345343,9,9324.271422,518.015079,1036.030158,315.273641,7,0
0,0,19,19,18,44,62,101,73,174,0.000333,0.345343,9,9324.271422,518.015079,1036.030158,315.273641,7,0
0,0,29,29,21,45,66,144,94,238,0.000333,0.479522,20,28771.31601,1598.406445,1438.5658,339.372055,9,0
0,0,8,8,10,15,25,34,28,62,0.000333,0.095973,5,1439.595419,79.977523,287.919084,91.82264,1,0
0,0,15,15,13,21,34,57,49,106,0.000333,0.179757,12,6471.252734,359.514041,539.271061,140.344382,1,0
0,0,15,15,15,21,36,59,40,99,0.000333,0.170608,7,3582.758026,199.042113,511.822575,150.842025,6,0
0,0,15,15,15,21,36,58,40,98,0.000333,0.168884,7,3546.568551,197.031586,506.65265,150.842025,6,0
0,0,15,15,13,20,33,55,38,93,0.000333,0.156376,6,2814.771919,156.376218,469.128653,134.544278,5,0
0,0,15,15,13,20,33,54,38,92,0.000333,0.154695,6,2784.505554,154.694753,464.084259,134.544278,5,0
0,0,15,15,15,21,36,58,38,96,0.000333,0.165438,7,3474.189601,193.010533,496.3128,150.842025,6,0
0,0,15,15,15,20,35,58,38,96,0.000333,0.164137,7,3446.878187,191.493233,492.41117,145.041921,6,0
0,0,15,15,13,20,33,54,36,90,0.000333,0.151332,6,2723.972824,151.331824,453.995471,134.544278,5,0
0,0,15,15,13,19,32,54,36,90,0.000333,0.15,6,2700,150,450,128.816339,5,0
0,0,17,17,12,21,33,54,66,120,0.000333,0.201776,18,10895.8913,605.327294,605.327294,135.258216,1,0
0,0,19,19,18,45,63,101,74,175,0.000333,0.348675,9,9414.21588,523.011993,1046.023987,322.192039,7,0
0,0,15,15,15,21,36,59,40,99,0.000333,0.170608,7,3582.758026,199.042113,511.822575,150.842025,6,0
0,0,15,15,15,21,36,58,40,98,0.000333,0.168884,7,3546.568551,197.031586,506.65265,150.842025,6,0
0,0,15,15,13,20,33,55,38,93,0.000333,0.156376,6,2814.771919,156.376218,469.128653,134.544278,5,0
0,0,15,15,13,20,33,54,38,92,0.000333,0.154695,6,2784.505554,154.694753,464.084259,134.544278,5,0
0,0,18,18,16,44,60,98,70,168,0.000333,0.330786,8,7938.86096,441.047831,992.35762,304.214991,7,0
0,0,12,12,13,16,29,42,31,73,0.000333,0.118211,6,2127.795676,118.210871,354.632613,112.105716,2,0
0,0,12,12,13,16,29,42,31,73,0.000333,0.118211,6,2127.795676,118.210871,354.632613,112.105716,2,0
0,0,15,15,12,20,32,49,54,103,0.000333,0.171667,12,6180,343.333333,515,129.458112,1,0
0,0,33,33,20,51,71,167,108,275,0.000333,0.563727,20,33823.60916,1879.089398,1691.180458,375.732254,12,0
0,0,33,33,21,50,71,168,107,275,0.000333,0.563727,20,33823.60916,1879.089398,1691.180458,374.431475,12,0
0,0,32,32,21,51,72,162,106,268,0.000333,0.55118,20,33070.79801,1837.266556,1653.5399,381.532358,12,0
0,0,32,32,21,50,71,163,109,272,0.000333,0.557577,20,33454.62433,1858.590241,1672.731217,374.431475,12,0
0,0,32,32,21,50,71,163,109,272,0.000333,0.557577,20,33454.62433,1858.590241,1672.731217,374.431475,12,0
0,0,32,32,21,51,72,162,106,268,0.000333,0.55118,20,33070.79801,1837.266556,1653.5399,381.532358,12,0
0,0,32,32,21,50,71,163,107,270,0.000333,0.553477,20,33208.63445,1844.924136,1660.431722,374.431475,12,0
0,0,32,32,20,53,73,162,107,269,0.000333,0.555021,20,33301.25613,1850.069785,1665.062806,390.018346,12,0
0,0,32,32,21,52,73,163,106,269,0.000333,0.555021,20,33301.25613,1850.069785,1665.062806,388.661531,12,0
0,0,29,29,19,45,64,145,94,239,0.000333,0.478,18,25812,1434,1434,327.844012,9,0
0,0,15,15,16,22,38,52,51,103,0.000333,0.180179,16,8648.584542,480.476919,540.536534,162.107496,1,0
0,0,30,30,20,46,66,146,101,247,0.000333,0.497655,20,29859.30695,1658.850386,1492.965347,340.522412,10,0
0,0,34,34,23,58,81,156,110,266,0.000333,0.562133,11,18550.40111,1030.577839,1686.400101,443.804823,14,0
0,0,34,34,23,57,80,156,110,266,0.000333,0.560544,11,18497.96161,1027.664534,1681.632873,436.516656,14,0
0,0,15,15,13,21,34,53,37,90,0.000333,0.152624,6,2747.229934,152.623885,457.871656,140.344382,5,0
0,0,15,15,13,20,33,53,37,90,0.000333,0.151332,6,2723.972824,151.331824,453.995471,134.544278,5,0
0,0,9,9,14,16,30,37,31,68,0.000333,0.111223,7,2335.679924,129.759996,333.668561,117.302969,1,0
0,0,19,19,18,45,63,101,74,175,0.000333,0.348675,9,9414.21588,523.011993,1046.023987,322.192039,7,0
0,0,21,21,18,46,64,109,87,196,0.000333,0.392,9,10584,588,1176,329.1425,7,0
0,0,19,19,18,45,63,101,74,175,0.000333,0.348675,9,9414.21588,523.011993,1046.023987,322.192039,7,0
0,0,19,19,18,45,63,101,74,175,0.000333,0.348675,9,9414.21588,523.011993,1046.023987,322.192039,7,0
0,0,18,18,16,44,60,98,70,168,0.000333,0.330786,8,7938.86096,441.047831,992.35762,304.214991,7,0
0,0,19,19,18,45,63,101,74,175,0.000333,0.348675,9,9414.21588,523.011993,1046.023987,322.192039,7,0
0,0,27,27,19,45,64,136,88,224,0.000333,0.448,9,12096,672,1344,327.844012,9,0
0,0,27,27,20,44,64,137,87,224,0.000333,0.448,10,13440,746.666667,1344,326.653553,9,0
0,0,29,29,21,45,66,144,94,238,0.000333,0.479522,20,28771.31601,1598.406445,1438.5658,339.372055,9,0
0,0,29,29,21,44,65,145,95,240,0.000333,0.481789,20,28907.3655,1605.96475,1445.368275,332.453657,9,0
0,0,29,29,21,47,68,149,96,245,0.000333,0.497143,20,29828.56792,1657.142662,1491.428396,353.304342,10,0
0,0,29,29,21,46,67,150,97,247,0.000333,0.499441,20,29966.4806,1664.804478,1498.32403,346.322516,10,0
0,0,29,29,20,49,69,149,97,246,0.000333,0.500899,10,15026.97016,834.831676,1502.697016,361.559344,10,0
0,0,29,29,21,48,69,150,96,246,0.000333,0.500899,20,30053.94033,1669.663352,1502.697016,360.316866,10,0
0,0,30,30,20,47,67,154,98,252,0.000333,0.509551,20,30573.08952,1698.504973,1528.654476,347.504238,10,0
0,0,30,30,21,46,67,155,97,252,0.000333,0.509551,20,30573.08952,1698.504973,1528.654476,346.322516,10,0
0,0,20,20,18,46,64,104,75,179,0.000333,0.358,9,9666,537,1074,329.1425,8,0
0,0,32,32,19,50,69,158,105,263,0.000333,0.535514,18,28917.75478,1606.541932,1606.541932,362.903432,11,0
0,0,29,29,20,47,67,148,100,248,0.000333,0.501463,20,30087.80239,1671.544577,1504.390119,347.504238,10,0
0,0,29,29,21,49,70,149,101,250,0.000333,0.510774,20,30646.41509,1702.578616,1532.320754,367.359448,10,0
0,0,27,27,19,45,64,135,90,225,0.000333,0.45,18,24300,1350,1350,327.844012,9,0
0,0,27,27,20,47,67,136,90,226,0.000333,0.456979,10,13709.36157,761.631198,1370.936157,347.504238,9,0
0,0,17,17,12,21,33,54,66,120,0.000333,0.201776,18,10895.8913,605.327294,605.327294,135.258216,1,0
0,0,15,15,12,20,32,49,54,103,0.000333,0.171667,12,6180,343.333333,515,129.458112,1,0
0,0,13,13,12,19,31,44,42,86,0.000333,0.14202,12,5112.730592,284.040588,426.060883,123.730173,1,0
0,0,9,9,11,17,28,35,30,65,0.000333,0.104159,5,1562.39035,86.799464,312.47807,107.540616,1,0
0,0,14,14,13,21,34,46,41,87,0.000333,0.147536,6,2655.655603,147.536422,442.609267,140.344382,1,0
0,0,19,19,18,44,62,101,73,174,0.000333,0.345343,9,9324.271422,518.015079,1036.030158,315.273641,7,0
0,0,29,29,21,45,66,144,94,238,0.000333,0.479522,20,28771.31601,1598.406445,1438.5658,339.372055,9,0
0,0,13,13,12,19,31,44,42,86,0.000333,0.14202,12,5112.730592,284.040588,426.060883,123.730173,1,0
0,0,28,28,19,47,66,140,93,233,0.000333,0.469448,9,12675.09447,704.171915,1408.34383,341.776299,9,0
0,0,19,19,18,45,63,101,74,175,0.000333,0.348675,9,9414.21588,523.011993,1046.023987,322.192039,7,0
0,0,30,30,20,46,66,146,101,247,0.000333,0.497655,20,29859.30695,1658.850386,1492.965347,340.522412,10,0
0,0,19,19,18,44,62,101,73,174,0.000333,0.345343,9,9324.271422,518.015079,1036.030158,315.273641,7,0
0,0,30,30,21,46,67,147,95,242,0.000333,0.489331,20,29359.87168,1631.103982,1467.993584,346.322516,10,0
0,0,27,27,19,47,66,136,89,225,0.000333,0.45333,9,12239.89809,679.994338,1359.988677,341.776299,10,0
0,0,28,28,22,46,68,142,94,236,0.000333,0.47888,22,31606.10707,1755.894837,1436.641231,352.191346,10,0
0,0,22,22,20,47,67,113,89,202,0.000333,0.40845,10,12253.50017,680.750009,1225.350016,347.504238,7,0
0,0,27,27,20,46,66,136,88,224,0.000333,0.451315,10,13539.44283,752.191268,1353.944283,340.522412,10,0
0,0,29,29,21,47,68,145,92,237,0.000333,0.48091,10,14427.28693,801.515941,1442.728693,353.304342,10,0
0,0,27,27,19,47,66,136,89,225,0.000333,0.45333,9,12239.89809,679.994338,1359.988677,341.776299,10,0
0,0,27,27,19,46,65,136,88,224,0.000333,0.44967,9,12141.09351,674.505195,1349.01039,334.794473,10,0
0,0,29,29,20,46,66,140,91,231,0.000333,0.465418,10,13962.55042,775.697245,1396.255042,340.522412,10,0
0,0,31,31,21,48,69,147,97,244,0.000333,0.496827,20,29809.59935,1656.088853,1490.479967,360.316866,12,0
0,0,27,27,19,46,65,136,88,224,0.000333,0.44967,9,12141.09351,674.505195,1349.01039,334.794473,10,0
0,0,18,18,14,26,40,59,60,119,0.000333,0.211103,14,8866.332206,492.574011,633.309443,175.514402,3,0
0,0,17,17,16,26,42,59,60,119,0.000333,0.213895,16,10266.97237,570.387354,641.685773,186.211433,4,0
0,0,31,31,20,52,72,158,102,260,0.000333,0.534727,10,16041.805,891.211389,1604.1805,382.861427,13,0
0,0,31,31,21,51,72,159,101,260,0.000333,0.534727,10,16041.805,891.211389,1604.1805,381.532358,13,0
0,0,31,31,21,51,72,159,101,260,0.000333,0.534727,10,16041.805,891.211389,1604.1805,381.532358,13,0
0,0,19,19,18,44,62,102,73,175,0.000333,0.347328,9,9377.859189,520.992177,1041.984354,315.273641,7,0
0,0,32,32,21,50,71,158,101,259,0.000333,0.530928,20,31855.69008,1769.76056,1592.784504,374.431475,12,0
0,0,34,34,22,51,73,177,108,285,0.000333,0.588033,22,38810.19998,2156.122221,1764.099999,387.401188,14,0
0,0,32,32,22,49,71,159,100,259,0.000333,0.530928,22,35041.25909,1946.736616,1592.784504,373.228278,12,0
0,0,31,31,20,51,71,158,101,259,0.000333,0.530928,10,15927.84504,884.88028,1592.784504,375.732254,13,0
0,0,31,31,21,50,71,159,100,259,0.000333,0.530928,20,31855.69008,1769.76056,1592.784504,374.431475,13,0
0,0,31,31,21,50,71,159,100,259,0.000333,0.530928,20,31855.69008,1769.76056,1592.784504,374.431475,13,0
0,0,31,31,20,51,71,158,101,259,0.000333,0.530928,10,15927.84504,884.88028,1592.784504,375.732254,13,0
0,0,31,31,21,50,71,159,100,259,0.000333,0.530928,20,31855.69008,1769.76056,1592.784504,374.431475,13,0
0,0,31,31,21,50,71,159,100,259,0.000333,0.530928,20,31855.69008,1769.76056,1592.784504,374.431475,13,0
0,0,16,16,12,22,34,58,69,127,0.000333,0.215369,18,11629.94006,646.107781,646.107781,141.127046,3,0
0,0,16,16,14,23,37,60,71,131,0.000333,0.227479,21,14331.20621,796.178123,682.438391,157.344894,4,0
0,0,19,19,13,25,38,62,71,133,0.000333,0.232658,12,8375.692311,465.31624,697.974359,164.202121,3,0
0,0,18,18,15,25,40,62,71,133,0.000333,0.235939,14,9909.430113,550.523895,707.816437,174.699764,4,0
0,0,15,15,16,23,39,55,49,104,0.000333,0.183227,16,8794.909292,488.606072,549.681831,168.041925,4,0
0,0,17,17,14,25,39,65,54,119,0.000333,0.209654,14,8805.480097,489.193339,628.962864,169.399374,3,0
0,0,16,16,16,25,41,65,54,119,0.000333,0.212516,16,10200.77902,566.709945,637.548689,180.096405,4,0
0,0,16,16,14,24,38,57,50,107,0.000333,0.187176,14,7861.395415,436.74419,561.528244,163.342069,3,0
0,0,15,15,16,24,40,57,50,107,0.000333,0.189815,16,9111.140898,506.174494,569.446306,174.0391,4,0
0,0,32,32,23,52,75,165,108,273,0.000333,0.566823,22,37410.28506,2078.34917,1700.467503,400.46479,13,0
0,0,32,32,24,51,75,166,107,273,0.000333,0.566823,24,40811.22006,2267.290003,1700.467503,399.332792,13,0
0,0,30,30,20,50,70,155,100,255,0.000333,0.520989,20,31259.34339,1736.630188,1562.967169,368.631371,12,0
0,0,30,30,21,49,70,156,99,255,0.000333,0.520989,20,31259.34339,1736.630188,1562.967169,367.359448,12,0
0,0,22,22,20,48,68,113,93,206,0.000333,0.418006,10,12540.17345,696.676303,1254.017345,354.516762,7,0
0,0,19,19,18,45,63,101,74,175,0.000333,0.348675,9,9414.21588,523.011993,1046.023987,322.192039,7,0
0,0,29,29,21,46,67,141,91,232,0.000333,0.469111,10,14073.32692,781.851496,1407.332692,346.322516,10,0
0,0,19,19,18,45,63,101,74,175,0.000333,0.348675,9,9414.21588,523.011993,1046.023987,322.192039,7,0
0,0,32,32,20,49,69,156,108,264,0.000333,0.53755,20,32253.00913,1791.833841,1612.650457,361.559344,11,0
0,0,17,17,16,21,37,56,65,121,0.000333,0.210115,24,15128.25257,840.458476,630.343857,156.238666,1,0
0,0,35,35,19,51,70,164,126,290,0.000333,0.592497,18,31994.85735,1777.492075,1777.492075,370.004315,11,0
0,0,37,37,19,52,71,170,136,306,0.000333,0.627274,18,33872.80713,1881.822619,1881.822619,377.133488,11,0
0,0,31,31,19,49,68,152,106,258,0.000333,0.523522,18,28270.17744,1570.565413,1570.565413,355.831405,11,0
0,0,33,33,19,50,69,158,116,274,0.000333,0.557912,18,30127.24262,1673.735701,1673.735701,362.903432,11,0
0,0,19,19,18,44,62,102,73,175,0.000333,0.347328,9,9377.859189,520.992177,1041.984354,315.273641,7,0
0,0,31,31,21,51,72,158,101,259,0.000333,0.53267,10,15980.10575,887.783653,1598.010575,381.532358,13,0
0,0,31,31,22,50,72,159,100,259,0.000333,0.53267,22,35156.23266,1953.124037,1598.010575,380.300305,13,0
0,0,31,31,22,50,72,159,100,259,0.000333,0.53267,22,35156.23266,1953.124037,1598.010575,380.300305,13,0
0,0,31,31,20,50,70,158,101,259,0.000333,0.529161,20,31749.68603,1763.871446,1587.484301,368.631371,13,0
0,0,31,31,21,49,70,159,100,259,0.000333,0.529161,20,31749.68603,1763.871446,1587.484301,367.359448,13,0
0,0,19,19,18,44,62,102,73,175,0.000333,0.347328,9,9377.859189,520.992177,1041.984354,315.273641,7,0
0,0,19,19,18,44,62,102,73,175,0.000333,0.347328,9,9377.859189,520.992177,1041.984354,315.273641,7,0
0,0,19,19,18,44,62,101,73,174,0.000333,0.345343,9,9324.271422,518.015079,1036.030158,315.273641,7,0
0,0,21,21,19,45,64,111,80,191,0.000333,0.382,9,10314,573,1146,327.844012,7,0
0,0,19,19,18,44,62,102,73,175,0.000333,0.347328,9,9377.859189,520.992177,1041.984354,315.273641,7,0
0,0,19,19,18,44,62,102,73,175,0.000333,0.347328,9,9377.859189,520.992177,1041.984354,315.273641,7,0
0,0,19,19,18,44,62,102,73,175,0.000333,0.347328,9,9377.859189,520.992177,1041.984354,315.273641,7,0
0,0,19,19,18,44,62,102,73,175,0.000333,0.347328,9,9377.859189,520.992177,1041.984354,315.273641,7,0
0,0,32,32,19,51,70,158,112,270,0.000333,0.551635,18,29788.31546,1654.906415,1654.906415,370.004315,11,0
0,0,22,22,18,48,66,123,85,208,0.000333,0.419078,9,11315.10579,628.616988,1257.233977,343.13685,9,0
0,0,22,22,19,47,66,124,84,208,0.000333,0.419078,9,11315.10579,628.616988,1257.233977,341.776299,9,0
0,0,32,32,20,50,70,156,111,267,0.000333,0.545506,20,32730.37131,1818.353962,1636.518566,368.631371,11,0
0,0,28,28,20,47,67,145,91,236,0.000333,0.477199,10,14315.97049,795.331694,1431.597049,347.504238,11,0
0,0,28,28,21,46,67,146,90,236,0.000333,0.477199,10,14315.97049,795.331694,1431.597049,346.322516,11,0
0,0,28,28,21,46,67,146,90,236,0.000333,0.477199,10,14315.97049,795.331694,1431.597049,346.322516,11,0
0,0,19,19,18,45,63,101,74,175,0.000333,0.348675,9,9414.21588,523.011993,1046.023987,322.192039,7,0
0,0,34,34,23,58,81,156,110,266,0.000333,0.562133,11,18550.40111,1030.577839,1686.400101,443.804823,14,0
0,0,34,34,23,57,80,156,110,266,0.000333,0.560544,11,18497.96161,1027.664534,1681.632873,436.516656,14,0
0,0,15,15,13,21,34,53,37,90,0.000333,0.152624,6,2747.229934,152.623885,457.871656,140.344382,5,0
0,0,15,15,13,20,33,53,37,90,0.000333,0.151332,6,2723.972824,151.331824,453.995471,134.544278,5,0
0,0,11,11,12,20,32,44,36,80,0.000333,0.133333,6,2400,133.333333,400,129.458112,3,0
0,0,11,11,14,21,35,46,38,84,0.000333,0.14362,7,3016.018414,167.556579,430.859773,145.541635,4,0
0,0,15,15,16,22,38,52,51,103,0.000333,0.180179,16,8648.584542,480.476919,540.536534,162.107496,1,0
0,0,9,9,14,17,31,39,31,70,0.000333,0.115598,7,2427.556192,134.864233,346.793742,122.789837,1,0
0,0,21,21,19,46,65,110,81,191,0.000333,0.383424,9,10352.45027,575.136126,1150.272252,334.794473,7,0
0,0,26,26,19,44,63,133,86,219,0.000333,0.436341,9,11781.21873,654.512152,1309.024303,320.925614,9,0
0,0,27,27,19,45,64,135,90,225,0.000333,0.45,18,24300,1350,1350,327.844012,9,0
0,0,28,28,20,46,66,145,91,236,0.000333,0.475492,10,14264.77012,792.487229,1426.477012,340.522412,11,0
0,0,28,28,21,45,66,146,90,236,0.000333,0.475492,20,28529.54024,1584.974458,1426.477012,339.372055,11,0
0,0,28,28,21,45,66,146,90,236,0.000333,0.475492,20,28529.54024,1584.974458,1426.477012,339.372055,11,0
0,0,27,27,20,46,66,142,90,232,0.000333,0.467433,10,14022.99436,779.055242,1402.299436,340.522412,10,0
0,0,27,27,21,45,66,143,89,232,0.000333,0.467433,10,14022.99436,779.055242,1402.299436,339.372055,10,0
0,0,28,28,20,47,67,145,91,236,0.000333,0.477199,10,14315.97049,795.331694,1431.597049,347.504238,11,0
0,0,28,28,21,46,67,146,90,236,0.000333,0.477199,10,14315.97049,795.331694,1431.597049,346.322516,11,0
0,0,28,28,21,46,67,146,90,236,0.000333,0.477199,10,14315.97049,795.331694,1431.597049,346.322516,11,0
0,0,27,27,19,45,64,136,88,224,0.000333,0.448,9,12096,672,1344,327.844012,9,0
0,0,28,28,20,48,68,145,92,237,0.000333,0.48091,10,14427.28693,801.515941,1442.728693,354.516762,11,0
0,0,28,28,21,47,68,146,91,237,0.000333,0.48091,10,14427.28693,801.515941,1442.728693,353.304342,11,0
0,0,28,28,21,47,68,146,91,237,0.000333,0.48091,10,14427.28693,801.515941,1442.728693,353.304342,11,0
0,0,33,33,19,52,71,167,116,283,0.000333,0.580126,18,31326.81183,1740.378435,1740.378435,377.133488,11,0
0,0,30,30,22,47,69,150,94,244,0.000333,0.496827,22,32790.55928,1821.697738,1490.479967,359.173172,11,0
0,0,30,30,22,46,68,151,93,244,0.000333,0.495114,22,32677.50053,1815.416696,1485.340933,352.191346,11,0
0,0,30,30,22,46,68,151,93,244,0.000333,0.495114,22,32677.50053,1815.416696,1485.340933,352.191346,11,0
0,0,28,28,20,48,68,145,92,237,0.000333,0.48091,10,14427.28693,801.515941,1442.728693,354.516762,11,0
0,0,28,28,21,47,68,146,91,237,0.000333,0.48091,10,14427.28693,801.515941,1442.728693,353.304342,11,0
0,0,28,28,21,47,68,146,91,237,0.000333,0.48091,10,14427.28693,801.515941,1442.728693,353.304342,11,0
0,0,28,28,20,47,67,145,91,236,0.000333,0.477199,10,14315.97049,795.331694,1431.597049,347.504238,11,0
0,0,28,28,21,46,67,146,90,236,0.000333,0.477199,10,14315.97049,795.331694,1431.597049,346.322516,11,0
0,0,28,28,21,46,67,146,90,236,0.000333,0.477199,10,14315.97049,795.331694,1431.597049,346.322516,11,0
0,0,28,28,20,47,67,145,91,236,0.000333,0.477199,10,14315.97049,795.331694,1431.597049,347.504238,11,0
0,0,28,28,21,46,67,146,90,236,0.000333,0.477199,10,14315.97049,795.331694,1431.597049,346.322516,11,0
0,0,28,28,21,46,67,146,90,236,0.000333,0.477199,10,14315.97049,795.331694,1431.597049,346.322516,11,0
0,0,22,22,18,48,66,123,85,208,0.000333,0.419078,9,11315.10579,628.616988,1257.233977,343.13685,9,0
0,0,22,22,19,47,66,124,84,208,0.000333,0.419078,9,11315.10579,628.616988,1257.233977,341.776299,9,0
0,0,21,21,15,24,39,79,51,130,0.000333,0.229034,14,9619.432038,534.412891,687.102288,168.642459,6,0
0,0,21,21,16,22,38,82,50,132,0.000333,0.230909,16,11083.62291,615.756828,692.726432,162.107496,6,0
0,0,26,26,16,22,38,103,63,166,0.000333,0.290385,16,13938.49548,774.36086,871.155967,162.107496,7,0
0,0,21,21,14,22,36,76,48,124,0.000333,0.21369,14,8974.989803,498.610545,641.0707,151.410465,5,0
0,0,26,26,14,22,36,97,61,158,0.000333,0.272283,14,11435.8741,635.326339,816.84815,151.410465,6,0
0,0,27,27,19,46,65,136,88,224,0.000333,0.44967,9,12141.09351,674.505195,1349.01039,334.794473,10,0
0,0,27,27,19,46,65,135,92,227,0.000333,0.455692,18,24607.39488,1367.077494,1367.077494,334.794473,9,0
0,0,15,15,14,18,32,53,37,90,0.000333,0.15,14,6300,350,450,128.361619,2,0
0,0,20,20,18,46,64,104,75,179,0.000333,0.358,9,9666,537,1074,329.1425,8,0
0,0,12,12,13,16,29,42,31,73,0.000333,0.118211,6,2127.795676,118.210871,354.632613,112.105716,2,0
0,0,12,12,13,16,29,42,31,73,0.000333,0.118211,6,2127.795676,118.210871,354.632613,112.105716,2,0
0,0,12,12,13,16,29,42,31,73,0.000333,0.118211,6,2127.795676,118.210871,354.632613,112.105716,2,0
0,0,12,12,13,16,29,42,31,73,0.000333,0.118211,6,2127.795676,118.210871,354.632613,112.105716,2,0
0,0,12,12,14,17,31,43,32,75,0.000333,0.123855,7,2600.953063,144.497392,371.564723,122.789837,2,0
0,0,12,12,13,17,30,42,32,74,0.000333,0.121037,6,2178.659424,121.036635,363.109904,117.592585,2,0
0,0,12,12,14,17,31,43,32,75,0.000333,0.123855,7,2600.953063,144.497392,371.564723,122.789837,2,0
0,0,12,12,13,17,30,42,32,74,0.000333,0.121037,6,2178.659424,121.036635,363.109904,117.592585,2,0
0,0,27,27,19,45,64,136,88,224,0.000333,0.448,9,12096,672,1344,327.844012,10,0
0,0,12,12,13,16,29,42,31,73,0.000333,0.118211,6,2127.795676,118.210871,354.632613,112.105716,2,0
0,0,12,12,13,16,29,42,31,73,0.000333,0.118211,6,2127.795676,118.210871,354.632613,112.105716,2,0
0,0,12,12,14,16,30,43,32,75,0.000333,0.122672,14,5152.235125,286.235285,368.016795,117.302969,2,0
0,0,12,12,13,16,29,42,32,74,0.000333,0.11983,12,4313.887124,239.660396,359.490594,112.105716,2,0
0,0,10,10,12,19,31,43,33,76,0.000333,0.125506,6,2259.113518,125.506307,376.51892,123.730173,3,0
0,0,10,10,14,20,34,45,35,80,0.000333,0.135666,7,2848.979191,158.276622,406.997027,139.741531,4,0
0,0,22,22,20,48,68,113,93,206,0.000333,0.418006,10,12540.17345,696.676303,1254.017345,354.516762,7,0
0,0,20,20,18,45,63,104,74,178,0.000333,0.354652,9,9575.602437,531.977913,1063.955826,322.192039,8,0
0,0,20,20,19,44,63,105,73,178,0.000333,0.354652,9,9575.602437,531.977913,1063.955826,320.925614,8,0
0,0,20,20,19,44,63,105,73,178,0.000333,0.354652,9,9575.602437,531.977913,1063.955826,320.925614,8,0
0,0,22,22,20,45,65,110,77,187,0.000333,0.375394,10,11261.82781,625.657101,1126.182781,333.571951,8,0
0,0,30,30,19,50,69,148,102,250,0.000333,0.509044,18,27488.36006,1527.131114,1527.131114,362.903432,11,0
0,0,27,27,19,44,63,136,87,223,0.000333,0.444311,9,11996.40081,666.466711,1332.933423,320.925614,10,0
0,0,33,33,19,52,71,158,115,273,0.000333,0.559627,18,30219.85735,1678.880964,1678.880964,377.133488,11,0
0,0,12,12,13,16,29,42,31,73,0.000333,0.118211,6,2127.795676,118.210871,354.632613,112.105716,2,0
0,0,12,12,13,16,29,42,31,73,0.000333,0.118211,6,2127.795676,118.210871,354.632613,112.105716,2,0
0,0,29,29,20,46,66,143,101,244,0.000333,0.491611,20,29496.6433,1638.702406,1474.832165,340.522412,9,0
0,0,27,27,19,45,64,136,87,223,0.000333,0.446,9,12042,669,1338,327.844012,10,0
0,0,33,33,19,51,70,167,113,280,0.000333,0.572066,18,30891.58641,1716.199245,1716.199245,370.004315,11,0
0,0,29,29,21,46,67,144,95,239,0.000333,0.483265,20,28995.90633,1610.883685,1449.795317,346.322516,9,0
0,0,27,27,19,46,65,136,89,225,0.000333,0.451678,9,12195.29482,677.516379,1355.032758,334.794473,9,0
0,0,27,27,19,46,65,135,92,227,0.000333,0.455692,18,24607.39488,1367.077494,1367.077494,334.794473,9,0
0,0,28,28,19,46,65,139,99,238,0.000333,0.477775,18,25799.82371,1433.32354,1433.32354,334.794473,9,0
0,0,30,30,19,47,66,145,111,256,0.000333,0.515788,18,27852.5681,1547.364895,1547.364895,341.776299,9,0
0,0,32,32,19,48,67,151,123,274,0.000333,0.554036,18,29917.95189,1662.108438,1662.108438,348.788823,9,0
0,0,34,34,19,49,68,157,135,292,0.000333,0.592513,18,31995.70469,1777.53915,1777.53915,355.831405,9,0
0,0,10,10,16,19,35,45,36,81,0.000333,0.138491,8,3323.775395,184.654189,415.471924,144.710623,4,0
0,0,10,10,14,18,32,43,34,77,0.000333,0.128333,7,2695,149.722222,385,128.361619,3,0
0,0,10,10,12,19,31,43,33,76,0.000333,0.125506,6,2259.113518,125.506307,376.51892,123.730173,3,0
0,0,10,10,14,20,34,45,35,80,0.000333,0.135666,7,2848.979191,158.276622,406.997027,139.741531,4,0
0,0,10,10,15,21,36,47,36,83,0.000333,0.143035,7,3003.726426,166.87369,429.103775,150.842025,4,0
0,0,10,10,13,20,33,45,34,79,0.000333,0.132836,6,2391.042813,132.835712,398.507135,134.544278,3,0
0,0,29,29,21,46,67,141,91,232,0.000333,0.469111,10,14073.32692,781.851496,1407.332692,346.322516,10,0
0,0,20,20,19,45,64,104,74,178,0.000333,0.356,9,9612,534,1068,327.844012,8,0
0,0,20,20,18,46,64,104,75,179,0.000333,0.358,9,9666,537,1074,329.1425,8,0
0,0,20,20,18,46,64,104,75,179,0.000333,0.358,9,9666,537,1074,329.1425,8,0
0,0,22,22,20,46,66,113,78,191,0.000333,0.384826,10,11544.79277,641.377376,1154.479277,340.522412,8,0
0,0,20,20,18,45,63,104,74,178,0.000333,0.354652,9,9575.602437,531.977913,1063.955826,322.192039,8,0
0,0,30,30,19,48,67,149,97,246,0.000333,0.497419,18,26860.64294,1492.257941,1492.257941,348.788823,12,0
0,0,31,31,22,49,71,155,103,258,0.000333,0.528878,22,34905.96465,1939.220258,1586.634757,373.228278,12,0
0,0,27,27,19,47,66,136,89,225,0.000333,0.45333,9,12239.89809,679.994338,1359.988677,341.776299,10,0
0,0,20,20,18,47,65,104,76,180,0.000333,0.361342,9,9756.235857,542.013103,1084.026206,336.124326,8,0
0,0,20,20,18,47,65,104,76,180,0.000333,0.361342,9,9756.235857,542.013103,1084.026206,336.124326,8,0
0,0,20,20,18,46,64,104,75,179,0.000333,0.358,9,9666,537,1074,329.1425,8,0
0,0,20,20,18,46,64,104,75,179,0.000333,0.358,9,9666,537,1074,329.1425,8,0
0,0,22,22,19,46,65,108,78,186,0.000333,0.373387,9,10081.44372,560.080207,1120.160413,334.794473,8,0
0,0,38,38,20,54,74,176,140,316,0.000333,0.654062,20,39243.74527,2180.208071,1962.187264,397.202487,12,0
0,0,20,20,18,47,65,104,76,180,0.000333,0.361342,9,9756.235857,542.013103,1084.026206,336.124326,8,0
0,0,11,11,12,15,27,39,30,69,0.000333,0.109362,12,3937.046852,218.724825,328.087238,101.622909,1,0
0,0,13,13,15,16,31,48,37,85,0.000333,0.140369,14,5895.493609,327.527423,421.106686,122.603359,2,0
0,0,15,15,14,20,34,50,51,101,0.000333,0.171278,14,7193.672458,399.64847,513.833747,139.741531,2,0
0,0,15,15,14,20,34,50,51,101,0.000333,0.171278,14,7193.672458,399.64847,513.833747,139.741531,2,0
0,0,13,13,13,16,29,46,36,82,0.000333,0.132785,12,4780.253299,265.569628,398.354442,112.105716,1,0
0,0,13,13,12,16,28,43,36,79,0.000333,0.126594,12,4557.372466,253.187359,379.781039,107.01955,1,0
0,0,23,23,17,29,46,93,62,155,0.000333,0.285384,16,13698.43365,761.024092,856.152103,210.368317,7,0
0,0,25,25,18,27,45,110,72,182,0.000333,0.333172,18,17991.31074,999.517264,999.517264,203.440613,8,0
0,0,30,30,18,27,45,131,85,216,0.000333,0.395413,27,32028.48726,1779.360403,1186.240269,203.440613,9,0
0,0,21,21,14,22,36,76,48,124,0.000333,0.21369,14,8974.989803,498.610545,641.0707,151.410465,5,0
0,0,26,26,14,22,36,97,61,158,0.000333,0.272283,14,11435.8741,635.326339,816.84815,151.410465,6,0
0,0,16,16,12,22,34,58,69,127,0.000333,0.215369,18,11629.94006,646.107781,646.107781,141.127046,3,0
0,0,16,16,14,23,37,60,71,131,0.000333,0.227479,21,14331.20621,796.178123,682.438391,157.344894,4,0
0,0,19,19,13,25,38,62,71,133,0.000333,0.232658,12,8375.692311,465.31624,697.974359,164.202121,3,0
0,0,38,38,23,62,85,165,144,309,0.000333,0.660167,22,43571.03958,2420.61331,1980.501799,473.202096,12,0
0,0,30,30,19,49,68,149,98,247,0.000333,0.501201,18,27064.85979,1503.603322,1503.603322,355.831405,11,0
0,0,11,11,13,21,34,44,35,79,0.000333,0.13397,6,2411.457387,133.969855,401.909564,140.344382,3,0
0,0,11,11,15,22,37,46,37,83,0.000333,0.144128,7,3026.692405,168.149578,432.384629,156.710855,4,0
0,0,10,10,13,17,30,44,31,75,0.000333,0.122672,6,2208.100768,122.672265,368.016795,117.592585,3,0
0,0,10,10,15,18,33,46,33,79,0.000333,0.132836,7,2789.549948,154.974997,398.507135,133.662009,4,0
0,0,17,17,13,24,37,57,59,116,0.000333,0.201432,12,7251.559085,402.864394,604.29659,158.144816,3,0
0,0,36,36,23,61,84,160,132,292,0.000333,0.622186,22,41064.24712,2281.347062,1866.556687,465.816903,12,0
0,0,15,15,13,23,36,52,47,99,0.000333,0.170608,12,6141.870902,341.21505,511.822575,152.147641,3,0
0,0,34,34,23,60,83,155,120,275,0.000333,0.584379,22,38568.98856,2142.721587,1753.135844,458.455361,12,0
0,0,15,15,13,20,33,53,43,96,0.000333,0.161421,12,5811.142026,322.841224,484.261835,134.544278,3,0
0,0,34,34,23,57,80,156,116,272,0.000333,0.573188,22,37830.41772,2101.689873,1719.564442,436.516656,12,0
0,0,16,16,14,25,39,54,46,100,0.000333,0.17618,7,3699.781553,205.54342,528.540222,169.399374,3,0
0,0,35,35,23,62,85,157,119,276,0.000333,0.589664,11,19458.91088,1081.050605,1768.991898,473.202096,12,0
0,0,24,24,20,44,64,131,87,218,0.000333,0.436,10,13080,726.666667,1308,326.653553,9,0
0,0,27,27,19,46,65,136,89,225,0.000333,0.451678,9,12195.29482,677.516379,1355.032758,334.794473,9,0
0,0,30,30,19,47,66,150,106,256,0.000333,0.515788,18,27852.5681,1547.364895,1547.364895,341.776299,9,0
0,0,20,20,18,44,62,104,74,178,0.000333,0.353282,9,9538.622489,529.923472,1059.846943,315.273641,8,0
0,0,20,20,19,43,62,105,73,178,0.000333,0.353282,9,9538.622489,529.923472,1059.846943,314.040007,8,0
0,0,20,20,19,43,62,105,73,178,0.000333,0.353282,9,9538.622489,529.923472,1059.846943,314.040007,8,0
0,0,20,20,18,46,64,104,75,179,0.000333,0.358,9,9666,537,1074,329.1425,8,0
0,0,20,20,19,45,64,105,74,179,0.000333,0.358,9,9666,537,1074,327.844012,8,0
0,0,20,20,19,45,64,105,74,179,0.000333,0.358,9,9666,537,1074,327.844012,8,0
0,0,22,22,20,45,65,109,77,186,0.000333,0.373387,10,11201.60413,622.311341,1120.160413,333.571951,8,0
0,0,22,22,20,44,64,110,76,186,0.000333,0.372,10,11160,620,1116,326.653553,8,0
0,0,22,22,20,44,64,110,76,186,0.000333,0.372,10,11160,620,1116,326.653553,8,0
0,0,27,27,19,44,63,137,87,224,0.000333,0.446304,9,12050.19633,669.455351,1338.910703,320.925614,9,0
0,0,19,19,18,42,60,102,71,173,0.000333,0.340631,9,9197.028657,510.946037,1021.892073,301.535982,7,0
0,0,20,20,18,46,64,104,76,180,0.000333,0.36,9,9720,540,1080,329.1425,8,0
0,0,20,20,18,45,63,104,75,179,0.000333,0.356644,9,9629.397957,534.966553,1069.933106,322.192039,8,0
0,0,19,19,18,45,63,101,74,175,0.000333,0.348675,9,9414.21588,523.011993,1046.023987,322.192039,7,0
0,0,20,20,18,46,64,104,75,179,0.000333,0.358,9,9666,537,1074,329.1425,8,0
0,0,20,20,18,46,64,104,75,179,0.000333,0.358,9,9666,537,1074,329.1425,8,0
0,0,25,25,20,49,69,122,87,209,0.000333,0.425561,10,12766.81612,709.267562,1276.681611,361.559344,10,0
0,0,25,25,20,48,68,123,86,209,0.000333,0.424093,10,12722.79734,706.822074,1272.279734,354.516762,10,0
0,0,25,25,20,48,68,123,86,209,0.000333,0.424093,10,12722.79734,706.822074,1272.279734,354.516762,10,0
0,0,23,23,18,50,68,117,85,202,0.000333,0.409889,9,11067.00745,614.833747,1229.667494,357.25146,10,0
0,0,23,23,19,49,68,118,84,202,0.000333,0.409889,9,11067.00745,614.833747,1229.667494,355.831405,10,0
0,0,23,23,19,49,68,118,84,202,0.000333,0.409889,9,11067.00745,614.833747,1229.667494,355.831405,10,0
0,0,23,23,18,50,68,117,85,202,0.000333,0.409889,9,11067.00745,614.833747,1229.667494,357.25146,10,0
0,0,23,23,19,49,68,118,84,202,0.000333,0.409889,9,11067.00745,614.833747,1229.667494,355.831405,10,0
0,0,23,23,19,49,68,118,84,202,0.000333,0.409889,9,11067.00745,614.833747,1229.667494,355.831405,10,0
0,0,23,23,18,49,67,117,84,201,0.000333,0.406428,9,10973.55535,609.641964,1219.283927,350.179432,10,0
0,0,23,23,19,48,67,118,83,201,0.000333,0.406428,9,10973.55535,609.641964,1219.283927,348.788823,10,0
0,0,23,23,19,48,67,118,83,201,0.000333,0.406428,9,10973.55535,609.641964,1219.283927,348.788823,10,0
0,0,23,23,18,49,67,117,84,201,0.000333,0.406428,9,10973.55535,609.641964,1219.283927,350.179432,10,0
0,0,23,23,19,48,67,118,83,201,0.000333,0.406428,9,10973.55535,609.641964,1219.283927,348.788823,10,0
0,0,23,23,19,48,67,118,83,201,0.000333,0.406428,9,10973.55535,609.641964,1219.283927,348.788823,10,0
0,0,23,23,18,49,67,117,85,202,0.000333,0.40845,9,11028.15015,612.675008,1225.350016,350.179432,10,0
0,0,23,23,19,48,67,118,84,202,0.000333,0.40845,9,11028.15015,612.675008,1225.350016,348.788823,10,0
0,0,23,23,19,48,67,118,84,202,0.000333,0.40845,9,11028.15015,612.675008,1225.350016,348.788823,10,0
0,0,32,32,26,57,83,148,116,264,0.000333,0.561003,26,43758.27066,2431.015036,1683.01041,454.686163,10,0
0,0,16,16,16,24,40,58,53,111,0.000333,0.196911,16,9451.744297,525.096905,590.734019,174.0391,3,0
0,0,16,16,14,19,33,57,44,101,0.000333,0.169828,14,7132.773285,396.265182,509.483806,134.013592,3,0
0,0,32,32,24,52,76,147,107,254,0.000333,0.528991,24,38087.36612,2115.964785,1586.973588,406.461965,10,0
0,0,15,15,13,19,32,54,42,96,0.000333,0.16,12,5760,320,480,128.816339,3,0
0,0,31,31,23,52,75,144,105,249,0.000333,0.516992,22,34121.46879,1895.637155,1550.975854,400.46479,10,0
0,0,29,29,23,51,74,138,97,235,0.000333,0.486407,11,16051.43695,891.746497,1459.221541,393.335617,10,0
0,0,13,13,13,18,31,48,34,82,0.000333,0.135415,6,2437.464585,135.414699,406.244097,123.164366,3,0
0,0,35,35,24,55,79,151,106,257,0.000333,0.540024,12,19440.85983,1080.047768,1620.071652,428.013884,12,0
0,0,35,35,24,54,78,151,106,257,0.000333,0.538449,12,19384.18044,1076.898913,1615.34837,420.803025,12,0
0,0,19,19,14,23,37,61,43,104,0.000333,0.180594,7,3792.48205,210.693447,541.78315,157.344894,5,0
0,0,19,19,14,22,36,61,43,104,0.000333,0.179224,7,3763.705401,209.094745,537.6722,151.410465,5,0
0,0,17,17,17,43,60,100,73,173,0.000333,0.340631,8,8175.136584,454.174255,1021.892073,302.816253,7,0
0,0,27,27,19,45,64,137,88,225,0.000333,0.45,9,12150,675,1350,327.844012,9,0
0,0,8,8,11,13,24,35,26,61,0.000333,0.093228,10,2796.827125,155.379285,279.682713,86.159464,1,0
0,0,13,13,12,19,31,44,42,86,0.000333,0.14202,12,5112.730592,284.040588,426.060883,123.730173,1,0
0,0,14,14,13,21,34,46,41,87,0.000333,0.147536,6,2655.655603,147.536422,442.609267,140.344382,1,0
0,0,32,32,23,50,73,174,108,282,0.000333,0.581844,22,38401.67156,2133.426198,1745.530526,386.234734,13,0
0,0,32,32,23,50,73,174,108,282,0.000333,0.581844,22,38401.67156,2133.426198,1745.530526,386.234734,13,0
0,0,13,13,13,16,29,46,36,82,0.000333,0.132785,12,4780.253299,265.569628,398.354442,112.105716,1,0
0,0,13,13,12,16,28,43,36,79,0.000333,0.126594,12,4557.372466,253.187359,379.781039,107.01955,1,0
0,0,13,13,12,19,31,44,42,86,0.000333,0.14202,12,5112.730592,284.040588,426.060883,123.730173,1,0
0,0,9,9,11,17,28,35,30,65,0.000333,0.104159,5,1562.39035,86.799464,312.47807,107.540616,1,0
0,0,14,14,13,21,34,46,41,87,0.000333,0.147536,6,2655.655603,147.536422,442.609267,140.344382,1,0
0,0,20,20,18,45,63,104,74,178,0.000333,0.354652,9,9575.602437,531.977913,1063.955826,322.192039,8,0
0,0,22,22,20,45,65,109,77,186,0.000333,0.373387,10,11201.60413,622.311341,1120.160413,333.571951,8,0
0,0,19,19,18,44,62,101,73,174,0.000333,0.345343,9,9324.271422,518.015079,1036.030158,315.273641,7,0
0,0,29,29,21,47,68,145,92,237,0.000333,0.48091,10,14427.28693,801.515941,1442.728693,353.304342,10,0
0,0,27,27,19,47,66,136,89,225,0.000333,0.45333,9,12239.89809,679.994338,1359.988677,341.776299,10,0
0,0,27,27,19,46,65,136,88,224,0.000333,0.44967,9,12141.09351,674.505195,1349.01039,334.794473,10,0
0,0,29,29,20,46,66,140,91,231,0.000333,0.465418,10,13962.55042,775.697245,1396.255042,340.522412,10,0
0,0,27,27,19,45,64,136,88,224,0.000333,0.448,9,12096,672,1344,327.844012,10,0
0,0,28,28,22,46,68,142,94,236,0.000333,0.47888,22,31606.10707,1755.894837,1436.641231,352.191346,10,0
0,0,27,27,19,47,66,136,89,225,0.000333,0.45333,9,12239.89809,679.994338,1359.988677,341.776299,10,0
0,0,27,27,20,46,66,136,88,224,0.000333,0.451315,10,13539.44283,752.191268,1353.944283,340.522412,10,0
0,0,26,26,19,45,64,133,87,220,0.000333,0.44,9,11880,660,1320,327.844012,9,0
0,0,34,34,20,53,73,176,117,293,0.000333,0.60454,20,36272.37192,2015.131773,1813.618596,390.018346,12,0
0,0,34,34,21,55,76,177,118,295,0.000333,0.61438,20,36862.77233,2047.931796,1843.138616,410.21345,12,0
0,0,31,31,23,55,78,144,102,246,0.000333,0.515403,11,17008.2984,944.905467,1546.208946,422.016709,12,0
0,0,31,31,23,55,78,143,102,245,0.000333,0.513308,11,16939.15898,941.064388,1539.923544,422.016709,12,0
0,0,15,15,13,21,34,54,39,93,0.000333,0.157711,6,2838.804265,157.711348,473.134044,140.344382,5,0
0,0,15,15,13,21,34,53,39,92,0.000333,0.156016,6,2808.279488,156.015527,468.046581,140.344382,5,0
0,0,31,31,24,55,79,143,100,243,0.000333,0.510606,12,18381.82466,1021.212481,1531.818722,428.013884,12,0
0,0,31,31,24,55,79,143,100,243,0.000333,0.510606,12,18381.82466,1021.212481,1531.818722,428.013884,12,0
0,0,15,15,14,21,35,53,37,90,0.000333,0.153878,7,3231.448301,179.524906,461.635472,145.541635,5,0
0,0,15,15,14,21,35,53,37,90,0.000333,0.153878,7,3231.448301,179.524906,461.635472,145.541635,5,0
0,0,37,37,23,57,80,164,113,277,0.000333,0.583725,11,19262.91491,1070.161939,1751.174082,436.516656,12,0
0,0,53,53,24,55,79,253,173,426,0.000333,0.895137,36,96674.78155,5370.821197,2685.410599,428.013884,18,0
0,0,58,58,24,55,79,273,187,460,0.000333,0.96658,36,104390.6092,5799.478288,2899.739144,428.013884,19,0
0,0,21,21,14,23,37,75,49,124,0.000333,0.215324,14,9043.611043,502.422836,645.972217,157.344894,5,0
0,0,26,26,14,23,37,95,63,158,0.000333,0.274365,14,11523.31085,640.183936,823.093632,157.344894,6,0
0,0,31,31,23,55,78,144,102,246,0.000333,0.515403,11,17008.2984,944.905467,1546.208946,422.016709,12,0
0,0,31,31,23,55,78,143,102,245,0.000333,0.513308,11,16939.15898,941.064388,1539.923544,422.016709,12,0
0,0,15,15,13,21,34,54,39,93,0.000333,0.157711,6,2838.804265,157.711348,473.134044,140.344382,5,0
0,0,15,15,13,21,34,53,39,92,0.000333,0.156016,6,2808.279488,156.015527,468.046581,140.344382,5,0
0,0,33,33,21,50,71,160,105,265,0.000333,0.543228,20,32593.65973,1810.758874,1629.682987,374.431475,12,0
0,0,35,35,24,55,79,153,106,259,0.000333,0.544226,12,19592.15057,1088.452809,1632.679214,428.013884,12,0
0,0,35,35,24,54,78,153,106,259,0.000333,0.54264,12,19535.0301,1085.27945,1627.919175,420.803025,12,0
0,0,19,19,14,23,37,63,43,106,0.000333,0.184067,7,3865.414397,214.745244,552.202057,157.344894,5,0
0,0,19,19,14,22,36,63,43,106,0.000333,0.182671,7,3836.084351,213.115797,548.01205,151.410465,5,0
0,0,31,31,23,55,78,143,100,243,0.000333,0.509118,11,16800.88013,933.38223,1527.352739,422.016709,12,0
0,0,31,31,23,54,77,143,100,243,0.000333,0.50761,11,16751.12042,930.617801,1522.829129,414.80585,12,0
0,0,15,15,13,21,34,53,37,90,0.000333,0.152624,6,2747.229934,152.623885,457.871656,140.344382,5,0
0,0,15,15,13,20,33,53,37,90,0.000333,0.151332,6,2723.972824,151.331824,453.995471,134.544278,5,0
0,0,31,31,23,53,76,143,100,243,0.000333,0.506082,11,16700.71024,927.817236,1518.246386,407.621709,12,0
0,0,15,15,14,20,34,53,37,90,0.000333,0.152624,7,3205.10159,178.061199,457.871656,139.741531,5,0
0,0,32,32,25,55,80,155,111,266,0.000333,0.560544,24,40359.18896,2242.177164,1681.632873,434.071189,12,0
0,0,16,16,16,23,39,65,48,113,0.000333,0.199083,16,9556.007212,530.88929,597.250451,168.041925,5,0
0,0,12,12,13,15,28,42,31,73,0.000333,0.116979,12,4211.242912,233.95794,350.936909,106.709075,2,0
0,0,30,30,19,46,65,145,106,251,0.000333,0.503871,18,27209.05778,1511.614321,1511.614321,334.794473,9,0
0,0,12,12,13,16,29,42,31,73,0.000333,0.118211,6,2127.795676,118.210871,354.632613,112.105716,2,0
0,0,12,12,13,16,29,42,31,73,0.000333,0.118211,6,2127.795676,118.210871,354.632613,112.105716,2,0
0,0,15,15,14,19,33,55,40,95,0.000333,0.159739,14,6709.044179,372.724677,479.217441,134.013592,3,0
0,0,31,31,23,52,75,145,103,248,0.000333,0.514916,11,16992.21739,944.012077,1544.747035,400.46479,10,0
0,0,32,32,23,56,79,146,116,262,0.000333,0.55053,22,36334.99223,2018.61068,1651.590556,429.253801,11,0
0,0,32,32,23,56,79,146,116,262,0.000333,0.55053,22,36334.99223,2018.61068,1651.590556,429.253801,11,0
0,0,16,16,13,23,36,56,50,106,0.000333,0.182671,12,6576.144602,365.341367,548.01205,152.147641,4,0
0,0,19,19,18,44,62,102,73,175,0.000333,0.347328,9,9377.859189,520.992177,1041.984354,315.273641,7,0
0,0,19,19,18,44,62,102,73,175,0.000333,0.347328,9,9377.859189,520.992177,1041.984354,315.273641,7,0
0,0,8,8,12,16,28,36,29,65,0.000333,0.104159,6,1874.86842,104.159357,312.47807,107.01955,1,0
0,0,19,19,18,44,62,102,73,175,0.000333,0.347328,9,9377.859189,520.992177,1041.984354,315.273641,7,0
0,0,16,16,13,22,35,51,55,106,0.000333,0.181235,12,6524.447998,362.469333,543.704,146.213212,1,0
0,0,18,18,15,25,40,66,56,122,0.000333,0.216425,14,9089.853186,504.991844,649.275228,174.699764,3,0
0,0,34,34,23,57,80,156,119,275,0.000333,0.57951,22,38247.66497,2124.870276,1738.530226,436.516656,10,0
0,0,19,19,18,44,62,110,75,185,0.000333,0.367175,9,9913.736857,550.763159,1101.526317,315.273641,7,0
0,0,19,19,19,43,62,111,74,185,0.000333,0.367175,9,9913.736857,550.763159,1101.526317,314.040007,7,0
0,0,22,22,18,46,64,112,87,199,0.000333,0.398,9,10746,597,1194,329.1425,8,0
0,0,19,19,18,44,62,101,73,174,0.000333,0.345343,9,9324.271422,518.015079,1036.030158,315.273641,7,0
0,0,10,10,16,18,34,46,35,81,0.000333,0.137361,8,3296.675921,183.148662,412.08449,139.05865,4,0
0,0,10,10,14,17,31,44,33,77,0.000333,0.127158,7,2670.311811,148.350656,381.473116,122.789837,3,0
0,0,19,19,18,44,62,102,73,175,0.000333,0.347328,9,9377.859189,520.992177,1041.984354,315.273641,7,0
0,0,27,27,19,46,65,136,89,225,0.000333,0.451678,9,12195.29482,677.516379,1355.032758,334.794473,9,0
0,0,20,20,18,45,63,104,75,179,0.000333,0.356644,9,9629.397957,534.966553,1069.933106,322.192039,8,0
0,0,20,20,19,44,63,105,74,179,0.000333,0.356644,9,9629.397957,534.966553,1069.933106,320.925614,8,0
0,0,20,20,19,44,63,105,74,179,0.000333,0.356644,9,9629.397957,534.966553,1069.933106,320.925614,8,0
0,0,20,20,18,45,63,105,74,179,0.000333,0.356644,9,9629.397957,534.966553,1069.933106,322.192039,8,0
0,0,19,19,18,45,63,101,74,175,0.000333,0.348675,9,9414.21588,523.011993,1046.023987,322.192039,7,0
0,0,17,17,17,25,42,73,51,124,0.000333,0.222882,16,10698.35777,594.353209,668.64736,185.583273,7,0
0,0,17,17,17,25,42,72,51,123,0.000333,0.221085,16,10612.08069,589.560038,663.255043,185.583273,7,0
0,0,15,15,13,20,33,55,38,93,0.000333,0.156376,6,2814.771919,156.376218,469.128653,134.544278,5,0
0,0,15,15,13,20,33,54,38,92,0.000333,0.154695,6,2784.505554,154.694753,464.084259,134.544278,5,0
0,0,33,33,21,51,72,160,106,266,0.000333,0.547067,20,32824.00101,1823.555612,1641.20005,381.532358,12,0
0,0,12,12,13,16,29,42,31,73,0.000333,0.118211,6,2127.795676,118.210871,354.632613,112.105716,2,0
0,0,12,12,13,16,29,42,31,73,0.000333,0.118211,6,2127.795676,118.210871,354.632613,112.105716,2,0
0,0,12,12,14,16,30,43,32,75,0.000333,0.122672,14,5152.235125,286.235285,368.016795,117.302969,2,0
0,0,12,12,13,16,29,42,32,74,0.000333,0.11983,12,4313.887124,239.660396,359.490594,112.105716,2,0
0,0,20,20,18,45,63,105,74,179,0.000333,0.356644,9,9629.397957,534.966553,1069.933106,322.192039,8,0
0,0,31,31,19,50,69,152,103,255,0.000333,0.519225,18,28038.12726,1557.673736,1557.673736,362.903432,11,0
0,0,33,33,20,51,71,159,115,274,0.000333,0.561677,20,33700.61422,1872.256345,1685.030711,375.732254,12,0
0,0,10,10,15,20,35,48,35,83,0.000333,0.14191,7,2980.113433,165.561857,425.73049,145.041921,4,0
0,0,10,10,13,19,32,46,33,79,0.000333,0.131667,6,2370,131.666667,395,128.816339,3,0
0,0,19,19,18,45,63,101,74,175,0.000333,0.348675,9,9414.21588,523.011993,1046.023987,322.192039,7,0
0,0,19,19,18,44,62,102,73,175,0.000333,0.347328,9,9377.859189,520.992177,1041.984354,315.273641,7,0
0,0,14,14,15,21,36,49,49,98,0.000333,0.168884,14,7093.137102,394.063172,506.65265,150.842025,1,0
0,0,27,27,19,46,65,136,89,225,0.000333,0.451678,9,12195.29482,677.516379,1355.032758,334.794473,9,0
0,0,30,30,19,47,66,150,106,256,0.000333,0.515788,18,27852.5681,1547.364895,1547.364895,341.776299,9,0
0,0,19,19,18,44,62,101,73,174,0.000333,0.345343,9,9324.271422,518.015079,1036.030158,315.273641,7,0
0,0,19,19,19,43,62,102,72,174,0.000333,0.345343,9,9324.271422,518.015079,1036.030158,314.040007,7,0
0,0,29,29,20,46,66,143,101,244,0.000333,0.491611,20,29496.6433,1638.702406,1474.832165,340.522412,9,0
0,0,12,12,13,16,29,42,31,73,0.000333,0.118211,6,2127.795676,118.210871,354.632613,112.105716,2,0
0,0,12,12,13,16,29,42,31,73,0.000333,0.118211,6,2127.795676,118.210871,354.632613,112.105716,2,0
0,0,20,20,18,45,63,105,75,180,0.000333,0.358637,9,9683.193476,537.955193,1075.910386,322.192039,8,0
0,0,30,30,19,48,67,154,106,260,0.000333,0.525728,18,28389.29741,1577.18319,1577.18319,348.788823,9,0
0,0,30,30,19,47,66,145,111,256,0.000333,0.515788,18,27852.5681,1547.364895,1547.364895,341.776299,9,0
0,0,32,32,19,48,67,151,123,274,0.000333,0.554036,18,29917.95189,1662.108438,1662.108438,348.788823,9,0
0,0,18,18,14,25,39,60,59,119,0.000333,0.209654,14,8805.480097,489.193339,628.962864,169.399374,3,0
0,0,34,34,23,58,81,150,122,272,0.000333,0.574813,22,37937.66242,2107.647912,1724.439201,443.804823,10,0
0,0,16,16,14,23,37,58,49,107,0.000333,0.185804,14,7803.761142,433.542286,557.41151,157.344894,3,0
0,0,16,16,16,24,40,62,51,113,0.000333,0.200459,16,9622.045996,534.558111,601.377875,174.0391,4,0
0,0,17,17,14,24,38,66,53,119,0.000333,0.208168,14,8743.047237,485.724847,624.503374,163.342069,3,0
0,0,17,17,16,25,41,70,55,125,0.000333,0.223231,16,10715.10401,595.283556,669.694001,180.096405,4,0
0,0,10,10,12,18,30,44,32,76,0.000333,0.124308,6,2237.542112,124.307895,372.923685,118.0782,3,0
0,0,10,10,14,19,33,46,34,80,0.000333,0.134517,7,2824.860707,156.936706,403.55153,134.013592,4,0
0,0,18,18,15,25,40,66,56,122,0.000333,0.216425,14,9089.853186,504.991844,649.275228,174.699764,3,0
0,0,18,18,17,26,43,70,58,128,0.000333,0.231521,16,11112.99022,617.388345,694.561889,191.698301,4,0
0,0,18,18,14,25,39,60,59,119,0.000333,0.209654,14,8805.480097,489.193339,628.962864,169.399374,3,0
0,0,18,18,16,26,42,64,61,125,0.000333,0.22468,16,10784.63485,599.14638,674.039678,186.211433,4,0
0,0,19,19,18,44,62,102,73,175,0.000333,0.347328,9,9377.859189,520.992177,1041.984354,315.273641,7,0
0,0,32,32,19,51,70,158,112,270,0.000333,0.551635,18,29788.31546,1654.906415,1654.906415,370.004315,11,0
0,0,19,19,18,45,63,101,74,175,0.000333,0.348675,9,9414.21588,523.011993,1046.023987,322.192039,7,0
0,0,10,10,15,20,35,48,35,83,0.000333,0.14191,7,2980.113433,165.561857,425.73049,145.041921,4,0
0,0,10,10,13,19,32,46,33,79,0.000333,0.131667,6,2370,131.666667,395,128.816339,3,0
0,0,19,19,18,45,63,101,74,175,0.000333,0.348675,9,9414.21588,523.011993,1046.023987,322.192039,7,0
0,0,19,19,18,44,62,102,73,175,0.000333,0.347328,9,9377.859189,520.992177,1041.984354,315.273641,7,0
0,0,19,19,18,45,63,101,74,175,0.000333,0.348675,9,9414.21588,523.011993,1046.023987,322.192039,7,0
0,0,14,14,13,16,29,48,40,88,0.000333,0.142501,12,5130.027931,285.001552,427.502328,112.105716,1,0
0,0,18,18,15,26,41,65,57,122,0.000333,0.217874,14,9150.698824,508.372157,653.621345,180.814792,3,0
0,0,17,17,17,26,43,65,57,122,0.000333,0.220668,16,10592.0688,588.448267,662.0043,191.698301,4,0
0,0,17,17,17,25,42,73,51,124,0.000333,0.222882,16,10698.35777,594.353209,668.64736,185.583273,7,0
0,0,17,17,17,25,42,72,51,123,0.000333,0.221085,16,10612.08069,589.560038,663.255043,185.583273,7,0
0,0,15,15,13,20,33,55,38,93,0.000333,0.156376,6,2814.771919,156.376218,469.128653,134.544278,5,0
0,0,15,15,13,20,33,54,38,92,0.000333,0.154695,6,2784.505554,154.694753,464.084259,134.544278,5,0
0,0,32,32,23,50,73,174,108,282,0.000333,0.581844,22,38401.67156,2133.426198,1745.530526,386.234734,13,0
0,0,32,32,23,50,73,174,108,282,0.000333,0.581844,22,38401.67156,2133.426198,1745.530526,386.234734,13,0
0,0,27,27,19,46,65,136,88,224,0.000333,0.44967,9,12141.09351,674.505195,1349.01039,334.794473,10,0
0,0,27,27,20,46,66,136,88,224,0.000333,0.451315,10,13539.44283,752.191268,1353.944283,340.522412,10,0
0,0,27,27,19,47,66,136,89,225,0.000333,0.45333,9,12239.89809,679.994338,1359.988677,341.776299,10,0
0,0,29,29,21,47,68,145,92,237,0.000333,0.48091,10,14427.28693,801.515941,1442.728693,353.304342,10,0
0,0,27,27,19,46,65,136,88,224,0.000333,0.44967,9,12141.09351,674.505195,1349.01039,334.794473,10,0
0,0,19,19,18,45,63,101,74,175,0.000333,0.348675,9,9414.21588,523.011993,1046.023987,322.192039,7,0
0,0,27,27,19,47,66,136,89,225,0.000333,0.45333,9,12239.89809,679.994338,1359.988677,341.776299,10,0
0,0,21,21,18,27,45,80,55,135,0.000333,0.247133,18,13345.20302,741.400168,741.400168,203.440613,7,0
0,0,21,21,18,26,44,80,55,135,0.000333,0.245674,18,13266.41883,737.023269,737.023269,197.270083,7,0
0,0,19,19,14,22,36,62,42,104,0.000333,0.179224,7,3763.705401,209.094745,537.6722,151.410465,5,0
0,0,19,19,14,21,35,62,42,104,0.000333,0.177815,14,7468.236073,414.902004,533.445434,145.541635,5,0
0,0,19,19,18,44,62,110,75,185,0.000333,0.367175,9,9913.736857,550.763159,1101.526317,315.273641,7,0
0,0,30,30,19,49,68,148,100,248,0.000333,0.50323,18,27174.43412,1509.690785,1509.690785,355.831405,11,0
0,0,11,11,12,20,32,44,36,80,0.000333,0.133333,6,2400,133.333333,400,129.458112,3,0
0,0,11,11,14,21,35,46,38,84,0.000333,0.14362,7,3016.018414,167.556579,430.859773,145.541635,4,0
0,0,32,32,23,50,73,174,108,282,0.000333,0.581844,22,38401.67156,2133.426198,1745.530526,386.234734,13,0
0,0,32,32,23,50,73,174,108,282,0.000333,0.581844,22,38401.67156,2133.426198,1745.530526,386.234734,13,0
0,0,27,27,19,45,64,136,88,224,0.000333,0.448,9,12096,672,1344,327.844012,9,0
0,0,29,29,19,47,66,145,102,247,0.000333,0.497655,18,26873.37626,1492.965347,1492.965347,341.776299,9,0
0,0,19,19,18,44,62,102,73,175,0.000333,0.347328,9,9377.859189,520.992177,1041.984354,315.273641,7,0
0,0,31,31,19,50,69,152,109,261,0.000333,0.531442,18,28697.8479,1594.324883,1594.324883,362.903432,11,0
0,0,15,15,15,21,36,58,38,96,0.000333,0.165438,7,3474.189601,193.010533,496.3128,150.842025,6,0
0,0,15,15,15,20,35,58,38,96,0.000333,0.164137,7,3446.878187,191.493233,492.41117,145.041921,6,0
0,0,15,15,13,20,33,54,36,90,0.000333,0.151332,6,2723.972824,151.331824,453.995471,134.544278,5,0
0,0,15,15,13,19,32,54,36,90,0.000333,0.15,6,2700,150,450,128.816339,5,0
0,0,29,29,21,48,69,145,106,251,0.000333,0.51108,20,30664.79277,1703.599599,1533.239639,360.316866,9,0
0,0,24,24,20,44,64,131,87,218,0.000333,0.436,10,13080,726.666667,1308,326.653553,9,0
0,0,21,21,18,46,64,110,80,190,0.000333,0.38,9,10260,570,1140,329.1425,7,0
0,0,19,19,18,42,60,101,71,172,0.000333,0.338662,9,9143.866642,507.992591,1015.985182,301.535982,7,0
0,0,29,29,19,48,67,146,96,242,0.000333,0.489331,18,26423.88451,1467.993584,1467.993584,348.788823,11,0
0,0,18,18,16,43,59,98,69,167,0.000333,0.327467,8,7859.211114,436.62284,982.401389,297.329384,7,0
0,0,22,22,19,47,66,113,82,195,0.000333,0.392886,9,10607.91168,589.328427,1178.656853,341.776299,8,0
0,0,22,22,18,47,65,112,91,203,0.000333,0.407514,9,11002.86599,611.270333,1222.540666,336.124326,8,0
0,0,21,21,18,46,64,109,87,196,0.000333,0.392,9,10584,588,1176,329.1425,7,0
0,0,20,20,18,47,65,104,76,180,0.000333,0.361342,9,9756.235857,542.013103,1084.026206,336.124326,8,0
0,0,20,20,19,46,65,104,75,179,0.000333,0.359335,9,9702.034547,539.001919,1078.003839,334.794473,8,0
0,0,20,20,18,45,63,104,75,179,0.000333,0.356644,9,9629.397957,534.966553,1069.933106,322.192039,8,0
0,0,21,21,21,46,67,110,81,191,0.000333,0.386208,10,11586.23035,643.679464,1158.623035,346.322516,8,0
0,0,27,27,19,46,65,136,89,225,0.000333,0.451678,9,12195.29482,677.516379,1355.032758,334.794473,9,0
0,0,19,19,18,45,63,101,74,175,0.000333,0.348675,9,9414.21588,523.011993,1046.023987,322.192039,7,0
0,0,18,18,16,44,60,98,70,168,0.000333,0.330786,8,7938.86096,441.047831,992.35762,304.214991,7,0
0,0,31,31,19,50,69,152,109,261,0.000333,0.531442,18,28697.8479,1594.324883,1594.324883,362.903432,11,0
0,0,32,32,23,50,73,174,108,282,0.000333,0.581844,22,38401.67156,2133.426198,1745.530526,386.234734,13,0
0,0,32,32,23,50,73,174,108,282,0.000333,0.581844,22,38401.67156,2133.426198,1745.530526,386.234734,13,0
0,0,18,18,13,30,43,99,79,178,0.000333,0.321958,12,11590.50152,643.916751,965.875126,195.312434,5,0
0,0,20,20,16,29,45,87,59,146,0.000333,0.26727,16,12828.96883,712.720491,801.810552,204.881449,12,0
0,0,27,27,20,46,66,242,139,381,0.000333,0.767638,30,69087.42478,3838.190266,2302.914159,340.522412,20,0
0,0,32,32,17,35,52,143,112,255,0.000333,0.484537,24,34886.69108,1938.149504,1453.612128,249.011774,9,0
0,0,26,26,15,34,49,110,91,201,0.000333,0.376186,14,15799.7935,877.766306,1128.556679,231.577096,8,0
0,0,26,26,15,34,49,110,91,201,0.000333,0.376186,14,15799.7935,877.766306,1128.556679,231.577096,8,0
0,0,10,10,12,25,37,55,37,92,0.000333,0.159757,6,2875.618258,159.75657,479.26971,159.115955,4,0
0,0,40,40,22,48,70,179,141,320,0.000333,0.65379,22,43150.15244,2397.230691,1961.370565,366.185696,12,0
0,0,26,26,20,39,59,131,103,234,0.000333,0.458846,20,27530.76947,1529.487193,1376.538474,292.569248,9,0
0,0,26,26,20,39,59,131,103,234,0.000333,0.458846,20,27530.76947,1529.487193,1376.538474,292.569248,9,0
0,0,19,19,16,23,39,66,44,110,0.000333,0.193798,8,4651.153953,258.397442,581.394244,168.041925,6,0
0,0,19,19,16,22,38,66,44,110,0.000333,0.192424,16,9236.352424,513.13069,577.272026,162.107496,6,0
0,0,19,19,14,22,36,62,42,104,0.000333,0.179224,7,3763.705401,209.094745,537.6722,151.410465,5,0
0,0,19,19,14,21,35,62,42,104,0.000333,0.177815,14,7468.236073,414.902004,533.445434,145.541635,5,0
0,0,30,30,19,50,69,149,99,248,0.000333,0.504971,9,13634.22659,757.457033,1514.914065,362.903432,11,0
0,0,27,27,19,46,65,135,91,226,0.000333,0.453685,9,12249.49613,680.527563,1361.055126,334.794473,9,0
0,0,27,27,20,47,67,144,95,239,0.000333,0.483265,20,28995.90633,1610.883685,1449.795317,347.504238,11,0
0,0,30,30,19,49,68,148,100,248,0.000333,0.50323,18,27174.43412,1509.690785,1509.690785,355.831405,11,0
0,0,36,36,20,53,73,170,130,300,0.000333,0.618982,20,37138.94735,2063.274853,1856.947368,390.018346,12,0
0,0,29,29,22,47,69,314,169,483,0.000333,0.983472,33,97363.77132,5409.098406,2950.417313,359.173172,6,0
0,0,29,29,22,47,69,314,169,483,0.000333,0.983472,33,97363.77132,5409.098406,2950.417313,359.173172,6,0
0,0,28,28,22,48,70,308,167,475,0.000333,0.97047,33,96076.51129,5337.583961,2911.409433,366.185696,6,0
0,0,28,28,22,48,70,308,167,475,0.000333,0.97047,33,96076.51129,5337.583961,2911.409433,366.185696,6,0
0,0,16,16,14,25,39,54,46,100,0.000333,0.17618,7,3699.781553,205.54342,528.540222,169.399374,3,0
0,0,16,16,16,26,42,58,48,106,0.000333,0.190529,8,4572.685175,254.038065,571.585647,186.211433,4,0
0,0,33,33,19,51,70,163,116,279,0.000333,0.570023,18,30781.25931,1710.069962,1710.069962,370.004315,11,0
0,0,19,19,18,44,62,110,75,185,0.000333,0.367175,9,9913.736857,550.763159,1101.526317,315.273641,7,0
0,0,19,19,19,43,62,111,74,185,0.000333,0.367175,9,9913.736857,550.763159,1101.526317,314.040007,7,0
0,0,19,19,19,43,62,111,74,185,0.000333,0.367175,9,9913.736857,550.763159,1101.526317,314.040007,7,0
0,0,54,54,22,50,72,273,179,452,0.000333,0.929602,33,92030.60132,5112.811185,2788.806101,380.300305,21,0
0,0,48,48,22,50,72,229,144,373,0.000333,0.767127,22,50630.40456,2812.800253,2301.382026,380.300305,18,0
0,0,32,32,21,50,71,154,100,254,0.000333,0.520679,20,31240.71537,1735.595298,1562.035768,374.431475,13,0
0,0,32,32,21,50,71,153,100,253,0.000333,0.518629,20,31117.72043,1728.762246,1555.886021,374.431475,13,0
0,0,32,32,21,50,71,154,100,254,0.000333,0.520679,20,31240.71537,1735.595298,1562.035768,374.431475,13,0
0,0,32,32,21,50,71,153,100,253,0.000333,0.518629,20,31117.72043,1728.762246,1555.886021,374.431475,13,0
0,0,32,32,21,50,71,154,100,254,0.000333,0.520679,20,31240.71537,1735.595298,1562.035768,374.431475,13,0
0,0,32,32,21,50,71,153,100,253,0.000333,0.518629,20,31117.72043,1728.762246,1555.886021,374.431475,13,0
0,0,32,32,21,49,70,153,99,252,0.000333,0.51486,20,30891.58641,1716.199245,1544.57932,367.359448,13,0
0,0,32,32,21,49,70,153,99,252,0.000333,0.51486,20,30891.58641,1716.199245,1544.57932,367.359448,13,0
0,0,32,32,21,49,70,153,99,252,0.000333,0.51486,20,30891.58641,1716.199245,1544.57932,367.359448,13,0
0,0,32,32,21,49,70,153,99,252,0.000333,0.51486,20,30891.58641,1716.199245,1544.57932,367.359448,13,0
0,0,34,34,22,49,71,157,102,259,0.000333,0.530928,22,35041.25909,1946.736616,1592.784504,373.228278,13,0
0,0,34,34,22,49,71,157,102,259,0.000333,0.530928,22,35041.25909,1946.736616,1592.784504,373.228278,13,0
0,0,34,34,22,49,71,158,102,260,0.000333,0.532978,22,35176.55352,1954.252974,1598.934251,373.228278,13,0
0,0,34,34,22,49,71,158,102,260,0.000333,0.532978,22,35176.55352,1954.252974,1598.934251,373.228278,13,0
0,0,32,32,21,49,70,153,99,252,0.000333,0.51486,20,30891.58641,1716.199245,1544.57932,367.359448,13,0
0,0,32,32,21,49,70,153,99,252,0.000333,0.51486,20,30891.58641,1716.199245,1544.57932,367.359448,13,0
0,0,22,22,20,46,66,114,78,192,0.000333,0.386841,10,11605.23671,644.735373,1160.523671,340.522412,8,0
0,0,20,20,18,46,64,105,75,180,0.000333,0.36,9,9720,540,1080,329.1425,8,0
0,0,20,20,18,46,64,105,75,180,0.000333,0.36,9,9720,540,1080,329.1425,8,0
0,0,20,20,19,45,64,105,74,179,0.000333,0.358,9,9666,537,1074,327.844012,8,0
0,0,20,20,18,44,62,105,74,179,0.000333,0.355267,9,9592.210256,532.90057,1065.80114,315.273641,8,0
0,0,21,21,21,45,66,111,80,191,0.000333,0.384826,10,11544.79277,641.377376,1154.479277,339.372055,8,0
0,0,30,30,19,51,70,149,99,248,0.000333,0.506687,9,13680.55969,760.031094,1520.062188,370.004315,12,0
0,0,30,30,19,51,70,149,99,248,0.000333,0.506687,9,13680.55969,760.031094,1520.062188,370.004315,12,0
0,0,30,30,19,50,69,149,98,247,0.000333,0.502935,9,13579.24987,754.40277,1508.805541,362.903432,12,0
0,0,30,30,19,50,69,149,98,247,0.000333,0.502935,9,13579.24987,754.40277,1508.805541,362.903432,12,0
0,0,30,30,19,49,68,149,98,247,0.000333,0.501201,18,27064.85979,1503.603322,1503.603322,355.831405,12,0
0,0,32,32,21,52,73,158,116,274,0.000333,0.565337,20,33920.23858,1884.457699,1696.011929,388.661531,11,0
0,0,30,30,20,48,68,150,97,247,0.000333,0.501201,20,30072.06644,1670.670358,1503.603322,354.516762,11,0
0,0,27,27,20,48,68,144,97,241,0.000333,0.489026,20,29341.5709,1630.087272,1467.078545,354.516762,11,0
0,0,21,21,18,29,47,81,56,137,0.000333,0.25366,9,6848.808054,380.489336,760.978673,215.940099,7,0
0,0,21,21,18,28,46,81,56,137,0.000333,0.252243,18,13621.10378,756.727988,756.727988,209.664588,7,0
0,0,19,19,14,23,37,63,43,106,0.000333,0.184067,7,3865.414397,214.745244,552.202057,157.344894,5,0
0,0,19,19,14,22,36,63,43,106,0.000333,0.182671,7,3836.084351,213.115797,548.01205,151.410465,5,0
0,0,17,17,17,26,43,71,50,121,0.000333,0.218859,8,5252.624283,291.81246,656.578035,191.698301,7,0
0,0,17,17,17,26,43,71,50,121,0.000333,0.218859,8,5252.624283,291.81246,656.578035,191.698301,7,0
0,0,15,15,13,20,33,53,37,90,0.000333,0.151332,6,2723.972824,151.331824,453.995471,134.544278,5,0
0,0,15,15,13,20,33,53,37,90,0.000333,0.151332,6,2723.972824,151.331824,453.995471,134.544278,5,0
0,0,17,17,17,26,43,72,52,124,0.000333,0.224286,16,10765.70927,598.09496,672.85683,191.698301,7,0
0,0,17,17,17,26,43,71,52,123,0.000333,0.222477,16,10678.88904,593.271613,667.430565,191.698301,7,0
0,0,15,15,13,20,33,54,39,93,0.000333,0.156376,6,2814.771919,156.376218,469.128653,134.544278,5,0
0,0,15,15,13,20,33,53,39,92,0.000333,0.154695,6,2784.505554,154.694753,464.084259,134.544278,5,0
0,0,45,45,28,62,90,178,145,323,0.000333,0.698956,28,58712.3194,3261.795522,2096.86855,503.766109,12,0
0,0,18,18,17,24,41,61,68,129,0.000333,0.230375,16,11057.98734,614.33263,691.124209,179.525968,3,0
0,0,13,13,13,19,32,47,35,82,0.000333,0.136667,6,2460,136.666667,410,128.816339,3,0
0,0,15,15,17,25,42,65,48,113,0.000333,0.203111,8,4874.65495,270.814164,609.331869,185.583273,5,0
0,0,17,17,17,27,44,72,52,124,0.000333,0.225657,8,5415.756166,300.875343,676.969521,197.868831,7,0
0,0,17,17,17,27,44,71,52,123,0.000333,0.223837,8,5372.080713,298.448928,671.510089,197.868831,7,0
0,0,15,15,13,21,34,54,39,93,0.000333,0.157711,6,2838.804265,157.711348,473.134044,140.344382,5,0
0,0,15,15,13,21,34,53,39,92,0.000333,0.156016,6,2808.279488,156.015527,468.046581,140.344382,5,0
0,0,17,17,17,27,44,72,52,124,0.000333,0.225657,8,5415.756166,300.875343,676.969521,197.868831,7,0
0,0,17,17,17,27,44,71,52,123,0.000333,0.223837,8,5372.080713,298.448928,671.510089,197.868831,7,0
0,0,15,15,13,21,34,54,39,93,0.000333,0.157711,6,2838.804265,157.711348,473.134044,140.344382,5,0
0,0,15,15,13,21,34,53,39,92,0.000333,0.156016,6,2808.279488,156.015527,468.046581,140.344382,5,0
0,0,17,17,17,27,44,71,50,121,0.000333,0.220197,8,5284.729807,293.5961,660.591226,197.868831,7,0
0,0,17,17,17,26,43,71,50,121,0.000333,0.218859,8,5252.624283,291.81246,656.578035,191.698301,7,0
0,0,15,15,13,21,34,53,37,90,0.000333,0.152624,6,2747.229934,152.623885,457.871656,140.344382,5,0
0,0,15,15,13,20,33,53,37,90,0.000333,0.151332,6,2723.972824,151.331824,453.995471,134.544278,5,0
0,0,33,33,21,50,71,160,105,265,0.000333,0.543228,20,32593.65973,1810.758874,1629.682987,374.431475,12,0
0,0,29,29,19,48,67,146,96,242,0.000333,0.489331,18,26423.88451,1467.993584,1467.993584,348.788823,11,0
0,0,31,31,19,49,68,152,106,258,0.000333,0.523522,18,28270.17744,1570.565413,1570.565413,355.831405,11,0
0,0,31,31,19,51,70,153,103,256,0.000333,0.523032,18,28243.73614,1569.096452,1569.096452,370.004315,11,0
0,0,32,32,19,49,68,158,104,262,0.000333,0.531638,18,28708.47476,1594.915264,1594.915264,355.831405,11,0
0,0,19,19,18,45,63,101,74,175,0.000333,0.348675,9,9414.21588,523.011993,1046.023987,322.192039,7,0
0,0,19,19,18,45,63,101,74,175,0.000333,0.348675,9,9414.21588,523.011993,1046.023987,322.192039,7,0
0,0,21,21,18,46,64,110,80,190,0.000333,0.38,9,10260,570,1140,329.1425,7,0
0,0,22,22,19,47,66,113,82,195,0.000333,0.392886,9,10607.91168,589.328427,1178.656853,341.776299,8,0
0,0,21,21,21,46,67,110,81,191,0.000333,0.386208,10,11586.23035,643.679464,1158.623035,346.322516,8,0
0,0,30,30,19,50,69,149,99,248,0.000333,0.504971,9,13634.22659,757.457033,1514.914065,362.903432,11,0
0,0,34,34,23,56,79,158,111,269,0.000333,0.565239,11,18652.88723,1036.271513,1695.717021,429.253801,14,0
0,0,34,34,23,56,79,157,111,268,0.000333,0.563138,11,18583.54565,1032.419203,1689.413241,429.253801,14,0
0,0,15,15,13,20,33,55,38,93,0.000333,0.156376,6,2814.771919,156.376218,469.128653,134.544278,5,0
0,0,15,15,13,20,33,54,38,92,0.000333,0.154695,6,2784.505554,154.694753,464.084259,134.544278,5,0
0,0,40,40,23,58,81,178,122,300,0.000333,0.633985,22,41843.01002,2324.611668,1901.955001,443.804823,14,0
0,0,59,59,24,56,80,280,192,472,0.000333,0.99465,36,107422.2022,5967.900122,2983.950061,435.250976,22,0
0,0,64,64,24,56,80,301,205,506,0.000333,1.066299,36,115160.2422,6397.791232,3198.895616,435.250976,23,0
0,0,21,21,14,22,36,76,48,124,0.000333,0.21369,14,8974.989803,498.610545,641.0707,151.410465,5,0
0,0,26,26,14,22,36,97,61,158,0.000333,0.272283,14,11435.8741,635.326339,816.84815,151.410465,6,0
0,0,34,34,23,56,79,157,109,266,0.000333,0.558935,11,18444.86247,1024.714582,1676.805679,429.253801,14,0
0,0,34,34,23,55,78,157,109,266,0.000333,0.557306,11,18391.08689,1021.72705,1671.91699,422.016709,14,0
0,0,15,15,13,20,33,54,36,90,0.000333,0.151332,6,2723.972824,151.331824,453.995471,134.544278,5,0
0,0,15,15,13,19,32,54,36,90,0.000333,0.15,6,2700,150,450,128.816339,5,0
0,0,17,17,18,25,43,72,49,121,0.000333,0.218859,9,5909.202318,328.289018,656.578035,191.155055,7,0
0,0,17,17,18,25,43,72,49,121,0.000333,0.218859,9,5909.202318,328.289018,656.578035,191.155055,7,0
0,0,15,15,14,20,34,54,36,90,0.000333,0.152624,7,3205.10159,178.061199,457.871656,139.741531,5,0
0,0,15,15,14,20,34,54,36,90,0.000333,0.152624,7,3205.10159,178.061199,457.871656,139.741531,5,0
0,0,17,17,18,24,42,72,49,121,0.000333,0.21749,18,11744.46735,652.470408,652.470408,185.09775,7,0
0,0,15,15,14,19,33,54,36,90,0.000333,0.151332,7,3177.968295,176.553794,453.995471,134.013592,5,0
0,0,18,18,17,25,42,75,60,135,0.000333,0.242654,16,11647.40563,647.078091,727.962852,185.583273,6,0
0,0,18,18,17,25,42,75,60,135,0.000333,0.242654,16,11647.40563,647.078091,727.962852,185.583273,6,0
0,0,16,16,13,20,33,57,44,101,0.000333,0.169828,12,6113.805673,339.655871,509.483806,134.544278,4,0
0,0,15,15,17,23,40,66,47,113,0.000333,0.200459,16,9622.045996,534.558111,601.377875,173.528793,5,0
0,0,13,13,13,18,31,48,34,82,0.000333,0.135415,6,2437.464585,135.414699,406.244097,123.164366,3,0
0,0,19,19,18,45,63,101,74,175,0.000333,0.348675,9,9414.21588,523.011993,1046.023987,322.192039,7,0
0,0,19,19,18,45,63,101,74,175,0.000333,0.348675,9,9414.21588,523.011993,1046.023987,322.192039,7,0
0,0,21,21,18,46,64,109,87,196,0.000333,0.392,9,10584,588,1176,329.1425,7,0
0,0,19,19,18,45,63,101,74,175,0.000333,0.348675,9,9414.21588,523.011993,1046.023987,322.192039,7,0
0,0,19,19,18,45,63,101,74,175,0.000333,0.348675,9,9414.21588,523.011993,1046.023987,322.192039,7,0
0,0,19,19,18,45,63,101,74,175,0.000333,0.348675,9,9414.21588,523.011993,1046.023987,322.192039,7,0
0,0,18,18,16,44,60,98,70,168,0.000333,0.330786,8,7938.86096,441.047831,992.35762,304.214991,7,0
0,0,22,22,20,46,66,109,78,187,0.000333,0.376767,10,11303.017,627.945389,1130.3017,340.522412,8,0
0,0,22,22,19,46,65,108,78,186,0.000333,0.373387,9,10081.44372,560.080207,1120.160413,334.794473,8,0
0,0,20,20,18,46,64,104,75,179,0.000333,0.358,9,9666,537,1074,329.1425,8,0
0,0,20,20,18,47,65,104,76,180,0.000333,0.361342,9,9756.235857,542.013103,1084.026206,336.124326,8,0
0,0,22,22,20,47,67,113,79,192,0.000333,0.38823,10,11646.89125,647.049514,1164.689125,347.504238,8,0
0,0,20,20,19,46,65,104,75,179,0.000333,0.359335,9,9702.034547,539.001919,1078.003839,334.794473,8,0
0,0,20,20,18,47,65,104,76,180,0.000333,0.361342,9,9756.235857,542.013103,1084.026206,336.124326,8,0
0,0,21,21,21,46,67,110,81,191,0.000333,0.386208,10,11586.23035,643.679464,1158.623035,346.322516,8,0
0,0,20,20,18,45,63,104,75,179,0.000333,0.356644,9,9629.397957,534.966553,1069.933106,322.192039,8,0
0,0,33,33,19,52,71,167,116,283,0.000333,0.580126,18,31326.81183,1740.378435,1740.378435,377.133488,11,0
0,0,34,34,23,56,79,157,109,266,0.000333,0.558935,11,18444.86247,1024.714582,1676.805679,429.253801,14,0
0,0,34,34,23,55,78,157,109,266,0.000333,0.557306,11,18391.08689,1021.72705,1671.91699,422.016709,14,0
0,0,15,15,13,20,33,54,36,90,0.000333,0.151332,6,2723.972824,151.331824,453.995471,134.544278,5,0
0,0,15,15,13,19,32,54,36,90,0.000333,0.15,6,2700,150,450,128.816339,5,0
0,0,24,24,20,43,63,131,85,216,0.000333,0.430364,10,12910.92464,717.273591,1291.092463,319.767946,9,0
0,0,24,24,20,44,64,131,87,218,0.000333,0.436,10,13080,726.666667,1308,326.653553,9,0
0,0,27,27,20,44,64,146,89,235,0.000333,0.47,20,28200,1566.666667,1410,326.653553,9,0
0,0,27,27,21,45,66,147,90,237,0.000333,0.477507,20,28650.42813,1591.690451,1432.521406,339.372055,9,0
0,0,29,29,21,47,68,154,104,258,0.000333,0.523522,20,31411.30826,1745.072681,1570.565413,353.304342,9,0
0,0,29,29,22,48,70,155,110,265,0.000333,0.54142,22,35733.71999,1985.206666,1624.259999,366.185696,9,0
0,0,36,36,21,52,73,182,124,306,0.000333,0.631362,20,37881.7263,2104.54035,1894.086315,388.661531,13,0
0,0,36,36,23,55,78,186,132,318,0.000333,0.666253,22,43972.67392,2442.926329,1998.757906,422.016709,13,0
0,0,34,34,21,51,72,176,114,290,0.000333,0.596426,20,35785.56501,1988.086945,1789.27825,381.532358,13,0
0,0,34,34,23,54,77,180,120,300,0.000333,0.626679,22,41360.79117,2297.821732,1880.035962,414.80585,13,0
0,0,32,32,21,49,70,166,106,272,0.000333,0.555722,20,33343.29961,1852.405534,1667.164981,367.359448,11,0
0,0,32,32,21,48,69,167,107,274,0.000333,0.557912,20,33474.71402,1859.706335,1673.735701,360.316866,11,0
0,0,30,30,19,49,68,158,100,258,0.000333,0.523522,18,28270.17744,1570.565413,1570.565413,355.831405,11,0
0,0,30,30,20,48,68,159,99,258,0.000333,0.523522,20,31411.30826,1745.072681,1570.565413,354.516762,11,0
0,0,35,35,23,51,74,186,116,302,0.000333,0.625085,22,41255.60816,2291.978231,1875.254916,393.335617,13,0
0,0,34,34,23,51,74,181,116,297,0.000333,0.614736,22,40572.56829,2254.031572,1844.20765,393.335617,13,0
0,0,29,29,25,35,60,145,116,261,0.000333,0.513899,36,55501.14404,3083.396891,1541.698445,295.62131,14,0
0,0,53,53,22,52,74,256,208,464,0.000333,0.960395,44,126772.1999,7042.899995,2881.186362,394.530361,29,0
0,0,54,54,24,52,76,268,212,480,0.000333,0.999668,48,143952.2499,7997.347217,2999.005206,406.461965,31,0
0,0,61,61,27,52,79,277,224,501,0.000333,1.052731,52,164226.0961,9123.672003,3158.194155,424.804828,31,0
0,0,66,66,25,60,85,353,279,632,0.000333,1.350245,48,194435.2834,10801.96019,4050.735072,470.50984,37,0
0,0,67,67,26,60,86,365,283,648,0.000333,1.388073,52,216539.4172,12029.96762,4164.219561,476.624868,39,0
0,0,74,74,30,60,90,374,295,669,0.000333,1.447683,60,260582.9833,14476.83241,4343.049721,501.620154,39,0
0,0,70,70,24,65,89,382,300,682,0.000333,1.47215,48,211989.6096,11777.20053,4416.4502,501.493008,42,0
0,0,71,71,25,65,90,394,304,698,0.000333,1.510438,48,217503.0461,12083.50256,4531.313461,507.550313,44,0
0,0,78,78,29,65,94,403,316,719,0.000333,1.570916,56,263913.9655,14661.88697,4712.749384,532.335357,44,0
0,0,73,73,33,71,104,415,307,722,0.000333,1.612572,64,309613.9185,17200.77325,4837.717476,603.097051,28,0
0,0,39,39,21,41,62,216,158,374,0.000333,0.74229,30,66806.0826,3711.449033,2226.86942,311.898298,18,0
0,0,25,25,16,26,42,115,93,208,0.000333,0.373867,24,26918.44858,1495.469365,1121.602024,186.211433,14,0
0,0,46,46,23,46,69,255,187,442,0.000333,0.899989,44,118798.5836,6599.921313,2699.96781,358.125775,24,0
0,0,30,30,18,30,48,145,118,263,0.000333,0.489615,27,39658.81872,2203.267707,1468.845138,222.265368,20,0
0,0,42,42,21,36,57,195,156,351,0.000333,0.682448,40,81893.7758,4549.654211,2047.344395,278.355966,23,0
0,0,79,79,24,55,79,455,318,773,0.000333,1.624274,60,292369.3511,16242.74173,4872.822518,428.013884,31,0
0,0,65,65,24,59,83,342,274,616,0.000333,1.309008,48,188497.1659,10472.06477,3927.02429,457.11504,37,0
0,0,66,66,25,59,84,354,278,632,0.000333,1.346648,48,193917.3413,10773.18563,4039.944611,463.172345,39,0
0,0,73,73,29,59,88,363,290,653,0.000333,1.406003,56,236208.4954,13122.69419,4218.008847,487.957389,39,0
0,0,11,11,15,19,34,54,51,105,0.000333,0.178061,14,7478.570377,415.476132,534.183598,139.313982,6,0
0,0,21,21,19,30,49,96,64,160,0.000333,0.299451,18,16170.36435,898.353575,898.353575,227.917341,11,0
0,0,26,26,22,22,44,112,68,180,0.000333,0.327566,33,32429.02382,1801.612434,982.697691,196.214991,11,0
0,0,10,10,16,21,37,53,43,96,0.000333,0.166703,16,8001.72037,444.540021,500.107523,156.238666,4,0
0,0,10,10,16,19,35,51,39,90,0.000333,0.153878,16,7386.167544,410.342641,461.635472,144.710623,4,0
0,0,13,13,17,21,38,67,53,120,0.000333,0.209917,16,10076.02083,559.778935,629.751302,161.725534,6,0
0,0,10,10,15,21,36,55,45,100,0.000333,0.172331,14,7237.895002,402.105278,516.9925,150.842025,4,0
0,0,13,13,21,25,46,70,58,128,0.000333,0.235672,20,14140.31861,785.573256,707.01593,208.335071,5,0
0,0,13,13,21,23,44,68,55,123,0.000333,0.223837,20,13430.20178,746.122321,671.510089,196.280591,5,0
0,0,13,13,21,24,45,69,56,125,0.000333,0.228827,20,13729.63274,762.757374,686.481637,202.277766,5,0
0,0,13,13,21,23,44,68,54,122,0.000333,0.222017,20,13321.01315,740.056286,666.050657,196.280591,5,0
0,0,13,13,21,25,46,72,60,132,0.000333,0.243037,20,14582.20356,810.12242,729.110178,208.335071,5,0
0,0,44,44,29,44,73,206,151,357,0.000333,0.736589,42,92810.22944,5156.123858,2209.767368,381.09644,14,0
0,0,48,48,32,35,67,215,133,348,0.000333,0.703666,48,101327.9538,5629.330769,2110.999038,339.524906,17,0
0,0,15,15,20,26,46,100,68,168,0.000333,0.309319,20,18559.16817,1031.064898,927.958409,208.649995,7,0
0,0,37,37,30,40,70,186,123,309,0.000333,0.631316,45,85227.68035,4734.871131,1893.948452,360.083842,12,0
0,0,49,49,29,45,74,227,162,389,0.000333,0.805159,42,101450.0491,5636.113838,2415.477359,388.014838,16,0
0,0,37,37,30,38,68,176,117,293,0.000333,0.594542,45,80263.19756,4459.066531,1783.626612,346.627963,12,0
0,0,49,49,29,48,77,237,168,405,0.000333,0.846016,42,106598.0391,5922.113281,2538.048549,408.959649,16,0
0,0,22,22,23,20,43,109,76,185,0.000333,0.33462,33,33127.34633,1840.408129,1003.85898,190.480487,7,0
0,0,22,22,30,20,50,167,100,267,0.000333,0.502303,75,113018.2202,6278.790011,1506.909603,233.64528,15,0
0,0,10,10,16,14,30,47,33,80,0.000333,0.13085,16,6280.819962,348.934442,392.551248,117.302969,3,0
0,0,30,30,20,40,60,257,140,397,0.000333,0.781679,30,70351.06699,3908.392611,2345.035566,299.315686,11,0
0,0,30,30,20,42,62,254,142,396,0.000333,0.785954,30,70735.85217,3929.769565,2357.861739,312.915894,11,0
0,0,30,30,20,42,62,257,142,399,0.000333,0.791908,30,71271.72984,3959.540546,2375.724328,312.915894,11,0
0,0,36,36,24,49,73,292,168,460,0.000333,0.949106,36,102503.4947,5694.638594,2847.319297,385.159882,13,0
0,0,34,34,20,48,68,283,163,446,0.000333,0.905003,30,81450.25282,4525.014045,2715.008427,354.516762,12,0
0,0,34,34,20,45,65,281,159,440,0.000333,0.883281,30,79495.25513,4416.403063,2649.841838,333.571951,12,0
0,0,33,33,20,48,68,280,161,441,0.000333,0.894857,30,80537.13339,4474.285188,2684.571113,354.516762,11,0
0,0,33,33,20,45,65,278,157,435,0.000333,0.873243,30,78591.89996,4366.216664,2619.729999,333.571951,11,0
0,0,33,33,23,43,66,290,167,457,0.000333,0.920763,33,91155.50771,5064.194873,2762.288113,337.371309,12,0
0,0,33,33,23,42,65,293,167,460,0.000333,0.92343,33,91419.5434,5078.863522,2770.289194,330.519257,12,0
0,0,34,34,23,43,66,289,165,454,0.000333,0.914718,33,90557.1127,5030.950705,2744.15493,337.371309,13,0
0,0,33,33,23,44,67,290,169,459,0.000333,0.928112,33,91883.05297,5104.614054,2784.334938,344.256916,12,0
0,0,33,33,23,44,67,293,169,462,0.000333,0.934178,33,92483.5958,5137.977544,2802.533206,344.256916,12,0
0,0,33,33,23,43,66,286,163,449,0.000333,0.904644,33,89559.78767,4975.543759,2713.93296,337.371309,12,0
0,0,42,42,26,58,84,337,200,537,0.000333,1.144225,39,133874.3038,7437.461321,3432.674456,461.97433,13,0
0,0,51,51,23,40,63,436,233,669,0.000333,1.332933,55,219934.0148,12218.55638,3998.800269,316.919049,20,0
0,0,47,47,23,35,58,419,226,645,0.000333,1.259466,66,249374.251,13854.12505,3778.397742,283.566831,19,0
0,0,41,41,21,49,70,352,197,549,0.000333,1.121659,40,134599.0551,7477.725281,3364.976376,367.359448,15,0
0,0,30,30,20,42,62,254,142,396,0.000333,0.785954,30,70735.85217,3929.769565,2357.861739,312.915894,11,0
0,0,30,30,20,40,60,257,140,397,0.000333,0.781679,30,70351.06699,3908.392611,2345.035566,299.315686,11,0
0,0,30,30,20,42,62,257,142,399,0.000333,0.791908,30,71271.72984,3959.540546,2375.724328,312.915894,11,0
0,0,33,33,23,43,66,290,167,457,0.000333,0.920763,33,91155.50771,5064.194873,2762.288113,337.371309,12,0
0,0,33,33,23,44,67,290,169,459,0.000333,0.928112,33,91883.05297,5104.614054,2784.334938,344.256916,12,0
0,0,33,33,23,43,66,286,163,449,0.000333,0.904644,33,89559.78767,4975.543759,2713.93296,337.371309,12,0
0,0,33,33,23,42,65,293,167,460,0.000333,0.92343,33,91419.5434,5078.863522,2770.289194,330.519257,12,0
0,0,34,34,23,43,66,289,165,454,0.000333,0.914718,33,90557.1127,5030.950705,2744.15493,337.371309,13,0
0,0,33,33,23,44,67,293,169,462,0.000333,0.934178,33,92483.5958,5137.977544,2802.533206,344.256916,12,0
0,0,47,47,23,35,58,419,226,645,0.000333,1.259466,66,249374.251,13854.12505,3778.397742,283.566831,19,0
0,0,51,51,23,40,63,436,233,669,0.000333,1.332933,55,219934.0148,12218.55638,3998.800269,316.919049,20,0
0,0,42,42,26,58,84,337,200,537,0.000333,1.144225,39,133874.3038,7437.461321,3432.674456,461.97433,13,0
0,0,33,33,20,45,65,278,157,435,0.000333,0.873243,30,78591.89996,4366.216664,2619.729999,333.571951,11,0
0,0,33,33,20,48,68,280,161,441,0.000333,0.894857,30,80537.13339,4474.285188,2684.571113,354.516762,11,0
0,0,34,34,20,45,65,281,159,440,0.000333,0.883281,30,79495.25513,4416.403063,2649.841838,333.571951,12,0
0,0,34,34,20,48,68,283,163,446,0.000333,0.905003,30,81450.25282,4525.014045,2715.008427,354.516762,12,0
0,0,34,34,23,50,73,187,124,311,0.000333,0.641678,22,42350.77963,2352.821091,1925.035438,386.234734,18,0
0,0,44,44,28,60,88,255,161,416,0.000333,0.895708,28,75239.45949,4179.969972,2687.123553,489.019374,19,0
0,0,17,17,20,39,59,167,85,252,0.000333,0.494142,20,29648.52097,1647.140054,1482.426048,292.569248,8,0
0,0,16,16,18,37,55,152,77,229,0.000333,0.44131,18,23830.76474,1323.931374,1323.931374,267.808425,6,0
0,0,12,12,17,28,45,86,53,139,0.000333,0.254456,8,6106.940643,339.27448,763.36758,204.092806,3,0
0,0,45,45,24,54,78,249,161,410,0.000333,0.859005,24,61848.35783,3436.01988,2577.01491,420.803025,20,0
0,0,34,34,24,54,78,255,173,428,0.000333,0.896717,36,96845.47739,5380.304299,2690.15215,420.803025,11,0
0,0,19,19,23,34,57,121,86,207,0.000333,0.402469,22,26562.98113,1475.721174,1207.408233,277.015662,7,0
0,0,13,13,19,22,41,79,54,133,0.000333,0.237518,18,12825.9795,712.554417,712.554417,178.818118,6,0
0,0,78,78,31,94,125,563,354,917,0.000333,2.129208,45,287443.0885,15969.06047,6387.624189,769.711438,31,0
0,0,23,23,23,37,60,146,103,249,0.000333,0.490272,22,32357.94668,1797.663705,1470.815758,296.7917,9,0
0,0,15,15,19,26,45,105,76,181,0.000333,0.331342,18,17892.45739,994.02541,994.02541,202.922055,6,0
0,0,92,92,22,65,87,507,304,811,0.000333,1.741742,44,229909.9957,12772.77754,5225.227175,489.561403,40,0
0,0,50,50,26,68,94,314,198,512,0.000333,1.11865,26,87254.68679,4847.4826,3355.949492,536.158906,20,0
0,0,39,39,25,67,92,320,210,530,0.000333,1.152496,36,124469.5621,6914.975673,3457.487837,522.524381,11,0
0,0,24,24,25,50,75,186,123,309,0.000333,0.641568,24,46192.91941,2566.2733,1924.704975,398.289214,7,0
0,0,18,18,22,38,60,144,91,235,0.000333,0.462706,22,30538.62438,1696.590243,1388.11929,297.528741,6,0
0,0,28,28,25,53,78,211,140,351,0.000333,0.735392,24,52948.22829,2941.568238,2206.176179,419.676189,9,0
0,0,20,20,22,42,64,170,113,283,0.000333,0.566,22,37356,2075.333333,1698,324.584827,6,0
0,0,97,97,25,78,103,572,341,913,0.000333,2.034925,48,293029.1991,16279.39995,6104.774981,606.357778,40,0
0,0,47,47,26,68,94,307,192,499,0.000333,1.090247,26,85039.23576,4724.401987,3270.739837,536.158906,20,0
0,0,36,36,25,67,92,313,204,517,0.000333,1.124227,36,121416.5351,6745.363063,3372.681531,522.524381,11,0
0,0,21,21,25,50,75,179,117,296,0.000333,0.614577,24,44249.52798,2458.30711,1843.730332,398.289214,7,0
0,0,15,15,22,38,60,137,85,222,0.000333,0.43711,22,28849.25367,1602.736315,1311.329712,297.528741,6,0
0,0,25,25,25,53,78,204,134,338,0.000333,0.708155,24,50987.1828,2832.621267,2124.46595,419.676189,9,0
0,0,17,17,22,42,64,163,107,270,0.000333,0.54,22,35640,1980,1620,324.584827,6,0
0,0,94,94,25,78,103,565,335,900,0.000333,2.00595,48,288856.8228,16047.60127,6017.850474,606.357778,40,0
0,0,9,9,13,16,29,70,48,118,0.000333,0.191081,18,10318.35163,573.241757,573.241757,112.105716,3,0
0,0,18,18,18,34,52,123,87,210,0.000333,0.399031,18,21547.66214,1197.092341,1197.092341,248.032387,7,0
0,0,68,68,27,79,106,442,280,722,0.000333,1.619186,39,189444.7842,10524.71023,4857.558568,626.380642,26,0
0,0,24,24,19,39,58,159,111,270,0.000333,0.527218,18,28469.78764,1581.654869,1581.654869,286.841309,9,0
0,0,28,28,19,40,59,185,128,313,0.000333,0.613756,27,49714.21641,2761.900912,1841.267274,293.587747,11,0
0,0,47,47,26,62,88,341,220,561,0.000333,1.207914,39,141325.9044,7851.439132,3623.741138,491.371604,16,0
0,0,22,22,18,36,54,150,105,255,0.000333,0.489165,18,26414.93364,1467.496313,1467.496313,261.17595,9,0
0,0,64,64,19,62,81,385,230,615,0.000333,1.299669,27,105273.2093,5848.511628,3899.007752,449.870794,29,0
0,0,57,57,18,58,76,349,209,558,0.000333,1.162115,27,94131.27592,5229.515329,3486.343553,414.821548,26,0
0,0,17,17,29,51,80,182,114,296,0.000333,0.623764,28,52396.14005,2910.896669,1871.290716,430.175141,9,0
0,0,43,43,29,69,98,310,188,498,0.000333,1.098042,28,92235.51407,5124.195226,3294.125502,562.369636,22,0
0,0,17,17,29,51,80,183,114,297,0.000333,0.625871,28,52573.15404,2920.73078,1877.612644,430.175141,9,0
0,0,47,47,31,70,101,402,250,652,0.000333,1.447051,45,195351.9249,10852.88472,4341.153887,582.629897,18,0
0,0,22,22,29,52,81,211,135,346,0.000333,0.731196,28,61420.46683,3412.248157,2193.588101,437.304314,11,0
0,0,21,21,29,54,83,207,131,338,0.000333,0.718254,28,60333.37318,3351.854065,2154.763328,451.645374,11,0
0,0,66,66,28,78,106,469,279,748,0.000333,1.677495,42,211364.349,11742.46383,5032.4845,624.867311,31,0
0,0,59,59,28,75,103,433,258,691,0.000333,1.540124,42,194055.6183,10780.86768,4620.371864,601.76734,28,0
0,0,18,18,13,30,43,99,79,178,0.000333,0.321958,12,11590.50152,643.916751,965.875126,195.312434,5,0
0,0,18,18,13,30,43,99,79,178,0.000333,0.321958,12,11590.50152,643.916751,965.875126,195.312434,5,0
0,0,41,41,21,50,71,355,199,554,0.000333,1.135653,30,102208.7971,5678.266507,3406.959904,374.431475,15,0
0,0,30,30,20,41,61,254,140,394,0.000333,0.778904,30,70101.31533,3894.517518,2336.710511,306.098194,11,0
0,0,30,30,20,40,60,257,140,397,0.000333,0.781679,30,70351.06699,3908.392611,2345.035566,299.315686,11,0
0,0,30,30,20,42,62,254,142,396,0.000333,0.785954,30,70735.85217,3929.769565,2357.861739,312.915894,11,0
0,0,33,33,23,44,67,293,169,462,0.000333,0.934178,33,92483.5958,5137.977544,2802.533206,344.256916,12,0
0,0,33,33,23,43,66,290,167,457,0.000333,0.920763,33,91155.50771,5064.194873,2762.288113,337.371309,12,0
0,0,33,33,23,43,66,286,163,449,0.000333,0.904644,33,89559.78767,4975.543759,2713.93296,337.371309,12,0
0,0,33,33,23,42,65,293,167,460,0.000333,0.92343,33,91419.5434,5078.863522,2770.289194,330.519257,12,0
0,0,34,34,23,43,66,289,165,454,0.000333,0.914718,33,90557.1127,5030.950705,2744.15493,337.371309,13,0
0,0,33,33,23,44,67,290,169,459,0.000333,0.928112,33,91883.05297,5104.614054,2784.334938,344.256916,12,0
0,0,42,42,26,58,84,337,200,537,0.000333,1.144225,39,133874.3038,7437.461321,3432.674456,461.97433,13,0
0,0,47,47,23,35,58,419,226,645,0.000333,1.259466,66,249374.251,13854.12505,3778.397742,283.566831,19,0
0,0,51,51,23,40,63,436,233,669,0.000333,1.332933,55,219934.0148,12218.55638,3998.800269,316.919049,20,0
0,0,33,33,20,48,68,280,161,441,0.000333,0.894857,30,80537.13339,4474.285188,2684.571113,354.516762,11,0
0,0,33,33,20,45,65,278,157,435,0.000333,0.873243,30,78591.89996,4366.216664,2619.729999,333.571951,11,0
0,0,34,34,20,48,68,283,163,446,0.000333,0.905003,30,81450.25282,4525.014045,2715.008427,354.516762,12,0
0,0,34,34,20,45,65,281,159,440,0.000333,0.883281,30,79495.25513,4416.403063,2649.841838,333.571951,12,0
0,0,20,20,19,24,43,91,63,154,0.000333,0.278548,18,15041.6059,835.644772,835.644772,190.749723,9,0
0,0,33,33,21,48,69,176,116,292,0.000333,0.594563,20,35673.78283,1981.876824,1783.689141,360.316866,9,0
0,0,57,57,22,58,80,295,195,490,0.000333,1.032582,33,102225.5773,5679.198739,3097.744766,437.870393,14,0
0,0,54,54,22,58,80,281,187,468,0.000333,0.986221,33,97635.8575,5424.214305,2958.662348,437.870393,13,0
0,0,50,50,22,58,80,271,178,449,0.000333,0.946182,33,93672.00858,5204.000477,2838.545715,437.870393,12,0
0,0,21,21,20,24,44,163,104,267,0.000333,0.485889,40,58306.72969,3239.26276,1457.668242,196.477662,5,0
0,0,21,21,20,25,45,159,102,261,0.000333,0.477791,40,57334.94633,3185.274796,1433.373658,202.534967,5,0
0,0,9,9,20,36,56,139,88,227,0.000333,0.439423,20,26365.39135,1464.743964,1318.269567,272.555862,3,0
0,0,20,20,20,26,46,165,102,267,0.000333,0.491597,30,44243.73127,2457.98507,1474.791042,208.649995,5,0
0,0,43,43,19,47,66,227,145,372,0.000333,0.749505,27,60709.89454,3372.771919,2248.514612,341.776299,6,0
0,0,36,36,17,39,56,205,126,331,0.000333,0.640745,24,46133.6275,2562.979306,1922.234479,275.617555,5,0
0,0,39,39,19,47,66,217,136,353,0.000333,0.711224,18,38406.08023,2133.671124,2133.671124,341.776299,5,0
0,0,32,32,17,39,56,195,117,312,0.000333,0.603965,24,43485.47366,2415.859648,1811.894736,275.617555,4,0
0,0,18,18,15,26,41,86,54,140,0.000333,0.250019,14,10500.80193,583.377885,750.057281,180.814792,10,0
0,0,10,10,11,16,27,73,44,117,0.000333,0.185441,10,5563.218378,309.067688,556.321838,102.053748,4,0
0,0,10,10,10,16,26,67,41,108,0.000333,0.169216,10,5076.474896,282.026383,507.64749,97.219281,3,0
0,0,10,10,10,16,26,71,41,112,0.000333,0.175483,10,5264.492484,292.471805,526.449248,97.219281,3,0
0,0,10,10,10,16,26,67,41,108,0.000333,0.169216,10,5076.474896,282.026383,507.64749,97.219281,3,0
0,0,10,10,10,16,26,71,41,112,0.000333,0.175483,10,5264.492484,292.471805,526.449248,97.219281,3,0
0,0,10,10,10,16,26,67,41,108,0.000333,0.169216,10,5076.474896,282.026383,507.64749,97.219281,3,0
0,0,10,10,10,16,26,67,41,108,0.000333,0.169216,10,5076.474896,282.026383,507.64749,97.219281,3,0
0,0,10,10,10,16,26,67,41,108,0.000333,0.169216,10,5076.474896,282.026383,507.64749,97.219281,3,0
0,0,43,43,25,78,103,284,216,500,0.000333,1.114417,24,80238.00633,4457.667018,3343.250264,606.357778,27,0
0,0,87,87,29,88,117,475,334,809,0.000333,1.852708,42,233441.2524,12968.95847,5558.125058,709.311431,52,0
0,0,89,89,31,77,108,563,420,983,0.000333,2.213351,75,498004.0811,27666.89339,6640.054415,636.122649,46,0
0,0,24,24,22,37,59,136,99,235,0.000333,0.460807,22,30413.26457,1689.625809,1382.421117,290.85727,13,0
0,0,23,23,22,37,59,129,96,225,0.000333,0.441198,22,29119.08309,1617.726839,1323.594686,290.85727,12,0
0,0,23,23,22,37,59,129,96,225,0.000333,0.441198,22,29119.08309,1617.726839,1323.594686,290.85727,12,0
0,0,32,32,17,35,52,143,112,255,0.000333,0.484537,24,34886.69108,1938.149504,1453.612128,249.011774,9,0
0,0,26,26,15,34,49,110,91,201,0.000333,0.376186,14,15799.7935,877.766306,1128.556679,231.577096,8,0
0,0,26,26,15,34,49,110,91,201,0.000333,0.376186,14,15799.7935,877.766306,1128.556679,231.577096,8,0
0,0,40,40,22,48,70,179,141,320,0.000333,0.65379,22,43150.15244,2397.230691,1961.370565,366.185696,12,0
0,0,26,26,20,39,59,131,103,234,0.000333,0.458846,20,27530.76947,1529.487193,1376.538474,292.569248,9,0
0,0,26,26,20,39,59,131,103,234,0.000333,0.458846,20,27530.76947,1529.487193,1376.538474,292.569248,9,0
0,0,12,12,14,20,34,63,39,102,0.000333,0.172974,7,3632.448469,201.802693,518.92121,139.741531,9,0
0,0,13,13,17,17,34,82,47,129,0.000333,0.218761,16,10500.5233,583.362406,656.282707,138.973737,2,0
0,0,41,41,30,58,88,291,187,478,0.000333,1.029203,45,138942.3741,7719.020784,3087.608314,486.969616,21,0
0,0,83,83,25,84,109,499,324,823,0.000333,1.856739,36,200527.7652,11140.4314,5570.215699,653.051068,28,0
0,0,57,57,25,63,88,362,228,590,0.000333,1.270355,36,137198.3276,7622.12931,3811.064655,492.66504,14,0
0,0,39,39,30,55,85,271,174,445,0.000333,0.950726,45,128348.0535,7130.447416,2852.178967,465.181502,22,0
0,0,21,21,17,24,41,101,78,179,0.000333,0.319667,24,23016.04341,1278.669078,959.001809,179.525968,9,0
0,0,40,40,27,48,75,237,163,400,0.000333,0.830509,39,97169.57157,5398.309532,2491.527476,396.460163,21,0
0,0,22,22,19,26,45,114,86,200,0.000333,0.366124,27,29656.00672,1647.555929,1098.370619,202.922055,11,0
0,0,41,41,29,49,78,250,171,421,0.000333,0.882051,42,111138.482,6174.360113,2646.154334,416.002231,23,0
0,0,10,10,18,21,39,90,61,151,0.000333,0.266032,18,14365.72323,798.095735,798.095735,167.297316,4,0
0,0,27,27,17,30,47,86,66,152,0.000333,0.281433,16,13508.76009,750.486672,844.297505,216.693586,7,0
0,0,25,25,19,41,60,148,106,254,0.000333,0.500117,18,27006.3038,1500.350211,1500.350211,300.370255,19,0
0,0,31,31,20,45,65,163,123,286,0.000333,0.574132,20,34447.94389,1913.774661,1722.397195,333.571951,16,0
0,0,15,15,29,25,54,127,94,221,0.000333,0.423943,42,53416.8658,2967.603655,1271.830138,256.977854,14,0
0,0,5,5,12,14,26,45,34,79,0.000333,0.123778,12,4456.016853,247.556492,371.334738,96.322519,2,0
0,0,33,33,21,49,70,189,139,328,0.000333,0.670135,20,40208.09659,2233.783144,2010.40483,367.359448,20,0
0,0,37,37,21,51,72,196,150,346,0.000333,0.711598,20,42695.88101,2371.993389,2134.79405,381.532358,17,0
0,0,50,50,15,42,57,184,125,309,0.000333,0.600788,14,25233.0822,1401.8379,1802.363014,285.080691,24,0
0,0,47,47,33,48,81,377,318,695,0.000333,1.468732,96,422994.7922,23499.71068,4406.195752,434.543206,38,0
0,0,45,45,33,45,78,354,302,656,0.000333,1.374408,96,395829.4901,21990.52723,4123.223856,413.598395,33,0
0,0,50,50,34,50,84,401,338,739,0.000333,1.574641,102,481840.1027,26768.89459,4723.922575,455.166546,42,0
0,0,48,48,34,48,82,378,322,700,0.000333,1.483429,102,453929.2131,25218.28962,4450.286403,441.051937,37,0
0,0,53,53,36,77,113,475,339,814,0.000333,1.850542,72,399717.0486,22206.5027,5551.625675,668.659864,53,0
0,0,37,37,30,62,92,459,359,818,0.000333,1.778758,75,400220.526,22234.47367,5336.27368,516.366889,33,0
0,0,11,11,18,30,48,168,116,284,0.000333,0.52871,27,42825.49246,2379.194025,1586.12935,222.265368,5,0
0,0,23,23,20,49,69,184,131,315,0.000333,0.641395,20,38483.70408,2137.98356,1924.185204,361.559344,11,0
0,0,36,36,23,57,80,252,177,429,0.000333,0.904036,33,89499.53604,4972.196447,2712.107153,436.516656,19,0
0,0,18,18,15,25,40,103,57,160,0.000333,0.283836,14,11921.11893,662.284385,851.508495,174.699764,7,0
0,0,18,18,15,25,40,104,57,161,0.000333,0.28561,14,11995.62593,666.423663,856.830423,174.699764,7,0
0,0,55,55,21,39,60,266,186,452,0.000333,0.889972,40,106796.582,5933.143443,2669.914549,298.369352,6,0
0,0,21,21,20,32,52,143,86,229,0.000333,0.435134,20,26108.01391,1450.445217,1305.400695,246.438562,4,0
0,0,53,53,29,47,76,267,183,450,0.000333,0.937189,42,118085.83,6560.323889,2811.567381,401.947125,20,0
0,0,12,12,20,13,33,72,55,127,0.000333,0.213546,40,25625.52213,1423.640118,640.638053,134.544278,5,0
0,0,44,44,32,46,78,279,187,466,0.000333,0.976332,64,187455.8358,10414.2131,2928.997434,414.08385,17,0
0,0,15,15,19,20,39,96,72,168,0.000333,0.295983,27,23974.58447,1331.921359,887.947573,167.149185,8,0
0,0,13,13,18,19,37,89,68,157,0.000333,0.272628,27,22082.87282,1226.826268,817.884178,155.769273,7,0
0,0,47,47,33,53,86,303,204,507,0.000333,1.086039,48,156389.5791,8688.309948,3258.116231,470.04479,20,0
0,0,12,12,19,20,39,87,66,153,0.000333,0.269556,27,21833.99657,1212.999809,808.666539,167.149185,7,0
0,0,19,19,21,30,51,123,80,203,0.000333,0.383834,20,23030.04689,1279.447049,1151.502344,239.445384,4,0
0,0,51,51,28,36,64,338,200,538,0.000333,1.076,70,225960,12553.33333,3228,320.723238,34,0
0,0,65,65,33,47,80,478,273,751,0.000333,1.582589,80,379821.4399,21101.19111,4747.767999,427.530682,20,0
0,0,82,82,31,58,89,478,330,808,0.000333,1.744131,75,392429.4459,21801.63588,5232.392612,493.342983,33,0
0,0,53,53,31,49,80,594,356,950,0.000333,2.001944,105,630612.3275,35034.01819,6005.83169,428.700868,23,0
0,0,56,56,33,54,87,498,333,831,0.000333,1.784695,96,513992.2603,28555.12557,5354.086045,477.228931,24,0
0,0,96,96,33,67,100,576,405,981,0.000333,2.172541,96,625691.8005,34760.65559,6517.622922,572.892982,36,0
0,0,89,89,33,61,94,530,375,905,0.000333,1.977301,96,569462.6794,31636.81552,5931.902911,528.239984,35,0
0,0,48,48,34,47,81,311,238,549,0.000333,1.160193,85,295849.1004,16436.06113,3480.577652,434.039413,17,0
0,0,50,50,35,47,82,345,264,609,0.000333,1.290583,85,329098.6795,18283.25997,3871.749171,440.590582,23,0
0,0,24,24,22,37,59,136,99,235,0.000333,0.460807,22,30413.26457,1689.625809,1382.421117,290.85727,13,0
0,0,23,23,22,37,59,129,96,225,0.000333,0.441198,22,29119.08309,1617.726839,1323.594686,290.85727,12,0
0,0,23,23,22,37,59,129,96,225,0.000333,0.441198,22,29119.08309,1617.726839,1323.594686,290.85727,12,0
0,0,32,32,17,35,52,143,112,255,0.000333,0.484537,24,34886.69108,1938.149504,1453.612128,249.011774,9,0
0,0,26,26,15,34,49,110,91,201,0.000333,0.376186,14,15799.7935,877.766306,1128.556679,231.577096,8,0
0,0,26,26,15,34,49,110,91,201,0.000333,0.376186,14,15799.7935,877.766306,1128.556679,231.577096,8,0
0,0,40,40,22,48,70,179,141,320,0.000333,0.65379,22,43150.15244,2397.230691,1961.370565,366.185696,12,0
0,0,26,26,20,39,59,131,103,234,0.000333,0.458846,20,27530.76947,1529.487193,1376.538474,292.569248,9,0
0,0,26,26,20,39,59,131,103,234,0.000333,0.458846,20,27530.76947,1529.487193,1376.538474,292.569248,9,0
0,0,21,21,20,25,45,101,83,184,0.000333,0.336834,30,30315.02909,1684.168283,1010.50097,202.534967,13,0
0,0,71,71,29,53,82,426,282,708,0.000333,1.500382,70,315080.2773,17504.45985,4501.146819,444.461233,30,0
0,0,78,78,29,59,88,472,312,784,0.000333,1.688065,70,354493.6072,19694.08929,5064.194389,487.957389,31,0
0,0,60,60,29,49,78,362,241,603,0.000333,1.263366,56,212245.4621,11791.41456,3790.097538,416.002231,26,0
0,0,67,67,29,55,84,408,271,679,0.000333,1.446795,56,243061.4777,13503.41543,4340.38353,458.856233,27,0
0,0,63,63,28,54,82,388,254,642,0.000333,1.360516,56,228566.7097,12698.15054,4081.548387,445.369863,27,0
0,0,63,63,28,53,81,392,256,648,0.000333,1.369408,56,230060.4769,12781.13761,4108.222802,438.185722,27,0
0,0,54,54,26,45,71,315,201,516,0.000333,1.057757,52,165010.0147,9167.223039,3173.269514,369.344822,25,0
0,0,51,51,28,36,64,338,200,538,0.000333,1.076,70,225960,12553.33333,3228,320.723238,34,0
0,0,65,65,33,47,80,478,273,751,0.000333,1.582589,80,379821.4399,21101.19111,4747.767999,427.530682,20,0
0,0,82,82,31,58,89,478,330,808,0.000333,1.744131,75,392429.4459,21801.63588,5232.392612,493.342983,33,0
0,0,53,53,31,49,80,594,356,950,0.000333,2.001944,105,630612.3275,35034.01819,6005.83169,428.700868,23,0
0,0,56,56,33,54,87,498,333,831,0.000333,1.784695,96,513992.2603,28555.12557,5354.086045,477.228931,24,0
0,0,89,89,33,61,94,530,375,905,0.000333,1.977301,96,569462.6794,31636.81552,5931.902911,528.239984,35,0
0,0,96,96,33,67,100,576,405,981,0.000333,2.172541,96,625691.8005,34760.65559,6517.622922,572.892982,36,0
0,0,48,48,34,47,81,311,238,549,0.000333,1.160193,85,295849.1004,16436.06113,3480.577652,434.039413,17,0
0,0,50,50,35,47,82,345,264,609,0.000333,1.290583,85,329098.6795,18283.25997,3871.749171,440.590582,23,0
0,0,30,30,20,40,60,257,140,397,0.000333,0.781679,30,70351.06699,3908.392611,2345.035566,299.315686,11,0
0,0,30,30,20,42,62,257,142,399,0.000333,0.791908,30,71271.72984,3959.540546,2375.724328,312.915894,11,0
0,0,30,30,20,42,62,254,142,396,0.000333,0.785954,30,70735.85217,3929.769565,2357.861739,312.915894,11,0
0,0,36,36,24,49,73,292,168,460,0.000333,0.949106,36,102503.4947,5694.638594,2847.319297,385.159882,13,0
0,0,33,33,20,45,65,278,157,435,0.000333,0.873243,30,78591.89996,4366.216664,2619.729999,333.571951,11,0
0,0,33,33,20,48,68,280,161,441,0.000333,0.894857,30,80537.13339,4474.285188,2684.571113,354.516762,11,0
0,0,34,34,20,45,65,281,159,440,0.000333,0.883281,30,79495.25513,4416.403063,2649.841838,333.571951,12,0
0,0,34,34,20,48,68,283,163,446,0.000333,0.905003,30,81450.25282,4525.014045,2715.008427,354.516762,12,0
0,0,42,42,26,58,84,337,200,537,0.000333,1.144225,39,133874.3038,7437.461321,3432.674456,461.97433,13,0
0,0,51,51,23,40,63,436,233,669,0.000333,1.332933,55,219934.0148,12218.55638,3998.800269,316.919049,20,0
0,0,47,47,23,35,58,419,226,645,0.000333,1.259466,66,249374.251,13854.12505,3778.397742,283.566831,19,0
0,0,33,33,23,43,66,290,167,457,0.000333,0.920763,33,91155.50771,5064.194873,2762.288113,337.371309,12,0
0,0,33,33,23,42,65,293,167,460,0.000333,0.92343,33,91419.5434,5078.863522,2770.289194,330.519257,12,0
0,0,33,33,23,44,67,293,169,462,0.000333,0.934178,33,92483.5958,5137.977544,2802.533206,344.256916,12,0
0,0,33,33,23,43,66,286,163,449,0.000333,0.904644,33,89559.78767,4975.543759,2713.93296,337.371309,12,0
0,0,33,33,23,44,67,290,169,459,0.000333,0.928112,33,91883.05297,5104.614054,2784.334938,344.256916,12,0
0,0,34,34,23,43,66,289,165,454,0.000333,0.914718,33,90557.1127,5030.950705,2744.15493,337.371309,13,0
0,0,12,12,14,20,34,63,39,102,0.000333,0.172974,7,3632.448469,201.802693,518.92121,139.741531,9,0
0,0,42,42,24,77,101,267,208,475,0.000333,1.054217,24,75903.6109,4216.867272,3162.650454,592.581664,27,0
0,0,87,87,29,88,117,475,334,809,0.000333,1.852708,42,233441.2524,12968.95847,5558.125058,709.311431,52,0
0,0,89,89,31,77,108,563,420,983,0.000333,2.213351,75,498004.0811,27666.89339,6640.054415,636.122649,46,0
0,0,19,19,23,44,67,199,104,303,0.000333,0.612675,22,40436.55054,2246.47503,1838.025025,344.256916,6,0
0,0,27,27,27,49,76,278,141,419,0.000333,0.872627,26,68064.92233,3781.384574,2617.881628,403.502745,8,0
0,0,24,24,19,34,53,142,94,236,0.000333,0.450596,18,24332.20609,1351.789227,1351.789227,253.684359,8,0
0,0,16,16,13,27,40,63,57,120,0.000333,0.212877,12,7663.576457,425.754248,638.631371,176.487679,6,0
0,0,36,36,16,42,58,267,167,434,0.000333,0.847455,24,61016.73005,3389.818336,2542.363752,290.477332,4,0
0,0,35,35,16,42,58,263,165,428,0.000333,0.835739,24,60173.18078,3342.954488,2507.215866,290.477332,3,0
0,0,34,34,16,42,58,259,163,422,0.000333,0.824023,24,59329.63152,3296.09064,2472.06798,290.477332,2,0
0,0,17,17,14,34,48,126,80,206,0.000333,0.383501,14,16107.03185,894.835103,1150.502275,226.276706,1,0
0,0,28,28,27,55,82,268,148,416,0.000333,0.881581,26,68763.28248,3820.18236,2644.741634,446.356747,8,0
0,0,25,25,27,54,81,249,138,387,0.000333,0.817841,26,63791.57073,3543.976152,2453.521951,439.145888,8,0
0,0,22,22,27,54,81,241,131,372,0.000333,0.786141,26,61319.02923,3406.612735,2358.424201,439.145888,8,0
0,0,41,41,32,79,111,436,246,682,0.000333,1.544597,48,222421.9978,12356.77766,4633.791621,657.998679,19,0
0,0,13,13,16,30,46,73,51,124,0.000333,0.228307,8,5479.37346,304.409637,684.921683,211.206718,4,0
0,0,8,8,16,14,30,51,34,85,0.000333,0.139029,16,6673.37121,370.742845,417.085701,117.302969,2,0
0,0,12,12,14,29,43,60,42,102,0.000333,0.184493,7,3874.353035,215.241835,553.479005,194.184418,4,0
0,0,22,22,23,20,43,109,76,185,0.000333,0.33462,33,33127.34633,1840.408129,1003.85898,190.480487,7,0
0,0,22,22,30,20,50,167,100,267,0.000333,0.502303,75,113018.2202,6278.790011,1506.909603,233.64528,15,0
0,0,10,10,16,14,30,47,33,80,0.000333,0.13085,16,6280.819962,348.934442,392.551248,117.302969,3,0
0,0,8,8,16,14,30,52,34,86,0.000333,0.140664,16,6751.88146,375.104526,421.992591,117.302969,2,0
0,0,49,49,27,53,80,394,235,629,0.000333,1.325498,52,206777.6241,11487.64579,3976.492772,431.961747,25,0
0,0,43,43,25,78,103,284,216,500,0.000333,1.114417,24,80238.00633,4457.667018,3343.250264,606.357778,27,0
0,0,23,23,21,44,65,134,105,239,0.000333,0.479782,20,28786.91815,1599.27323,1439.345907,332.453657,11,0
0,0,70,70,32,76,108,457,294,751,0.000333,1.690974,48,243500.1847,13527.78804,5072.920514,634.842491,32,0
0,0,48,48,24,57,81,203,157,360,0.000333,0.760782,24,54776.30403,3043.128001,2282.346001,442.513831,25,0
0,0,48,48,27,67,94,276,199,475,0.000333,1.03781,26,80949.17232,4497.17624,3113.429705,534.809938,23,0
0,0,42,42,28,66,94,253,178,431,0.000333,0.941676,28,79100.77826,4394.487681,2825.027795,533.53595,20,0
0,0,44,44,28,67,95,258,184,442,0.000333,0.967959,28,81308.53301,4517.140723,2903.876179,541.033914,20,0
0,0,37,37,26,61,87,280,178,458,0.000333,0.983623,26,76722.57115,4262.365064,2950.868121,483.98641,12,0
0,0,84,84,31,71,102,535,402,937,0.000333,2.084021,75,468904.6909,26050.26061,6252.062545,590.212131,47,0
0,0,87,87,29,88,117,475,334,809,0.000333,1.852708,42,233441.2524,12968.95847,5558.125058,709.311431,52,0
0,0,17,17,17,37,54,112,86,198,0.000333,0.379823,16,18231.48361,1012.8602,1139.467725,262.236643,10,0
0,0,34,34,26,61,87,275,171,446,0.000333,0.957851,26,74712.37278,4150.687377,2873.552799,483.98641,12,0
0,0,89,89,31,77,108,563,420,983,0.000333,2.213351,75,498004.0811,27666.89339,6640.054415,636.122649,46,0
0,0,91,91,31,79,110,567,429,996,0.000333,2.251411,75,506567.5706,28142.64281,6754.234275,651.578765,50,0
0,0,48,48,34,48,82,378,322,700,0.000333,1.483429,102,453929.2131,25218.28962,4450.286403,441.051937,37,0
0,0,50,50,34,50,84,401,338,739,0.000333,1.574641,102,481840.1027,26768.89459,4723.922575,455.166546,42,0
0,0,45,45,33,45,78,354,302,656,0.000333,1.374408,96,395829.4901,21990.52723,4123.223856,413.598395,33,0
0,0,47,47,33,48,81,377,318,695,0.000333,1.468732,96,422994.7922,23499.71068,4406.195752,434.543206,38,0
0,0,53,53,36,77,113,475,339,814,0.000333,1.850542,72,399717.0486,22206.5027,5551.625675,668.659864,53,0
0,0,11,11,12,27,39,56,39,95,0.000333,0.167371,6,3012.679265,167.37107,502.113211,171.401513,5,0
0,0,63,63,33,66,99,551,441,992,0.000333,2.192107,96,631326.8896,35073.71609,6576.321767,565.395018,39,0
0,0,39,39,30,64,94,482,375,857,0.000333,1.872428,75,421296.1984,23405.34436,5617.282646,531.206718,38,0
0,0,11,11,18,30,48,168,116,284,0.000333,0.52871,27,42825.49246,2379.194025,1586.12935,222.265368,5,0
0,0,23,23,20,49,69,184,131,315,0.000333,0.641395,20,38483.70408,2137.98356,1924.185204,361.559344,11,0
0,0,39,39,26,58,84,264,186,450,0.000333,0.958848,39,112185.1708,6232.509487,2876.54284,461.97433,20,0
0,0,27,27,20,46,66,242,139,381,0.000333,0.767638,30,69087.42478,3838.190266,2302.914159,340.522412,20,0
0,0,26,26,21,34,55,141,83,224,0.000333,0.431675,20,25900.49152,1438.916195,1295.024576,265.212402,15,0
0,0,10,10,11,26,37,50,42,92,0.000333,0.159757,5,2396.348548,133.130475,479.26971,160.26518,5,0
0,0,49,49,22,75,97,269,212,481,0.000333,1.058186,22,69840.2777,3880.015428,3174.558077,565.268897,28,0
0,0,53,53,24,83,107,300,234,534,0.000333,1.199981,24,86398.6409,4799.924494,3599.943371,639.167373,30,0
0,0,35,35,20,51,71,176,153,329,0.000333,0.674422,30,60698.00407,3372.111337,2023.266802,375.732254,18,0
0,0,39,39,22,61,83,207,175,382,0.000333,0.811755,22,53575.83138,2976.435077,2435.265063,459.882473,20,0
0,0,19,19,23,38,61,118,106,224,0.000333,0.442828,22,29226.6736,1623.704089,1328.485164,303.463171,14,0
0,0,18,18,19,29,48,73,59,132,0.000333,0.245738,18,13269.8709,737.21505,737.21505,221.592072,4,0
0,0,19,19,22,33,55,109,94,203,0.000333,0.391205,22,25819.55248,1434.419582,1173.616022,264.572502,9,0
0,0,32,32,22,56,78,270,161,431,0.000333,0.903003,22,59598.18384,3311.010213,2709.008356,423.319371,13,0
0,0,40,40,27,32,59,202,135,337,0.000333,0.660817,52,103087.4368,5727.079822,1982.450708,288.381963,17,0
0,0,78,78,30,56,86,316,226,542,0.000333,1.161012,60,208982.1298,11610.11832,3483.035497,472.418594,23,0
0,0,78,78,30,56,86,316,226,542,0.000333,1.161012,60,208982.1298,11610.11832,3483.035497,472.418594,23,0
0,0,46,46,19,38,57,185,134,319,0.000333,0.620231,27,50238.68169,2791.037872,1860.691915,280.131868,12,0
0,0,8,8,12,15,27,33,24,57,0.000333,0.090343,6,1626.171526,90.342863,271.028588,101.622909,5,0
0,0,13,13,16,17,33,54,37,91,0.000333,0.153013,16,7344.637838,408.035435,459.039865,133.486868,7,0
0,0,29,29,19,28,47,116,81,197,0.000333,0.364751,18,19696.57207,1094.254004,1094.254004,215.316561,11,0
0,0,29,29,21,28,49,122,82,204,0.000333,0.3818,20,22908.01616,1272.667565,1145.400808,226.844604,12,0
0,0,28,28,20,28,48,114,77,191,0.000333,0.355576,20,21334.55675,1185.253153,1066.727838,221.0445,10,0
0,0,24,24,19,27,46,115,73,188,0.000333,0.346143,18,18691.73366,1038.429648,1038.429648,209.092585,10,0
0,0,22,22,17,26,43,107,68,175,0.000333,0.316532,16,15193.54131,844.085629,949.596332,191.698301,10,0
0,0,8,8,16,14,30,51,34,85,0.000333,0.139029,16,6673.37121,370.742845,417.085701,117.302969,2,0
0,0,27,27,19,51,70,259,143,402,0.000333,0.821324,18,44351.49191,2463.971773,2463.971773,370.004315,13,0
0,0,18,18,15,25,40,103,57,160,0.000333,0.283836,14,11921.11893,662.284385,851.508495,174.699764,7,0
0,0,18,18,15,25,40,104,57,161,0.000333,0.28561,14,11995.62593,666.423663,856.830423,174.699764,7,0
0,0,6,6,12,10,22,30,20,50,0.000333,0.074324,12,2675.658971,148.647721,222.971581,76.238831,4,0
0,0,15,15,16,18,34,72,55,127,0.000333,0.215369,24,15506.58674,861.477041,646.107781,139.05865,8,0
0,0,11,11,15,17,32,73,59,132,0.000333,0.22,21,13860,770,660,128.090227,11,0
0,0,18,18,20,31,51,104,87,191,0.000333,0.361144,20,21668.66481,1203.814711,1083.43324,240.018648,11,0
0,0,16,16,21,31,52,106,93,199,0.000333,0.378129,30,34031.62512,1890.64584,1134.387504,245.818752,9,0
0,0,12,12,16,24,40,81,67,148,0.000333,0.262548,16,12602.32573,700.129207,787.645358,174.0391,7,0
0,0,16,16,20,31,51,104,93,197,0.000333,0.372489,30,33524.03377,1862.446321,1117.467792,240.018648,9,0
0,0,31,31,23,29,52,175,105,280,0.000333,0.532041,33,52672.063,2926.225722,1596.123121,244.923374,9,0
0,0,31,31,21,30,51,170,102,272,0.000333,0.5143,30,46286.99079,2571.499488,1542.899693,239.445384,13,0
0,0,31,31,20,27,47,185,98,283,0.000333,0.523983,30,47158.45935,2619.914408,1571.948645,214.820524,19,0
0,0,25,25,19,25,44,153,83,236,0.000333,0.429475,27,34787.49827,1932.638793,1288.425862,196.807027,14,0
0,0,25,25,22,28,50,138,88,226,0.000333,0.42517,33,42091.87946,2338.437748,1275.511499,232.713433,9,0
0,0,21,21,22,27,49,139,92,231,0.000333,0.432333,33,42800.93314,2377.829619,1296.997974,226.489458,12,0
0,0,28,28,24,41,65,170,120,290,0.000333,0.582162,24,41915.67998,2328.648888,1746.486666,329.698732,12,0
0,0,26,26,26,41,67,172,126,298,0.000333,0.602565,39,70500.08857,3916.671587,1807.694579,341.871065,10,0
0,0,22,22,21,34,55,147,100,247,0.000333,0.475999,20,28559.91699,1586.662055,1427.995849,265.212402,8,0
0,0,26,26,26,41,67,170,126,296,0.000333,0.598521,39,70026.93362,3890.385201,1795.5624,341.871065,10,0
0,0,27,27,16,21,37,159,94,253,0.000333,0.439331,32,42175.73445,2343.096358,1317.991702,156.238666,18,0
0,0,48,48,29,52,81,309,201,510,0.000333,1.077775,42,135799.5871,7544.421503,3233.323501,437.304314,18,0
0,0,47,47,30,50,80,300,194,494,0.000333,1.041011,45,140536.4615,7807.581197,3123.032479,429.399527,19,0
0,0,48,48,30,53,83,311,201,512,0.000333,1.088007,45,146880.9085,8160.050472,3264.020189,450.786502,18,0
0,0,47,47,31,50,81,302,194,496,0.000333,1.048189,45,141505.4521,7861.414004,3144.565601,435.772895,19,0
0,0,8,8,13,13,26,40,26,66,0.000333,0.10341,12,3722.748257,206.819348,310.229021,96.211433,6,0
0,0,8,8,13,21,34,61,54,115,0.000333,0.195019,12,7020.698721,390.038818,585.058227,140.344382,3,0
0,0,9,9,14,22,36,65,56,121,0.000333,0.20852,14,8757.852952,486.547386,625.560925,151.410465,3,0
0,0,31,31,17,35,52,136,109,245,0.000333,0.465536,24,33518.58554,1862.143641,1396.607731,249.011774,8,0
0,0,26,26,15,34,49,110,91,201,0.000333,0.376186,14,15799.7935,877.766306,1128.556679,231.577096,8,0
0,0,27,27,15,34,49,117,94,211,0.000333,0.394901,14,16585.85288,921.436271,1184.703777,231.577096,9,0
0,0,39,39,22,48,70,172,138,310,0.000333,0.633359,22,41801.71018,2322.317232,1900.077735,366.185696,11,0
0,0,26,26,20,39,59,131,103,234,0.000333,0.458846,20,27530.76947,1529.487193,1376.538474,292.569248,9,0
0,0,42,42,24,77,101,267,208,475,0.000333,1.054217,24,75903.6109,4216.867272,3162.650454,592.581664,27,0
0,0,23,23,21,44,65,134,105,239,0.000333,0.479782,20,28786.91815,1599.27323,1439.345907,332.453657,11,0
0,0,70,70,32,76,108,457,294,751,0.000333,1.690974,48,243500.1847,13527.78804,5072.920514,634.842491,32,0
0,0,48,48,24,57,81,203,157,360,0.000333,0.760782,24,54776.30403,3043.128001,2282.346001,442.513831,25,0
0,0,48,48,27,67,94,276,199,475,0.000333,1.03781,26,80949.17232,4497.17624,3113.429705,534.809938,23,0
0,0,42,42,28,66,94,253,178,431,0.000333,0.941676,28,79100.77826,4394.487681,2825.027795,533.53595,20,0
0,0,44,44,28,67,95,258,184,442,0.000333,0.967959,28,81308.53301,4517.140723,2903.876179,541.033914,20,0
0,0,37,37,26,61,87,280,178,458,0.000333,0.983623,26,76722.57115,4262.365064,2950.868121,483.98641,12,0
0,0,87,87,29,88,117,475,334,809,0.000333,1.852708,42,233441.2524,12968.95847,5558.125058,709.311431,52,0
0,0,17,17,17,37,54,112,86,198,0.000333,0.379823,16,18231.48361,1012.8602,1139.467725,262.236643,10,0
0,0,34,34,26,61,87,275,171,446,0.000333,0.957851,26,74712.37278,4150.687377,2873.552799,483.98641,12,0
0,0,89,89,31,77,108,563,420,983,0.000333,2.213351,75,498004.0811,27666.89339,6640.054415,636.122649,46,0
0,0,21,21,17,24,41,101,78,179,0.000333,0.319667,24,23016.04341,1278.669078,959.001809,179.525968,9,0
0,0,40,40,27,48,75,237,163,400,0.000333,0.830509,39,97169.57157,5398.309532,2491.527476,396.460163,21,0
0,0,22,22,19,26,45,114,86,200,0.000333,0.366124,27,29656.00672,1647.555929,1098.370619,202.922055,11,0
0,0,41,41,29,49,78,250,171,421,0.000333,0.882051,42,111138.482,6174.360113,2646.154334,416.002231,23,0
0,0,10,10,18,21,39,90,61,151,0.000333,0.266032,18,14365.72323,798.095735,798.095735,167.297316,4,0
0,0,27,27,17,30,47,86,66,152,0.000333,0.281433,16,13508.76009,750.486672,844.297505,216.693586,7,0
0,0,25,25,19,41,60,148,106,254,0.000333,0.500117,18,27006.3038,1500.350211,1500.350211,300.370255,19,0
0,0,31,31,20,45,65,163,123,286,0.000333,0.574132,20,34447.94389,1913.774661,1722.397195,333.571951,16,0
0,0,15,15,29,25,54,127,94,221,0.000333,0.423943,42,53416.8658,2967.603655,1271.830138,256.977854,14,0
0,0,5,5,12,14,26,45,34,79,0.000333,0.123778,12,4456.016853,247.556492,371.334738,96.322519,2,0
0,0,33,33,21,49,70,189,139,328,0.000333,0.670135,20,40208.09659,2233.783144,2010.40483,367.359448,20,0
0,0,37,37,21,51,72,196,150,346,0.000333,0.711598,20,42695.88101,2371.993389,2134.79405,381.532358,17,0
0,0,50,50,15,42,57,184,125,309,0.000333,0.600788,14,25233.0822,1401.8379,1802.363014,285.080691,24,0
0,0,21,21,17,29,46,94,63,157,0.000333,0.289066,16,13875.18763,770.843757,867.199227,210.368317,11,0
0,0,16,16,16,27,43,170,88,258,0.000333,0.466659,24,33599.43136,1866.635076,1399.976307,192.381963,8,0
0,0,15,15,16,25,41,166,84,250,0.000333,0.446463,24,32145.31203,1785.850668,1339.388001,180.096405,8,0
0,0,18,18,15,25,40,103,57,160,0.000333,0.283836,14,11921.11893,662.284385,851.508495,174.699764,7,0
0,0,18,18,15,25,40,104,57,161,0.000333,0.28561,14,11995.62593,666.423663,856.830423,174.699764,7,0
0,0,27,27,20,46,66,242,139,381,0.000333,0.767638,30,69087.42478,3838.190266,2302.914159,340.522412,20,0
0,0,26,26,19,35,54,167,86,253,0.000333,0.485329,18,26207.75769,1455.986538,1455.986538,260.235528,15,0
0,0,26,26,22,22,44,112,68,180,0.000333,0.327566,33,32429.02382,1801.612434,982.697691,196.214991,11,0
0,0,10,10,15,21,36,55,45,100,0.000333,0.172331,14,7237.895002,402.105278,516.9925,150.842025,4,0
0,0,10,10,16,19,35,51,39,90,0.000333,0.153878,16,7386.167544,410.342641,461.635472,144.710623,4,0
0,0,10,10,16,21,37,53,43,96,0.000333,0.166703,16,8001.72037,444.540021,500.107523,156.238666,4,0
0,0,13,13,17,21,38,67,53,120,0.000333,0.209917,16,10076.02083,559.778935,629.751302,161.725534,6,0
0,0,13,13,21,23,44,68,54,122,0.000333,0.222017,20,13321.01315,740.056286,666.050657,196.280591,5,0
0,0,13,13,21,25,46,70,58,128,0.000333,0.235672,20,14140.31861,785.573256,707.01593,208.335071,5,0
0,0,13,13,21,25,46,72,60,132,0.000333,0.243037,20,14582.20356,810.12242,729.110178,208.335071,5,0
0,0,13,13,21,24,45,69,56,125,0.000333,0.228827,20,13729.63274,762.757374,686.481637,202.277766,5,0
0,0,13,13,21,23,44,68,55,123,0.000333,0.223837,20,13430.20178,746.122321,671.510089,196.280591,5,0
0,0,48,48,32,35,67,215,133,348,0.000333,0.703666,48,101327.9538,5629.330769,2110.999038,339.524906,17,0
0,0,44,44,29,44,73,206,151,357,0.000333,0.736589,42,92810.22944,5156.123858,2209.767368,381.09644,14,0
0,0,49,49,29,45,74,227,162,389,0.000333,0.805159,42,101450.0491,5636.113838,2415.477359,388.014838,16,0
0,0,49,49,29,48,77,237,168,405,0.000333,0.846016,42,106598.0391,5922.113281,2538.048549,408.959649,16,0
0,0,15,15,20,26,46,100,68,168,0.000333,0.309319,20,18559.16817,1031.064898,927.958409,208.649995,7,0
0,0,37,37,30,40,70,186,123,309,0.000333,0.631316,45,85227.68035,4734.871131,1893.948452,360.083842,12,0
0,0,37,37,30,38,68,176,117,293,0.000333,0.594542,45,80263.19756,4459.066531,1783.626612,346.627963,12,0
0,0,28,28,18,36,54,136,88,224,0.000333,0.429698,18,23203.70641,1289.0948,1289.0948,261.17595,14,0
0,0,74,74,29,54,83,438,291,729,0.000333,1.549135,70,325318.2622,18073.23679,4647.403745,451.645374,30,0
0,0,81,81,29,60,89,484,321,805,0.000333,1.737655,70,364907.5788,20272.64327,5212.965412,495.294885,31,0
0,0,63,63,29,50,79,374,250,624,0.000333,1.311186,70,275349.1431,15297.17462,3933.559187,423.074258,26,0
0,0,70,70,29,56,85,420,280,700,0.000333,1.495525,70,314060.1559,17447.78644,4486.573655,466.093324,27,0
0,0,66,66,28,55,83,400,263,663,0.000333,1.408884,56,236692.464,13149.58133,4226.651143,452.580722,27,0
0,0,66,66,28,54,82,404,265,669,0.000333,1.417734,56,238179.3283,13232.18491,4253.202291,445.369863,27,0
0,0,57,57,26,46,72,327,210,537,0.000333,1.104417,52,172288.9857,9571.610319,3313.249726,376.295283,25,0
0,0,85,85,31,59,90,490,339,829,0.000333,1.793915,75,403630.9663,22423.94257,5381.746217,500.656026,33,0
0,0,92,92,33,62,95,542,384,926,0.000333,2.027895,96,584033.8842,32446.3269,6083.686293,535.625177,35,0
0,0,18,18,15,25,40,103,57,160,0.000333,0.283836,14,11921.11893,662.284385,851.508495,174.699764,7,0
0,0,18,18,15,25,40,104,57,161,0.000333,0.28561,14,11995.62593,666.423663,856.830423,174.699764,7,0
0,0,19,19,23,44,67,199,104,303,0.000333,0.612675,22,40436.55054,2246.47503,1838.025025,344.256916,6,0
0,0,27,27,27,49,76,278,141,419,0.000333,0.872627,26,68064.92233,3781.384574,2617.881628,403.502745,8,0
0,0,24,24,19,34,53,142,94,236,0.000333,0.450596,18,24332.20609,1351.789227,1351.789227,253.684359,8,0
0,0,16,16,13,27,40,63,57,120,0.000333,0.212877,12,7663.576457,425.754248,638.631371,176.487679,6,0
0,0,36,36,16,42,58,267,167,434,0.000333,0.847455,24,61016.73005,3389.818336,2542.363752,290.477332,4,0
0,0,35,35,16,42,58,263,165,428,0.000333,0.835739,24,60173.18078,3342.954488,2507.215866,290.477332,3,0
0,0,34,34,16,42,58,259,163,422,0.000333,0.824023,24,59329.63152,3296.09064,2472.06798,290.477332,2,0
0,0,17,17,14,34,48,126,80,206,0.000333,0.383501,14,16107.03185,894.835103,1150.502275,226.276706,1,0
0,0,28,28,27,55,82,268,148,416,0.000333,0.881581,26,68763.28248,3820.18236,2644.741634,446.356747,8,0
0,0,25,25,27,54,81,249,138,387,0.000333,0.817841,26,63791.57073,3543.976152,2453.521951,439.145888,8,0
0,0,22,22,27,54,81,241,131,372,0.000333,0.786141,26,61319.02923,3406.612735,2358.424201,439.145888,8,0
0,0,34,34,30,69,99,705,290,995,0.000333,2.198737,60,395772.5902,21987.36612,6596.209837,568.694905,18,0
0,0,34,34,30,69,99,705,290,995,0.000333,2.198737,60,395772.5902,21987.36612,6596.209837,568.694905,18,0
0,0,41,41,32,79,111,436,246,682,0.000333,1.544597,48,222421.9978,12356.77766,4633.791621,657.998679,19,0
0,0,49,49,28,36,64,310,179,489,0.000333,0.978,56,164304,9128,2934,320.723238,32,0
0,0,48,48,34,48,82,378,322,700,0.000333,1.483429,102,453929.2131,25218.28962,4450.286403,441.051937,37,0
0,0,50,50,34,50,84,401,338,739,0.000333,1.574641,102,481840.1027,26768.89459,4723.922575,455.166546,42,0
0,0,45,45,33,45,78,354,302,656,0.000333,1.374408,96,395829.4901,21990.52723,4123.223856,413.598395,33,0
0,0,47,47,33,48,81,377,318,695,0.000333,1.468732,96,422994.7922,23499.71068,4406.195752,434.543206,38,0
0,0,53,53,36,77,113,475,339,814,0.000333,1.850542,72,399717.0486,22206.5027,5551.625675,668.659864,53,0
0,0,63,63,33,66,99,551,441,992,0.000333,2.192107,96,631326.8896,35073.71609,6576.321767,565.395018,39,0
0,0,39,39,30,64,94,482,375,857,0.000333,1.872428,75,421296.1984,23405.34436,5617.282646,531.206718,38,0
0,0,11,11,18,30,48,168,116,284,0.000333,0.52871,27,42825.49246,2379.194025,1586.12935,222.265368,5,0
0,0,23,23,20,49,69,184,131,315,0.000333,0.641395,20,38483.70408,2137.98356,1924.185204,361.559344,11,0
0,0,39,39,26,58,84,264,186,450,0.000333,0.958848,39,112185.1708,6232.509487,2876.54284,461.97433,20,0
0,0,10,10,11,16,27,73,44,117,0.000333,0.185441,10,5563.218378,309.067688,556.321838,102.053748,4,0
0,0,10,10,10,16,26,67,41,108,0.000333,0.169216,10,5076.474896,282.026383,507.64749,97.219281,3,0
0,0,10,10,10,16,26,71,41,112,0.000333,0.175483,10,5264.492484,292.471805,526.449248,97.219281,3,0
0,0,10,10,10,16,26,67,41,108,0.000333,0.169216,10,5076.474896,282.026383,507.64749,97.219281,3,0
0,0,10,10,10,16,26,71,41,112,0.000333,0.175483,10,5264.492484,292.471805,526.449248,97.219281,3,0
0,0,10,10,10,16,26,67,41,108,0.000333,0.169216,10,5076.474896,282.026383,507.64749,97.219281,3,0
0,0,10,10,10,16,26,67,41,108,0.000333,0.169216,10,5076.474896,282.026383,507.64749,97.219281,3,0
0,0,10,10,10,16,26,67,41,108,0.000333,0.169216,10,5076.474896,282.026383,507.64749,97.219281,3,0
0,0,19,19,17,31,48,99,61,160,0.000333,0.297865,8,7148.752001,397.152889,893.594,223.066954,11,0
0,0,20,20,19,24,43,91,63,154,0.000333,0.278548,18,15041.6059,835.644772,835.644772,190.749723,9,0
0,0,33,33,21,48,69,176,116,292,0.000333,0.594563,20,35673.78283,1981.876824,1783.689141,360.316866,9,0
0,0,57,57,22,58,80,295,195,490,0.000333,1.032582,33,102225.5773,5679.198739,3097.744766,437.870393,14,0
0,0,54,54,22,58,80,281,187,468,0.000333,0.986221,33,97635.8575,5424.214305,2958.662348,437.870393,13,0
0,0,50,50,22,58,80,271,178,449,0.000333,0.946182,33,93672.00858,5204.000477,2838.545715,437.870393,12,0
0,0,21,21,20,24,44,163,104,267,0.000333,0.485889,40,58306.72969,3239.26276,1457.668242,196.477662,5,0
0,0,21,21,20,25,45,159,102,261,0.000333,0.477791,40,57334.94633,3185.274796,1433.373658,202.534967,5,0
0,0,9,9,20,36,56,139,88,227,0.000333,0.439423,20,26365.39135,1464.743964,1318.269567,272.555862,3,0
0,0,20,20,20,26,46,165,102,267,0.000333,0.491597,30,44243.73127,2457.98507,1474.791042,208.649995,5,0
0,0,41,41,19,45,64,216,139,355,0.000333,0.71,27,57510,3195,2130,327.844012,5,0
0,0,38,38,17,44,61,216,132,348,0.000333,0.687966,24,49533.51824,2751.862125,2063.896593,309.70186,6,0
0,0,37,37,19,45,64,206,130,336,0.000333,0.672,18,36288,2016,2016,327.844012,4,0
0,0,34,34,17,44,61,206,123,329,0.000333,0.650404,16,31219.40135,1734.411186,1951.212584,309.70186,5,0
0,0,20,20,17,30,47,99,63,162,0.000333,0.299948,16,14397.4943,799.860795,899.843394,216.693586,11,0
0,0,10,10,15,24,39,54,39,93,0.000333,0.163847,7,3440.796844,191.15538,491.542406,168.642459,4,0
0,0,16,16,16,27,43,170,88,258,0.000333,0.466659,24,33599.43136,1866.635076,1399.976307,192.381963,8,0
0,0,15,15,16,25,41,166,84,250,0.000333,0.446463,24,32145.31203,1785.850668,1339.388001,180.096405,8,0
0,0,10,10,10,16,26,71,41,112,0.000333,0.175483,10,5264.492484,292.471805,526.449248,97.219281,3,0
0,0,10,10,10,16,26,67,41,108,0.000333,0.169216,10,5076.474896,282.026383,507.64749,97.219281,3,0
0,0,10,10,10,16,26,71,41,112,0.000333,0.175483,10,5264.492484,292.471805,526.449248,97.219281,3,0
0,0,10,10,10,16,26,67,41,108,0.000333,0.169216,10,5076.474896,282.026383,507.64749,97.219281,3,0
0,0,10,10,10,16,26,67,41,108,0.000333,0.169216,10,5076.474896,282.026383,507.64749,97.219281,3,0
0,0,10,10,10,16,26,67,41,108,0.000333,0.169216,10,5076.474896,282.026383,507.64749,97.219281,3,0
0,0,77,77,37,106,143,544,420,964,0.000333,2.300705,54,372714.2623,20706.34791,6902.115969,905.909343,28,0
0,0,17,17,21,44,65,191,145,336,0.000333,0.674505,30,60705.46756,3372.525975,2023.515585,332.453657,10,0
0,0,42,42,24,77,101,267,208,475,0.000333,1.054217,24,75903.6109,4216.867272,3162.650454,592.581664,27,0
0,0,85,85,31,73,104,554,415,969,0.000333,2.164242,75,486954.4565,27053.02536,6492.726087,605.437278,47,0
0,0,91,91,29,89,118,494,350,844,0.000333,1.936317,42,243975.9308,13554.21838,5808.950734,717.221724,56,0
0,0,91,91,31,79,110,567,429,996,0.000333,2.251411,75,506567.5706,28142.64281,6754.234275,651.578765,50,0
0,0,89,89,31,77,108,563,420,983,0.000333,2.213351,75,498004.0811,27666.89339,6640.054415,636.122649,46,0
0,0,12,12,14,20,34,63,39,102,0.000333,0.172974,7,3632.448469,201.802693,518.92121,139.741531,9,0
0,0,21,21,19,30,49,96,64,160,0.000333,0.299451,18,16170.36435,898.353575,898.353575,227.917341,11,0
0,0,18,18,15,25,40,103,57,160,0.000333,0.283836,14,11921.11893,662.284385,851.508495,174.699764,7,0
0,0,18,18,15,25,40,104,57,161,0.000333,0.28561,14,11995.62593,666.423663,856.830423,174.699764,7,0
0,0,34,34,23,50,73,190,128,318,0.000333,0.656121,22,43304.01261,2405.778479,1968.36421,386.234734,22,0
0,0,44,44,28,60,88,255,161,416,0.000333,0.895708,28,75239.45949,4179.969972,2687.123553,489.019374,19,0
0,0,30,30,21,43,64,157,104,261,0.000333,0.522,20,31320,1740,1566,325.56805,16,0
0,0,56,56,27,60,87,372,227,599,0.000333,1.286441,39,150513.603,8361.866834,3859.323154,482.795398,13,0
0,0,60,60,27,60,87,404,247,651,0.000333,1.398119,52,218106.5232,12117.02907,4194.356216,482.795398,14,0
0,0,55,55,27,57,84,390,229,619,0.000333,1.318948,52,205755.9132,11430.88407,3956.844485,460.856693,15,0
0,0,59,59,26,57,83,422,249,671,0.000333,1.425884,52,222437.8758,12357.65977,4277.651458,454.686163,16,0
0,0,13,13,13,19,32,70,40,110,0.000333,0.183333,12,6600,366.666667,550,128.816339,4,0
0,0,11,11,17,21,38,55,40,95,0.000333,0.166184,8,3988.42491,221.579162,498.553114,161.725534,7,0
0,0,16,16,18,37,55,152,77,229,0.000333,0.44131,18,23830.76474,1323.931374,1323.931374,267.808425,6,0
0,0,17,17,20,39,59,167,85,252,0.000333,0.494142,20,29648.52097,1647.140054,1482.426048,292.569248,8,0
0,0,12,12,17,28,45,86,53,139,0.000333,0.254456,8,6106.940643,339.27448,763.36758,204.092806,3,0
0,0,18,18,15,25,40,103,57,160,0.000333,0.283836,14,11921.11893,662.284385,851.508495,174.699764,7,0
0,0,18,18,15,25,40,104,57,161,0.000333,0.28561,14,11995.62593,666.423663,856.830423,174.699764,7,0
0,0,48,48,29,66,95,285,181,466,0.000333,1.020518,28,85723.47598,4762.415332,3061.552713,539.811461,21,0
0,0,30,30,21,43,64,160,108,268,0.000333,0.536,20,32160,1786.666667,1608,325.56805,20,0
0,0,30,30,21,43,64,157,104,261,0.000333,0.522,20,31320,1740,1566,325.56805,16,0
0,0,56,56,27,60,87,372,227,599,0.000333,1.286441,39,150513.603,8361.866834,3859.323154,482.795398,13,0
0,0,60,60,27,60,87,404,247,651,0.000333,1.398119,52,218106.5232,12117.02907,4194.356216,482.795398,14,0
0,0,55,55,27,57,84,390,229,619,0.000333,1.318948,52,205755.9132,11430.88407,3956.844485,460.856693,15,0
0,0,59,59,26,57,83,422,249,671,0.000333,1.425884,52,222437.8758,12357.65977,4277.651458,454.686163,16,0
0,0,13,13,13,19,32,70,40,110,0.000333,0.183333,12,6600,366.666667,550,128.816339,4,0
0,0,11,11,17,21,38,55,40,95,0.000333,0.166184,8,3988.42491,221.579162,498.553114,161.725534,7,0
0,0,12,12,17,28,45,86,53,139,0.000333,0.254456,8,6106.940643,339.27448,763.36758,204.092806,3,0
0,0,17,17,20,39,59,167,85,252,0.000333,0.494142,20,29648.52097,1647.140054,1482.426048,292.569248,8,0
0,0,16,16,18,37,55,152,77,229,0.000333,0.44131,18,23830.76474,1323.931374,1323.931374,267.808425,6,0
0,0,13,13,17,17,34,82,47,129,0.000333,0.218761,16,10500.5233,583.362406,656.282707,138.973737,2,0
0,0,41,41,30,58,88,291,187,478,0.000333,1.029203,45,138942.3741,7719.020784,3087.608314,486.969616,21,0
0,0,83,83,25,84,109,499,324,823,0.000333,1.856739,36,200527.7652,11140.4314,5570.215699,653.051068,28,0
0,0,57,57,25,63,88,362,228,590,0.000333,1.270355,36,137198.3276,7622.12931,3811.064655,492.66504,14,0
0,0,24,24,22,31,53,400,98,498,0.000333,0.950835,33,94132.64475,5229.591375,2852.504386,251.687581,9,0
0,0,31,31,21,35,56,428,116,544,0.000333,1.053067,30,94776.03233,5265.335129,3159.201078,271.763571,12,0
0,0,39,39,30,55,85,271,174,445,0.000333,0.950726,45,128348.0535,7130.447416,2852.178967,465.181502,22,0
0,0,10,10,11,26,37,50,42,92,0.000333,0.159757,5,2396.348548,133.130475,479.26971,160.26518,5,0
0,0,49,49,22,75,97,269,212,481,0.000333,1.058186,22,69840.2777,3880.015428,3174.558077,565.268897,28,0
0,0,53,53,24,83,107,300,234,534,0.000333,1.199981,24,86398.6409,4799.924494,3599.943371,639.167373,30,0
0,0,35,35,20,51,71,176,153,329,0.000333,0.674422,30,60698.00407,3372.111337,2023.266802,375.732254,18,0
0,0,39,39,22,61,83,207,175,382,0.000333,0.811755,22,53575.83138,2976.435077,2435.265063,459.882473,20,0
0,0,19,19,22,33,55,109,94,203,0.000333,0.391205,22,25819.55248,1434.419582,1173.616022,264.572502,9,0
0,0,19,19,23,38,61,118,106,224,0.000333,0.442828,22,29226.6736,1623.704089,1328.485164,303.463171,14,0
0,0,18,18,19,29,48,73,59,132,0.000333,0.245738,18,13269.8709,737.21505,737.21505,221.592072,4,0
0,0,40,40,27,32,59,202,135,337,0.000333,0.660817,52,103087.4368,5727.079822,1982.450708,288.381963,17,0
0,0,78,78,30,56,86,316,226,542,0.000333,1.161012,60,208982.1298,11610.11832,3483.035497,472.418594,23,0
0,0,78,78,30,56,86,316,226,542,0.000333,1.161012,60,208982.1298,11610.11832,3483.035497,472.418594,23,0
0,0,46,46,19,38,57,185,134,319,0.000333,0.620231,27,50238.68169,2791.037872,1860.691915,280.131868,12,0
0,0,8,8,12,15,27,33,24,57,0.000333,0.090343,6,1626.171526,90.342863,271.028588,101.622909,5,0
0,0,13,13,16,17,33,54,37,91,0.000333,0.153013,16,7344.637838,408.035435,459.039865,133.486868,7,0
0,0,29,29,19,28,47,116,81,197,0.000333,0.364751,18,19696.57207,1094.254004,1094.254004,215.316561,11,0
0,0,29,29,21,28,49,122,82,204,0.000333,0.3818,20,22908.01616,1272.667565,1145.400808,226.844604,12,0
0,0,28,28,20,28,48,114,77,191,0.000333,0.355576,20,21334.55675,1185.253153,1066.727838,221.0445,10,0
0,0,24,24,19,27,46,115,73,188,0.000333,0.346143,18,18691.73366,1038.429648,1038.429648,209.092585,10,0
0,0,22,22,17,26,43,107,68,175,0.000333,0.316532,16,15193.54131,844.085629,949.596332,191.698301,10,0
0,0,74,74,29,54,83,438,291,729,0.000333,1.549135,70,325318.2622,18073.23679,4647.403745,451.645374,30,0
0,0,81,81,29,60,89,484,321,805,0.000333,1.737655,70,364907.5788,20272.64327,5212.965412,495.294885,31,0
0,0,63,63,29,50,79,374,250,624,0.000333,1.311186,70,275349.1431,15297.17462,3933.559187,423.074258,26,0
0,0,70,70,29,56,85,420,280,700,0.000333,1.495525,70,314060.1559,17447.78644,4486.573655,466.093324,27,0
0,0,66,66,28,55,83,400,263,663,0.000333,1.408884,56,236692.464,13149.58133,4226.651143,452.580722,27,0
0,0,66,66,28,54,82,404,265,669,0.000333,1.417734,56,238179.3283,13232.18491,4253.202291,445.369863,27,0
0,0,57,57,26,46,72,327,210,537,0.000333,1.104417,52,172288.9857,9571.610319,3313.249726,376.295283,25,0
0,0,85,85,31,59,90,490,339,829,0.000333,1.793915,75,403630.9663,22423.94257,5381.746217,500.656026,33,0
0,0,92,92,33,62,95,542,384,926,0.000333,2.027895,96,584033.8842,32446.3269,6083.686293,535.625177,35,0
0,0,62,62,30,39,69,447,277,724,0.000333,1.474191,105,464370.0292,25798.33496,4422.571707,353.337404,39,0
0,0,37,37,29,44,73,272,177,449,0.000333,0.92641,56,155636.9487,8646.49715,2779.231227,381.09644,14,0
0,0,21,21,20,25,45,100,81,181,0.000333,0.331342,30,29820.76231,1656.709017,994.02541,202.534967,13,0
0,0,46,46,28,39,67,413,205,618,0.000333,1.249614,70,262419.0184,14578.83435,3748.84312,340.736624,13,0
0,0,78,78,29,59,88,472,312,784,0.000333,1.688065,70,354493.6072,19694.08929,5064.194389,487.957389,31,0
0,0,71,71,29,53,82,426,282,708,0.000333,1.500382,70,315080.2773,17504.45985,4501.146819,444.461233,30,0
0,0,67,67,29,55,84,408,271,679,0.000333,1.446795,56,243061.4777,13503.41543,4340.38353,458.856233,27,0
0,0,60,60,29,49,78,362,241,603,0.000333,1.263366,56,212245.4621,11791.41456,3790.097538,416.002231,26,0
0,0,63,63,28,54,82,388,254,642,0.000333,1.360516,56,228566.7097,12698.15054,4081.548387,445.369863,27,0
0,0,63,63,28,53,81,392,256,648,0.000333,1.369408,56,230060.4769,12781.13761,4108.222802,438.185722,27,0
0,0,54,54,26,45,71,315,201,516,0.000333,1.057757,52,165010.0147,9167.223039,3173.269514,369.344822,25,0
0,0,26,26,23,29,52,167,114,281,0.000333,0.533941,33,52860.17751,2936.676528,1601.823561,244.923374,10,0
0,0,28,28,23,29,52,175,120,295,0.000333,0.560543,44,73991.70754,4110.650419,1681.629717,244.923374,10,0
0,0,11,11,21,26,47,92,56,148,0.000333,0.274026,20,16441.583,913.421278,822.07915,214.450099,6,0
0,0,11,11,21,26,47,92,56,148,0.000333,0.274026,20,16441.583,913.421278,822.07915,214.450099,6,0
0,0,51,51,28,36,64,338,200,538,0.000333,1.076,70,225960,12553.33333,3228,320.723238,34,0
0,0,65,65,33,47,80,478,273,751,0.000333,1.582589,80,379821.4399,21101.19111,4747.767999,427.530682,20,0
0,0,82,82,31,58,89,478,330,808,0.000333,1.744131,75,392429.4459,21801.63588,5232.392612,493.342983,33,0
0,0,48,48,34,47,81,311,238,549,0.000333,1.160193,85,295849.1004,16436.06113,3480.577652,434.039413,17,0
0,0,50,50,35,47,82,345,264,609,0.000333,1.290583,85,329098.6795,18283.25997,3871.749171,440.590582,23,0
0,0,96,96,33,67,100,576,405,981,0.000333,2.172541,96,625691.8005,34760.65559,6517.622922,572.892982,36,0
0,0,89,89,33,61,94,530,375,905,0.000333,1.977301,96,569462.6794,31636.81552,5931.902911,528.239984,35,0
0,0,53,53,31,49,80,594,356,950,0.000333,2.001944,105,630612.3275,35034.01819,6005.83169,428.700868,23,0
0,0,56,56,33,54,87,498,333,831,0.000333,1.784695,96,513992.2603,28555.12557,5354.086045,477.228931,24,0
0,0,26,26,21,23,44,115,72,187,0.000333,0.340305,30,30627.41138,1701.522854,1020.913713,196.280591,11,0
0,0,10,10,16,20,36,52,41,93,0.000333,0.160268,16,7692.848402,427.380467,480.803025,150.438562,4,0
0,0,10,10,16,21,37,53,43,96,0.000333,0.166703,16,8001.72037,444.540021,500.107523,156.238666,4,0
0,0,13,13,17,21,38,67,53,120,0.000333,0.209917,16,10076.02083,559.778935,629.751302,161.725534,6,0
0,0,10,10,16,19,35,51,39,90,0.000333,0.153878,16,7386.167544,410.342641,461.635472,144.710623,4,0
0,0,13,13,21,23,44,68,54,122,0.000333,0.222017,20,13321.01315,740.056286,666.050657,196.280591,5,0
0,0,13,13,21,25,46,72,60,132,0.000333,0.243037,20,14582.20356,810.12242,729.110178,208.335071,5,0
0,0,13,13,21,25,46,70,58,128,0.000333,0.235672,20,14140.31861,785.573256,707.01593,208.335071,5,0
0,0,13,13,21,24,45,69,56,125,0.000333,0.228827,20,13729.63274,762.757374,686.481637,202.277766,5,0
0,0,13,13,21,23,44,68,55,123,0.000333,0.223837,20,13430.20178,746.122321,671.510089,196.280591,5,0
0,0,44,44,29,44,73,206,151,357,0.000333,0.736589,42,92810.22944,5156.123858,2209.767368,381.09644,14,0
0,0,48,48,32,35,67,215,133,348,0.000333,0.703666,48,101327.9538,5629.330769,2110.999038,339.524906,17,0
0,0,49,49,29,48,77,237,168,405,0.000333,0.846016,42,106598.0391,5922.113281,2538.048549,408.959649,16,0
0,0,37,37,30,40,70,186,123,309,0.000333,0.631316,45,85227.68035,4734.871131,1893.948452,360.083842,12,0
0,0,37,37,30,38,68,176,117,293,0.000333,0.594542,45,80263.19756,4459.066531,1783.626612,346.627963,12,0
0,0,49,49,29,45,74,227,162,389,0.000333,0.805159,42,101450.0491,5636.113838,2415.477359,388.014838,16,0
0,0,15,15,20,26,46,100,68,168,0.000333,0.309319,20,18559.16817,1031.064898,927.958409,208.649995,7,0
0,0,9,9,13,15,28,59,39,98,0.000333,0.15704,12,5653.449388,314.080522,471.120782,106.709075,4,0
0,0,25,25,26,27,53,164,111,275,0.000333,0.525059,52,81909.2625,4550.514583,1575.178125,250.593395,9,0
0,0,19,19,24,26,50,134,90,224,0.000333,0.421408,36,45512.05631,2528.447573,1264.223787,232.250533,8,0
0,0,27,27,20,46,66,242,139,381,0.000333,0.767638,30,69087.42478,3838.190266,2302.914159,340.522412,20,0
0,0,21,21,20,25,45,100,81,181,0.000333,0.331342,30,29820.76231,1656.709017,994.02541,202.534967,13,0
0,0,26,26,21,23,44,115,72,187,0.000333,0.340305,30,30627.41138,1701.522854,1020.913713,196.280591,11,0
0,0,10,10,16,20,36,52,41,93,0.000333,0.160268,16,7692.848402,427.380467,480.803025,150.438562,4,0
0,0,10,10,16,21,37,53,43,96,0.000333,0.166703,16,8001.72037,444.540021,500.107523,156.238666,4,0
0,0,10,10,16,19,35,51,39,90,0.000333,0.153878,16,7386.167544,410.342641,461.635472,144.710623,4,0
0,0,13,13,17,21,38,67,53,120,0.000333,0.209917,16,10076.02083,559.778935,629.751302,161.725534,6,0
0,0,13,13,21,24,45,69,56,125,0.000333,0.228827,20,13729.63274,762.757374,686.481637,202.277766,5,0
0,0,48,48,32,35,67,215,133,348,0.000333,0.703666,48,101327.9538,5629.330769,2110.999038,339.524906,17,0
0,0,37,37,30,38,68,176,117,293,0.000333,0.594542,45,80263.19756,4459.066531,1783.626612,346.627963,12,0
0,0,37,37,30,40,70,186,123,309,0.000333,0.631316,45,85227.68035,4734.871131,1893.948452,360.083842,12,0
0,0,49,49,28,36,64,310,179,489,0.000333,0.978,56,164304,9128,2934,320.723238,32,0
0,0,82,82,31,58,89,478,330,808,0.000333,1.744131,75,392429.4459,21801.63588,5232.392612,493.342983,33,0
0,0,65,65,33,47,80,478,273,751,0.000333,1.582589,80,379821.4399,21101.19111,4747.767999,427.530682,20,0
0,0,48,48,34,47,81,311,238,549,0.000333,1.160193,85,295849.1004,16436.06113,3480.577652,434.039413,17,0
0,0,50,50,35,47,82,345,264,609,0.000333,1.290583,85,329098.6795,18283.25997,3871.749171,440.590582,23,0
0,0,96,96,33,67,100,576,405,981,0.000333,2.172541,96,625691.8005,34760.65559,6517.622922,572.892982,36,0
0,0,89,89,33,61,94,530,375,905,0.000333,1.977301,96,569462.6794,31636.81552,5931.902911,528.239984,35,0
0,0,53,53,31,49,80,594,356,950,0.000333,2.001944,105,630612.3275,35034.01819,6005.83169,428.700868,23,0
0,0,56,56,33,54,87,498,333,831,0.000333,1.784695,96,513992.2603,28555.12557,5354.086045,477.228931,24,0
0,0,22,22,18,48,66,114,83,197,0.000333,0.396915,9,10716.71077,595.372821,1190.745642,343.13685,9,0
0,0,45,45,24,54,78,249,161,410,0.000333,0.859005,24,61848.35783,3436.01988,2577.01491,420.803025,20,0
0,0,19,19,23,34,57,121,86,207,0.000333,0.402469,22,26562.98113,1475.721174,1207.408233,277.015662,7,0
0,0,34,34,24,54,78,255,173,428,0.000333,0.896717,36,96845.47739,5380.304299,2690.15215,420.803025,11,0
0,0,92,92,22,65,87,507,304,811,0.000333,1.741742,44,229909.9957,12772.77754,5225.227175,489.561403,40,0
0,0,50,50,26,68,94,314,198,512,0.000333,1.11865,26,87254.68679,4847.4826,3355.949492,536.158906,20,0
0,0,24,24,25,50,75,186,123,309,0.000333,0.641568,24,46192.91941,2566.2733,1924.704975,398.289214,7,0
0,0,39,39,25,67,92,320,210,530,0.000333,1.152496,36,124469.5621,6914.975673,3457.487837,522.524381,11,0
0,0,97,97,25,78,103,572,341,913,0.000333,2.034925,48,293029.1991,16279.39995,6104.774981,606.357778,40,0
0,0,47,47,26,68,94,307,192,499,0.000333,1.090247,26,85039.23576,4724.401987,3270.739837,536.158906,20,0
0,0,21,21,25,50,75,179,117,296,0.000333,0.614577,24,44249.52798,2458.30711,1843.730332,398.289214,7,0
0,0,36,36,25,67,92,313,204,517,0.000333,1.124227,36,121416.5351,6745.363063,3372.681531,522.524381,11,0
0,0,94,94,25,78,103,565,335,900,0.000333,2.00595,48,288856.8228,16047.60127,6017.850474,606.357778,40,0
0,0,18,18,18,34,52,123,87,210,0.000333,0.399031,18,21547.66214,1197.092341,1197.092341,248.032387,7,0
0,0,82,82,26,82,108,540,324,864,0.000333,1.945408,39,227612.6893,12645.1494,5836.222802,643.530697,33,0
0,0,57,57,18,58,76,349,209,558,0.000333,1.162115,27,94131.27592,5229.515329,3486.343553,414.821548,26,0
0,0,43,43,29,70,99,310,189,499,0.000333,1.102683,28,92625.3707,5145.853928,3308.048953,569.93126,22,0
0,0,17,17,29,51,80,182,114,296,0.000333,0.623764,28,52396.14005,2910.896669,1871.290716,430.175141,9,0
0,0,17,17,29,51,80,182,114,296,0.000333,0.623764,28,52396.14005,2910.896669,1871.290716,430.175141,9,0
0,0,66,66,28,78,106,469,279,748,0.000333,1.677495,42,211364.349,11742.46383,5032.4845,624.867311,31,0
0,0,59,59,28,75,103,433,258,691,0.000333,1.540124,42,194055.6183,10780.86768,4620.371864,601.76734,28,0
0,0,22,22,18,48,66,114,83,197,0.000333,0.396915,9,10716.71077,595.372821,1190.745642,343.13685,9,0
0,0,25,25,18,50,68,125,97,222,0.000333,0.450472,9,12162.75076,675.708375,1351.416751,357.25146,10,0
0,0,25,25,19,50,69,126,91,217,0.000333,0.44185,9,11929.94826,662.774904,1325.549807,362.903432,10,0
0,0,22,22,18,48,66,114,83,197,0.000333,0.396915,9,10716.71077,595.372821,1190.745642,343.13685,9,0
0,0,18,18,15,25,40,103,57,160,0.000333,0.283836,14,11921.11893,662.284385,851.508495,174.699764,7,0
0,0,18,18,15,25,40,104,57,161,0.000333,0.28561,14,11995.62593,666.423663,856.830423,174.699764,7,0
0,0,77,77,37,106,143,544,420,964,0.000333,2.300705,54,372714.2623,20706.34791,6902.115969,905.909343,28,0
0,0,17,17,21,44,65,191,145,336,0.000333,0.674505,30,60705.46756,3372.525975,2023.515585,332.453657,10,0
0,0,22,22,18,49,67,114,84,198,0.000333,0.400362,9,10809.77094,600.54283,1201.08566,350.179432,9,0
0,0,21,21,16,48,64,111,80,191,0.000333,0.382,8,9168,509.333333,1146,332.0782,9,0
0,0,18,18,22,36,58,126,72,198,0.000333,0.386627,22,25517.36522,1417.631401,1159.880237,284.224796,7,0
0,0,12,12,14,20,34,63,39,102,0.000333,0.172974,7,3632.448469,201.802693,518.92121,139.741531,9,0
0,0,13,13,17,17,34,82,47,129,0.000333,0.218761,16,10500.5233,583.362406,656.282707,138.973737,2,0
0,0,41,41,30,58,88,291,187,478,0.000333,1.029203,45,138942.3741,7719.020784,3087.608314,486.969616,21,0
0,0,83,83,25,84,109,499,324,823,0.000333,1.856739,36,200527.7652,11140.4314,5570.215699,653.051068,28,0
0,0,57,57,25,63,88,362,228,590,0.000333,1.270355,36,137198.3276,7622.12931,3811.064655,492.66504,14,0
0,0,35,35,24,46,70,207,136,343,0.000333,0.700781,24,50456.2578,2803.125433,2102.344075,364.12295,18,0
0,0,39,39,30,55,85,271,174,445,0.000333,0.950726,45,128348.0535,7130.447416,2852.178967,465.181502,22,0
0,0,18,18,15,25,40,103,57,160,0.000333,0.283836,14,11921.11893,662.284385,851.508495,174.699764,7,0
0,0,18,18,15,25,40,104,57,161,0.000333,0.28561,14,11995.62593,666.423663,856.830423,174.699764,7,0
0,0,55,55,21,39,60,266,186,452,0.000333,0.889972,40,106796.582,5933.143443,2669.914549,298.369352,6,0
0,0,21,21,20,32,52,143,86,229,0.000333,0.435134,20,26108.01391,1450.445217,1305.400695,246.438562,4,0
0,0,53,53,29,47,76,267,183,450,0.000333,0.937189,42,118085.83,6560.323889,2811.567381,401.947125,20,0
0,0,12,12,20,13,33,72,55,127,0.000333,0.213546,40,25625.52213,1423.640118,640.638053,134.544278,5,0
0,0,44,44,32,46,78,279,187,466,0.000333,0.976332,64,187455.8358,10414.2131,2928.997434,414.08385,17,0
0,0,15,15,19,20,39,96,72,168,0.000333,0.295983,27,23974.58447,1331.921359,887.947573,167.149185,8,0
0,0,13,13,18,19,37,89,68,157,0.000333,0.272628,27,22082.87282,1226.826268,817.884178,155.769273,7,0
0,0,47,47,33,53,86,303,204,507,0.000333,1.086039,48,156389.5791,8688.309948,3258.116231,470.04479,20,0
0,0,12,12,19,20,39,87,66,153,0.000333,0.269556,27,21833.99657,1212.999809,808.666539,167.149185,7,0
0,0,19,19,21,30,51,123,80,203,0.000333,0.383834,20,23030.04689,1279.447049,1151.502344,239.445384,4,0
0,0,22,22,18,49,67,114,84,198,0.000333,0.400362,9,10809.77094,600.54283,1201.08566,350.179432,9,0
0,0,19,19,23,44,67,199,104,303,0.000333,0.612675,22,40436.55054,2246.47503,1838.025025,344.256916,6,0
0,0,27,27,27,49,76,278,141,419,0.000333,0.872627,26,68064.92233,3781.384574,2617.881628,403.502745,8,0
0,0,16,16,13,27,40,63,57,120,0.000333,0.212877,12,7663.576457,425.754248,638.631371,176.487679,6,0
0,0,24,24,19,34,53,142,94,236,0.000333,0.450596,18,24332.20609,1351.789227,1351.789227,253.684359,8,0
0,0,36,36,16,42,58,267,167,434,0.000333,0.847455,24,61016.73005,3389.818336,2542.363752,290.477332,4,0
0,0,35,35,16,42,58,263,165,428,0.000333,0.835739,24,60173.18078,3342.954488,2507.215866,290.477332,3,0
0,0,34,34,16,42,58,259,163,422,0.000333,0.824023,24,59329.63152,3296.09064,2472.06798,290.477332,2,0
0,0,17,17,14,34,48,126,80,206,0.000333,0.383501,14,16107.03185,894.835103,1150.502275,226.276706,1,0
0,0,28,28,27,55,82,268,148,416,0.000333,0.881581,26,68763.28248,3820.18236,2644.741634,446.356747,8,0
0,0,25,25,27,54,81,249,138,387,0.000333,0.817841,26,63791.57073,3543.976152,2453.521951,439.145888,8,0
0,0,22,22,27,54,81,241,131,372,0.000333,0.786141,26,61319.02923,3406.612735,2358.424201,439.145888,8,0
0,0,34,34,30,69,99,705,290,995,0.000333,2.198737,60,395772.5902,21987.36612,6596.209837,568.694905,18,0
0,0,34,34,30,69,99,705,290,995,0.000333,2.198737,60,395772.5902,21987.36612,6596.209837,568.694905,18,0
0,0,41,41,32,79,111,436,246,682,0.000333,1.544597,48,222421.9978,12356.77766,4633.791621,657.998679,19,0
0,0,24,24,18,50,68,123,90,213,0.000333,0.43221,9,11669.66627,648.314793,1296.629585,357.25146,9,0
0,0,22,22,18,49,67,114,84,198,0.000333,0.400362,9,10809.77094,600.54283,1201.08566,350.179432,9,0
0,0,22,22,18,49,67,114,84,198,0.000333,0.400362,9,10809.77094,600.54283,1201.08566,350.179432,9,0
0,0,24,24,19,50,69,123,91,214,0.000333,0.435741,9,11765.0181,653.612117,1307.224234,362.903432,9,0
0,0,60,60,30,39,69,419,256,675,0.000333,1.374418,90,371092.8607,20616.27004,4123.254008,353.337404,37,0
0,0,21,21,20,25,45,100,81,181,0.000333,0.331342,30,29820.76231,1656.709017,994.02541,202.534967,13,0
0,0,49,49,28,36,64,310,179,489,0.000333,0.978,56,164304,9128,2934,320.723238,32,0
0,0,65,65,33,47,80,478,273,751,0.000333,1.582589,80,379821.4399,21101.19111,4747.767999,427.530682,20,0
0,0,82,82,31,58,89,478,330,808,0.000333,1.744131,75,392429.4459,21801.63588,5232.392612,493.342983,33,0
0,0,53,53,31,49,80,594,356,950,0.000333,2.001944,105,630612.3275,35034.01819,6005.83169,428.700868,23,0
0,0,56,56,33,54,87,498,333,831,0.000333,1.784695,96,513992.2603,28555.12557,5354.086045,477.228931,24,0
0,0,96,96,33,67,100,576,405,981,0.000333,2.172541,96,625691.8005,34760.65559,6517.622922,572.892982,36,0
0,0,89,89,33,61,94,530,375,905,0.000333,1.977301,96,569462.6794,31636.81552,5931.902911,528.239984,35,0
0,0,50,50,35,47,82,345,264,609,0.000333,1.290583,85,329098.6795,18283.25997,3871.749171,440.590582,23,0
0,0,48,48,34,47,81,311,238,549,0.000333,1.160193,85,295849.1004,16436.06113,3480.577652,434.039413,17,0
0,0,18,18,13,30,43,99,79,178,0.000333,0.321958,12,11590.50152,643.916751,965.875126,195.312434,5,0
0,0,12,12,14,20,34,63,39,102,0.000333,0.172974,7,3632.448469,201.802693,518.92121,139.741531,9,0
0,0,17,17,21,21,42,98,61,159,0.000333,0.285793,20,17147.5694,952.642745,857.37847,184.477332,5,0
0,0,62,62,30,39,69,447,277,724,0.000333,1.474191,105,464370.0292,25798.33496,4422.571707,353.337404,39,0
0,0,37,37,29,44,73,272,177,449,0.000333,0.92641,56,155636.9487,8646.49715,2779.231227,381.09644,14,0
0,0,21,21,20,25,45,101,83,184,0.000333,0.336834,30,30315.02909,1684.168283,1010.50097,202.534967,13,0
0,0,46,46,28,39,67,413,205,618,0.000333,1.249614,70,262419.0184,14578.83435,3748.84312,340.736624,13,0
0,0,78,78,29,59,88,472,312,784,0.000333,1.688065,70,354493.6072,19694.08929,5064.194389,487.957389,31,0
0,0,71,71,29,53,82,426,282,708,0.000333,1.500382,70,315080.2773,17504.45985,4501.146819,444.461233,30,0
0,0,67,67,29,55,84,408,271,679,0.000333,1.446795,56,243061.4777,13503.41543,4340.38353,458.856233,27,0
0,0,60,60,29,49,78,362,241,603,0.000333,1.263366,56,212245.4621,11791.41456,3790.097538,416.002231,26,0
0,0,63,63,28,54,82,388,254,642,0.000333,1.360516,56,228566.7097,12698.15054,4081.548387,445.369863,27,0
0,0,63,63,28,53,81,392,256,648,0.000333,1.369408,56,230060.4769,12781.13761,4108.222802,438.185722,27,0
0,0,54,54,26,45,71,315,201,516,0.000333,1.057757,52,165010.0147,9167.223039,3173.269514,369.344822,25,0
0,0,26,26,23,29,52,167,114,281,0.000333,0.533941,33,52860.17751,2936.676528,1601.823561,244.923374,10,0
0,0,28,28,23,29,52,175,120,295,0.000333,0.560543,44,73991.70754,4110.650419,1681.629717,244.923374,10,0
0,0,11,11,21,26,47,92,56,148,0.000333,0.274026,20,16441.583,913.421278,822.07915,214.450099,6,0
0,0,11,11,21,26,47,92,56,148,0.000333,0.274026,20,16441.583,913.421278,822.07915,214.450099,6,0
0,0,51,51,28,36,64,338,200,538,0.000333,1.076,70,225960,12553.33333,3228,320.723238,34,0
0,0,82,82,31,58,89,478,330,808,0.000333,1.744131,75,392429.4459,21801.63588,5232.392612,493.342983,33,0
0,0,65,65,33,47,80,478,273,751,0.000333,1.582589,80,379821.4399,21101.19111,4747.767999,427.530682,20,0
0,0,56,56,33,54,87,498,333,831,0.000333,1.784695,96,513992.2603,28555.12557,5354.086045,477.228931,24,0
0,0,53,53,31,49,80,594,356,950,0.000333,2.001944,105,630612.3275,35034.01819,6005.83169,428.700868,23,0
0,0,96,96,33,67,100,576,405,981,0.000333,2.172541,96,625691.8005,34760.65559,6517.622922,572.892982,36,0
0,0,89,89,33,61,94,530,375,905,0.000333,1.977301,96,569462.6794,31636.81552,5931.902911,528.239984,35,0
0,0,50,50,35,47,82,345,264,609,0.000333,1.290583,85,329098.6795,18283.25997,3871.749171,440.590582,23,0
0,0,48,48,34,47,81,311,238,549,0.000333,1.160193,85,295849.1004,16436.06113,3480.577652,434.039413,17,0
0,0,24,24,18,49,67,123,89,212,0.000333,0.42867,9,11574.09818,643.005454,1286.010908,350.179432,9,0
0,0,30,30,27,45,72,191,122,313,0.000333,0.643729,26,50210.84966,2789.491648,1931.186525,375.515352,28,0
0,0,60,60,30,44,74,357,208,565,0.000333,1.169447,60,210500.4691,11694.47051,3508.341152,387.421709,42,0
0,0,18,18,20,26,46,113,92,205,0.000333,0.377443,30,33969.90603,1887.217002,1132.330201,208.649995,8,0
0,0,10,10,15,14,29,47,38,85,0.000333,0.137643,14,5780.997384,321.166521,412.928385,111.906328,3,0
0,0,80,80,27,80,107,504,409,913,0.000333,2.051653,65,400072.3583,22226.24213,6154.959359,634.13621,60,0
0,0,80,80,28,83,111,511,410,921,0.000333,2.085886,56,350428.7927,19468.26626,6257.657013,663.734211,58,0
0,0,58,58,31,50,81,285,233,518,0.000333,1.094681,60,197042.5381,10946.80767,3284.042301,435.772895,33,0
0,0,53,53,29,46,75,290,236,526,0.000333,1.09212,70,229345.1042,12741.39468,3276.358631,394.965299,36,0
0,0,44,44,28,41,69,224,187,411,0.000333,0.836868,56,140593.7989,7810.766605,2510.603552,354.26557,28,0
0,0,45,45,29,41,70,224,187,411,0.000333,0.839712,56,141071.5779,7837.309884,2519.13532,360.541081,27,0
0,0,54,54,28,54,82,328,269,597,0.000333,1.265153,56,212545.6786,11808.09326,3795.458547,445.369863,37,0
0,0,63,63,28,58,86,399,323,722,0.000333,1.546588,70,324783.4207,18043.52337,4639.763153,474.368836,44,0
0,0,19,19,21,37,58,139,105,244,0.000333,0.476449,20,28586.94726,1588.163736,1429.347363,284.98844,15,0
0,0,14,14,21,36,57,110,86,196,0.000333,0.381082,20,22864.92886,1270.273825,1143.246443,278.355966,12,0
0,0,19,19,21,37,58,136,102,238,0.000333,0.464733,20,27883.98954,1549.11053,1394.199477,284.98844,15,0
0,0,14,14,21,36,57,107,83,190,0.000333,0.369416,20,22164.98205,1231.387892,1108.249103,278.355966,12,0
0,0,18,18,22,37,59,150,111,261,0.000333,0.51179,33,50667.20458,2814.844699,1535.369836,290.85727,12,0
0,0,13,13,22,35,57,121,92,213,0.000333,0.414135,22,27332.92261,1518.4957,1242.405573,277.632401,9,0
0,0,7,7,13,25,38,55,57,112,0.000333,0.195923,12,7053.214578,391.845254,587.767882,164.202121,3,0
0,0,30,30,22,58,80,225,159,384,0.000333,0.809207,22,53407.64855,2967.091586,2427.620388,437.870393,14,0
0,0,26,26,21,18,39,150,64,214,0.000333,0.377025,30,33932.28225,1885.126791,1131.076075,167.297316,21,0
0,0,22,22,20,17,37,134,53,187,0.000333,0.324723,30,29225.03338,1623.612966,974.167779,155.92543,15,0
0,0,30,30,20,21,41,143,75,218,0.000333,0.389315,30,35038.39011,1946.577228,1167.946337,178.677228,14,0
0,0,13,13,18,24,42,81,68,149,0.000333,0.267818,18,14462.19533,803.455296,803.455296,185.09775,6,0
0,0,38,38,27,55,82,251,177,428,0.000333,0.907011,39,106120.2581,5895.569892,2721.032258,446.356747,21,0
0,0,74,74,33,80,113,445,312,757,0.000333,1.720958,48,247818.0228,13767.66793,5162.875475,672.219254,41,0
0,0,92,92,30,91,121,577,422,999,0.000333,2.303981,60,414716.6624,23039.81458,6911.944374,739.41603,57,0
0,0,70,70,31,78,109,421,297,718,0.000333,1.619852,45,218680.0355,12148.89086,4859.556345,643.841459,39,0
0,0,27,27,18,33,51,140,86,226,0.000333,0.427323,18,23075.42629,1281.968127,1281.968127,241.523656,13,0
0,0,22,22,14,20,34,97,67,164,0.000333,0.278115,21,17521.22203,973.401224,834.343906,139.741531,7,0
0,0,60,60,27,48,75,342,240,582,0.000333,1.208391,65,235636.2111,13090.90062,3625.172478,396.460163,38,0
0,0,18,18,19,21,40,122,57,179,0.000333,0.317542,18,17147.25232,952.625129,952.625129,172.949289,14,0
0,0,18,18,19,21,40,122,57,179,0.000333,0.317542,18,17147.25232,952.625129,952.625129,172.949289,14,0
0,0,21,21,20,22,42,141,70,211,0.000333,0.37926,30,34133.36929,1896.298294,1137.778976,184.546058,15,0
0,0,20,20,22,21,43,133,65,198,0.000333,0.358133,33,35455.21391,1969.734106,1074.400421,190.346161,15,0
0,0,26,26,23,24,47,188,92,280,0.000333,0.518428,33,51324.40099,2851.355611,1555.284878,214.081025,17,0
0,0,22,22,23,26,49,160,81,241,0.000333,0.451048,33,44653.78739,2480.765966,1353.145072,226.253358,15,0
0,0,20,20,22,23,45,134,67,201,0.000333,0.367954,22,24284.97439,1349.165244,1103.862472,202.149421,15,0
0,0,20,20,22,21,43,134,67,201,0.000333,0.36356,33,35992.41412,1999.578562,1090.679216,190.346161,15,0
0,0,20,20,22,21,43,133,65,198,0.000333,0.358133,33,35455.21391,1969.734106,1074.400421,190.346161,15,0
0,0,20,20,22,23,45,134,67,201,0.000333,0.367954,22,24284.97439,1349.165244,1103.862472,202.149421,15,0
0,0,20,20,20,22,42,137,66,203,0.000333,0.36488,30,32839.21311,1824.400728,1094.640437,184.546058,14,0
0,0,20,20,20,21,41,130,63,193,0.000333,0.344669,30,31020.22611,1723.345895,1034.007537,178.677228,14,0
0,0,21,21,20,27,47,158,79,237,0.000333,0.438813,20,26328.75116,1462.708398,1316.437558,214.820524,14,0
0,0,20,20,20,22,42,137,66,203,0.000333,0.36488,30,32839.21311,1824.400728,1094.640437,184.546058,14,0
0,0,23,23,20,24,44,146,73,219,0.000333,0.398539,30,35868.46573,1992.692541,1195.615524,196.477662,15,0
0,0,23,23,21,23,44,145,71,216,0.000333,0.393079,30,35377.11689,1965.395383,1179.23723,196.280591,15,0
0,0,23,23,21,24,45,146,73,219,0.000333,0.400905,30,36081.47484,2004.52638,1202.715828,202.277766,15,0
0,0,25,25,21,26,47,167,79,246,0.000333,0.455476,30,40992.86573,2277.381429,1366.428858,214.450099,16,0
0,0,23,23,20,24,44,146,73,219,0.000333,0.398539,30,35868.46573,1992.692541,1195.615524,196.477662,15,0
0,0,21,21,20,27,47,158,79,237,0.000333,0.438813,20,26328.75116,1462.708398,1316.437558,214.820524,14,0
0,0,21,21,20,22,42,142,70,212,0.000333,0.381057,30,34295.13881,1905.285489,1143.171294,184.546058,15,0
0,0,24,24,20,26,46,158,83,241,0.000333,0.443726,30,39935.35294,2218.630719,1331.178431,208.649995,15,0
0,0,23,23,23,25,48,153,80,233,0.000333,0.433765,33,42942.77667,2385.709815,1301.296263,220.13833,16,0
0,0,23,23,23,25,48,153,80,233,0.000333,0.433765,33,42942.77667,2385.709815,1301.296263,220.13833,16,0
0,0,47,47,26,48,74,295,157,452,0.000333,0.935558,39,109460.2439,6081.124663,2806.672921,390.289633,32,0
0,0,39,39,20,37,57,230,120,350,0.000333,0.680504,30,61245.34515,3402.519175,2041.511505,279.188336,27,0
0,0,40,40,24,44,68,251,132,383,0.000333,0.777166,36,83933.93766,4662.996536,2331.498268,350.254091,28,0
0,0,26,26,21,25,46,166,86,252,0.000333,0.463979,30,41758.12839,2319.896022,1391.937613,208.335071,16,0
0,0,26,26,22,25,47,169,89,258,0.000333,0.477695,33,47291.76948,2627.320527,1433.083924,214.2039,18,0
0,0,24,24,24,26,50,180,90,270,0.000333,0.507947,36,54858.28217,3047.682342,1523.841171,232.250533,17,0
0,0,57,57,24,40,64,390,160,550,0.000333,1.1,48,158400,8800,3300,322.916224,57,0
0,0,56,56,25,41,66,409,172,581,0.000333,1.170598,48,168566.0632,9364.781289,3511.792983,335.756037,54,0
0,0,55,55,25,42,67,408,170,578,0.000333,1.168733,48,168297.5785,9349.865472,3506.199552,342.573737,53,0
0,0,55,55,26,40,66,408,168,576,0.000333,1.160524,52,181041.6927,10057.87182,3481.571013,335.088556,53,0
0,0,56,56,25,41,66,400,170,570,0.000333,1.148435,48,165374.6231,9187.479061,3445.304648,335.756037,54,0
0,0,55,55,25,42,67,408,170,578,0.000333,1.168733,48,168297.5785,9349.865472,3506.199552,342.573737,53,0
0,0,55,55,26,40,66,408,168,576,0.000333,1.160524,52,181041.6927,10057.87182,3481.571013,335.088556,53,0
0,0,79,79,29,62,91,573,261,834,0.000333,1.809167,56,303940.0409,16885.55783,5427.50073,510.04162,64,0
0,0,62,62,28,53,81,481,208,689,0.000333,1.456052,42,183462.5794,10192.36552,4368.156652,438.185722,57,0
0,0,79,79,29,62,91,573,261,834,0.000333,1.809167,56,303940.0409,16885.55783,5427.50073,510.04162,64,0
0,0,62,62,28,53,81,481,208,689,0.000333,1.456052,42,183462.5794,10192.36552,4368.156652,438.185722,57,0
0,0,59,59,25,44,69,425,185,610,0.000333,1.242067,48,178857.5961,9936.533116,3726.199919,356.311396,55,0
0,0,59,59,25,44,69,424,185,609,0.000333,1.24003,48,178564.3869,9920.243718,3720.091394,356.311396,55,0
0,0,21,21,20,30,50,138,93,231,0.000333,0.434577,30,39111.9234,2172.884633,1303.73078,233.64528,10,0
0,0,23,23,22,37,59,129,96,225,0.000333,0.441198,22,29119.08309,1617.726839,1323.594686,290.85727,12,0
0,0,23,23,22,37,59,129,96,225,0.000333,0.441198,22,29119.08309,1617.726839,1323.594686,290.85727,12,0
0,0,24,24,22,37,59,136,99,235,0.000333,0.460807,22,30413.26457,1689.625809,1382.421117,290.85727,13,0
0,0,31,31,17,35,52,136,109,245,0.000333,0.465536,24,33518.58554,1862.143641,1396.607731,249.011774,8,0
0,0,26,26,15,34,49,110,91,201,0.000333,0.376186,14,15799.7935,877.766306,1128.556679,231.577096,8,0
0,0,27,27,15,34,49,117,94,211,0.000333,0.394901,14,16585.85288,921.436271,1184.703777,231.577096,9,0
0,0,39,39,22,48,70,172,138,310,0.000333,0.633359,22,41801.71018,2322.317232,1900.077735,366.185696,11,0
0,0,26,26,20,39,59,131,103,234,0.000333,0.458846,20,27530.76947,1529.487193,1376.538474,292.569248,9,0
0,0,27,27,20,39,59,138,106,244,0.000333,0.478455,20,28707.29808,1594.849893,1435.364904,292.569248,10,0
0,0,12,12,14,20,34,63,39,102,0.000333,0.172974,7,3632.448469,201.802693,518.92121,139.741531,9,0
0,0,12,12,14,20,34,63,39,102,0.000333,0.172974,7,3632.448469,201.802693,518.92121,139.741531,9,0
0,0,19,19,17,28,45,90,57,147,0.000333,0.269101,16,12916.83848,717.602138,807.302405,204.092806,10,0
0,0,10,10,11,16,27,73,44,117,0.000333,0.185441,10,5563.218378,309.067688,556.321838,102.053748,4,0
0,0,10,10,10,16,26,67,41,108,0.000333,0.169216,10,5076.474896,282.026383,507.64749,97.219281,3,0
0,0,10,10,10,16,26,71,41,112,0.000333,0.175483,10,5264.492484,292.471805,526.449248,97.219281,3,0
0,0,10,10,10,16,26,67,41,108,0.000333,0.169216,10,5076.474896,282.026383,507.64749,97.219281,3,0
0,0,10,10,10,16,26,71,41,112,0.000333,0.175483,10,5264.492484,292.471805,526.449248,97.219281,3,0
0,0,10,10,10,16,26,67,41,108,0.000333,0.169216,10,5076.474896,282.026383,507.64749,97.219281,3,0
0,0,10,10,10,16,26,67,41,108,0.000333,0.169216,10,5076.474896,282.026383,507.64749,97.219281,3,0
0,0,10,10,10,16,26,67,41,108,0.000333,0.169216,10,5076.474896,282.026383,507.64749,97.219281,3,0
0,0,18,18,15,25,40,103,57,160,0.000333,0.283836,14,11921.11893,662.284385,851.508495,174.699764,7,0
0,0,18,18,15,25,40,104,57,161,0.000333,0.28561,14,11995.62593,666.423663,856.830423,174.699764,7,0
0,0,42,42,24,77,101,267,208,475,0.000333,1.054217,24,75903.6109,4216.867272,3162.650454,592.581664,27,0
0,0,84,84,31,71,102,535,402,937,0.000333,2.084021,75,468904.6909,26050.26061,6252.062545,590.212131,47,0
0,0,87,87,29,88,117,475,334,809,0.000333,1.852708,42,233441.2524,12968.95847,5558.125058,709.311431,52,0
0,0,91,91,31,79,110,567,429,996,0.000333,2.251411,75,506567.5706,28142.64281,6754.234275,651.578765,50,0
0,0,89,89,31,77,108,563,420,983,0.000333,2.213351,75,498004.0811,27666.89339,6640.054415,636.122649,46,0
0,0,45,45,26,35,61,230,122,352,0.000333,0.695873,39,81417.16217,4523.175676,2087.619543,301.736338,26,0
0,0,71,71,29,53,82,426,282,708,0.000333,1.500382,70,315080.2773,17504.45985,4501.146819,444.461233,30,0
0,0,78,78,29,59,88,472,312,784,0.000333,1.688065,70,354493.6072,19694.08929,5064.194389,487.957389,31,0
0,0,60,60,29,49,78,362,241,603,0.000333,1.263366,56,212245.4621,11791.41456,3790.097538,416.002231,26,0
0,0,67,67,29,55,84,408,271,679,0.000333,1.446795,56,243061.4777,13503.41543,4340.38353,458.856233,27,0
0,0,63,63,28,54,82,388,254,642,0.000333,1.360516,56,228566.7097,12698.15054,4081.548387,445.369863,27,0
0,0,63,63,28,53,81,392,256,648,0.000333,1.369408,56,230060.4769,12781.13761,4108.222802,438.185722,27,0
0,0,54,54,26,45,71,315,201,516,0.000333,1.057757,52,165010.0147,9167.223039,3173.269514,369.344822,25,0
0,0,82,82,31,58,89,478,330,808,0.000333,1.744131,75,392429.4459,21801.63588,5232.392612,493.342983,33,0
0,0,89,89,33,61,94,530,375,905,0.000333,1.977301,96,569462.6794,31636.81552,5931.902911,528.239984,35,0
0,0,96,96,33,67,100,576,405,981,0.000333,2.172541,96,625691.8005,34760.65559,6517.622922,572.892982,36,0
0,0,27,27,27,49,76,278,141,419,0.000333,0.872627,26,68064.92233,3781.384574,2617.881628,403.502745,8,0
0,0,19,19,23,44,67,199,104,303,0.000333,0.612675,22,40436.55054,2246.47503,1838.025025,344.256916,6,0
0,0,16,16,13,27,40,63,57,120,0.000333,0.212877,12,7663.576457,425.754248,638.631371,176.487679,6,0
0,0,24,24,19,34,53,142,94,236,0.000333,0.450596,18,24332.20609,1351.789227,1351.789227,253.684359,8,0
0,0,36,36,16,42,58,267,167,434,0.000333,0.847455,24,61016.73005,3389.818336,2542.363752,290.477332,4,0
0,0,35,35,16,42,58,263,165,428,0.000333,0.835739,24,60173.18078,3342.954488,2507.215866,290.477332,3,0
0,0,34,34,16,42,58,259,163,422,0.000333,0.824023,24,59329.63152,3296.09064,2472.06798,290.477332,2,0
0,0,17,17,14,34,48,126,80,206,0.000333,0.383501,14,16107.03185,894.835103,1150.502275,226.276706,1,0
0,0,28,28,27,55,82,268,148,416,0.000333,0.881581,26,68763.28248,3820.18236,2644.741634,446.356747,8,0
0,0,25,25,27,54,81,249,138,387,0.000333,0.817841,26,63791.57073,3543.976152,2453.521951,439.145888,8,0
0,0,22,22,27,54,81,241,131,372,0.000333,0.786141,26,61319.02923,3406.612735,2358.424201,439.145888,8,0
0,0,41,41,32,79,111,436,246,682,0.000333,1.544597,48,222421.9978,12356.77766,4633.791621,657.998679,19,0
0,0,42,42,16,51,67,269,209,478,0.000333,0.96653,32,92786.90026,5154.827792,2899.590633,353.293692,9,0
0,0,35,35,18,44,62,256,190,446,0.000333,0.885191,36,95600.57596,5311.143109,2655.571554,315.273641,6,0
0,0,36,36,19,44,63,261,194,455,0.000333,0.906554,36,97907.84515,5439.32473,2719.662365,320.925614,7,0
0,0,14,14,17,17,34,87,68,155,0.000333,0.262852,32,25233.81569,1401.87865,788.55674,138.973737,5,0
0,0,21,21,20,24,44,124,94,218,0.000333,0.396719,30,35704.68279,1983.593488,1190.156093,196.477662,8,0
0,0,19,19,23,24,47,118,89,207,0.000333,0.383267,33,37943.39645,2107.966469,1149.799892,214.081025,7,0
0,0,20,20,26,27,53,128,92,220,0.000333,0.420048,39,49145.5575,2730.30875,1260.1425,250.593395,8,0
0,0,10,10,12,15,27,57,45,102,0.000333,0.161666,18,8729.973454,484.998525,484.998525,101.622909,3,0
0,0,25,25,25,30,55,167,132,299,0.000333,0.576209,48,82974.07461,4609.670812,1728.626554,263.303123,24,0
0,0,12,12,14,17,31,76,57,133,0.000333,0.219636,21,13837.0703,768.726127,658.908109,122.789837,4,0
0,0,13,13,14,17,31,76,55,131,0.000333,0.216333,21,13628.99405,757.166336,648.999717,122.789837,5,0
0,0,12,12,13,18,31,75,57,132,0.000333,0.217985,18,11771.17043,653.953913,653.953913,123.164366,4,0
0,0,12,12,14,19,33,74,56,130,0.000333,0.21859,14,9180.797297,510.044294,655.771236,134.013592,4,0
0,0,19,19,19,25,44,101,78,179,0.000333,0.325746,27,26385.43301,1465.85739,977.23826,196.807027,6,0
0,0,16,16,15,22,37,92,70,162,0.000333,0.28131,21,17722.56035,984.586686,843.931445,156.710855,6,0
0,0,14,14,17,21,38,86,65,151,0.000333,0.264146,24,19018.48931,1056.582739,792.437055,161.725534,5,0
0,0,15,15,20,25,45,96,68,164,0.000333,0.300221,20,18013.27816,1000.737675,900.663908,202.534967,6,0
0,0,13,13,13,14,27,67,51,118,0.000333,0.187026,18,10099.38106,561.076725,561.076725,101.408685,4,0
0,0,31,31,23,42,65,166,132,298,0.000333,0.598222,33,59223.96507,3290.220282,1794.665608,330.519257,9,0
0,0,14,14,14,21,35,84,69,153,0.000333,0.261593,21,16480.38633,915.577019,784.780302,145.541635,4,0
0,0,30,30,22,37,59,154,118,272,0.000333,0.53336,33,52802.60401,2933.478001,1600.078909,290.85727,9,0
0,0,30,30,23,39,62,159,123,282,0.000333,0.559694,33,55409.75086,3078.319492,1679.08336,310.172612,9,0
0,0,14,14,14,23,37,85,67,152,0.000333,0.263946,14,11085.71676,615.873153,791.836912,157.344894,4,0
0,0,14,14,14,18,32,91,69,160,0.000333,0.266667,21,16800,933.333333,800,128.361619,4,0
0,0,14,14,14,22,36,89,69,158,0.000333,0.272283,21,17153.81116,952.989509,816.84815,151.410465,4,0
0,0,14,14,15,23,38,89,70,159,0.000333,0.27814,21,17522.82997,973.490554,834.420475,162.645284,4,0
0,0,14,14,14,20,34,90,69,159,0.000333,0.269636,21,16987.03843,943.724357,808.906592,139.741531,4,0
0,0,14,14,14,23,37,93,71,164,0.000333,0.284783,21,17941.35739,996.742077,854.350352,157.344894,4,0
0,0,14,14,15,24,39,93,72,165,0.000333,0.290697,21,18313.91869,1017.439927,872.091366,168.642459,4,0
0,0,14,14,14,22,36,90,70,160,0.000333,0.275729,21,17370.94801,965.052667,827.188,151.410465,4,0
0,0,14,14,14,23,37,90,71,161,0.000333,0.279574,21,17613.16183,978.508991,838.721992,157.344894,4,0
0,0,14,14,14,22,36,90,70,160,0.000333,0.275729,21,17370.94801,965.052667,827.188,151.410465,4,0
0,0,14,14,14,23,37,90,71,161,0.000333,0.279574,21,17613.16183,978.508991,838.721992,157.344894,4,0
0,0,14,14,14,23,37,93,71,164,0.000333,0.284783,21,17941.35739,996.742077,854.350352,157.344894,4,0
0,0,14,14,15,24,39,93,72,165,0.000333,0.290697,21,18313.91869,1017.439927,872.091366,168.642459,4,0
0,0,14,14,14,22,36,89,69,158,0.000333,0.272283,21,17153.81116,952.989509,816.84815,151.410465,4,0
0,0,14,14,15,23,38,89,70,159,0.000333,0.27814,21,17522.82997,973.490554,834.420475,162.645284,4,0
0,0,14,14,14,23,37,93,71,164,0.000333,0.284783,21,17941.35739,996.742077,854.350352,157.344894,4,0
0,0,14,14,15,24,39,93,72,165,0.000333,0.290697,21,18313.91869,1017.439927,872.091366,168.642459,4,0
0,0,14,14,14,23,37,93,71,164,0.000333,0.284783,21,17941.35739,996.742077,854.350352,157.344894,4,0
0,0,14,14,15,24,39,93,72,165,0.000333,0.290697,21,18313.91869,1017.439927,872.091366,168.642459,4,0
0,0,31,31,23,43,66,167,132,299,0.000333,0.602425,33,59640.03678,3313.335376,1807.273842,337.371309,9,0
0,0,14,14,15,20,35,85,69,154,0.000333,0.263303,21,16588.10128,921.561182,789.909585,145.041921,4,0
0,0,30,30,22,38,60,155,118,273,0.000333,0.537527,33,53215.17738,2956.398743,1612.581133,297.528741,9,0
0,0,30,30,23,40,63,160,123,283,0.000333,0.563857,33,55821.81721,3101.212067,1691.570218,316.919049,9,0
0,0,14,14,15,22,37,86,67,153,0.000333,0.265682,21,16737.97366,929.887426,797.046365,156.710855,4,0
0,0,19,19,23,26,49,128,107,235,0.000333,0.439819,44,58056.09979,3225.338877,1319.456813,226.253358,22,0
0,0,16,16,22,21,43,88,79,167,0.000333,0.302062,33,29904.14506,1661.341392,906.186214,190.346161,11,0
0,0,17,17,22,25,47,119,98,217,0.000333,0.401782,33,39776.41077,2209.800598,1205.345781,214.2039,20,0
0,0,24,24,24,28,52,160,125,285,0.000333,0.541542,48,77982.01534,4332.334186,1624.62532,244.645038,22,0
0,0,20,20,22,27,49,147,113,260,0.000333,0.486608,44,64232.28062,3568.460034,1459.824559,226.489458,19,0
0,0,49,49,23,35,58,259,199,458,0.000333,0.894318,55,147562.5413,8197.918959,2682.955296,283.566831,23,0
0,0,33,33,20,33,53,188,148,336,0.000333,0.641527,40,76983.25091,4276.847273,1924.581273,252.903568,17,0
0,0,34,34,24,34,58,206,156,362,0.000333,0.706863,48,101788.2778,5654.904321,2120.58912,283.012837,17,0
0,0,32,32,22,33,55,176,138,314,0.000333,0.605116,44,79875.2658,4437.514767,1815.34695,264.572502,15,0
0,0,32,32,22,33,55,179,141,320,0.000333,0.616678,44,81401.54477,4522.308043,1850.035108,264.572502,14,0
0,0,32,32,22,34,56,182,142,324,0.000333,0.627194,44,82789.65177,4599.425098,1881.582995,271.081232,16,0
0,0,32,32,22,33,55,179,141,320,0.000333,0.616678,44,81401.54477,4522.308043,1850.035108,264.572502,14,0
0,0,37,37,24,34,58,223,164,387,0.000333,0.75568,48,108817.855,6045.436387,2267.038645,283.012837,19,0
0,0,44,44,20,34,54,231,175,406,0.000333,0.778828,50,116824.2163,6490.234239,2336.484326,259.412299,23,0
0,0,61,61,23,37,60,298,227,525,0.000333,1.033706,66,204673.7591,11370.7644,3101.117563,296.7917,29,0
0,0,44,44,27,42,69,280,221,501,0.000333,1.020124,65,198924.0989,11051.33883,3060.370753,354.859294,35,0
0,0,34,34,20,32,52,182,148,330,0.000333,0.627048,40,75245.80428,4180.32246,1881.145107,246.438562,14,0
0,0,35,35,22,33,55,187,152,339,0.000333,0.653294,44,86234.76149,4790.820083,1959.880943,264.572502,14,0
0,0,34,34,20,32,52,182,148,330,0.000333,0.627048,40,75245.80428,4180.32246,1881.145107,246.438562,14,0
0,0,43,43,23,50,73,243,198,441,0.000333,0.909904,33,90080.51681,5004.473156,2729.71263,386.234734,20,0
0,0,35,35,22,33,55,189,152,341,0.000333,0.657148,44,86743.52114,4819.084508,1971.443662,264.572502,14,0
0,0,36,36,22,34,56,194,156,350,0.000333,0.677525,44,89433.2658,4968.514767,2032.574223,271.081232,14,0
0,0,35,35,22,33,55,189,152,341,0.000333,0.657148,44,86743.52114,4819.084508,1971.443662,264.572502,14,0
0,0,44,44,24,51,75,250,202,452,0.000333,0.938475,36,101355.3377,5630.852096,2815.426048,399.332792,20,0
0,0,35,35,22,34,56,190,153,343,0.000333,0.663974,44,87644.60048,4869.144471,1991.922738,271.081232,14,0
0,0,36,36,22,34,56,194,156,350,0.000333,0.677525,44,89433.2658,4968.514767,2032.574223,271.081232,14,0
0,0,35,35,22,33,55,190,153,343,0.000333,0.661002,44,87252.2808,4847.348933,1983.006382,264.572502,14,0
0,0,44,44,24,51,75,250,202,452,0.000333,0.938475,36,101355.3377,5630.852096,2815.426048,399.332792,20,0
0,0,34,34,21,34,55,184,150,334,0.000333,0.643658,40,77238.96577,4291.053654,1930.974144,265.212402,14,0
0,0,35,35,22,34,56,188,153,341,0.000333,0.660103,44,87133.55325,4840.752958,1980.308028,271.081232,14,0
0,0,34,34,21,33,54,184,150,334,0.000333,0.640711,40,76885.29703,4271.40539,1922.132426,258.703672,14,0
0,0,43,43,23,51,74,244,199,443,0.000333,0.916929,33,90775.99875,5043.111042,2750.787841,393.335617,20,0
0,0,61,61,24,41,65,306,238,544,0.000333,1.092056,60,196570.0854,10920.5603,3276.16809,329.698732,25,0
0,0,31,31,20,33,53,172,135,307,0.000333,0.586157,40,70338.86318,3907.714621,1758.47158,252.903568,17,0
0,0,32,32,24,34,58,190,143,333,0.000333,0.650236,48,93633.96823,5201.887124,1950.707671,283.012837,17,0
0,0,30,30,22,33,55,160,125,285,0.000333,0.549229,33,54373.68811,3020.76045,1647.687518,264.572502,15,0
0,0,30,30,22,33,55,163,128,291,0.000333,0.560792,33,55518.39733,3084.355407,1682.375677,264.572502,14,0
0,0,30,30,22,34,56,166,129,295,0.000333,0.571057,33,56534.60017,3140.81112,1713.169702,271.081232,16,0
0,0,30,30,22,33,55,163,128,291,0.000333,0.560792,33,55518.39733,3084.355407,1682.375677,264.572502,14,0
0,0,35,35,24,34,58,207,151,358,0.000333,0.699052,48,100663.5454,5592.41919,2097.157196,283.012837,19,0
0,0,42,42,20,34,54,215,162,377,0.000333,0.723198,40,86783.70353,4821.316863,2169.592588,259.412299,23,0
0,0,59,59,23,37,60,282,214,496,0.000333,0.976606,55,161139.9754,8952.220858,2929.817735,296.7917,29,0
0,0,42,42,27,42,69,264,208,472,0.000333,0.961075,52,149927.6243,8329.312459,2883.223544,354.859294,35,0
0,0,32,32,20,32,52,166,135,301,0.000333,0.571944,40,68633.29421,3812.960789,1715.832355,246.438562,14,0
0,0,33,33,22,33,55,171,139,310,0.000333,0.597407,44,78857.74649,4380.985916,1792.221511,264.572502,14,0
0,0,32,32,20,32,52,166,135,301,0.000333,0.571944,40,68633.29421,3812.960789,1715.832355,246.438562,14,0
0,0,41,41,23,50,73,227,185,412,0.000333,0.850069,33,84156.8547,4675.380817,2550.207718,386.234734,20,0
0,0,33,33,22,33,55,173,139,312,0.000333,0.601261,44,79366.50615,4409.250342,1803.784231,264.572502,14,0
0,0,34,34,22,34,56,178,143,321,0.000333,0.621387,44,82023.08092,4556.837829,1864.16093,271.081232,14,0
0,0,33,33,22,33,55,173,139,312,0.000333,0.601261,44,79366.50615,4409.250342,1803.784231,264.572502,14,0
0,0,42,42,24,51,75,234,189,423,0.000333,0.878263,36,94852.45102,5269.580612,2634.790306,399.332792,20,0
0,0,33,33,22,34,56,174,140,314,0.000333,0.607836,44,80234.4156,4457.467534,1823.509446,271.081232,14,0
0,0,34,34,22,34,56,178,143,321,0.000333,0.621387,44,82023.08092,4556.837829,1864.16093,271.081232,14,0
0,0,33,33,22,33,55,174,140,314,0.000333,0.605116,44,79875.2658,4437.514767,1815.34695,264.572502,14,0
0,0,42,42,24,51,75,234,189,423,0.000333,0.878263,36,94852.45102,5269.580612,2634.790306,399.332792,20,0
0,0,32,32,21,34,55,168,137,305,0.000333,0.587772,40,70532.58851,3918.477139,1763.314713,265.212402,14,0
0,0,33,33,22,34,56,172,140,312,0.000333,0.603965,44,79723.36837,4429.076021,1811.894736,271.081232,14,0
0,0,32,32,21,33,54,168,137,305,0.000333,0.58508,40,70209.62753,3900.534863,1755.240688,258.703672,14,0
0,0,41,41,23,51,74,228,186,414,0.000333,0.856905,33,84833.55188,4712.975105,2570.713693,393.335617,20,0
0,0,4,4,9,11,20,35,23,58,0.000333,0.083557,8,2005.374636,111.409702,250.67183,66.583073,1,0
0,0,23,23,17,22,39,104,81,185,0.000333,0.325933,24,23467.18585,1303.732547,977.79941,167.594364,11,0
0,0,75,75,25,44,69,366,279,645,0.000333,1.313333,72,283679.8758,15759.9931,3939.998275,356.311396,31,0
0,0,61,61,22,42,64,310,236,546,0.000333,1.092,55,180180,10010,3276,324.584827,25,0
0,0,59,59,22,42,64,297,225,522,0.000333,1.044,55,172260,9570,3132,324.584827,25,0
0,0,27,27,19,29,48,155,125,280,0.000333,0.521263,36,56296.42201,3127.579,1563.7895,221.592072,13,0
0,0,48,48,24,40,64,250,198,448,0.000333,0.896,48,129024,7168,2688,322.916224,22,0
0,0,29,29,19,30,49,160,127,287,0.000333,0.537141,36,58011.18211,3222.843451,1611.421725,227.917341,14,0
0,0,32,32,19,35,54,179,147,326,0.000333,0.625364,36,67539.35973,3752.186651,1876.093326,260.235528,16,0
0,0,41,41,26,42,68,261,208,469,0.000333,0.951673,52,148461.0438,8247.835765,2855.020073,348.688764,34,0
0,0,26,26,16,36,52,197,152,349,0.000333,0.663151,32,63662.51077,3536.806154,1989.453462,250.1173,6,0
0,0,23,23,17,37,54,209,155,364,0.000333,0.69826,32,67032.92963,3724.051646,2094.779051,262.236643,5,0
0,0,24,24,15,28,43,115,92,207,0.000333,0.374412,21,23587.97289,1310.442938,1123.236804,193.209297,6,0
0,0,22,22,15,27,42,110,86,196,0.000333,0.352298,21,22194.77851,1233.043251,1056.894215,186.985321,6,0
0,0,21,21,15,27,42,109,84,193,0.000333,0.346906,21,21855.06252,1214.17014,1040.717263,186.985321,6,0
0,0,19,19,15,25,40,107,79,186,0.000333,0.32996,21,20787.45114,1154.858397,989.878626,174.699764,6,0
0,0,22,22,20,31,51,125,94,219,0.000333,0.414087,30,37267.8345,2070.43525,1242.26115,240.018648,8,0
0,0,24,24,21,31,52,135,100,235,0.000333,0.446534,30,40188.10001,2232.672223,1339.603334,245.818752,9,0
0,0,21,21,21,26,47,140,107,247,0.000333,0.457328,40,54879.33786,3048.852103,1371.983446,214.450099,8,0
0,0,28,28,21,33,54,177,133,310,0.000333,0.594672,40,71360.60503,3964.478057,1784.015126,258.703672,11,0
0,0,13,13,22,21,43,75,59,134,0.000333,0.242373,22,15996.6285,888.701583,727.119477,190.346161,5,0
0,0,14,14,26,24,50,85,62,147,0.000333,0.276549,26,21570.81836,1198.378798,829.64686,232.250533,6,0
0,0,35,35,22,29,51,176,136,312,0.000333,0.589932,44,77871.0551,4326.169727,1769.796707,238.988944,14,0
0,0,19,19,18,26,44,105,85,190,0.000333,0.345764,27,28006.8842,1555.938011,1037.292008,197.270083,8,0
0,0,20,20,24,28,52,123,93,216,0.000333,0.410432,36,44326.61925,2462.589958,1231.294979,244.645038,8,0
0,0,18,18,21,26,47,93,75,168,0.000333,0.311057,20,18663.41854,1036.856586,933.170927,214.450099,6,0
0,0,18,18,21,26,47,96,78,174,0.000333,0.322166,30,28994.95381,1610.830767,966.49846,214.450099,5,0
0,0,18,18,21,27,48,99,79,178,0.000333,0.331374,20,19882.4665,1104.581472,994.123325,220.620628,7,0
0,0,18,18,21,26,47,96,78,174,0.000333,0.322166,30,28994.95381,1610.830767,966.49846,214.450099,5,0
0,0,23,23,24,28,52,140,101,241,0.000333,0.457935,36,49457.015,2747.611944,1373.805972,244.645038,10,0
0,0,30,30,19,28,47,148,112,260,0.000333,0.481398,36,51990.95165,2888.386203,1444.193101,215.316561,14,0
0,0,47,47,22,33,55,215,164,379,0.000333,0.730378,44,96409.95458,5356.108588,2191.135331,264.572502,20,0
0,0,30,30,26,37,63,197,158,355,0.000333,0.707311,52,110340.5874,6130.032633,2121.934373,314.961207,26,0
0,0,20,20,19,25,44,99,85,184,0.000333,0.334845,27,27122.45628,1506.803127,1004.535418,196.807027,5,0
0,0,21,21,21,26,47,104,89,193,0.000333,0.357345,30,32161.06945,1786.726081,1072.035648,214.450099,5,0
0,0,20,20,19,25,44,99,85,184,0.000333,0.334845,27,27122.45628,1506.803127,1004.535418,196.807027,5,0
0,0,29,29,23,44,67,160,135,295,0.000333,0.596499,33,59053.37827,3280.743237,1789.496311,344.256916,11,0
0,0,21,21,21,26,47,106,89,195,0.000333,0.361048,30,32494.34478,1805.241377,1083.144826,214.450099,5,0
0,0,22,22,21,27,48,111,93,204,0.000333,0.379777,30,34179.9705,1898.88725,1139.33235,220.620628,5,0
0,0,21,21,21,26,47,106,89,195,0.000333,0.361048,30,32494.34478,1805.241377,1083.144826,214.450099,5,0
0,0,30,30,24,45,69,167,139,306,0.000333,0.623069,36,67291.50542,3738.416968,1869.208484,357.172489,11,0
0,0,21,21,21,27,48,107,90,197,0.000333,0.366746,30,33007.12838,1833.729354,1100.237613,220.620628,5,0
0,0,22,22,21,27,48,111,93,204,0.000333,0.379777,30,34179.9705,1898.88725,1139.33235,220.620628,5,0
0,0,21,21,21,26,47,107,90,197,0.000333,0.364751,30,32827.62011,1823.756673,1094.254004,214.450099,5,0
0,0,30,30,24,45,69,167,139,306,0.000333,0.623069,36,67291.50542,3738.416968,1869.208484,357.172489,11,0
0,0,20,20,20,27,47,101,87,188,0.000333,0.348088,30,31327.88112,1740.43784,1044.262704,214.820524,5,0
0,0,21,21,21,27,48,105,90,195,0.000333,0.363023,30,32672.03063,1815.112813,1089.067688,220.620628,5,0
0,0,20,20,20,26,46,101,87,188,0.000333,0.346143,30,31152.88943,1730.71608,1038.429648,208.649995,5,0
0,0,29,29,23,45,68,161,136,297,0.000333,0.602659,33,59663.22331,3314.623517,1807.976464,351.175314,11,0
0,0,36,36,22,29,51,182,141,323,0.000333,0.610731,44,80616.50896,4478.694942,1832.193385,238.988944,16,0
0,0,20,20,18,27,45,111,90,201,0.000333,0.367954,27,29804.28675,1655.793709,1103.862472,203.440613,10,0
0,0,21,21,24,29,53,129,98,227,0.000333,0.433413,36,46808.56596,2600.475886,1300.237943,250.920549,10,0
0,0,19,19,21,27,48,99,80,179,0.000333,0.333236,20,19994.16575,1110.786986,999.708288,220.620628,8,0
0,0,19,19,21,27,48,102,83,185,0.000333,0.344406,30,30996.54188,1722.030104,1033.218063,220.620628,7,0
0,0,19,19,21,28,49,105,84,189,0.000333,0.353727,30,31835.40482,1768.633601,1061.180161,226.844604,9,0
0,0,19,19,21,27,48,102,83,185,0.000333,0.344406,30,30996.54188,1722.030104,1033.218063,220.620628,7,0
0,0,24,24,24,29,53,146,106,252,0.000333,0.481145,36,51963.69436,2886.871909,1443.435955,250.920549,12,0
0,0,31,31,19,29,48,154,117,271,0.000333,0.504508,36,54486.89416,3027.049675,1513.524838,221.592072,16,0
0,0,48,48,22,33,55,221,169,390,0.000333,0.751577,55,124010.1659,6889.453659,2254.730288,264.572502,22,0
0,0,31,31,26,38,64,203,163,366,0.000333,0.732,52,114192,6344,2196,321.632678,28,0
0,0,21,21,19,26,45,105,90,195,0.000333,0.35697,27,28914.60655,1606.367031,1070.911354,202.922055,7,0
0,0,22,22,21,27,48,110,94,204,0.000333,0.379777,30,34179.9705,1898.88725,1139.33235,220.620628,7,0
0,0,21,21,19,26,45,105,90,195,0.000333,0.35697,27,28914.60655,1606.367031,1070.911354,202.922055,7,0
0,0,30,30,23,45,68,166,140,306,0.000333,0.620921,33,61471.19977,3415.066654,1862.763629,351.175314,13,0
0,0,22,22,21,27,48,112,94,206,0.000333,0.383501,30,34515.06825,1917.503792,1150.502275,220.620628,7,0
0,0,23,23,21,28,49,117,98,215,0.000333,0.402388,30,36214.8785,2011.937694,1207.162616,226.844604,7,0
0,0,22,22,21,27,48,112,94,206,0.000333,0.383501,30,34515.06825,1917.503792,1150.502275,220.620628,7,0
0,0,31,31,24,46,70,173,144,317,0.000333,0.647661,36,69947.37779,3885.965433,1942.982716,364.12295,13,0
0,0,22,22,21,28,49,113,95,208,0.000333,0.389287,30,35035.78943,1946.432746,1167.859648,226.844604,7,0
0,0,23,23,21,28,49,117,98,215,0.000333,0.402388,30,36214.8785,2011.937694,1207.162616,226.844604,7,0
0,0,22,22,21,27,48,113,95,208,0.000333,0.387224,30,34850.16601,1936.120334,1161.6722,220.620628,7,0
0,0,31,31,24,46,70,173,144,317,0.000333,0.647661,36,69947.37779,3885.965433,1942.982716,364.12295,13,0
0,0,21,21,20,28,48,107,92,199,0.000333,0.370469,30,33342.22613,1852.345896,1111.407538,221.0445,7,0
0,0,22,22,21,28,49,111,95,206,0.000333,0.385543,30,34698.90684,1927.717046,1156.630228,226.844604,7,0
0,0,21,21,20,27,47,107,92,199,0.000333,0.368454,30,33160.89545,1842.271969,1105.363181,214.820524,7,0
0,0,30,30,23,46,69,167,141,308,0.000333,0.627142,33,62087.04258,3449.280143,1881.425533,358.125775,13,0
0,0,25,25,23,47,70,170,118,288,0.000333,0.588411,22,38835.1372,2157.507622,1765.233509,365.107601,12,0
0,0,30,30,20,40,60,257,140,397,0.000333,0.781679,30,70351.06699,3908.392611,2345.035566,299.315686,11,0
0,0,30,30,20,42,62,254,142,396,0.000333,0.785954,30,70735.85217,3929.769565,2357.861739,312.915894,11,0
0,0,30,30,20,41,61,254,140,394,0.000333,0.778904,30,70101.31533,3894.517518,2336.710511,306.098194,11,0
0,0,36,36,24,49,73,292,168,460,0.000333,0.949106,36,102503.4947,5694.638594,2847.319297,385.159882,13,0
0,0,34,34,20,45,65,281,159,440,0.000333,0.883281,30,79495.25513,4416.403063,2649.841838,333.571951,12,0
0,0,34,34,20,48,68,283,163,446,0.000333,0.905003,30,81450.25282,4525.014045,2715.008427,354.516762,12,0
0,0,33,33,20,45,65,278,157,435,0.000333,0.873243,30,78591.89996,4366.216664,2619.729999,333.571951,11,0
0,0,33,33,20,48,68,280,161,441,0.000333,0.894857,30,80537.13339,4474.285188,2684.571113,354.516762,11,0
0,0,42,42,26,58,84,337,200,537,0.000333,1.144225,39,133874.3038,7437.461321,3432.674456,461.97433,13,0
0,0,33,33,23,44,67,293,169,462,0.000333,0.934178,33,92483.5958,5137.977544,2802.533206,344.256916,12,0
0,0,34,34,23,43,66,289,165,454,0.000333,0.914718,33,90557.1127,5030.950705,2744.15493,337.371309,13,0
0,0,33,33,23,42,65,293,167,460,0.000333,0.92343,33,91419.5434,5078.863522,2770.289194,330.519257,12,0
0,0,33,33,23,43,66,286,163,449,0.000333,0.904644,33,89559.78767,4975.543759,2713.93296,337.371309,12,0
0,0,33,33,23,44,67,290,169,459,0.000333,0.928112,33,91883.05297,5104.614054,2784.334938,344.256916,12,0
0,0,33,33,23,43,66,290,167,457,0.000333,0.920763,33,91155.50771,5064.194873,2762.288113,337.371309,12,0
0,0,51,51,23,40,63,436,233,669,0.000333,1.332933,55,219934.0148,12218.55638,3998.800269,316.919049,20,0
0,0,47,47,23,35,58,419,226,645,0.000333,1.259466,66,249374.251,13854.12505,3778.397742,283.566831,19,0
0,0,18,18,15,25,40,103,57,160,0.000333,0.283836,14,11921.11893,662.284385,851.508495,174.699764,7,0
0,0,18,18,15,25,40,104,57,161,0.000333,0.28561,14,11995.62593,666.423663,856.830423,174.699764,7,0
0,0,51,51,26,53,79,318,177,495,0.000333,1.040124,39,121694.4873,6760.804852,3120.37147,425.791217,19,0
0,0,24,24,21,21,42,164,87,251,0.000333,0.451157,40,54138.86693,3007.714829,1353.471673,184.477332,12,0
0,0,60,60,30,44,74,357,208,565,0.000333,1.169447,60,210500.4691,11694.47051,3508.341152,387.421709,42,0
0,0,30,30,27,45,72,191,122,313,0.000333,0.643729,26,50210.84966,2789.491648,1931.186525,375.515352,28,0
0,0,18,18,20,26,46,113,92,205,0.000333,0.377443,30,33969.90603,1887.217002,1132.330201,208.649995,8,0
0,0,10,10,15,14,29,47,38,85,0.000333,0.137643,14,5780.997384,321.166521,412.928385,111.906328,3,0
0,0,34,34,20,43,63,165,114,279,0.000333,0.555887,20,33353.22197,1852.956776,1667.661099,319.767946,10,0
0,0,79,79,28,83,111,507,409,916,0.000333,2.074562,56,348526.3563,19362.57535,6223.684934,663.734211,57,0
0,0,85,85,28,83,111,536,431,967,0.000333,2.190067,70,459914.01,25550.77833,6570.200143,663.734211,63,0
0,0,79,79,27,80,107,500,408,908,0.000333,2.040417,65,397881.3815,22104.5212,6121.252024,634.13621,59,0
0,0,64,64,34,67,101,372,291,663,0.000333,1.471465,68,300178.8065,16676.60036,4414.394213,579.401712,35,0
0,0,58,58,31,50,81,285,233,518,0.000333,1.094681,60,197042.5381,10946.80767,3284.042301,435.772895,33,0
0,0,45,45,29,41,70,224,187,411,0.000333,0.839712,56,141071.5779,7837.309884,2519.13532,360.541081,27,0
0,0,53,53,29,46,75,290,236,526,0.000333,1.09212,70,229345.1042,12741.39468,3276.358631,394.965299,36,0
0,0,44,44,28,41,69,224,187,411,0.000333,0.836868,56,140593.7989,7810.766605,2510.603552,354.26557,28,0
0,0,54,54,28,54,82,328,269,597,0.000333,1.265153,56,212545.6786,11808.09326,3795.458547,445.369863,37,0
0,0,63,63,28,58,86,399,323,722,0.000333,1.546588,70,324783.4207,18043.52337,4639.763153,474.368836,44,0
0,0,14,14,21,36,57,110,86,196,0.000333,0.381082,20,22864.92886,1270.273825,1143.246443,278.355966,12,0
0,0,19,19,21,37,58,139,105,244,0.000333,0.476449,20,28586.94726,1588.163736,1429.347363,284.98844,15,0
0,0,14,14,21,36,57,107,83,190,0.000333,0.369416,20,22164.98205,1231.387892,1108.249103,278.355966,12,0
0,0,19,19,21,37,58,136,102,238,0.000333,0.464733,20,27883.98954,1549.11053,1394.199477,284.98844,15,0
0,0,13,13,22,35,57,121,92,213,0.000333,0.414135,22,27332.92261,1518.4957,1242.405573,277.632401,9,0
0,0,18,18,22,37,59,150,111,261,0.000333,0.51179,33,50667.20458,2814.844699,1535.369836,290.85727,12,0
0,0,7,7,13,25,38,55,57,112,0.000333,0.195923,12,7053.214578,391.845254,587.767882,164.202121,3,0
0,0,30,30,22,58,80,225,159,384,0.000333,0.809207,22,53407.64855,2967.091586,2427.620388,437.870393,14,0
0,0,26,26,21,18,39,150,64,214,0.000333,0.377025,30,33932.28225,1885.126791,1131.076075,167.297316,21,0
0,0,22,22,20,17,37,134,53,187,0.000333,0.324723,30,29225.03338,1623.612966,974.167779,155.92543,15,0
0,0,30,30,20,21,41,143,75,218,0.000333,0.389315,30,35038.39011,1946.577228,1167.946337,178.677228,14,0
0,0,13,13,18,24,42,81,68,149,0.000333,0.267818,18,14462.19533,803.455296,803.455296,185.09775,6,0
0,0,42,42,29,57,86,275,192,467,0.000333,1.000355,42,126044.7569,7002.486494,3001.06564,473.35618,23,0
0,0,74,74,33,80,113,445,312,757,0.000333,1.720958,48,247818.0228,13767.66793,5162.875475,672.219254,41,0
0,0,18,18,15,25,40,103,57,160,0.000333,0.283836,14,11921.11893,662.284385,851.508495,174.699764,7,0
0,0,18,18,15,25,40,104,57,161,0.000333,0.28561,14,11995.62593,666.423663,856.830423,174.699764,7,0
0,0,17,17,21,21,42,98,61,159,0.000333,0.285793,20,17147.5694,952.642745,857.37847,184.477332,5,0
0,0,18,18,13,30,43,99,79,178,0.000333,0.321958,12,11590.50152,643.916751,965.875126,195.312434,5,0
0,0,42,42,20,52,72,329,183,512,0.000333,1.053001,30,94770.04802,5265.002668,3159.001601,382.861427,24,0
0,0,77,77,29,53,82,503,314,817,0.000333,1.731373,70,363588.3991,20199.35551,5194.119988,444.461233,30,0
0,0,55,55,28,49,77,354,228,582,0.000333,1.215757,56,204247.1069,11347.0615,3647.269767,409.72672,20,0
0,0,41,41,22,40,62,274,172,446,0.000333,0.885191,44,116845.1484,6491.397133,2655.571554,310.984619,16,0
0,0,62,62,24,46,70,402,246,648,0.000333,1.323925,60,238306.5237,13239.25132,3971.775395,364.12295,26,0
0,0,6,6,15,15,30,45,34,79,0.000333,0.129215,14,5427.020999,301.501167,387.644357,117.206718,1,0
0,0,5,5,14,11,25,26,24,50,0.000333,0.077398,14,3250.699333,180.594407,232.192809,91.356717,1,0
0,0,6,6,15,15,30,45,34,79,0.000333,0.129215,14,5427.020999,301.501167,387.644357,117.206718,1,0
0,0,5,5,14,11,25,26,24,50,0.000333,0.077398,14,3250.699333,180.594407,232.192809,91.356717,1,0
0,0,12,12,14,20,34,63,39,102,0.000333,0.172974,7,3632.448469,201.802693,518.92121,139.741531,9,0
0,0,26,26,17,33,50,133,81,214,0.000333,0.402595,16,19324.56359,1073.586866,1207.785225,235.951874,12,0
0,0,75,75,29,54,83,441,293,734,0.000333,1.55976,70,327549.526,18197.19589,4679.278943,451.645374,30,0
0,0,82,82,29,60,89,487,323,810,0.000333,1.748448,70,367174.0855,20398.56031,5245.344079,495.294885,31,0
0,0,64,64,29,50,79,377,252,629,0.000333,1.321693,70,277555.4663,15419.74813,3965.078091,423.074258,26,0
0,0,71,71,29,56,85,423,282,705,0.000333,1.506207,70,316303.4427,17572.41348,4518.62061,466.093324,27,0
0,0,67,67,28,55,83,403,265,668,0.000333,1.419509,56,238477.475,13248.74861,4258.52634,452.580722,27,0
0,0,67,67,28,54,82,407,267,674,0.000333,1.42833,56,239959.4429,13331.08016,4284.990051,445.369863,27,0
0,0,58,58,26,46,72,330,212,542,0.000333,1.1147,52,173893.1662,9660.731458,3344.099351,376.295283,25,0
0,0,51,51,28,36,64,338,200,538,0.000333,1.076,70,225960,12553.33333,3228,320.723238,34,0
0,0,65,65,33,47,80,478,273,751,0.000333,1.582589,80,379821.4399,21101.19111,4747.767999,427.530682,20,0
0,0,86,86,31,59,90,493,341,834,0.000333,1.804735,75,406065.4112,22559.18951,5414.205482,500.656026,33,0
0,0,93,93,33,62,95,545,386,931,0.000333,2.038845,96,587187.4149,32621.52305,6116.535571,535.625177,35,0
0,0,53,53,31,49,80,594,356,950,0.000333,2.001944,105,630612.3275,35034.01819,6005.83169,428.700868,23,0
0,0,56,56,33,54,87,498,333,831,0.000333,1.784695,96,513992.2603,28555.12557,5354.086045,477.228931,24,0
0,0,48,48,34,47,81,311,238,549,0.000333,1.160193,85,295849.1004,16436.06113,3480.577652,434.039413,17,0
0,0,50,50,35,47,82,345,264,609,0.000333,1.290583,85,329098.6795,18283.25997,3871.749171,440.590582,23,0
0,0,41,41,17,47,64,178,151,329,0.000333,0.658,24,47376,2632,1974,330.552544,8,0
0,0,63,63,20,66,86,287,238,525,0.000333,1.124596,30,101213.6699,5622.98166,3373.788996,485.368574,15,0
0,0,60,60,20,63,83,274,226,500,0.000333,1.062507,30,95625.59147,5312.532859,3187.519716,463.007197,14,0
0,0,44,44,18,45,63,193,158,351,0.000333,0.699342,27,56646.68184,3147.03788,2098.025253,322.192039,11,0
0,0,47,47,16,52,68,211,173,384,0.000333,0.779195,24,56102.05755,3116.780975,2337.585731,360.422865,8,0
0,0,47,47,16,53,69,211,173,384,0.000333,0.781891,24,56296.16139,3127.564522,2345.673391,367.579784,8,0
0,0,44,44,16,51,67,211,172,383,0.000333,0.774437,24,55759.49184,3097.749547,2323.31216,353.293692,7,0
0,0,44,44,16,52,68,211,172,383,0.000333,0.777166,24,55955.95844,3108.664358,2331.498268,360.422865,7,0
0,0,60,60,17,65,82,320,276,596,0.000333,1.263034,32,121251.2318,6736.179546,3789.100995,460.940776,7,0
0,0,48,48,16,53,69,236,195,431,0.000333,0.877591,24,63186.57698,3510.365388,2632.774041,367.579784,6,0
0,0,64,64,17,69,86,351,302,653,0.000333,1.398784,32,134283.2283,7460.179351,4196.350885,490.975056,9,0
0,0,52,52,16,57,73,267,221,488,0.000333,1.006878,24,72495.22523,4027.512513,3020.634385,396.474731,8,0
0,0,26,26,14,40,54,134,111,245,0.000333,0.469982,14,19739.26413,1096.625785,1409.947438,266.180093,3,0
0,0,26,26,14,41,55,134,111,245,0.000333,0.472144,14,19830.06382,1101.670212,1416.43313,272.962601,3,0
0,0,25,25,14,37,51,126,105,231,0.000333,0.436777,14,18344.62356,1019.145753,1310.330254,246.052743,3,0
0,0,25,25,14,38,52,126,105,231,0.000333,0.438934,14,18435.22205,1024.179003,1316.801575,252.724214,3,0
0,0,24,24,14,38,52,127,105,232,0.000333,0.440834,14,18515.02821,1028.612678,1322.502015,252.724214,3,0
0,0,24,24,14,39,53,127,105,232,0.000333,0.442959,14,18604.28564,1033.571424,1328.877545,259.433655,3,0
0,0,36,36,14,53,67,223,189,412,0.000333,0.833076,21,52483.80368,2915.766871,2499.228746,356.882753,4,0
0,0,36,36,14,54,68,223,189,412,0.000333,0.836012,21,52668.7285,2926.040472,2508.034691,364.066894,4,0
0,0,35,35,16,56,72,218,184,402,0.000333,0.82677,24,59527.43641,3307.079801,2480.309851,389.211876,5,0
0,0,35,35,16,57,73,218,184,402,0.000333,0.829436,24,59719.42734,3317.745964,2488.309473,396.474731,5,0
0,0,24,24,14,39,53,129,106,235,0.000333,0.448687,14,18844.8583,1046.936572,1346.061307,259.433655,4,0
0,0,24,24,14,40,54,129,106,235,0.000333,0.4508,14,18933.57988,1051.865549,1352.398563,266.180093,4,0
0,0,61,61,15,90,105,481,415,896,0.000333,2.005321,28,168446.9915,9358.166197,6015.963984,642.870138,5,0
0,0,49,49,14,77,91,397,334,731,0.000333,1.585733,28,133201.5407,7400.085594,4757.197882,535.845533,4,0
0,0,13,13,12,26,38,61,52,113,0.000333,0.197672,12,7116.189708,395.343873,593.015809,165.230983,2,0
0,0,13,13,12,25,37,61,52,113,0.000333,0.196223,12,7064.018764,392.445487,588.66823,159.115955,2,0
0,0,18,18,11,36,47,109,94,203,0.000333,0.375861,10,11275.81537,626.434187,1127.581537,224.171048,1,0
0,0,18,18,11,35,46,109,94,203,0.000333,0.373761,10,11212.83077,622.935043,1121.283077,217.578653,1,0
0,0,86,86,28,67,95,512,408,920,0.000333,2.014756,84,507718.4414,28206.58008,6044.26716,541.033914,36,0
0,0,80,80,28,65,93,499,396,895,0.000333,1.950849,84,491613.9594,27311.88663,5852.547136,526.059846,36,0
0,0,64,64,25,61,86,311,250,561,0.000333,1.201712,48,173046.4573,9613.692073,3605.134527,477.871382,27,0
0,0,62,62,25,63,88,305,245,550,0.000333,1.184229,36,127896.746,7105.374781,3552.68739,492.66504,27,0
0,0,72,72,25,62,87,331,272,603,0.000333,1.295032,48,186484.5565,10360.25314,3885.094928,485.256576,28,0
0,0,71,71,25,62,87,329,271,600,0.000333,1.288589,48,185556.7727,10308.70959,3865.766098,485.256576,28,0
0,0,73,73,25,62,87,329,274,603,0.000333,1.295032,48,186484.5565,10360.25314,3885.094928,485.256576,28,0
1,0,69,70,24,95,119,419,331,750,0.000333,1.723704,36,186160.0796,10342.22665,5171.113322,734.175383,15,0
1,0,68,69,23,94,117,414,328,742,0.000333,1.69927,33,168227.7505,9345.98614,5097.810622,720.173277,14,0
0,0,10,10,11,16,27,73,44,117,0.000333,0.185441,10,5563.218378,309.067688,556.321838,102.053748,4,0
0,0,10,10,10,16,26,67,41,108,0.000333,0.169216,10,5076.474896,282.026383,507.64749,97.219281,3,0
0,0,10,10,10,16,26,71,41,112,0.000333,0.175483,10,5264.492484,292.471805,526.449248,97.219281,3,0
0,0,10,10,10,16,26,67,41,108,0.000333,0.169216,10,5076.474896,282.026383,507.64749,97.219281,3,0
0,0,10,10,10,16,26,71,41,112,0.000333,0.175483,10,5264.492484,292.471805,526.449248,97.219281,3,0
0,0,10,10,10,16,26,67,41,108,0.000333,0.169216,10,5076.474896,282.026383,507.64749,97.219281,3,0
0,0,10,10,10,16,26,67,41,108,0.000333,0.169216,10,5076.474896,282.026383,507.64749,97.219281,3,0
0,0,10,10,10,16,26,67,41,108,0.000333,0.169216,10,5076.474896,282.026383,507.64749,97.219281,3,0
0,0,9,9,20,32,52,79,66,145,0.000333,0.275521,20,16531.27518,918.404177,826.563759,246.438562,4,0
0,0,11,11,17,36,53,86,81,167,0.000333,0.318854,16,15305.00346,850.27797,956.562716,255.604168,3,0
0,0,16,16,17,45,62,141,125,266,0.000333,0.527939,16,25341.0595,1407.836639,1583.816219,316.620258,4,0
0,0,36,36,22,55,77,211,152,363,0.000333,0.758281,22,50046.55731,2780.364295,2274.843514,416.08228,12,0
0,0,36,36,22,55,77,211,152,363,0.000333,0.758281,22,50046.55731,2780.364295,2274.843514,416.08228,12,0
0,0,65,65,23,72,95,362,274,636,0.000333,1.392809,33,137888.1295,7660.451639,4178.428167,548.276525,26,0
0,0,9,9,11,31,42,54,48,102,0.000333,0.183339,5,2750.081886,152.782327,550.016377,191.633833,1,0
0,0,54,54,23,75,98,332,234,566,0.000333,1.247975,33,123549.5505,6863.863915,3743.925772,571.203327,11,0
0,0,45,45,23,68,91,265,192,457,0.000333,0.991354,22,65429.36731,3634.964851,2974.062151,517.989398,11,0
0,0,46,46,23,70,93,272,198,470,0.000333,1.024468,22,67614.90211,3756.38345,3073.404641,533.091736,11,0
0,0,59,59,23,87,110,366,259,625,0.000333,1.412783,22,93243.69606,5180.205337,4238.349821,664.578009,11,0
0,0,59,59,23,82,105,366,257,623,0.000333,1.394325,33,138038.1736,7668.787422,4182.974958,625.361189,11,0
0,0,60,60,27,81,108,371,263,634,0.000333,1.427533,39,167021.3484,9278.963799,4282.598676,641.909813,12,0
0,0,9,9,11,32,43,55,50,105,0.000333,0.189919,5,2848.788996,158.266055,569.757799,198.053748,1,0
0,0,66,66,27,86,113,404,285,689,0.000333,1.566368,39,183265.0289,10181.39049,4699.103305,681.040731,15,0
0,0,63,63,27,84,111,397,278,675,0.000333,1.528744,39,178862.9977,9936.833205,4586.23071,665.336626,14,0
0,0,55,55,23,76,99,341,241,582,0.000333,1.286095,33,127323.4232,7073.523514,3858.285553,578.884416,11,0
0,0,45,45,23,68,91,267,195,462,0.000333,1.0022,22,66145.22472,3674.734707,3006.601124,517.989398,11,0
0,0,46,46,23,70,93,274,201,475,0.000333,1.035367,22,68334.20958,3796.344976,3106.100435,533.091736,11,0
0,0,60,60,23,88,111,375,266,641,0.000333,1.45174,33,143722.2788,7984.571046,4355.22057,672.471907,11,0
0,0,58,58,23,80,103,365,256,621,0.000333,1.384106,33,137026.4553,7612.58085,4152.316827,609.796173,11,0
0,0,64,64,27,84,111,394,280,674,0.000333,1.526479,39,178598.0155,9922.11197,4579.436294,665.336626,14,0
0,0,9,9,11,32,43,55,50,105,0.000333,0.189919,5,2848.788996,158.266055,569.757799,198.053748,1,0
0,0,55,55,23,76,99,341,241,582,0.000333,1.286095,33,127323.4232,7073.523514,3858.285553,578.884416,11,0
0,0,29,29,19,54,73,200,144,344,0.000333,0.709767,18,38327.39367,2129.299648,2129.299648,391.474548,4,0
0,0,45,45,23,68,91,267,195,462,0.000333,1.0022,22,66145.22472,3674.734707,3006.601124,517.989398,11,0
0,0,19,19,19,45,64,126,98,224,0.000333,0.448,18,24192,1344,1344,327.844012,4,0
0,0,46,46,23,70,93,274,201,475,0.000333,1.035367,22,68334.20958,3796.344976,3106.100435,533.091736,11,0
0,0,20,20,19,47,66,133,104,237,0.000333,0.477507,18,25785.38531,1432.521406,1432.521406,341.776299,4,0
0,0,60,60,23,88,111,375,266,641,0.000333,1.45174,33,143722.2788,7984.571046,4355.22057,672.471907,11,0
0,0,34,34,19,66,85,234,169,403,0.000333,0.860995,18,46493.72185,2582.984547,2582.984547,479.640635,4,0
0,0,58,58,22,79,101,364,255,619,0.000333,1.373811,33,136007.286,7555.960331,4121.432908,596.106175,11,0
0,0,32,32,18,57,75,223,158,381,0.000333,0.79106,18,42717.23858,2373.179921,2373.179921,407.533381,4,0
0,0,43,43,26,61,87,267,194,461,0.000333,0.990066,39,115837.6811,6435.426728,2970.196952,483.98641,12,0
0,0,17,17,23,39,62,126,97,223,0.000333,0.442595,22,29211.2871,1622.849283,1327.785777,310.172612,5,0
0,0,75,75,27,94,121,417,310,727,0.000333,1.676671,39,196170.5294,10898.36274,5030.013573,744.513315,23,0
0,0,51,51,24,77,101,277,219,496,0.000333,1.100824,24,79259.34949,4403.297194,3302.472895,592.581664,17,0
0,0,51,51,24,77,101,277,219,496,0.000333,1.100824,24,79259.34949,4403.297194,3302.472895,592.581664,17,0
0,0,49,49,23,81,104,270,215,485,0.000333,1.083238,22,71493.69179,3971.871766,3249.713263,617.569775,16,0
0,0,70,70,27,98,125,388,295,683,0.000333,1.585877,39,185547.596,10308.19978,4757.630666,776.623527,21,0
0,0,71,71,29,88,117,392,293,685,0.000333,1.568733,42,197660.393,10981.13294,4706.199833,709.311431,21,0
0,0,111,111,30,102,132,475,364,839,0.000333,1.970082,45,265961.1,14775.61667,5910.246666,827.794103,30,0
0,0,63,63,22,69,91,290,210,500,0.000333,1.084632,33,107378.6116,5965.47842,3253.89732,519.595683,21,0
0,0,53,53,20,53,73,230,167,397,0.000333,0.81912,30,73720.8105,4095.600583,2457.36035,390.018346,16,0
0,0,14,14,17,22,39,63,46,109,0.000333,0.192036,16,9217.74147,512.096748,576.108842,167.594364,5,0
0,0,105,105,27,85,112,439,332,771,0.000333,1.74949,39,204690.3552,11371.6864,5248.470645,673.180192,30,0
0,0,95,95,25,98,123,449,336,785,0.000333,1.816625,36,196195.4599,10899.74777,5449.873887,764.337969,30,0
0,0,88,88,25,90,115,417,318,735,0.000333,1.677145,36,181131.6667,10062.87038,5031.435187,700.363183,26,0
1,0,30,31,18,36,54,111,91,202,0.000333,0.387496,18,20924.77096,1162.487275,1162.487275,261.17595,16,0
1,0,35,36,20,50,70,147,122,269,0.000333,0.549592,20,32975.54263,1831.974591,1648.777132,368.631371,16,0
0,0,66,66,25,89,114,305,242,547,0.000333,1.245864,24,89702.18011,4983.45445,3737.590838,692.43668,15,0
0,0,69,69,25,89,114,333,260,593,0.000333,1.350635,24,97245.69068,5402.538371,4051.903778,692.43668,15,0
0,0,58,58,22,64,86,266,193,459,0.000333,0.983219,33,97338.63224,5407.701791,2949.655522,482.107496,19,0
0,0,41,41,19,49,68,171,155,326,0.000333,0.661504,27,53581.84793,2976.769329,1984.512886,355.831405,12,0
0,0,45,45,24,58,82,249,208,457,0.000333,0.968467,36,104594.4456,5810.802532,2905.401266,449.801998,15,0
0,0,111,111,29,73,102,440,375,815,0.000333,1.812676,70,380661.8658,21147.88143,5438.026654,592.738642,29,0
0,0,39,39,19,52,71,185,176,361,0.000333,0.74002,27,59941.58517,3330.088065,2220.05871,377.133488,11,0
0,0,43,43,24,61,85,263,229,492,0.000333,1.05114,36,113523.1323,6306.840681,3153.420341,471.814078,14,0
0,0,109,109,29,76,105,454,396,850,0.000333,1.90237,70,399497.6083,22194.31157,5707.10869,615.72394,28,0
0,0,40,40,16,51,67,164,137,301,0.000333,0.608631,16,29214.28554,1623.015863,1825.892846,353.293692,7,0
0,0,43,43,19,70,89,232,194,426,0.000333,0.919554,18,49655.92395,2758.662442,2758.662442,509.760434,7,0
0,0,46,46,19,68,87,240,197,437,0.000333,0.938522,18,50680.19354,2815.566308,2815.566308,494.658096,9,0
0,0,31,31,15,41,56,116,99,215,0.000333,0.416194,14,17480.13832,971.118795,1248.581308,278.262991,7,0
0,0,30,30,15,41,56,110,94,204,0.000333,0.3949,14,16585.80566,921.433648,1184.700404,278.262991,7,0
0,0,21,21,21,35,56,131,109,240,0.000333,0.464588,30,41812.95544,2322.941969,1393.765181,271.763571,9,0
0,0,16,16,16,30,46,79,58,137,0.000333,0.252243,8,6053.823904,336.32355,756.727988,211.206718,8,0
1,0,22,23,21,44,65,114,104,218,0.000333,0.437625,20,26257.52367,1458.751315,1312.876183,332.453657,9,0
1,0,25,26,22,50,72,145,132,277,0.000333,0.56969,22,37599.52296,2088.862387,1709.069225,380.300305,10,0
1,0,25,26,22,50,72,145,132,277,0.000333,0.56969,22,37599.52296,2088.862387,1709.069225,380.300305,10,0
1,0,25,26,22,52,74,145,133,278,0.000333,0.575409,22,37977.01678,2109.834266,1726.228036,394.530361,10,0
2,0,34,36,23,55,78,190,175,365,0.000333,0.764724,33,75707.66973,4205.981651,2294.17181,422.016709,16,0
1,0,33,34,24,54,78,175,152,327,0.000333,0.685109,24,49327.83661,2740.435367,2055.326526,420.803025,16,0
1,0,32,33,23,54,77,176,159,335,0.000333,0.699791,22,46186.21681,2565.900934,2099.373491,414.80585,16,0
1,0,31,32,23,53,76,167,155,322,0.000333,0.670611,22,44260.31851,2458.906584,2011.832659,407.621709,14,0
1,0,32,33,24,53,77,166,148,314,0.000333,0.655924,24,47226.50337,2623.694632,1967.770974,413.618884,14,0
1,0,31,32,23,53,76,167,155,322,0.000333,0.670611,22,44260.31851,2458.906584,2011.832659,407.621709,14,0
7,0,99,106,29,84,113,518,462,980,0.000333,2.227925,70,467864.2768,25992.45982,6683.775383,677.836112,38,0
1,0,37,38,25,56,81,205,175,380,0.000333,0.803048,36,86729.14804,4818.286002,2409.143001,441.30828,18,0
1,0,36,37,24,57,81,206,182,388,0.000333,0.819954,36,88555.02484,4919.723602,2459.861801,442.513831,18,0
2,0,35,37,25,55,80,197,174,371,0.000333,0.781812,36,84435.67164,4690.870646,2345.435323,434.071189,16,0
2,0,34,36,25,54,79,188,170,358,0.000333,0.752251,36,81243.12628,4513.507016,2256.753508,426.86033,14,0
2,0,39,41,26,57,83,227,197,424,0.000333,0.901006,39,105417.652,5856.536224,2703.016719,454.686163,18,0
1,0,9,10,12,29,41,67,67,134,0.000333,0.239304,12,8614.943623,478.607979,717.911969,183.900999,1,0
1,0,9,10,12,29,41,67,67,134,0.000333,0.239304,12,8614.943623,478.607979,717.911969,183.900999,1,0
1,0,9,10,12,30,42,67,68,135,0.000333,0.242654,12,8735.554225,485.308568,727.962852,190.226268,1,0
4,0,61,65,27,79,106,435,377,812,0.000333,1.821024,52,284079.7133,15782.20629,5463.071409,626.380642,31,0
3,0,47,50,23,66,89,274,246,520,0.000333,1.12246,33,111123.5857,6173.532538,3367.381384,502.971937,18,0
3,0,56,59,27,70,97,324,283,607,0.000333,1.335382,52,208319.649,11573.31383,4006.147095,557.431774,25,0
2,0,53,55,24,70,94,311,274,585,0.000333,1.278145,36,138039.6412,7668.868956,3834.434478,539.088911,25,0
2,0,53,55,24,70,94,311,274,585,0.000333,1.278145,36,138039.6412,7668.868956,3834.434478,539.088911,25,0
3,0,59,62,30,74,104,330,296,626,0.000333,1.398158,60,251668.5158,13981.58421,4194.475264,606.706267,22,0
2,0,57,59,36,73,109,328,280,608,0.000333,1.371685,54,222213.0278,12345.16821,4115.056069,637.974493,22,0
2,0,57,59,26,73,99,308,280,588,0.000333,1.299354,39,152024.406,8445.800334,3898.061693,574.068625,22,0
2,0,82,84,29,82,111,417,359,776,0.000333,1.757489,56,295258.1359,16403.22977,5272.466712,662.200713,29,0
2,0,57,59,26,73,99,308,281,589,0.000333,1.301564,39,152282.9509,8460.16394,3904.691049,574.068625,22,0
3,0,56,59,24,70,94,327,292,619,0.000333,1.35243,48,194749.944,10819.44133,4057.290499,539.088911,25,0
2,0,55,57,25,68,93,312,269,581,0.000333,1.266417,36,136773.0457,7598.502539,3799.251269,530.043878,25,0
2,0,54,56,23,69,92,313,276,589,0.000333,1.280793,44,169064.6317,9392.479536,3842.377992,525.530113,25,0
4,0,49,53,25,71,96,314,284,598,0.000333,1.312603,48,189014.7636,10500.8202,3937.807575,552.72845,21,0
3,0,58,61,29,80,109,328,291,619,0.000333,1.396502,42,175959.2561,9775.514226,4189.506097,646.635696,21,0
3,0,57,60,25,69,94,334,291,625,0.000333,1.365539,48,196637.6656,10924.31475,4096.618032,537.584592,25,0
2,0,25,27,19,50,69,146,124,270,0.000333,0.549767,18,29687.42886,1649.301603,1649.301603,362.903432,20,0
3,0,25,28,20,53,73,169,145,314,0.000333,0.647868,20,38872.09823,2159.561013,1943.604911,390.018346,19,0
3,0,34,37,24,57,81,219,182,401,0.000333,0.847427,36,91522.07464,5084.559702,2542.279851,442.513831,26,0
2,0,31,33,21,57,78,206,173,379,0.000333,0.794056,30,71465.02323,3970.279068,2382.167441,424.713397,26,0
2,0,31,33,21,57,78,206,173,379,0.000333,0.794056,30,71465.02323,3970.279068,2382.167441,424.713397,26,0
3,0,37,40,26,61,87,225,195,420,0.000333,0.902012,39,105535.4145,5863.078581,2706.036268,483.98641,23,0
2,0,35,37,32,60,92,223,179,402,0.000333,0.874157,32,83919.101,4662.172278,2622.471906,514.413436,23,0
2,0,35,37,22,60,82,203,179,382,0.000333,0.809528,22,53428.86705,2968.270391,2428.584866,452.520931,23,0
2,0,60,62,28,69,97,312,258,570,0.000333,1.253983,42,158001.9134,8777.88408,3761.95032,556.094125,30,0
2,0,35,37,22,60,82,203,180,383,0.000333,0.811647,33,80353.09979,4464.061099,2434.942418,452.520931,23,0
3,0,34,37,22,57,79,222,191,413,0.000333,0.86782,33,85914.22782,4773.012656,2603.461449,430.582226,26,0
2,0,33,35,23,55,78,207,168,375,0.000333,0.785675,33,77781.85246,4321.214025,2357.025832,422.016709,26,0
2,0,32,34,21,56,77,208,175,383,0.000333,0.80006,30,72005.37735,4000.298742,2400.179245,417.450542,26,0
4,0,27,31,23,59,82,209,183,392,0.000333,0.83072,33,82241.29273,4568.960707,2492.160386,451.117865,22,0
3,0,36,39,28,68,96,223,190,413,0.000333,0.90653,28,76148.50636,4230.472575,2719.589513,548.553411,22,0
3,0,35,38,23,56,79,229,190,419,0.000333,0.880428,33,87162.37641,4842.354245,2641.284133,429.253801,26,0
2,0,48,50,27,73,100,367,315,682,0.000333,1.51037,52,235617.7159,13089.87311,4531.109921,580.239155,28,0
3,0,54,57,26,75,101,390,347,737,0.000333,1.635701,52,255169.2969,14176.07205,4907.101863,589.372834,29,0
1,0,51,52,31,86,117,415,341,756,0.000333,1.731332,45,233729.8078,12984.98932,5193.995728,706.238855,31,0
1,0,52,53,31,82,113,403,325,728,0.000333,1.65503,45,223429.0628,12412.72571,4965.090285,674.89935,28,0
1,0,11,12,18,30,48,65,59,124,0.000333,0.230845,9,6232.818151,346.267675,692.53535,222.265368,4,0
1,0,5,6,9,19,28,29,30,59,0.000333,0.094545,4,1134.535762,63.029765,283.63394,109.239948,2,0
0,0,9,9,13,15,28,59,39,98,0.000333,0.15704,12,5653.449388,314.080522,471.120782,106.709075,4,0
0,0,25,25,26,27,53,164,111,275,0.000333,0.525059,52,81909.2625,4550.514583,1575.178125,250.593395,9,0
0,0,19,19,24,26,50,134,90,224,0.000333,0.421408,36,45512.05631,2528.447573,1264.223787,232.250533,8,0
0,0,60,60,30,44,74,357,208,565,0.000333,1.169447,60,210500.4691,11694.47051,3508.341152,387.421709,42,0
0,0,30,30,27,45,72,191,122,313,0.000333,0.643729,26,50210.84966,2789.491648,1931.186525,375.515352,28,0
0,0,18,18,20,26,46,113,92,205,0.000333,0.377443,30,33969.90603,1887.217002,1132.330201,208.649995,8,0
0,0,10,10,15,14,29,47,38,85,0.000333,0.137643,14,5780.997384,321.166521,412.928385,111.906328,3,0
0,0,80,80,28,83,111,511,410,921,0.000333,2.085886,56,350428.7927,19468.26626,6257.657013,663.734211,58,0
0,0,86,86,28,83,111,540,432,972,0.000333,2.201391,70,462292.0555,25682.89198,6604.172222,663.734211,64,0
0,0,80,80,27,80,107,504,409,913,0.000333,2.051653,65,400072.3583,22226.24213,6154.959359,634.13621,60,0
0,0,66,66,31,55,86,352,282,634,0.000333,1.358084,75,305568.8891,16976.04939,4074.251854,471.55487,42,0
0,0,45,45,29,41,70,224,187,411,0.000333,0.839712,56,141071.5779,7837.309884,2519.13532,360.541081,27,0
0,0,44,44,28,41,69,224,187,411,0.000333,0.836868,56,140593.7989,7810.766605,2510.603552,354.26557,28,0
0,0,45,45,29,41,70,223,187,410,0.000333,0.837669,56,140728.3381,7818.241004,2513.006037,360.541081,27,0
0,0,54,54,28,54,82,328,269,597,0.000333,1.265153,56,212545.6786,11808.09326,3795.458547,445.369863,37,0
0,0,63,63,28,58,86,399,323,722,0.000333,1.546588,70,324783.4207,18043.52337,4639.763153,474.368836,44,0
0,0,14,14,21,36,57,110,86,196,0.000333,0.381082,20,22864.92886,1270.273825,1143.246443,278.355966,12,0
0,0,19,19,21,37,58,139,105,244,0.000333,0.476449,20,28586.94726,1588.163736,1429.347363,284.98844,15,0
0,0,14,14,21,36,57,107,83,190,0.000333,0.369416,20,22164.98205,1231.387892,1108.249103,278.355966,12,0
0,0,19,19,21,37,58,136,102,238,0.000333,0.464733,20,27883.98954,1549.11053,1394.199477,284.98844,15,0
0,0,13,13,22,35,57,121,92,213,0.000333,0.414135,22,27332.92261,1518.4957,1242.405573,277.632401,9,0
0,0,18,18,22,37,59,150,111,261,0.000333,0.51179,33,50667.20458,2814.844699,1535.369836,290.85727,12,0
0,0,7,7,13,25,38,55,57,112,0.000333,0.195923,12,7053.214578,391.845254,587.767882,164.202121,3,0
0,0,30,30,22,58,80,225,159,384,0.000333,0.809207,22,53407.64855,2967.091586,2427.620388,437.870393,14,0
0,0,26,26,21,18,39,150,64,214,0.000333,0.377025,30,33932.28225,1885.126791,1131.076075,167.297316,21,0
0,0,22,22,20,17,37,134,53,187,0.000333,0.324723,30,29225.03338,1623.612966,974.167779,155.92543,15,0
0,0,30,30,20,21,41,143,75,218,0.000333,0.389315,30,35038.39011,1946.577228,1167.946337,178.677228,14,0
0,0,13,13,18,24,42,81,68,149,0.000333,0.267818,18,14462.19533,803.455296,803.455296,185.09775,6,0
0,0,38,38,27,55,82,251,177,428,0.000333,0.907011,39,106120.2581,5895.569892,2721.032258,446.356747,21,0
0,0,74,74,33,80,113,445,312,757,0.000333,1.720958,48,247818.0228,13767.66793,5162.875475,672.219254,41,0
0,0,70,70,31,78,109,421,297,718,0.000333,1.619852,45,218680.0355,12148.89086,4859.556345,643.841459,39,0
0,0,92,92,30,91,121,577,422,999,0.000333,2.303981,60,414716.6624,23039.81458,6911.944374,739.41603,57,0
0,0,42,42,16,51,67,269,209,478,0.000333,0.96653,32,92786.90026,5154.827792,2899.590633,353.293692,9,0
0,0,36,36,19,44,63,261,194,455,0.000333,0.906554,36,97907.84515,5439.32473,2719.662365,320.925614,7,0
0,0,35,35,18,44,62,256,190,446,0.000333,0.885191,36,95600.57596,5311.143109,2655.571554,315.273641,6,0
0,0,14,14,17,17,34,87,68,155,0.000333,0.262852,32,25233.81569,1401.87865,788.55674,138.973737,5,0
0,0,19,19,23,24,47,118,89,207,0.000333,0.383267,33,37943.39645,2107.966469,1149.799892,214.081025,7,0
0,0,21,21,20,24,44,124,94,218,0.000333,0.396719,30,35704.68279,1983.593488,1190.156093,196.477662,8,0
0,0,20,20,26,27,53,128,92,220,0.000333,0.420048,39,49145.5575,2730.30875,1260.1425,250.593395,8,0
0,0,13,13,14,17,31,76,55,131,0.000333,0.216333,21,13628.99405,757.166336,648.999717,122.789837,5,0
0,0,12,12,14,19,33,74,56,130,0.000333,0.21859,14,9180.797297,510.044294,655.771236,134.013592,4,0
0,0,12,12,14,17,31,76,57,133,0.000333,0.219636,21,13837.0703,768.726127,658.908109,122.789837,4,0
0,0,12,12,13,18,31,75,57,132,0.000333,0.217985,18,11771.17043,653.953913,653.953913,123.164366,4,0
0,0,19,19,19,25,44,101,78,179,0.000333,0.325746,27,26385.43301,1465.85739,977.23826,196.807027,6,0
0,0,10,10,12,15,27,57,45,102,0.000333,0.161666,18,8729.973454,484.998525,484.998525,101.622909,3,0
0,0,25,25,25,30,55,167,132,299,0.000333,0.576209,48,82974.07461,4609.670812,1728.626554,263.303123,24,0
0,0,14,14,14,22,36,89,69,158,0.000333,0.272283,21,17153.81116,952.989509,816.84815,151.410465,4,0
0,0,14,14,15,23,38,89,70,159,0.000333,0.27814,21,17522.82997,973.490554,834.420475,162.645284,4,0
0,0,14,14,14,23,37,93,71,164,0.000333,0.284783,21,17941.35739,996.742077,854.350352,157.344894,4,0
0,0,14,14,15,24,39,93,72,165,0.000333,0.290697,21,18313.91869,1017.439927,872.091366,168.642459,4,0
0,0,14,14,14,23,37,93,71,164,0.000333,0.284783,21,17941.35739,996.742077,854.350352,157.344894,4,0
0,0,14,14,15,24,39,93,72,165,0.000333,0.290697,21,18313.91869,1017.439927,872.091366,168.642459,4,0
0,0,14,14,14,22,36,90,70,160,0.000333,0.275729,21,17370.94801,965.052667,827.188,151.410465,4,0
0,0,14,14,14,23,37,90,71,161,0.000333,0.279574,21,17613.16183,978.508991,838.721992,157.344894,4,0
0,0,14,14,15,22,37,86,67,153,0.000333,0.265682,21,16737.97366,929.887426,797.046365,156.710855,4,0
0,0,31,31,23,43,66,167,132,299,0.000333,0.602425,33,59640.03678,3313.335376,1807.273842,337.371309,9,0
0,0,30,30,22,38,60,155,118,273,0.000333,0.537527,33,53215.17738,2956.398743,1612.581133,297.528741,9,0
0,0,14,14,15,20,35,85,69,154,0.000333,0.263303,21,16588.10128,921.561182,789.909585,145.041921,4,0
0,0,30,30,23,40,63,160,123,283,0.000333,0.563857,33,55821.81721,3101.212067,1691.570218,316.919049,9,0
0,0,14,14,14,20,34,90,69,159,0.000333,0.269636,21,16987.03843,943.724357,808.906592,139.741531,4,0
0,0,14,14,14,22,36,90,70,160,0.000333,0.275729,21,17370.94801,965.052667,827.188,151.410465,4,0
0,0,14,14,14,23,37,90,71,161,0.000333,0.279574,21,17613.16183,978.508991,838.721992,157.344894,4,0
0,0,14,14,14,23,37,85,67,152,0.000333,0.263946,14,11085.71676,615.873153,791.836912,157.344894,4,0
0,0,31,31,23,42,65,166,132,298,0.000333,0.598222,33,59223.96507,3290.220282,1794.665608,330.519257,9,0
0,0,30,30,22,37,59,154,118,272,0.000333,0.53336,33,52802.60401,2933.478001,1600.078909,290.85727,9,0
0,0,14,14,14,21,35,84,69,153,0.000333,0.261593,21,16480.38633,915.577019,784.780302,145.541635,4,0
0,0,30,30,23,39,62,159,123,282,0.000333,0.559694,33,55409.75086,3078.319492,1679.08336,310.172612,9,0
0,0,14,14,14,18,32,91,69,160,0.000333,0.266667,21,16800,933.333333,800,128.361619,4,0
0,0,14,14,14,23,37,93,71,164,0.000333,0.284783,21,17941.35739,996.742077,854.350352,157.344894,4,0
0,0,14,14,15,24,39,93,72,165,0.000333,0.290697,21,18313.91869,1017.439927,872.091366,168.642459,4,0
0,0,14,14,14,22,36,89,69,158,0.000333,0.272283,21,17153.81116,952.989509,816.84815,151.410465,4,0
0,0,14,14,15,23,38,89,70,159,0.000333,0.27814,21,17522.82997,973.490554,834.420475,162.645284,4,0
0,0,14,14,14,23,37,93,71,164,0.000333,0.284783,21,17941.35739,996.742077,854.350352,157.344894,4,0
0,0,14,14,15,24,39,93,72,165,0.000333,0.290697,21,18313.91869,1017.439927,872.091366,168.642459,4,0
0,0,13,13,13,14,27,67,51,118,0.000333,0.187026,18,10099.38106,561.076725,561.076725,101.408685,4,0
0,0,14,14,17,21,38,86,65,151,0.000333,0.264146,24,19018.48931,1056.582739,792.437055,161.725534,5,0
0,0,16,16,15,22,37,92,70,162,0.000333,0.28131,21,17722.56035,984.586686,843.931445,156.710855,6,0
0,0,15,15,20,25,45,96,68,164,0.000333,0.300221,20,18013.27816,1000.737675,900.663908,202.534967,6,0
0,0,19,19,23,26,49,128,107,235,0.000333,0.439819,44,58056.09979,3225.338877,1319.456813,226.253358,22,0
0,0,16,16,22,21,43,88,79,167,0.000333,0.302062,33,29904.14506,1661.341392,906.186214,190.346161,11,0
0,0,17,17,22,25,47,119,98,217,0.000333,0.401782,33,39776.41077,2209.800598,1205.345781,214.2039,20,0
0,0,24,24,24,28,52,160,125,285,0.000333,0.541542,48,77982.01534,4332.334186,1624.62532,244.645038,22,0
0,0,20,20,22,27,49,147,113,260,0.000333,0.486608,44,64232.28062,3568.460034,1459.824559,226.489458,19,0
0,0,33,33,20,33,53,188,148,336,0.000333,0.641527,40,76983.25091,4276.847273,1924.581273,252.903568,17,0
0,0,49,49,23,35,58,259,199,458,0.000333,0.894318,55,147562.5413,8197.918959,2682.955296,283.566831,23,0
0,0,44,44,27,42,69,280,221,501,0.000333,1.020124,65,198924.0989,11051.33883,3060.370753,354.859294,35,0
0,0,61,61,23,37,60,298,227,525,0.000333,1.033706,66,204673.7591,11370.7644,3101.117563,296.7917,29,0
0,0,44,44,20,34,54,231,175,406,0.000333,0.778828,50,116824.2163,6490.234239,2336.484326,259.412299,23,0
0,0,32,32,22,33,55,176,138,314,0.000333,0.605116,44,79875.2658,4437.514767,1815.34695,264.572502,15,0
0,0,32,32,22,33,55,179,141,320,0.000333,0.616678,44,81401.54477,4522.308043,1850.035108,264.572502,14,0
0,0,37,37,24,34,58,223,164,387,0.000333,0.75568,48,108817.855,6045.436387,2267.038645,283.012837,19,0
0,0,34,34,24,34,58,206,156,362,0.000333,0.706863,48,101788.2778,5654.904321,2120.58912,283.012837,17,0
0,0,32,32,22,33,55,179,141,320,0.000333,0.616678,44,81401.54477,4522.308043,1850.035108,264.572502,14,0
0,0,32,32,22,34,56,182,142,324,0.000333,0.627194,44,82789.65177,4599.425098,1881.582995,271.081232,16,0
0,0,36,36,22,34,56,194,156,350,0.000333,0.677525,44,89433.2658,4968.514767,2032.574223,271.081232,14,0
0,0,35,35,22,33,55,189,152,341,0.000333,0.657148,44,86743.52114,4819.084508,1971.443662,264.572502,14,0
0,0,44,44,24,51,75,250,202,452,0.000333,0.938475,36,101355.3377,5630.852096,2815.426048,399.332792,20,0
0,0,35,35,22,33,55,189,152,341,0.000333,0.657148,44,86743.52114,4819.084508,1971.443662,264.572502,14,0
0,0,36,36,22,34,56,194,156,350,0.000333,0.677525,44,89433.2658,4968.514767,2032.574223,271.081232,14,0
0,0,35,35,22,33,55,190,153,343,0.000333,0.661002,44,87252.2808,4847.348933,1983.006382,264.572502,14,0
0,0,35,35,22,34,56,190,153,343,0.000333,0.663974,44,87644.60048,4869.144471,1991.922738,271.081232,14,0
0,0,44,44,24,51,75,250,202,452,0.000333,0.938475,36,101355.3377,5630.852096,2815.426048,399.332792,20,0
0,0,35,35,22,34,56,188,153,341,0.000333,0.660103,44,87133.55325,4840.752958,1980.308028,271.081232,14,0
0,0,34,34,21,33,54,184,150,334,0.000333,0.640711,40,76885.29703,4271.40539,1922.132426,258.703672,14,0
0,0,34,34,21,34,55,184,150,334,0.000333,0.643658,40,77238.96577,4291.053654,1930.974144,265.212402,14,0
0,0,43,43,23,51,74,244,199,443,0.000333,0.916929,33,90775.99875,5043.111042,2750.787841,393.335617,20,0
0,0,35,35,22,33,55,187,152,339,0.000333,0.653294,44,86234.76149,4790.820083,1959.880943,264.572502,14,0
0,0,34,34,20,32,52,182,148,330,0.000333,0.627048,40,75245.80428,4180.32246,1881.145107,246.438562,14,0
0,0,43,43,23,50,73,243,198,441,0.000333,0.909904,33,90080.51681,5004.473156,2729.71263,386.234734,20,0
0,0,34,34,20,32,52,182,148,330,0.000333,0.627048,40,75245.80428,4180.32246,1881.145107,246.438562,14,0
0,0,45,45,21,39,60,235,187,422,0.000333,0.830903,40,99708.31325,5539.350736,2492.707831,298.369352,19,0
0,0,47,47,23,35,58,243,186,429,0.000333,0.837691,55,138219.0616,7678.836754,2513.073847,283.566831,23,0
0,0,42,42,27,42,69,264,208,472,0.000333,0.961075,52,149927.6243,8329.312459,2883.223544,354.859294,35,0
0,0,59,59,23,37,60,282,214,496,0.000333,0.976606,55,161139.9754,8952.220858,2929.817735,296.7917,29,0
0,0,42,42,20,34,54,215,162,377,0.000333,0.723198,40,86783.70353,4821.316863,2169.592588,259.412299,23,0
0,0,30,30,22,33,55,160,125,285,0.000333,0.549229,33,54373.68811,3020.76045,1647.687518,264.572502,15,0
0,0,30,30,22,33,55,163,128,291,0.000333,0.560792,33,55518.39733,3084.355407,1682.375677,264.572502,14,0
0,0,35,35,24,34,58,207,151,358,0.000333,0.699052,48,100663.5454,5592.41919,2097.157196,283.012837,19,0
0,0,32,32,24,34,58,190,143,333,0.000333,0.650236,48,93633.96823,5201.887124,1950.707671,283.012837,17,0
0,0,30,30,22,33,55,163,128,291,0.000333,0.560792,33,55518.39733,3084.355407,1682.375677,264.572502,14,0
0,0,30,30,22,34,56,166,129,295,0.000333,0.571057,33,56534.60017,3140.81112,1713.169702,271.081232,16,0
0,0,34,34,22,34,56,178,143,321,0.000333,0.621387,44,82023.08092,4556.837829,1864.16093,271.081232,14,0
0,0,33,33,22,33,55,173,139,312,0.000333,0.601261,44,79366.50615,4409.250342,1803.784231,264.572502,14,0
0,0,42,42,24,51,75,234,189,423,0.000333,0.878263,36,94852.45102,5269.580612,2634.790306,399.332792,20,0
0,0,33,33,22,33,55,173,139,312,0.000333,0.601261,44,79366.50615,4409.250342,1803.784231,264.572502,14,0
0,0,34,34,22,34,56,178,143,321,0.000333,0.621387,44,82023.08092,4556.837829,1864.16093,271.081232,14,0
0,0,33,33,22,33,55,174,140,314,0.000333,0.605116,44,79875.2658,4437.514767,1815.34695,264.572502,14,0
0,0,33,33,22,34,56,174,140,314,0.000333,0.607836,44,80234.4156,4457.467534,1823.509446,271.081232,14,0
0,0,42,42,24,51,75,234,189,423,0.000333,0.878263,36,94852.45102,5269.580612,2634.790306,399.332792,20,0
0,0,33,33,22,34,56,172,140,312,0.000333,0.603965,44,79723.36837,4429.076021,1811.894736,271.081232,14,0
0,0,32,32,21,33,54,168,137,305,0.000333,0.58508,40,70209.62753,3900.534863,1755.240688,258.703672,14,0
0,0,32,32,21,34,55,168,137,305,0.000333,0.587772,40,70532.58851,3918.477139,1763.314713,265.212402,14,0
0,0,41,41,23,51,74,228,186,414,0.000333,0.856905,33,84833.55188,4712.975105,2570.713693,393.335617,20,0
0,0,33,33,22,33,55,171,139,310,0.000333,0.597407,44,78857.74649,4380.985916,1792.221511,264.572502,14,0
0,0,32,32,20,32,52,166,135,301,0.000333,0.571944,40,68633.29421,3812.960789,1715.832355,246.438562,14,0
0,0,41,41,23,50,73,227,185,412,0.000333,0.850069,33,84156.8547,4675.380817,2550.207718,386.234734,20,0
0,0,32,32,20,32,52,166,135,301,0.000333,0.571944,40,68633.29421,3812.960789,1715.832355,246.438562,14,0
0,0,4,4,9,11,20,35,23,58,0.000333,0.083557,8,2005.374636,111.409702,250.67183,66.583073,1,0
0,0,23,23,17,22,39,104,81,185,0.000333,0.325933,24,23467.18585,1303.732547,977.79941,167.594364,11,0
0,0,75,75,25,44,69,366,279,645,0.000333,1.313333,72,283679.8758,15759.9931,3939.998275,356.311396,31,0
0,0,61,61,22,42,64,310,236,546,0.000333,1.092,55,180180,10010,3276,324.584827,25,0
0,0,59,59,22,42,64,297,225,522,0.000333,1.044,55,172260,9570,3132,324.584827,25,0
0,0,26,26,16,36,52,197,152,349,0.000333,0.663151,32,63662.51077,3536.806154,1989.453462,250.1173,6,0
0,0,23,23,17,37,54,209,155,364,0.000333,0.69826,32,67032.92963,3724.051646,2094.779051,262.236643,5,0
0,0,41,41,26,42,68,261,208,469,0.000333,0.951673,52,148461.0438,8247.835765,2855.020073,348.688764,34,0
0,0,32,32,19,35,54,179,147,326,0.000333,0.625364,36,67539.35973,3752.186651,1876.093326,260.235528,16,0
0,0,48,48,24,40,64,250,198,448,0.000333,0.896,48,129024,7168,2688,322.916224,22,0
0,0,29,29,19,30,49,160,127,287,0.000333,0.537141,36,58011.18211,3222.843451,1611.421725,227.917341,14,0
0,0,27,27,19,29,48,155,125,280,0.000333,0.521263,36,56296.42201,3127.579,1563.7895,221.592072,13,0
0,0,24,24,15,28,43,115,92,207,0.000333,0.374412,21,23587.97289,1310.442938,1123.236804,193.209297,6,0
0,0,22,22,15,27,42,110,86,196,0.000333,0.352298,21,22194.77851,1233.043251,1056.894215,186.985321,6,0
0,0,21,21,15,27,42,109,84,193,0.000333,0.346906,21,21855.06252,1214.17014,1040.717263,186.985321,6,0
0,0,19,19,15,25,40,107,79,186,0.000333,0.32996,21,20787.45114,1154.858397,989.878626,174.699764,6,0
0,0,22,22,20,31,51,125,94,219,0.000333,0.414087,30,37267.8345,2070.43525,1242.26115,240.018648,8,0
0,0,24,24,21,31,52,135,100,235,0.000333,0.446534,30,40188.10001,2232.672223,1339.603334,245.818752,9,0
0,0,21,21,21,26,47,140,107,247,0.000333,0.457328,40,54879.33786,3048.852103,1371.983446,214.450099,8,0
0,0,26,26,24,33,57,171,128,299,0.000333,0.581345,36,62785.22811,3488.068228,1744.034114,276.504106,10,0
0,0,15,15,19,21,40,81,64,145,0.000333,0.257227,27,20835.34849,1157.519361,771.679574,172.949289,6,0
0,0,14,14,26,24,50,85,62,147,0.000333,0.276549,26,21570.81836,1198.378798,829.64686,232.250533,6,0
0,0,19,19,18,26,44,105,85,190,0.000333,0.345764,27,28006.8842,1555.938011,1037.292008,197.270083,8,0
0,0,35,35,22,29,51,176,136,312,0.000333,0.589932,44,77871.0551,4326.169727,1769.796707,238.988944,14,0
0,0,30,30,26,37,63,197,158,355,0.000333,0.707311,52,110340.5874,6130.032633,2121.934373,314.961207,26,0
0,0,47,47,22,33,55,215,164,379,0.000333,0.730378,44,96409.95458,5356.108588,2191.135331,264.572502,20,0
0,0,30,30,19,28,47,148,112,260,0.000333,0.481398,36,51990.95165,2888.386203,1444.193101,215.316561,14,0
0,0,18,18,21,26,47,93,75,168,0.000333,0.311057,20,18663.41854,1036.856586,933.170927,214.450099,6,0
0,0,18,18,21,26,47,96,78,174,0.000333,0.322166,30,28994.95381,1610.830767,966.49846,214.450099,5,0
0,0,23,23,24,28,52,140,101,241,0.000333,0.457935,36,49457.015,2747.611944,1373.805972,244.645038,10,0
0,0,20,20,24,28,52,123,93,216,0.000333,0.410432,36,44326.61925,2462.589958,1231.294979,244.645038,8,0
0,0,18,18,21,26,47,96,78,174,0.000333,0.322166,30,28994.95381,1610.830767,966.49846,214.450099,5,0
0,0,18,18,21,27,48,99,79,178,0.000333,0.331374,20,19882.4665,1104.581472,994.123325,220.620628,7,0
0,0,22,22,21,27,48,111,93,204,0.000333,0.379777,30,34179.9705,1898.88725,1139.33235,220.620628,5,0
0,0,21,21,21,26,47,106,89,195,0.000333,0.361048,30,32494.34478,1805.241377,1083.144826,214.450099,5,0
0,0,30,30,24,45,69,167,139,306,0.000333,0.623069,36,67291.50542,3738.416968,1869.208484,357.172489,11,0
0,0,21,21,21,26,47,106,89,195,0.000333,0.361048,30,32494.34478,1805.241377,1083.144826,214.450099,5,0
0,0,22,22,21,27,48,111,93,204,0.000333,0.379777,30,34179.9705,1898.88725,1139.33235,220.620628,5,0
0,0,21,21,21,26,47,107,90,197,0.000333,0.364751,30,32827.62011,1823.756673,1094.254004,214.450099,5,0
0,0,21,21,21,27,48,107,90,197,0.000333,0.366746,30,33007.12838,1833.729354,1100.237613,220.620628,5,0
0,0,30,30,24,45,69,167,139,306,0.000333,0.623069,36,67291.50542,3738.416968,1869.208484,357.172489,11,0
0,0,21,21,21,27,48,105,90,195,0.000333,0.363023,30,32672.03063,1815.112813,1089.067688,220.620628,5,0
0,0,20,20,20,26,46,101,87,188,0.000333,0.346143,30,31152.88943,1730.71608,1038.429648,208.649995,5,0
0,0,20,20,20,27,47,101,87,188,0.000333,0.348088,30,31327.88112,1740.43784,1044.262704,214.820524,5,0
0,0,29,29,23,45,68,161,136,297,0.000333,0.602659,33,59663.22331,3314.623517,1807.976464,351.175314,11,0
0,0,21,21,21,26,47,104,89,193,0.000333,0.357345,30,32161.06945,1786.726081,1072.035648,214.450099,5,0
0,0,20,20,19,25,44,99,85,184,0.000333,0.334845,27,27122.45628,1506.803127,1004.535418,196.807027,5,0
0,0,29,29,23,44,67,160,135,295,0.000333,0.596499,33,59053.37827,3280.743237,1789.496311,344.256916,11,0
0,0,20,20,19,25,44,99,85,184,0.000333,0.334845,27,27122.45628,1506.803127,1004.535418,196.807027,5,0
0,0,20,20,18,27,45,111,90,201,0.000333,0.367954,27,29804.28675,1655.793709,1103.862472,203.440613,10,0
0,0,36,36,22,29,51,182,141,323,0.000333,0.610731,44,80616.50896,4478.694942,1832.193385,238.988944,16,0
0,0,31,31,26,38,64,203,163,366,0.000333,0.732,52,114192,6344,2196,321.632678,28,0
0,0,48,48,22,33,55,221,169,390,0.000333,0.751577,55,124010.1659,6889.453659,2254.730288,264.572502,22,0
0,0,31,31,19,29,48,154,117,271,0.000333,0.504508,36,54486.89416,3027.049675,1513.524838,221.592072,16,0
0,0,19,19,21,27,48,99,80,179,0.000333,0.333236,20,19994.16575,1110.786986,999.708288,220.620628,8,0
0,0,19,19,21,27,48,102,83,185,0.000333,0.344406,30,30996.54188,1722.030104,1033.218063,220.620628,7,0
0,0,24,24,24,29,53,146,106,252,0.000333,0.481145,36,51963.69436,2886.871909,1443.435955,250.920549,12,0
0,0,21,21,24,29,53,129,98,227,0.000333,0.433413,36,46808.56596,2600.475886,1300.237943,250.920549,10,0
0,0,19,19,21,27,48,102,83,185,0.000333,0.344406,30,30996.54188,1722.030104,1033.218063,220.620628,7,0
0,0,19,19,21,28,49,105,84,189,0.000333,0.353727,30,31835.40482,1768.633601,1061.180161,226.844604,9,0
0,0,23,23,21,28,49,117,98,215,0.000333,0.402388,30,36214.8785,2011.937694,1207.162616,226.844604,7,0
0,0,22,22,21,27,48,112,94,206,0.000333,0.383501,30,34515.06825,1917.503792,1150.502275,220.620628,7,0
0,0,31,31,24,46,70,173,144,317,0.000333,0.647661,36,69947.37779,3885.965433,1942.982716,364.12295,13,0
0,0,22,22,21,27,48,112,94,206,0.000333,0.383501,30,34515.06825,1917.503792,1150.502275,220.620628,7,0
0,0,23,23,21,28,49,117,98,215,0.000333,0.402388,30,36214.8785,2011.937694,1207.162616,226.844604,7,0
0,0,22,22,21,27,48,113,95,208,0.000333,0.387224,30,34850.16601,1936.120334,1161.6722,220.620628,7,0
0,0,22,22,21,28,49,113,95,208,0.000333,0.389287,30,35035.78943,1946.432746,1167.859648,226.844604,7,0
0,0,31,31,24,46,70,173,144,317,0.000333,0.647661,36,69947.37779,3885.965433,1942.982716,364.12295,13,0
0,0,22,22,21,28,49,111,95,206,0.000333,0.385543,30,34698.90684,1927.717046,1156.630228,226.844604,7,0
0,0,21,21,20,27,47,107,92,199,0.000333,0.368454,30,33160.89545,1842.271969,1105.363181,214.820524,7,0
0,0,21,21,20,28,48,107,92,199,0.000333,0.370469,30,33342.22613,1852.345896,1111.407538,221.0445,7,0
0,0,30,30,23,46,69,167,141,308,0.000333,0.627142,33,62087.04258,3449.280143,1881.425533,358.125775,13,0
0,0,22,22,21,27,48,110,94,204,0.000333,0.379777,30,34179.9705,1898.88725,1139.33235,220.620628,7,0
0,0,21,21,19,26,45,105,90,195,0.000333,0.35697,27,28914.60655,1606.367031,1070.911354,202.922055,7,0
0,0,30,30,23,45,68,166,140,306,0.000333,0.620921,33,61471.19977,3415.066654,1862.763629,351.175314,13,0
0,0,21,21,19,26,45,105,90,195,0.000333,0.35697,27,28914.60655,1606.367031,1070.911354,202.922055,7,0
0,0,27,27,20,46,66,242,139,381,0.000333,0.767638,30,69087.42478,3838.190266,2302.914159,340.522412,20,0
0,0,21,21,17,29,46,94,63,157,0.000333,0.289066,16,13875.18763,770.843757,867.199227,210.368317,11,0
0,0,18,18,15,25,40,103,57,160,0.000333,0.283836,14,11921.11893,662.284385,851.508495,174.699764,7,0
0,0,18,18,15,25,40,104,57,161,0.000333,0.28561,14,11995.62593,666.423663,856.830423,174.699764,7,0
0,0,10,10,11,16,27,73,44,117,0.000333,0.185441,10,5563.218378,309.067688,556.321838,102.053748,4,0
0,0,10,10,10,16,26,67,41,108,0.000333,0.169216,10,5076.474896,282.026383,507.64749,97.219281,3,0
0,0,10,10,10,16,26,71,41,112,0.000333,0.175483,10,5264.492484,292.471805,526.449248,97.219281,3,0
0,0,10,10,10,16,26,67,41,108,0.000333,0.169216,10,5076.474896,282.026383,507.64749,97.219281,3,0
0,0,10,10,10,16,26,71,41,112,0.000333,0.175483,10,5264.492484,292.471805,526.449248,97.219281,3,0
0,0,10,10,10,16,26,67,41,108,0.000333,0.169216,10,5076.474896,282.026383,507.64749,97.219281,3,0
0,0,10,10,10,16,26,67,41,108,0.000333,0.169216,10,5076.474896,282.026383,507.64749,97.219281,3,0
0,0,10,10,10,16,26,67,41,108,0.000333,0.169216,10,5076.474896,282.026383,507.64749,97.219281,3,0
0,0,34,34,27,48,75,179,124,303,0.000333,0.629111,26,49070.63364,2726.146314,1887.332063,396.460163,20,0
0,0,30,30,26,35,61,157,107,264,0.000333,0.521905,39,61062.87163,3392.381757,1565.714657,301.736338,20,0
0,0,28,28,23,28,51,145,100,245,0.000333,0.463248,33,45861.55889,2547.864383,1389.744209,238.647863,18,0
0,0,41,41,26,52,78,207,142,349,0.000333,0.731202,26,57033.73973,3168.541096,2193.605374,418.634298,23,0
0,0,37,37,25,39,64,185,125,310,0.000333,0.62,36,66960,3720,1860,322.227091,23,0
0,0,35,35,22,32,54,173,118,291,0.000333,0.558224,33,55264.18468,3070.232482,1674.672263,258.107496,21,0
0,0,14,14,18,28,46,67,46,113,0.000333,0.208054,9,5617.462509,312.081251,624.162501,209.664588,4,0
0,0,29,29,22,47,69,314,169,483,0.000333,0.983472,33,97363.77132,5409.098406,2950.417313,359.173172,6,0
0,0,29,29,22,47,69,314,169,483,0.000333,0.983472,33,97363.77132,5409.098406,2950.417313,359.173172,6,0
0,0,28,28,22,48,70,308,167,475,0.000333,0.97047,33,96076.51129,5337.583961,2911.409433,366.185696,6,0
0,0,28,28,22,48,70,308,167,475,0.000333,0.97047,33,96076.51129,5337.583961,2911.409433,366.185696,6,0
0,0,31,31,17,35,52,136,109,245,0.000333,0.465536,24,33518.58554,1862.143641,1396.607731,249.011774,8,0
0,0,27,27,15,34,49,117,94,211,0.000333,0.394901,14,16585.85288,921.436271,1184.703777,231.577096,9,0
0,0,26,26,15,34,49,110,91,201,0.000333,0.376186,14,15799.7935,877.766306,1128.556679,231.577096,8,0
0,0,39,39,22,48,70,172,138,310,0.000333,0.633359,22,41801.71018,2322.317232,1900.077735,366.185696,11,0
0,0,29,29,23,23,46,127,80,207,0.000333,0.381126,33,37731.45172,2096.191762,1143.377325,208.08385,13,0
0,0,10,10,16,21,37,53,43,96,0.000333,0.166703,16,8001.72037,444.540021,500.107523,156.238666,4,0
0,0,10,10,16,20,36,52,41,93,0.000333,0.160268,16,7692.848402,427.380467,480.803025,150.438562,4,0
0,0,10,10,15,21,36,55,45,100,0.000333,0.172331,14,7237.895002,402.105278,516.9925,150.842025,4,0
0,0,10,10,16,19,35,51,39,90,0.000333,0.153878,16,7386.167544,410.342641,461.635472,144.710623,4,0
0,0,13,13,21,23,44,68,55,123,0.000333,0.223837,20,13430.20178,746.122321,671.510089,196.280591,5,0
0,0,13,13,21,25,46,72,60,132,0.000333,0.243037,20,14582.20356,810.12242,729.110178,208.335071,5,0
0,0,13,13,21,24,45,69,56,125,0.000333,0.228827,20,13729.63274,762.757374,686.481637,202.277766,5,0
0,0,13,13,21,23,44,68,54,122,0.000333,0.222017,20,13321.01315,740.056286,666.050657,196.280591,5,0
0,0,13,13,21,25,46,70,58,128,0.000333,0.235672,20,14140.31861,785.573256,707.01593,208.335071,5,0
0,0,44,44,29,44,73,206,151,357,0.000333,0.736589,42,92810.22944,5156.123858,2209.767368,381.09644,14,0
0,0,48,48,32,35,67,215,133,348,0.000333,0.703666,48,101327.9538,5629.330769,2110.999038,339.524906,17,0
0,0,49,49,29,45,74,227,162,389,0.000333,0.805159,42,101450.0491,5636.113838,2415.477359,388.014838,16,0
0,0,15,15,20,26,46,100,68,168,0.000333,0.309319,20,18559.16817,1031.064898,927.958409,208.649995,7,0
0,0,37,37,30,38,68,176,117,293,0.000333,0.594542,45,80263.19756,4459.066531,1783.626612,346.627963,12,0
0,0,37,37,30,40,70,186,123,309,0.000333,0.631316,45,85227.68035,4734.871131,1893.948452,360.083842,12,0
0,0,49,49,29,48,77,237,168,405,0.000333,0.846016,42,106598.0391,5922.113281,2538.048549,408.959649,16,0
0,0,18,18,15,25,40,103,57,160,0.000333,0.283836,14,11921.11893,662.284385,851.508495,174.699764,7,0
0,0,18,18,15,25,40,104,57,161,0.000333,0.28561,14,11995.62593,666.423663,856.830423,174.699764,7,0
0,0,21,21,18,30,48,100,65,165,0.000333,0.307173,18,16587.33863,921.518813,921.518813,222.265368,15,0
0,0,16,16,16,27,43,170,88,258,0.000333,0.466659,24,33599.43136,1866.635076,1399.976307,192.381963,8,0
0,0,15,15,16,25,41,166,84,250,0.000333,0.446463,24,32145.31203,1785.850668,1339.388001,180.096405,8,0
0,0,19,19,23,35,58,121,87,208,0.000333,0.406153,22,26806.12103,1489.228946,1218.460047,283.566831,7,0
0,0,63,63,25,71,96,398,258,656,0.000333,1.439912,36,155510.4744,8639.470801,4319.7354,552.72845,24,0
0,0,33,33,24,52,76,259,171,430,0.000333,0.895536,36,96717.91791,5373.217662,2686.608831,406.461965,11,0
0,0,78,78,31,94,125,563,354,917,0.000333,2.129208,45,287443.0885,15969.06047,6387.624189,769.711438,31,0
0,0,13,13,19,22,41,79,54,133,0.000333,0.237518,18,12825.9795,712.554417,712.554417,178.818118,6,0
0,0,23,23,23,37,60,146,103,249,0.000333,0.490272,22,32357.94668,1797.663705,1470.815758,296.7917,9,0
0,0,92,92,22,65,87,507,304,811,0.000333,1.741742,44,229909.9957,12772.77754,5225.227175,489.561403,40,0
0,0,15,15,19,26,45,105,76,181,0.000333,0.331342,18,17892.45739,994.02541,994.02541,202.922055,6,0
0,0,24,24,25,51,76,186,124,310,0.000333,0.645619,24,46484.5807,2582.476706,1936.857529,405.390097,7,0
0,0,68,68,26,83,109,463,295,758,0.000333,1.710095,39,200081.065,11115.61472,5130.283718,651.339705,24,0
0,0,38,38,25,65,90,324,208,532,0.000333,1.151222,36,124331.9705,6907.331694,3453.665847,507.550313,11,0
0,0,18,18,22,38,60,144,91,235,0.000333,0.462706,22,30538.62438,1696.590243,1388.11929,297.528741,6,0
0,0,28,28,25,53,78,211,140,351,0.000333,0.735392,24,52948.22829,2941.568238,2206.176179,419.676189,9,0
0,0,97,97,25,78,103,572,341,913,0.000333,2.034925,48,293029.1991,16279.39995,6104.774981,606.357778,40,0
0,0,20,20,22,42,64,170,113,283,0.000333,0.566,22,37356,2075.333333,1698,324.584827,6,0
0,0,21,21,25,51,76,179,118,297,0.000333,0.618545,24,44535.22732,2474.179295,1855.634471,405.390097,7,0
0,0,65,65,26,83,109,456,289,745,0.000333,1.680766,39,196649.5956,10924.97753,5042.297322,651.339705,24,0
0,0,35,35,25,65,90,317,202,519,0.000333,1.123091,36,121293.7833,6738.543514,3369.271757,507.550313,11,0
0,0,15,15,22,38,60,137,85,222,0.000333,0.43711,22,28849.25367,1602.736315,1311.329712,297.528741,6,0
0,0,25,25,25,53,78,204,134,338,0.000333,0.708155,24,50987.1828,2832.621267,2124.46595,419.676189,9,0
0,0,94,94,25,78,103,565,335,900,0.000333,2.00595,48,288856.8228,16047.60127,6017.850474,606.357778,40,0
0,0,17,17,22,42,64,163,107,270,0.000333,0.54,22,35640,1980,1620,324.584827,6,0
0,0,9,9,13,16,29,70,48,118,0.000333,0.191081,18,10318.35163,573.241757,573.241757,112.105716,3,0
0,0,68,68,27,78,105,442,279,721,0.000333,1.613657,39,188797.8697,10488.77054,4840.971018,618.643336,26,0
0,0,24,24,19,40,59,159,112,271,0.000333,0.531399,18,28695.5328,1594.196266,1594.196266,293.587747,9,0
0,0,18,18,18,36,54,123,87,210,0.000333,0.402842,18,21753.47476,1208.526375,1208.526375,261.17595,7,0
0,0,28,28,19,40,59,185,128,313,0.000333,0.613756,27,49714.21641,2761.900912,1841.267274,293.587747,11,0
0,0,82,82,26,82,108,540,324,864,0.000333,1.945408,39,227612.6893,12645.1494,5836.222802,643.530697,33,0
0,0,22,22,18,36,54,150,105,255,0.000333,0.489165,18,26414.93364,1467.496313,1467.496313,261.17595,9,0
0,0,29,29,19,40,59,186,126,312,0.000333,0.611795,27,49555.38505,2753.076947,1835.384631,293.587747,12,0
0,0,57,57,18,58,76,349,209,558,0.000333,1.162115,27,94131.27592,5229.515329,3486.343553,414.821548,26,0
0,0,43,43,29,69,98,310,188,498,0.000333,1.098042,28,92235.51407,5124.195226,3294.125502,562.369636,22,0
0,0,17,17,29,51,80,183,114,297,0.000333,0.625871,28,52573.15404,2920.73078,1877.612644,430.175141,9,0
0,0,17,17,29,52,81,182,115,297,0.000333,0.627645,28,52722.19262,2929.010701,1882.935451,437.304314,9,0
0,0,22,22,29,52,81,211,135,346,0.000333,0.731196,28,61420.46683,3412.248157,2193.588101,437.304314,11,0
0,0,47,47,31,70,101,402,250,652,0.000333,1.447051,45,195351.9249,10852.88472,4341.153887,582.629897,18,0
0,0,21,21,29,54,83,207,131,338,0.000333,0.718254,28,60333.37318,3351.854065,2154.763328,451.645374,11,0
0,0,66,66,28,78,106,469,279,748,0.000333,1.677495,42,211364.349,11742.46383,5032.4845,624.867311,31,0
0,0,59,59,28,75,103,433,258,691,0.000333,1.540124,42,194055.6183,10780.86768,4620.371864,601.76734,28,0
0,0,77,77,29,53,82,503,314,817,0.000333,1.731373,70,363588.3991,20199.35551,5194.119988,444.461233,30,0
0,0,55,55,28,49,77,354,228,582,0.000333,1.215757,56,204247.1069,11347.0615,3647.269767,409.72672,20,0
0,0,41,41,22,40,62,274,172,446,0.000333,0.885191,44,116845.1484,6491.397133,2655.571554,310.984619,16,0
0,0,62,62,24,46,70,402,246,648,0.000333,1.323925,60,238306.5237,13239.25132,3971.775395,364.12295,26,0
0,0,6,6,15,15,30,45,34,79,0.000333,0.129215,14,5427.020999,301.501167,387.644357,117.206718,1,0
0,0,5,5,14,11,25,26,24,50,0.000333,0.077398,14,3250.699333,180.594407,232.192809,91.356717,1,0
0,0,6,6,15,15,30,45,34,79,0.000333,0.129215,14,5427.020999,301.501167,387.644357,117.206718,1,0
0,0,5,5,14,11,25,26,24,50,0.000333,0.077398,14,3250.699333,180.594407,232.192809,91.356717,1,0
0,0,5,5,11,12,23,27,21,48,0.000333,0.072377,5,1085.654869,60.314159,217.130974,81.073298,2,0
0,0,12,12,14,20,34,63,39,102,0.000333,0.172974,7,3632.448469,201.802693,518.92121,139.741531,9,0
0,0,57,57,31,46,77,409,237,646,0.000333,1.349448,75,303625.8079,16868.10044,4048.344105,407.663936,35,0
0,0,35,35,30,42,72,236,170,406,0.000333,0.834997,60,150299.373,8349.965169,2504.989551,373.68405,21,0
0,0,41,41,31,44,75,283,199,482,0.000333,1.000764,60,180137.4365,10007.63536,3002.290609,393.795077,25,0
0,0,68,68,30,62,92,493,297,790,0.000333,1.717871,60,309216.8367,17178.71315,5153.613945,516.366889,43,0
0,0,35,35,27,40,67,243,144,387,0.000333,0.782526,39,91555.48415,5086.415786,2347.576517,341.259086,27,0
0,0,25,25,24,27,51,168,110,278,0.000333,0.525645,48,75692.84376,4205.157987,1576.934245,238.421063,14,0
0,0,23,23,24,27,51,158,105,263,0.000333,0.497283,36,53706.52314,2983.69573,1491.847865,238.421063,13,0
0,0,18,18,25,27,52,144,95,239,0.000333,0.454135,36,49046.58334,2724.810185,1362.405093,244.478367,13,0
0,0,18,18,25,27,52,144,95,239,0.000333,0.454135,36,49046.58334,2724.810185,1362.405093,244.478367,13,0
0,0,18,18,25,27,52,144,94,238,0.000333,0.452235,36,48841.36751,2713.409306,1356.704653,244.478367,13,0
0,0,20,20,25,27,52,155,101,256,0.000333,0.486438,36,52535.25244,2918.625136,1459.312568,244.478367,14,0
0,0,21,21,23,27,50,141,94,235,0.000333,0.442102,33,43768.10475,2431.561375,1326.306205,232.423888,10,0
0,0,41,41,27,49,76,292,176,468,0.000333,0.974677,39,114037.173,6335.398499,2924.030076,403.502745,27,0
0,0,43,43,29,58,87,313,192,505,0.000333,1.084562,42,136654.8315,7591.935086,3253.686465,480.644347,27,0
0,0,42,42,29,58,87,311,190,501,0.000333,1.075972,42,135572.417,7531.800947,3227.914691,480.644347,27,0
0,0,20,20,25,42,67,166,108,274,0.000333,0.554036,24,39890.60252,2216.144584,1662.108438,342.573737,7,0
0,0,63,63,29,50,79,463,283,746,0.000333,1.56754,70,329183.4307,18287.96837,4702.620438,423.074258,31,0
0,0,12,12,14,20,34,63,39,102,0.000333,0.172974,7,3632.448469,201.802693,518.92121,139.741531,9,0
0,0,20,20,19,24,43,91,63,154,0.000333,0.278548,18,15041.6059,835.644772,835.644772,190.749723,9,0
0,0,33,33,21,48,69,176,116,292,0.000333,0.594563,20,35673.78283,1981.876824,1783.689141,360.316866,9,0
0,0,57,57,22,58,80,295,195,490,0.000333,1.032582,33,102225.5773,5679.198739,3097.744766,437.870393,14,0
0,0,54,54,22,58,80,281,187,468,0.000333,0.986221,33,97635.8575,5424.214305,2958.662348,437.870393,13,0
0,0,50,50,22,58,80,271,178,449,0.000333,0.946182,33,93672.00858,5204.000477,2838.545715,437.870393,12,0
0,0,21,21,20,24,44,163,104,267,0.000333,0.485889,40,58306.72969,3239.26276,1457.668242,196.477662,5,0
0,0,21,21,20,25,45,159,102,261,0.000333,0.477791,40,57334.94633,3185.274796,1433.373658,202.534967,5,0
0,0,9,9,20,36,56,139,88,227,0.000333,0.439423,20,26365.39135,1464.743964,1318.269567,272.555862,3,0
0,0,20,20,20,26,46,165,102,267,0.000333,0.491597,30,44243.73127,2457.98507,1474.791042,208.649995,5,0
0,0,43,43,19,47,66,227,145,372,0.000333,0.749505,27,60709.89454,3372.771919,2248.514612,341.776299,6,0
0,0,36,36,17,39,56,205,126,331,0.000333,0.640745,24,46133.6275,2562.979306,1922.234479,275.617555,5,0
0,0,39,39,19,47,66,217,136,353,0.000333,0.711224,18,38406.08023,2133.671124,2133.671124,341.776299,5,0
0,0,32,32,17,39,56,195,117,312,0.000333,0.603965,24,43485.47366,2415.859648,1811.894736,275.617555,4,0
0,0,29,29,25,35,60,145,116,261,0.000333,0.513899,36,55501.14404,3083.396891,1541.698445,295.62131,14,0
0,0,53,53,22,52,74,256,208,464,0.000333,0.960395,44,126772.1999,7042.899995,2881.186362,394.530361,29,0
0,0,54,54,24,52,76,268,212,480,0.000333,0.999668,48,143952.2499,7997.347217,2999.005206,406.461965,31,0
0,0,61,61,27,52,79,277,224,501,0.000333,1.052731,52,164226.0961,9123.672003,3158.194155,424.804828,31,0
0,0,66,66,25,60,85,353,279,632,0.000333,1.350245,48,194435.2834,10801.96019,4050.735072,470.50984,37,0
0,0,67,67,26,60,86,365,283,648,0.000333,1.388073,52,216539.4172,12029.96762,4164.219561,476.624868,39,0
0,0,74,74,30,60,90,374,295,669,0.000333,1.447683,60,260582.9833,14476.83241,4343.049721,501.620154,39,0
0,0,70,70,24,65,89,382,300,682,0.000333,1.47215,48,211989.6096,11777.20053,4416.4502,501.493008,42,0
0,0,71,71,25,65,90,394,304,698,0.000333,1.510438,48,217503.0461,12083.50256,4531.313461,507.550313,44,0
0,0,78,78,29,65,94,403,316,719,0.000333,1.570916,56,263913.9655,14661.88697,4712.749384,532.335357,44,0
0,0,80,80,32,60,92,409,303,712,0.000333,1.548259,80,371582.089,20643.44939,4644.776113,514.413436,29,0
0,0,78,78,33,71,104,433,322,755,0.000333,1.686277,64,323765.2472,17986.95818,5058.831987,603.097051,29,0
0,0,79,79,33,71,104,438,326,764,0.000333,1.706379,64,327624.7005,18201.37225,5119.135945,603.097051,29,0
0,0,39,39,21,41,62,216,158,374,0.000333,0.74229,30,66806.0826,3711.449033,2226.86942,311.898298,18,0
0,0,25,25,16,26,42,115,93,208,0.000333,0.373867,24,26918.44858,1495.469365,1121.602024,186.211433,14,0
0,0,44,44,22,45,67,245,180,425,0.000333,0.859363,44,113435.8679,6301.992659,2578.087906,345.240885,23,0
0,0,32,32,19,31,50,155,125,280,0.000333,0.52676,36,56890.07039,3160.559466,1580.279733,234.290708,21,0
0,0,42,42,21,36,57,195,156,351,0.000333,0.682448,40,81893.7758,4549.654211,2047.344395,278.355966,23,0
0,0,79,79,24,55,79,455,318,773,0.000333,1.624274,60,292369.3511,16242.74173,4872.822518,428.013884,31,0
0,0,65,65,24,59,83,342,274,616,0.000333,1.309008,48,188497.1659,10472.06477,3927.02429,457.11504,37,0
0,0,66,66,25,59,84,354,278,632,0.000333,1.346648,48,193917.3413,10773.18563,4039.944611,463.172345,39,0
0,0,73,73,29,59,88,363,290,653,0.000333,1.406003,56,236208.4954,13122.69419,4218.008847,487.957389,39,0
0,0,11,11,15,19,34,54,51,105,0.000333,0.178061,14,7478.570377,415.476132,534.183598,139.313982,6,0
0,0,12,12,14,20,34,63,39,102,0.000333,0.172974,7,3632.448469,201.802693,518.92121,139.741531,9,0
0,0,23,23,22,37,59,129,96,225,0.000333,0.441198,22,29119.08309,1617.726839,1323.594686,290.85727,12,0
0,0,23,23,22,37,59,129,96,225,0.000333,0.441198,22,29119.08309,1617.726839,1323.594686,290.85727,12,0
0,0,24,24,22,37,59,136,99,235,0.000333,0.460807,22,30413.26457,1689.625809,1382.421117,290.85727,13,0
0,0,31,31,17,35,52,136,109,245,0.000333,0.465536,24,33518.58554,1862.143641,1396.607731,249.011774,8,0
0,0,26,26,15,34,49,110,91,201,0.000333,0.376186,14,15799.7935,877.766306,1128.556679,231.577096,8,0
0,0,27,27,15,34,49,117,94,211,0.000333,0.394901,14,16585.85288,921.436271,1184.703777,231.577096,9,0
0,0,39,39,22,48,70,172,138,310,0.000333,0.633359,22,41801.71018,2322.317232,1900.077735,366.185696,11,0
0,0,26,26,20,39,59,131,103,234,0.000333,0.458846,20,27530.76947,1529.487193,1376.538474,292.569248,9,0
0,0,27,27,20,39,59,138,106,244,0.000333,0.478455,20,28707.29808,1594.849893,1435.364904,292.569248,10,0
0,0,21,21,17,29,46,94,63,157,0.000333,0.289066,16,13875.18763,770.843757,867.199227,210.368317,13,0
0,0,77,77,29,53,82,503,314,817,0.000333,1.731373,70,363588.3991,20199.35551,5194.119988,444.461233,30,0
0,0,55,55,28,49,77,354,228,582,0.000333,1.215757,56,204247.1069,11347.0615,3647.269767,409.72672,20,0
0,0,41,41,22,40,62,274,172,446,0.000333,0.885191,44,116845.1484,6491.397133,2655.571554,310.984619,16,0
0,0,62,62,24,46,70,402,246,648,0.000333,1.323925,60,238306.5237,13239.25132,3971.775395,364.12295,26,0
0,0,6,6,15,15,30,45,34,79,0.000333,0.129215,14,5427.020999,301.501167,387.644357,117.206718,1,0
0,0,5,5,14,11,25,26,24,50,0.000333,0.077398,14,3250.699333,180.594407,232.192809,91.356717,1,0
0,0,6,6,15,15,30,45,34,79,0.000333,0.129215,14,5427.020999,301.501167,387.644357,117.206718,1,0
0,0,5,5,14,11,25,26,24,50,0.000333,0.077398,14,3250.699333,180.594407,232.192809,91.356717,1,0
0,0,85,85,27,57,84,404,240,644,0.000333,1.372217,52,214065.9259,11892.55144,4116.65242,460.856693,35,0
0,0,77,77,25,50,75,359,234,593,0.000333,1.23123,48,177297.0952,9849.838623,3693.689483,398.289214,31,0
0,0,86,86,27,60,87,395,261,656,0.000333,1.408857,52,219781.6885,12210.09381,4226.570933,482.795398,35,0
0,0,76,76,25,50,75,353,229,582,0.000333,1.208391,48,174008.2789,9667.126608,3625.172478,398.289214,31,0
0,0,86,86,27,54,81,407,257,664,0.000333,1.40322,52,218902.3409,12161.24116,4209.660402,439.145888,38,0
0,0,87,87,27,60,87,401,266,667,0.000333,1.432481,52,223467.0522,12414.83623,4297.443312,482.795398,35,0
0,0,10,10,11,16,27,73,44,117,0.000333,0.185441,10,5563.218378,309.067688,556.321838,102.053748,4,0
0,0,10,10,10,16,26,67,41,108,0.000333,0.169216,10,5076.474896,282.026383,507.64749,97.219281,3,0
0,0,10,10,10,16,26,71,41,112,0.000333,0.175483,10,5264.492484,292.471805,526.449248,97.219281,3,0
0,0,10,10,10,16,26,67,41,108,0.000333,0.169216,10,5076.474896,282.026383,507.64749,97.219281,3,0
0,0,10,10,10,16,26,71,41,112,0.000333,0.175483,10,5264.492484,292.471805,526.449248,97.219281,3,0
0,0,10,10,10,16,26,67,41,108,0.000333,0.169216,10,5076.474896,282.026383,507.64749,97.219281,3,0
0,0,10,10,10,16,26,67,41,108,0.000333,0.169216,10,5076.474896,282.026383,507.64749,97.219281,3,0
0,0,10,10,10,16,26,67,41,108,0.000333,0.169216,10,5076.474896,282.026383,507.64749,97.219281,3,0
0,0,88,88,27,57,84,414,249,663,0.000333,1.412702,52,220381.5355,12243.41864,4238.106451,460.856693,35,0
0,0,90,90,27,60,87,411,275,686,0.000333,1.473286,52,229832.6804,12768.48224,4419.859238,482.795398,35,0
0,0,79,79,25,50,75,363,238,601,0.000333,1.24784,48,179688.9616,9982.720088,3743.520033,398.289214,31,0
0,0,89,89,27,60,87,405,270,675,0.000333,1.449662,52,226147.3167,12563.73982,4348.98686,482.795398,35,0
0,0,80,80,25,50,75,369,243,612,0.000333,1.270679,48,182977.7779,10165.4321,3812.037039,398.289214,31,0
0,0,89,89,27,54,81,417,266,683,0.000333,1.443373,52,225166.1127,12509.22848,4330.117552,439.145888,38,0
0,0,86,86,27,57,84,408,243,651,0.000333,1.387133,52,216392.7294,12021.8183,4161.398642,460.856693,35,0
0,0,78,78,25,50,75,363,237,600,0.000333,1.245764,48,179389.9783,9966.109905,3737.291214,398.289214,31,0
0,0,77,77,25,50,75,357,232,589,0.000333,1.222925,48,176101.162,9783.39789,3668.774209,398.289214,31,0
0,0,87,87,27,60,87,399,264,663,0.000333,1.423891,52,222126.92,12340.38444,4271.671538,482.795398,35,0
0,0,88,88,27,60,87,405,269,674,0.000333,1.447515,52,225812.2836,12545.12687,4342.543916,482.795398,35,0
0,0,87,87,27,54,81,411,260,671,0.000333,1.418013,52,221210.0463,12289.44702,4254.039352,439.145888,38,0
0,0,89,89,27,57,84,418,252,670,0.000333,1.427618,52,222708.339,12372.6855,4282.852673,460.856693,35,0
0,0,90,90,27,54,81,421,269,690,0.000333,1.458166,52,227473.8181,12637.43434,4374.496502,439.145888,38,0
0,0,91,91,27,60,87,415,278,693,0.000333,1.48832,52,232177.9118,12898.77288,4464.959843,482.795398,35,0
0,0,81,81,25,50,75,373,246,619,0.000333,1.285213,48,185070.6609,10281.70339,3855.638769,398.289214,31,0
0,0,80,80,25,50,75,367,241,608,0.000333,1.262374,48,181781.8447,10098.99137,3787.121764,398.289214,31,0
0,0,90,90,27,60,87,409,273,682,0.000333,1.464696,52,228492.5481,12694.03045,4394.087464,482.795398,35,0
0,0,10,10,11,26,37,50,42,92,0.000333,0.159757,5,2396.348548,133.130475,479.26971,160.26518,5,0
0,0,49,49,22,75,97,269,212,481,0.000333,1.058186,22,69840.2777,3880.015428,3174.558077,565.268897,28,0
0,0,53,53,24,83,107,300,234,534,0.000333,1.199981,24,86398.6409,4799.924494,3599.943371,639.167373,30,0
0,0,35,35,20,51,71,176,153,329,0.000333,0.674422,30,60698.00407,3372.111337,2023.266802,375.732254,18,0
0,0,39,39,22,61,83,207,175,382,0.000333,0.811755,22,53575.83138,2976.435077,2435.265063,459.882473,20,0
0,0,18,18,19,29,48,73,59,132,0.000333,0.245738,18,13269.8709,737.21505,737.21505,221.592072,4,0
0,0,19,19,23,38,61,118,106,224,0.000333,0.442828,22,29226.6736,1623.704089,1328.485164,303.463171,14,0
0,0,19,19,22,33,55,109,94,203,0.000333,0.391205,22,25819.55248,1434.419582,1173.616022,264.572502,9,0
0,0,40,40,27,32,59,202,135,337,0.000333,0.660817,52,103087.4368,5727.079822,1982.450708,288.381963,17,0
0,0,78,78,30,56,86,316,226,542,0.000333,1.161012,60,208982.1298,11610.11832,3483.035497,472.418594,23,0
0,0,78,78,30,56,86,316,226,542,0.000333,1.161012,60,208982.1298,11610.11832,3483.035497,472.418594,23,0
0,0,46,46,19,38,57,185,134,319,0.000333,0.620231,27,50238.68169,2791.037872,1860.691915,280.131868,12,0
0,0,8,8,12,15,27,33,24,57,0.000333,0.090343,6,1626.171526,90.342863,271.028588,101.622909,5,0
0,0,13,13,16,17,33,54,37,91,0.000333,0.153013,16,7344.637838,408.035435,459.039865,133.486868,7,0
0,0,29,29,19,28,47,116,81,197,0.000333,0.364751,18,19696.57207,1094.254004,1094.254004,215.316561,11,0
0,0,29,29,21,28,49,122,82,204,0.000333,0.3818,20,22908.01616,1272.667565,1145.400808,226.844604,12,0
0,0,28,28,20,28,48,114,77,191,0.000333,0.355576,20,21334.55675,1185.253153,1066.727838,221.0445,10,0
0,0,24,24,19,27,46,115,73,188,0.000333,0.346143,18,18691.73366,1038.429648,1038.429648,209.092585,10,0
0,0,22,22,17,26,43,107,68,175,0.000333,0.316532,16,15193.54131,844.085629,949.596332,191.698301,10,0
0,0,41,41,21,50,71,355,199,554,0.000333,1.135653,30,102208.7971,5678.266507,3406.959904,374.431475,15,0
0,0,30,30,20,41,61,254,140,394,0.000333,0.778904,30,70101.31533,3894.517518,2336.710511,306.098194,11,0
0,0,30,30,20,42,62,254,142,396,0.000333,0.785954,30,70735.85217,3929.769565,2357.861739,312.915894,11,0
0,0,30,30,20,40,60,257,140,397,0.000333,0.781679,30,70351.06699,3908.392611,2345.035566,299.315686,11,0
0,0,33,33,23,43,66,286,163,449,0.000333,0.904644,33,89559.78767,4975.543759,2713.93296,337.371309,12,0
0,0,33,33,23,44,67,293,169,462,0.000333,0.934178,33,92483.5958,5137.977544,2802.533206,344.256916,12,0
0,0,33,33,23,43,66,290,167,457,0.000333,0.920763,33,91155.50771,5064.194873,2762.288113,337.371309,12,0
0,0,34,34,23,43,66,289,165,454,0.000333,0.914718,33,90557.1127,5030.950705,2744.15493,337.371309,13,0
0,0,33,33,23,44,67,290,169,459,0.000333,0.928112,33,91883.05297,5104.614054,2784.334938,344.256916,12,0
0,0,33,33,23,42,65,293,167,460,0.000333,0.92343,33,91419.5434,5078.863522,2770.289194,330.519257,12,0
0,0,47,47,23,35,58,419,226,645,0.000333,1.259466,66,249374.251,13854.12505,3778.397742,283.566831,19,0
0,0,51,51,23,40,63,436,233,669,0.000333,1.332933,55,219934.0148,12218.55638,3998.800269,316.919049,20,0
0,0,42,42,26,58,84,337,200,537,0.000333,1.144225,39,133874.3038,7437.461321,3432.674456,461.97433,13,0
0,0,33,33,20,45,65,278,157,435,0.000333,0.873243,30,78591.89996,4366.216664,2619.729999,333.571951,11,0
0,0,33,33,20,48,68,280,161,441,0.000333,0.894857,30,80537.13339,4474.285188,2684.571113,354.516762,11,0
0,0,34,34,20,45,65,281,159,440,0.000333,0.883281,30,79495.25513,4416.403063,2649.841838,333.571951,12,0
0,0,34,34,20,48,68,283,163,446,0.000333,0.905003,30,81450.25282,4525.014045,2715.008427,354.516762,12,0
0,0,60,60,30,39,69,419,256,675,0.000333,1.374418,90,371092.8607,20616.27004,4123.254008,353.337404,37,0
0,0,37,37,29,44,73,272,177,449,0.000333,0.92641,56,155636.9487,8646.49715,2779.231227,381.09644,14,0
0,0,21,21,20,25,45,101,83,184,0.000333,0.336834,30,30315.02909,1684.168283,1010.50097,202.534967,13,0
0,0,46,46,28,39,67,413,205,618,0.000333,1.249614,70,262419.0184,14578.83435,3748.84312,340.736624,13,0
0,0,71,71,29,53,82,426,282,708,0.000333,1.500382,70,315080.2773,17504.45985,4501.146819,444.461233,30,0
0,0,78,78,29,59,88,472,312,784,0.000333,1.688065,70,354493.6072,19694.08929,5064.194389,487.957389,31,0
0,0,60,60,29,49,78,362,241,603,0.000333,1.263366,56,212245.4621,11791.41456,3790.097538,416.002231,26,0
0,0,67,67,29,55,84,408,271,679,0.000333,1.446795,56,243061.4777,13503.41543,4340.38353,458.856233,27,0
0,0,63,63,28,54,82,388,254,642,0.000333,1.360516,56,228566.7097,12698.15054,4081.548387,445.369863,27,0
0,0,63,63,28,53,81,392,256,648,0.000333,1.369408,56,230060.4769,12781.13761,4108.222802,438.185722,27,0
0,0,54,54,26,45,71,315,201,516,0.000333,1.057757,52,165010.0147,9167.223039,3173.269514,369.344822,25,0
0,0,26,26,23,29,52,167,114,281,0.000333,0.533941,33,52860.17751,2936.676528,1601.823561,244.923374,10,0
0,0,28,28,23,29,52,175,120,295,0.000333,0.560543,44,73991.70754,4110.650419,1681.629717,244.923374,10,0
0,0,11,11,21,26,47,92,56,148,0.000333,0.274026,20,16441.583,913.421278,822.07915,214.450099,6,0
0,0,11,11,21,26,47,92,56,148,0.000333,0.274026,20,16441.583,913.421278,822.07915,214.450099,6,0
0,0,49,49,28,36,64,310,179,489,0.000333,0.978,56,164304,9128,2934,320.723238,32,0
0,0,65,65,33,47,80,478,273,751,0.000333,1.582589,80,379821.4399,21101.19111,4747.767999,427.530682,20,0
0,0,82,82,31,58,89,478,330,808,0.000333,1.744131,75,392429.4459,21801.63588,5232.392612,493.342983,33,0
0,0,89,89,33,61,94,530,375,905,0.000333,1.977301,96,569462.6794,31636.81552,5931.902911,528.239984,35,0
0,0,96,96,33,67,100,576,405,981,0.000333,2.172541,96,625691.8005,34760.65559,6517.622922,572.892982,36,0
0,0,53,53,31,49,80,594,356,950,0.000333,2.001944,105,630612.3275,35034.01819,6005.83169,428.700868,23,0
0,0,56,56,33,54,87,498,333,831,0.000333,1.784695,96,513992.2603,28555.12557,5354.086045,477.228931,24,0
0,0,48,48,34,47,81,311,238,549,0.000333,1.160193,85,295849.1004,16436.06113,3480.577652,434.039413,17,0
0,0,50,50,35,47,82,345,264,609,0.000333,1.290583,85,329098.6795,18283.25997,3871.749171,440.590582,23,0
0,0,18,18,15,25,40,103,57,160,0.000333,0.283836,14,11921.11893,662.284385,851.508495,174.699764,7,0
0,0,18,18,15,25,40,104,57,161,0.000333,0.28561,14,11995.62593,666.423663,856.830423,174.699764,7,0
0,0,12,12,14,20,34,63,39,102,0.000333,0.172974,7,3632.448469,201.802693,518.92121,139.741531,9,0
0,0,21,21,18,30,48,95,64,159,0.000333,0.296003,18,15984.16268,888.009038,888.009038,222.265368,11,0
0,0,26,26,22,21,43,111,66,177,0.000333,0.32015,33,31694.81243,1760.822913,960.448862,190.346161,11,0
0,0,10,10,16,20,36,52,41,93,0.000333,0.160268,16,7692.848402,427.380467,480.803025,150.438562,4,0
0,0,10,10,15,21,36,55,45,100,0.000333,0.172331,14,7237.895002,402.105278,516.9925,150.842025,4,0
0,0,13,13,17,21,38,67,53,120,0.000333,0.209917,16,10076.02083,559.778935,629.751302,161.725534,6,0
0,0,10,10,16,21,37,53,43,96,0.000333,0.166703,16,8001.72037,444.540021,500.107523,156.238666,4,0
0,0,13,13,21,23,44,68,55,123,0.000333,0.223837,20,13430.20178,746.122321,671.510089,196.280591,5,0
0,0,13,13,21,25,46,72,60,132,0.000333,0.243037,20,14582.20356,810.12242,729.110178,208.335071,5,0
0,0,13,13,21,24,45,69,56,125,0.000333,0.228827,20,13729.63274,762.757374,686.481637,202.277766,5,0
0,0,13,13,21,23,44,68,54,122,0.000333,0.222017,20,13321.01315,740.056286,666.050657,196.280591,5,0
0,0,13,13,21,25,46,70,58,128,0.000333,0.235672,20,14140.31861,785.573256,707.01593,208.335071,5,0
0,0,48,48,32,35,67,215,133,348,0.000333,0.703666,48,101327.9538,5629.330769,2110.999038,339.524906,17,0
0,0,44,44,29,44,73,206,151,357,0.000333,0.736589,42,92810.22944,5156.123858,2209.767368,381.09644,14,0
0,0,15,15,20,26,46,100,68,168,0.000333,0.309319,20,18559.16817,1031.064898,927.958409,208.649995,7,0
0,0,37,37,30,40,70,186,123,309,0.000333,0.631316,45,85227.68035,4734.871131,1893.948452,360.083842,12,0
0,0,37,37,30,38,68,176,117,293,0.000333,0.594542,45,80263.19756,4459.066531,1783.626612,346.627963,12,0
0,0,49,49,29,48,77,237,168,405,0.000333,0.846016,42,106598.0391,5922.113281,2538.048549,408.959649,16,0
0,0,49,49,29,45,74,227,162,389,0.000333,0.805159,42,101450.0491,5636.113838,2415.477359,388.014838,16,0
0,0,12,12,14,20,34,63,39,102,0.000333,0.172974,7,3632.448469,201.802693,518.92121,139.741531,9,0
0,0,24,24,22,37,59,136,99,235,0.000333,0.460807,22,30413.26457,1689.625809,1382.421117,290.85727,13,0
0,0,23,23,22,37,59,129,96,225,0.000333,0.441198,22,29119.08309,1617.726839,1323.594686,290.85727,12,0
0,0,23,23,22,37,59,129,96,225,0.000333,0.441198,22,29119.08309,1617.726839,1323.594686,290.85727,12,0
0,0,32,32,17,35,52,143,112,255,0.000333,0.484537,24,34886.69108,1938.149504,1453.612128,249.011774,9,0
0,0,26,26,15,34,49,110,91,201,0.000333,0.376186,14,15799.7935,877.766306,1128.556679,231.577096,8,0
0,0,26,26,15,34,49,110,91,201,0.000333,0.376186,14,15799.7935,877.766306,1128.556679,231.577096,8,0
0,0,40,40,22,48,70,179,141,320,0.000333,0.65379,22,43150.15244,2397.230691,1961.370565,366.185696,12,0
0,0,26,26,20,39,59,131,103,234,0.000333,0.458846,20,27530.76947,1529.487193,1376.538474,292.569248,9,0
0,0,26,26,20,39,59,131,103,234,0.000333,0.458846,20,27530.76947,1529.487193,1376.538474,292.569248,9,0
0,0,13,13,19,22,41,79,54,133,0.000333,0.237518,18,12825.9795,712.554417,712.554417,178.818118,6,0
0,0,45,45,24,54,78,249,161,410,0.000333,0.859005,24,61848.35783,3436.01988,2577.01491,420.803025,20,0
0,0,33,33,24,52,76,259,171,430,0.000333,0.895536,36,96717.91791,5373.217662,2686.608831,406.461965,11,0
0,0,19,19,23,34,57,121,86,207,0.000333,0.402469,22,26562.98113,1475.721174,1207.408233,277.015662,7,0
0,0,34,34,24,54,78,255,173,428,0.000333,0.896717,36,96845.47739,5380.304299,2690.15215,420.803025,11,0
0,0,92,92,22,65,87,507,304,811,0.000333,1.741742,44,229909.9957,12772.77754,5225.227175,489.561403,40,0
0,0,15,15,19,26,45,105,76,181,0.000333,0.331342,18,17892.45739,994.02541,994.02541,202.922055,6,0
0,0,23,23,23,37,60,146,103,249,0.000333,0.490272,22,32357.94668,1797.663705,1470.815758,296.7917,9,0
0,0,18,18,22,38,60,144,91,235,0.000333,0.462706,22,30538.62438,1696.590243,1388.11929,297.528741,6,0
0,0,50,50,26,68,94,314,198,512,0.000333,1.11865,26,87254.68679,4847.4826,3355.949492,536.158906,20,0
0,0,38,38,25,65,90,324,208,532,0.000333,1.151222,36,124331.9705,6907.331694,3453.665847,507.550313,11,0
0,0,24,24,25,50,75,186,123,309,0.000333,0.641568,24,46192.91941,2566.2733,1924.704975,398.289214,7,0
0,0,39,39,25,67,92,320,210,530,0.000333,1.152496,36,124469.5621,6914.975673,3457.487837,522.524381,11,0
0,0,97,97,25,78,103,572,341,913,0.000333,2.034925,48,293029.1991,16279.39995,6104.774981,606.357778,40,0
0,0,20,20,22,42,64,170,113,283,0.000333,0.566,22,37356,2075.333333,1698,324.584827,6,0
0,0,28,28,25,53,78,211,140,351,0.000333,0.735392,24,52948.22829,2941.568238,2206.176179,419.676189,9,0
0,0,15,15,22,38,60,137,85,222,0.000333,0.43711,22,28849.25367,1602.736315,1311.329712,297.528741,6,0
0,0,47,47,26,68,94,307,192,499,0.000333,1.090247,26,85039.23576,4724.401987,3270.739837,536.158906,20,0
0,0,35,35,25,65,90,317,202,519,0.000333,1.123091,36,121293.7833,6738.543514,3369.271757,507.550313,11,0
0,0,21,21,25,50,75,179,117,296,0.000333,0.614577,24,44249.52798,2458.30711,1843.730332,398.289214,7,0
0,0,36,36,25,67,92,313,204,517,0.000333,1.124227,36,121416.5351,6745.363063,3372.681531,522.524381,11,0
0,0,94,94,25,78,103,565,335,900,0.000333,2.00595,48,288856.8228,16047.60127,6017.850474,606.357778,40,0
0,0,17,17,22,42,64,163,107,270,0.000333,0.54,22,35640,1980,1620,324.584827,6,0
0,0,25,25,25,53,78,204,134,338,0.000333,0.708155,24,50987.1828,2832.621267,2124.46595,419.676189,9,0
0,0,68,68,27,78,105,442,279,721,0.000333,1.613657,39,188797.8697,10488.77054,4840.971018,618.643336,26,0
0,0,24,24,19,40,59,159,112,271,0.000333,0.531399,18,28695.5328,1594.196266,1594.196266,293.587747,9,0
0,0,18,18,18,36,54,123,87,210,0.000333,0.402842,18,21753.47476,1208.526375,1208.526375,261.17595,7,0
0,0,9,9,13,16,29,70,48,118,0.000333,0.191081,18,10318.35163,573.241757,573.241757,112.105716,3,0
0,0,28,28,19,40,59,185,128,313,0.000333,0.613756,27,49714.21641,2761.900912,1841.267274,293.587747,11,0
0,0,22,22,18,36,54,150,105,255,0.000333,0.489165,18,26414.93364,1467.496313,1467.496313,261.17595,9,0
0,0,82,82,26,82,108,540,324,864,0.000333,1.945408,39,227612.6893,12645.1494,5836.222802,643.530697,33,0
0,0,29,29,19,40,59,186,126,312,0.000333,0.611795,27,49555.38505,2753.076947,1835.384631,293.587747,12,0
0,0,57,57,18,58,76,349,209,558,0.000333,1.162115,27,94131.27592,5229.515329,3486.343553,414.821548,26,0
0,0,43,43,29,69,98,310,188,498,0.000333,1.098042,28,92235.51407,5124.195226,3294.125502,562.369636,22,0
0,0,17,17,29,52,81,182,115,297,0.000333,0.627645,28,52722.19262,2929.010701,1882.935451,437.304314,9,0
0,0,17,17,29,51,80,183,114,297,0.000333,0.625871,28,52573.15404,2920.73078,1877.612644,430.175141,9,0
0,0,22,22,29,52,81,211,135,346,0.000333,0.731196,28,61420.46683,3412.248157,2193.588101,437.304314,11,0
0,0,47,47,31,70,101,402,250,652,0.000333,1.447051,45,195351.9249,10852.88472,4341.153887,582.629897,18,0
0,0,21,21,29,54,83,207,131,338,0.000333,0.718254,28,60333.37318,3351.854065,2154.763328,451.645374,11,0
0,0,66,66,28,78,106,469,279,748,0.000333,1.677495,42,211364.349,11742.46383,5032.4845,624.867311,31,0
0,0,59,59,28,75,103,433,258,691,0.000333,1.540124,42,194055.6183,10780.86768,4620.371864,601.76734,28,0
0,0,57,57,29,49,78,269,157,426,0.000333,0.892527,42,112458.4165,6247.689806,2677.581345,416.002231,34,0
0,0,39,39,23,34,57,183,108,291,0.000333,0.56579,33,56013.24281,3111.846823,1697.370994,277.015662,21,0
0,0,36,36,22,26,48,172,99,271,0.000333,0.504508,33,49946.31964,2774.795536,1513.524838,220.318928,21,0
0,0,29,29,25,35,60,145,116,261,0.000333,0.513899,36,55501.14404,3083.396891,1541.698445,295.62131,14,0
0,0,59,59,27,51,78,267,217,484,0.000333,1.014045,52,158191.003,8788.389058,3042.134674,417.675655,31,0
0,0,51,51,22,51,73,246,201,447,0.000333,0.922284,33,91306.10207,5072.561226,2766.851578,387.401188,29,0
0,0,52,52,24,51,75,258,205,463,0.000333,0.961314,48,138429.2666,7690.51481,2883.943054,399.332792,31,0
0,0,74,74,30,60,90,374,295,669,0.000333,1.447683,60,260582.9833,14476.83241,4343.049721,501.620154,39,0
0,0,66,66,25,60,85,353,279,632,0.000333,1.350245,48,194435.2834,10801.96019,4050.735072,470.50984,37,0
0,0,67,67,26,60,86,365,283,648,0.000333,1.388073,52,216539.4172,12029.96762,4164.219561,476.624868,39,0
0,0,78,78,29,65,94,403,316,719,0.000333,1.570916,56,263913.9655,14661.88697,4712.749384,532.335357,44,0
0,0,70,70,24,65,89,382,300,682,0.000333,1.47215,48,211989.6096,11777.20053,4416.4502,501.493008,42,0
0,0,71,71,25,65,90,394,304,698,0.000333,1.510438,48,217503.0461,12083.50256,4531.313461,507.550313,44,0
0,0,103,103,33,62,95,532,391,923,0.000333,2.021326,96,582141.7657,32341.20921,6063.976726,535.625177,37,0
0,0,102,102,34,73,107,562,412,974,0.000333,2.18873,85,558126.0518,31007.00288,6566.188845,624.830929,37,0
0,0,103,103,34,73,107,567,416,983,0.000333,2.208954,85,563283.274,31293.51523,6626.862048,624.830929,37,0
0,0,60,60,23,46,69,355,249,604,0.000333,1.22985,55,202925.1825,11273.62125,3689.548772,358.125775,27,0
0,0,42,42,21,36,57,195,156,351,0.000333,0.682448,40,81893.7758,4549.654211,2047.344395,278.355966,23,0
0,0,25,25,16,25,41,116,96,212,0.000333,0.3786,24,27259.2246,1514.401367,1135.801025,180.096405,15,0
0,0,30,30,18,30,48,145,118,263,0.000333,0.489615,27,39658.81872,2203.267707,1468.845138,222.265368,20,0
0,0,25,25,16,26,42,115,93,208,0.000333,0.373867,24,26918.44858,1495.469365,1121.602024,186.211433,14,0
0,0,73,73,29,59,88,363,290,653,0.000333,1.406003,56,236208.4954,13122.69419,4218.008847,487.957389,39,0
0,0,65,65,24,59,83,342,274,616,0.000333,1.309008,48,188497.1659,10472.06477,3927.02429,457.11504,37,0
0,0,66,66,25,59,84,354,278,632,0.000333,1.346648,48,193917.3413,10773.18563,4039.944611,463.172345,39,0
0,0,11,11,15,19,34,54,51,105,0.000333,0.178061,14,7478.570377,415.476132,534.183598,139.313982,6,0
0,0,18,18,15,25,40,103,57,160,0.000333,0.283836,14,11921.11893,662.284385,851.508495,174.699764,7,0
0,0,18,18,15,25,40,104,57,161,0.000333,0.28561,14,11995.62593,666.423663,856.830423,174.699764,7,0
0,0,12,12,14,20,34,63,39,102,0.000333,0.172974,7,3632.448469,201.802693,518.92121,139.741531,9,0
0,0,35,35,18,44,62,256,190,446,0.000333,0.885191,36,95600.57596,5311.143109,2655.571554,315.273641,6,0
0,0,36,36,19,44,63,261,194,455,0.000333,0.906554,36,97907.84515,5439.32473,2719.662365,320.925614,7,0
0,0,42,42,16,51,67,269,209,478,0.000333,0.96653,32,92786.90026,5154.827792,2899.590633,353.293692,9,0
0,0,14,14,17,17,34,87,68,155,0.000333,0.262852,32,25233.81569,1401.87865,788.55674,138.973737,5,0
0,0,21,21,20,24,44,124,94,218,0.000333,0.396719,30,35704.68279,1983.593488,1190.156093,196.477662,8,0
0,0,19,19,23,24,47,118,89,207,0.000333,0.383267,33,37943.39645,2107.966469,1149.799892,214.081025,7,0
0,0,20,20,26,27,53,128,92,220,0.000333,0.420048,39,49145.5575,2730.30875,1260.1425,250.593395,8,0
0,0,19,19,19,25,44,101,78,179,0.000333,0.325746,27,26385.43301,1465.85739,977.23826,196.807027,6,0
0,0,12,12,14,17,31,76,57,133,0.000333,0.219636,21,13837.0703,768.726127,658.908109,122.789837,4,0
0,0,12,12,14,19,33,74,56,130,0.000333,0.21859,14,9180.797297,510.044294,655.771236,134.013592,4,0
0,0,13,13,14,17,31,76,55,131,0.000333,0.216333,21,13628.99405,757.166336,648.999717,122.789837,5,0
0,0,12,12,13,18,31,75,57,132,0.000333,0.217985,18,11771.17043,653.953913,653.953913,123.164366,4,0
0,0,25,25,25,30,55,167,132,299,0.000333,0.576209,48,82974.07461,4609.670812,1728.626554,263.303123,24,0
0,0,10,10,12,15,27,57,45,102,0.000333,0.161666,18,8729.973454,484.998525,484.998525,101.622909,3,0
0,0,14,14,14,23,37,93,71,164,0.000333,0.284783,21,17941.35739,996.742077,854.350352,157.344894,4,0
0,0,14,14,15,24,39,93,72,165,0.000333,0.290697,21,18313.91869,1017.439927,872.091366,168.642459,4,0
0,0,14,14,15,22,37,86,67,153,0.000333,0.265682,21,16737.97366,929.887426,797.046365,156.710855,4,0
0,0,14,14,15,20,35,85,69,154,0.000333,0.263303,21,16588.10128,921.561182,789.909585,145.041921,4,0
0,0,31,31,23,43,66,167,132,299,0.000333,0.602425,33,59640.03678,3313.335376,1807.273842,337.371309,9,0
0,0,30,30,22,38,60,155,118,273,0.000333,0.537527,33,53215.17738,2956.398743,1612.581133,297.528741,9,0
0,0,30,30,23,40,63,160,123,283,0.000333,0.563857,33,55821.81721,3101.212067,1691.570218,316.919049,9,0
0,0,14,14,14,18,32,91,69,160,0.000333,0.266667,21,16800,933.333333,800,128.361619,4,0
0,0,14,14,14,22,36,90,70,160,0.000333,0.275729,21,17370.94801,965.052667,827.188,151.410465,4,0
0,0,14,14,14,23,37,90,71,161,0.000333,0.279574,21,17613.16183,978.508991,838.721992,157.344894,4,0
0,0,14,14,14,20,34,90,69,159,0.000333,0.269636,21,16987.03843,943.724357,808.906592,139.741531,4,0
0,0,14,14,14,22,36,90,70,160,0.000333,0.275729,21,17370.94801,965.052667,827.188,151.410465,4,0
0,0,14,14,14,23,37,90,71,161,0.000333,0.279574,21,17613.16183,978.508991,838.721992,157.344894,4,0
0,0,14,14,14,23,37,93,71,164,0.000333,0.284783,21,17941.35739,996.742077,854.350352,157.344894,4,0
0,0,14,14,15,24,39,93,72,165,0.000333,0.290697,21,18313.91869,1017.439927,872.091366,168.642459,4,0
0,0,14,14,14,23,37,93,71,164,0.000333,0.284783,21,17941.35739,996.742077,854.350352,157.344894,4,0
0,0,14,14,15,24,39,93,72,165,0.000333,0.290697,21,18313.91869,1017.439927,872.091366,168.642459,4,0
0,0,14,14,14,22,36,89,69,158,0.000333,0.272283,21,17153.81116,952.989509,816.84815,151.410465,4,0
0,0,14,14,15,23,38,89,70,159,0.000333,0.27814,21,17522.82997,973.490554,834.420475,162.645284,4,0
0,0,14,14,14,22,36,89,69,158,0.000333,0.272283,21,17153.81116,952.989509,816.84815,151.410465,4,0
0,0,14,14,15,23,38,89,70,159,0.000333,0.27814,21,17522.82997,973.490554,834.420475,162.645284,4,0
0,0,14,14,14,23,37,93,71,164,0.000333,0.284783,21,17941.35739,996.742077,854.350352,157.344894,4,0
0,0,14,14,15,24,39,93,72,165,0.000333,0.290697,21,18313.91869,1017.439927,872.091366,168.642459,4,0
0,0,14,14,14,23,37,85,67,152,0.000333,0.263946,14,11085.71676,615.873153,791.836912,157.344894,4,0
0,0,14,14,14,21,35,84,69,153,0.000333,0.261593,21,16480.38633,915.577019,784.780302,145.541635,4,0
0,0,31,31,23,42,65,166,132,298,0.000333,0.598222,33,59223.96507,3290.220282,1794.665608,330.519257,9,0
0,0,30,30,22,37,59,154,118,272,0.000333,0.53336,33,52802.60401,2933.478001,1600.078909,290.85727,9,0
0,0,30,30,23,39,62,159,123,282,0.000333,0.559694,33,55409.75086,3078.319492,1679.08336,310.172612,9,0
0,0,13,13,13,14,27,67,51,118,0.000333,0.187026,18,10099.38106,561.076725,561.076725,101.408685,4,0
0,0,16,16,15,22,37,92,70,162,0.000333,0.28131,21,17722.56035,984.586686,843.931445,156.710855,6,0
0,0,14,14,17,21,38,86,65,151,0.000333,0.264146,24,19018.48931,1056.582739,792.437055,161.725534,5,0
0,0,15,15,20,25,45,96,68,164,0.000333,0.300221,20,18013.27816,1000.737675,900.663908,202.534967,6,0
0,0,19,19,23,26,49,128,107,235,0.000333,0.439819,44,58056.09979,3225.338877,1319.456813,226.253358,22,0
0,0,16,16,22,21,43,88,79,167,0.000333,0.302062,33,29904.14506,1661.341392,906.186214,190.346161,11,0
0,0,17,17,22,25,47,119,98,217,0.000333,0.401782,33,39776.41077,2209.800598,1205.345781,214.2039,20,0
0,0,24,24,24,28,52,160,125,285,0.000333,0.541542,48,77982.01534,4332.334186,1624.62532,244.645038,22,0
0,0,20,20,22,27,49,147,113,260,0.000333,0.486608,44,64232.28062,3568.460034,1459.824559,226.489458,19,0
0,0,33,33,20,33,53,188,148,336,0.000333,0.641527,40,76983.25091,4276.847273,1924.581273,252.903568,17,0
0,0,49,49,23,35,58,259,199,458,0.000333,0.894318,55,147562.5413,8197.918959,2682.955296,283.566831,23,0
0,0,44,44,20,34,54,231,175,406,0.000333,0.778828,50,116824.2163,6490.234239,2336.484326,259.412299,23,0
0,0,61,61,23,37,60,298,227,525,0.000333,1.033706,66,204673.7591,11370.7644,3101.117563,296.7917,29,0
0,0,32,32,22,33,55,176,138,314,0.000333,0.605116,44,79875.2658,4437.514767,1815.34695,264.572502,15,0
0,0,32,32,22,33,55,179,141,320,0.000333,0.616678,44,81401.54477,4522.308043,1850.035108,264.572502,14,0
0,0,37,37,24,34,58,223,164,387,0.000333,0.75568,48,108817.855,6045.436387,2267.038645,283.012837,19,0
0,0,34,34,24,34,58,206,156,362,0.000333,0.706863,48,101788.2778,5654.904321,2120.58912,283.012837,17,0
0,0,32,32,22,33,55,179,141,320,0.000333,0.616678,44,81401.54477,4522.308043,1850.035108,264.572502,14,0
0,0,32,32,22,34,56,182,142,324,0.000333,0.627194,44,82789.65177,4599.425098,1881.582995,271.081232,16,0
0,0,44,44,27,42,69,280,221,501,0.000333,1.020124,65,198924.0989,11051.33883,3060.370753,354.859294,35,0
0,0,35,35,22,34,56,188,153,341,0.000333,0.660103,44,87133.55325,4840.752958,1980.308028,271.081232,14,0
0,0,43,43,23,51,74,244,199,443,0.000333,0.916929,33,90775.99875,5043.111042,2750.787841,393.335617,20,0
0,0,34,34,21,34,55,184,150,334,0.000333,0.643658,40,77238.96577,4291.053654,1930.974144,265.212402,14,0
0,0,34,34,21,33,54,184,150,334,0.000333,0.640711,40,76885.29703,4271.40539,1922.132426,258.703672,14,0
0,0,36,36,22,34,56,194,156,350,0.000333,0.677525,44,89433.2658,4968.514767,2032.574223,271.081232,14,0
0,0,35,35,22,33,55,189,152,341,0.000333,0.657148,44,86743.52114,4819.084508,1971.443662,264.572502,14,0
0,0,44,44,24,51,75,250,202,452,0.000333,0.938475,36,101355.3377,5630.852096,2815.426048,399.332792,20,0
0,0,35,35,22,33,55,189,152,341,0.000333,0.657148,44,86743.52114,4819.084508,1971.443662,264.572502,14,0
0,0,35,35,22,33,55,187,152,339,0.000333,0.653294,44,86234.76149,4790.820083,1959.880943,264.572502,14,0
0,0,34,34,20,32,52,182,148,330,0.000333,0.627048,40,75245.80428,4180.32246,1881.145107,246.438562,14,0
0,0,43,43,23,50,73,243,198,441,0.000333,0.909904,33,90080.51681,5004.473156,2729.71263,386.234734,20,0
0,0,34,34,20,32,52,182,148,330,0.000333,0.627048,40,75245.80428,4180.32246,1881.145107,246.438562,14,0
0,0,36,36,22,34,56,194,156,350,0.000333,0.677525,44,89433.2658,4968.514767,2032.574223,271.081232,14,0
0,0,44,44,24,51,75,250,202,452,0.000333,0.938475,36,101355.3377,5630.852096,2815.426048,399.332792,20,0
0,0,35,35,22,34,56,190,153,343,0.000333,0.663974,44,87644.60048,4869.144471,1991.922738,271.081232,14,0
0,0,35,35,22,33,55,190,153,343,0.000333,0.661002,44,87252.2808,4847.348933,1983.006382,264.572502,14,0
0,0,45,45,21,39,60,235,187,422,0.000333,0.830903,40,99708.31325,5539.350736,2492.707831,298.369352,19,0
0,0,47,47,23,35,58,243,186,429,0.000333,0.837691,55,138219.0616,7678.836754,2513.073847,283.566831,23,0
0,0,42,42,20,34,54,215,162,377,0.000333,0.723198,40,86783.70353,4821.316863,2169.592588,259.412299,23,0
0,0,59,59,23,37,60,282,214,496,0.000333,0.976606,55,161139.9754,8952.220858,2929.817735,296.7917,29,0
0,0,30,30,22,33,55,160,125,285,0.000333,0.549229,33,54373.68811,3020.76045,1647.687518,264.572502,15,0
0,0,30,30,22,33,55,163,128,291,0.000333,0.560792,33,55518.39733,3084.355407,1682.375677,264.572502,14,0
0,0,35,35,24,34,58,207,151,358,0.000333,0.699052,48,100663.5454,5592.41919,2097.157196,283.012837,19,0
0,0,32,32,24,34,58,190,143,333,0.000333,0.650236,48,93633.96823,5201.887124,1950.707671,283.012837,17,0
0,0,30,30,22,33,55,163,128,291,0.000333,0.560792,33,55518.39733,3084.355407,1682.375677,264.572502,14,0
0,0,30,30,22,34,56,166,129,295,0.000333,0.571057,33,56534.60017,3140.81112,1713.169702,271.081232,16,0
0,0,42,42,27,42,69,264,208,472,0.000333,0.961075,52,149927.6243,8329.312459,2883.223544,354.859294,35,0
0,0,33,33,22,34,56,172,140,312,0.000333,0.603965,44,79723.36837,4429.076021,1811.894736,271.081232,14,0
0,0,41,41,23,51,74,228,186,414,0.000333,0.856905,33,84833.55188,4712.975105,2570.713693,393.335617,20,0
0,0,32,32,21,34,55,168,137,305,0.000333,0.587772,40,70532.58851,3918.477139,1763.314713,265.212402,14,0
0,0,32,32,21,33,54,168,137,305,0.000333,0.58508,40,70209.62753,3900.534863,1755.240688,258.703672,14,0
0,0,34,34,22,34,56,178,143,321,0.000333,0.621387,44,82023.08092,4556.837829,1864.16093,271.081232,14,0
0,0,33,33,22,33,55,173,139,312,0.000333,0.601261,44,79366.50615,4409.250342,1803.784231,264.572502,14,0
0,0,42,42,24,51,75,234,189,423,0.000333,0.878263,36,94852.45102,5269.580612,2634.790306,399.332792,20,0
0,0,33,33,22,33,55,173,139,312,0.000333,0.601261,44,79366.50615,4409.250342,1803.784231,264.572502,14,0
0,0,33,33,22,33,55,171,139,310,0.000333,0.597407,44,78857.74649,4380.985916,1792.221511,264.572502,14,0
0,0,32,32,20,32,52,166,135,301,0.000333,0.571944,40,68633.29421,3812.960789,1715.832355,246.438562,14,0
0,0,41,41,23,50,73,227,185,412,0.000333,0.850069,33,84156.8547,4675.380817,2550.207718,386.234734,20,0
0,0,32,32,20,32,52,166,135,301,0.000333,0.571944,40,68633.29421,3812.960789,1715.832355,246.438562,14,0
0,0,34,34,22,34,56,178,143,321,0.000333,0.621387,44,82023.08092,4556.837829,1864.16093,271.081232,14,0
0,0,42,42,24,51,75,234,189,423,0.000333,0.878263,36,94852.45102,5269.580612,2634.790306,399.332792,20,0
0,0,33,33,22,34,56,174,140,314,0.000333,0.607836,44,80234.4156,4457.467534,1823.509446,271.081232,14,0
0,0,33,33,22,33,55,174,140,314,0.000333,0.605116,44,79875.2658,4437.514767,1815.34695,264.572502,14,0
0,0,4,4,9,11,20,35,23,58,0.000333,0.083557,8,2005.374636,111.409702,250.67183,66.583073,1,0
0,0,23,23,17,22,39,104,81,185,0.000333,0.325933,24,23467.18585,1303.732547,977.79941,167.594364,11,0
0,0,75,75,25,44,69,366,279,645,0.000333,1.313333,72,283679.8758,15759.9931,3939.998275,356.311396,31,0
0,0,61,61,22,42,64,310,236,546,0.000333,1.092,55,180180,10010,3276,324.584827,25,0
0,0,59,59,22,42,64,297,225,522,0.000333,1.044,55,172260,9570,3132,324.584827,25,0
0,0,32,32,19,35,54,179,147,326,0.000333,0.625364,36,67539.35973,3752.186651,1876.093326,260.235528,16,0
0,0,29,29,19,30,49,160,127,287,0.000333,0.537141,36,58011.18211,3222.843451,1611.421725,227.917341,14,0
0,0,27,27,19,29,48,155,125,280,0.000333,0.521263,36,56296.42201,3127.579,1563.7895,221.592072,13,0
0,0,48,48,24,40,64,250,198,448,0.000333,0.896,48,129024,7168,2688,322.916224,22,0
0,0,41,41,26,42,68,261,208,469,0.000333,0.951673,52,148461.0438,8247.835765,2855.020073,348.688764,34,0
0,0,23,23,17,37,54,209,155,364,0.000333,0.69826,32,67032.92963,3724.051646,2094.779051,262.236643,5,0
0,0,26,26,16,36,52,197,152,349,0.000333,0.663151,32,63662.51077,3536.806154,1989.453462,250.1173,6,0
0,0,24,24,15,28,43,115,92,207,0.000333,0.374412,21,23587.97289,1310.442938,1123.236804,193.209297,6,0
0,0,22,22,15,27,42,110,86,196,0.000333,0.352298,21,22194.77851,1233.043251,1056.894215,186.985321,6,0
0,0,21,21,15,27,42,109,84,193,0.000333,0.346906,21,21855.06252,1214.17014,1040.717263,186.985321,6,0
0,0,19,19,15,25,40,107,79,186,0.000333,0.32996,21,20787.45114,1154.858397,989.878626,174.699764,6,0
0,0,24,24,21,31,52,135,100,235,0.000333,0.446534,30,40188.10001,2232.672223,1339.603334,245.818752,9,0
0,0,22,22,20,31,51,125,94,219,0.000333,0.414087,30,37267.8345,2070.43525,1242.26115,240.018648,8,0
0,0,21,21,21,26,47,140,107,247,0.000333,0.457328,40,54879.33786,3048.852103,1371.983446,214.450099,8,0
0,0,28,28,21,33,54,177,133,310,0.000333,0.594672,40,71360.60503,3964.478057,1784.015126,258.703672,11,0
0,0,13,13,22,21,43,75,59,134,0.000333,0.242373,22,15996.6285,888.701583,727.119477,190.346161,5,0
0,0,14,14,26,24,50,85,62,147,0.000333,0.276549,26,21570.81836,1198.378798,829.64686,232.250533,6,0
0,0,19,19,18,26,44,105,85,190,0.000333,0.345764,27,28006.8842,1555.938011,1037.292008,197.270083,8,0
0,0,35,35,22,29,51,176,136,312,0.000333,0.589932,44,77871.0551,4326.169727,1769.796707,238.988944,14,0
0,0,30,30,19,28,47,148,112,260,0.000333,0.481398,36,51990.95165,2888.386203,1444.193101,215.316561,14,0
0,0,47,47,22,33,55,215,164,379,0.000333,0.730378,44,96409.95458,5356.108588,2191.135331,264.572502,20,0
0,0,18,18,21,26,47,93,75,168,0.000333,0.311057,20,18663.41854,1036.856586,933.170927,214.450099,6,0
0,0,18,18,21,26,47,96,78,174,0.000333,0.322166,30,28994.95381,1610.830767,966.49846,214.450099,5,0
0,0,23,23,24,28,52,140,101,241,0.000333,0.457935,36,49457.015,2747.611944,1373.805972,244.645038,10,0
0,0,20,20,24,28,52,123,93,216,0.000333,0.410432,36,44326.61925,2462.589958,1231.294979,244.645038,8,0
0,0,18,18,21,26,47,96,78,174,0.000333,0.322166,30,28994.95381,1610.830767,966.49846,214.450099,5,0
0,0,18,18,21,27,48,99,79,178,0.000333,0.331374,20,19882.4665,1104.581472,994.123325,220.620628,7,0
0,0,30,30,26,37,63,197,158,355,0.000333,0.707311,52,110340.5874,6130.032633,2121.934373,314.961207,26,0
0,0,21,21,21,27,48,105,90,195,0.000333,0.363023,30,32672.03063,1815.112813,1089.067688,220.620628,5,0
0,0,29,29,23,45,68,161,136,297,0.000333,0.602659,33,59663.22331,3314.623517,1807.976464,351.175314,11,0
0,0,20,20,20,27,47,101,87,188,0.000333,0.348088,30,31327.88112,1740.43784,1044.262704,214.820524,5,0
0,0,20,20,20,26,46,101,87,188,0.000333,0.346143,30,31152.88943,1730.71608,1038.429648,208.649995,5,0
0,0,22,22,21,27,48,111,93,204,0.000333,0.379777,30,34179.9705,1898.88725,1139.33235,220.620628,5,0
0,0,21,21,21,26,47,106,89,195,0.000333,0.361048,30,32494.34478,1805.241377,1083.144826,214.450099,5,0
0,0,30,30,24,45,69,167,139,306,0.000333,0.623069,36,67291.50542,3738.416968,1869.208484,357.172489,11,0
0,0,21,21,21,26,47,106,89,195,0.000333,0.361048,30,32494.34478,1805.241377,1083.144826,214.450099,5,0
0,0,21,21,21,26,47,104,89,193,0.000333,0.357345,30,32161.06945,1786.726081,1072.035648,214.450099,5,0
0,0,20,20,19,25,44,99,85,184,0.000333,0.334845,27,27122.45628,1506.803127,1004.535418,196.807027,5,0
0,0,29,29,23,44,67,160,135,295,0.000333,0.596499,33,59053.37827,3280.743237,1789.496311,344.256916,11,0
0,0,20,20,19,25,44,99,85,184,0.000333,0.334845,27,27122.45628,1506.803127,1004.535418,196.807027,5,0
0,0,22,22,21,27,48,111,93,204,0.000333,0.379777,30,34179.9705,1898.88725,1139.33235,220.620628,5,0
0,0,30,30,24,45,69,167,139,306,0.000333,0.623069,36,67291.50542,3738.416968,1869.208484,357.172489,11,0
0,0,21,21,21,27,48,107,90,197,0.000333,0.366746,30,33007.12838,1833.729354,1100.237613,220.620628,5,0
0,0,21,21,21,26,47,107,90,197,0.000333,0.364751,30,32827.62011,1823.756673,1094.254004,214.450099,5,0
0,0,20,20,18,27,45,111,90,201,0.000333,0.367954,27,29804.28675,1655.793709,1103.862472,203.440613,10,0
0,0,36,36,22,29,51,182,141,323,0.000333,0.610731,44,80616.50896,4478.694942,1832.193385,238.988944,16,0
0,0,31,31,19,29,48,154,117,271,0.000333,0.504508,36,54486.89416,3027.049675,1513.524838,221.592072,16,0
0,0,48,48,22,33,55,221,169,390,0.000333,0.751577,55,124010.1659,6889.453659,2254.730288,264.572502,22,0
0,0,19,19,21,27,48,99,80,179,0.000333,0.333236,20,19994.16575,1110.786986,999.708288,220.620628,8,0
0,0,19,19,21,27,48,102,83,185,0.000333,0.344406,30,30996.54188,1722.030104,1033.218063,220.620628,7,0
0,0,24,24,24,29,53,146,106,252,0.000333,0.481145,36,51963.69436,2886.871909,1443.435955,250.920549,12,0
0,0,21,21,24,29,53,129,98,227,0.000333,0.433413,36,46808.56596,2600.475886,1300.237943,250.920549,10,0
0,0,19,19,21,27,48,102,83,185,0.000333,0.344406,30,30996.54188,1722.030104,1033.218063,220.620628,7,0
0,0,19,19,21,28,49,105,84,189,0.000333,0.353727,30,31835.40482,1768.633601,1061.180161,226.844604,9,0
0,0,31,31,26,38,64,203,163,366,0.000333,0.732,52,114192,6344,2196,321.632678,28,0
0,0,22,22,21,28,49,111,95,206,0.000333,0.385543,30,34698.90684,1927.717046,1156.630228,226.844604,7,0
0,0,30,30,23,46,69,167,141,308,0.000333,0.627142,33,62087.04258,3449.280143,1881.425533,358.125775,13,0
0,0,21,21,20,28,48,107,92,199,0.000333,0.370469,30,33342.22613,1852.345896,1111.407538,221.0445,7,0
0,0,21,21,20,27,47,107,92,199,0.000333,0.368454,30,33160.89545,1842.271969,1105.363181,214.820524,7,0
0,0,23,23,21,28,49,117,98,215,0.000333,0.402388,30,36214.8785,2011.937694,1207.162616,226.844604,7,0
0,0,22,22,21,27,48,112,94,206,0.000333,0.383501,30,34515.06825,1917.503792,1150.502275,220.620628,7,0
0,0,31,31,24,46,70,173,144,317,0.000333,0.647661,36,69947.37779,3885.965433,1942.982716,364.12295,13,0
0,0,22,22,21,27,48,112,94,206,0.000333,0.383501,30,34515.06825,1917.503792,1150.502275,220.620628,7,0
0,0,22,22,21,27,48,110,94,204,0.000333,0.379777,30,34179.9705,1898.88725,1139.33235,220.620628,7,0
0,0,21,21,19,26,45,105,90,195,0.000333,0.35697,27,28914.60655,1606.367031,1070.911354,202.922055,7,0
0,0,30,30,23,45,68,166,140,306,0.000333,0.620921,33,61471.19977,3415.066654,1862.763629,351.175314,13,0
0,0,21,21,19,26,45,105,90,195,0.000333,0.35697,27,28914.60655,1606.367031,1070.911354,202.922055,7,0
0,0,23,23,21,28,49,117,98,215,0.000333,0.402388,30,36214.8785,2011.937694,1207.162616,226.844604,7,0
0,0,31,31,24,46,70,173,144,317,0.000333,0.647661,36,69947.37779,3885.965433,1942.982716,364.12295,13,0
0,0,22,22,21,28,49,113,95,208,0.000333,0.389287,30,35035.78943,1946.432746,1167.859648,226.844604,7,0
0,0,22,22,21,27,48,113,95,208,0.000333,0.387224,30,34850.16601,1936.120334,1161.6722,220.620628,7,0
0,0,24,24,16,30,46,127,76,203,0.000333,0.373761,16,17940.52923,996.696069,1121.283077,211.206718,12,0
0,0,30,30,17,50,67,283,155,438,0.000333,0.885649,24,63766.72957,3542.596087,2656.947065,351.679678,16,0
0,0,12,12,14,20,34,63,39,102,0.000333,0.172974,7,3632.448469,201.802693,518.92121,139.741531,9,0
0,0,21,21,17,29,46,94,63,157,0.000333,0.289066,16,13875.18763,770.843757,867.199227,210.368317,11,0
0,0,18,18,15,25,40,103,57,160,0.000333,0.283836,14,11921.11893,662.284385,851.508495,174.699764,7,0
0,0,18,18,15,25,40,104,57,161,0.000333,0.28561,14,11995.62593,666.423663,856.830423,174.699764,7,0
0,0,9,9,20,36,56,139,88,227,0.000333,0.439423,20,26365.39135,1464.743964,1318.269567,272.555862,3,0
0,0,62,62,30,39,69,447,277,724,0.000333,1.474191,105,464370.0292,25798.33496,4422.571707,353.337404,39,0
0,0,78,78,29,59,88,472,312,784,0.000333,1.688065,70,354493.6072,19694.08929,5064.194389,487.957389,31,0
0,0,71,71,29,53,82,426,282,708,0.000333,1.500382,70,315080.2773,17504.45985,4501.146819,444.461233,30,0
0,0,67,67,29,55,84,408,271,679,0.000333,1.446795,56,243061.4777,13503.41543,4340.38353,458.856233,27,0
0,0,60,60,29,49,78,362,241,603,0.000333,1.263366,56,212245.4621,11791.41456,3790.097538,416.002231,26,0
0,0,63,63,28,54,82,388,254,642,0.000333,1.360516,56,228566.7097,12698.15054,4081.548387,445.369863,27,0
0,0,63,63,28,53,81,392,256,648,0.000333,1.369408,56,230060.4769,12781.13761,4108.222802,438.185722,27,0
0,0,54,54,26,45,71,315,201,516,0.000333,1.057757,52,165010.0147,9167.223039,3173.269514,369.344822,25,0
0,0,51,51,28,36,64,338,200,538,0.000333,1.076,70,225960,12553.33333,3228,320.723238,34,0
0,0,82,82,31,58,89,478,330,808,0.000333,1.744131,75,392429.4459,21801.63588,5232.392612,493.342983,33,0
0,0,96,96,33,67,100,576,405,981,0.000333,2.172541,96,625691.8005,34760.65559,6517.622922,572.892982,36,0
0,0,89,89,33,61,94,530,375,905,0.000333,1.977301,96,569462.6794,31636.81552,5931.902911,528.239984,35,0
0,0,44,44,28,35,63,229,120,349,0.000333,0.695357,42,87614.96912,4867.498284,2086.070693,314.130843,26,0
0,0,60,60,30,39,69,419,256,675,0.000333,1.374418,90,371092.8607,20616.27004,4123.254008,353.337404,37,0
0,0,37,37,29,44,73,272,177,449,0.000333,0.92641,56,155636.9487,8646.49715,2779.231227,381.09644,14,0
0,0,21,21,20,25,45,100,81,181,0.000333,0.331342,30,29820.76231,1656.709017,994.02541,202.534967,13,0
0,0,46,46,28,39,67,413,205,618,0.000333,1.249614,70,262419.0184,14578.83435,3748.84312,340.736624,13,0
0,0,78,78,29,59,88,472,312,784,0.000333,1.688065,70,354493.6072,19694.08929,5064.194389,487.957389,31,0
0,0,71,71,29,53,82,426,282,708,0.000333,1.500382,70,315080.2773,17504.45985,4501.146819,444.461233,30,0
0,0,67,67,29,55,84,408,271,679,0.000333,1.446795,56,243061.4777,13503.41543,4340.38353,458.856233,27,0
0,0,60,60,29,49,78,362,241,603,0.000333,1.263366,56,212245.4621,11791.41456,3790.097538,416.002231,26,0
0,0,63,63,28,54,82,388,254,642,0.000333,1.360516,56,228566.7097,12698.15054,4081.548387,445.369863,27,0
0,0,63,63,28,53,81,392,256,648,0.000333,1.369408,56,230060.4769,12781.13761,4108.222802,438.185722,27,0
0,0,54,54,26,45,71,315,201,516,0.000333,1.057757,52,165010.0147,9167.223039,3173.269514,369.344822,25,0
0,0,26,26,23,29,52,167,114,281,0.000333,0.533941,33,52860.17751,2936.676528,1601.823561,244.923374,10,0
0,0,28,28,23,29,52,175,120,295,0.000333,0.560543,44,73991.70754,4110.650419,1681.629717,244.923374,10,0
0,0,11,11,21,26,47,92,56,148,0.000333,0.274026,20,16441.583,913.421278,822.07915,214.450099,6,0
0,0,11,11,21,26,47,92,56,148,0.000333,0.274026,20,16441.583,913.421278,822.07915,214.450099,6,0
0,0,49,49,28,36,64,310,179,489,0.000333,0.978,56,164304,9128,2934,320.723238,32,0
0,0,65,65,33,47,80,478,273,751,0.000333,1.582589,80,379821.4399,21101.19111,4747.767999,427.530682,20,0
0,0,82,82,31,58,89,478,330,808,0.000333,1.744131,75,392429.4459,21801.63588,5232.392612,493.342983,33,0
0,0,50,50,35,47,82,345,264,609,0.000333,1.290583,85,329098.6795,18283.25997,3871.749171,440.590582,23,0
0,0,48,48,34,47,81,311,238,549,0.000333,1.160193,85,295849.1004,16436.06113,3480.577652,434.039413,17,0
0,0,96,96,33,67,100,576,405,981,0.000333,2.172541,96,625691.8005,34760.65559,6517.622922,572.892982,36,0
0,0,89,89,33,61,94,530,375,905,0.000333,1.977301,96,569462.6794,31636.81552,5931.902911,528.239984,35,0
0,0,56,56,33,54,87,498,333,831,0.000333,1.784695,96,513992.2603,28555.12557,5354.086045,477.228931,24,0
0,0,53,53,31,49,80,594,356,950,0.000333,2.001944,105,630612.3275,35034.01819,6005.83169,428.700868,23,0
0,0,12,12,14,20,34,63,39,102,0.000333,0.172974,7,3632.448469,201.802693,518.92121,139.741531,9,0
0,0,5,5,11,12,23,27,21,48,0.000333,0.072377,5,1085.654869,60.314159,217.130974,81.073298,2,0
0,0,57,57,31,46,77,409,237,646,0.000333,1.349448,75,303625.8079,16868.10044,4048.344105,407.663936,35,0
0,0,35,35,30,42,72,236,170,406,0.000333,0.834997,60,150299.373,8349.965169,2504.989551,373.68405,21,0
0,0,41,41,31,44,75,283,199,482,0.000333,1.000764,60,180137.4365,10007.63536,3002.290609,393.795077,25,0
0,0,68,68,30,62,92,493,297,790,0.000333,1.717871,60,309216.8367,17178.71315,5153.613945,516.366889,43,0
0,0,35,35,27,40,67,243,144,387,0.000333,0.782526,39,91555.48415,5086.415786,2347.576517,341.259086,27,0
0,0,25,25,24,27,51,168,110,278,0.000333,0.525645,48,75692.84376,4205.157987,1576.934245,238.421063,14,0
0,0,21,21,23,27,50,141,94,235,0.000333,0.442102,33,43768.10475,2431.561375,1326.306205,232.423888,10,0
0,0,18,18,25,27,52,144,95,239,0.000333,0.454135,36,49046.58334,2724.810185,1362.405093,244.478367,13,0
0,0,18,18,25,27,52,144,94,238,0.000333,0.452235,36,48841.36751,2713.409306,1356.704653,244.478367,13,0
0,0,20,20,25,27,52,155,101,256,0.000333,0.486438,36,52535.25244,2918.625136,1459.312568,244.478367,14,0
0,0,18,18,25,27,52,144,95,239,0.000333,0.454135,36,49046.58334,2724.810185,1362.405093,244.478367,13,0
0,0,23,23,24,27,51,158,105,263,0.000333,0.497283,36,53706.52314,2983.69573,1491.847865,238.421063,13,0
0,0,42,42,29,58,87,311,190,501,0.000333,1.075972,42,135572.417,7531.800947,3227.914691,480.644347,27,0
0,0,41,41,27,49,76,292,176,468,0.000333,0.974677,39,114037.173,6335.398499,2924.030076,403.502745,27,0
0,0,41,41,27,49,76,292,176,468,0.000333,0.974677,39,114037.173,6335.398499,2924.030076,403.502745,27,0
0,0,20,20,25,42,67,166,108,274,0.000333,0.554036,24,39890.60252,2216.144584,1662.108438,342.573737,7,0
0,0,63,63,29,50,79,463,283,746,0.000333,1.56754,70,329183.4307,18287.96837,4702.620438,423.074258,31,0
0,0,25,25,20,51,71,126,99,225,0.000333,0.461231,10,13836.93102,768.71839,1383.693102,375.732254,9,0
0,0,22,22,18,48,66,114,83,197,0.000333,0.396915,9,10716.71077,595.372821,1190.745642,343.13685,9,0
0,0,22,22,18,48,66,114,83,197,0.000333,0.396915,9,10716.71077,595.372821,1190.745642,343.13685,9,0
0,0,32,32,17,21,38,149,63,212,0.000333,0.370854,24,26701.45519,1483.414177,1112.560633,161.725534,14,0
0,0,90,90,27,57,84,422,254,676,0.000333,1.440402,52,224702.742,12483.48567,4321.206578,460.856693,35,0
0,0,82,82,25,50,75,377,248,625,0.000333,1.297671,48,186864.5607,10381.36448,3893.011682,398.289214,31,0
0,0,81,81,25,50,75,371,243,614,0.000333,1.274832,48,183575.7444,10198.65247,3824.494676,398.289214,31,0
0,0,91,91,27,54,81,425,271,696,0.000333,1.470845,65,286814.8141,15934.15634,4412.535602,439.145888,38,0
0,0,91,91,27,60,87,413,275,688,0.000333,1.477582,52,230502.7465,12805.70814,4432.745125,482.795398,35,0
0,0,41,41,25,39,64,155,117,272,0.000333,0.544,36,58752,3264,1632,322.227091,15,0
0,0,92,92,27,60,87,419,280,699,0.000333,1.501206,52,234188.1102,13010.45057,4503.617504,482.795398,35,0
0,0,42,42,25,39,64,161,122,283,0.000333,0.566,36,61128,3396,1698,322.227091,15,0
0,0,12,12,14,37,51,95,87,182,0.000333,0.344127,14,14453.33977,802.963321,1032.381412,246.052743,6,0
0,0,44,44,20,20,40,189,99,288,0.000333,0.510905,40,61308.61165,3406.033981,1532.715291,172.877124,17,0
0,0,18,18,15,25,40,103,57,160,0.000333,0.283836,14,11921.11893,662.284385,851.508495,174.699764,7,0
0,0,18,18,15,25,40,104,57,161,0.000333,0.28561,14,11995.62593,666.423663,856.830423,174.699764,7,0
0,0,18,18,15,25,40,103,57,160,0.000333,0.283836,14,11921.11893,662.284385,851.508495,174.699764,7,0
0,0,18,18,15,25,40,104,57,161,0.000333,0.28561,14,11995.62593,666.423663,856.830423,174.699764,7,0
0,0,13,13,19,15,34,77,46,123,0.000333,0.208586,27,16895.4641,938.636894,625.757929,139.313982,5,0
0,0,17,17,21,21,42,98,61,159,0.000333,0.285793,20,17147.5694,952.642745,857.37847,184.477332,5,0
0,0,10,10,11,26,37,50,42,92,0.000333,0.159757,5,2396.348548,133.130475,479.26971,160.26518,5,0
0,0,49,49,22,75,97,269,212,481,0.000333,1.058186,22,69840.2777,3880.015428,3174.558077,565.268897,28,0
0,0,53,53,24,83,107,300,234,534,0.000333,1.199981,24,86398.6409,4799.924494,3599.943371,639.167373,30,0
0,0,35,35,20,51,71,176,153,329,0.000333,0.674422,30,60698.00407,3372.111337,2023.266802,375.732254,18,0
0,0,39,39,22,61,83,207,175,382,0.000333,0.811755,22,53575.83138,2976.435077,2435.265063,459.882473,20,0
0,0,18,18,19,29,48,73,59,132,0.000333,0.245738,18,13269.8709,737.21505,737.21505,221.592072,4,0
0,0,19,19,22,33,55,109,94,203,0.000333,0.391205,22,25819.55248,1434.419582,1173.616022,264.572502,9,0
0,0,19,19,23,38,61,118,106,224,0.000333,0.442828,22,29226.6736,1623.704089,1328.485164,303.463171,14,0
0,0,40,40,27,32,59,202,135,337,0.000333,0.660817,52,103087.4368,5727.079822,1982.450708,288.381963,17,0
0,0,78,78,30,56,86,316,226,542,0.000333,1.161012,60,208982.1298,11610.11832,3483.035497,472.418594,23,0
0,0,78,78,30,56,86,316,226,542,0.000333,1.161012,60,208982.1298,11610.11832,3483.035497,472.418594,23,0
0,0,46,46,19,38,57,185,134,319,0.000333,0.620231,27,50238.68169,2791.037872,1860.691915,280.131868,12,0
0,0,8,8,12,15,27,33,24,57,0.000333,0.090343,6,1626.171526,90.342863,271.028588,101.622909,5,0
0,0,13,13,16,17,33,54,37,91,0.000333,0.153013,16,7344.637838,408.035435,459.039865,133.486868,7,0
0,0,29,29,19,28,47,116,81,197,0.000333,0.364751,18,19696.57207,1094.254004,1094.254004,215.316561,11,0
0,0,29,29,21,28,49,122,82,204,0.000333,0.3818,20,22908.01616,1272.667565,1145.400808,226.844604,12,0
0,0,28,28,20,28,48,114,77,191,0.000333,0.355576,20,21334.55675,1185.253153,1066.727838,221.0445,10,0
0,0,24,24,19,27,46,115,73,188,0.000333,0.346143,18,18691.73366,1038.429648,1038.429648,209.092585,10,0
0,0,22,22,17,26,43,107,68,175,0.000333,0.316532,16,15193.54131,844.085629,949.596332,191.698301,10,0
0,0,13,13,19,15,34,77,46,123,0.000333,0.208586,27,16895.4641,938.636894,625.757929,139.313982,5,0
0,0,16,16,16,27,43,170,88,258,0.000333,0.466659,24,33599.43136,1866.635076,1399.976307,192.381963,8,0
0,0,15,15,16,25,41,166,84,250,0.000333,0.446463,24,32145.31203,1785.850668,1339.388001,180.096405,8,0
0,0,32,32,20,45,65,267,149,416,0.000333,0.835102,30,75159.15031,4175.50835,2505.30501,333.571951,18,0
0,0,8,8,16,14,30,52,34,86,0.000333,0.140664,16,6751.88146,375.104526,421.992591,117.302969,2,0
0,0,27,27,20,33,53,150,99,249,0.000333,0.475417,30,42787.5658,2377.086989,1426.252193,252.903568,9,0
0,0,18,18,15,25,40,103,57,160,0.000333,0.283836,14,11921.11893,662.284385,851.508495,174.699764,7,0
0,0,18,18,15,25,40,104,57,161,0.000333,0.28561,14,11995.62593,666.423663,856.830423,174.699764,7,0
0,0,10,10,11,26,37,50,42,92,0.000333,0.159757,5,2396.348548,133.130475,479.26971,160.26518,5,0
0,0,49,49,22,75,97,269,212,481,0.000333,1.058186,22,69840.2777,3880.015428,3174.558077,565.268897,28,0
0,0,53,53,24,83,107,300,234,534,0.000333,1.199981,24,86398.6409,4799.924494,3599.943371,639.167373,30,0
0,0,35,35,20,51,71,176,153,329,0.000333,0.674422,30,60698.00407,3372.111337,2023.266802,375.732254,18,0
0,0,39,39,22,61,83,207,175,382,0.000333,0.811755,22,53575.83138,2976.435077,2435.265063,459.882473,20,0
0,0,18,18,19,29,48,73,59,132,0.000333,0.245738,18,13269.8709,737.21505,737.21505,221.592072,4,0
0,0,19,19,23,38,61,118,106,224,0.000333,0.442828,22,29226.6736,1623.704089,1328.485164,303.463171,14,0
0,0,19,19,22,33,55,109,94,203,0.000333,0.391205,22,25819.55248,1434.419582,1173.616022,264.572502,9,0
0,0,40,40,27,32,59,202,135,337,0.000333,0.660817,52,103087.4368,5727.079822,1982.450708,288.381963,17,0
0,0,78,78,30,56,86,316,226,542,0.000333,1.161012,60,208982.1298,11610.11832,3483.035497,472.418594,23,0
0,0,78,78,30,56,86,316,226,542,0.000333,1.161012,60,208982.1298,11610.11832,3483.035497,472.418594,23,0
0,0,46,46,19,38,57,185,134,319,0.000333,0.620231,27,50238.68169,2791.037872,1860.691915,280.131868,12,0
0,0,8,8,12,15,27,33,24,57,0.000333,0.090343,6,1626.171526,90.342863,271.028588,101.622909,5,0
0,0,13,13,16,17,33,54,37,91,0.000333,0.153013,16,7344.637838,408.035435,459.039865,133.486868,7,0
0,0,29,29,19,28,47,116,81,197,0.000333,0.364751,18,19696.57207,1094.254004,1094.254004,215.316561,11,0
0,0,29,29,21,28,49,122,82,204,0.000333,0.3818,20,22908.01616,1272.667565,1145.400808,226.844604,12,0
0,0,28,28,20,28,48,114,77,191,0.000333,0.355576,20,21334.55675,1185.253153,1066.727838,221.0445,10,0
0,0,24,24,19,27,46,115,73,188,0.000333,0.346143,18,18691.73366,1038.429648,1038.429648,209.092585,10,0
0,0,22,22,17,26,43,107,68,175,0.000333,0.316532,16,15193.54131,844.085629,949.596332,191.698301,10,0
0,0,27,27,20,33,53,150,99,249,0.000333,0.475417,30,42787.5658,2377.086989,1426.252193,252.903568,9,0
0,0,42,42,16,51,67,269,209,478,0.000333,0.96653,32,92786.90026,5154.827792,2899.590633,353.293692,9,0
0,0,36,36,19,44,63,261,194,455,0.000333,0.906554,36,97907.84515,5439.32473,2719.662365,320.925614,7,0
0,0,35,35,18,44,62,256,190,446,0.000333,0.885191,36,95600.57596,5311.143109,2655.571554,315.273641,6,0
0,0,14,14,17,17,34,87,68,155,0.000333,0.262852,32,25233.81569,1401.87865,788.55674,138.973737,5,0
0,0,25,25,25,30,55,167,132,299,0.000333,0.576209,48,82974.07461,4609.670812,1728.626554,263.303123,24,0
0,0,10,10,12,15,27,57,45,102,0.000333,0.161666,18,8729.973454,484.998525,484.998525,101.622909,3,0
0,0,12,12,14,19,33,74,56,130,0.000333,0.21859,14,9180.797297,510.044294,655.771236,134.013592,4,0
0,0,19,19,19,25,44,101,78,179,0.000333,0.325746,27,26385.43301,1465.85739,977.23826,196.807027,6,0
0,0,12,12,14,17,31,76,57,133,0.000333,0.219636,21,13837.0703,768.726127,658.908109,122.789837,4,0
0,0,12,12,13,18,31,75,57,132,0.000333,0.217985,18,11771.17043,653.953913,653.953913,123.164366,4,0
0,0,13,13,14,17,31,76,55,131,0.000333,0.216333,21,13628.99405,757.166336,648.999717,122.789837,5,0
0,0,20,20,26,27,53,128,92,220,0.000333,0.420048,39,49145.5575,2730.30875,1260.1425,250.593395,8,0
0,0,21,21,20,24,44,124,94,218,0.000333,0.396719,30,35704.68279,1983.593488,1190.156093,196.477662,8,0
0,0,19,19,23,24,47,118,89,207,0.000333,0.383267,33,37943.39645,2107.966469,1149.799892,214.081025,7,0
0,0,13,13,13,14,27,67,51,118,0.000333,0.187026,18,10099.38106,561.076725,561.076725,101.408685,4,0
0,0,15,15,20,25,45,96,68,164,0.000333,0.300221,20,18013.27816,1000.737675,900.663908,202.534967,6,0
0,0,16,16,15,22,37,92,70,162,0.000333,0.28131,21,17722.56035,984.586686,843.931445,156.710855,6,0
0,0,14,14,17,21,38,86,65,151,0.000333,0.264146,24,19018.48931,1056.582739,792.437055,161.725534,5,0
0,0,14,14,15,23,38,89,70,159,0.000333,0.27814,21,17522.82997,973.490554,834.420475,162.645284,4,0
0,0,14,14,14,22,36,89,69,158,0.000333,0.272283,21,17153.81116,952.989509,816.84815,151.410465,4,0
0,0,14,14,14,20,34,90,69,159,0.000333,0.269636,21,16987.03843,943.724357,808.906592,139.741531,4,0
0,0,14,14,15,24,39,93,72,165,0.000333,0.290697,21,18313.91869,1017.439927,872.091366,168.642459,4,0
0,0,14,14,14,23,37,93,71,164,0.000333,0.284783,21,17941.35739,996.742077,854.350352,157.344894,4,0
0,0,14,14,14,18,32,91,69,160,0.000333,0.266667,21,16800,933.333333,800,128.361619,4,0
0,0,14,14,14,23,37,93,71,164,0.000333,0.284783,21,17941.35739,996.742077,854.350352,157.344894,4,0
0,0,14,14,15,24,39,93,72,165,0.000333,0.290697,21,18313.91869,1017.439927,872.091366,168.642459,4,0
0,0,14,14,14,23,37,90,71,161,0.000333,0.279574,21,17613.16183,978.508991,838.721992,157.344894,4,0
0,0,14,14,14,22,36,90,70,160,0.000333,0.275729,21,17370.94801,965.052667,827.188,151.410465,4,0
0,0,14,14,14,22,36,89,69,158,0.000333,0.272283,21,17153.81116,952.989509,816.84815,151.410465,4,0
0,0,14,14,15,23,38,89,70,159,0.000333,0.27814,21,17522.82997,973.490554,834.420475,162.645284,4,0
0,0,14,14,14,22,36,90,70,160,0.000333,0.275729,21,17370.94801,965.052667,827.188,151.410465,4,0
0,0,14,14,14,23,37,90,71,161,0.000333,0.279574,21,17613.16183,978.508991,838.721992,157.344894,4,0
0,0,14,14,14,23,37,93,71,164,0.000333,0.284783,21,17941.35739,996.742077,854.350352,157.344894,4,0
0,0,14,14,15,24,39,93,72,165,0.000333,0.290697,21,18313.91869,1017.439927,872.091366,168.642459,4,0
0,0,31,31,23,43,66,167,132,299,0.000333,0.602425,33,59640.03678,3313.335376,1807.273842,337.371309,9,0
0,0,14,14,15,22,37,86,67,153,0.000333,0.265682,21,16737.97366,929.887426,797.046365,156.710855,4,0
0,0,30,30,22,38,60,155,118,273,0.000333,0.537527,33,53215.17738,2956.398743,1612.581133,297.528741,9,0
0,0,14,14,15,20,35,85,69,154,0.000333,0.263303,21,16588.10128,921.561182,789.909585,145.041921,4,0
0,0,30,30,23,40,63,160,123,283,0.000333,0.563857,33,55821.81721,3101.212067,1691.570218,316.919049,9,0
0,0,31,31,23,42,65,166,132,298,0.000333,0.598222,33,59223.96507,3290.220282,1794.665608,330.519257,9,0
0,0,14,14,14,23,37,85,67,152,0.000333,0.263946,14,11085.71676,615.873153,791.836912,157.344894,4,0
0,0,30,30,22,37,59,154,118,272,0.000333,0.53336,33,52802.60401,2933.478001,1600.078909,290.85727,9,0
0,0,14,14,14,21,35,84,69,153,0.000333,0.261593,21,16480.38633,915.577019,784.780302,145.541635,4,0
0,0,30,30,23,39,62,159,123,282,0.000333,0.559694,33,55409.75086,3078.319492,1679.08336,310.172612,9,0
0,0,14,14,15,24,39,93,72,165,0.000333,0.290697,21,18313.91869,1017.439927,872.091366,168.642459,4,0
0,0,14,14,14,23,37,93,71,164,0.000333,0.284783,21,17941.35739,996.742077,854.350352,157.344894,4,0
0,0,19,19,23,26,49,128,107,235,0.000333,0.439819,44,58056.09979,3225.338877,1319.456813,226.253358,22,0
0,0,16,16,22,21,43,88,79,167,0.000333,0.302062,33,29904.14506,1661.341392,906.186214,190.346161,11,0
0,0,17,17,22,25,47,119,98,217,0.000333,0.401782,33,39776.41077,2209.800598,1205.345781,214.2039,20,0
0,0,24,24,24,28,52,160,125,285,0.000333,0.541542,48,77982.01534,4332.334186,1624.62532,244.645038,22,0
0,0,20,20,22,27,49,147,113,260,0.000333,0.486608,44,64232.28062,3568.460034,1459.824559,226.489458,19,0
0,0,33,33,20,33,53,188,148,336,0.000333,0.641527,40,76983.25091,4276.847273,1924.581273,252.903568,17,0
0,0,49,49,23,35,58,259,199,458,0.000333,0.894318,55,147562.5413,8197.918959,2682.955296,283.566831,23,0
0,0,44,44,20,34,54,231,175,406,0.000333,0.778828,50,116824.2163,6490.234239,2336.484326,259.412299,23,0
0,0,61,61,23,37,60,298,227,525,0.000333,1.033706,66,204673.7591,11370.7644,3101.117563,296.7917,29,0
0,0,32,32,22,34,56,182,142,324,0.000333,0.627194,44,82789.65177,4599.425098,1881.582995,271.081232,16,0
0,0,37,37,24,34,58,223,164,387,0.000333,0.75568,48,108817.855,6045.436387,2267.038645,283.012837,19,0
0,0,32,32,22,33,55,179,141,320,0.000333,0.616678,44,81401.54477,4522.308043,1850.035108,264.572502,14,0
0,0,32,32,22,33,55,179,141,320,0.000333,0.616678,44,81401.54477,4522.308043,1850.035108,264.572502,14,0
0,0,32,32,22,33,55,176,138,314,0.000333,0.605116,44,79875.2658,4437.514767,1815.34695,264.572502,15,0
0,0,34,34,24,34,58,206,156,362,0.000333,0.706863,48,101788.2778,5654.904321,2120.58912,283.012837,17,0
0,0,44,44,27,42,69,280,221,501,0.000333,1.020124,65,198924.0989,11051.33883,3060.370753,354.859294,35,0
0,0,34,34,21,34,55,184,150,334,0.000333,0.643658,40,77238.96577,4291.053654,1930.974144,265.212402,14,0
0,0,34,34,21,33,54,184,150,334,0.000333,0.640711,40,76885.29703,4271.40539,1922.132426,258.703672,14,0
0,0,43,43,23,51,74,244,199,443,0.000333,0.916929,33,90775.99875,5043.111042,2750.787841,393.335617,20,0
0,0,35,35,22,34,56,188,153,341,0.000333,0.660103,44,87133.55325,4840.752958,1980.308028,271.081232,14,0
0,0,34,34,20,32,52,182,148,330,0.000333,0.627048,40,75245.80428,4180.32246,1881.145107,246.438562,14,0
0,0,35,35,22,33,55,187,152,339,0.000333,0.653294,44,86234.76149,4790.820083,1959.880943,264.572502,14,0
0,0,43,43,23,50,73,243,198,441,0.000333,0.909904,33,90080.51681,5004.473156,2729.71263,386.234734,20,0
0,0,34,34,20,32,52,182,148,330,0.000333,0.627048,40,75245.80428,4180.32246,1881.145107,246.438562,14,0
0,0,35,35,22,34,56,190,153,343,0.000333,0.663974,44,87644.60048,4869.144471,1991.922738,271.081232,14,0
0,0,35,35,22,33,55,190,153,343,0.000333,0.661002,44,87252.2808,4847.348933,1983.006382,264.572502,14,0
0,0,44,44,24,51,75,250,202,452,0.000333,0.938475,36,101355.3377,5630.852096,2815.426048,399.332792,20,0
0,0,36,36,22,34,56,194,156,350,0.000333,0.677525,44,89433.2658,4968.514767,2032.574223,271.081232,14,0
0,0,35,35,22,33,55,189,152,341,0.000333,0.657148,44,86743.52114,4819.084508,1971.443662,264.572502,14,0
0,0,36,36,22,34,56,194,156,350,0.000333,0.677525,44,89433.2658,4968.514767,2032.574223,271.081232,14,0
0,0,44,44,24,51,75,250,202,452,0.000333,0.938475,36,101355.3377,5630.852096,2815.426048,399.332792,20,0
0,0,35,35,22,33,55,189,152,341,0.000333,0.657148,44,86743.52114,4819.084508,1971.443662,264.572502,14,0
0,0,45,45,21,39,60,235,187,422,0.000333,0.830903,40,99708.31325,5539.350736,2492.707831,298.369352,19,0
0,0,47,47,23,35,58,243,186,429,0.000333,0.837691,55,138219.0616,7678.836754,2513.073847,283.566831,23,0
0,0,42,42,20,34,54,215,162,377,0.000333,0.723198,40,86783.70353,4821.316863,2169.592588,259.412299,23,0
0,0,59,59,23,37,60,282,214,496,0.000333,0.976606,55,161139.9754,8952.220858,2929.817735,296.7917,29,0
0,0,30,30,22,34,56,166,129,295,0.000333,0.571057,33,56534.60017,3140.81112,1713.169702,271.081232,16,0
0,0,35,35,24,34,58,207,151,358,0.000333,0.699052,48,100663.5454,5592.41919,2097.157196,283.012837,19,0
0,0,30,30,22,33,55,163,128,291,0.000333,0.560792,33,55518.39733,3084.355407,1682.375677,264.572502,14,0
0,0,30,30,22,33,55,163,128,291,0.000333,0.560792,33,55518.39733,3084.355407,1682.375677,264.572502,14,0
0,0,30,30,22,33,55,160,125,285,0.000333,0.549229,33,54373.68811,3020.76045,1647.687518,264.572502,15,0
0,0,32,32,24,34,58,190,143,333,0.000333,0.650236,48,93633.96823,5201.887124,1950.707671,283.012837,17,0
0,0,42,42,27,42,69,264,208,472,0.000333,0.961075,52,149927.6243,8329.312459,2883.223544,354.859294,35,0
0,0,32,32,21,34,55,168,137,305,0.000333,0.587772,40,70532.58851,3918.477139,1763.314713,265.212402,14,0
0,0,32,32,21,33,54,168,137,305,0.000333,0.58508,40,70209.62753,3900.534863,1755.240688,258.703672,14,0
0,0,41,41,23,51,74,228,186,414,0.000333,0.856905,33,84833.55188,4712.975105,2570.713693,393.335617,20,0
0,0,33,33,22,34,56,172,140,312,0.000333,0.603965,44,79723.36837,4429.076021,1811.894736,271.081232,14,0
0,0,32,32,20,32,52,166,135,301,0.000333,0.571944,40,68633.29421,3812.960789,1715.832355,246.438562,14,0
0,0,33,33,22,33,55,171,139,310,0.000333,0.597407,44,78857.74649,4380.985916,1792.221511,264.572502,14,0
0,0,41,41,23,50,73,227,185,412,0.000333,0.850069,33,84156.8547,4675.380817,2550.207718,386.234734,20,0
0,0,32,32,20,32,52,166,135,301,0.000333,0.571944,40,68633.29421,3812.960789,1715.832355,246.438562,14,0
0,0,33,33,22,34,56,174,140,314,0.000333,0.607836,44,80234.4156,4457.467534,1823.509446,271.081232,14,0
0,0,33,33,22,33,55,174,140,314,0.000333,0.605116,44,79875.2658,4437.514767,1815.34695,264.572502,14,0
0,0,42,42,24,51,75,234,189,423,0.000333,0.878263,36,94852.45102,5269.580612,2634.790306,399.332792,20,0
0,0,34,34,22,34,56,178,143,321,0.000333,0.621387,44,82023.08092,4556.837829,1864.16093,271.081232,14,0
0,0,33,33,22,33,55,173,139,312,0.000333,0.601261,44,79366.50615,4409.250342,1803.784231,264.572502,14,0
0,0,34,34,22,34,56,178,143,321,0.000333,0.621387,44,82023.08092,4556.837829,1864.16093,271.081232,14,0
0,0,42,42,24,51,75,234,189,423,0.000333,0.878263,36,94852.45102,5269.580612,2634.790306,399.332792,20,0
0,0,33,33,22,33,55,173,139,312,0.000333,0.601261,44,79366.50615,4409.250342,1803.784231,264.572502,14,0
0,0,4,4,9,11,20,35,23,58,0.000333,0.083557,8,2005.374636,111.409702,250.67183,66.583073,1,0
0,0,23,23,17,22,39,104,81,185,0.000333,0.325933,24,23467.18585,1303.732547,977.79941,167.594364,11,0
0,0,75,75,25,44,69,366,279,645,0.000333,1.313333,72,283679.8758,15759.9931,3939.998275,356.311396,31,0
0,0,61,61,22,42,64,310,236,546,0.000333,1.092,55,180180,10010,3276,324.584827,25,0
0,0,59,59,22,42,64,297,225,522,0.000333,1.044,55,172260,9570,3132,324.584827,25,0
0,0,29,29,19,30,49,160,127,287,0.000333,0.537141,36,58011.18211,3222.843451,1611.421725,227.917341,14,0
0,0,32,32,19,35,54,179,147,326,0.000333,0.625364,36,67539.35973,3752.186651,1876.093326,260.235528,16,0
0,0,48,48,24,40,64,250,198,448,0.000333,0.896,48,129024,7168,2688,322.916224,22,0
0,0,27,27,19,29,48,155,125,280,0.000333,0.521263,36,56296.42201,3127.579,1563.7895,221.592072,13,0
0,0,41,41,26,42,68,261,208,469,0.000333,0.951673,52,148461.0438,8247.835765,2855.020073,348.688764,34,0
0,0,26,26,16,36,52,197,152,349,0.000333,0.663151,32,63662.51077,3536.806154,1989.453462,250.1173,6,0
0,0,23,23,17,37,54,209,155,364,0.000333,0.69826,32,67032.92963,3724.051646,2094.779051,262.236643,5,0
0,0,24,24,15,28,43,115,92,207,0.000333,0.374412,21,23587.97289,1310.442938,1123.236804,193.209297,6,0
0,0,22,22,15,27,42,110,86,196,0.000333,0.352298,21,22194.77851,1233.043251,1056.894215,186.985321,6,0
0,0,21,21,15,27,42,109,84,193,0.000333,0.346906,21,21855.06252,1214.17014,1040.717263,186.985321,6,0
0,0,19,19,15,25,40,107,79,186,0.000333,0.32996,21,20787.45114,1154.858397,989.878626,174.699764,6,0
0,0,22,22,20,31,51,125,94,219,0.000333,0.414087,30,37267.8345,2070.43525,1242.26115,240.018648,8,0
0,0,24,24,21,31,52,135,100,235,0.000333,0.446534,30,40188.10001,2232.672223,1339.603334,245.818752,9,0
0,0,21,21,21,26,47,140,107,247,0.000333,0.457328,40,54879.33786,3048.852103,1371.983446,214.450099,8,0
0,0,27,27,27,34,61,181,131,312,0.000333,0.616797,39,72165.21192,4009.17844,1850.390049,301.355699,11,0
0,0,15,15,19,21,40,81,64,145,0.000333,0.257227,27,20835.34849,1157.519361,771.679574,172.949289,6,0
0,0,13,13,22,21,43,75,59,134,0.000333,0.242373,22,15996.6285,888.701583,727.119477,190.346161,5,0
0,0,19,19,18,26,44,105,85,190,0.000333,0.345764,27,28006.8842,1555.938011,1037.292008,197.270083,8,0
0,0,35,35,22,29,51,176,136,312,0.000333,0.589932,44,77871.0551,4326.169727,1769.796707,238.988944,14,0
0,0,30,30,19,28,47,148,112,260,0.000333,0.481398,36,51990.95165,2888.386203,1444.193101,215.316561,14,0
0,0,47,47,22,33,55,215,164,379,0.000333,0.730378,44,96409.95458,5356.108588,2191.135331,264.572502,20,0
0,0,18,18,21,27,48,99,79,178,0.000333,0.331374,20,19882.4665,1104.581472,994.123325,220.620628,7,0
0,0,23,23,24,28,52,140,101,241,0.000333,0.457935,36,49457.015,2747.611944,1373.805972,244.645038,10,0
0,0,18,18,21,26,47,96,78,174,0.000333,0.322166,30,28994.95381,1610.830767,966.49846,214.450099,5,0
0,0,18,18,21,26,47,96,78,174,0.000333,0.322166,30,28994.95381,1610.830767,966.49846,214.450099,5,0
0,0,18,18,21,26,47,93,75,168,0.000333,0.311057,20,18663.41854,1036.856586,933.170927,214.450099,6,0
0,0,20,20,24,28,52,123,93,216,0.000333,0.410432,36,44326.61925,2462.589958,1231.294979,244.645038,8,0
0,0,30,30,26,37,63,197,158,355,0.000333,0.707311,52,110340.5874,6130.032633,2121.934373,314.961207,26,0
0,0,20,20,20,27,47,101,87,188,0.000333,0.348088,30,31327.88112,1740.43784,1044.262704,214.820524,5,0
0,0,20,20,20,26,46,101,87,188,0.000333,0.346143,30,31152.88943,1730.71608,1038.429648,208.649995,5,0
0,0,29,29,23,45,68,161,136,297,0.000333,0.602659,33,59663.22331,3314.623517,1807.976464,351.175314,11,0
0,0,21,21,21,27,48,105,90,195,0.000333,0.363023,30,32672.03063,1815.112813,1089.067688,220.620628,5,0
0,0,20,20,19,25,44,99,85,184,0.000333,0.334845,27,27122.45628,1506.803127,1004.535418,196.807027,5,0
0,0,21,21,21,26,47,104,89,193,0.000333,0.357345,30,32161.06945,1786.726081,1072.035648,214.450099,5,0
0,0,29,29,23,44,67,160,135,295,0.000333,0.596499,33,59053.37827,3280.743237,1789.496311,344.256916,11,0
0,0,20,20,19,25,44,99,85,184,0.000333,0.334845,27,27122.45628,1506.803127,1004.535418,196.807027,5,0
0,0,21,21,21,27,48,107,90,197,0.000333,0.366746,30,33007.12838,1833.729354,1100.237613,220.620628,5,0
0,0,21,21,21,26,47,107,90,197,0.000333,0.364751,30,32827.62011,1823.756673,1094.254004,214.450099,5,0
0,0,30,30,24,45,69,167,139,306,0.000333,0.623069,36,67291.50542,3738.416968,1869.208484,357.172489,11,0
0,0,22,22,21,27,48,111,93,204,0.000333,0.379777,30,34179.9705,1898.88725,1139.33235,220.620628,5,0
0,0,21,21,21,26,47,106,89,195,0.000333,0.361048,30,32494.34478,1805.241377,1083.144826,214.450099,5,0
0,0,22,22,21,27,48,111,93,204,0.000333,0.379777,30,34179.9705,1898.88725,1139.33235,220.620628,5,0
0,0,30,30,24,45,69,167,139,306,0.000333,0.623069,36,67291.50542,3738.416968,1869.208484,357.172489,11,0
0,0,21,21,21,26,47,106,89,195,0.000333,0.361048,30,32494.34478,1805.241377,1083.144826,214.450099,5,0
0,0,20,20,18,27,45,111,90,201,0.000333,0.367954,27,29804.28675,1655.793709,1103.862472,203.440613,10,0
0,0,36,36,22,29,51,182,141,323,0.000333,0.610731,44,80616.50896,4478.694942,1832.193385,238.988944,16,0
0,0,31,31,19,29,48,154,117,271,0.000333,0.504508,36,54486.89416,3027.049675,1513.524838,221.592072,16,0
0,0,48,48,22,33,55,221,169,390,0.000333,0.751577,55,124010.1659,6889.453659,2254.730288,264.572502,22,0
0,0,19,19,21,28,49,105,84,189,0.000333,0.353727,30,31835.40482,1768.633601,1061.180161,226.844604,9,0
0,0,24,24,24,29,53,146,106,252,0.000333,0.481145,36,51963.69436,2886.871909,1443.435955,250.920549,12,0
0,0,19,19,21,27,48,102,83,185,0.000333,0.344406,30,30996.54188,1722.030104,1033.218063,220.620628,7,0
0,0,19,19,21,27,48,102,83,185,0.000333,0.344406,30,30996.54188,1722.030104,1033.218063,220.620628,7,0
0,0,19,19,21,27,48,99,80,179,0.000333,0.333236,20,19994.16575,1110.786986,999.708288,220.620628,8,0
0,0,21,21,24,29,53,129,98,227,0.000333,0.433413,36,46808.56596,2600.475886,1300.237943,250.920549,10,0
0,0,31,31,26,38,64,203,163,366,0.000333,0.732,52,114192,6344,2196,321.632678,28,0
0,0,21,21,20,28,48,107,92,199,0.000333,0.370469,30,33342.22613,1852.345896,1111.407538,221.0445,7,0
0,0,21,21,20,27,47,107,92,199,0.000333,0.368454,30,33160.89545,1842.271969,1105.363181,214.820524,7,0
0,0,30,30,23,46,69,167,141,308,0.000333,0.627142,33,62087.04258,3449.280143,1881.425533,358.125775,13,0
0,0,22,22,21,28,49,111,95,206,0.000333,0.385543,30,34698.90684,1927.717046,1156.630228,226.844604,7,0
0,0,21,21,19,26,45,105,90,195,0.000333,0.35697,27,28914.60655,1606.367031,1070.911354,202.922055,7,0
0,0,22,22,21,27,48,110,94,204,0.000333,0.379777,30,34179.9705,1898.88725,1139.33235,220.620628,7,0
0,0,30,30,23,45,68,166,140,306,0.000333,0.620921,33,61471.19977,3415.066654,1862.763629,351.175314,13,0
0,0,21,21,19,26,45,105,90,195,0.000333,0.35697,27,28914.60655,1606.367031,1070.911354,202.922055,7,0
0,0,22,22,21,28,49,113,95,208,0.000333,0.389287,30,35035.78943,1946.432746,1167.859648,226.844604,7,0
0,0,22,22,21,27,48,113,95,208,0.000333,0.387224,30,34850.16601,1936.120334,1161.6722,220.620628,7,0
0,0,31,31,24,46,70,173,144,317,0.000333,0.647661,36,69947.37779,3885.965433,1942.982716,364.12295,13,0
0,0,23,23,21,28,49,117,98,215,0.000333,0.402388,30,36214.8785,2011.937694,1207.162616,226.844604,7,0
0,0,22,22,21,27,48,112,94,206,0.000333,0.383501,30,34515.06825,1917.503792,1150.502275,220.620628,7,0
0,0,23,23,21,28,49,117,98,215,0.000333,0.402388,30,36214.8785,2011.937694,1207.162616,226.844604,7,0
0,0,31,31,24,46,70,173,144,317,0.000333,0.647661,36,69947.37779,3885.965433,1942.982716,364.12295,13,0
0,0,22,22,21,27,48,112,94,206,0.000333,0.383501,30,34515.06825,1917.503792,1150.502275,220.620628,7,0
0,0,18,18,13,30,43,99,79,178,0.000333,0.321958,12,11590.50152,643.916751,965.875126,195.312434,5,0
0,0,11,11,11,26,37,61,38,99,0.000333,0.171912,5,2578.679416,143.259968,515.735883,160.26518,10,0
0,0,18,18,15,25,40,103,57,160,0.000333,0.283836,14,11921.11893,662.284385,851.508495,174.699764,7,0
0,0,18,18,15,25,40,104,57,161,0.000333,0.28561,14,11995.62593,666.423663,856.830423,174.699764,7,0
0,0,22,22,23,20,43,109,76,185,0.000333,0.33462,33,33127.34633,1840.408129,1003.85898,190.480487,7,0
0,0,22,22,30,20,50,167,100,267,0.000333,0.502303,75,113018.2202,6278.790011,1506.909603,233.64528,15,0
0,0,10,10,16,14,30,47,33,80,0.000333,0.13085,16,6280.819962,348.934442,392.551248,117.302969,3,0
0,0,10,10,11,16,27,73,44,117,0.000333,0.185441,10,5563.218378,309.067688,556.321838,102.053748,4,0
0,0,10,10,10,16,26,67,41,108,0.000333,0.169216,10,5076.474896,282.026383,507.64749,97.219281,3,0
0,0,10,10,10,16,26,71,41,112,0.000333,0.175483,10,5264.492484,292.471805,526.449248,97.219281,3,0
0,0,10,10,10,16,26,67,41,108,0.000333,0.169216,10,5076.474896,282.026383,507.64749,97.219281,3,0
0,0,10,10,10,16,26,71,41,112,0.000333,0.175483,10,5264.492484,292.471805,526.449248,97.219281,3,0
0,0,10,10,10,16,26,67,41,108,0.000333,0.169216,10,5076.474896,282.026383,507.64749,97.219281,3,0
0,0,10,10,10,16,26,67,41,108,0.000333,0.169216,10,5076.474896,282.026383,507.64749,97.219281,3,0
0,0,10,10,10,16,26,67,41,108,0.000333,0.169216,10,5076.474896,282.026383,507.64749,97.219281,3,0
0,0,12,12,14,20,34,63,39,102,0.000333,0.172974,7,3632.448469,201.802693,518.92121,139.741531,9,0
0,0,24,24,18,50,68,122,97,219,0.000333,0.444385,9,11998.38926,666.577181,1333.154362,357.25146,9,0
0,0,60,60,30,39,69,419,256,675,0.000333,1.374418,90,371092.8607,20616.27004,4123.254008,353.337404,37,0
0,0,37,37,29,44,73,272,177,449,0.000333,0.92641,56,155636.9487,8646.49715,2779.231227,381.09644,14,0
0,0,21,21,20,25,45,100,81,181,0.000333,0.331342,30,29820.76231,1656.709017,994.02541,202.534967,13,0
0,0,46,46,28,39,67,413,205,618,0.000333,1.249614,70,262419.0184,14578.83435,3748.84312,340.736624,13,0
0,0,81,81,29,60,89,484,321,805,0.000333,1.737655,70,364907.5788,20272.64327,5212.965412,495.294885,31,0
0,0,74,74,29,54,83,438,291,729,0.000333,1.549135,70,325318.2622,18073.23679,4647.403745,451.645374,30,0
0,0,70,70,29,56,85,420,280,700,0.000333,1.495525,70,314060.1559,17447.78644,4486.573655,466.093324,27,0
0,0,63,63,29,50,79,374,250,624,0.000333,1.311186,70,275349.1431,15297.17462,3933.559187,423.074258,26,0
0,0,66,66,28,55,83,400,263,663,0.000333,1.408884,56,236692.464,13149.58133,4226.651143,452.580722,27,0
0,0,66,66,28,54,82,404,265,669,0.000333,1.417734,56,238179.3283,13232.18491,4253.202291,445.369863,27,0
0,0,57,57,26,46,72,327,210,537,0.000333,1.104417,52,172288.9857,9571.610319,3313.249726,376.295283,25,0
0,0,26,26,23,29,52,167,114,281,0.000333,0.533941,33,52860.17751,2936.676528,1601.823561,244.923374,10,0
0,0,28,28,23,29,52,175,120,295,0.000333,0.560543,44,73991.70754,4110.650419,1681.629717,244.923374,10,0
0,0,11,11,21,26,47,92,56,148,0.000333,0.274026,20,16441.583,913.421278,822.07915,214.450099,6,0
0,0,11,11,21,26,47,92,56,148,0.000333,0.274026,20,16441.583,913.421278,822.07915,214.450099,6,0
0,0,49,49,28,36,64,310,179,489,0.000333,0.978,56,164304,9128,2934,320.723238,32,0
0,0,65,65,33,47,80,478,273,751,0.000333,1.582589,80,379821.4399,21101.19111,4747.767999,427.530682,20,0
0,0,85,85,31,59,90,490,339,829,0.000333,1.793915,75,403630.9663,22423.94257,5381.746217,500.656026,33,0
0,0,92,92,33,62,95,542,384,926,0.000333,2.027895,96,584033.8842,32446.3269,6083.686293,535.625177,35,0
0,0,56,56,33,54,87,498,333,831,0.000333,1.784695,96,513992.2603,28555.12557,5354.086045,477.228931,24,0
0,0,53,53,31,49,80,594,356,950,0.000333,2.001944,105,630612.3275,35034.01819,6005.83169,428.700868,23,0
0,0,48,48,34,47,81,311,238,549,0.000333,1.160193,85,295849.1004,16436.06113,3480.577652,434.039413,17,0
0,0,50,50,35,47,82,345,264,609,0.000333,1.290583,85,329098.6795,18283.25997,3871.749171,440.590582,23,0
0,0,22,22,18,49,67,114,84,198,0.000333,0.400362,9,10809.77094,600.54283,1201.08566,350.179432,9,0
0,0,12,12,14,20,34,63,39,102,0.000333,0.172974,7,3632.448469,201.802693,518.92121,139.741531,9,0
0,0,26,26,18,33,51,191,82,273,0.000333,0.516191,18,27874.29813,1548.572118,1548.572118,241.523656,12,0
0,0,55,55,21,39,60,266,186,452,0.000333,0.889972,40,106796.582,5933.143443,2669.914549,298.369352,6,0
0,0,21,21,20,32,52,143,86,229,0.000333,0.435134,20,26108.01391,1450.445217,1305.400695,246.438562,4,0
0,0,53,53,29,47,76,267,183,450,0.000333,0.937189,42,118085.83,6560.323889,2811.567381,401.947125,20,0
0,0,44,44,32,46,78,279,187,466,0.000333,0.976332,64,187455.8358,10414.2131,2928.997434,414.08385,17,0
0,0,45,45,33,53,86,296,200,496,0.000333,1.062476,48,152996.5113,8499.806182,3187.427318,470.04479,19,0
0,0,19,19,21,30,51,123,80,203,0.000333,0.383834,20,23030.04689,1279.447049,1151.502344,239.445384,4,0
0,0,22,22,18,49,67,114,84,198,0.000333,0.400362,9,10809.77094,600.54283,1201.08566,350.179432,9,0
0,0,18,18,15,25,40,103,57,160,0.000333,0.283836,14,11921.11893,662.284385,851.508495,174.699764,7,0
0,0,18,18,15,25,40,104,57,161,0.000333,0.28561,14,11995.62593,666.423663,856.830423,174.699764,7,0
0,0,34,34,23,50,73,187,124,311,0.000333,0.641678,22,42350.77963,2352.821091,1925.035438,386.234734,18,0
0,0,44,44,28,60,88,255,161,416,0.000333,0.895708,28,75239.45949,4179.969972,2687.123553,489.019374,19,0
0,0,30,30,21,43,64,160,108,268,0.000333,0.536,20,32160,1786.666667,1608,325.56805,20,0
0,0,56,56,27,60,87,372,227,599,0.000333,1.286441,39,150513.603,8361.866834,3859.323154,482.795398,13,0
0,0,60,60,27,60,87,404,247,651,0.000333,1.398119,52,218106.5232,12117.02907,4194.356216,482.795398,14,0
0,0,55,55,27,57,84,390,229,619,0.000333,1.318948,52,205755.9132,11430.88407,3956.844485,460.856693,15,0
0,0,59,59,26,57,83,422,249,671,0.000333,1.425884,52,222437.8758,12357.65977,4277.651458,454.686163,16,0
0,0,13,13,13,19,32,70,40,110,0.000333,0.183333,12,6600,366.666667,550,128.816339,4,0
0,0,11,11,17,21,38,55,40,95,0.000333,0.166184,8,3988.42491,221.579162,498.553114,161.725534,7,0
0,0,16,16,18,37,55,152,77,229,0.000333,0.44131,18,23830.76474,1323.931374,1323.931374,267.808425,6,0
0,0,12,12,17,28,45,86,53,139,0.000333,0.254456,8,6106.940643,339.27448,763.36758,204.092806,3,0
0,0,17,17,20,39,59,167,85,252,0.000333,0.494142,20,29648.52097,1647.140054,1482.426048,292.569248,8,0
0,0,22,22,18,49,67,114,84,198,0.000333,0.400362,9,10809.77094,600.54283,1201.08566,350.179432,9,0
0,0,18,18,15,25,40,103,57,160,0.000333,0.283836,14,11921.11893,662.284385,851.508495,174.699764,7,0
0,0,18,18,15,25,40,104,57,161,0.000333,0.28561,14,11995.62593,666.423663,856.830423,174.699764,7,0
0,0,17,17,21,21,42,98,61,159,0.000333,0.285793,20,17147.5694,952.642745,857.37847,184.477332,5,0
0,0,18,18,15,25,40,103,57,160,0.000333,0.283836,14,11921.11893,662.284385,851.508495,174.699764,7,0
0,0,18,18,15,25,40,104,57,161,0.000333,0.28561,14,11995.62593,666.423663,856.830423,174.699764,7,0
0,0,77,77,29,53,82,503,314,817,0.000333,1.731373,70,363588.3991,20199.35551,5194.119988,444.461233,30,0
0,0,55,55,28,49,77,354,228,582,0.000333,1.215757,56,204247.1069,11347.0615,3647.269767,409.72672,20,0
0,0,41,41,22,40,62,274,172,446,0.000333,0.885191,44,116845.1484,6491.397133,2655.571554,310.984619,16,0
0,0,62,62,24,46,70,402,246,648,0.000333,1.323925,60,238306.5237,13239.25132,3971.775395,364.12295,26,0
0,0,6,6,15,15,30,45,34,79,0.000333,0.129215,14,5427.020999,301.501167,387.644357,117.206718,1,0
0,0,5,5,14,11,25,26,24,50,0.000333,0.077398,14,3250.699333,180.594407,232.192809,91.356717,1,0
0,0,6,6,15,15,30,45,34,79,0.000333,0.129215,14,5427.020999,301.501167,387.644357,117.206718,1,0
0,0,5,5,14,11,25,26,24,50,0.000333,0.077398,14,3250.699333,180.594407,232.192809,91.356717,1,0
0,0,60,60,30,39,69,419,256,675,0.000333,1.374418,90,371092.8607,20616.27004,4123.254008,353.337404,37,0
0,0,37,37,29,44,73,272,177,449,0.000333,0.92641,56,155636.9487,8646.49715,2779.231227,381.09644,14,0
0,0,21,21,20,25,45,101,83,184,0.000333,0.336834,30,30315.02909,1684.168283,1010.50097,202.534967,13,0
0,0,46,46,28,39,67,413,205,618,0.000333,1.249614,70,262419.0184,14578.83435,3748.84312,340.736624,13,0
0,0,78,78,29,59,88,472,312,784,0.000333,1.688065,70,354493.6072,19694.08929,5064.194389,487.957389,31,0
0,0,71,71,29,53,82,426,282,708,0.000333,1.500382,70,315080.2773,17504.45985,4501.146819,444.461233,30,0
0,0,67,67,29,55,84,408,271,679,0.000333,1.446795,56,243061.4777,13503.41543,4340.38353,458.856233,27,0
0,0,60,60,29,49,78,362,241,603,0.000333,1.263366,56,212245.4621,11791.41456,3790.097538,416.002231,26,0
0,0,63,63,28,54,82,388,254,642,0.000333,1.360516,56,228566.7097,12698.15054,4081.548387,445.369863,27,0
0,0,63,63,28,53,81,392,256,648,0.000333,1.369408,56,230060.4769,12781.13761,4108.222802,438.185722,27,0
0,0,54,54,26,45,71,315,201,516,0.000333,1.057757,52,165010.0147,9167.223039,3173.269514,369.344822,25,0
0,0,26,26,23,29,52,167,114,281,0.000333,0.533941,33,52860.17751,2936.676528,1601.823561,244.923374,10,0
0,0,28,28,23,29,52,175,120,295,0.000333,0.560543,44,73991.70754,4110.650419,1681.629717,244.923374,10,0
0,0,11,11,21,26,47,92,56,148,0.000333,0.274026,20,16441.583,913.421278,822.07915,214.450099,6,0
0,0,11,11,21,26,47,92,56,148,0.000333,0.274026,20,16441.583,913.421278,822.07915,214.450099,6,0
0,0,49,49,28,36,64,310,179,489,0.000333,0.978,56,164304,9128,2934,320.723238,32,0
0,0,65,65,33,47,80,478,273,751,0.000333,1.582589,80,379821.4399,21101.19111,4747.767999,427.530682,20,0
0,0,82,82,31,58,89,478,330,808,0.000333,1.744131,75,392429.4459,21801.63588,5232.392612,493.342983,33,0
0,0,96,96,33,67,100,576,405,981,0.000333,2.172541,96,625691.8005,34760.65559,6517.622922,572.892982,36,0
0,0,89,89,33,61,94,530,375,905,0.000333,1.977301,96,569462.6794,31636.81552,5931.902911,528.239984,35,0
0,0,53,53,31,49,80,594,356,950,0.000333,2.001944,105,630612.3275,35034.01819,6005.83169,428.700868,23,0
0,0,56,56,33,54,87,498,333,831,0.000333,1.784695,96,513992.2603,28555.12557,5354.086045,477.228931,24,0
0,0,48,48,34,47,81,311,238,549,0.000333,1.160193,85,295849.1004,16436.06113,3480.577652,434.039413,17,0
0,0,50,50,35,47,82,345,264,609,0.000333,1.290583,85,329098.6795,18283.25997,3871.749171,440.590582,23,0
0,0,12,12,14,20,34,63,39,102,0.000333,0.172974,7,3632.448469,201.802693,518.92121,139.741531,9,0
0,0,18,18,17,27,44,83,54,137,0.000333,0.249314,16,11967.07411,664.83745,747.942132,197.868831,10,0
0,0,23,23,16,31,47,113,69,182,0.000333,0.336978,16,16174.96274,898.609041,1010.935171,217.580086,14,0
0,0,62,62,30,39,69,447,277,724,0.000333,1.474191,105,464370.0292,25798.33496,4422.571707,353.337404,39,0
0,0,37,37,29,44,73,272,177,449,0.000333,0.92641,56,155636.9487,8646.49715,2779.231227,381.09644,14,0
0,0,21,21,20,25,45,100,81,181,0.000333,0.331342,30,29820.76231,1656.709017,994.02541,202.534967,13,0
0,0,46,46,28,39,67,413,205,618,0.000333,1.249614,70,262419.0184,14578.83435,3748.84312,340.736624,13,0
0,0,78,78,29,59,88,472,312,784,0.000333,1.688065,70,354493.6072,19694.08929,5064.194389,487.957389,31,0
0,0,71,71,29,53,82,426,282,708,0.000333,1.500382,70,315080.2773,17504.45985,4501.146819,444.461233,30,0
0,0,67,67,29,55,84,408,271,679,0.000333,1.446795,56,243061.4777,13503.41543,4340.38353,458.856233,27,0
0,0,60,60,29,49,78,362,241,603,0.000333,1.263366,56,212245.4621,11791.41456,3790.097538,416.002231,26,0
0,0,63,63,28,54,82,388,254,642,0.000333,1.360516,56,228566.7097,12698.15054,4081.548387,445.369863,27,0
0,0,63,63,28,53,81,392,256,648,0.000333,1.369408,56,230060.4769,12781.13761,4108.222802,438.185722,27,0
0,0,54,54,26,45,71,315,201,516,0.000333,1.057757,52,165010.0147,9167.223039,3173.269514,369.344822,25,0
0,0,26,26,23,29,52,167,114,281,0.000333,0.533941,33,52860.17751,2936.676528,1601.823561,244.923374,10,0
0,0,28,28,23,29,52,175,120,295,0.000333,0.560543,44,73991.70754,4110.650419,1681.629717,244.923374,10,0
0,0,11,11,21,26,47,92,56,148,0.000333,0.274026,20,16441.583,913.421278,822.07915,214.450099,6,0
0,0,11,11,21,26,47,92,56,148,0.000333,0.274026,20,16441.583,913.421278,822.07915,214.450099,6,0
0,0,51,51,28,36,64,338,200,538,0.000333,1.076,70,225960,12553.33333,3228,320.723238,34,0
0,0,65,65,33,47,80,478,273,751,0.000333,1.582589,80,379821.4399,21101.19111,4747.767999,427.530682,20,0
0,0,82,82,31,58,89,478,330,808,0.000333,1.744131,75,392429.4459,21801.63588,5232.392612,493.342983,33,0
0,0,96,96,33,67,100,576,405,981,0.000333,2.172541,96,625691.8005,34760.65559,6517.622922,572.892982,36,0
0,0,89,89,33,61,94,530,375,905,0.000333,1.977301,96,569462.6794,31636.81552,5931.902911,528.239984,35,0
0,0,48,48,34,47,81,311,238,549,0.000333,1.160193,85,295849.1004,16436.06113,3480.577652,434.039413,17,0
0,0,50,50,35,47,82,345,264,609,0.000333,1.290583,85,329098.6795,18283.25997,3871.749171,440.590582,23,0
0,0,56,56,33,54,87,498,333,831,0.000333,1.784695,96,513992.2603,28555.12557,5354.086045,477.228931,24,0
0,0,53,53,31,49,80,594,356,950,0.000333,2.001944,105,630612.3275,35034.01819,6005.83169,428.700868,23,0
0,0,18,18,16,27,43,87,55,142,0.000333,0.256843,16,12328.47352,684.915196,770.529595,192.381963,10,0
0,0,14,14,21,36,57,110,86,196,0.000333,0.381082,20,22864.92886,1270.273825,1143.246443,278.355966,12,0
0,0,19,19,21,37,58,139,105,244,0.000333,0.476449,20,28586.94726,1588.163736,1429.347363,284.98844,15,0
0,0,14,14,21,36,57,107,83,190,0.000333,0.369416,20,22164.98205,1231.387892,1108.249103,278.355966,12,0
0,0,19,19,21,37,58,136,102,238,0.000333,0.464733,20,27883.98954,1549.11053,1394.199477,284.98844,15,0
0,0,13,13,22,35,57,121,92,213,0.000333,0.414135,22,27332.92261,1518.4957,1242.405573,277.632401,9,0
0,0,18,18,22,37,59,150,111,261,0.000333,0.51179,33,50667.20458,2814.844699,1535.369836,290.85727,12,0
0,0,7,7,13,25,38,55,57,112,0.000333,0.195923,12,7053.214578,391.845254,587.767882,164.202121,3,0
0,0,30,30,22,58,80,225,159,384,0.000333,0.809207,22,53407.64855,2967.091586,2427.620388,437.870393,14,0
0,0,13,13,18,24,42,81,68,149,0.000333,0.267818,18,14462.19533,803.455296,803.455296,185.09775,6,0
0,0,38,38,27,55,82,251,177,428,0.000333,0.907011,39,106120.2581,5895.569892,2721.032258,446.356747,21,0
0,0,74,74,33,80,113,445,312,757,0.000333,1.720958,48,247818.0228,13767.66793,5162.875475,672.219254,41,0
0,0,92,92,30,91,121,577,422,999,0.000333,2.303981,60,414716.6624,23039.81458,6911.944374,739.41603,57,0
0,0,70,70,31,78,109,421,297,718,0.000333,1.619852,45,218680.0355,12148.89086,4859.556345,643.841459,39,0
0,0,6,6,12,10,22,30,20,50,0.000333,0.074324,12,2675.658971,148.647721,222.971581,76.238831,4,0
0,0,11,11,15,17,32,73,59,132,0.000333,0.22,21,13860,770,660,128.090227,11,0
0,0,15,15,16,18,34,72,55,127,0.000333,0.215369,24,15506.58674,861.477041,646.107781,139.05865,8,0
0,0,18,18,20,31,51,104,87,191,0.000333,0.361144,20,21668.66481,1203.814711,1083.43324,240.018648,11,0
0,0,12,12,16,24,40,81,67,148,0.000333,0.262548,16,12602.32573,700.129207,787.645358,174.0391,7,0
0,0,16,16,21,31,52,106,93,199,0.000333,0.378129,30,34031.62512,1890.64584,1134.387504,245.818752,9,0
0,0,16,16,20,31,51,104,93,197,0.000333,0.372489,30,33524.03377,1862.446321,1117.467792,240.018648,9,0
0,0,31,31,23,29,52,175,105,280,0.000333,0.532041,33,52672.063,2926.225722,1596.123121,244.923374,9,0
0,0,21,21,22,27,49,139,92,231,0.000333,0.432333,33,42800.93314,2377.829619,1296.997974,226.489458,12,0
0,0,25,25,22,28,50,138,88,226,0.000333,0.42517,33,42091.87946,2338.437748,1275.511499,232.713433,9,0
0,0,28,28,24,41,65,170,120,290,0.000333,0.582162,24,41915.67998,2328.648888,1746.486666,329.698732,12,0
0,0,31,31,21,30,51,170,102,272,0.000333,0.5143,30,46286.99079,2571.499488,1542.899693,239.445384,13,0
0,0,31,31,20,27,47,185,98,283,0.000333,0.523983,30,47158.45935,2619.914408,1571.948645,214.820524,19,0
0,0,25,25,19,25,44,153,83,236,0.000333,0.429475,27,34787.49827,1932.638793,1288.425862,196.807027,14,0
0,0,22,22,21,34,55,147,100,247,0.000333,0.475999,20,28559.91699,1586.662055,1427.995849,265.212402,8,0
0,0,26,26,26,41,67,172,126,298,0.000333,0.602565,39,70500.08857,3916.671587,1807.694579,341.871065,10,0
0,0,26,26,26,41,67,170,126,296,0.000333,0.598521,39,70026.93362,3890.385201,1795.5624,341.871065,10,0
0,0,27,27,16,21,37,159,94,253,0.000333,0.439331,32,42175.73445,2343.096358,1317.991702,156.238666,18,0
0,0,48,48,29,52,81,309,201,510,0.000333,1.077775,42,135799.5871,7544.421503,3233.323501,437.304314,18,0
0,0,47,47,30,50,80,300,194,494,0.000333,1.041011,45,140536.4615,7807.581197,3123.032479,429.399527,19,0
0,0,48,48,30,53,83,311,201,512,0.000333,1.088007,45,146880.9085,8160.050472,3264.020189,450.786502,18,0
0,0,47,47,31,50,81,302,194,496,0.000333,1.048189,45,141505.4521,7861.414004,3144.565601,435.772895,19,0
0,0,8,8,13,13,26,40,26,66,0.000333,0.10341,12,3722.748257,206.819348,310.229021,96.211433,6,0
0,0,8,8,13,21,34,61,54,115,0.000333,0.195019,12,7020.698721,390.038818,585.058227,140.344382,3,0
0,0,9,9,14,22,36,65,56,121,0.000333,0.20852,14,8757.852952,486.547386,625.560925,151.410465,3,0
0,0,21,21,17,24,41,101,78,179,0.000333,0.319667,24,23016.04341,1278.669078,959.001809,179.525968,9,0
0,0,40,40,27,48,75,237,163,400,0.000333,0.830509,39,97169.57157,5398.309532,2491.527476,396.460163,21,0
0,0,22,22,19,26,45,114,86,200,0.000333,0.366124,27,29656.00672,1647.555929,1098.370619,202.922055,11,0
0,0,41,41,29,49,78,250,171,421,0.000333,0.882051,42,111138.482,6174.360113,2646.154334,416.002231,23,0
0,0,10,10,18,21,39,90,61,151,0.000333,0.266032,18,14365.72323,798.095735,798.095735,167.297316,4,0
0,0,27,27,17,30,47,86,66,152,0.000333,0.281433,16,13508.76009,750.486672,844.297505,216.693586,7,0
0,0,25,25,19,41,60,148,106,254,0.000333,0.500117,18,27006.3038,1500.350211,1500.350211,300.370255,19,0
0,0,31,31,20,45,65,163,123,286,0.000333,0.574132,20,34447.94389,1913.774661,1722.397195,333.571951,16,0
0,0,15,15,29,25,54,127,94,221,0.000333,0.423943,42,53416.8658,2967.603655,1271.830138,256.977854,14,0
0,0,5,5,12,14,26,45,34,79,0.000333,0.123778,12,4456.016853,247.556492,371.334738,96.322519,2,0
0,0,33,33,21,49,70,189,139,328,0.000333,0.670135,20,40208.09659,2233.783144,2010.40483,367.359448,20,0
0,0,37,37,21,51,72,196,150,346,0.000333,0.711598,20,42695.88101,2371.993389,2134.79405,381.532358,17,0
0,0,50,50,15,42,57,184,125,309,0.000333,0.600788,14,25233.0822,1401.8379,1802.363014,285.080691,24,0
0,0,62,62,30,39,69,447,277,724,0.000333,1.474191,105,464370.0292,25798.33496,4422.571707,353.337404,39,0
0,0,37,37,29,44,73,272,177,449,0.000333,0.92641,56,155636.9487,8646.49715,2779.231227,381.09644,14,0
0,0,21,21,20,25,45,101,83,184,0.000333,0.336834,30,30315.02909,1684.168283,1010.50097,202.534967,13,0
0,0,46,46,28,39,67,413,205,618,0.000333,1.249614,70,262419.0184,14578.83435,3748.84312,340.736624,13,0
0,0,81,81,29,60,89,484,321,805,0.000333,1.737655,70,364907.5788,20272.64327,5212.965412,495.294885,31,0
0,0,74,74,29,54,83,438,291,729,0.000333,1.549135,70,325318.2622,18073.23679,4647.403745,451.645374,30,0
0,0,70,70,29,56,85,420,280,700,0.000333,1.495525,70,314060.1559,17447.78644,4486.573655,466.093324,27,0
0,0,63,63,29,50,79,374,250,624,0.000333,1.311186,70,275349.1431,15297.17462,3933.559187,423.074258,26,0
0,0,66,66,28,55,83,400,263,663,0.000333,1.408884,56,236692.464,13149.58133,4226.651143,452.580722,27,0
0,0,66,66,28,54,82,404,265,669,0.000333,1.417734,56,238179.3283,13232.18491,4253.202291,445.369863,27,0
0,0,57,57,26,46,72,327,210,537,0.000333,1.104417,52,172288.9857,9571.610319,3313.249726,376.295283,25,0
0,0,26,26,23,29,52,167,114,281,0.000333,0.533941,33,52860.17751,2936.676528,1601.823561,244.923374,10,0
0,0,28,28,23,29,52,175,120,295,0.000333,0.560543,44,73991.70754,4110.650419,1681.629717,244.923374,10,0
0,0,11,11,21,26,47,92,56,148,0.000333,0.274026,20,16441.583,913.421278,822.07915,214.450099,6,0
0,0,11,11,21,26,47,92,56,148,0.000333,0.274026,20,16441.583,913.421278,822.07915,214.450099,6,0
0,0,51,51,28,36,64,338,200,538,0.000333,1.076,70,225960,12553.33333,3228,320.723238,34,0
0,0,65,65,33,47,80,478,273,751,0.000333,1.582589,80,379821.4399,21101.19111,4747.767999,427.530682,20,0
0,0,85,85,31,59,90,490,339,829,0.000333,1.793915,75,403630.9663,22423.94257,5381.746217,500.656026,33,0
0,0,50,50,35,47,82,345,264,609,0.000333,1.290583,85,329098.6795,18283.25997,3871.749171,440.590582,23,0
0,0,48,48,34,47,81,311,238,549,0.000333,1.160193,85,295849.1004,16436.06113,3480.577652,434.039413,17,0
0,0,92,92,33,62,95,542,384,926,0.000333,2.027895,96,584033.8842,32446.3269,6083.686293,535.625177,35,0
0,0,56,56,33,54,87,498,333,831,0.000333,1.784695,96,513992.2603,28555.12557,5354.086045,477.228931,24,0
0,0,53,53,31,49,80,594,356,950,0.000333,2.001944,105,630612.3275,35034.01819,6005.83169,428.700868,23,0
0,0,20,20,16,29,45,87,59,146,0.000333,0.26727,16,12828.96883,712.720491,801.810552,204.881449,10,0
0,0,29,29,22,47,69,314,169,483,0.000333,0.983472,33,97363.77132,5409.098406,2950.417313,359.173172,6,0
0,0,29,29,22,47,69,314,169,483,0.000333,0.983472,33,97363.77132,5409.098406,2950.417313,359.173172,6,0
0,0,28,28,22,48,70,308,167,475,0.000333,0.97047,33,96076.51129,5337.583961,2911.409433,366.185696,6,0
0,0,28,28,22,48,70,308,167,475,0.000333,0.97047,33,96076.51129,5337.583961,2911.409433,366.185696,6,0
0,0,18,18,15,25,40,103,57,160,0.000333,0.283836,14,11921.11893,662.284385,851.508495,174.699764,7,0
0,0,18,18,15,25,40,104,57,161,0.000333,0.28561,14,11995.62593,666.423663,856.830423,174.699764,7,0
0,0,5,5,11,12,23,27,21,48,0.000333,0.072377,5,1085.654869,60.314159,217.130974,81.073298,2,0
0,0,9,9,13,15,28,59,39,98,0.000333,0.15704,12,5653.449388,314.080522,471.120782,106.709075,4,0
0,0,25,25,26,27,53,164,111,275,0.000333,0.525059,52,81909.2625,4550.514583,1575.178125,250.593395,9,0
0,0,19,19,24,26,50,134,90,224,0.000333,0.421408,36,45512.05631,2528.447573,1264.223787,232.250533,8,0
0,0,42,42,16,51,67,269,209,478,0.000333,0.96653,32,92786.90026,5154.827792,2899.590633,353.293692,9,0
0,0,35,35,18,44,62,256,190,446,0.000333,0.885191,36,95600.57596,5311.143109,2655.571554,315.273641,6,0
0,0,36,36,19,44,63,261,194,455,0.000333,0.906554,36,97907.84515,5439.32473,2719.662365,320.925614,7,0
0,0,14,14,17,17,34,87,68,155,0.000333,0.262852,32,25233.81569,1401.87865,788.55674,138.973737,5,0
0,0,12,12,13,18,31,75,57,132,0.000333,0.217985,18,11771.17043,653.953913,653.953913,123.164366,4,0
0,0,13,13,14,17,31,76,55,131,0.000333,0.216333,21,13628.99405,757.166336,648.999717,122.789837,5,0
0,0,12,12,14,17,31,76,57,133,0.000333,0.219636,21,13837.0703,768.726127,658.908109,122.789837,4,0
0,0,12,12,14,19,33,74,56,130,0.000333,0.21859,14,9180.797297,510.044294,655.771236,134.013592,4,0
0,0,19,19,19,25,44,101,78,179,0.000333,0.325746,27,26385.43301,1465.85739,977.23826,196.807027,6,0
0,0,19,19,23,24,47,118,89,207,0.000333,0.383267,33,37943.39645,2107.966469,1149.799892,214.081025,7,0
0,0,21,21,20,24,44,124,94,218,0.000333,0.396719,30,35704.68279,1983.593488,1190.156093,196.477662,8,0
0,0,20,20,26,27,53,128,92,220,0.000333,0.420048,39,49145.5575,2730.30875,1260.1425,250.593395,8,0
0,0,10,10,12,15,27,57,45,102,0.000333,0.161666,18,8729.973454,484.998525,484.998525,101.622909,3,0
0,0,25,25,25,30,55,167,132,299,0.000333,0.576209,48,82974.07461,4609.670812,1728.626554,263.303123,24,0
0,0,14,14,14,23,37,90,71,161,0.000333,0.279574,21,17613.16183,978.508991,838.721992,157.344894,4,0
0,0,14,14,14,22,36,90,70,160,0.000333,0.275729,21,17370.94801,965.052667,827.188,151.410465,4,0
0,0,14,14,15,24,39,93,72,165,0.000333,0.290697,21,18313.91869,1017.439927,872.091366,168.642459,4,0
0,0,14,14,14,23,37,93,71,164,0.000333,0.284783,21,17941.35739,996.742077,854.350352,157.344894,4,0
0,0,31,31,23,43,66,167,132,299,0.000333,0.602425,33,59640.03678,3313.335376,1807.273842,337.371309,9,0
0,0,30,30,23,40,63,160,123,283,0.000333,0.563857,33,55821.81721,3101.212067,1691.570218,316.919049,9,0
0,0,14,14,15,22,37,86,67,153,0.000333,0.265682,21,16737.97366,929.887426,797.046365,156.710855,4,0
0,0,30,30,22,38,60,155,118,273,0.000333,0.537527,33,53215.17738,2956.398743,1612.581133,297.528741,9,0
0,0,14,14,15,20,35,85,69,154,0.000333,0.263303,21,16588.10128,921.561182,789.909585,145.041921,4,0
0,0,14,14,15,23,38,89,70,159,0.000333,0.27814,21,17522.82997,973.490554,834.420475,162.645284,4,0
0,0,14,14,14,22,36,89,69,158,0.000333,0.272283,21,17153.81116,952.989509,816.84815,151.410465,4,0
0,0,14,14,15,24,39,93,72,165,0.000333,0.290697,21,18313.91869,1017.439927,872.091366,168.642459,4,0
0,0,14,14,14,23,37,93,71,164,0.000333,0.284783,21,17941.35739,996.742077,854.350352,157.344894,4,0
0,0,14,14,14,20,34,90,69,159,0.000333,0.269636,21,16987.03843,943.724357,808.906592,139.741531,4,0
0,0,14,14,14,18,32,91,69,160,0.000333,0.266667,21,16800,933.333333,800,128.361619,4,0
0,0,14,14,15,24,39,93,72,165,0.000333,0.290697,21,18313.91869,1017.439927,872.091366,168.642459,4,0
0,0,14,14,14,23,37,93,71,164,0.000333,0.284783,21,17941.35739,996.742077,854.350352,157.344894,4,0
0,0,14,14,15,23,38,89,70,159,0.000333,0.27814,21,17522.82997,973.490554,834.420475,162.645284,4,0
0,0,14,14,14,22,36,89,69,158,0.000333,0.272283,21,17153.81116,952.989509,816.84815,151.410465,4,0
0,0,14,14,14,23,37,90,71,161,0.000333,0.279574,21,17613.16183,978.508991,838.721992,157.344894,4,0
0,0,14,14,14,22,36,90,70,160,0.000333,0.275729,21,17370.94801,965.052667,827.188,151.410465,4,0
0,0,31,31,23,42,65,166,132,298,0.000333,0.598222,33,59223.96507,3290.220282,1794.665608,330.519257,9,0
0,0,30,30,23,39,62,159,123,282,0.000333,0.559694,33,55409.75086,3078.319492,1679.08336,310.172612,9,0
0,0,14,14,14,23,37,85,67,152,0.000333,0.263946,14,11085.71676,615.873153,791.836912,157.344894,4,0
0,0,30,30,22,37,59,154,118,272,0.000333,0.53336,33,52802.60401,2933.478001,1600.078909,290.85727,9,0
0,0,14,14,14,21,35,84,69,153,0.000333,0.261593,21,16480.38633,915.577019,784.780302,145.541635,4,0
0,0,14,14,15,24,39,93,72,165,0.000333,0.290697,21,18313.91869,1017.439927,872.091366,168.642459,4,0
0,0,14,14,14,23,37,93,71,164,0.000333,0.284783,21,17941.35739,996.742077,854.350352,157.344894,4,0
0,0,14,14,17,21,38,86,65,151,0.000333,0.264146,24,19018.48931,1056.582739,792.437055,161.725534,5,0
0,0,16,16,15,22,37,92,70,162,0.000333,0.28131,21,17722.56035,984.586686,843.931445,156.710855,6,0
0,0,15,15,20,25,45,96,68,164,0.000333,0.300221,20,18013.27816,1000.737675,900.663908,202.534967,6,0
0,0,13,13,13,14,27,67,51,118,0.000333,0.187026,18,10099.38106,561.076725,561.076725,101.408685,4,0
0,0,19,19,23,26,49,128,107,235,0.000333,0.439819,44,58056.09979,3225.338877,1319.456813,226.253358,22,0
0,0,16,16,22,21,43,88,79,167,0.000333,0.302062,33,29904.14506,1661.341392,906.186214,190.346161,11,0
0,0,17,17,22,25,47,119,98,217,0.000333,0.401782,33,39776.41077,2209.800598,1205.345781,214.2039,20,0
0,0,24,24,24,28,52,160,125,285,0.000333,0.541542,48,77982.01534,4332.334186,1624.62532,244.645038,22,0
0,0,20,20,22,27,49,147,113,260,0.000333,0.486608,44,64232.28062,3568.460034,1459.824559,226.489458,19,0
0,0,49,49,23,35,58,259,199,458,0.000333,0.894318,55,147562.5413,8197.918959,2682.955296,283.566831,23,0
0,0,33,33,20,33,53,188,148,336,0.000333,0.641527,40,76983.25091,4276.847273,1924.581273,252.903568,17,0
0,0,44,44,20,34,54,231,175,406,0.000333,0.778828,50,116824.2163,6490.234239,2336.484326,259.412299,23,0
0,0,61,61,23,37,60,298,227,525,0.000333,1.033706,66,204673.7591,11370.7644,3101.117563,296.7917,29,0
0,0,44,44,27,42,69,280,221,501,0.000333,1.020124,65,198924.0989,11051.33883,3060.370753,354.859294,35,0
0,0,37,37,24,34,58,223,164,387,0.000333,0.75568,48,108817.855,6045.436387,2267.038645,283.012837,19,0
0,0,32,32,22,33,55,176,138,314,0.000333,0.605116,44,79875.2658,4437.514767,1815.34695,264.572502,15,0
0,0,34,34,24,34,58,206,156,362,0.000333,0.706863,48,101788.2778,5654.904321,2120.58912,283.012837,17,0
0,0,32,32,22,33,55,179,141,320,0.000333,0.616678,44,81401.54477,4522.308043,1850.035108,264.572502,14,0
0,0,32,32,22,33,55,179,141,320,0.000333,0.616678,44,81401.54477,4522.308043,1850.035108,264.572502,14,0
0,0,32,32,22,34,56,182,142,324,0.000333,0.627194,44,82789.65177,4599.425098,1881.582995,271.081232,16,0
0,0,36,36,22,34,56,194,156,350,0.000333,0.677525,44,89433.2658,4968.514767,2032.574223,271.081232,14,0
0,0,35,35,22,33,55,189,152,341,0.000333,0.657148,44,86743.52114,4819.084508,1971.443662,264.572502,14,0
0,0,35,35,22,33,55,189,152,341,0.000333,0.657148,44,86743.52114,4819.084508,1971.443662,264.572502,14,0
0,0,44,44,24,51,75,250,202,452,0.000333,0.938475,36,101355.3377,5630.852096,2815.426048,399.332792,20,0
0,0,35,35,22,34,56,190,153,343,0.000333,0.663974,44,87644.60048,4869.144471,1991.922738,271.081232,14,0
0,0,35,35,22,33,55,190,153,343,0.000333,0.661002,44,87252.2808,4847.348933,1983.006382,264.572502,14,0
0,0,36,36,22,34,56,194,156,350,0.000333,0.677525,44,89433.2658,4968.514767,2032.574223,271.081232,14,0
0,0,44,44,24,51,75,250,202,452,0.000333,0.938475,36,101355.3377,5630.852096,2815.426048,399.332792,20,0
0,0,35,35,22,33,55,187,152,339,0.000333,0.653294,44,86234.76149,4790.820083,1959.880943,264.572502,14,0
0,0,34,34,20,32,52,182,148,330,0.000333,0.627048,40,75245.80428,4180.32246,1881.145107,246.438562,14,0
0,0,34,34,20,32,52,182,148,330,0.000333,0.627048,40,75245.80428,4180.32246,1881.145107,246.438562,14,0
0,0,43,43,23,50,73,243,198,441,0.000333,0.909904,33,90080.51681,5004.473156,2729.71263,386.234734,20,0
0,0,34,34,21,34,55,184,150,334,0.000333,0.643658,40,77238.96577,4291.053654,1930.974144,265.212402,14,0
0,0,34,34,21,33,54,184,150,334,0.000333,0.640711,40,76885.29703,4271.40539,1922.132426,258.703672,14,0
0,0,35,35,22,34,56,188,153,341,0.000333,0.660103,44,87133.55325,4840.752958,1980.308028,271.081232,14,0
0,0,43,43,23,51,74,244,199,443,0.000333,0.916929,33,90775.99875,5043.111042,2750.787841,393.335617,20,0
0,0,61,61,24,41,65,306,238,544,0.000333,1.092056,60,196570.0854,10920.5603,3276.16809,329.698732,25,0
0,0,31,31,20,33,53,172,135,307,0.000333,0.586157,40,70338.86318,3907.714621,1758.47158,252.903568,17,0
0,0,42,42,20,34,54,215,162,377,0.000333,0.723198,40,86783.70353,4821.316863,2169.592588,259.412299,23,0
0,0,59,59,23,37,60,282,214,496,0.000333,0.976606,55,161139.9754,8952.220858,2929.817735,296.7917,29,0
0,0,42,42,27,42,69,264,208,472,0.000333,0.961075,52,149927.6243,8329.312459,2883.223544,354.859294,35,0
0,0,35,35,24,34,58,207,151,358,0.000333,0.699052,48,100663.5454,5592.41919,2097.157196,283.012837,19,0
0,0,30,30,22,33,55,160,125,285,0.000333,0.549229,33,54373.68811,3020.76045,1647.687518,264.572502,15,0
0,0,32,32,24,34,58,190,143,333,0.000333,0.650236,48,93633.96823,5201.887124,1950.707671,283.012837,17,0
0,0,30,30,22,33,55,163,128,291,0.000333,0.560792,33,55518.39733,3084.355407,1682.375677,264.572502,14,0
0,0,30,30,22,33,55,163,128,291,0.000333,0.560792,33,55518.39733,3084.355407,1682.375677,264.572502,14,0
0,0,30,30,22,34,56,166,129,295,0.000333,0.571057,33,56534.60017,3140.81112,1713.169702,271.081232,16,0
0,0,34,34,22,34,56,178,143,321,0.000333,0.621387,44,82023.08092,4556.837829,1864.16093,271.081232,14,0
0,0,33,33,22,33,55,173,139,312,0.000333,0.601261,44,79366.50615,4409.250342,1803.784231,264.572502,14,0
0,0,33,33,22,33,55,173,139,312,0.000333,0.601261,44,79366.50615,4409.250342,1803.784231,264.572502,14,0
0,0,42,42,24,51,75,234,189,423,0.000333,0.878263,36,94852.45102,5269.580612,2634.790306,399.332792,20,0
0,0,33,33,22,34,56,174,140,314,0.000333,0.607836,44,80234.4156,4457.467534,1823.509446,271.081232,14,0
0,0,33,33,22,33,55,174,140,314,0.000333,0.605116,44,79875.2658,4437.514767,1815.34695,264.572502,14,0
0,0,34,34,22,34,56,178,143,321,0.000333,0.621387,44,82023.08092,4556.837829,1864.16093,271.081232,14,0
0,0,42,42,24,51,75,234,189,423,0.000333,0.878263,36,94852.45102,5269.580612,2634.790306,399.332792,20,0
0,0,33,33,22,33,55,171,139,310,0.000333,0.597407,44,78857.74649,4380.985916,1792.221511,264.572502,14,0
0,0,32,32,20,32,52,166,135,301,0.000333,0.571944,40,68633.29421,3812.960789,1715.832355,246.438562,14,0
0,0,32,32,20,32,52,166,135,301,0.000333,0.571944,40,68633.29421,3812.960789,1715.832355,246.438562,14,0
0,0,41,41,23,50,73,227,185,412,0.000333,0.850069,33,84156.8547,4675.380817,2550.207718,386.234734,20,0
0,0,32,32,21,34,55,168,137,305,0.000333,0.587772,40,70532.58851,3918.477139,1763.314713,265.212402,14,0
0,0,32,32,21,33,54,168,137,305,0.000333,0.58508,40,70209.62753,3900.534863,1755.240688,258.703672,14,0
0,0,33,33,22,34,56,172,140,312,0.000333,0.603965,44,79723.36837,4429.076021,1811.894736,271.081232,14,0
0,0,41,41,23,51,74,228,186,414,0.000333,0.856905,33,84833.55188,4712.975105,2570.713693,393.335617,20,0
0,0,4,4,9,11,20,35,23,58,0.000333,0.083557,8,2005.374636,111.409702,250.67183,66.583073,1,0
0,0,23,23,17,22,39,104,81,185,0.000333,0.325933,24,23467.18585,1303.732547,977.79941,167.594364,11,0
0,0,75,75,25,44,69,366,279,645,0.000333,1.313333,72,283679.8758,15759.9931,3939.998275,356.311396,31,0
0,0,61,61,22,42,64,310,236,546,0.000333,1.092,55,180180,10010,3276,324.584827,25,0
0,0,59,59,22,42,64,297,225,522,0.000333,1.044,55,172260,9570,3132,324.584827,25,0
0,0,26,26,16,36,52,197,152,349,0.000333,0.663151,32,63662.51077,3536.806154,1989.453462,250.1173,6,0
0,0,23,23,17,37,54,209,155,364,0.000333,0.69826,32,67032.92963,3724.051646,2094.779051,262.236643,5,0
0,0,29,29,19,30,49,160,127,287,0.000333,0.537141,36,58011.18211,3222.843451,1611.421725,227.917341,14,0
0,0,48,48,24,40,64,250,198,448,0.000333,0.896,48,129024,7168,2688,322.916224,22,0
0,0,32,32,19,35,54,179,147,326,0.000333,0.625364,36,67539.35973,3752.186651,1876.093326,260.235528,16,0
0,0,41,41,26,42,68,261,208,469,0.000333,0.951673,52,148461.0438,8247.835765,2855.020073,348.688764,34,0
0,0,27,27,19,29,48,155,125,280,0.000333,0.521263,36,56296.42201,3127.579,1563.7895,221.592072,13,0
0,0,24,24,15,28,43,115,92,207,0.000333,0.374412,21,23587.97289,1310.442938,1123.236804,193.209297,6,0
0,0,22,22,15,27,42,110,86,196,0.000333,0.352298,21,22194.77851,1233.043251,1056.894215,186.985321,6,0
0,0,21,21,15,27,42,109,84,193,0.000333,0.346906,21,21855.06252,1214.17014,1040.717263,186.985321,6,0
0,0,19,19,15,25,40,107,79,186,0.000333,0.32996,21,20787.45114,1154.858397,989.878626,174.699764,6,0
0,0,21,21,21,26,47,140,107,247,0.000333,0.457328,40,54879.33786,3048.852103,1371.983446,214.450099,8,0
0,0,26,26,24,33,57,171,128,299,0.000333,0.581345,36,62785.22811,3488.068228,1744.034114,276.504106,10,0
0,0,15,15,19,21,40,81,64,145,0.000333,0.257227,27,20835.34849,1157.519361,771.679574,172.949289,6,0
0,0,14,14,26,24,50,85,62,147,0.000333,0.276549,26,21570.81836,1198.378798,829.64686,232.250533,6,0
0,0,35,35,22,29,51,176,136,312,0.000333,0.589932,44,77871.0551,4326.169727,1769.796707,238.988944,14,0
0,0,19,19,18,26,44,105,85,190,0.000333,0.345764,27,28006.8842,1555.938011,1037.292008,197.270083,8,0
0,0,30,30,19,28,47,148,112,260,0.000333,0.481398,36,51990.95165,2888.386203,1444.193101,215.316561,14,0
0,0,47,47,22,33,55,215,164,379,0.000333,0.730378,44,96409.95458,5356.108588,2191.135331,264.572502,20,0
0,0,30,30,26,37,63,197,158,355,0.000333,0.707311,52,110340.5874,6130.032633,2121.934373,314.961207,26,0
0,0,23,23,24,28,52,140,101,241,0.000333,0.457935,36,49457.015,2747.611944,1373.805972,244.645038,10,0
0,0,18,18,21,26,47,93,75,168,0.000333,0.311057,20,18663.41854,1036.856586,933.170927,214.450099,6,0
0,0,20,20,24,28,52,123,93,216,0.000333,0.410432,36,44326.61925,2462.589958,1231.294979,244.645038,8,0
0,0,18,18,21,26,47,96,78,174,0.000333,0.322166,30,28994.95381,1610.830767,966.49846,214.450099,5,0
0,0,18,18,21,26,47,96,78,174,0.000333,0.322166,30,28994.95381,1610.830767,966.49846,214.450099,5,0
0,0,18,18,21,27,48,99,79,178,0.000333,0.331374,20,19882.4665,1104.581472,994.123325,220.620628,7,0
0,0,22,22,21,27,48,111,93,204,0.000333,0.379777,30,34179.9705,1898.88725,1139.33235,220.620628,5,0
0,0,21,21,21,26,47,106,89,195,0.000333,0.361048,30,32494.34478,1805.241377,1083.144826,214.450099,5,0
0,0,21,21,21,26,47,106,89,195,0.000333,0.361048,30,32494.34478,1805.241377,1083.144826,214.450099,5,0
0,0,30,30,24,45,69,167,139,306,0.000333,0.623069,36,67291.50542,3738.416968,1869.208484,357.172489,11,0
0,0,21,21,21,27,48,107,90,197,0.000333,0.366746,30,33007.12838,1833.729354,1100.237613,220.620628,5,0
0,0,21,21,21,26,47,107,90,197,0.000333,0.364751,30,32827.62011,1823.756673,1094.254004,214.450099,5,0
0,0,22,22,21,27,48,111,93,204,0.000333,0.379777,30,34179.9705,1898.88725,1139.33235,220.620628,5,0
0,0,30,30,24,45,69,167,139,306,0.000333,0.623069,36,67291.50542,3738.416968,1869.208484,357.172489,11,0
0,0,21,21,21,26,47,104,89,193,0.000333,0.357345,30,32161.06945,1786.726081,1072.035648,214.450099,5,0
0,0,20,20,19,25,44,99,85,184,0.000333,0.334845,27,27122.45628,1506.803127,1004.535418,196.807027,5,0
0,0,20,20,19,25,44,99,85,184,0.000333,0.334845,27,27122.45628,1506.803127,1004.535418,196.807027,5,0
0,0,29,29,23,44,67,160,135,295,0.000333,0.596499,33,59053.37827,3280.743237,1789.496311,344.256916,11,0
0,0,20,20,20,27,47,101,87,188,0.000333,0.348088,30,31327.88112,1740.43784,1044.262704,214.820524,5,0
0,0,20,20,20,26,46,101,87,188,0.000333,0.346143,30,31152.88943,1730.71608,1038.429648,208.649995,5,0
0,0,21,21,21,27,48,105,90,195,0.000333,0.363023,30,32672.03063,1815.112813,1089.067688,220.620628,5,0
0,0,29,29,23,45,68,161,136,297,0.000333,0.602659,33,59663.22331,3314.623517,1807.976464,351.175314,11,0
0,0,36,36,22,29,51,182,141,323,0.000333,0.610731,44,80616.50896,4478.694942,1832.193385,238.988944,16,0
0,0,20,20,18,27,45,111,90,201,0.000333,0.367954,27,29804.28675,1655.793709,1103.862472,203.440613,10,0
0,0,31,31,19,29,48,154,117,271,0.000333,0.504508,36,54486.89416,3027.049675,1513.524838,221.592072,16,0
0,0,48,48,22,33,55,221,169,390,0.000333,0.751577,55,124010.1659,6889.453659,2254.730288,264.572502,22,0
0,0,31,31,26,38,64,203,163,366,0.000333,0.732,52,114192,6344,2196,321.632678,28,0
0,0,24,24,24,29,53,146,106,252,0.000333,0.481145,36,51963.69436,2886.871909,1443.435955,250.920549,12,0
0,0,19,19,21,27,48,99,80,179,0.000333,0.333236,20,19994.16575,1110.786986,999.708288,220.620628,8,0
0,0,21,21,24,29,53,129,98,227,0.000333,0.433413,36,46808.56596,2600.475886,1300.237943,250.920549,10,0
0,0,19,19,21,27,48,102,83,185,0.000333,0.344406,30,30996.54188,1722.030104,1033.218063,220.620628,7,0
0,0,19,19,21,27,48,102,83,185,0.000333,0.344406,30,30996.54188,1722.030104,1033.218063,220.620628,7,0
0,0,19,19,21,28,49,105,84,189,0.000333,0.353727,30,31835.40482,1768.633601,1061.180161,226.844604,9,0
0,0,23,23,21,28,49,117,98,215,0.000333,0.402388,30,36214.8785,2011.937694,1207.162616,226.844604,7,0
0,0,22,22,21,27,48,112,94,206,0.000333,0.383501,30,34515.06825,1917.503792,1150.502275,220.620628,7,0
0,0,22,22,21,27,48,112,94,206,0.000333,0.383501,30,34515.06825,1917.503792,1150.502275,220.620628,7,0
0,0,31,31,24,46,70,173,144,317,0.000333,0.647661,36,69947.37779,3885.965433,1942.982716,364.12295,13,0
0,0,22,22,21,28,49,113,95,208,0.000333,0.389287,30,35035.78943,1946.432746,1167.859648,226.844604,7,0
0,0,22,22,21,27,48,113,95,208,0.000333,0.387224,30,34850.16601,1936.120334,1161.6722,220.620628,7,0
0,0,23,23,21,28,49,117,98,215,0.000333,0.402388,30,36214.8785,2011.937694,1207.162616,226.844604,7,0
0,0,31,31,24,46,70,173,144,317,0.000333,0.647661,36,69947.37779,3885.965433,1942.982716,364.12295,13,0
0,0,22,22,21,27,48,110,94,204,0.000333,0.379777,30,34179.9705,1898.88725,1139.33235,220.620628,7,0
0,0,21,21,19,26,45,105,90,195,0.000333,0.35697,27,28914.60655,1606.367031,1070.911354,202.922055,7,0
0,0,21,21,19,26,45,105,90,195,0.000333,0.35697,27,28914.60655,1606.367031,1070.911354,202.922055,7,0
0,0,30,30,23,45,68,166,140,306,0.000333,0.620921,33,61471.19977,3415.066654,1862.763629,351.175314,13,0
0,0,21,21,20,28,48,107,92,199,0.000333,0.370469,30,33342.22613,1852.345896,1111.407538,221.0445,7,0
0,0,21,21,20,27,47,107,92,199,0.000333,0.368454,30,33160.89545,1842.271969,1105.363181,214.820524,7,0
0,0,22,22,21,28,49,111,95,206,0.000333,0.385543,30,34698.90684,1927.717046,1156.630228,226.844604,7,0
0,0,30,30,23,46,69,167,141,308,0.000333,0.627142,33,62087.04258,3449.280143,1881.425533,358.125775,13,0
0,0,60,60,30,39,69,419,256,675,0.000333,1.374418,90,371092.8607,20616.27004,4123.254008,353.337404,37,0
0,0,37,37,29,44,73,272,177,449,0.000333,0.92641,56,155636.9487,8646.49715,2779.231227,381.09644,14,0
0,0,21,21,20,25,45,101,83,184,0.000333,0.336834,30,30315.02909,1684.168283,1010.50097,202.534967,13,0
0,0,46,46,28,39,67,413,205,618,0.000333,1.249614,70,262419.0184,14578.83435,3748.84312,340.736624,13,0
0,0,81,81,29,60,89,484,321,805,0.000333,1.737655,70,364907.5788,20272.64327,5212.965412,495.294885,31,0
0,0,74,74,29,54,83,438,291,729,0.000333,1.549135,70,325318.2622,18073.23679,4647.403745,451.645374,30,0
0,0,70,70,29,56,85,420,280,700,0.000333,1.495525,70,314060.1559,17447.78644,4486.573655,466.093324,27,0
0,0,63,63,29,50,79,374,250,624,0.000333,1.311186,70,275349.1431,15297.17462,3933.559187,423.074258,26,0
0,0,66,66,28,55,83,400,263,663,0.000333,1.408884,56,236692.464,13149.58133,4226.651143,452.580722,27,0
0,0,66,66,28,54,82,404,265,669,0.000333,1.417734,56,238179.3283,13232.18491,4253.202291,445.369863,27,0
0,0,57,57,26,46,72,327,210,537,0.000333,1.104417,52,172288.9857,9571.610319,3313.249726,376.295283,25,0
0,0,26,26,23,29,52,167,114,281,0.000333,0.533941,33,52860.17751,2936.676528,1601.823561,244.923374,10,0
0,0,28,28,23,29,52,175,120,295,0.000333,0.560543,44,73991.70754,4110.650419,1681.629717,244.923374,10,0
0,0,11,11,21,26,47,92,56,148,0.000333,0.274026,20,16441.583,913.421278,822.07915,214.450099,6,0
0,0,11,11,21,26,47,92,56,148,0.000333,0.274026,20,16441.583,913.421278,822.07915,214.450099,6,0
0,0,49,49,28,36,64,310,179,489,0.000333,0.978,56,164304,9128,2934,320.723238,32,0
0,0,85,85,31,59,90,490,339,829,0.000333,1.793915,75,403630.9663,22423.94257,5381.746217,500.656026,33,0
0,0,65,65,33,47,80,478,273,751,0.000333,1.582589,80,379821.4399,21101.19111,4747.767999,427.530682,20,0
0,0,92,92,33,62,95,542,384,926,0.000333,2.027895,96,584033.8842,32446.3269,6083.686293,535.625177,35,0
0,0,48,48,34,47,81,311,238,549,0.000333,1.160193,85,295849.1004,16436.06113,3480.577652,434.039413,17,0
0,0,50,50,35,47,82,345,264,609,0.000333,1.290583,85,329098.6795,18283.25997,3871.749171,440.590582,23,0
0,0,53,53,31,49,80,594,356,950,0.000333,2.001944,105,630612.3275,35034.01819,6005.83169,428.700868,23,0
0,0,56,56,33,54,87,498,333,831,0.000333,1.784695,96,513992.2603,28555.12557,5354.086045,477.228931,24,0
0,0,26,26,22,23,45,113,70,183,0.000333,0.335003,33,33165.30085,1842.516714,1005.009117,202.149421,11,0
0,0,13,13,17,21,38,67,53,120,0.000333,0.209917,16,10076.02083,559.778935,629.751302,161.725534,6,0
0,0,10,10,16,20,36,52,41,93,0.000333,0.160268,16,7692.848402,427.380467,480.803025,150.438562,4,0
0,0,10,10,16,19,35,51,39,90,0.000333,0.153878,16,7386.167544,410.342641,461.635472,144.710623,4,0
0,0,10,10,15,21,36,55,45,100,0.000333,0.172331,14,7237.895002,402.105278,516.9925,150.842025,4,0
0,0,13,13,21,25,46,70,58,128,0.000333,0.235672,20,14140.31861,785.573256,707.01593,208.335071,5,0
0,0,13,13,21,23,44,68,54,122,0.000333,0.222017,20,13321.01315,740.056286,666.050657,196.280591,5,0
0,0,13,13,21,24,45,69,56,125,0.000333,0.228827,20,13729.63274,762.757374,686.481637,202.277766,5,0
0,0,13,13,21,25,46,72,60,132,0.000333,0.243037,20,14582.20356,810.12242,729.110178,208.335071,5,0
0,0,13,13,21,23,44,68,55,123,0.000333,0.223837,20,13430.20178,746.122321,671.510089,196.280591,5,0
0,0,48,48,32,35,67,215,133,348,0.000333,0.703666,48,101327.9538,5629.330769,2110.999038,339.524906,17,0
0,0,44,44,29,44,73,206,151,357,0.000333,0.736589,42,92810.22944,5156.123858,2209.767368,381.09644,14,0
0,0,49,49,29,48,77,237,168,405,0.000333,0.846016,42,106598.0391,5922.113281,2538.048549,408.959649,16,0
0,0,37,37,30,38,68,176,117,293,0.000333,0.594542,45,80263.19756,4459.066531,1783.626612,346.627963,12,0
0,0,15,15,20,26,46,100,68,168,0.000333,0.309319,20,18559.16817,1031.064898,927.958409,208.649995,7,0
0,0,49,49,29,45,74,227,162,389,0.000333,0.805159,42,101450.0491,5636.113838,2415.477359,388.014838,16,0
0,0,37,37,30,40,70,186,123,309,0.000333,0.631316,45,85227.68035,4734.871131,1893.948452,360.083842,12,0
0,0,12,12,14,20,34,63,39,102,0.000333,0.172974,7,3632.448469,201.802693,518.92121,139.741531,9,0
0,0,20,20,18,34,52,107,65,172,0.000333,0.326825,9,8824.280684,490.237816,980.475632,248.032387,10,0
0,0,20,20,19,24,43,91,63,154,0.000333,0.278548,18,15041.6059,835.644772,835.644772,190.749723,9,0
0,0,33,33,21,48,69,176,116,292,0.000333,0.594563,20,35673.78283,1981.876824,1783.689141,360.316866,9,0
0,0,57,57,22,58,80,295,195,490,0.000333,1.032582,33,102225.5773,5679.198739,3097.744766,437.870393,14,0
0,0,54,54,22,58,80,281,187,468,0.000333,0.986221,33,97635.8575,5424.214305,2958.662348,437.870393,13,0
0,0,50,50,22,58,80,271,178,449,0.000333,0.946182,33,93672.00858,5204.000477,2838.545715,437.870393,12,0
0,0,21,21,20,24,44,163,104,267,0.000333,0.485889,40,58306.72969,3239.26276,1457.668242,196.477662,5,0
0,0,21,21,20,25,45,159,102,261,0.000333,0.477791,40,57334.94633,3185.274796,1433.373658,202.534967,5,0
0,0,9,9,20,36,56,139,88,227,0.000333,0.439423,20,26365.39135,1464.743964,1318.269567,272.555862,3,0
0,0,20,20,20,26,46,165,102,267,0.000333,0.491597,30,44243.73127,2457.98507,1474.791042,208.649995,5,0
0,0,43,43,19,47,66,227,145,372,0.000333,0.749505,27,60709.89454,3372.771919,2248.514612,341.776299,6,0
0,0,36,36,17,39,56,205,126,331,0.000333,0.640745,24,46133.6275,2562.979306,1922.234479,275.617555,5,0
0,0,39,39,19,47,66,217,136,353,0.000333,0.711224,18,38406.08023,2133.671124,2133.671124,341.776299,5,0
0,0,32,32,17,39,56,195,117,312,0.000333,0.603965,24,43485.47366,2415.859648,1811.894736,275.617555,4,0
0,0,22,22,18,33,51,109,69,178,0.000333,0.336564,18,18174.4508,1009.691711,1009.691711,241.523656,10,0
0,0,57,57,31,46,77,409,237,646,0.000333,1.349448,75,303625.8079,16868.10044,4048.344105,407.663936,35,0
0,0,41,41,31,44,75,283,199,482,0.000333,1.000764,60,180137.4365,10007.63536,3002.290609,393.795077,25,0
0,0,35,35,30,42,72,236,170,406,0.000333,0.834997,60,150299.373,8349.965169,2504.989551,373.68405,21,0
0,0,68,68,30,62,92,493,297,790,0.000333,1.717871,60,309216.8367,17178.71315,5153.613945,516.366889,43,0
0,0,35,35,27,40,67,243,144,387,0.000333,0.782526,39,91555.48415,5086.415786,2347.576517,341.259086,27,0
0,0,25,25,24,27,51,168,110,278,0.000333,0.525645,48,75692.84376,4205.157987,1576.934245,238.421063,14,0
0,0,23,23,24,27,51,158,105,263,0.000333,0.497283,36,53706.52314,2983.69573,1491.847865,238.421063,13,0
0,0,21,21,23,27,50,141,94,235,0.000333,0.442102,33,43768.10475,2431.561375,1326.306205,232.423888,10,0
0,0,18,18,25,27,52,144,95,239,0.000333,0.454135,36,49046.58334,2724.810185,1362.405093,244.478367,13,0
0,0,18,18,25,27,52,144,94,238,0.000333,0.452235,36,48841.36751,2713.409306,1356.704653,244.478367,13,0
0,0,18,18,25,27,52,144,95,239,0.000333,0.454135,36,49046.58334,2724.810185,1362.405093,244.478367,13,0
0,0,20,20,25,27,52,155,101,256,0.000333,0.486438,36,52535.25244,2918.625136,1459.312568,244.478367,14,0
0,0,42,42,29,58,87,311,190,501,0.000333,1.075972,42,135572.417,7531.800947,3227.914691,480.644347,27,0
0,0,41,41,27,49,76,292,176,468,0.000333,0.974677,39,114037.173,6335.398499,2924.030076,403.502745,27,0
0,0,41,41,27,49,76,292,176,468,0.000333,0.974677,39,114037.173,6335.398499,2924.030076,403.502745,27,0
0,0,20,20,25,42,67,166,108,274,0.000333,0.554036,24,39890.60252,2216.144584,1662.108438,342.573737,7,0
0,0,63,63,29,50,79,463,283,746,0.000333,1.56754,70,329183.4307,18287.96837,4702.620438,423.074258,31,0
0,0,26,26,22,22,44,112,68,180,0.000333,0.327566,33,32429.02382,1801.612434,982.697691,196.214991,11,0
0,0,10,10,16,19,35,51,39,90,0.000333,0.153878,16,7386.167544,410.342641,461.635472,144.710623,4,0
0,0,10,10,16,21,37,53,43,96,0.000333,0.166703,16,8001.72037,444.540021,500.107523,156.238666,4,0
0,0,13,13,17,21,38,67,53,120,0.000333,0.209917,16,10076.02083,559.778935,629.751302,161.725534,6,0
0,0,10,10,15,21,36,55,45,100,0.000333,0.172331,14,7237.895002,402.105278,516.9925,150.842025,4,0
0,0,13,13,21,24,45,69,56,125,0.000333,0.228827,20,13729.63274,762.757374,686.481637,202.277766,5,0
0,0,13,13,21,25,46,72,60,132,0.000333,0.243037,20,14582.20356,810.12242,729.110178,208.335071,5,0
0,0,13,13,21,23,44,68,55,123,0.000333,0.223837,20,13430.20178,746.122321,671.510089,196.280591,5,0
0,0,13,13,21,23,44,68,54,122,0.000333,0.222017,20,13321.01315,740.056286,666.050657,196.280591,5,0
0,0,13,13,21,25,46,70,58,128,0.000333,0.235672,20,14140.31861,785.573256,707.01593,208.335071,5,0
0,0,44,44,29,44,73,206,151,357,0.000333,0.736589,42,92810.22944,5156.123858,2209.767368,381.09644,14,0
0,0,48,48,32,35,67,215,133,348,0.000333,0.703666,48,101327.9538,5629.330769,2110.999038,339.524906,17,0
0,0,37,37,30,38,68,176,117,293,0.000333,0.594542,45,80263.19756,4459.066531,1783.626612,346.627963,12,0
0,0,49,49,29,45,74,227,162,389,0.000333,0.805159,42,101450.0491,5636.113838,2415.477359,388.014838,16,0
0,0,49,49,29,48,77,237,168,405,0.000333,0.846016,42,106598.0391,5922.113281,2538.048549,408.959649,16,0
0,0,37,37,30,40,70,186,123,309,0.000333,0.631316,45,85227.68035,4734.871131,1893.948452,360.083842,12,0
0,0,15,15,20,26,46,100,68,168,0.000333,0.309319,20,18559.16817,1031.064898,927.958409,208.649995,7,0
0,0,31,31,26,46,72,170,116,286,0.000333,0.5882,26,45879.56231,2548.864573,1764.59855,376.295283,22,0
0,0,27,27,24,32,56,146,99,245,0.000333,0.474267,36,51220.87041,2845.603912,1422.801956,270.0391,24,0
0,0,28,28,23,28,51,150,101,251,0.000333,0.474593,33,46984.69911,2610.261062,1423.778761,238.647863,29,0
0,0,38,38,25,50,75,198,134,332,0.000333,0.689323,24,49631.22733,2757.290407,2067.967805,398.289214,26,0
0,0,34,34,23,36,59,174,117,291,0.000333,0.570616,33,56491.0212,3138.390067,1711.849127,290.159225,28,0
0,0,35,35,22,32,54,178,119,297,0.000333,0.569734,33,56403.65241,3133.536245,1709.201588,258.107496,33,0
0,0,18,18,20,31,51,104,87,191,0.000333,0.361144,20,21668.66481,1203.814711,1083.43324,240.018648,11,0
0,0,16,16,20,31,51,104,93,197,0.000333,0.372489,30,33524.03377,1862.446321,1117.467792,240.018648,9,0
0,0,16,16,21,31,52,106,93,199,0.000333,0.378129,30,34031.62512,1890.64584,1134.387504,245.818752,9,0
0,0,12,12,16,24,40,81,67,148,0.000333,0.262548,16,12602.32573,700.129207,787.645358,174.0391,7,0
0,0,28,28,24,41,65,170,120,290,0.000333,0.582162,24,41915.67998,2328.648888,1746.486666,329.698732,12,0
0,0,31,31,20,27,47,185,98,283,0.000333,0.523983,30,47158.45935,2619.914408,1571.948645,214.820524,19,0
0,0,26,26,26,41,67,170,126,296,0.000333,0.598521,39,70026.93362,3890.385201,1795.5624,341.871065,10,0
0,0,26,26,26,41,67,172,126,298,0.000333,0.602565,39,70500.08857,3916.671587,1807.694579,341.871065,10,0
0,0,22,22,21,34,55,147,100,247,0.000333,0.475999,20,28559.91699,1586.662055,1427.995849,265.212402,8,0
0,0,27,27,16,21,37,159,94,253,0.000333,0.439331,32,42175.73445,2343.096358,1317.991702,156.238666,18,0
0,0,48,48,29,52,81,309,201,510,0.000333,1.077775,42,135799.5871,7544.421503,3233.323501,437.304314,18,0
0,0,47,47,30,50,80,300,194,494,0.000333,1.041011,45,140536.4615,7807.581197,3123.032479,429.399527,19,0
0,0,48,48,30,53,83,311,201,512,0.000333,1.088007,45,146880.9085,8160.050472,3264.020189,450.786502,18,0
0,0,47,47,31,50,81,302,194,496,0.000333,1.048189,45,141505.4521,7861.414004,3144.565601,435.772895,19,0
0,0,8,8,13,13,26,40,26,66,0.000333,0.10341,12,3722.748257,206.819348,310.229021,96.211433,6,0
0,0,8,8,13,21,34,61,54,115,0.000333,0.195019,12,7020.698721,390.038818,585.058227,140.344382,3,0
0,0,9,9,14,22,36,65,56,121,0.000333,0.20852,14,8757.852952,486.547386,625.560925,151.410465,3,0
0,0,12,12,14,20,34,63,39,102,0.000333,0.172974,7,3632.448469,201.802693,518.92121,139.741531,9,0
0,0,21,21,17,29,46,94,63,157,0.000333,0.289066,16,13875.18763,770.843757,867.199227,210.368317,13,0
0,0,22,22,30,20,50,167,100,267,0.000333,0.502303,75,113018.2202,6278.790011,1506.909603,233.64528,15,0
0,0,22,22,23,20,43,109,76,185,0.000333,0.33462,33,33127.34633,1840.408129,1003.85898,190.480487,7,0
0,0,10,10,16,14,30,47,33,80,0.000333,0.13085,16,6280.819962,348.934442,392.551248,117.302969,3,0
0,0,9,9,16,14,30,49,35,84,0.000333,0.137393,16,6594.86096,366.381164,412.17881,117.302969,3,0
0,0,29,29,23,23,46,127,80,207,0.000333,0.381126,33,37731.45172,2096.191762,1143.377325,208.08385,13,0
0,0,10,10,16,19,35,51,39,90,0.000333,0.153878,16,7386.167544,410.342641,461.635472,144.710623,4,0
0,0,10,10,15,21,36,55,45,100,0.000333,0.172331,14,7237.895002,402.105278,516.9925,150.842025,4,0
0,0,10,10,16,20,36,52,41,93,0.000333,0.160268,16,7692.848402,427.380467,480.803025,150.438562,4,0
0,0,10,10,16,21,37,53,43,96,0.000333,0.166703,16,8001.72037,444.540021,500.107523,156.238666,4,0
0,0,13,13,21,24,45,69,56,125,0.000333,0.228827,20,13729.63274,762.757374,686.481637,202.277766,5,0
0,0,13,13,21,25,46,72,60,132,0.000333,0.243037,20,14582.20356,810.12242,729.110178,208.335071,5,0
0,0,13,13,21,23,44,68,55,123,0.000333,0.223837,20,13430.20178,746.122321,671.510089,196.280591,5,0
0,0,13,13,21,23,44,68,54,122,0.000333,0.222017,20,13321.01315,740.056286,666.050657,196.280591,5,0
0,0,13,13,21,25,46,70,58,128,0.000333,0.235672,20,14140.31861,785.573256,707.01593,208.335071,5,0
0,0,44,44,29,44,73,206,151,357,0.000333,0.736589,42,92810.22944,5156.123858,2209.767368,381.09644,14,0
0,0,48,48,32,35,67,215,133,348,0.000333,0.703666,48,101327.9538,5629.330769,2110.999038,339.524906,17,0
0,0,37,37,30,40,70,186,123,309,0.000333,0.631316,45,85227.68035,4734.871131,1893.948452,360.083842,12,0
0,0,15,15,20,26,46,100,68,168,0.000333,0.309319,20,18559.16817,1031.064898,927.958409,208.649995,7,0
0,0,49,49,29,45,74,227,162,389,0.000333,0.805159,42,101450.0491,5636.113838,2415.477359,388.014838,16,0
0,0,49,49,29,48,77,237,168,405,0.000333,0.846016,42,106598.0391,5922.113281,2538.048549,408.959649,16,0
0,0,37,37,30,38,68,176,117,293,0.000333,0.594542,45,80263.19756,4459.066531,1783.626612,346.627963,12,0
0,0,37,37,23,51,74,285,164,449,0.000333,0.929348,33,92005.47052,5111.415029,2788.044561,393.335617,20,0
0,0,8,8,16,14,30,51,34,85,0.000333,0.139029,16,6673.37121,370.742845,417.085701,117.302969,2,0
0,0,55,55,21,39,60,266,186,452,0.000333,0.889972,40,106796.582,5933.143443,2669.914549,298.369352,6,0
0,0,21,21,20,32,52,143,86,229,0.000333,0.435134,20,26108.01391,1450.445217,1305.400695,246.438562,4,0
0,0,53,53,29,47,76,267,183,450,0.000333,0.937189,42,118085.83,6560.323889,2811.567381,401.947125,20,0
0,0,12,12,20,13,33,72,55,127,0.000333,0.213546,40,25625.52213,1423.640118,640.638053,134.544278,5,0
0,0,44,44,32,46,78,279,187,466,0.000333,0.976332,64,187455.8358,10414.2131,2928.997434,414.08385,17,0
0,0,15,15,19,20,39,96,72,168,0.000333,0.295983,27,23974.58447,1331.921359,887.947573,167.149185,8,0
0,0,13,13,18,19,37,89,68,157,0.000333,0.272628,27,22082.87282,1226.826268,817.884178,155.769273,7,0
0,0,47,47,33,53,86,303,204,507,0.000333,1.086039,48,156389.5791,8688.309948,3258.116231,470.04479,20,0
0,0,12,12,19,20,39,87,66,153,0.000333,0.269556,27,21833.99657,1212.999809,808.666539,167.149185,7,0
0,0,39,39,25,54,79,295,172,467,0.000333,0.981289,36,105979.1619,5887.731219,2943.865609,426.86033,20,0
0,0,19,19,21,30,51,123,80,203,0.000333,0.383834,20,23030.04689,1279.447049,1151.502344,239.445384,4,0
0,0,13,13,19,15,34,77,46,123,0.000333,0.208586,27,16895.4641,938.636894,625.757929,139.313982,5,0
0,0,34,34,24,41,65,255,146,401,0.000333,0.80499,36,86938.90175,4829.938986,2414.969493,329.698732,21,0
0,0,60,60,30,44,74,357,208,565,0.000333,1.169447,60,210500.4691,11694.47051,3508.341152,387.421709,42,0
0,0,30,30,27,45,72,191,122,313,0.000333,0.643729,26,50210.84966,2789.491648,1931.186525,375.515352,28,0
0,0,18,18,20,26,46,113,92,205,0.000333,0.377443,30,33969.90603,1887.217002,1132.330201,208.649995,8,0
0,0,10,10,15,14,29,47,38,85,0.000333,0.137643,14,5780.997384,321.166521,412.928385,111.906328,3,0
0,0,79,79,28,83,111,507,409,916,0.000333,2.074562,56,348526.3563,19362.57535,6223.684934,663.734211,57,0
0,0,85,85,28,83,111,536,431,967,0.000333,2.190067,70,459914.01,25550.77833,6570.200143,663.734211,63,0
0,0,79,79,27,80,107,500,408,908,0.000333,2.040417,65,397881.3815,22104.5212,6121.252024,634.13621,59,0
0,0,58,58,31,50,81,285,233,518,0.000333,1.094681,60,197042.5381,10946.80767,3284.042301,435.772895,33,0
0,0,44,44,28,41,69,224,187,411,0.000333,0.836868,56,140593.7989,7810.766605,2510.603552,354.26557,28,0
0,0,45,45,29,41,70,224,187,411,0.000333,0.839712,56,141071.5779,7837.309884,2519.13532,360.541081,27,0
0,0,53,53,29,46,75,290,236,526,0.000333,1.09212,70,229345.1042,12741.39468,3276.358631,394.965299,36,0
0,0,54,54,28,54,82,328,269,597,0.000333,1.265153,56,212545.6786,11808.09326,3795.458547,445.369863,37,0
0,0,74,74,29,63,92,467,368,835,0.000333,1.815725,70,381302.1963,21183.45535,5447.174233,517.450084,49,0
0,0,14,14,21,36,57,110,86,196,0.000333,0.381082,20,22864.92886,1270.273825,1143.246443,278.355966,12,0
0,0,19,19,21,37,58,139,105,244,0.000333,0.476449,20,28586.94726,1588.163736,1429.347363,284.98844,15,0
0,0,14,14,21,36,57,107,83,190,0.000333,0.369416,20,22164.98205,1231.387892,1108.249103,278.355966,12,0
0,0,19,19,21,37,58,136,102,238,0.000333,0.464733,20,27883.98954,1549.11053,1394.199477,284.98844,15,0
0,0,13,13,22,35,57,121,92,213,0.000333,0.414135,22,27332.92261,1518.4957,1242.405573,277.632401,9,0
0,0,18,18,22,37,59,150,111,261,0.000333,0.51179,33,50667.20458,2814.844699,1535.369836,290.85727,12,0
0,0,7,7,13,25,38,55,57,112,0.000333,0.195923,12,7053.214578,391.845254,587.767882,164.202121,3,0
0,0,30,30,22,58,80,225,159,384,0.000333,0.809207,22,53407.64855,2967.091586,2427.620388,437.870393,14,0
0,0,26,26,21,18,39,150,64,214,0.000333,0.377025,30,33932.28225,1885.126791,1131.076075,167.297316,21,0
0,0,22,22,20,17,37,134,53,187,0.000333,0.324723,30,29225.03338,1623.612966,974.167779,155.92543,15,0
0,0,30,30,20,21,41,143,75,218,0.000333,0.389315,30,35038.39011,1946.577228,1167.946337,178.677228,14,0
0,0,13,13,18,24,42,81,68,149,0.000333,0.267818,18,14462.19533,803.455296,803.455296,185.09775,6,0
0,0,38,38,27,55,82,251,177,428,0.000333,0.907011,39,106120.2581,5895.569892,2721.032258,446.356747,21,0
0,0,70,70,31,78,109,421,297,718,0.000333,1.619852,45,218680.0355,12148.89086,4859.556345,643.841459,39,0
0,0,92,92,30,91,121,577,422,999,0.000333,2.303981,60,414716.6624,23039.81458,6911.944374,739.41603,57,0
0,0,12,12,14,20,34,63,39,102,0.000333,0.172974,7,3632.448469,201.802693,518.92121,139.741531,9,0
0,0,20,20,17,29,46,92,59,151,0.000333,0.278019,16,13344.92569,741.38476,834.057855,210.368317,12,0
0,0,17,17,21,21,42,98,61,159,0.000333,0.285793,20,17147.5694,952.642745,857.37847,184.477332,5,0
0,0,14,14,14,19,33,73,50,123,0.000333,0.20682,14,8686.446674,482.580371,620.460477,134.013592,1,0
0,0,14,14,14,20,34,78,55,133,0.000333,0.225544,14,9472.85581,526.269767,676.632558,139.741531,1,0
0,0,14,14,14,19,33,80,56,136,0.000333,0.228679,14,9604.526403,533.5848,686.0376,134.013592,1,0
0,0,14,14,14,20,34,78,56,134,0.000333,0.22724,14,9544.08029,530.226683,681.720021,139.741531,1,0
0,0,6,6,9,15,24,36,31,67,0.000333,0.102397,8,2457.5399,136.529994,307.192488,87.132684,1,0
0,0,22,22,17,31,48,113,85,198,0.000333,0.368608,16,17693.1612,982.9534,1105.822575,223.066954,2,0
0,0,9,9,12,18,30,46,41,87,0.000333,0.1423,12,5122.793782,284.599655,426.899482,118.0782,2,0
0,0,10,10,14,27,41,69,50,119,0.000333,0.212516,7,4462.84082,247.935601,637.548689,181.684931,2,0
0,0,6,6,9,16,25,34,30,64,0.000333,0.099069,4,1188.827185,66.045955,297.206796,92.529325,1,0
0,0,29,29,26,32,58,163,127,290,0.000333,0.566271,39,66253.76506,3680.764725,1698.814489,282.211433,8,0
0,0,24,24,17,31,48,117,90,207,0.000333,0.385362,16,18497.3958,1027.6331,1156.087238,223.066954,2,0
0,0,11,11,14,18,32,50,46,96,0.000333,0.16,14,6720,373.333333,480,128.361619,2,0
0,0,12,12,14,27,41,73,55,128,0.000333,0.228589,14,9600.733192,533.374066,685.766657,181.684931,2,0
0,0,8,8,11,16,27,38,35,73,0.000333,0.115702,10,3471.067877,192.837104,347.106788,102.053748,1,0
0,0,25,25,23,39,62,213,124,337,0.000333,0.668855,33,66216.61717,3678.700954,2006.564157,310.172612,13,0
0,0,7,7,12,11,23,44,38,82,0.000333,0.123644,18,6676.777447,370.93208,370.93208,81.073298,3,0
0,0,46,46,25,34,59,340,265,605,0.000333,1.186333,84,298955.9198,16608.66221,3558.999045,289.070141,20,0
0,0,20,20,17,28,45,132,86,218,0.000333,0.399075,24,28733.3754,1596.298633,1197.223975,204.092806,8,0
0,0,22,22,18,28,46,141,91,232,0.000333,0.427155,27,34599.59209,1922.199561,1281.466374,209.664588,9,0
0,0,30,30,23,33,56,175,134,309,0.000333,0.598158,44,78956.79752,4386.488751,1794.472671,270.506931,4,0
0,0,42,42,24,33,57,304,239,543,0.000333,1.055753,84,266049.7793,14780.5433,3167.259278,276.504106,19,0
0,0,53,53,33,53,86,318,239,557,0.000333,1.193143,64,229083.486,12726.86033,3579.429468,470.04479,11,0
0,0,53,53,33,53,86,318,239,557,0.000333,1.193143,64,229083.486,12726.86033,3579.429468,470.04479,11,0
0,0,55,55,34,52,86,343,246,589,0.000333,1.26169,68,257384.756,14299.15311,3785.069941,469.396602,18,0
0,0,56,56,34,52,86,345,248,593,0.000333,1.270258,68,259132.7,14396.26111,3810.775,469.396602,18,0
0,0,14,14,14,23,37,80,65,145,0.000333,0.25179,14,10575.19033,587.510574,755.370738,157.344894,2,0
0,0,8,8,16,14,30,51,34,85,0.000333,0.139029,16,6673.37121,370.742845,417.085701,117.302969,2,0
0,0,21,21,17,24,41,101,78,179,0.000333,0.319667,24,23016.04341,1278.669078,959.001809,179.525968,9,0
0,0,40,40,27,48,75,237,163,400,0.000333,0.830509,39,97169.57157,5398.309532,2491.527476,396.460163,21,0
0,0,22,22,19,26,45,114,86,200,0.000333,0.366124,27,29656.00672,1647.555929,1098.370619,202.922055,11,0
0,0,41,41,29,49,78,250,171,421,0.000333,0.882051,42,111138.482,6174.360113,2646.154334,416.002231,23,0
0,0,10,10,18,21,39,90,61,151,0.000333,0.266032,18,14365.72323,798.095735,798.095735,167.297316,4,0
0,0,27,27,17,30,47,86,66,152,0.000333,0.281433,16,13508.76009,750.486672,844.297505,216.693586,7,0
0,0,25,25,19,41,60,148,106,254,0.000333,0.500117,18,27006.3038,1500.350211,1500.350211,300.370255,19,0
0,0,31,31,20,45,65,163,123,286,0.000333,0.574132,20,34447.94389,1913.774661,1722.397195,333.571951,16,0
0,0,15,15,29,25,54,127,94,221,0.000333,0.423943,42,53416.8658,2967.603655,1271.830138,256.977854,14,0
0,0,5,5,12,14,26,45,34,79,0.000333,0.123778,12,4456.016853,247.556492,371.334738,96.322519,2,0
0,0,33,33,21,49,70,189,139,328,0.000333,0.670135,20,40208.09659,2233.783144,2010.40483,367.359448,20,0
0,0,37,37,21,51,72,196,150,346,0.000333,0.711598,20,42695.88101,2371.993389,2134.79405,381.532358,17,0
0,0,50,50,15,42,57,184,125,309,0.000333,0.600788,14,25233.0822,1401.8379,1802.363014,285.080691,24,0
0,0,34,34,22,49,71,279,156,435,0.000333,0.891713,33,88279.6199,4904.423328,2675.139997,373.228278,18,0
0,0,36,36,24,51,75,290,164,454,0.000333,0.942628,36,101803.8127,5655.767371,2827.883685,399.332792,18,0
0,0,12,12,14,20,34,63,39,102,0.000333,0.172974,7,3632.448469,201.802693,518.92121,139.741531,9,0
0,0,55,55,21,39,60,266,186,452,0.000333,0.889972,40,106796.582,5933.143443,2669.914549,298.369352,6,0
0,0,21,21,20,32,52,143,86,229,0.000333,0.435134,20,26108.01391,1450.445217,1305.400695,246.438562,4,0
0,0,53,53,29,47,76,267,183,450,0.000333,0.937189,42,118085.83,6560.323889,2811.567381,401.947125,20,0
0,0,12,12,20,13,33,72,55,127,0.000333,0.213546,40,25625.52213,1423.640118,640.638053,134.544278,5,0
0,0,44,44,32,46,78,279,187,466,0.000333,0.976332,64,187455.8358,10414.2131,2928.997434,414.08385,17,0
0,0,13,13,18,19,37,89,68,157,0.000333,0.272628,27,22082.87282,1226.826268,817.884178,155.769273,7,0
0,0,15,15,19,20,39,96,72,168,0.000333,0.295983,27,23974.58447,1331.921359,887.947573,167.149185,8,0
0,0,45,45,33,53,86,296,200,496,0.000333,1.062476,48,152996.5113,8499.806182,3187.427318,470.04479,19,0
0,0,14,14,20,21,41,94,70,164,0.000333,0.29288,30,26359.15586,1464.397548,878.638529,178.677228,8,0
0,0,19,19,21,30,51,123,80,203,0.000333,0.383834,20,23030.04689,1279.447049,1151.502344,239.445384,4,0
0,0,57,57,31,46,77,409,237,646,0.000333,1.349448,75,303625.8079,16868.10044,4048.344105,407.663936,35,0
0,0,41,41,31,44,75,283,199,482,0.000333,1.000764,60,180137.4365,10007.63536,3002.290609,393.795077,25,0
0,0,35,35,30,42,72,236,170,406,0.000333,0.834997,60,150299.373,8349.965169,2504.989551,373.68405,21,0
0,0,68,68,30,62,92,493,297,790,0.000333,1.717871,60,309216.8367,17178.71315,5153.613945,516.366889,43,0
0,0,35,35,27,40,67,243,144,387,0.000333,0.782526,39,91555.48415,5086.415786,2347.576517,341.259086,27,0
0,0,18,18,25,27,52,144,95,239,0.000333,0.454135,36,49046.58334,2724.810185,1362.405093,244.478367,13,0
0,0,18,18,25,27,52,144,94,238,0.000333,0.452235,36,48841.36751,2713.409306,1356.704653,244.478367,13,0
0,0,18,18,25,27,52,144,95,239,0.000333,0.454135,36,49046.58334,2724.810185,1362.405093,244.478367,13,0
0,0,20,20,25,27,52,155,101,256,0.000333,0.486438,36,52535.25244,2918.625136,1459.312568,244.478367,14,0
0,0,23,23,24,27,51,158,105,263,0.000333,0.497283,36,53706.52314,2983.69573,1491.847865,238.421063,13,0
0,0,21,21,23,27,50,141,94,235,0.000333,0.442102,33,43768.10475,2431.561375,1326.306205,232.423888,10,0
0,0,25,25,24,27,51,168,110,278,0.000333,0.525645,48,75692.84376,4205.157987,1576.934245,238.421063,14,0
0,0,41,41,27,49,76,292,176,468,0.000333,0.974677,39,114037.173,6335.398499,2924.030076,403.502745,27,0
0,0,42,42,29,58,87,311,190,501,0.000333,1.075972,42,135572.417,7531.800947,3227.914691,480.644347,27,0
0,0,43,43,29,58,87,313,192,505,0.000333,1.084562,42,136654.8315,7591.935086,3253.686465,480.644347,27,0
0,0,20,20,25,42,67,166,108,274,0.000333,0.554036,24,39890.60252,2216.144584,1662.108438,342.573737,7,0
0,0,63,63,29,50,79,463,283,746,0.000333,1.56754,70,329183.4307,18287.96837,4702.620438,423.074258,31,0
0,0,18,18,15,25,40,103,57,160,0.000333,0.283836,14,11921.11893,662.284385,851.508495,174.699764,7,0
0,0,18,18,15,25,40,104,57,161,0.000333,0.28561,14,11995.62593,666.423663,856.830423,174.699764,7,0
0,0,47,47,26,37,63,236,125,361,0.000333,0.719266,39,84154.12404,4675.229113,2157.798052,314.961207,26,0
0,0,18,18,15,25,40,103,57,160,0.000333,0.283836,14,11921.11893,662.284385,851.508495,174.699764,7,0
0,0,18,18,15,25,40,104,57,161,0.000333,0.28561,14,11995.62593,666.423663,856.830423,174.699764,7,0
0,0,49,49,29,47,76,252,140,392,0.000333,0.816396,28,68577.25239,3809.847355,2449.187585,401.947125,26,0
0,0,27,27,27,49,76,278,141,419,0.000333,0.872627,26,68064.92233,3781.384574,2617.881628,403.502745,8,0
0,0,19,19,23,44,67,199,104,303,0.000333,0.612675,22,40436.55054,2246.47503,1838.025025,344.256916,6,0
0,0,16,16,13,27,40,63,57,120,0.000333,0.212877,12,7663.576457,425.754248,638.631371,176.487679,6,0
0,0,24,24,19,34,53,142,94,236,0.000333,0.450596,18,24332.20609,1351.789227,1351.789227,253.684359,8,0
0,0,36,36,16,42,58,267,167,434,0.000333,0.847455,24,61016.73005,3389.818336,2542.363752,290.477332,4,0
0,0,35,35,16,42,58,263,165,428,0.000333,0.835739,24,60173.18078,3342.954488,2507.215866,290.477332,3,0
0,0,34,34,16,42,58,259,163,422,0.000333,0.824023,24,59329.63152,3296.09064,2472.06798,290.477332,2,0
0,0,17,17,14,34,48,126,80,206,0.000333,0.383501,14,16107.03185,894.835103,1150.502275,226.276706,1,0
0,0,28,28,27,55,82,268,148,416,0.000333,0.881581,26,68763.28248,3820.18236,2644.741634,446.356747,8,0
0,0,25,25,27,54,81,249,138,387,0.000333,0.817841,26,63791.57073,3543.976152,2453.521951,439.145888,8,0
0,0,22,22,27,54,81,241,131,372,0.000333,0.786141,26,61319.02923,3406.612735,2358.424201,439.145888,8,0
0,0,34,34,30,69,99,705,290,995,0.000333,2.198737,60,395772.5902,21987.36612,6596.209837,568.694905,18,0
0,0,34,34,30,69,99,705,290,995,0.000333,2.198737,60,395772.5902,21987.36612,6596.209837,568.694905,18,0
0,0,41,41,32,79,111,436,246,682,0.000333,1.544597,48,222421.9978,12356.77766,4633.791621,657.998679,19,0
0,0,18,18,15,25,40,103,57,160,0.000333,0.283836,14,11921.11893,662.284385,851.508495,174.699764,7,0
0,0,18,18,15,25,40,104,57,161,0.000333,0.28561,14,11995.62593,666.423663,856.830423,174.699764,7,0
0,0,24,24,22,37,59,136,99,235,0.000333,0.460807,22,30413.26457,1689.625809,1382.421117,290.85727,13,0
0,0,23,23,22,37,59,129,96,225,0.000333,0.441198,22,29119.08309,1617.726839,1323.594686,290.85727,12,0
0,0,23,23,22,37,59,129,96,225,0.000333,0.441198,22,29119.08309,1617.726839,1323.594686,290.85727,12,0
0,0,32,32,17,35,52,143,112,255,0.000333,0.484537,24,34886.69108,1938.149504,1453.612128,249.011774,9,0
0,0,26,26,15,34,49,110,91,201,0.000333,0.376186,14,15799.7935,877.766306,1128.556679,231.577096,8,0
0,0,26,26,15,34,49,110,91,201,0.000333,0.376186,14,15799.7935,877.766306,1128.556679,231.577096,8,0
0,0,40,40,22,48,70,179,141,320,0.000333,0.65379,22,43150.15244,2397.230691,1961.370565,366.185696,12,0
0,0,26,26,20,39,59,131,103,234,0.000333,0.458846,20,27530.76947,1529.487193,1376.538474,292.569248,9,0
0,0,26,26,20,39,59,131,103,234,0.000333,0.458846,20,27530.76947,1529.487193,1376.538474,292.569248,9,0
0,0,12,12,14,20,34,63,39,102,0.000333,0.172974,7,3632.448469,201.802693,518.92121,139.741531,9,0
0,0,29,29,23,23,46,127,80,207,0.000333,0.381126,33,37731.45172,2096.191762,1143.377325,208.08385,13,0
0,0,10,10,16,20,36,52,41,93,0.000333,0.160268,16,7692.848402,427.380467,480.803025,150.438562,4,0
0,0,10,10,15,21,36,55,45,100,0.000333,0.172331,14,7237.895002,402.105278,516.9925,150.842025,4,0
0,0,10,10,16,21,37,53,43,96,0.000333,0.166703,16,8001.72037,444.540021,500.107523,156.238666,4,0
0,0,10,10,16,19,35,51,39,90,0.000333,0.153878,16,7386.167544,410.342641,461.635472,144.710623,4,0
0,0,13,13,21,23,44,68,55,123,0.000333,0.223837,20,13430.20178,746.122321,671.510089,196.280591,5,0
0,0,13,13,21,23,44,68,54,122,0.000333,0.222017,20,13321.01315,740.056286,666.050657,196.280591,5,0
0,0,13,13,21,24,45,69,56,125,0.000333,0.228827,20,13729.63274,762.757374,686.481637,202.277766,5,0
0,0,13,13,21,25,46,70,58,128,0.000333,0.235672,20,14140.31861,785.573256,707.01593,208.335071,5,0
0,0,13,13,21,25,46,72,60,132,0.000333,0.243037,20,14582.20356,810.12242,729.110178,208.335071,5,0
0,0,44,44,29,44,73,206,151,357,0.000333,0.736589,42,92810.22944,5156.123858,2209.767368,381.09644,14,0
0,0,48,48,32,35,67,215,133,348,0.000333,0.703666,48,101327.9538,5629.330769,2110.999038,339.524906,17,0
0,0,49,49,29,48,77,237,168,405,0.000333,0.846016,42,106598.0391,5922.113281,2538.048549,408.959649,16,0
0,0,37,37,30,38,68,176,117,293,0.000333,0.594542,45,80263.19756,4459.066531,1783.626612,346.627963,12,0
0,0,49,49,29,45,74,227,162,389,0.000333,0.805159,42,101450.0491,5636.113838,2415.477359,388.014838,16,0
0,0,15,15,20,26,46,100,68,168,0.000333,0.309319,20,18559.16817,1031.064898,927.958409,208.649995,7,0
0,0,37,37,30,40,70,186,123,309,0.000333,0.631316,45,85227.68035,4734.871131,1893.948452,360.083842,12,0
0,0,44,44,25,30,55,212,117,329,0.000333,0.634022,36,68474.42445,3804.134691,1902.067346,263.303123,23,0
0,0,13,13,17,17,34,82,47,129,0.000333,0.218761,16,10500.5233,583.362406,656.282707,138.973737,2,0
0,0,41,41,30,58,88,291,187,478,0.000333,1.029203,45,138942.3741,7719.020784,3087.608314,486.969616,21,0
0,0,83,83,25,84,109,499,324,823,0.000333,1.856739,36,200527.7652,11140.4314,5570.215699,653.051068,28,0
0,0,57,57,25,63,88,362,228,590,0.000333,1.270355,36,137198.3276,7622.12931,3811.064655,492.66504,14,0
0,0,39,39,30,55,85,271,174,445,0.000333,0.950726,45,128348.0535,7130.447416,2852.178967,465.181502,22,0
0,0,27,27,17,33,50,137,84,221,0.000333,0.415764,16,19956.67549,1108.704194,1247.292218,235.951874,12,0
0,0,12,12,14,20,34,63,39,102,0.000333,0.172974,7,3632.448469,201.802693,518.92121,139.741531,9,0
0,0,22,22,14,20,34,97,67,164,0.000333,0.278115,21,17521.22203,973.401224,834.343906,139.741531,7,0
0,0,37,37,26,40,66,243,146,389,0.000333,0.783756,39,91699.50319,5094.416844,2351.269312,335.088556,18,0
0,0,18,18,19,21,40,122,57,179,0.000333,0.317542,18,17147.25232,952.625129,952.625129,172.949289,14,0
0,0,18,18,19,21,40,122,57,179,0.000333,0.317542,18,17147.25232,952.625129,952.625129,172.949289,14,0
0,0,20,20,22,21,43,133,65,198,0.000333,0.358133,33,35455.21391,1969.734106,1074.400421,190.346161,15,0
0,0,26,26,23,24,47,188,92,280,0.000333,0.518428,33,51324.40099,2851.355611,1555.284878,214.081025,17,0
0,0,20,20,22,23,45,134,67,201,0.000333,0.367954,22,24284.97439,1349.165244,1103.862472,202.149421,15,0
0,0,20,20,22,21,43,133,65,198,0.000333,0.358133,33,35455.21391,1969.734106,1074.400421,190.346161,15,0
0,0,20,20,22,23,45,134,67,201,0.000333,0.367954,22,24284.97439,1349.165244,1103.862472,202.149421,15,0
0,0,20,20,22,21,43,134,67,201,0.000333,0.36356,33,35992.41412,1999.578562,1090.679216,190.346161,15,0
0,0,22,22,23,26,49,160,81,241,0.000333,0.451048,33,44653.78739,2480.765966,1353.145072,226.253358,15,0
0,0,21,21,20,22,42,141,70,211,0.000333,0.37926,30,34133.36929,1896.298294,1137.778976,184.546058,15,0
0,0,21,21,20,22,42,142,70,212,0.000333,0.381057,30,34295.13881,1905.285489,1143.171294,184.546058,15,0
0,0,20,20,20,22,42,137,66,203,0.000333,0.36488,30,32839.21311,1824.400728,1094.640437,184.546058,14,0
0,0,21,21,20,27,47,158,79,237,0.000333,0.438813,20,26328.75116,1462.708398,1316.437558,214.820524,14,0
0,0,20,20,20,21,41,130,63,193,0.000333,0.344669,30,31020.22611,1723.345895,1034.007537,178.677228,14,0
0,0,20,20,20,22,42,137,66,203,0.000333,0.36488,30,32839.21311,1824.400728,1094.640437,184.546058,14,0
0,0,23,23,21,24,45,146,73,219,0.000333,0.400905,30,36081.47484,2004.52638,1202.715828,202.277766,15,0
0,0,23,23,20,24,44,146,73,219,0.000333,0.398539,30,35868.46573,1992.692541,1195.615524,196.477662,15,0
0,0,23,23,20,24,44,146,73,219,0.000333,0.398539,30,35868.46573,1992.692541,1195.615524,196.477662,15,0
0,0,25,25,21,26,47,167,79,246,0.000333,0.455476,30,40992.86573,2277.381429,1366.428858,214.450099,16,0
0,0,23,23,21,23,44,145,71,216,0.000333,0.393079,30,35377.11689,1965.395383,1179.23723,196.280591,15,0
0,0,21,21,20,27,47,158,79,237,0.000333,0.438813,20,26328.75116,1462.708398,1316.437558,214.820524,14,0
0,0,23,23,23,25,48,153,80,233,0.000333,0.433765,33,42942.77667,2385.709815,1301.296263,220.13833,16,0
0,0,23,23,23,25,48,153,80,233,0.000333,0.433765,33,42942.77667,2385.709815,1301.296263,220.13833,16,0
0,0,24,24,20,26,46,158,83,241,0.000333,0.443726,30,39935.35294,2218.630719,1331.178431,208.649995,15,0
0,0,24,24,24,26,50,180,90,270,0.000333,0.507947,36,54858.28217,3047.682342,1523.841171,232.250533,17,0
0,0,47,47,26,48,74,295,157,452,0.000333,0.935558,39,109460.2439,6081.124663,2806.672921,390.289633,32,0
0,0,39,39,20,37,57,230,120,350,0.000333,0.680504,30,61245.34515,3402.519175,2041.511505,279.188336,27,0
0,0,40,40,24,44,68,251,132,383,0.000333,0.777166,36,83933.93766,4662.996536,2331.498268,350.254091,28,0
0,0,26,26,22,25,47,169,89,258,0.000333,0.477695,33,47291.76948,2627.320527,1433.083924,214.2039,18,0
0,0,26,26,21,25,46,166,86,252,0.000333,0.463979,30,41758.12839,2319.896022,1391.937613,208.335071,16,0
0,0,57,57,24,40,64,390,160,550,0.000333,1.1,48,158400,8800,3300,322.916224,57,0
0,0,56,56,25,41,66,400,170,570,0.000333,1.148435,48,165374.6231,9187.479061,3445.304648,335.756037,54,0
0,0,55,55,25,42,67,408,170,578,0.000333,1.168733,48,168297.5785,9349.865472,3506.199552,342.573737,53,0
0,0,55,55,26,40,66,408,168,576,0.000333,1.160524,52,181041.6927,10057.87182,3481.571013,335.088556,53,0
0,0,79,79,29,62,91,573,261,834,0.000333,1.809167,56,303940.0409,16885.55783,5427.50073,510.04162,64,0
0,0,62,62,28,53,81,481,208,689,0.000333,1.456052,42,183462.5794,10192.36552,4368.156652,438.185722,57,0
0,0,79,79,29,62,91,573,261,834,0.000333,1.809167,56,303940.0409,16885.55783,5427.50073,510.04162,64,0
0,0,56,56,25,41,66,409,172,581,0.000333,1.170598,48,168566.0632,9364.781289,3511.792983,335.756037,54,0
0,0,55,55,25,42,67,408,170,578,0.000333,1.168733,48,168297.5785,9349.865472,3506.199552,342.573737,53,0
0,0,55,55,26,40,66,408,168,576,0.000333,1.160524,52,181041.6927,10057.87182,3481.571013,335.088556,53,0
0,0,59,59,25,44,69,424,185,609,0.000333,1.24003,48,178564.3869,9920.243718,3720.091394,356.311396,55,0
0,0,59,59,25,44,69,425,185,610,0.000333,1.242067,48,178857.5961,9936.533116,3726.199919,356.311396,55,0
0,0,29,29,22,47,69,314,169,483,0.000333,0.983472,33,97363.77132,5409.098406,2950.417313,359.173172,6,0
0,0,29,29,22,47,69,314,169,483,0.000333,0.983472,33,97363.77132,5409.098406,2950.417313,359.173172,6,0
0,0,28,28,22,48,70,308,167,475,0.000333,0.97047,33,96076.51129,5337.583961,2911.409433,366.185696,6,0
0,0,28,28,22,48,70,308,167,475,0.000333,0.97047,33,96076.51129,5337.583961,2911.409433,366.185696,6,0
0,0,18,18,15,25,40,103,57,160,0.000333,0.283836,14,11921.11893,662.284385,851.508495,174.699764,7,0
0,0,18,18,15,25,40,104,57,161,0.000333,0.28561,14,11995.62593,666.423663,856.830423,174.699764,7,0
0,0,12,12,14,20,34,63,39,102,0.000333,0.172974,7,3632.448469,201.802693,518.92121,139.741531,9,0
0,0,5,5,11,12,23,27,21,48,0.000333,0.072377,5,1085.654869,60.314159,217.130974,81.073298,2,0
0,0,53,53,29,47,76,267,183,450,0.000333,0.937189,42,118085.83,6560.323889,2811.567381,401.947125,20,0
0,0,12,12,20,13,33,72,55,127,0.000333,0.213546,40,25625.52213,1423.640118,640.638053,134.544278,5,0
0,0,44,44,32,46,78,279,187,466,0.000333,0.976332,64,187455.8358,10414.2131,2928.997434,414.08385,17,0
0,0,13,13,18,19,37,89,68,157,0.000333,0.272628,27,22082.87282,1226.826268,817.884178,155.769273,7,0
0,0,15,15,19,20,39,96,72,168,0.000333,0.295983,27,23974.58447,1331.921359,887.947573,167.149185,8,0
0,0,45,45,33,53,86,296,200,496,0.000333,1.062476,48,152996.5113,8499.806182,3187.427318,470.04479,19,0
0,0,14,14,20,21,41,94,70,164,0.000333,0.29288,30,26359.15586,1464.397548,878.638529,178.677228,8,0
0,0,18,18,15,25,40,103,57,160,0.000333,0.283836,14,11921.11893,662.284385,851.508495,174.699764,7,0
0,0,18,18,15,25,40,104,57,161,0.000333,0.28561,14,11995.62593,666.423663,856.830423,174.699764,7,0
0,0,18,18,15,25,40,103,57,160,0.000333,0.283836,14,11921.11893,662.284385,851.508495,174.699764,7,0
0,0,18,18,15,25,40,104,57,161,0.000333,0.28561,14,11995.62593,666.423663,856.830423,174.699764,7,0
0,0,13,13,17,17,34,82,47,129,0.000333,0.218761,16,10500.5233,583.362406,656.282707,138.973737,2,0
0,0,41,41,30,58,88,291,187,478,0.000333,1.029203,45,138942.3741,7719.020784,3087.608314,486.969616,21,0
0,0,83,83,25,84,109,499,324,823,0.000333,1.856739,36,200527.7652,11140.4314,5570.215699,653.051068,28,0
0,0,57,57,25,63,88,362,228,590,0.000333,1.270355,36,137198.3276,7622.12931,3811.064655,492.66504,14,0
0,0,39,39,30,55,85,271,174,445,0.000333,0.950726,45,128348.0535,7130.447416,2852.178967,465.181502,22,0
0,0,55,55,21,39,60,266,186,452,0.000333,0.889972,40,106796.582,5933.143443,2669.914549,298.369352,6,0
0,0,21,21,20,32,52,143,86,229,0.000333,0.435134,20,26108.01391,1450.445217,1305.400695,246.438562,4,0
0,0,53,53,29,47,76,267,183,450,0.000333,0.937189,42,118085.83,6560.323889,2811.567381,401.947125,20,0
0,0,12,12,20,13,33,72,55,127,0.000333,0.213546,40,25625.52213,1423.640118,640.638053,134.544278,5,0
0,0,44,44,32,46,78,279,187,466,0.000333,0.976332,64,187455.8358,10414.2131,2928.997434,414.08385,17,0
0,0,13,13,18,19,37,89,68,157,0.000333,0.272628,27,22082.87282,1226.826268,817.884178,155.769273,7,0
0,0,15,15,19,20,39,96,72,168,0.000333,0.295983,27,23974.58447,1331.921359,887.947573,167.149185,8,0
0,0,45,45,33,53,86,296,200,496,0.000333,1.062476,48,152996.5113,8499.806182,3187.427318,470.04479,19,0
0,0,14,14,20,21,41,94,70,164,0.000333,0.29288,30,26359.15586,1464.397548,878.638529,178.677228,8,0
0,0,19,19,21,30,51,123,80,203,0.000333,0.383834,20,23030.04689,1279.447049,1151.502344,239.445384,4,0
0,0,77,77,29,53,82,503,314,817,0.000333,1.731373,70,363588.3991,20199.35551,5194.119988,444.461233,30,0
0,0,55,55,28,49,77,354,228,582,0.000333,1.215757,56,204247.1069,11347.0615,3647.269767,409.72672,20,0
0,0,41,41,22,40,62,274,172,446,0.000333,0.885191,44,116845.1484,6491.397133,2655.571554,310.984619,16,0
0,0,62,62,24,46,70,402,246,648,0.000333,1.323925,60,238306.5237,13239.25132,3971.775395,364.12295,26,0
0,0,6,6,15,15,30,45,34,79,0.000333,0.129215,14,5427.020999,301.501167,387.644357,117.206718,1,0
0,0,5,5,14,11,25,26,24,50,0.000333,0.077398,14,3250.699333,180.594407,232.192809,91.356717,1,0
0,0,6,6,15,15,30,45,34,79,0.000333,0.129215,14,5427.020999,301.501167,387.644357,117.206718,1,0
0,0,5,5,14,11,25,26,24,50,0.000333,0.077398,14,3250.699333,180.594407,232.192809,91.356717,1,0
0,0,18,18,15,25,40,103,57,160,0.000333,0.283836,14,11921.11893,662.284385,851.508495,174.699764,7,0
0,0,18,18,15,25,40,104,57,161,0.000333,0.28561,14,11995.62593,666.423663,856.830423,174.699764,7,0
0,0,10,10,11,26,37,50,42,92,0.000333,0.159757,5,2396.348548,133.130475,479.26971,160.26518,5,0
0,0,49,49,22,75,97,269,212,481,0.000333,1.058186,22,69840.2777,3880.015428,3174.558077,565.268897,28,0
0,0,53,53,24,83,107,300,234,534,0.000333,1.199981,24,86398.6409,4799.924494,3599.943371,639.167373,30,0
0,0,35,35,20,51,71,176,153,329,0.000333,0.674422,30,60698.00407,3372.111337,2023.266802,375.732254,18,0
0,0,39,39,22,61,83,207,175,382,0.000333,0.811755,22,53575.83138,2976.435077,2435.265063,459.882473,20,0
0,0,19,19,22,33,55,109,94,203,0.000333,0.391205,22,25819.55248,1434.419582,1173.616022,264.572502,9,0
0,0,18,18,19,29,48,73,59,132,0.000333,0.245738,18,13269.8709,737.21505,737.21505,221.592072,4,0
0,0,19,19,23,38,61,118,106,224,0.000333,0.442828,22,29226.6736,1623.704089,1328.485164,303.463171,14,0
0,0,40,40,27,32,59,202,135,337,0.000333,0.660817,52,103087.4368,5727.079822,1982.450708,288.381963,17,0
0,0,78,78,30,56,86,316,226,542,0.000333,1.161012,60,208982.1298,11610.11832,3483.035497,472.418594,23,0
0,0,78,78,30,56,86,316,226,542,0.000333,1.161012,60,208982.1298,11610.11832,3483.035497,472.418594,23,0
0,0,46,46,19,38,57,185,134,319,0.000333,0.620231,27,50238.68169,2791.037872,1860.691915,280.131868,12,0
0,0,8,8,12,15,27,33,24,57,0.000333,0.090343,6,1626.171526,90.342863,271.028588,101.622909,5,0
0,0,13,13,16,17,33,54,37,91,0.000333,0.153013,16,7344.637838,408.035435,459.039865,133.486868,7,0
0,0,29,29,19,28,47,116,81,197,0.000333,0.364751,18,19696.57207,1094.254004,1094.254004,215.316561,11,0
0,0,29,29,21,28,49,122,82,204,0.000333,0.3818,20,22908.01616,1272.667565,1145.400808,226.844604,12,0
0,0,28,28,20,28,48,114,77,191,0.000333,0.355576,20,21334.55675,1185.253153,1066.727838,221.0445,10,0
0,0,24,24,19,27,46,115,73,188,0.000333,0.346143,18,18691.73366,1038.429648,1038.429648,209.092585,10,0
0,0,22,22,17,26,43,107,68,175,0.000333,0.316532,16,15193.54131,844.085629,949.596332,191.698301,10,0
0,0,18,18,15,25,40,103,57,160,0.000333,0.283836,14,11921.11893,662.284385,851.508495,174.699764,7,0
0,0,18,18,15,25,40,104,57,161,0.000333,0.28561,14,11995.62593,666.423663,856.830423,174.699764,7,0
0,0,18,18,15,25,40,103,57,160,0.000333,0.283836,14,11921.11893,662.284385,851.508495,174.699764,7,0
0,0,18,18,15,25,40,104,57,161,0.000333,0.28561,14,11995.62593,666.423663,856.830423,174.699764,7,0
0,0,12,12,14,20,34,63,39,102,0.000333,0.172974,7,3632.448469,201.802693,518.92121,139.741531,9,0
0,0,25,25,17,31,48,130,78,208,0.000333,0.387224,16,18586.7552,1032.597511,1161.6722,223.066954,17,0
0,0,34,34,23,50,73,190,128,318,0.000333,0.656121,22,43304.01261,2405.778479,1968.36421,386.234734,22,0
0,0,30,30,21,43,64,157,104,261,0.000333,0.522,20,31320,1740,1566,325.56805,16,0
0,0,44,44,28,60,88,255,161,416,0.000333,0.895708,28,75239.45949,4179.969972,2687.123553,489.019374,19,0
0,0,56,56,27,60,87,372,227,599,0.000333,1.286441,39,150513.603,8361.866834,3859.323154,482.795398,13,0
0,0,60,60,27,60,87,404,247,651,0.000333,1.398119,52,218106.5232,12117.02907,4194.356216,482.795398,14,0
0,0,55,55,27,57,84,390,229,619,0.000333,1.318948,52,205755.9132,11430.88407,3956.844485,460.856693,15,0
0,0,59,59,26,57,83,422,249,671,0.000333,1.425884,52,222437.8758,12357.65977,4277.651458,454.686163,16,0
0,0,13,13,13,19,32,70,40,110,0.000333,0.183333,12,6600,366.666667,550,128.816339,4,0
0,0,11,11,17,21,38,55,40,95,0.000333,0.166184,8,3988.42491,221.579162,498.553114,161.725534,7,0
0,0,12,12,17,28,45,86,53,139,0.000333,0.254456,8,6106.940643,339.27448,763.36758,204.092806,3,0
0,0,16,16,18,37,55,152,77,229,0.000333,0.44131,18,23830.76474,1323.931374,1323.931374,267.808425,6,0
0,0,17,17,20,39,59,167,85,252,0.000333,0.494142,20,29648.52097,1647.140054,1482.426048,292.569248,8,0
0,0,60,60,30,39,69,419,256,675,0.000333,1.374418,90,371092.8607,20616.27004,4123.254008,353.337404,37,0
0,0,37,37,29,44,73,272,177,449,0.000333,0.92641,56,155636.9487,8646.49715,2779.231227,381.09644,14,0
0,0,21,21,20,25,45,101,83,184,0.000333,0.336834,30,30315.02909,1684.168283,1010.50097,202.534967,13,0
0,0,46,46,28,39,67,413,205,618,0.000333,1.249614,70,262419.0184,14578.83435,3748.84312,340.736624,13,0
0,0,82,82,29,60,89,487,323,810,0.000333,1.748448,70,367174.0855,20398.56031,5245.344079,495.294885,31,0
0,0,75,75,29,54,83,441,293,734,0.000333,1.55976,70,327549.526,18197.19589,4679.278943,451.645374,30,0
0,0,71,71,29,56,85,423,282,705,0.000333,1.506207,70,316303.4427,17572.41348,4518.62061,466.093324,27,0
0,0,64,64,29,50,79,377,252,629,0.000333,1.321693,70,277555.4663,15419.74813,3965.078091,423.074258,26,0
0,0,67,67,28,55,83,403,265,668,0.000333,1.419509,56,238477.475,13248.74861,4258.52634,452.580722,27,0
0,0,67,67,28,54,82,407,267,674,0.000333,1.42833,56,239959.4429,13331.08016,4284.990051,445.369863,27,0
0,0,58,58,26,46,72,330,212,542,0.000333,1.1147,52,173893.1662,9660.731458,3344.099351,376.295283,25,0
0,0,26,26,23,29,52,167,114,281,0.000333,0.533941,33,52860.17751,2936.676528,1601.823561,244.923374,10,0
0,0,28,28,23,29,52,175,120,295,0.000333,0.560543,44,73991.70754,4110.650419,1681.629717,244.923374,10,0
0,0,11,11,21,26,47,92,56,148,0.000333,0.274026,20,16441.583,913.421278,822.07915,214.450099,6,0
0,0,11,11,21,26,47,92,56,148,0.000333,0.274026,20,16441.583,913.421278,822.07915,214.450099,6,0
0,0,49,49,28,36,64,310,179,489,0.000333,0.978,56,164304,9128,2934,320.723238,32,0
0,0,86,86,31,59,90,493,341,834,0.000333,1.804735,75,406065.4112,22559.18951,5414.205482,500.656026,33,0
0,0,65,65,33,47,80,478,273,751,0.000333,1.582589,80,379821.4399,21101.19111,4747.767999,427.530682,20,0
0,0,50,50,35,47,82,345,264,609,0.000333,1.290583,85,329098.6795,18283.25997,3871.749171,440.590582,23,0
0,0,48,48,34,47,81,311,238,549,0.000333,1.160193,85,295849.1004,16436.06113,3480.577652,434.039413,17,0
0,0,56,56,33,54,87,498,333,831,0.000333,1.784695,96,513992.2603,28555.12557,5354.086045,477.228931,24,0
0,0,53,53,31,49,80,594,356,950,0.000333,2.001944,105,630612.3275,35034.01819,6005.83169,428.700868,23,0
0,0,93,93,33,62,95,545,386,931,0.000333,2.038845,96,587187.4149,32621.52305,6116.535571,535.625177,35,0
0,0,18,18,15,25,40,103,57,160,0.000333,0.283836,14,11921.11893,662.284385,851.508495,174.699764,7,0
0,0,18,18,15,25,40,104,57,161,0.000333,0.28561,14,11995.62593,666.423663,856.830423,174.699764,7,0
0,0,5,5,11,12,23,27,21,48,0.000333,0.072377,5,1085.654869,60.314159,217.130974,81.073298,2,0
0,0,24,24,19,47,66,123,87,210,0.000333,0.423108,9,11423.90489,634.661383,1269.322765,341.776299,9,0
0,0,33,33,22,47,69,165,109,274,0.000333,0.557912,22,36822.18543,2045.676968,1673.735701,359.173172,10,0
0,0,32,32,19,49,68,173,112,285,0.000333,0.578309,18,31228.68438,1734.92691,1734.92691,355.831405,11,0
0,0,21,21,18,43,61,108,77,185,0.000333,0.365729,9,9874.677667,548.593204,1097.186407,308.388034,7,0
0,0,22,22,18,46,64,114,81,195,0.000333,0.39,9,10530,585,1170,329.1425,9,0
0,0,31,31,20,48,68,154,101,255,0.000333,0.517434,20,31046.06049,1724.781138,1552.303025,354.516762,11,0
0,0,15,15,14,20,34,52,41,93,0.000333,0.157711,14,6623.876619,367.993146,473.134044,139.741531,3,0
0,0,34,34,23,57,80,155,114,269,0.000333,0.566866,22,37413.17047,2078.50947,1700.598658,436.516656,12,0
0,0,20,20,16,25,41,75,62,137,0.000333,0.244662,16,11743.75399,652.430777,733.984625,180.096405,3,0
0,0,39,39,23,59,82,178,135,313,0.000333,0.663305,22,43778.1031,2432.116839,1989.913777,451.117865,12,0
0,0,24,24,18,47,65,121,87,208,0.000333,0.417551,9,11273.87255,626.326253,1252.652505,336.124326,9,0
0,0,21,21,18,43,61,108,77,185,0.000333,0.365729,9,9874.677667,548.593204,1097.186407,308.388034,7,0
0,0,14,14,16,21,37,56,45,101,0.000333,0.175385,16,8418.476639,467.693147,526.15479,156.238666,3,0
0,0,14,14,17,22,39,58,47,105,0.000333,0.184989,16,8879.475728,493.304207,554.967233,167.594364,4,0
0,0,28,28,19,44,63,140,91,231,0.000333,0.460251,18,24853.52992,1380.751662,1380.751662,320.925614,9,0
0,0,20,20,16,25,41,75,62,137,0.000333,0.244662,16,11743.75399,652.430777,733.984625,180.096405,3,0
0,0,36,36,23,56,79,165,125,290,0.000333,0.609365,22,40218.12117,2234.340065,1828.096417,429.253801,10,0
0,0,14,14,16,20,36,52,41,93,0.000333,0.160268,16,7692.848402,427.380467,480.803025,150.438562,4,0
0,0,31,31,19,48,67,153,101,254,0.000333,0.513596,18,27734.15978,1540.786654,1540.786654,348.788823,11,0
0,0,31,31,20,48,68,154,101,255,0.000333,0.517434,20,31046.06049,1724.781138,1552.303025,354.516762,11,0
0,0,19,19,18,42,60,101,71,172,0.000333,0.338662,9,9143.866642,507.992591,1015.985182,301.535982,7,0
0,0,14,14,15,21,36,57,45,102,0.000333,0.175777,14,7382.652902,410.147383,527.33235,150.842025,3,0
0,0,14,14,16,22,38,59,47,106,0.000333,0.185427,16,8900.485063,494.471392,556.280316,162.107496,4,0
0,0,14,14,16,21,37,56,45,101,0.000333,0.175385,16,8418.476639,467.693147,526.15479,156.238666,3,0
0,0,14,14,17,22,39,58,47,105,0.000333,0.184989,16,8879.475728,493.304207,554.967233,167.594364,4,0
0,0,12,12,13,18,31,45,33,78,0.000333,0.128809,6,2318.563873,128.809104,386.427312,123.164366,3,0
0,0,12,12,15,19,34,47,35,82,0.000333,0.139057,7,2920.203671,162.233537,417.171953,139.313982,4,0
0,0,20,20,16,25,41,75,62,137,0.000333,0.244662,16,11743.75399,652.430777,733.984625,180.096405,3,0
0,0,22,22,17,31,48,93,75,168,0.000333,0.312758,16,15012.3792,834.021067,938.2737,223.066954,5,0
0,0,21,21,19,43,62,109,77,186,0.000333,0.36916,9,9967.324624,553.740257,1107.480514,314.040007,7,0
0,0,21,21,19,43,62,110,77,187,0.000333,0.371145,9,10020.91239,556.717355,1113.43471,314.040007,7,0
0,0,21,21,18,43,61,109,77,186,0.000333,0.367706,9,9928.054303,551.558572,1103.117145,308.388034,7,0
0,0,15,15,14,20,34,52,41,93,0.000333,0.157711,14,6623.876619,367.993146,473.134044,139.741531,3,0
0,0,15,15,16,21,37,56,43,99,0.000333,0.171912,16,8251.774131,458.431896,515.735883,156.238666,4,0
0,0,24,24,18,47,65,122,87,209,0.000333,0.419558,9,11328.07386,629.337436,1258.674873,336.124326,9,0
0,0,15,15,14,20,34,52,41,93,0.000333,0.157711,14,6623.876619,367.993146,473.134044,139.741531,3,0
0,0,31,31,23,54,77,142,104,246,0.000333,0.513876,11,16957.92438,942.10691,1541.629489,414.80585,10,0
0,0,12,12,13,18,31,45,33,78,0.000333,0.128809,6,2318.563873,128.809104,386.427312,123.164366,3,0
0,0,12,12,15,19,34,47,35,82,0.000333,0.139057,7,2920.203671,162.233537,417.171953,139.313982,4,0
0,0,24,24,18,47,65,121,87,208,0.000333,0.417551,9,11273.87255,626.326253,1252.652505,336.124326,9,0
0,0,36,36,22,51,73,178,119,297,0.000333,0.612793,22,40444.31367,2246.906315,1838.377894,387.401188,12,0
0,0,32,32,21,45,66,159,105,264,0.000333,0.531907,20,31914.40095,1773.022275,1595.720048,339.372055,9,0
0,0,24,24,19,47,66,122,87,209,0.000333,0.421093,9,11369.50534,631.639185,1263.278371,341.776299,9,0
0,0,31,31,19,47,66,153,100,253,0.000333,0.509744,18,27526.17082,1529.231712,1529.231712,341.776299,11,0
0,0,29,29,19,46,65,160,103,263,0.000333,0.527961,18,28509.88923,1583.882735,1583.882735,334.794473,9,0
0,0,29,29,19,45,64,145,94,239,0.000333,0.478,18,25812,1434,1434,327.844012,9,0
0,0,35,35,21,50,71,171,113,284,0.000333,0.582176,20,34930.56364,1940.586869,1746.528182,374.431475,10,0
0,0,35,35,21,49,70,172,115,287,0.000333,0.586368,20,35182.08452,1954.560251,1759.104226,367.359448,11,0
0,0,21,21,19,43,62,109,77,186,0.000333,0.36916,9,9967.324624,553.740257,1107.480514,314.040007,7,0
0,0,31,31,19,47,66,153,100,253,0.000333,0.509744,18,27526.17082,1529.231712,1529.231712,341.776299,11,0
0,0,28,28,19,43,62,140,90,230,0.000333,0.456488,18,24650.37273,1369.465151,1369.465151,314.040007,9,0
0,0,38,38,22,60,82,202,136,338,0.000333,0.716284,22,47274.75671,2626.375373,2148.852578,452.520931,12,0
0,0,32,32,19,48,67,158,103,261,0.000333,0.52775,18,28498.48702,1583.249279,1583.249279,348.788823,11,0
0,0,29,29,19,46,65,146,94,240,0.000333,0.481789,18,26016.62895,1445.368275,1445.368275,334.794473,11,0
0,0,21,21,19,43,62,110,77,187,0.000333,0.371145,9,10020.91239,556.717355,1113.43471,314.040007,7,0
0,0,28,28,20,43,63,141,90,231,0.000333,0.460251,20,27615.03325,1534.168514,1380.751662,319.767946,9,0
0,0,21,21,18,43,61,108,77,185,0.000333,0.365729,9,9874.677667,548.593204,1097.186407,308.388034,7,0
0,0,26,26,19,42,61,133,84,217,0.000333,0.42899,18,23165.46004,1286.970002,1286.970002,307.187955,9,0
0,0,31,31,19,47,66,153,100,253,0.000333,0.509744,18,27526.17082,1529.231712,1529.231712,341.776299,11,0
0,0,12,12,13,18,31,45,33,78,0.000333,0.128809,6,2318.563873,128.809104,386.427312,123.164366,3,0
0,0,12,12,15,19,34,47,35,82,0.000333,0.139057,7,2920.203671,162.233537,417.171953,139.313982,4,0
0,0,24,24,19,47,66,123,87,210,0.000333,0.423108,9,11423.90489,634.661383,1269.322765,341.776299,9,0
0,0,24,24,18,47,65,121,87,208,0.000333,0.417551,9,11273.87255,626.326253,1252.652505,336.124326,9,0
0,0,12,12,13,18,31,45,33,78,0.000333,0.128809,6,2318.563873,128.809104,386.427312,123.164366,3,0
0,0,12,12,15,19,34,47,35,82,0.000333,0.139057,7,2920.203671,162.233537,417.171953,139.313982,4,0
0,0,15,15,14,20,34,52,41,93,0.000333,0.157711,14,6623.876619,367.993146,473.134044,139.741531,3,0
0,0,17,17,18,26,44,70,54,124,0.000333,0.225657,18,12185.45137,676.969521,676.969521,197.270083,5,0
0,0,28,28,20,44,64,141,91,232,0.000333,0.464,20,27840,1546.666667,1392,326.653553,9,0
0,0,32,32,19,49,68,158,104,262,0.000333,0.531638,18,28708.47476,1594.915264,1594.915264,355.831405,11,0
0,0,32,32,19,50,69,173,113,286,0.000333,0.582346,18,31446.6839,1747.037995,1747.037995,362.903432,11,0
0,0,29,29,19,44,63,145,93,238,0.000333,0.474198,18,25606.66719,1422.592622,1422.592622,320.925614,9,0
0,0,22,22,18,46,64,115,81,196,0.000333,0.392,9,10584,588,1176,329.1425,9,0
0,0,29,29,19,45,64,160,102,262,0.000333,0.524,18,28296,1572,1572,327.844012,9,0
0,0,28,28,19,43,62,140,90,230,0.000333,0.456488,18,24650.37273,1369.465151,1369.465151,314.040007,9,0
0,0,19,19,17,25,42,75,62,137,0.000333,0.246249,16,11819.95979,656.664433,738.747487,185.583273,4,0
0,0,22,22,18,46,64,114,81,195,0.000333,0.39,9,10530,585,1170,329.1425,9,0
0,0,24,24,18,47,65,122,87,209,0.000333,0.419558,9,11328.07386,629.337436,1258.674873,336.124326,9,0
0,0,32,32,21,45,66,159,105,264,0.000333,0.531907,20,31914.40095,1773.022275,1595.720048,339.372055,9,0
0,0,14,14,15,21,36,57,45,102,0.000333,0.175777,14,7382.652902,410.147383,527.33235,150.842025,3,0
0,0,14,14,16,22,38,59,47,106,0.000333,0.185427,16,8900.485063,494.471392,556.280316,162.107496,4,0
0,0,28,28,19,44,63,140,91,231,0.000333,0.460251,18,24853.52992,1380.751662,1380.751662,320.925614,9,0
0,0,29,29,19,46,65,146,94,240,0.000333,0.481789,18,26016.62895,1445.368275,1445.368275,334.794473,11,0
0,0,35,35,21,49,70,172,115,287,0.000333,0.586368,20,35182.08452,1954.560251,1759.104226,367.359448,11,0
0,0,28,28,19,43,62,140,90,230,0.000333,0.456488,18,24650.37273,1369.465151,1369.465151,314.040007,9,0
0,0,32,32,19,48,67,158,103,261,0.000333,0.52775,18,28498.48702,1583.249279,1583.249279,348.788823,11,0
0,0,32,32,19,49,68,173,112,285,0.000333,0.578309,18,31228.68438,1734.92691,1734.92691,355.831405,11,0
0,0,19,19,18,42,60,102,71,173,0.000333,0.340631,9,9197.028657,510.946037,1021.892073,301.535982,7,0
0,0,28,28,20,44,64,141,91,232,0.000333,0.464,20,27840,1546.666667,1392,326.653553,9,0
0,0,24,24,18,47,65,121,87,208,0.000333,0.417551,9,11273.87255,626.326253,1252.652505,336.124326,9,0
0,0,33,33,19,51,70,158,105,263,0.000333,0.537334,18,29016.0258,1612.001433,1612.001433,370.004315,10,0
0,0,33,33,19,49,68,163,105,268,0.000333,0.543813,18,29365.92075,1631.440041,1631.440041,355.831405,10,0
0,0,26,26,19,42,61,133,84,217,0.000333,0.42899,18,23165.46004,1286.970002,1286.970002,307.187955,9,0
0,0,35,35,21,49,70,172,115,287,0.000333,0.586368,20,35182.08452,1954.560251,1759.104226,367.359448,11,0
0,0,29,29,19,44,63,145,93,238,0.000333,0.474198,18,25606.66719,1422.592622,1422.592622,320.925614,9,0
0,0,26,26,19,42,61,133,84,217,0.000333,0.42899,18,23165.46004,1286.970002,1286.970002,307.187955,9,0
0,0,28,28,19,43,62,140,90,230,0.000333,0.456488,18,24650.37273,1369.465151,1369.465151,314.040007,9,0
0,0,29,29,19,45,64,160,102,262,0.000333,0.524,18,28296,1572,1572,327.844012,9,0
0,0,32,32,21,45,66,159,105,264,0.000333,0.531907,20,31914.40095,1773.022275,1595.720048,339.372055,9,0
0,0,22,22,18,46,64,114,81,195,0.000333,0.39,9,10530,585,1170,329.1425,9,0
0,0,19,19,18,42,60,101,71,172,0.000333,0.338662,9,9143.866642,507.992591,1015.985182,301.535982,7,0
0,0,19,19,18,42,60,101,71,172,0.000333,0.338662,9,9143.866642,507.992591,1015.985182,301.535982,7,0
0,0,21,21,18,43,61,108,77,185,0.000333,0.365729,9,9874.677667,548.593204,1097.186407,308.388034,7,0
0,0,28,28,20,43,63,141,90,231,0.000333,0.460251,20,27615.03325,1534.168514,1380.751662,319.767946,9,0
0,0,20,20,18,44,62,105,73,178,0.000333,0.353282,9,9538.622489,529.923472,1059.846943,315.273641,8,0
0,0,12,12,13,18,31,45,33,78,0.000333,0.128809,6,2318.563873,128.809104,386.427312,123.164366,3,0
0,0,12,12,15,19,34,47,35,82,0.000333,0.139057,7,2920.203671,162.233537,417.171953,139.313982,4,0
0,0,28,28,19,43,62,140,90,230,0.000333,0.456488,18,24650.37273,1369.465151,1369.465151,314.040007,9,0
0,0,28,28,20,44,64,141,93,234,0.000333,0.468,20,28080,1560,1404,326.653553,9,0
0,0,20,20,18,42,60,105,72,177,0.000333,0.348507,9,9409.676719,522.759818,1045.519635,301.535982,8,0
0,0,20,20,18,43,61,105,72,177,0.000333,0.349914,9,9447.664579,524.870254,1049.740509,308.388034,8,0
0,0,20,20,18,43,61,105,72,177,0.000333,0.349914,9,9447.664579,524.870254,1049.740509,308.388034,8,0
0,0,22,22,19,43,62,109,75,184,0.000333,0.365191,9,9860.14909,547.786061,1095.572121,314.040007,8,0
0,0,31,31,19,48,67,153,101,254,0.000333,0.513596,18,27734.15978,1540.786654,1540.786654,348.788823,11,0
0,0,31,31,19,47,66,153,100,253,0.000333,0.509744,18,27526.17082,1529.231712,1529.231712,341.776299,11,0
0,0,19,19,18,42,60,101,71,172,0.000333,0.338662,9,9143.866642,507.992591,1015.985182,301.535982,7,0
0,0,29,29,19,46,65,146,94,240,0.000333,0.481789,18,26016.62895,1445.368275,1445.368275,334.794473,11,0
0,0,21,21,18,43,61,109,77,186,0.000333,0.367706,9,9928.054303,551.558572,1103.117145,308.388034,7,0
0,0,22,22,18,46,64,114,81,195,0.000333,0.39,9,10530,585,1170,329.1425,9,0
0,0,22,22,18,46,64,115,81,196,0.000333,0.392,9,10584,588,1176,329.1425,9,0
0,0,24,24,18,47,65,122,87,209,0.000333,0.419558,9,11328.07386,629.337436,1258.674873,336.124326,9,0
0,0,14,14,16,21,37,56,45,101,0.000333,0.175385,16,8418.476639,467.693147,526.15479,156.238666,3,0
0,0,14,14,17,22,39,58,47,105,0.000333,0.184989,16,8879.475728,493.304207,554.967233,167.594364,4,0
0,0,14,14,15,21,36,57,45,102,0.000333,0.175777,14,7382.652902,410.147383,527.33235,150.842025,3,0
0,0,14,14,16,22,38,59,47,106,0.000333,0.185427,16,8900.485063,494.471392,556.280316,162.107496,4,0
0,0,21,21,18,43,61,108,77,185,0.000333,0.365729,9,9874.677667,548.593204,1097.186407,308.388034,7,0
0,0,21,21,19,44,63,109,80,189,0.000333,0.376569,9,10167.35315,564.852953,1129.705906,320.925614,7,0
0,0,24,24,19,47,66,122,87,209,0.000333,0.421093,9,11369.50534,631.639185,1263.278371,341.776299,9,0
0,0,31,31,20,47,67,154,100,254,0.000333,0.513596,20,30815.73309,1711.985172,1540.786654,347.504238,11,0
0,0,21,21,18,43,61,110,78,188,0.000333,0.37166,9,10034.80758,557.48931,1114.978619,308.388034,7,0
0,0,20,20,16,25,41,75,62,137,0.000333,0.244662,16,11743.75399,652.430777,733.984625,180.096405,3,0
0,0,20,20,17,26,43,79,64,143,0.000333,0.258652,16,12415.29376,689.738542,775.95586,191.698301,4,0
0,0,35,35,19,48,67,164,112,276,0.000333,0.55808,18,30136.3311,1674.240617,1674.240617,348.788823,9,0
0,0,19,19,18,42,60,102,71,173,0.000333,0.340631,9,9197.028657,510.946037,1021.892073,301.535982,7,0
0,0,21,21,18,43,61,109,77,186,0.000333,0.367706,9,9928.054303,551.558572,1103.117145,308.388034,7,0
0,0,24,24,19,47,66,122,87,209,0.000333,0.421093,9,11369.50534,631.639185,1263.278371,341.776299,9,0
0,0,30,30,21,49,70,155,100,255,0.000333,0.520989,20,31259.34339,1736.630188,1562.967169,367.359448,11,0
0,0,36,36,20,56,76,174,118,292,0.000333,0.608132,20,36487.89668,2027.105371,1824.394834,411.650438,12,0
0,0,32,32,19,50,69,159,105,264,0.000333,0.53755,18,29027.70822,1612.650457,1612.650457,362.903432,11,0
0,0,34,34,20,55,75,168,112,280,0.000333,0.581356,20,34881.38467,1937.854704,1744.069233,404.413346,12,0
0,0,25,25,19,47,66,122,85,207,0.000333,0.417063,9,11260.70624,625.594791,1251.189583,341.776299,10,0
0,0,32,32,19,49,68,158,101,259,0.000333,0.525551,18,28379.75177,1576.652876,1576.652876,355.831405,10,0
0,0,28,28,19,44,63,140,91,231,0.000333,0.460251,18,24853.52992,1380.751662,1380.751662,320.925614,9,0
0,0,31,31,19,47,66,153,100,253,0.000333,0.509744,18,27526.17082,1529.231712,1529.231712,341.776299,11,0
0,0,35,35,19,50,69,164,110,274,0.000333,0.557912,18,30127.24262,1673.735701,1673.735701,362.903432,10,0
0,0,33,33,19,49,68,158,104,262,0.000333,0.531638,18,28708.47476,1594.915264,1594.915264,355.831405,10,0
0,0,33,33,21,47,68,163,108,271,0.000333,0.549901,20,32994.0486,1833.0027,1649.70243,353.304342,10,0
0,0,33,33,23,48,71,166,111,277,0.000333,0.567827,22,37476.55895,2082.031053,1703.479952,372.120125,10,0
0,0,31,31,20,48,68,155,103,258,0.000333,0.523522,20,31411.30826,1745.072681,1570.565413,354.516762,11,0
0,0,38,38,19,53,72,177,123,300,0.000333,0.616993,18,33317.59501,1850.9775,1850.9775,384.290407,11,0
0,0,37,37,19,51,70,170,116,286,0.000333,0.584325,18,31553.54897,1752.974943,1752.974943,370.004315,10,0
0,0,23,23,18,47,65,118,82,200,0.000333,0.401491,9,10840.26206,602.236781,1204.473563,336.124326,10,0
0,0,36,36,21,51,72,178,120,298,0.000333,0.612879,20,36772.75301,2042.930723,1838.63765,381.532358,11,0
0,0,36,36,23,52,75,181,123,304,0.000333,0.631187,22,41658.3394,2314.352189,1893.560882,400.46479,11,0
0,0,23,23,18,47,65,118,83,201,0.000333,0.403499,9,10894.46337,605.247965,1210.49593,336.124326,10,0
0,0,23,23,18,46,64,118,82,200,0.000333,0.4,9,10800,600,1200,329.1425,10,0
0,0,23,23,18,48,66,118,83,201,0.000333,0.404974,9,10934.30896,607.461609,1214.923218,343.13685,10,0
0,0,27,27,19,43,62,135,86,221,0.000333,0.438626,18,23685.79292,1315.877385,1315.877385,314.040007,9,0
0,0,24,24,19,47,66,122,87,209,0.000333,0.421093,9,11369.50534,631.639185,1263.278371,341.776299,9,0
0,0,24,24,19,48,67,123,90,213,0.000333,0.430692,9,11628.69298,646.038499,1292.076998,348.788823,9,0
0,0,28,28,20,44,64,141,93,234,0.000333,0.468,20,28080,1560,1404,326.653553,9,0
0,0,29,29,20,46,66,161,103,264,0.000333,0.531907,20,31914.40095,1773.022275,1595.720048,340.522412,9,0
0,0,30,30,19,46,65,152,97,249,0.000333,0.499857,18,26992.25254,1499.569585,1499.569585,334.794473,9,0
0,0,29,29,19,45,64,146,94,240,0.000333,0.48,18,25920,1440,1440,327.844012,9,0
0,0,29,29,20,43,63,143,92,235,0.000333,0.46822,20,28093.21564,1560.734202,1404.660782,319.767946,9,0
0,0,35,35,19,48,67,164,112,276,0.000333,0.55808,18,30136.3311,1674.240617,1674.240617,348.788823,9,0
0,0,33,33,19,47,66,158,106,264,0.000333,0.531907,18,28722.96086,1595.720048,1595.720048,341.776299,9,0
0,0,27,27,19,45,64,135,88,223,0.000333,0.446,9,12042,669,1338,327.844012,9,0
0,0,23,23,18,46,64,118,82,200,0.000333,0.4,9,10800,600,1200,329.1425,10,0
0,0,34,34,19,51,70,165,108,273,0.000333,0.557765,18,30119.29675,1673.294264,1673.294264,370.004315,12,0
0,0,33,33,21,46,67,162,107,269,0.000333,0.543926,20,32635.55985,1813.086658,1631.777992,346.322516,9,0
0,0,33,33,23,47,70,165,110,275,0.000333,0.561851,22,37082.16225,2060.120125,1685.55283,365.107601,9,0
0,0,19,19,18,42,60,102,71,173,0.000333,0.340631,9,9197.028657,510.946037,1021.892073,301.535982,7,0
0,0,21,21,19,43,62,111,78,189,0.000333,0.375114,9,10128.08792,562.671551,1125.343103,314.040007,7,0
0,0,19,19,18,42,60,102,71,173,0.000333,0.340631,9,9197.028657,510.946037,1021.892073,301.535982,7,0
0,0,30,30,19,50,69,148,99,247,0.000333,0.502935,9,13579.24987,754.40277,1508.805541,362.903432,12,0
0,0,31,31,19,48,67,152,101,253,0.000333,0.511574,18,27624.97017,1534.720565,1534.720565,348.788823,9,0
0,0,31,31,19,46,65,157,101,258,0.000333,0.517924,18,27967.87612,1553.770896,1553.770896,334.794473,9,0
0,0,30,30,19,46,65,152,97,249,0.000333,0.499857,18,26992.25254,1499.569585,1499.569585,334.794473,9,0
0,0,33,33,21,47,68,166,109,275,0.000333,0.558017,20,33481.04563,1860.05809,1674.052281,353.304342,9,0
0,0,32,32,21,50,71,161,107,268,0.000333,0.549377,20,32962.64456,1831.258031,1648.132228,374.431475,11,0
0,0,20,20,18,44,62,105,73,178,0.000333,0.353282,9,9538.622489,529.923472,1059.846943,315.273641,8,0
0,0,19,19,18,42,60,102,71,173,0.000333,0.340631,9,9197.028657,510.946037,1021.892073,301.535982,7,0
0,0,21,21,21,43,64,111,78,189,0.000333,0.378,10,11340,630,1134,325.56805,8,0
0,0,31,31,20,47,67,154,100,254,0.000333,0.513596,20,30815.73309,1711.985172,1540.786654,347.504238,11,0
0,0,31,31,20,48,68,155,103,258,0.000333,0.523522,20,31411.30826,1745.072681,1570.565413,354.516762,11,0
0,0,22,22,18,46,64,115,81,196,0.000333,0.392,9,10584,588,1176,329.1425,9,0
0,0,30,30,19,50,69,148,99,247,0.000333,0.502935,9,13579.24987,754.40277,1508.805541,362.903432,11,0
0,0,36,36,21,52,73,179,120,299,0.000333,0.616919,20,37015.15086,2056.39727,1850.757543,388.661531,11,0
0,0,31,31,19,47,66,161,101,262,0.000333,0.527877,18,28505.36267,1583.631259,1583.631259,341.776299,9,0
0,0,35,35,22,55,77,179,120,299,0.000333,0.62459,22,41222.92187,2290.162326,1873.769176,416.08228,10,0
0,0,33,33,20,54,74,170,112,282,0.000333,0.583689,20,35021.31698,1945.628721,1751.065849,397.202487,10,0
0,0,27,27,19,47,66,135,90,225,0.000333,0.45333,9,12239.89809,679.994338,1359.988677,341.776299,9,0
0,0,29,29,19,45,64,160,102,262,0.000333,0.524,18,28296,1572,1572,327.844012,9,0
0,0,29,29,19,44,63,145,93,238,0.000333,0.474198,18,25606.66719,1422.592622,1422.592622,320.925614,9,0
0,0,24,24,18,47,65,122,87,209,0.000333,0.419558,9,11328.07386,629.337436,1258.674873,336.124326,9,0
0,0,24,24,19,47,66,124,88,212,0.000333,0.427137,9,11532.70398,640.705777,1281.411553,341.776299,9,0
0,0,38,38,19,52,71,177,119,296,0.000333,0.606775,18,32765.85265,1820.325147,1820.325147,377.133488,12,0
0,0,36,36,19,51,70,171,113,284,0.000333,0.580239,18,31332.89478,1740.716377,1740.716377,370.004315,12,0
0,0,24,24,19,47,66,124,88,212,0.000333,0.427137,9,11532.70398,640.705777,1281.411553,341.776299,9,0
0,0,24,24,18,47,65,124,87,211,0.000333,0.423573,9,11436.47648,635.359804,1270.719609,336.124326,9,0
0,0,21,21,19,44,63,109,80,189,0.000333,0.376569,9,10167.35315,564.852953,1129.705906,320.925614,7,0
0,0,21,21,19,44,63,110,80,190,0.000333,0.378561,9,10221.14867,567.841593,1135.683185,320.925614,7,0
0,0,30,30,20,44,64,146,93,239,0.000333,0.478,20,28680,1593.333333,1434,326.653553,10,0
0,0,30,30,21,44,65,147,93,240,0.000333,0.481789,20,28907.3655,1605.96475,1445.368275,332.453657,10,0
0,0,23,23,18,46,64,118,82,200,0.000333,0.4,9,10800,600,1200,329.1425,10,0
0,0,23,23,18,48,66,118,83,201,0.000333,0.404974,9,10934.30896,607.461609,1214.923218,343.13685,10,0
0,0,23,23,18,48,66,118,83,201,0.000333,0.404974,9,10934.30896,607.461609,1214.923218,343.13685,10,0
0,0,38,38,20,57,77,180,124,304,0.000333,0.635034,20,38102.06217,2116.781232,1905.103108,418.913293,12,0
0,0,21,21,19,43,62,111,78,189,0.000333,0.375114,9,10128.08792,562.671551,1125.343103,314.040007,7,0
0,0,21,21,18,43,61,109,77,186,0.000333,0.367706,9,9928.054303,551.558572,1103.117145,308.388034,7,0
0,0,33,33,20,52,72,170,108,278,0.000333,0.571746,20,34304.78301,1905.821278,1715.23915,382.861427,10,0
0,0,22,22,18,46,64,115,81,196,0.000333,0.392,9,10584,588,1176,329.1425,9,0
0,0,24,24,18,47,65,121,87,208,0.000333,0.417551,9,11273.87255,626.326253,1252.652505,336.124326,9,0
0,0,24,24,19,48,67,122,90,212,0.000333,0.42867,9,11574.09818,643.005454,1286.010908,348.788823,9,0
0,0,29,29,21,44,65,144,93,237,0.000333,0.475767,20,28546.02343,1585.890191,1427.301172,332.453657,9,0
0,0,30,30,20,45,65,146,94,240,0.000333,0.481789,20,28907.3655,1605.96475,1445.368275,333.571951,10,0
0,0,30,30,21,45,66,147,94,241,0.000333,0.485566,20,29133.97966,1618.554425,1456.698983,339.372055,10,0
0,0,27,27,19,46,65,135,89,224,0.000333,0.44967,9,12141.09351,674.505195,1349.01039,334.794473,9,0
0,0,21,21,19,43,62,109,77,186,0.000333,0.36916,9,9967.324624,553.740257,1107.480514,314.040007,7,0
0,0,21,21,19,44,63,110,80,190,0.000333,0.378561,9,10221.14867,567.841593,1135.683185,320.925614,7,0
0,0,19,19,19,43,62,102,72,174,0.000333,0.345343,9,9324.271422,518.015079,1036.030158,314.040007,7,0
0,0,33,33,20,54,74,174,111,285,0.000333,0.589898,20,35393.88418,1966.326899,1769.694209,397.202487,10,0
0,0,28,28,19,43,62,140,90,230,0.000333,0.456488,18,24650.37273,1369.465151,1369.465151,314.040007,9,0
0,0,37,37,20,55,75,177,122,299,0.000333,0.620806,20,37248.33577,2069.351987,1862.416788,404.413346,10,0
0,0,29,29,20,43,63,143,92,235,0.000333,0.46822,20,28093.21564,1560.734202,1404.660782,319.767946,9,0
0,0,33,33,20,53,73,165,110,275,0.000333,0.567401,20,34044.03507,1891.335282,1702.201754,390.018346,10,0
0,0,35,35,20,54,74,171,116,287,0.000333,0.594038,20,35642.26232,1980.125684,1782.113116,397.202487,10,0
0,0,32,32,21,48,69,157,103,260,0.000333,0.529405,20,31764.32718,1764.684843,1588.216359,360.316866,11,0
0,0,22,22,19,47,66,115,82,197,0.000333,0.396915,9,10716.71077,595.372821,1190.745642,341.776299,9,0
0,0,31,31,20,48,68,154,103,257,0.000333,0.521493,20,31289.559,1738.308834,1564.47795,354.516762,11,0
0,0,22,22,18,46,64,115,81,196,0.000333,0.392,9,10584,588,1176,329.1425,9,0
0,0,28,28,20,43,63,141,90,231,0.000333,0.460251,20,27615.03325,1534.168514,1380.751662,319.767946,9,0
0,0,33,33,20,54,74,161,109,270,0.000333,0.558851,20,33531.04817,1862.83601,1676.552409,397.202487,10,0
0,0,33,33,20,52,72,166,109,275,0.000333,0.565576,20,33934.58751,1885.254862,1696.729375,382.861427,10,0
0,0,27,27,19,44,63,136,87,223,0.000333,0.444311,9,11996.40081,666.466711,1332.933423,320.925614,9,0
0,0,33,33,20,53,73,170,109,279,0.000333,0.575654,20,34539.22104,1918.845613,1726.961052,390.018346,10,0
0,0,35,35,22,53,75,175,117,292,0.000333,0.606272,22,40013.93127,2222.996182,1818.815058,401.68728,10,0
0,0,27,27,19,46,65,135,89,224,0.000333,0.44967,9,12141.09351,674.505195,1349.01039,334.794473,9,0
0,0,31,31,19,47,66,153,100,253,0.000333,0.509744,18,27526.17082,1529.231712,1529.231712,341.776299,11,0
0,0,31,31,20,48,68,154,103,257,0.000333,0.521493,20,31289.559,1738.308834,1564.47795,354.516762,11,0
0,0,25,25,20,47,67,123,85,208,0.000333,0.420582,10,12617.46552,700.970306,1261.746552,347.504238,10,0
0,0,20,20,18,44,62,105,73,178,0.000333,0.353282,9,9538.622489,529.923472,1059.846943,315.273641,8,0
0,0,20,20,18,43,61,105,72,177,0.000333,0.349914,9,9447.664579,524.870254,1049.740509,308.388034,8,0
0,0,30,30,21,44,65,147,93,240,0.000333,0.481789,20,28907.3655,1605.96475,1445.368275,332.453657,10,0
0,0,29,29,21,44,65,145,89,234,0.000333,0.469745,20,28184.68137,1565.815631,1409.234068,332.453657,10,0
0,0,30,30,19,48,67,149,97,246,0.000333,0.497419,18,26860.64294,1492.257941,1492.257941,348.788823,11,0
0,0,29,29,19,46,65,146,95,241,0.000333,0.483797,18,26125.03157,1451.390643,1451.390643,334.794473,9,0
0,0,33,33,19,48,67,158,107,265,0.000333,0.535838,18,28935.24544,1607.513635,1607.513635,348.788823,9,0
0,0,31,31,19,47,66,152,101,253,0.000333,0.509744,18,27526.17082,1529.231712,1529.231712,341.776299,9,0
0,0,36,36,23,50,73,178,119,297,0.000333,0.612793,22,40444.31367,2246.906315,1838.377894,386.234734,10,0
0,0,19,19,18,42,60,102,71,173,0.000333,0.340631,9,9197.028657,510.946037,1021.892073,301.535982,7,0
0,0,20,20,18,43,61,105,72,177,0.000333,0.349914,9,9447.664579,524.870254,1049.740509,308.388034,8,0
0,0,19,19,18,42,60,102,71,173,0.000333,0.340631,9,9197.028657,510.946037,1021.892073,301.535982,7,0
0,0,21,21,21,43,64,111,78,189,0.000333,0.378,10,11340,630,1134,325.56805,8,0
0,0,22,22,18,44,62,113,79,192,0.000333,0.381069,9,10288.85122,571.602846,1143.205692,315.273641,8,0
0,0,22,22,19,44,63,114,79,193,0.000333,0.384538,9,10382.53523,576.807513,1153.615025,320.925614,8,0
0,0,21,21,18,43,61,111,77,188,0.000333,0.37166,9,10034.80758,557.48931,1114.978619,308.388034,7,0
0,0,19,19,18,42,60,102,71,173,0.000333,0.340631,9,9197.028657,510.946037,1021.892073,301.535982,7,0
0,0,19,19,18,42,60,102,71,173,0.000333,0.340631,9,9197.028657,510.946037,1021.892073,301.535982,7,0
0,0,21,21,19,43,62,111,78,189,0.000333,0.375114,9,10128.08792,562.671551,1125.343103,314.040007,7,0
0,0,24,24,19,47,66,122,87,209,0.000333,0.421093,9,11369.50534,631.639185,1263.278371,341.776299,9,0
0,0,22,22,18,46,64,114,81,195,0.000333,0.39,9,10530,585,1170,329.1425,9,0
0,0,33,33,20,51,71,166,108,274,0.000333,0.561677,20,33700.61422,1872.256345,1685.030711,375.732254,10,0
0,0,33,33,20,53,73,161,108,269,0.000333,0.555021,20,33301.25613,1850.069785,1665.062806,390.018346,10,0
0,0,20,20,18,43,61,105,73,178,0.000333,0.35189,9,9501.041215,527.835623,1055.671246,308.388034,8,0
0,0,35,35,22,52,74,175,116,291,0.000333,0.602317,22,39752.92045,2208.49558,1806.950929,394.530361,10,0
0,0,32,32,20,47,67,156,102,258,0.000333,0.521684,20,31301.02022,1738.945568,1565.051011,347.504238,11,0
0,0,31,31,19,48,67,153,101,254,0.000333,0.513596,18,27734.15978,1540.786654,1540.786654,348.788823,11,0
0,0,30,30,19,48,67,149,97,246,0.000333,0.497419,18,26860.64294,1492.257941,1492.257941,348.788823,11,0
0,0,30,30,19,48,67,148,97,245,0.000333,0.495397,18,26751.45333,1486.191852,1486.191852,348.788823,11,0
0,0,30,30,21,44,65,147,93,240,0.000333,0.481789,20,28907.3655,1605.96475,1445.368275,332.453657,10,0
0,0,30,30,20,44,64,146,93,239,0.000333,0.478,20,28680,1593.333333,1434,326.653553,10,0
0,0,29,29,21,43,64,144,92,236,0.000333,0.472,20,28320,1573.333333,1416,325.56805,9,0
0,0,28,28,19,43,62,140,90,230,0.000333,0.456488,18,24650.37273,1369.465151,1369.465151,314.040007,9,0
0,0,27,27,19,43,62,136,86,222,0.000333,0.440611,18,23792.96846,1321.831581,1321.831581,314.040007,9,0
0,0,21,21,18,43,61,108,77,185,0.000333,0.365729,9,9874.677667,548.593204,1097.186407,308.388034,7,0
0,0,38,38,20,58,78,184,127,311,0.000333,0.651587,20,39095.2018,2171.955656,1954.76009,426.20146,12,0
0,0,36,36,20,57,77,178,121,299,0.000333,0.62459,20,37475.38351,2081.965751,1873.769176,418.913293,12,0
0,0,32,32,20,48,68,156,103,259,0.000333,0.525551,20,31533.05752,1751.836529,1576.652876,354.516762,11,0
0,0,35,35,20,57,77,178,118,296,0.000333,0.618323,20,37099.37632,2061.076462,1854.968816,418.913293,12,0
0,0,22,22,18,46,64,115,81,196,0.000333,0.392,9,10584,588,1176,329.1425,9,0
0,0,23,23,18,47,65,118,82,200,0.000333,0.401491,9,10840.26206,602.236781,1204.473563,336.124326,10,0
0,0,25,25,18,48,66,126,89,215,0.000333,0.433182,9,11695.90262,649.772368,1299.544736,343.13685,10,0
0,0,22,22,18,46,64,115,81,196,0.000333,0.392,9,10584,588,1176,329.1425,9,0
0,0,27,27,19,45,64,135,88,223,0.000333,0.446,9,12042,669,1338,327.844012,9,0
0,0,32,32,19,48,67,158,100,258,0.000333,0.521684,18,28170.9182,1565.051011,1565.051011,348.788823,10,0
0,0,28,28,19,43,62,140,90,230,0.000333,0.456488,18,24650.37273,1369.465151,1369.465151,314.040007,9,0
0,0,37,37,19,50,69,170,115,285,0.000333,0.58031,18,31336.73046,1740.92947,1740.92947,362.903432,10,0
0,0,33,33,19,48,67,163,104,267,0.000333,0.539882,18,29153.62465,1619.645814,1619.645814,348.788823,10,0
0,0,27,27,19,43,62,136,86,222,0.000333,0.440611,18,23792.96846,1321.831581,1321.831581,314.040007,9,0
0,0,33,33,19,49,68,167,104,271,0.000333,0.549901,18,29694.64374,1649.70243,1649.70243,355.831405,10,0
0,0,35,35,22,54,76,179,119,298,0.000333,0.620627,22,40961.41278,2275.634043,1861.882399,408.871421,10,0
0,0,22,22,18,46,64,115,81,196,0.000333,0.392,9,10584,588,1176,329.1425,9,0
0,0,29,29,21,46,67,148,97,245,0.000333,0.495397,20,29723.83703,1651.32428,1486.191852,346.322516,9,0
0,0,23,23,18,47,65,118,83,201,0.000333,0.403499,9,10894.46337,605.247965,1210.49593,336.124326,10,0
0,0,23,23,19,47,66,118,82,200,0.000333,0.40296,9,10879.90942,604.439412,1208.878824,341.776299,10,0
0,0,25,25,19,47,66,122,85,207,0.000333,0.417063,9,11260.70624,625.594791,1251.189583,341.776299,10,0
0,0,25,25,20,48,68,127,86,213,0.000333,0.43221,10,12966.29585,720.34977,1296.629585,354.516762,10,0
0,0,23,23,18,48,66,118,83,201,0.000333,0.404974,9,10934.30896,607.461609,1214.923218,343.13685,10,0
0,0,23,23,18,48,66,118,83,201,0.000333,0.404974,9,10934.30896,607.461609,1214.923218,343.13685,10,0
0,0,23,23,18,47,65,118,82,200,0.000333,0.401491,9,10840.26206,602.236781,1204.473563,336.124326,10,0
0,0,23,23,18,47,65,118,82,200,0.000333,0.401491,9,10840.26206,602.236781,1204.473563,336.124326,10,0
0,0,23,23,18,46,64,118,82,200,0.000333,0.4,9,10800,600,1200,329.1425,10,0
0,0,35,35,20,56,76,174,115,289,0.000333,0.601884,20,36113.02103,2006.278946,1805.651051,411.650438,12,0
0,0,22,22,18,46,64,115,81,196,0.000333,0.392,9,10584,588,1176,329.1425,9,0
0,0,32,32,21,49,70,158,100,258,0.000333,0.527118,20,31627.10037,1757.061132,1581.355018,367.359448,12,0
0,0,23,23,18,48,66,118,83,201,0.000333,0.404974,9,10934.30896,607.461609,1214.923218,343.13685,10,0
0,0,40,40,20,58,78,186,130,316,0.000333,0.662062,20,39723.74202,2206.874557,1986.187101,426.20146,12,0
0,0,32,32,20,48,68,156,103,259,0.000333,0.525551,20,31533.05752,1751.836529,1576.652876,354.516762,11,0
0,0,31,31,19,47,66,153,100,253,0.000333,0.509744,18,27526.17082,1529.231712,1529.231712,341.776299,11,0
0,0,31,31,20,48,68,154,103,257,0.000333,0.521493,20,31289.559,1738.308834,1564.47795,354.516762,11,0
0,0,30,30,19,48,67,149,97,246,0.000333,0.497419,18,26860.64294,1492.257941,1492.257941,348.788823,11,0
0,0,31,31,19,48,67,153,101,254,0.000333,0.513596,18,27734.15978,1540.786654,1540.786654,348.788823,11,0
0,0,30,30,19,48,67,148,97,245,0.000333,0.495397,18,26751.45333,1486.191852,1486.191852,348.788823,11,0
0,0,36,36,19,54,73,171,115,286,0.000333,0.590097,18,31865.21683,1770.289824,1770.289824,391.474548,12,0
0,0,22,22,18,46,64,115,81,196,0.000333,0.392,9,10584,588,1176,329.1425,9,0
0,0,31,31,19,47,66,153,100,253,0.000333,0.509744,18,27526.17082,1529.231712,1529.231712,341.776299,11,0
0,0,31,31,20,48,68,154,103,257,0.000333,0.521493,20,31289.559,1738.308834,1564.47795,354.516762,11,0
0,0,36,36,20,58,78,174,119,293,0.000333,0.613874,20,36832.457,2046.247611,1841.62285,426.20146,12,0
0,0,24,24,19,47,66,122,87,209,0.000333,0.421093,9,11369.50534,631.639185,1263.278371,341.776299,9,0
0,0,24,24,19,48,67,123,90,213,0.000333,0.430692,9,11628.69298,646.038499,1292.076998,348.788823,9,0
0,0,24,24,18,47,65,122,87,209,0.000333,0.419558,9,11328.07386,629.337436,1258.674873,336.124326,9,0
0,0,24,24,18,47,65,122,87,209,0.000333,0.419558,9,11328.07386,629.337436,1258.674873,336.124326,9,0
0,0,22,22,18,46,64,115,81,196,0.000333,0.392,9,10584,588,1176,329.1425,9,0
0,0,24,24,18,47,65,123,88,211,0.000333,0.423573,9,11436.47648,635.359804,1270.719609,336.124326,9,0
0,0,27,27,19,46,65,135,89,224,0.000333,0.44967,9,12141.09351,674.505195,1349.01039,334.794473,10,0
0,0,31,31,19,47,66,157,102,259,0.000333,0.521833,18,28178.96538,1565.498077,1565.498077,341.776299,9,0
0,0,31,31,19,49,68,152,102,254,0.000333,0.515405,18,27831.88011,1546.215562,1546.215562,355.831405,9,0
0,0,31,31,19,48,67,161,102,263,0.000333,0.531794,18,28716.86623,1595.381457,1595.381457,348.788823,9,0
0,0,29,29,20,44,64,143,93,236,0.000333,0.472,20,28320,1573.333333,1416,326.653553,9,0
0,0,22,22,18,46,64,115,81,196,0.000333,0.392,9,10584,588,1176,329.1425,9,0
0,0,27,27,21,45,66,140,88,228,0.000333,0.459374,10,13781.21859,765.623255,1378.121859,339.372055,10,0
0,0,28,28,20,43,63,141,90,231,0.000333,0.460251,20,27615.03325,1534.168514,1380.751662,319.767946,9,0
0,0,28,28,20,44,64,142,93,235,0.000333,0.47,20,28200,1566.666667,1410,326.653553,9,0
0,0,34,34,19,53,72,165,112,277,0.000333,0.56969,18,30763.24606,1709.069225,1709.069225,384.290407,11,0
0,0,23,23,18,47,65,118,82,200,0.000333,0.401491,9,10840.26206,602.236781,1204.473563,336.124326,10,0
0,0,19,19,18,42,60,102,71,173,0.000333,0.340631,9,9197.028657,510.946037,1021.892073,301.535982,7,0
0,0,19,19,18,42,60,102,71,173,0.000333,0.340631,9,9197.028657,510.946037,1021.892073,301.535982,7,0
0,0,19,19,18,42,60,102,71,173,0.000333,0.340631,9,9197.028657,510.946037,1021.892073,301.535982,7,0
0,0,33,33,21,49,70,160,104,264,0.000333,0.539377,20,32362.61433,1797.923018,1618.130716,367.359448,12,0
0,0,33,33,20,49,69,159,104,263,0.000333,0.535514,20,32130.83864,1785.046591,1606.541932,361.559344,12,0
0,0,32,32,21,49,70,158,100,258,0.000333,0.527118,20,31627.10037,1757.061132,1581.355018,367.359448,12,0
0,0,23,23,18,47,65,118,82,200,0.000333,0.401491,9,10840.26206,602.236781,1204.473563,336.124326,10,0
0,0,19,19,18,42,60,101,71,172,0.000333,0.338662,9,9143.866642,507.992591,1015.985182,301.535982,7,0
0,0,33,33,19,50,69,165,107,272,0.000333,0.55384,18,29907.33574,1661.518652,1661.518652,362.903432,11,0
0,0,25,25,20,47,67,123,85,208,0.000333,0.420582,10,12617.46552,700.970306,1261.746552,347.504238,10,0
0,0,36,36,20,57,77,183,122,305,0.000333,0.637123,20,38227.3979,2123.744328,1911.369895,418.913293,12,0
0,0,36,36,20,59,79,178,122,300,0.000333,0.630378,20,37822.68449,2101.260249,1891.134224,433.514502,12,0
0,0,38,38,22,58,80,192,130,322,0.000333,0.678554,22,44784.53862,2488.029924,2035.660847,437.870393,12,0
0,0,22,22,18,46,64,115,81,196,0.000333,0.392,9,10584,588,1176,329.1425,9,0
0,0,36,36,19,53,72,180,115,295,0.000333,0.606709,18,32762.30176,1820.127875,1820.127875,384.290407,12,0
0,0,30,30,19,48,67,149,97,246,0.000333,0.497419,18,26860.64294,1492.257941,1492.257941,348.788823,11,0
0,0,36,36,19,52,71,171,114,285,0.000333,0.584226,18,31548.20272,1752.677929,1752.677929,377.133488,12,0
0,0,38,38,19,53,72,177,120,297,0.000333,0.610823,18,32984.41906,1832.467725,1832.467725,384.290407,12,0
0,0,40,40,19,54,73,183,126,309,0.000333,0.637552,18,34427.8042,1912.655789,1912.655789,391.474548,12,0
0,0,32,32,20,48,68,156,103,259,0.000333,0.525551,20,31533.05752,1751.836529,1576.652876,354.516762,11,0
0,0,19,19,18,42,60,102,71,173,0.000333,0.340631,9,9197.028657,510.946037,1021.892073,301.535982,7,0
0,0,21,21,18,43,61,109,77,186,0.000333,0.367706,9,9928.054303,551.558572,1103.117145,308.388034,7,0
0,0,22,22,18,46,64,115,81,196,0.000333,0.392,9,10584,588,1176,329.1425,9,0
0,0,35,35,19,49,68,164,113,277,0.000333,0.562076,18,30352.08973,1686.227207,1686.227207,355.831405,9,0
0,0,24,24,19,48,67,123,90,213,0.000333,0.430692,9,11628.69298,646.038499,1292.076998,348.788823,9,0
0,0,33,33,21,49,70,160,104,264,0.000333,0.539377,20,32362.61433,1797.923018,1618.130716,367.359448,12,0
0,0,32,32,21,48,69,157,103,260,0.000333,0.529405,20,31764.32718,1764.684843,1588.216359,360.316866,11,0
0,0,31,31,19,48,67,153,101,254,0.000333,0.513596,18,27734.15978,1540.786654,1540.786654,348.788823,11,0
0,0,36,36,21,52,73,179,120,299,0.000333,0.616919,20,37015.15086,2056.39727,1850.757543,388.661531,11,0
0,0,38,38,22,57,79,188,127,315,0.000333,0.661897,22,43685.20059,2426.955588,1985.690936,430.582226,12,0
0,0,36,36,20,57,77,183,119,302,0.000333,0.630857,20,37851.39071,2102.855039,1892.569535,418.913293,12,0
0,0,36,36,20,56,76,179,119,298,0.000333,0.620627,20,37237.64798,2068.758221,1861.882399,411.650438,12,0
0,0,22,22,18,46,64,115,81,196,0.000333,0.392,9,10584,588,1176,329.1425,9,0
0,0,24,24,18,47,65,124,87,211,0.000333,0.423573,9,11436.47648,635.359804,1270.719609,336.124326,9,0
0,0,22,22,18,46,64,115,81,196,0.000333,0.392,9,10584,588,1176,329.1425,9,0
0,0,22,22,18,46,64,115,81,196,0.000333,0.392,9,10584,588,1176,329.1425,9,0
0,0,34,34,19,50,69,165,110,275,0.000333,0.559948,18,30237.19606,1679.844226,1679.844226,362.903432,11,0
0,0,22,22,18,46,64,115,81,196,0.000333,0.392,9,10584,588,1176,329.1425,9,0
0,0,22,22,18,46,64,115,81,196,0.000333,0.392,9,10584,588,1176,329.1425,9,0
0,0,32,32,20,48,68,156,103,259,0.000333,0.525551,20,31533.05752,1751.836529,1576.652876,354.516762,11,0
0,0,20,20,18,42,60,105,72,177,0.000333,0.348507,9,9409.676719,522.759818,1045.519635,301.535982,8,0
0,0,19,19,18,42,60,102,71,173,0.000333,0.340631,9,9197.028657,510.946037,1021.892073,301.535982,7,0
0,0,30,30,19,47,66,149,96,245,0.000333,0.493626,18,26655.77807,1480.876559,1480.876559,341.776299,11,0
0,0,20,20,19,43,62,105,72,177,0.000333,0.351298,9,9485.034722,526.946373,1053.892747,314.040007,8,0
0,0,20,20,18,42,60,105,72,177,0.000333,0.348507,9,9409.676719,522.759818,1045.519635,301.535982,8,0
0,0,21,21,21,43,64,111,78,189,0.000333,0.378,10,11340,630,1134,325.56805,8,0
0,0,19,19,18,42,60,102,71,173,0.000333,0.340631,9,9197.028657,510.946037,1021.892073,301.535982,7,0
0,0,22,22,19,43,62,109,75,184,0.000333,0.365191,9,9860.14909,547.786061,1095.572121,314.040007,8,0
0,0,20,20,18,44,62,105,73,178,0.000333,0.353282,9,9538.622489,529.923472,1059.846943,315.273641,8,0
0,0,20,20,18,44,62,105,73,178,0.000333,0.353282,9,9538.622489,529.923472,1059.846943,315.273641,8,0
0,0,22,22,19,44,63,114,79,193,0.000333,0.384538,9,10382.53523,576.807513,1153.615025,320.925614,8,0
0,0,22,22,18,44,62,113,79,192,0.000333,0.381069,9,10288.85122,571.602846,1143.205692,315.273641,8,0
0,0,23,23,18,47,65,118,82,200,0.000333,0.401491,9,10840.26206,602.236781,1204.473563,336.124326,10,0
0,0,19,19,18,42,60,102,71,173,0.000333,0.340631,9,9197.028657,510.946037,1021.892073,301.535982,7,0
0,0,19,19,18,42,60,102,71,173,0.000333,0.340631,9,9197.028657,510.946037,1021.892073,301.535982,7,0
0,0,21,21,18,43,61,111,77,188,0.000333,0.37166,9,10034.80758,557.48931,1114.978619,308.388034,7,0
0,0,19,19,18,42,60,102,71,173,0.000333,0.340631,9,9197.028657,510.946037,1021.892073,301.535982,7,0
0,0,22,22,18,46,64,114,81,195,0.000333,0.39,9,10530,585,1170,329.1425,9,0
0,0,22,22,19,47,66,115,82,197,0.000333,0.396915,9,10716.71077,595.372821,1190.745642,341.776299,9,0
0,0,24,24,19,47,66,122,87,209,0.000333,0.421093,9,11369.50534,631.639185,1263.278371,341.776299,9,0
0,0,24,24,19,48,67,123,90,213,0.000333,0.430692,9,11628.69298,646.038499,1292.076998,348.788823,9,0
0,0,40,40,20,59,79,190,133,323,0.000333,0.678707,20,40722.42363,2262.356869,2036.121182,433.514502,12,0
0,0,31,31,19,48,67,153,101,254,0.000333,0.513596,18,27734.15978,1540.786654,1540.786654,348.788823,11,0
0,0,27,27,19,46,65,135,89,224,0.000333,0.44967,9,12141.09351,674.505195,1349.01039,334.794473,9,0
0,0,19,19,18,42,60,102,71,173,0.000333,0.340631,9,9197.028657,510.946037,1021.892073,301.535982,7,0
0,0,19,19,18,42,60,102,71,173,0.000333,0.340631,9,9197.028657,510.946037,1021.892073,301.535982,7,0
0,0,21,21,19,43,62,109,77,186,0.000333,0.36916,9,9967.324624,553.740257,1107.480514,314.040007,7,0
0,0,21,21,19,44,63,110,80,190,0.000333,0.378561,9,10221.14867,567.841593,1135.683185,320.925614,7,0
0,0,39,39,25,68,93,232,153,385,0.000333,0.839192,24,60421.82742,3356.76819,2517.576142,530.043878,16,0
0,0,33,33,19,51,70,165,108,273,0.000333,0.557765,18,30119.29675,1673.294264,1673.294264,370.004315,11,0
0,0,34,34,19,53,72,165,112,277,0.000333,0.56969,18,30763.24606,1709.069225,1709.069225,384.290407,11,0
0,0,34,34,19,51,70,170,112,282,0.000333,0.576153,18,31112.24059,1728.457811,1728.457811,370.004315,11,0
0,0,19,19,18,42,60,101,71,172,0.000333,0.338662,9,9143.866642,507.992591,1015.985182,301.535982,7,0
0,0,19,19,19,43,62,102,72,174,0.000333,0.345343,9,9324.271422,518.015079,1036.030158,314.040007,7,0
0,0,28,28,19,43,62,140,90,230,0.000333,0.456488,18,24650.37273,1369.465151,1369.465151,314.040007,9,0
0,0,33,33,19,48,67,158,103,261,0.000333,0.52775,18,28498.48702,1583.249279,1583.249279,348.788823,10,0
0,0,21,21,18,43,61,109,77,186,0.000333,0.367706,9,9928.054303,551.558572,1103.117145,308.388034,7,0
0,0,21,21,18,43,61,110,78,188,0.000333,0.37166,9,10034.80758,557.48931,1114.978619,308.388034,7,0
0,0,31,31,19,47,66,153,100,253,0.000333,0.509744,18,27526.17082,1529.231712,1529.231712,341.776299,11,0
0,0,27,27,19,44,63,135,87,222,0.000333,0.442319,9,11942.60529,663.478072,1326.956143,320.925614,9,0
0,0,31,31,19,48,67,152,98,250,0.000333,0.505507,18,27297.40136,1516.522298,1516.522298,348.788823,10,0
0,0,29,29,21,44,65,144,93,237,0.000333,0.475767,20,28546.02343,1585.890191,1427.301172,332.453657,9,0
0,0,28,28,19,44,63,140,91,231,0.000333,0.460251,18,24853.52992,1380.751662,1380.751662,320.925614,9,0
0,0,27,27,19,44,63,136,87,223,0.000333,0.444311,9,11996.40081,666.466711,1332.933423,320.925614,9,0
0,0,40,40,25,54,79,196,131,327,0.000333,0.687112,24,49472.07131,2748.448406,2061.336305,426.86033,10,0
0,0,35,35,23,49,72,174,120,294,0.000333,0.604653,22,39907.07491,2217.059717,1813.95795,379.162707,9,0
0,0,36,36,19,52,71,171,117,288,0.000333,0.590376,18,31880.28907,1771.12717,1771.12717,377.133488,11,0
0,0,34,34,19,51,70,165,111,276,0.000333,0.563894,18,30450.27803,1691.682113,1691.682113,370.004315,11,0
0,0,29,29,21,44,65,144,93,237,0.000333,0.475767,20,28546.02343,1585.890191,1427.301172,332.453657,9,0
0,0,19,19,18,42,60,102,71,173,0.000333,0.340631,9,9197.028657,510.946037,1021.892073,301.535982,7,0
0,0,21,21,18,43,61,111,77,188,0.000333,0.37166,9,10034.80758,557.48931,1114.978619,308.388034,7,0
0,0,20,20,18,44,62,105,73,178,0.000333,0.353282,9,9538.622489,529.923472,1059.846943,315.273641,8,0
0,0,20,20,18,44,62,105,73,178,0.000333,0.353282,9,9538.622489,529.923472,1059.846943,315.273641,8,0
0,0,19,19,18,42,60,102,71,173,0.000333,0.340631,9,9197.028657,510.946037,1021.892073,301.535982,7,0
0,0,22,22,19,44,63,114,79,193,0.000333,0.384538,9,10382.53523,576.807513,1153.615025,320.925614,8,0
0,0,33,33,21,47,68,165,110,275,0.000333,0.558017,20,33481.04563,1860.05809,1674.052281,353.304342,9,0
0,0,33,33,23,48,71,168,113,281,0.000333,0.576026,22,38017.73669,2112.096483,1728.078941,372.120125,9,0
0,0,22,22,19,47,66,115,82,197,0.000333,0.396915,9,10716.71077,595.372821,1190.745642,341.776299,9,0
0,0,28,28,20,44,64,142,93,235,0.000333,0.47,20,28200,1566.666667,1410,326.653553,9,0
0,0,19,19,18,42,60,101,71,172,0.000333,0.338662,9,9143.866642,507.992591,1015.985182,301.535982,7,0
0,0,19,19,19,43,62,102,72,174,0.000333,0.345343,9,9324.271422,518.015079,1036.030158,314.040007,7,0
0,0,23,23,18,47,65,118,82,200,0.000333,0.401491,9,10840.26206,602.236781,1204.473563,336.124326,10,0
0,0,23,23,18,47,65,118,82,200,0.000333,0.401491,9,10840.26206,602.236781,1204.473563,336.124326,10,0
0,0,25,25,20,47,67,123,85,208,0.000333,0.420582,10,12617.46552,700.970306,1261.746552,347.504238,10,0
0,0,23,23,18,48,66,118,83,201,0.000333,0.404974,9,10934.30896,607.461609,1214.923218,343.13685,10,0
0,0,32,32,19,49,68,173,112,285,0.000333,0.578309,18,31228.68438,1734.92691,1734.92691,355.831405,11,0
0,0,30,30,19,47,66,149,96,245,0.000333,0.493626,18,26655.77807,1480.876559,1480.876559,341.776299,11,0
0,0,28,28,19,44,63,140,91,231,0.000333,0.460251,18,24853.52992,1380.751662,1380.751662,320.925614,9,0
0,0,27,27,19,44,63,136,87,223,0.000333,0.444311,9,11996.40081,666.466711,1332.933423,320.925614,9,0
0,0,34,34,19,52,71,174,112,286,0.000333,0.586276,18,31658.89817,1758.827676,1758.827676,377.133488,11,0
0,0,30,30,19,48,67,149,97,246,0.000333,0.497419,18,26860.64294,1492.257941,1492.257941,348.788823,11,0
0,0,34,34,19,51,70,170,112,282,0.000333,0.576153,18,31112.24059,1728.457811,1728.457811,370.004315,11,0
0,0,22,22,18,46,64,115,81,196,0.000333,0.392,9,10584,588,1176,329.1425,9,0
0,0,30,30,21,45,66,147,94,241,0.000333,0.485566,20,29133.97966,1618.554425,1456.698983,339.372055,10,0
0,0,30,30,20,45,65,146,94,240,0.000333,0.481789,20,28907.3655,1605.96475,1445.368275,333.571951,10,0
0,0,23,23,18,48,66,118,83,201,0.000333,0.404974,9,10934.30896,607.461609,1214.923218,343.13685,10,0
0,0,27,27,21,45,66,142,90,232,0.000333,0.467433,20,28045.98871,1558.110484,1402.299436,339.372055,9,0
0,0,21,21,19,43,62,109,77,186,0.000333,0.36916,9,9967.324624,553.740257,1107.480514,314.040007,7,0
0,0,21,21,19,44,63,110,80,190,0.000333,0.378561,9,10221.14867,567.841593,1135.683185,320.925614,7,0
0,0,21,21,18,43,61,108,77,185,0.000333,0.365729,9,9874.677667,548.593204,1097.186407,308.388034,7,0
0,0,21,21,19,44,63,109,80,189,0.000333,0.376569,9,10167.35315,564.852953,1129.705906,320.925614,7,0
0,0,29,29,21,43,64,144,92,236,0.000333,0.472,20,28320,1573.333333,1416,325.56805,9,0
0,0,33,33,20,49,69,159,104,263,0.000333,0.535514,20,32130.83864,1785.046591,1606.541932,361.559344,12,0
0,0,32,32,19,49,68,173,112,285,0.000333,0.578309,18,31228.68438,1734.92691,1734.92691,355.831405,11,0
0,0,32,32,20,50,70,174,113,287,0.000333,0.586368,20,35182.08452,1954.560251,1759.104226,368.631371,11,0
0,0,24,24,18,47,65,121,87,208,0.000333,0.417551,9,11273.87255,626.326253,1252.652505,336.124326,9,0
0,0,24,24,19,48,67,122,90,212,0.000333,0.42867,9,11574.09818,643.005454,1286.010908,348.788823,9,0
0,0,23,23,18,46,64,118,82,200,0.000333,0.4,9,10800,600,1200,329.1425,10,0
0,0,22,22,18,46,64,115,81,196,0.000333,0.392,9,10584,588,1176,329.1425,9,0
0,0,27,27,19,43,62,136,86,222,0.000333,0.440611,18,23792.96846,1321.831581,1321.831581,314.040007,9,0
0,0,31,31,19,47,66,153,100,253,0.000333,0.509744,18,27526.17082,1529.231712,1529.231712,341.776299,11,0
0,0,31,31,20,48,68,154,103,257,0.000333,0.521493,20,31289.559,1738.308834,1564.47795,354.516762,11,0
0,0,27,27,19,45,64,135,88,223,0.000333,0.446,9,12042,669,1338,327.844012,9,0
0,0,33,33,21,47,68,166,109,275,0.000333,0.558017,20,33481.04563,1860.05809,1674.052281,353.304342,9,0
0,0,38,38,21,52,73,183,122,305,0.000333,0.629299,20,37757.92981,2097.662767,1887.89649,388.661531,12,0
0,0,32,32,19,48,67,158,103,261,0.000333,0.52775,18,28498.48702,1583.249279,1583.249279,348.788823,11,0
0,0,31,31,19,46,65,157,101,258,0.000333,0.517924,18,27967.87612,1553.770896,1553.770896,334.794473,9,0
0,0,31,31,19,48,67,152,101,253,0.000333,0.511574,18,27624.97017,1534.720565,1534.720565,348.788823,9,0
0,0,31,31,19,46,65,152,100,252,0.000333,0.505879,18,27317.4604,1517.636689,1517.636689,334.794473,9,0
0,0,24,24,21,47,68,124,88,212,0.000333,0.430181,10,12905.42122,716.967846,1290.542122,353.304342,10,0
0,0,31,31,19,48,67,153,101,254,0.000333,0.513596,18,27734.15978,1540.786654,1540.786654,348.788823,11,0
0,0,20,20,19,43,62,105,72,177,0.000333,0.351298,9,9485.034722,526.946373,1053.892747,314.040007,8,0
0,0,33,33,20,53,73,170,111,281,0.000333,0.57978,20,34786.81402,1932.600779,1739.340701,390.018346,10,0
0,0,33,33,21,48,69,160,103,263,0.000333,0.535514,20,32130.83864,1785.046591,1606.541932,360.316866,12,0
0,0,31,31,19,47,66,161,101,262,0.000333,0.527877,18,28505.36267,1583.631259,1583.631259,341.776299,9,0
0,0,36,36,19,51,70,171,116,287,0.000333,0.586368,18,31663.87607,1759.104226,1759.104226,370.004315,11,0
0,0,35,35,19,52,71,171,111,282,0.000333,0.578076,18,31216.11638,1734.228688,1734.228688,377.133488,12,0
0,0,31,31,19,48,67,153,101,254,0.000333,0.513596,18,27734.15978,1540.786654,1540.786654,348.788823,11,0
0,0,31,31,20,47,67,154,100,254,0.000333,0.513596,20,30815.73309,1711.985172,1540.786654,347.504238,11,0
0,0,33,33,19,47,66,158,106,264,0.000333,0.531907,18,28722.96086,1595.720048,1595.720048,341.776299,9,0
0,0,27,27,19,43,62,135,86,221,0.000333,0.438626,18,23685.79292,1315.877385,1315.877385,314.040007,9,0
0,0,29,29,19,45,64,146,94,240,0.000333,0.48,18,25920,1440,1440,327.844012,9,0
0,0,19,19,18,42,60,102,71,173,0.000333,0.340631,9,9197.028657,510.946037,1021.892073,301.535982,7,0
0,0,21,21,19,43,62,111,78,189,0.000333,0.375114,9,10128.08792,562.671551,1125.343103,314.040007,7,0
0,0,19,19,18,42,60,102,71,173,0.000333,0.340631,9,9197.028657,510.946037,1021.892073,301.535982,7,0
0,0,22,22,19,44,63,114,79,193,0.000333,0.384538,9,10382.53523,576.807513,1153.615025,320.925614,8,0
0,0,22,22,18,44,62,113,79,192,0.000333,0.381069,9,10288.85122,571.602846,1143.205692,315.273641,8,0
0,0,21,21,18,43,61,109,77,186,0.000333,0.367706,9,9928.054303,551.558572,1103.117145,308.388034,7,0
0,0,19,19,18,42,60,102,71,173,0.000333,0.340631,9,9197.028657,510.946037,1021.892073,301.535982,7,0
0,0,33,33,20,56,76,165,112,277,0.000333,0.576892,20,34613.51842,1922.973246,1730.675921,411.650438,10,0
0,0,19,19,19,43,62,102,72,174,0.000333,0.345343,9,9324.271422,518.015079,1036.030158,314.040007,7,0
0,0,28,28,19,43,62,140,90,230,0.000333,0.456488,18,24650.37273,1369.465151,1369.465151,314.040007,9,0
0,0,10,10,11,17,28,36,36,72,0.000333,0.115377,10,3461.295544,192.294197,346.129554,107.540616,3,0
0,0,33,33,20,55,75,165,111,276,0.000333,0.573051,20,34383.07917,1910.171065,1719.153959,404.413346,10,0
0,0,39,39,23,54,77,191,129,320,0.000333,0.668457,22,44118.17725,2451.009847,2005.371693,414.80585,12,0
0,0,38,38,23,53,76,187,130,317,0.000333,0.660198,22,43573.04648,2420.724804,1980.593022,407.621709,11,0
0,0,29,29,19,44,63,145,93,238,0.000333,0.474198,18,25606.66719,1422.592622,1422.592622,320.925614,9,0
0,0,35,35,21,49,70,172,112,284,0.000333,0.580239,20,34814.32754,1934.129308,1740.716377,367.359448,10,0
0,0,24,24,18,47,65,121,87,208,0.000333,0.417551,9,11273.87255,626.326253,1252.652505,336.124326,9,0
0,0,24,24,19,48,67,122,90,212,0.000333,0.42867,9,11574.09818,643.005454,1286.010908,348.788823,9,0
0,0,28,28,19,44,63,140,91,231,0.000333,0.460251,18,24853.52992,1380.751662,1380.751662,320.925614,9,0
0,0,32,32,20,54,74,165,108,273,0.000333,0.56506,20,33903.61538,1883.534188,1695.180769,397.202487,10,0
0,0,29,29,20,44,64,143,93,236,0.000333,0.472,20,28320,1573.333333,1416,326.653553,9,0
0,0,33,33,20,54,74,165,111,276,0.000333,0.57127,20,34276.18258,1904.232365,1713.809129,397.202487,10,0
0,0,35,35,20,55,75,171,117,288,0.000333,0.597967,20,35877.99566,1993.221981,1793.899783,404.413346,10,0
0,0,27,27,19,44,63,135,87,222,0.000333,0.442319,9,11942.60529,663.478072,1326.956143,320.925614,9,0
0,0,31,31,20,53,73,159,105,264,0.000333,0.544705,10,16341.13684,907.840935,1634.113684,390.018346,10,0
0,0,22,22,18,46,64,114,81,195,0.000333,0.39,9,10530,585,1170,329.1425,9,0
0,0,25,25,19,48,67,127,89,216,0.000333,0.436758,9,11792.47739,655.137633,1310.275265,348.788823,10,0
0,0,23,23,18,48,66,118,83,201,0.000333,0.404974,9,10934.30896,607.461609,1214.923218,343.13685,10,0
0,0,25,25,20,48,68,127,86,213,0.000333,0.43221,10,12966.29585,720.34977,1296.629585,354.516762,10,0
0,0,25,25,19,47,66,122,85,207,0.000333,0.417063,9,11260.70624,625.594791,1251.189583,341.776299,10,0
0,0,32,32,20,49,69,159,104,263,0.000333,0.535514,20,32130.83864,1785.046591,1606.541932,361.559344,11,0
0,0,30,30,21,45,66,147,94,241,0.000333,0.485566,20,29133.97966,1618.554425,1456.698983,339.372055,10,0
0,0,31,31,19,47,66,153,100,253,0.000333,0.509744,18,27526.17082,1529.231712,1529.231712,341.776299,11,0
0,0,35,35,19,51,70,171,110,281,0.000333,0.57411,18,31001.9135,1722.328528,1722.328528,370.004315,12,0
0,0,40,40,19,53,72,183,125,308,0.000333,0.633446,18,34206.06421,1900.3369,1900.3369,384.290407,12,0
0,0,36,36,19,51,70,176,114,290,0.000333,0.592497,18,31994.85735,1777.492075,1777.492075,370.004315,12,0
0,0,36,36,19,53,72,171,114,285,0.000333,0.586143,18,31651.71526,1758.428625,1758.428625,384.290407,12,0
0,0,36,36,19,52,71,180,114,294,0.000333,0.602675,18,32544.46176,1808.025653,1808.025653,377.133488,12,0
0,0,24,24,18,47,65,122,87,209,0.000333,0.419558,9,11328.07386,629.337436,1258.674873,336.124326,9,0
0,0,23,23,18,47,65,118,83,201,0.000333,0.403499,9,10894.46337,605.247965,1210.49593,336.124326,10,0
0,0,23,23,18,47,65,118,82,200,0.000333,0.401491,9,10840.26206,602.236781,1204.473563,336.124326,10,0
0,0,25,25,20,47,67,123,85,208,0.000333,0.420582,10,12617.46552,700.970306,1261.746552,347.504238,10,0
0,0,7,7,8,10,18,17,19,36,0.000333,0.050039,4,600.4692,33.3594,150.1173,57.219281,1,0
0,0,8,8,10,15,25,31,26,57,0.000333,0.088233,5,1323.499014,73.527723,264.699803,91.82264,3,0
0,0,23,23,19,47,66,118,82,200,0.000333,0.40296,9,10879.90942,604.439412,1208.878824,341.776299,10,0
0,0,23,23,18,48,66,118,83,201,0.000333,0.404974,9,10934.30896,607.461609,1214.923218,343.13685,10,0
0,0,23,23,18,48,66,118,83,201,0.000333,0.404974,9,10934.30896,607.461609,1214.923218,343.13685,10,0
0,0,24,24,21,47,68,124,88,212,0.000333,0.430181,10,12905.42122,716.967846,1290.542122,353.304342,10,0
0,0,29,29,21,44,65,145,89,234,0.000333,0.469745,20,28184.68137,1565.815631,1409.234068,332.453657,10,0
0,0,21,21,18,43,61,108,77,185,0.000333,0.365729,9,9874.677667,548.593204,1097.186407,308.388034,7,0
0,0,21,21,19,44,63,109,80,189,0.000333,0.376569,9,10167.35315,564.852953,1129.705906,320.925614,7,0
0,0,15,15,12,16,28,47,48,95,0.000333,0.152233,18,8220.576917,456.698718,456.698718,107.01955,1,0
0,0,16,16,14,22,36,65,56,121,0.000333,0.20852,14,8757.852952,486.547386,625.560925,151.410465,3,0
0,0,9,9,11,14,25,29,31,60,0.000333,0.092877,10,2786.313714,154.795206,278.631371,91.356717,1,0
0,0,10,10,13,19,32,43,38,81,0.000333,0.135,12,4860,270,405,128.816339,3,0
0,0,10,10,9,13,22,24,31,55,0.000333,0.081756,8,1962.149912,109.008328,245.268739,76.635041,1,0
0,0,11,11,11,18,29,42,40,82,0.000333,0.132785,10,3983.544416,221.308023,398.354442,113.112398,3,0
0,0,25,25,20,48,68,127,86,213,0.000333,0.43221,10,12966.29585,720.34977,1296.629585,354.516762,10,0
0,0,29,29,19,45,64,160,102,262,0.000333,0.524,18,28296,1572,1572,327.844012,9,0
0,0,28,28,19,43,62,140,90,230,0.000333,0.456488,18,24650.37273,1369.465151,1369.465151,314.040007,9,0
0,0,28,28,20,44,64,141,93,234,0.000333,0.468,20,28080,1560,1404,326.653553,9,0
0,0,24,24,19,47,66,124,88,212,0.000333,0.427137,9,11532.70398,640.705777,1281.411553,341.776299,9,0
0,0,22,22,18,46,64,115,81,196,0.000333,0.392,9,10584,588,1176,329.1425,9,0
0,0,22,22,18,46,64,115,81,196,0.000333,0.392,9,10584,588,1176,329.1425,9,0
0,0,24,24,18,47,65,122,87,209,0.000333,0.419558,9,11328.07386,629.337436,1258.674873,336.124326,9,0
0,0,22,22,18,46,64,114,81,195,0.000333,0.39,9,10530,585,1170,329.1425,9,0
0,0,22,22,19,47,66,115,82,197,0.000333,0.396915,9,10716.71077,595.372821,1190.745642,341.776299,9,0
0,0,28,28,19,44,63,140,91,231,0.000333,0.460251,18,24853.52992,1380.751662,1380.751662,320.925614,9,0
0,0,32,32,20,52,72,161,105,266,0.000333,0.547067,20,32824.00101,1823.555612,1641.20005,382.861427,10,0
0,0,37,37,20,54,74,173,120,293,0.000333,0.606457,20,36387.39672,2021.52204,1819.369836,397.202487,10,0
0,0,29,29,20,44,64,143,93,236,0.000333,0.472,20,28320,1573.333333,1416,326.653553,9,0
0,0,33,33,20,52,72,161,108,269,0.000333,0.553237,20,33194.19651,1844.122028,1659.709825,382.861427,10,0
0,0,35,35,20,53,73,167,114,281,0.000333,0.57978,20,34786.81402,1932.600779,1739.340701,390.018346,10,0
0,0,27,27,19,44,63,135,87,222,0.000333,0.442319,9,11942.60529,663.478072,1326.956143,320.925614,9,0
0,0,28,28,19,44,63,140,91,231,0.000333,0.460251,18,24853.52992,1380.751662,1380.751662,320.925614,9,0
0,0,27,27,19,44,63,136,87,223,0.000333,0.444311,9,11996.40081,666.466711,1332.933423,320.925614,9,0
0,0,10,10,9,14,23,23,34,57,0.000333,0.085948,8,2062.744252,114.596903,257.843031,81.832294,1,0
0,0,10,10,11,18,29,35,39,74,0.000333,0.11983,10,3594.905936,199.716996,359.490594,113.112398,3,0
0,0,33,33,20,48,68,159,103,262,0.000333,0.531638,20,31898.30529,1772.128072,1594.915264,354.516762,12,0
0,0,32,32,20,50,70,174,113,287,0.000333,0.586368,20,35182.08452,1954.560251,1759.104226,368.631371,11,0
0,0,45,45,26,71,97,258,176,434,0.000333,0.954787,26,74473.41651,4137.412028,2864.362174,558.843478,16,0
0,0,22,22,18,46,64,115,81,196,0.000333,0.392,9,10584,588,1176,329.1425,9,0
0,0,22,22,18,46,64,115,81,196,0.000333,0.392,9,10584,588,1176,329.1425,9,0
0,0,38,38,19,52,71,177,122,299,0.000333,0.612925,18,33097.939,1838.774389,1838.774389,377.133488,11,0
0,0,32,32,21,49,70,158,100,258,0.000333,0.527118,20,31627.10037,1757.061132,1581.355018,367.359448,12,0
0,0,21,21,19,43,62,109,77,186,0.000333,0.36916,9,9967.324624,553.740257,1107.480514,314.040007,7,0
0,0,27,27,19,43,62,135,86,221,0.000333,0.438626,18,23685.79292,1315.877385,1315.877385,314.040007,9,0
0,0,33,33,20,55,75,174,112,286,0.000333,0.593814,20,35628.84291,1979.380162,1781.442145,404.413346,10,0
0,0,28,28,20,43,63,141,90,231,0.000333,0.460251,20,27615.03325,1534.168514,1380.751662,319.767946,9,0
0,0,28,28,20,44,64,142,93,235,0.000333,0.47,20,28200,1566.666667,1410,326.653553,9,0
0,0,6,6,10,11,21,19,22,41,0.000333,0.060028,10,1800.850143,100.04723,180.085014,71.273029,1,0
0,0,7,7,12,12,24,23,24,47,0.000333,0.071831,12,2585.91885,143.662158,215.493238,86.0391,2,0
0,0,27,27,19,43,62,135,86,221,0.000333,0.438626,18,23685.79292,1315.877385,1315.877385,314.040007,9,0
0,0,31,31,19,47,66,152,97,249,0.000333,0.501685,18,27090.97444,1505.054136,1505.054136,341.776299,10,0
0,0,27,27,19,46,65,135,89,224,0.000333,0.44967,9,12141.09351,674.505195,1349.01039,334.794473,9,0
0,0,30,30,19,50,69,148,99,247,0.000333,0.502935,9,13579.24987,754.40277,1508.805541,362.903432,11,0
0,0,38,38,21,53,74,185,123,308,0.000333,0.637504,20,38250.23273,2125.01293,1912.511637,395.81845,12,0
0,0,35,35,19,49,68,164,109,273,0.000333,0.553959,18,29913.7924,1661.877356,1661.877356,355.831405,10,0
0,0,30,30,19,47,66,152,98,250,0.000333,0.5037,18,27199.77354,1511.09853,1511.09853,341.776299,9,0
0,0,22,22,18,46,64,114,81,195,0.000333,0.39,9,10530,585,1170,329.1425,9,0
0,0,22,22,19,47,66,115,82,197,0.000333,0.396915,9,10716.71077,595.372821,1190.745642,341.776299,9,0
0,0,16,16,14,22,36,61,55,116,0.000333,0.199904,14,8395.958202,466.442122,599.7113,151.410465,3,0
0,0,22,22,18,46,64,114,81,195,0.000333,0.39,9,10530,585,1170,329.1425,9,0
0,0,22,22,19,47,66,115,82,197,0.000333,0.396915,9,10716.71077,595.372821,1190.745642,341.776299,9,0
0,0,29,29,19,46,65,160,103,263,0.000333,0.527961,18,28509.88923,1583.882735,1583.882735,334.794473,9,0
0,0,31,31,19,47,66,157,102,259,0.000333,0.521833,18,28178.96538,1565.498077,1565.498077,341.776299,9,0
0,0,22,22,18,46,64,115,81,196,0.000333,0.392,9,10584,588,1176,329.1425,9,0
0,0,29,29,21,43,64,144,92,236,0.000333,0.472,20,28320,1573.333333,1416,325.56805,9,0
0,0,25,25,19,48,67,127,89,216,0.000333,0.436758,9,11792.47739,655.137633,1310.275265,348.788823,10,0
0,0,22,22,18,46,64,115,81,196,0.000333,0.392,9,10584,588,1176,329.1425,9,0
0,0,24,24,18,47,65,124,87,211,0.000333,0.423573,9,11436.47648,635.359804,1270.719609,336.124326,9,0
0,0,32,32,19,48,67,158,103,261,0.000333,0.52775,18,28498.48702,1583.249279,1583.249279,348.788823,11,0
0,0,32,32,20,49,69,159,104,263,0.000333,0.535514,20,32130.83864,1785.046591,1606.541932,361.559344,11,0
0,0,29,29,21,44,65,145,89,234,0.000333,0.469745,20,28184.68137,1565.815631,1409.234068,332.453657,10,0
0,0,30,30,19,49,68,148,98,246,0.000333,0.499172,18,26955.28546,1497.515859,1497.515859,355.831405,11,0
0,0,21,21,18,43,61,108,77,185,0.000333,0.365729,9,9874.677667,548.593204,1097.186407,308.388034,7,0
0,0,21,21,19,44,63,109,80,189,0.000333,0.376569,9,10167.35315,564.852953,1129.705906,320.925614,7,0
0,0,28,28,19,44,63,140,91,231,0.000333,0.460251,18,24853.52992,1380.751662,1380.751662,320.925614,9,0
0,0,28,28,19,43,62,140,90,230,0.000333,0.456488,18,24650.37273,1369.465151,1369.465151,314.040007,9,0
0,0,31,31,20,52,72,159,104,263,0.000333,0.540897,20,32453.80551,1802.989195,1622.690275,382.861427,10,0
0,0,22,22,18,46,64,115,81,196,0.000333,0.392,9,10584,588,1176,329.1425,9,0
0,0,22,22,18,46,64,115,81,196,0.000333,0.392,9,10584,588,1176,329.1425,9,0
0,0,24,24,18,47,65,122,87,209,0.000333,0.419558,9,11328.07386,629.337436,1258.674873,336.124326,9,0
0,0,22,22,18,46,64,115,81,196,0.000333,0.392,9,10584,588,1176,329.1425,9,0
0,0,33,33,21,48,69,166,110,276,0.000333,0.561984,20,33719.055,1873.280833,1685.95275,360.316866,9,0
0,0,24,24,18,47,65,123,88,211,0.000333,0.423573,9,11436.47648,635.359804,1270.719609,336.124326,9,0
0,0,22,22,18,46,64,115,81,196,0.000333,0.392,9,10584,588,1176,329.1425,9,0
0,0,36,36,23,49,72,177,118,295,0.000333,0.606709,22,40042.81326,2224.600737,1820.127875,379.162707,9,0
0,0,35,35,23,49,72,174,120,294,0.000333,0.604653,22,39907.07491,2217.059717,1813.95795,379.162707,9,0
0,0,29,29,19,44,63,145,93,238,0.000333,0.474198,18,25606.66719,1422.592622,1422.592622,320.925614,9,0
0,0,29,29,20,45,65,146,94,240,0.000333,0.481789,20,28907.3655,1605.96475,1445.368275,333.571951,9,0
0,0,29,29,19,44,63,145,93,238,0.000333,0.474198,18,25606.66719,1422.592622,1422.592622,320.925614,9,0
0,0,29,29,20,45,65,146,94,240,0.000333,0.481789,20,28907.3655,1605.96475,1445.368275,333.571951,9,0
0,0,37,37,20,53,73,173,119,292,0.000333,0.602476,20,36148.57542,2008.25419,1807.428771,390.018346,10,0
0,0,22,22,19,43,62,109,75,184,0.000333,0.365191,9,9860.14909,547.786061,1095.572121,314.040007,8,0
0,0,22,22,20,44,64,114,76,190,0.000333,0.38,10,11400,633.333333,1140,326.653553,8,0
0,0,20,20,18,44,62,105,73,178,0.000333,0.353282,9,9538.622489,529.923472,1059.846943,315.273641,8,0
0,0,20,20,18,44,62,105,73,178,0.000333,0.353282,9,9538.622489,529.923472,1059.846943,315.273641,8,0
0,0,20,20,18,44,62,105,73,178,0.000333,0.353282,9,9538.622489,529.923472,1059.846943,315.273641,8,0
0,0,22,22,20,43,63,110,75,185,0.000333,0.368599,10,11057.96786,614.331548,1105.796786,319.767946,8,0
0,0,20,20,18,43,61,105,72,177,0.000333,0.349914,9,9447.664579,524.870254,1049.740509,308.388034,8,0
0,0,19,19,18,42,60,101,71,172,0.000333,0.338662,9,9143.866642,507.992591,1015.985182,301.535982,7,0
0,0,19,19,19,43,62,102,72,174,0.000333,0.345343,9,9324.271422,518.015079,1036.030158,314.040007,7,0
0,0,20,20,19,43,62,105,72,177,0.000333,0.351298,9,9485.034722,526.946373,1053.892747,314.040007,8,0
0,0,20,20,18,42,60,105,72,177,0.000333,0.348507,9,9409.676719,522.759818,1045.519635,301.535982,8,0
0,0,22,22,20,43,63,110,75,185,0.000333,0.368599,10,11057.96786,614.331548,1105.796786,319.767946,8,0
0,0,20,20,18,43,61,105,72,177,0.000333,0.349914,9,9447.664579,524.870254,1049.740509,308.388034,8,0
0,0,20,20,18,43,61,105,72,177,0.000333,0.349914,9,9447.664579,524.870254,1049.740509,308.388034,8,0
0,0,4,4,7,8,15,9,10,19,0.000333,0.024744,3,222.692764,12.37182,74.230921,43.651484,1,0
0,0,5,5,9,9,18,13,12,25,0.000333,0.034749,4,416.9925,23.16625,104.248125,57.05865,2,0
0,0,22,22,18,46,64,115,81,196,0.000333,0.392,9,10584,588,1176,329.1425,9,0
0,0,31,31,20,47,67,154,100,254,0.000333,0.513596,20,30815.73309,1711.985172,1540.786654,347.504238,11,0
0,0,31,31,20,48,68,155,103,258,0.000333,0.523522,20,31411.30826,1745.072681,1570.565413,354.516762,11,0
0,0,23,23,18,47,65,118,82,200,0.000333,0.401491,9,10840.26206,602.236781,1204.473563,336.124326,10,0
0,0,33,33,20,49,69,159,104,263,0.000333,0.535514,20,32130.83864,1785.046591,1606.541932,361.559344,12,0
0,0,6,6,9,11,20,20,22,42,0.000333,0.060507,8,1452.16784,80.675991,181.52098,66.583073,1,0
0,0,7,7,11,12,23,24,24,48,0.000333,0.072377,10,2171.309739,120.628319,217.130974,81.073298,2,0
0,0,12,12,12,14,26,39,39,78,0.000333,0.122211,12,4399.611576,244.422865,366.634298,96.322519,1,0
0,0,32,32,21,48,69,142,110,252,0.000333,0.513116,20,30786.96326,1710.386848,1539.348163,360.316866,10,0
0,0,7,7,8,12,20,16,24,40,0.000333,0.057626,8,1383.01699,76.834277,172.877124,67.01955,1,0
0,0,8,8,10,17,27,30,31,61,0.000333,0.096683,5,1450.240688,80.568927,290.048138,102.706149,3,0
0,0,19,19,18,42,60,102,71,173,0.000333,0.340631,9,9197.028657,510.946037,1021.892073,301.535982,7,0
0,0,21,21,18,43,61,109,77,186,0.000333,0.367706,9,9928.054303,551.558572,1103.117145,308.388034,7,0
0,0,19,19,18,42,60,102,71,173,0.000333,0.340631,9,9197.028657,510.946037,1021.892073,301.535982,7,0
0,0,35,35,20,52,72,167,113,280,0.000333,0.57586,20,34551.58001,1919.532223,1727.579,382.861427,10,0
0,0,33,33,20,51,71,161,107,268,0.000333,0.549377,20,32962.64456,1831.258031,1648.132228,375.732254,10,0
0,0,31,31,20,50,70,155,101,256,0.000333,0.523032,20,31381.92905,1743.440503,1569.096452,368.631371,10,0
0,0,7,7,8,11,19,17,19,36,0.000333,0.050975,4,611.701562,33.98342,152.92539,62.053748,1,0
0,0,8,8,10,16,26,31,26,57,0.000333,0.089308,5,1339.62532,74.423629,267.925064,97.219281,3,0
0,0,21,21,18,43,61,109,77,186,0.000333,0.367706,9,9928.054303,551.558572,1103.117145,308.388034,7,0
0,0,27,27,19,43,62,136,86,222,0.000333,0.440611,18,23792.96846,1321.831581,1321.831581,314.040007,9,0
0,0,32,32,20,51,71,161,104,265,0.000333,0.543228,20,32593.65973,1810.758874,1629.682987,375.732254,10,0
0,0,28,28,19,43,62,140,90,230,0.000333,0.456488,18,24650.37273,1369.465151,1369.465151,314.040007,9,0
0,0,29,29,20,43,63,143,92,235,0.000333,0.46822,20,28093.21564,1560.734202,1404.660782,319.767946,9,0
0,0,20,20,18,42,60,105,72,177,0.000333,0.348507,9,9409.676719,522.759818,1045.519635,301.535982,8,0
0,0,20,20,19,43,62,105,72,177,0.000333,0.351298,9,9485.034722,526.946373,1053.892747,314.040007,8,0
0,0,22,22,18,44,62,113,79,192,0.000333,0.381069,9,10288.85122,571.602846,1143.205692,315.273641,8,0
0,0,22,22,18,46,64,115,81,196,0.000333,0.392,9,10584,588,1176,329.1425,9,0
0,0,9,9,11,14,25,29,32,61,0.000333,0.094425,10,2832.752276,157.375126,283.275228,91.356717,1,0
0,0,10,10,13,19,32,43,39,82,0.000333,0.136667,12,4920,273.333333,410,128.816339,3,0
0,0,22,22,20,44,64,114,76,190,0.000333,0.38,10,11400,633.333333,1140,326.653553,8,0
0,0,27,27,19,43,62,136,86,222,0.000333,0.440611,18,23792.96846,1321.831581,1321.831581,314.040007,9,0
0,0,29,29,21,45,66,145,90,235,0.000333,0.473478,20,28408.65236,1578.258464,1420.432618,339.372055,10,0
0,0,29,29,21,45,66,145,90,235,0.000333,0.473478,20,28408.65236,1578.258464,1420.432618,339.372055,10,0
0,0,32,32,19,50,69,173,113,286,0.000333,0.582346,18,31446.6839,1747.037995,1747.037995,362.903432,11,0
0,0,30,30,19,50,69,148,99,247,0.000333,0.502935,9,13579.24987,754.40277,1508.805541,362.903432,11,0
0,0,19,19,18,42,60,102,71,173,0.000333,0.340631,9,9197.028657,510.946037,1021.892073,301.535982,7,0
0,0,30,30,19,48,67,149,97,246,0.000333,0.497419,18,26860.64294,1492.257941,1492.257941,348.788823,11,0
0,0,23,23,18,47,65,118,82,200,0.000333,0.401491,9,10840.26206,602.236781,1204.473563,336.124326,10,0
0,0,23,23,18,47,65,118,82,200,0.000333,0.401491,9,10840.26206,602.236781,1204.473563,336.124326,10,0
0,0,20,20,18,43,61,105,72,177,0.000333,0.349914,9,9447.664579,524.870254,1049.740509,308.388034,8,0
0,0,29,29,19,45,64,160,102,262,0.000333,0.524,18,28296,1572,1572,327.844012,9,0
0,0,29,29,20,46,66,161,103,264,0.000333,0.531907,20,31914.40095,1773.022275,1595.720048,340.522412,9,0
0,0,19,19,18,42,60,102,71,173,0.000333,0.340631,9,9197.028657,510.946037,1021.892073,301.535982,7,0
0,0,23,23,18,48,66,118,83,201,0.000333,0.404974,9,10934.30896,607.461609,1214.923218,343.13685,10,0
0,0,29,29,20,44,64,143,93,236,0.000333,0.472,20,28320,1573.333333,1416,326.653553,9,0
0,0,7,7,8,10,18,16,18,34,0.000333,0.047259,4,567.1098,31.5061,141.77745,57.219281,1,0
0,0,10,10,13,17,30,34,29,63,0.000333,0.103045,6,1854.804645,103.044703,309.134108,117.592585,3,0
0,0,23,23,18,48,66,118,83,201,0.000333,0.404974,9,10934.30896,607.461609,1214.923218,343.13685,10,0
0,0,30,30,19,48,67,148,97,245,0.000333,0.495397,18,26751.45333,1486.191852,1486.191852,348.788823,11,0
0,0,20,20,18,44,62,105,73,178,0.000333,0.353282,9,9538.622489,529.923472,1059.846943,315.273641,8,0
0,0,30,30,19,48,67,149,97,246,0.000333,0.497419,18,26860.64294,1492.257941,1492.257941,348.788823,11,0
0,0,31,31,19,48,67,153,101,254,0.000333,0.513596,18,27734.15978,1540.786654,1540.786654,348.788823,11,0
0,0,32,32,21,48,69,157,103,260,0.000333,0.529405,20,31764.32718,1764.684843,1588.216359,360.316866,11,0
0,0,23,23,19,47,66,118,82,200,0.000333,0.40296,9,10879.90942,604.439412,1208.878824,341.776299,10,0
0,0,23,23,18,46,64,118,82,200,0.000333,0.4,9,10800,600,1200,329.1425,10,0
0,0,23,23,18,48,66,118,83,201,0.000333,0.404974,9,10934.30896,607.461609,1214.923218,343.13685,10,0
0,0,25,25,20,48,68,127,86,213,0.000333,0.43221,10,12966.29585,720.34977,1296.629585,354.516762,10,0
0,0,23,23,18,47,65,118,82,200,0.000333,0.401491,9,10840.26206,602.236781,1204.473563,336.124326,10,0
0,0,24,24,21,47,68,124,88,212,0.000333,0.430181,10,12905.42122,716.967846,1290.542122,353.304342,10,0
0,0,30,30,20,45,65,146,94,240,0.000333,0.481789,20,28907.3655,1605.96475,1445.368275,333.571951,10,0
0,0,32,32,21,49,70,158,100,258,0.000333,0.527118,20,31627.10037,1757.061132,1581.355018,367.359448,12,0
0,0,30,30,20,44,64,146,93,239,0.000333,0.478,20,28680,1593.333333,1434,326.653553,10,0
0,0,30,30,21,44,65,147,93,240,0.000333,0.481789,20,28907.3655,1605.96475,1445.368275,332.453657,10,0
0,0,29,29,21,45,66,145,90,235,0.000333,0.473478,20,28408.65236,1578.258464,1420.432618,339.372055,10,0
0,0,29,29,21,46,67,148,97,245,0.000333,0.495397,20,29723.83703,1651.32428,1486.191852,346.322516,9,0
0,0,30,30,21,45,66,147,94,241,0.000333,0.485566,20,29133.97966,1618.554425,1456.698983,339.372055,10,0
0,0,30,30,20,45,65,146,94,240,0.000333,0.481789,20,28907.3655,1605.96475,1445.368275,333.571951,10,0
0,0,19,19,18,42,60,101,71,172,0.000333,0.338662,9,9143.866642,507.992591,1015.985182,301.535982,7,0
0,0,19,19,19,43,62,102,72,174,0.000333,0.345343,9,9324.271422,518.015079,1036.030158,314.040007,7,0
0,0,33,33,20,49,69,159,104,263,0.000333,0.535514,20,32130.83864,1785.046591,1606.541932,361.559344,12,0
0,0,15,15,12,17,29,47,48,95,0.000333,0.153836,12,5538.098334,307.67213,461.508195,112.506418,1,0
0,0,15,15,14,22,36,59,53,112,0.000333,0.193011,14,8106.442402,450.357911,579.0316,151.410465,3,0
0,0,19,19,18,42,60,102,71,173,0.000333,0.340631,9,9197.028657,510.946037,1021.892073,301.535982,7,0
0,0,9,9,12,14,26,28,32,60,0.000333,0.094009,12,3384.316597,188.017589,282.026383,96.322519,1,0
0,0,10,10,14,19,33,42,39,81,0.000333,0.136199,14,5720.342931,317.79683,408.595924,134.013592,3,0
0,0,19,19,18,42,60,101,71,172,0.000333,0.338662,9,9143.866642,507.992591,1015.985182,301.535982,7,0
0,0,19,19,19,43,62,102,72,174,0.000333,0.345343,9,9324.271422,518.015079,1036.030158,314.040007,7,0
0,0,21,21,19,43,62,109,77,186,0.000333,0.36916,9,9967.324624,553.740257,1107.480514,314.040007,7,0
0,0,21,21,19,44,63,110,80,190,0.000333,0.378561,9,10221.14867,567.841593,1135.683185,320.925614,7,0
0,0,20,20,18,42,60,105,72,177,0.000333,0.348507,9,9409.676719,522.759818,1045.519635,301.535982,8,0
0,0,6,6,10,11,21,19,22,41,0.000333,0.060028,10,1800.850143,100.04723,180.085014,71.273029,1,0
0,0,7,7,12,12,24,23,24,47,0.000333,0.071831,12,2585.91885,143.662158,215.493238,86.0391,2,0
0,0,17,17,15,20,35,54,49,103,0.000333,0.176105,14,7396.42611,410.912562,528.316151,145.041921,1,0
0,0,17,17,14,20,34,60,50,110,0.000333,0.18654,14,7834.692776,435.26071,559.620913,139.741531,1,0
0,0,15,15,15,17,32,50,42,92,0.000333,0.153333,14,6440,357.777778,460,128.090227,1,0
0,0,18,18,14,19,33,57,56,113,0.000333,0.190006,14,7980.231497,443.346194,570.016535,134.013592,1,0
0,0,16,16,15,19,34,60,47,107,0.000333,0.181453,14,7621.019336,423.389963,544.358524,139.313982,1,0
0,0,15,15,15,18,33,52,43,95,0.000333,0.159739,14,6709.044179,372.724677,479.217441,133.662009,1,0
0,0,13,13,15,17,32,45,33,78,0.000333,0.13,7,2730,151.666667,390,128.090227,2,0
0,0,13,13,15,17,32,45,33,78,0.000333,0.13,7,2730,151.666667,390,128.090227,2,0
0,0,13,13,15,17,32,45,33,78,0.000333,0.13,7,2730,151.666667,390,128.090227,2,0
0,0,13,13,15,17,32,45,33,78,0.000333,0.13,7,2730,151.666667,390,128.090227,2,0
0,0,13,13,16,18,34,46,34,80,0.000333,0.135666,8,3255.976218,180.887568,406.997027,139.05865,2,0
0,0,13,13,15,18,33,45,34,79,0.000333,0.132836,7,2789.549948,154.974997,398.507135,133.662009,2,0
0,0,12,12,14,16,30,42,32,74,0.000333,0.121037,14,5083.538657,282.418814,363.109904,117.302969,1,0
0,0,13,13,15,16,31,45,33,78,0.000333,0.128809,14,5409.982371,300.554576,386.427312,122.603359,2,0
0,0,13,13,15,16,31,45,33,78,0.000333,0.128809,14,5409.982371,300.554576,386.427312,122.603359,2,0
0,0,13,13,16,18,34,46,34,80,0.000333,0.135666,8,3255.976218,180.887568,406.997027,139.05865,2,0
0,0,13,13,15,18,33,45,34,79,0.000333,0.132836,7,2789.549948,154.974997,398.507135,133.662009,2,0
0,0,15,15,16,17,33,50,36,86,0.000333,0.144606,16,6941.086308,385.615906,433.817894,133.486868,2,0
0,0,15,15,16,17,33,50,36,86,0.000333,0.144606,16,6941.086308,385.615906,433.817894,133.486868,2,0
0,0,28,28,19,43,62,140,90,230,0.000333,0.456488,18,24650.37273,1369.465151,1369.465151,314.040007,9,0
0,0,28,28,20,44,64,141,93,234,0.000333,0.468,20,28080,1560,1404,326.653553,9,0
0,0,22,22,20,44,64,114,76,190,0.000333,0.38,10,11400,633.333333,1140,326.653553,8,0
0,0,22,22,19,43,62,109,75,184,0.000333,0.365191,9,9860.14909,547.786061,1095.572121,314.040007,8,0
0,0,29,29,19,45,64,160,102,262,0.000333,0.524,18,28296,1572,1572,327.844012,9,0
0,0,29,29,20,46,66,161,103,264,0.000333,0.531907,20,31914.40095,1773.022275,1595.720048,340.522412,9,0
0,0,20,20,18,43,61,105,73,178,0.000333,0.35189,9,9501.041215,527.835623,1055.671246,308.388034,8,0
0,0,20,20,18,43,61,105,72,177,0.000333,0.349914,9,9447.664579,524.870254,1049.740509,308.388034,8,0
0,0,31,31,20,47,67,154,100,254,0.000333,0.513596,20,30815.73309,1711.985172,1540.786654,347.504238,11,0
0,0,31,31,20,48,68,155,103,258,0.000333,0.523522,20,31411.30826,1745.072681,1570.565413,354.516762,11,0
0,0,30,30,21,48,69,152,97,249,0.000333,0.507008,20,30420.4518,1690.0251,1521.02259,360.316866,11,0
0,0,22,22,18,46,64,115,81,196,0.000333,0.392,9,10584,588,1176,329.1425,9,0
0,0,24,24,18,47,65,122,87,209,0.000333,0.419558,9,11328.07386,629.337436,1258.674873,336.124326,9,0
0,0,33,33,19,48,67,158,107,265,0.000333,0.535838,18,28935.24544,1607.513635,1607.513635,348.788823,9,0
0,0,31,31,19,47,66,152,101,253,0.000333,0.509744,18,27526.17082,1529.231712,1529.231712,341.776299,9,0
0,0,20,20,18,44,62,105,73,178,0.000333,0.353282,9,9538.622489,529.923472,1059.846943,315.273641,8,0
0,0,29,29,21,44,65,144,93,237,0.000333,0.475767,20,28546.02343,1585.890191,1427.301172,332.453657,9,0
0,0,29,29,19,46,65,146,95,241,0.000333,0.483797,18,26125.03157,1451.390643,1451.390643,334.794473,9,0
0,0,27,27,19,44,63,135,87,222,0.000333,0.442319,9,11942.60529,663.478072,1326.956143,320.925614,9,0
0,0,27,27,19,44,63,136,87,223,0.000333,0.444311,9,11996.40081,666.466711,1332.933423,320.925614,9,0
0,0,28,28,19,44,63,140,91,231,0.000333,0.460251,18,24853.52992,1380.751662,1380.751662,320.925614,9,0
0,0,20,20,18,43,61,105,72,177,0.000333,0.349914,9,9447.664579,524.870254,1049.740509,308.388034,8,0
0,0,20,20,18,43,61,105,72,177,0.000333,0.349914,9,9447.664579,524.870254,1049.740509,308.388034,8,0
0,0,20,20,18,43,61,105,72,177,0.000333,0.349914,9,9447.664579,524.870254,1049.740509,308.388034,8,0
0,0,20,20,18,43,61,105,73,178,0.000333,0.35189,9,9501.041215,527.835623,1055.671246,308.388034,8,0
0,0,20,20,18,42,60,105,72,177,0.000333,0.348507,9,9409.676719,522.759818,1045.519635,301.535982,8,0
0,0,19,19,18,42,60,102,71,173,0.000333,0.340631,9,9197.028657,510.946037,1021.892073,301.535982,7,0
0,0,22,22,20,43,63,110,75,185,0.000333,0.368599,10,11057.96786,614.331548,1105.796786,319.767946,8,0
0,0,20,20,18,44,62,105,73,178,0.000333,0.353282,9,9538.622489,529.923472,1059.846943,315.273641,8,0
0,0,20,20,18,44,62,105,73,178,0.000333,0.353282,9,9538.622489,529.923472,1059.846943,315.273641,8,0
0,0,20,20,18,43,61,105,72,177,0.000333,0.349914,9,9447.664579,524.870254,1049.740509,308.388034,8,0
0,0,25,25,18,48,66,126,89,215,0.000333,0.433182,9,11695.90262,649.772368,1299.544736,343.13685,10,0
0,0,7,7,8,10,18,17,19,36,0.000333,0.050039,4,600.4692,33.3594,150.1173,57.219281,1,0
0,0,8,8,10,15,25,31,26,57,0.000333,0.088233,5,1323.499014,73.527723,264.699803,91.82264,3,0
0,0,4,4,7,8,15,9,10,19,0.000333,0.024744,3,222.692764,12.37182,74.230921,43.651484,1,0
0,0,5,5,9,9,18,13,12,25,0.000333,0.034749,4,416.9925,23.16625,104.248125,57.05865,2,0
0,0,19,19,18,42,60,102,71,173,0.000333,0.340631,9,9197.028657,510.946037,1021.892073,301.535982,7,0
0,0,7,7,8,11,19,17,21,38,0.000333,0.053807,4,645.684982,35.871388,161.421246,62.053748,1,0
0,0,8,8,10,16,26,31,28,59,0.000333,0.092442,5,1386.629717,77.034984,277.325943,97.219281,3,0
0,0,33,33,21,49,70,160,104,264,0.000333,0.539377,20,32362.61433,1797.923018,1618.130716,367.359448,12,0
0,0,32,32,19,48,67,158,103,261,0.000333,0.52775,18,28498.48702,1583.249279,1583.249279,348.788823,11,0
0,0,32,32,20,49,69,159,104,263,0.000333,0.535514,20,32130.83864,1785.046591,1606.541932,361.559344,11,0
0,0,7,7,8,12,20,16,24,40,0.000333,0.057626,8,1383.01699,76.834277,172.877124,67.01955,1,0
0,0,8,8,10,17,27,30,31,61,0.000333,0.096683,5,1450.240688,80.568927,290.048138,102.706149,3,0
0,0,21,21,18,43,61,109,77,186,0.000333,0.367706,9,9928.054303,551.558572,1103.117145,308.388034,7,0
0,0,36,36,20,58,78,187,122,309,0.000333,0.647396,20,38843.78571,2157.988095,1942.189286,426.20146,12,0
0,0,7,7,8,10,18,17,19,36,0.000333,0.050039,4,600.4692,33.3594,150.1173,57.219281,1,0
0,0,8,8,10,15,25,31,26,57,0.000333,0.088233,5,1323.499014,73.527723,264.699803,91.82264,3,0
0,0,29,29,19,45,64,145,94,239,0.000333,0.478,18,25812,1434,1434,327.844012,9,0
0,0,35,35,21,50,71,172,113,285,0.000333,0.584226,20,35053.55858,1947.419921,1752.677929,374.431475,10,0
0,0,20,20,18,44,62,105,73,178,0.000333,0.353282,9,9538.622489,529.923472,1059.846943,315.273641,8,0
0,0,22,22,20,43,63,110,75,185,0.000333,0.368599,10,11057.96786,614.331548,1105.796786,319.767946,8,0
0,0,12,12,12,14,26,39,39,78,0.000333,0.122211,12,4399.611576,244.422865,366.634298,96.322519,1,0
0,0,29,29,21,44,65,129,100,229,0.000333,0.459707,20,27582.44458,1532.358032,1379.122229,332.453657,8,0
0,0,6,6,9,11,20,20,22,42,0.000333,0.060507,8,1452.16784,80.675991,181.52098,66.583073,1,0
0,0,7,7,11,12,23,24,24,48,0.000333,0.072377,10,2171.309739,120.628319,217.130974,81.073298,2,0
0,0,20,20,18,43,61,105,73,178,0.000333,0.35189,9,9501.041215,527.835623,1055.671246,308.388034,8,0
0,0,20,20,18,43,61,105,72,177,0.000333,0.349914,9,9447.664579,524.870254,1049.740509,308.388034,8,0
0,0,20,20,18,44,62,105,73,178,0.000333,0.353282,9,9538.622489,529.923472,1059.846943,315.273641,8,0
0,0,22,22,18,46,64,115,81,196,0.000333,0.392,9,10584,588,1176,329.1425,9,0
0,0,9,9,11,14,25,29,35,64,0.000333,0.099069,10,2972.067961,165.114887,297.206796,91.356717,1,0
0,0,10,10,13,19,32,43,42,85,0.000333,0.141667,12,5100,283.333333,425,128.816339,3,0
0,0,22,22,18,46,64,114,81,195,0.000333,0.39,9,10530,585,1170,329.1425,9,0
0,0,22,22,19,47,66,115,82,197,0.000333,0.396915,9,10716.71077,595.372821,1190.745642,341.776299,9,0
0,0,10,10,12,14,26,37,28,65,0.000333,0.101843,12,3666.34298,203.685721,305.528582,96.322519,1,0
0,0,9,9,11,13,24,29,31,60,0.000333,0.091699,10,2750.9775,152.832083,275.09775,86.159464,1,0
0,0,10,10,13,18,31,43,38,81,0.000333,0.133763,12,4815.478814,267.526601,401.289901,123.164366,3,0
0,0,15,15,12,15,27,47,48,95,0.000333,0.150571,18,8130.857629,451.714313,451.714313,101.622909,1,0
0,0,32,32,22,51,73,147,114,261,0.000333,0.538515,22,35541.97262,1974.554034,1615.54421,387.401188,9,0
0,0,9,9,12,13,25,28,31,59,0.000333,0.091329,12,3287.850182,182.658343,273.987515,91.125266,1,0
0,0,10,10,14,18,32,42,38,80,0.000333,0.133333,14,5600,311.111111,400,128.361619,3,0
0,0,15,15,12,16,28,47,53,100,0.000333,0.160245,18,8653.23886,480.735492,480.735492,107.01955,1,0
0,0,16,16,14,22,36,65,62,127,0.000333,0.21886,14,9192.126653,510.673703,656.580475,151.410465,3,0
0,0,19,19,18,42,60,102,71,173,0.000333,0.340631,9,9197.028657,510.946037,1021.892073,301.535982,7,0
0,0,36,36,21,50,71,175,117,292,0.000333,0.598575,20,35914.52318,1995.251288,1795.726159,374.431475,11,0
0,0,36,36,23,51,74,178,120,298,0.000333,0.616806,22,40709.17627,2261.620904,1850.417103,393.335617,11,0
0,0,19,19,18,42,60,102,71,173,0.000333,0.340631,9,9197.028657,510.946037,1021.892073,301.535982,7,0
0,0,31,31,19,47,66,153,100,253,0.000333,0.509744,18,27526.17082,1529.231712,1529.231712,341.776299,11,0
0,0,33,33,21,48,69,160,103,263,0.000333,0.535514,20,32130.83864,1785.046591,1606.541932,360.316866,12,0
0,0,33,33,20,48,68,159,103,262,0.000333,0.531638,20,31898.30529,1772.128072,1594.915264,354.516762,12,0
0,0,32,32,21,47,68,157,102,259,0.000333,0.525551,20,31533.05752,1751.836529,1576.652876,353.304342,11,0
0,0,30,30,19,47,66,149,96,245,0.000333,0.493626,18,26655.77807,1480.876559,1480.876559,341.776299,11,0
0,0,20,20,16,24,40,76,61,137,0.000333,0.243035,16,11665.66638,648.092577,729.104149,174.0391,3,0
0,0,39,39,23,57,80,179,134,313,0.000333,0.659588,22,43532.79686,2418.488715,1978.763494,436.516656,12,0
0,0,21,21,16,45,61,111,77,188,0.000333,0.37166,8,8919.828956,495.546053,1114.978619,311.133389,9,0
0,0,24,24,18,47,65,121,87,208,0.000333,0.417551,9,11273.87255,626.326253,1252.652505,336.124326,9,0
0,0,24,24,19,47,66,123,88,211,0.000333,0.425122,9,11478.30443,637.68358,1275.367159,341.776299,9,0
0,0,22,22,18,46,64,114,81,195,0.000333,0.39,9,10530,585,1170,329.1425,9,0
0,0,22,22,18,46,64,114,81,195,0.000333,0.39,9,10530,585,1170,329.1425,9,0
0,0,31,31,20,47,67,155,100,255,0.000333,0.515618,20,30937.05487,1718.725271,1546.852744,347.504238,11,0
0,0,24,24,18,47,65,123,87,210,0.000333,0.421566,9,11382.27517,632.34862,1264.697241,336.124326,9,0
0,0,22,22,18,46,64,114,81,195,0.000333,0.39,9,10530,585,1170,329.1425,9,0
0,0,12,12,13,17,30,46,32,78,0.000333,0.127579,6,2296.424799,127.579155,382.737466,117.592585,3,0
0,0,12,12,15,18,33,48,34,82,0.000333,0.13788,7,2895.482225,160.860124,413.640318,133.662009,4,0
0,0,25,25,19,47,66,121,85,206,0.000333,0.415048,9,11206.3067,622.572594,1245.145189,341.776299,10,0
0,0,25,25,20,48,68,126,86,212,0.000333,0.430181,10,12905.42122,716.967846,1290.542122,354.516762,10,0
0,0,23,23,18,47,65,117,82,199,0.000333,0.399484,9,10786.06075,599.225597,1198.451195,336.124326,10,0
0,0,23,23,18,47,65,117,82,199,0.000333,0.399484,9,10786.06075,599.225597,1198.451195,336.124326,10,0
0,0,23,23,18,48,66,117,83,200,0.000333,0.40296,9,10879.90942,604.439412,1208.878824,343.13685,10,0
0,0,25,25,20,47,67,122,85,207,0.000333,0.41856,10,12556.80462,697.600257,1255.680462,347.504238,10,0
0,0,23,23,18,47,65,117,82,199,0.000333,0.399484,9,10786.06075,599.225597,1198.451195,336.124326,10,0
0,0,23,23,18,48,66,117,83,200,0.000333,0.40296,9,10879.90942,604.439412,1208.878824,343.13685,10,0
0,0,23,23,18,47,65,117,83,200,0.000333,0.401491,9,10840.26206,602.236781,1204.473563,336.124326,10,0
0,0,23,23,18,47,65,117,82,199,0.000333,0.399484,9,10786.06075,599.225597,1198.451195,336.124326,10,0
0,0,22,22,18,46,64,114,81,195,0.000333,0.39,9,10530,585,1170,329.1425,9,0
0,0,22,22,19,47,66,115,82,197,0.000333,0.396915,9,10716.71077,595.372821,1190.745642,341.776299,9,0
0,0,16,16,14,18,32,52,48,100,0.000333,0.166667,14,7000,388.888889,500,128.361619,1,0
0,0,18,18,14,19,33,57,56,113,0.000333,0.190006,14,7980.231497,443.346194,570.016535,134.013592,1,0
0,0,9,9,13,14,27,38,28,66,0.000333,0.104608,12,3765.870902,209.21505,313.822575,101.408685,1,0
0,0,32,32,20,47,67,156,102,258,0.000333,0.521684,20,31301.02022,1738.945568,1565.051011,347.504238,11,0
0,0,34,34,19,50,69,165,110,275,0.000333,0.559948,18,30237.19606,1679.844226,1679.844226,362.903432,11,0
0,0,36,36,19,51,70,171,116,287,0.000333,0.586368,18,31663.87607,1759.104226,1759.104226,370.004315,11,0
0,0,30,30,19,47,66,148,96,244,0.000333,0.491611,18,26546.97897,1474.832165,1474.832165,341.776299,11,0
0,0,32,32,19,49,68,159,104,263,0.000333,0.533668,18,28818.04909,1601.002727,1601.002727,355.831405,11,0
0,0,31,31,19,47,66,153,100,253,0.000333,0.509744,18,27526.17082,1529.231712,1529.231712,341.776299,11,0
0,0,30,30,19,47,66,149,96,245,0.000333,0.493626,18,26655.77807,1480.876559,1480.876559,341.776299,11,0
0,0,31,31,19,47,66,153,100,253,0.000333,0.509744,18,27526.17082,1529.231712,1529.231712,341.776299,11,0
0,0,33,33,19,50,69,165,107,272,0.000333,0.55384,18,29907.33574,1661.518652,1661.518652,362.903432,11,0
0,0,13,13,13,16,29,44,36,80,0.000333,0.129546,12,4663.661755,259.09232,388.63848,112.105716,1,0
0,0,24,24,18,47,65,130,89,219,0.000333,0.439633,9,11870.08696,659.449276,1318.898551,336.124326,9,0
0,0,24,24,19,48,67,131,92,223,0.000333,0.450913,9,12174.64101,676.368945,1352.737889,348.788823,9,0
0,0,10,10,12,14,26,37,28,65,0.000333,0.101843,12,3666.34298,203.685721,305.528582,96.322519,1,0
0,0,22,22,18,46,64,114,81,195,0.000333,0.39,9,10530,585,1170,329.1425,9,0
0,0,19,19,18,42,60,101,71,172,0.000333,0.338662,9,9143.866642,507.992591,1015.985182,301.535982,7,0
0,0,19,19,19,43,62,102,72,174,0.000333,0.345343,9,9324.271422,518.015079,1036.030158,314.040007,7,0
0,0,16,16,15,19,34,60,47,107,0.000333,0.181453,14,7621.019336,423.389963,544.358524,139.313982,1,0
0,0,15,15,15,18,33,52,43,95,0.000333,0.159739,14,6709.044179,372.724677,479.217441,133.662009,1,0
0,0,13,13,15,18,33,50,42,92,0.000333,0.154695,14,6497.179626,360.954424,464.084259,133.662009,1,0
0,0,17,17,14,20,34,60,50,110,0.000333,0.18654,14,7834.692776,435.26071,559.620913,139.741531,1,0
0,0,13,13,16,18,34,51,42,93,0.000333,0.157711,16,7570.144708,420.563595,473.134044,139.05865,1,0
0,0,19,19,16,20,36,70,59,129,0.000333,0.222307,16,10670.7252,592.818067,666.920325,150.438562,1,0
0,0,28,28,19,43,62,140,90,230,0.000333,0.456488,18,24650.37273,1369.465151,1369.465151,314.040007,9,0
0,0,28,28,20,44,64,141,93,234,0.000333,0.468,20,28080,1560,1404,326.653553,9,0
0,0,18,18,16,41,57,98,67,165,0.000333,0.320809,8,7699.414819,427.745268,962.426852,283.659632,7,0
0,0,21,21,18,43,61,108,77,185,0.000333,0.365729,9,9874.677667,548.593204,1097.186407,308.388034,7,0
0,0,21,21,18,43,61,110,77,187,0.000333,0.369683,9,9981.430939,554.523941,1109.047882,308.388034,7,0
0,0,22,22,19,44,63,113,79,192,0.000333,0.382546,9,10328.73971,573.818873,1147.637745,320.925614,8,0
0,0,21,21,19,43,62,110,78,188,0.000333,0.37313,9,10074.50016,559.694453,1119.388906,314.040007,7,0
0,0,19,19,18,42,60,101,71,172,0.000333,0.338662,9,9143.866642,507.992591,1015.985182,301.535982,7,0
0,0,19,19,18,42,60,101,71,172,0.000333,0.338662,9,9143.866642,507.992591,1015.985182,301.535982,7,0
0,0,15,15,15,20,35,49,41,90,0.000333,0.153878,14,6462.896601,359.049811,461.635472,145.041921,1,0
0,0,10,10,13,15,28,38,30,68,0.000333,0.108967,12,3922.801616,217.933423,326.900135,106.709075,1,0
0,0,16,16,16,18,34,54,47,101,0.000333,0.171278,16,8221.339951,456.741108,513.833747,139.05865,2,0
0,0,16,16,16,18,34,54,47,101,0.000333,0.171278,16,8221.339951,456.741108,513.833747,139.05865,2,0
0,0,16,16,16,18,34,53,47,100,0.000333,0.169582,16,8139.940546,452.218919,508.746284,139.05865,2,0
0,0,16,16,16,18,34,53,47,100,0.000333,0.169582,16,8139.940546,452.218919,508.746284,139.05865,2,0
0,0,14,14,14,17,31,46,38,84,0.000333,0.138717,14,5826.134861,323.674159,416.15249,122.789837,1,0
0,0,14,14,15,17,32,49,38,87,0.000333,0.145,14,6090,338.333333,435,128.090227,1,0
0,0,13,13,15,17,32,45,33,78,0.000333,0.13,7,2730,151.666667,390,128.090227,2,0
0,0,13,13,15,17,32,45,33,78,0.000333,0.13,7,2730,151.666667,390,128.090227,2,0
0,0,13,13,15,16,31,45,33,78,0.000333,0.128809,14,5409.982371,300.554576,386.427312,122.603359,2,0
0,0,14,14,17,17,34,51,39,90,0.000333,0.152624,16,7325.946491,406.997027,457.871656,138.973737,2,0
0,0,12,12,14,16,30,42,32,74,0.000333,0.121037,14,5083.538657,282.418814,363.109904,117.302969,1,0
0,0,24,24,18,47,65,121,87,208,0.000333,0.417551,9,11273.87255,626.326253,1252.652505,336.124326,9,0
0,0,15,15,16,17,33,49,36,85,0.000333,0.142925,16,6860.376002,381.132,428.7735,133.486868,2,0
0,0,15,15,16,17,33,49,36,85,0.000333,0.142925,16,6860.376002,381.132,428.7735,133.486868,2,0
0,0,32,32,19,49,68,182,114,296,0.000333,0.60063,18,32434.00202,1801.889001,1801.889001,355.831405,11,0
0,0,32,32,20,50,70,183,115,298,0.000333,0.608842,20,36530.52678,2029.47371,1826.526339,368.631371,11,0
0,0,32,32,19,48,67,167,105,272,0.000333,0.549992,18,29699.57268,1649.97626,1649.97626,348.788823,11,0
0,0,32,32,20,49,69,168,106,274,0.000333,0.557912,20,33474.71402,1859.706335,1673.735701,361.559344,11,0
0,0,22,22,18,46,64,123,83,206,0.000333,0.412,9,11124,618,1236,329.1425,9,0
0,0,22,22,19,47,66,124,84,208,0.000333,0.419078,9,11315.10579,628.616988,1257.233977,341.776299,9,0
0,0,24,24,18,47,65,121,87,208,0.000333,0.417551,9,11273.87255,626.326253,1252.652505,336.124326,9,0
0,0,24,24,19,48,67,122,90,212,0.000333,0.42867,9,11574.09818,643.005454,1286.010908,348.788823,9,0
0,0,22,22,18,46,64,114,81,195,0.000333,0.39,9,10530,585,1170,329.1425,9,0
0,0,22,22,18,46,64,114,81,195,0.000333,0.39,9,10530,585,1170,329.1425,9,0
0,0,13,13,15,17,32,45,33,78,0.000333,0.13,7,2730,151.666667,390,128.090227,2,0
0,0,13,13,15,17,32,45,33,78,0.000333,0.13,7,2730,151.666667,390,128.090227,2,0
0,0,13,13,15,17,32,45,33,78,0.000333,0.13,7,2730,151.666667,390,128.090227,2,0
0,0,13,13,15,17,32,45,33,78,0.000333,0.13,7,2730,151.666667,390,128.090227,2,0
0,0,15,15,16,17,33,50,36,86,0.000333,0.144606,16,6941.086308,385.615906,433.817894,133.486868,2,0
0,0,15,15,16,17,33,50,36,86,0.000333,0.144606,16,6941.086308,385.615906,433.817894,133.486868,2,0
0,0,19,19,18,42,60,102,71,173,0.000333,0.340631,9,9197.028657,510.946037,1021.892073,301.535982,7,0
0,0,12,12,14,17,31,48,40,88,0.000333,0.145323,14,6103.569854,339.087214,435.969275,122.789837,1,0
0,0,18,18,14,19,33,67,57,124,0.000333,0.208502,21,13135.60229,729.755683,625.504871,134.013592,1,0
0,0,29,29,19,44,63,146,93,239,0.000333,0.47619,18,25714.25823,1428.569902,1428.569902,320.925614,9,0
0,0,33,33,21,46,67,163,107,270,0.000333,0.545948,20,32756.88163,1819.826757,1637.844081,346.322516,9,0
0,0,29,29,23,46,69,161,98,259,0.000333,0.527369,22,34806.37236,1933.687353,1582.107834,358.125775,11,0
0,0,28,28,20,43,63,150,92,242,0.000333,0.482167,20,28930.03483,1607.224157,1446.501741,319.767946,9,0
0,0,28,28,20,44,64,151,95,246,0.000333,0.492,20,29520,1640,1476,326.653553,9,0
0,0,15,15,15,18,33,52,43,95,0.000333,0.159739,14,6709.044179,372.724677,479.217441,133.662009,1,0
0,0,11,11,14,15,29,40,30,70,0.000333,0.113353,14,4760.821375,264.490076,340.05867,111.906328,1,0
0,0,19,19,18,42,60,101,71,172,0.000333,0.338662,9,9143.866642,507.992591,1015.985182,301.535982,7,0
0,0,10,10,12,14,26,37,28,65,0.000333,0.101843,12,3666.34298,203.685721,305.528582,96.322519,1,0
0,0,19,19,18,42,60,101,71,172,0.000333,0.338662,9,9143.866642,507.992591,1015.985182,301.535982,7,0
0,0,38,38,22,56,78,188,126,314,0.000333,0.657872,22,43419.55853,2412.197696,1973.616297,423.319371,12,0
0,0,36,36,20,55,75,179,118,297,0.000333,0.616653,20,36999.18302,2055.510168,1849.959151,404.413346,12,0
0,0,36,36,20,57,77,174,118,292,0.000333,0.609967,20,36598.0334,2033.224078,1829.90167,418.913293,12,0
0,0,30,30,19,49,68,148,98,246,0.000333,0.499172,18,26955.28546,1497.515859,1497.515859,355.831405,11,0
0,0,9,9,12,14,26,37,28,65,0.000333,0.101843,12,3666.34298,203.685721,305.528582,96.322519,1,0
0,0,25,25,20,47,67,122,85,207,0.000333,0.41856,10,12556.80462,697.600257,1255.680462,347.504238,10,0
0,0,23,23,18,46,64,117,82,199,0.000333,0.398,9,10746,597,1194,329.1425,10,0
0,0,23,23,18,48,66,117,83,200,0.000333,0.40296,9,10879.90942,604.439412,1208.878824,343.13685,10,0
0,0,24,24,18,47,65,123,87,210,0.000333,0.421566,9,11382.27517,632.34862,1264.697241,336.124326,9,0
0,0,10,10,12,18,30,37,32,69,0.000333,0.112858,6,2031.452707,112.858484,338.575451,118.0782,1,0
0,0,13,13,15,18,33,50,42,92,0.000333,0.154695,14,6497.179626,360.954424,464.084259,133.662009,1,0
0,0,12,12,13,17,30,47,40,87,0.000333,0.1423,12,5122.793782,284.599655,426.899482,117.592585,1,0
0,0,11,11,14,15,29,40,30,70,0.000333,0.113353,14,4760.821375,264.490076,340.05867,111.906328,1,0
0,0,21,21,19,43,62,110,77,187,0.000333,0.371145,9,10020.91239,556.717355,1113.43471,314.040007,7,0
0,0,15,15,15,17,32,50,42,92,0.000333,0.153333,14,6440,357.777778,460,128.090227,1,0
0,0,21,21,18,43,61,117,79,196,0.000333,0.387475,9,10461.82066,581.212259,1162.424518,308.388034,7,0
0,0,21,21,19,44,63,118,82,200,0.000333,0.398485,9,10759.10386,597.727992,1195.455985,320.925614,7,0
0,0,16,16,14,18,32,52,48,100,0.000333,0.166667,14,7000,388.888889,500,128.361619,1,0
0,0,10,10,13,15,28,38,30,68,0.000333,0.108967,12,3922.801616,217.933423,326.900135,106.709075,1,0
0,0,14,14,14,17,31,47,40,87,0.000333,0.143672,14,6034.211106,335.23395,431.015079,122.789837,1,0
0,0,11,11,14,15,29,40,30,70,0.000333,0.113353,14,4760.821375,264.490076,340.05867,111.906328,1,0
0,0,22,22,18,46,64,114,81,195,0.000333,0.39,9,10530,585,1170,329.1425,9,0
0,0,13,13,16,18,34,46,34,80,0.000333,0.135666,8,3255.976218,180.887568,406.997027,139.05865,2,0
0,0,13,13,15,18,33,45,34,79,0.000333,0.132836,7,2789.549948,154.974997,398.507135,133.662009,2,0
0,0,13,13,16,18,34,46,34,80,0.000333,0.135666,8,3255.976218,180.887568,406.997027,139.05865,2,0
0,0,13,13,15,18,33,45,34,79,0.000333,0.132836,7,2789.549948,154.974997,398.507135,133.662009,2,0
0,0,21,21,16,45,61,111,77,188,0.000333,0.37166,8,8919.828956,495.546053,1114.978619,311.133389,9,0
0,0,24,24,18,47,65,121,87,208,0.000333,0.417551,9,11273.87255,626.326253,1252.652505,336.124326,9,0
0,0,13,13,15,17,32,45,33,78,0.000333,0.13,7,2730,151.666667,390,128.090227,2,0
0,0,13,13,15,17,32,45,33,78,0.000333,0.13,7,2730,151.666667,390,128.090227,2,0
0,0,13,13,15,17,32,45,33,78,0.000333,0.13,7,2730,151.666667,390,128.090227,2,0
0,0,13,13,15,17,32,45,33,78,0.000333,0.13,7,2730,151.666667,390,128.090227,2,0
0,0,15,15,16,17,33,49,36,85,0.000333,0.142925,16,6860.376002,381.132,428.7735,133.486868,2,0
0,0,15,15,16,17,33,49,36,85,0.000333,0.142925,16,6860.376002,381.132,428.7735,133.486868,2,0
0,0,16,16,16,19,35,56,39,95,0.000333,0.162427,16,7796.510186,433.139455,487.281887,144.710623,2,0
0,0,17,17,15,20,35,54,49,103,0.000333,0.176105,14,7396.42611,410.912562,528.316151,145.041921,1,0
0,0,19,19,18,42,60,101,71,172,0.000333,0.338662,9,9143.866642,507.992591,1015.985182,301.535982,7,0
0,0,9,9,12,14,26,37,28,65,0.000333,0.101843,12,3666.34298,203.685721,305.528582,96.322519,1,0
0,0,15,15,15,18,33,52,43,95,0.000333,0.159739,14,6709.044179,372.724677,479.217441,133.662009,1,0
0,0,12,12,14,17,31,48,40,88,0.000333,0.145323,14,6103.569854,339.087214,435.969275,122.789837,1,0
0,0,21,21,18,43,61,109,78,187,0.000333,0.369683,9,9981.430939,554.523941,1109.047882,308.388034,7,0
0,0,18,18,16,41,57,98,67,165,0.000333,0.320809,8,7699.414819,427.745268,962.426852,283.659632,7,0
0,0,18,18,14,19,33,57,56,113,0.000333,0.190006,14,7980.231497,443.346194,570.016535,134.013592,1,0
0,0,19,19,18,42,60,101,71,172,0.000333,0.338662,9,9143.866642,507.992591,1015.985182,301.535982,7,0
0,0,21,21,21,43,64,110,78,188,0.000333,0.376,10,11280,626.666667,1128,325.56805,8,0
0,0,20,20,18,42,60,104,72,176,0.000333,0.346538,9,9356.514703,519.806372,1039.612745,301.535982,8,0
0,0,20,20,19,43,62,104,72,176,0.000333,0.349313,9,9431.446956,523.969275,1047.938551,314.040007,8,0
0,0,20,20,18,44,62,104,73,177,0.000333,0.351298,9,9485.034722,526.946373,1053.892747,315.273641,8,0
0,0,23,23,18,48,66,117,83,200,0.000333,0.40296,9,10879.90942,604.439412,1208.878824,343.13685,10,0
0,0,20,20,18,44,62,104,73,177,0.000333,0.351298,9,9485.034722,526.946373,1053.892747,315.273641,8,0
0,0,23,23,18,47,65,117,82,199,0.000333,0.399484,9,10786.06075,599.225597,1198.451195,336.124326,10,0
0,0,22,22,18,44,62,112,79,191,0.000333,0.379084,9,10235.26346,568.625748,1137.251495,315.273641,8,0
0,0,22,22,20,44,64,113,76,189,0.000333,0.378,10,11340,630,1134,326.653553,8,0
0,0,22,22,18,46,64,114,81,195,0.000333,0.39,9,10530,585,1170,329.1425,9,0
0,0,23,23,18,47,65,117,82,199,0.000333,0.399484,9,10786.06075,599.225597,1198.451195,336.124326,10,0
0,0,22,22,19,43,62,108,75,183,0.000333,0.363206,9,9806.561323,544.808962,1089.617925,314.040007,8,0
0,0,15,15,15,18,33,52,43,95,0.000333,0.159739,14,6709.044179,372.724677,479.217441,133.662009,1,0
0,0,12,12,13,17,30,47,40,87,0.000333,0.1423,12,5122.793782,284.599655,426.899482,117.592585,1,0
0,0,15,15,12,17,29,52,52,104,0.000333,0.16841,18,9094.140423,505.230023,505.230023,112.506418,1,0
0,0,25,25,18,48,66,125,89,214,0.000333,0.431167,9,11641.50307,646.750171,1293.500342,343.13685,10,0
0,0,19,19,18,42,60,101,71,172,0.000333,0.338662,9,9143.866642,507.992591,1015.985182,301.535982,7,0
0,0,15,15,15,17,32,50,42,92,0.000333,0.153333,14,6440,357.777778,460,128.090227,1,0
0,0,20,20,18,43,61,104,72,176,0.000333,0.347937,9,9394.287943,521.904886,1043.809771,308.388034,8,0
0,0,20,20,18,44,62,104,73,177,0.000333,0.351298,9,9485.034722,526.946373,1053.892747,315.273641,8,0
0,0,20,20,18,43,61,104,73,177,0.000333,0.349914,9,9447.664579,524.870254,1049.740509,308.388034,8,0
0,0,20,20,18,43,61,104,72,176,0.000333,0.347937,9,9394.287943,521.904886,1043.809771,308.388034,8,0
0,0,22,22,19,44,63,113,79,192,0.000333,0.382546,9,10328.73971,573.818873,1147.637745,320.925614,8,0
0,0,24,24,19,47,66,123,88,211,0.000333,0.425122,9,11478.30443,637.68358,1275.367159,341.776299,9,0
0,0,23,23,18,47,65,117,83,200,0.000333,0.401491,9,10840.26206,602.236781,1204.473563,336.124326,10,0
0,0,25,25,19,48,67,126,89,215,0.000333,0.434736,9,11737.88258,652.104588,1304.209176,348.788823,10,0
0,0,16,16,15,19,34,60,47,107,0.000333,0.181453,14,7621.019336,423.389963,544.358524,139.313982,1,0
0,0,12,12,14,16,30,42,32,74,0.000333,0.121037,14,5083.538657,282.418814,363.109904,117.302969,1,0
0,0,13,13,15,16,31,45,33,78,0.000333,0.128809,14,5409.982371,300.554576,386.427312,122.603359,2,0
0,0,13,13,15,16,31,45,33,78,0.000333,0.128809,14,5409.982371,300.554576,386.427312,122.603359,2,0
0,0,13,13,16,18,34,51,42,93,0.000333,0.157711,16,7570.144708,420.563595,473.134044,139.05865,1,0
0,0,19,19,16,20,36,70,59,129,0.000333,0.222307,16,10670.7252,592.818067,666.920325,150.438562,1,0
0,0,13,13,15,18,33,50,42,92,0.000333,0.154695,14,6497.179626,360.954424,464.084259,133.662009,1,0
0,0,13,13,15,16,31,45,33,78,0.000333,0.128809,14,5409.982371,300.554576,386.427312,122.603359,2,0
0,0,12,12,14,17,31,48,40,88,0.000333,0.145323,14,6103.569854,339.087214,435.969275,122.789837,1,0
0,0,30,30,19,47,66,148,96,244,0.000333,0.491611,18,26546.97897,1474.832165,1474.832165,341.776299,11,0
0,0,14,14,14,17,31,46,38,84,0.000333,0.138717,14,5826.134861,323.674159,416.15249,122.789837,1,0
0,0,14,14,15,17,32,49,38,87,0.000333,0.145,14,6090,338.333333,435,128.090227,1,0
0,0,13,13,16,18,34,46,34,80,0.000333,0.135666,8,3255.976218,180.887568,406.997027,139.05865,2,0
0,0,13,13,15,18,33,45,34,79,0.000333,0.132836,7,2789.549948,154.974997,398.507135,133.662009,2,0
0,0,13,13,16,18,34,46,34,80,0.000333,0.135666,8,3255.976218,180.887568,406.997027,139.05865,2,0
0,0,13,13,15,18,33,45,34,79,0.000333,0.132836,7,2789.549948,154.974997,398.507135,133.662009,2,0
0,0,13,13,15,17,32,45,33,78,0.000333,0.13,7,2730,151.666667,390,128.090227,2,0
0,0,13,13,15,17,32,45,33,78,0.000333,0.13,7,2730,151.666667,390,128.090227,2,0
0,0,13,13,15,16,31,45,33,78,0.000333,0.128809,14,5409.982371,300.554576,386.427312,122.603359,2,0
0,0,14,14,17,17,34,51,39,90,0.000333,0.152624,16,7325.946491,406.997027,457.871656,138.973737,2,0
0,0,12,12,14,16,30,42,32,74,0.000333,0.121037,14,5083.538657,282.418814,363.109904,117.302969,1,0
0,0,16,16,16,18,34,54,47,101,0.000333,0.171278,16,8221.339951,456.741108,513.833747,139.05865,2,0
0,0,16,16,16,18,34,54,47,101,0.000333,0.171278,16,8221.339951,456.741108,513.833747,139.05865,2,0
0,0,16,16,16,18,34,53,47,100,0.000333,0.169582,16,8139.940546,452.218919,508.746284,139.05865,2,0
0,0,16,16,16,18,34,53,47,100,0.000333,0.169582,16,8139.940546,452.218919,508.746284,139.05865,2,0
0,0,18,18,14,19,33,67,57,124,0.000333,0.208502,21,13135.60229,729.755683,625.504871,134.013592,1,0
0,0,38,38,22,57,79,192,129,321,0.000333,0.674505,22,44517.29964,2473.183314,2023.51362,430.582226,12,0
0,0,32,32,19,49,68,173,112,285,0.000333,0.578309,18,31228.68438,1734.92691,1734.92691,355.831405,11,0
0,0,32,32,20,50,70,174,113,287,0.000333,0.586368,20,35182.08452,1954.560251,1759.104226,368.631371,11,0
0,0,38,38,23,51,74,196,123,319,0.000333,0.660272,22,43577.94372,2420.996873,1980.815624,393.335617,13,0
0,0,38,38,24,53,77,200,131,331,0.000333,0.691435,24,49783.35228,2765.741793,2074.306345,413.618884,13,0
0,0,23,23,19,47,66,117,82,199,0.000333,0.400945,9,10825.50987,601.417215,1202.83443,341.776299,10,0
0,0,20,20,19,43,62,104,72,176,0.000333,0.349313,9,9431.446956,523.969275,1047.938551,314.040007,8,0
0,0,29,29,19,45,64,160,102,262,0.000333,0.524,18,28296,1572,1572,327.844012,9,0
0,0,29,29,20,46,66,161,103,264,0.000333,0.531907,20,31914.40095,1773.022275,1595.720048,340.522412,9,0
0,0,20,20,18,44,62,104,73,177,0.000333,0.351298,9,9485.034722,526.946373,1053.892747,315.273641,8,0
0,0,20,20,18,44,62,104,73,177,0.000333,0.351298,9,9485.034722,526.946373,1053.892747,315.273641,8,0
0,0,21,21,21,43,64,110,78,188,0.000333,0.376,10,11280,626.666667,1128,325.56805,8,0
0,0,19,19,18,42,60,101,71,172,0.000333,0.338662,9,9143.866642,507.992591,1015.985182,301.535982,7,0
0,0,21,21,18,43,61,109,77,186,0.000333,0.367706,9,9928.054303,551.558572,1103.117145,308.388034,7,0
0,0,15,15,16,20,36,57,42,99,0.000333,0.170608,16,8189.161202,454.9534,511.822575,150.438562,4,0
0,0,21,21,18,43,61,110,77,187,0.000333,0.369683,9,9981.430939,554.523941,1109.047882,308.388034,7,0
0,0,20,20,18,42,60,104,72,176,0.000333,0.346538,9,9356.514703,519.806372,1039.612745,301.535982,8,0
0,0,24,24,18,47,65,122,87,209,0.000333,0.419558,9,11328.07386,629.337436,1258.674873,336.124326,9,0
0,0,12,12,13,17,30,47,40,87,0.000333,0.1423,12,5122.793782,284.599655,426.899482,117.592585,1,0
0,0,20,20,19,43,62,104,72,176,0.000333,0.349313,9,9431.446956,523.969275,1047.938551,314.040007,8,0
0,0,20,20,18,42,60,104,72,176,0.000333,0.346538,9,9356.514703,519.806372,1039.612745,301.535982,8,0
0,0,22,22,19,44,63,113,79,192,0.000333,0.382546,9,10328.73971,573.818873,1147.637745,320.925614,8,0
0,0,23,23,18,46,64,117,82,199,0.000333,0.398,9,10746,597,1194,329.1425,10,0
0,0,23,23,18,47,65,117,82,199,0.000333,0.399484,9,10786.06075,599.225597,1198.451195,336.124326,10,0
0,0,23,23,18,47,65,117,83,200,0.000333,0.401491,9,10840.26206,602.236781,1204.473563,336.124326,10,0
0,0,20,20,16,24,40,76,61,137,0.000333,0.243035,16,11665.66638,648.092577,729.104149,174.0391,3,0
0,0,22,22,17,29,46,94,74,168,0.000333,0.309319,16,14847.33454,824.851919,927.958409,210.368317,5,0
0,0,14,14,16,20,36,57,44,101,0.000333,0.174054,16,8354.598802,464.144378,522.162425,150.438562,3,0
0,0,14,14,17,21,38,59,46,105,0.000333,0.183677,16,8816.518223,489.806568,551.032389,161.725534,4,0
0,0,14,14,15,20,35,58,44,102,0.000333,0.174396,14,7324.616148,406.923119,523.186868,145.041921,3,0
0,0,14,14,16,21,37,60,46,106,0.000333,0.184067,16,8835.232908,490.846273,552.202057,156.238666,4,0
0,0,22,22,18,46,64,114,81,195,0.000333,0.39,9,10530,585,1170,329.1425,9,0
0,0,24,24,18,47,65,122,88,210,0.000333,0.421566,9,11382.27517,632.34862,1264.697241,336.124326,9,0
0,0,21,21,16,45,61,111,77,188,0.000333,0.37166,8,8919.828956,495.546053,1114.978619,311.133389,9,0
0,0,24,24,18,47,65,121,87,208,0.000333,0.417551,9,11273.87255,626.326253,1252.652505,336.124326,9,0
0,0,22,22,18,46,64,114,81,195,0.000333,0.39,9,10530,585,1170,329.1425,9,0
0,0,21,21,18,43,61,109,78,187,0.000333,0.369683,9,9981.430939,554.523941,1109.047882,308.388034,7,0
0,0,19,19,18,42,60,101,71,172,0.000333,0.338662,9,9143.866642,507.992591,1015.985182,301.535982,7,0
0,0,10,10,12,14,26,37,28,65,0.000333,0.101843,12,3666.34298,203.685721,305.528582,96.322519,1,0
0,0,12,12,13,17,30,47,40,87,0.000333,0.1423,12,5122.793782,284.599655,426.899482,117.592585,1,0
0,0,18,18,14,19,33,67,57,124,0.000333,0.208502,21,13135.60229,729.755683,625.504871,134.013592,1,0
0,0,12,12,14,17,31,48,40,88,0.000333,0.145323,14,6103.569854,339.087214,435.969275,122.789837,1,0
0,0,21,21,18,43,61,108,77,185,0.000333,0.365729,9,9874.677667,548.593204,1097.186407,308.388034,7,0
0,0,18,18,16,41,57,98,67,165,0.000333,0.320809,8,7699.414819,427.745268,962.426852,283.659632,7,0
0,0,13,13,16,17,33,46,34,80,0.000333,0.134517,16,6456.824473,358.712471,403.55153,133.486868,2,0
0,0,13,13,15,17,32,45,34,79,0.000333,0.131667,14,5530,307.222222,395,128.090227,2,0
0,0,20,20,18,44,62,104,73,177,0.000333,0.351298,9,9485.034722,526.946373,1053.892747,315.273641,8,0
0,0,22,22,19,43,62,108,75,183,0.000333,0.363206,9,9806.561323,544.808962,1089.617925,314.040007,8,0
0,0,22,22,20,44,64,113,76,189,0.000333,0.378,10,11340,630,1134,326.653553,8,0
0,0,20,20,18,43,61,104,72,176,0.000333,0.347937,9,9394.287943,521.904886,1043.809771,308.388034,8,0
0,0,20,20,18,43,61,104,72,176,0.000333,0.347937,9,9394.287943,521.904886,1043.809771,308.388034,8,0
0,0,20,20,18,44,62,104,73,177,0.000333,0.351298,9,9485.034722,526.946373,1053.892747,315.273641,8,0
0,0,22,22,20,43,63,109,75,184,0.000333,0.366607,10,10998.19506,611.010837,1099.819506,319.767946,8,0
0,0,30,30,19,49,68,148,98,246,0.000333,0.499172,18,26955.28546,1497.515859,1497.515859,355.831405,11,0
0,0,36,36,21,51,72,179,119,298,0.000333,0.612879,20,36772.75301,2042.930723,1838.63765,381.532358,11,0
0,0,34,34,19,52,71,165,111,276,0.000333,0.565777,18,30551.94369,1697.330205,1697.330205,377.133488,11,0
0,0,13,13,16,18,34,46,34,80,0.000333,0.135666,8,3255.976218,180.887568,406.997027,139.05865,2,0
0,0,13,13,15,18,33,45,34,79,0.000333,0.132836,7,2789.549948,154.974997,398.507135,133.662009,2,0
0,0,22,22,18,46,64,114,81,195,0.000333,0.39,9,10530,585,1170,329.1425,9,0
0,0,22,22,18,46,64,114,81,195,0.000333,0.39,9,10530,585,1170,329.1425,9,0
0,0,31,31,19,47,66,162,102,264,0.000333,0.531907,18,28722.96086,1595.720048,1595.720048,341.776299,11,0
0,0,31,31,20,48,68,163,105,268,0.000333,0.543813,20,32628.80083,1812.711157,1631.440041,354.516762,11,0
0,0,30,30,20,48,68,155,98,253,0.000333,0.513376,20,30802.56198,1711.253443,1540.128099,354.516762,12,0
0,0,30,30,21,49,70,156,99,255,0.000333,0.520989,20,31259.34339,1736.630188,1562.967169,367.359448,12,0
0,0,28,28,19,43,62,141,90,231,0.000333,0.458473,18,24757.54826,1375.419348,1375.419348,314.040007,9,0
0,0,12,12,14,16,30,42,32,74,0.000333,0.121037,14,5083.538657,282.418814,363.109904,117.302969,1,0
0,0,13,13,15,16,31,45,33,78,0.000333,0.128809,14,5409.982371,300.554576,386.427312,122.603359,2,0
0,0,13,13,15,16,31,45,33,78,0.000333,0.128809,14,5409.982371,300.554576,386.427312,122.603359,2,0
0,0,13,13,16,18,34,46,34,80,0.000333,0.135666,8,3255.976218,180.887568,406.997027,139.05865,2,0
0,0,13,13,15,18,33,45,34,79,0.000333,0.132836,7,2789.549948,154.974997,398.507135,133.662009,2,0
0,0,15,15,16,17,33,50,36,86,0.000333,0.144606,16,6941.086308,385.615906,433.817894,133.486868,2,0
0,0,15,15,16,17,33,50,36,86,0.000333,0.144606,16,6941.086308,385.615906,433.817894,133.486868,2,0
0,0,13,13,15,17,32,45,33,78,0.000333,0.13,7,2730,151.666667,390,128.090227,2,0
0,0,13,13,15,17,32,45,33,78,0.000333,0.13,7,2730,151.666667,390,128.090227,2,0
0,0,13,13,15,17,32,45,33,78,0.000333,0.13,7,2730,151.666667,390,128.090227,2,0
0,0,13,13,15,17,32,45,33,78,0.000333,0.13,7,2730,151.666667,390,128.090227,2,0
0,0,13,13,15,17,32,45,33,78,0.000333,0.13,7,2730,151.666667,390,128.090227,2,0
0,0,13,13,15,17,32,45,33,78,0.000333,0.13,7,2730,151.666667,390,128.090227,2,0
0,0,15,15,14,19,33,53,40,93,0.000333,0.156376,14,6567.801143,364.877841,469.128653,134.013592,3,0
0,0,17,17,18,24,42,71,53,124,0.000333,0.222882,18,12035.65249,668.64736,668.64736,185.09775,5,0
0,0,12,12,13,17,30,46,32,78,0.000333,0.127579,6,2296.424799,127.579155,382.737466,117.592585,3,0
0,0,12,12,15,18,33,48,34,82,0.000333,0.13788,7,2895.482225,160.860124,413.640318,133.662009,4,0
0,0,31,31,19,47,66,154,100,254,0.000333,0.511759,18,27634.96991,1535.276106,1535.276106,341.776299,11,0
0,0,32,32,19,49,68,174,112,286,0.000333,0.580338,18,31338.25871,1741.014373,1741.014373,355.831405,11,0
0,0,21,21,19,43,62,118,79,197,0.000333,0.390992,9,10556.79006,586.488337,1172.976673,314.040007,7,0
0,0,21,21,19,44,63,119,82,201,0.000333,0.400478,9,10812.89938,600.716632,1201.433265,320.925614,7,0
0,0,13,13,15,17,32,45,33,78,0.000333,0.13,7,2730,151.666667,390,128.090227,2,0
0,0,13,13,15,17,32,45,33,78,0.000333,0.13,7,2730,151.666667,390,128.090227,2,0
0,0,12,12,13,17,30,46,32,78,0.000333,0.127579,6,2296.424799,127.579155,382.737466,117.592585,3,0
0,0,12,12,15,18,33,48,34,82,0.000333,0.13788,7,2895.482225,160.860124,413.640318,133.662009,4,0
0,0,10,10,13,15,28,38,30,68,0.000333,0.108967,12,3922.801616,217.933423,326.900135,106.709075,1,0
0,0,14,14,14,17,31,47,40,87,0.000333,0.143672,14,6034.211106,335.23395,431.015079,122.789837,1,0
0,0,14,14,14,17,31,47,40,87,0.000333,0.143672,14,6034.211106,335.23395,431.015079,122.789837,1,0
0,0,11,11,14,15,29,40,30,70,0.000333,0.113353,14,4760.821375,264.490076,340.05867,111.906328,1,0
0,0,9,9,13,14,27,38,28,66,0.000333,0.104608,12,3765.870902,209.21505,313.822575,101.408685,1,0
0,0,14,14,14,17,31,46,38,84,0.000333,0.138717,14,5826.134861,323.674159,416.15249,122.789837,1,0
0,0,14,14,15,17,32,49,38,87,0.000333,0.145,14,6090,338.333333,435,128.090227,1,0
0,0,14,14,15,17,32,47,38,85,0.000333,0.141667,14,5950,330.555556,425,128.090227,1,0
0,0,15,15,15,20,35,49,41,90,0.000333,0.153878,14,6462.896601,359.049811,461.635472,145.041921,1,0
0,0,18,18,16,41,57,98,67,165,0.000333,0.320809,8,7699.414819,427.745268,962.426852,283.659632,7,0
0,0,15,15,14,19,33,53,40,93,0.000333,0.156376,14,6567.801143,364.877841,469.128653,134.013592,3,0
0,0,34,34,23,55,78,156,113,269,0.000333,0.563591,22,37197.01033,2066.500574,1690.773197,422.016709,12,0
0,0,24,24,18,47,65,123,87,210,0.000333,0.421566,9,11382.27517,632.34862,1264.697241,336.124326,9,0
0,0,22,22,18,46,64,114,81,195,0.000333,0.39,9,10530,585,1170,329.1425,9,0
0,0,24,24,21,47,68,123,88,211,0.000333,0.428152,10,12844.5466,713.585922,1284.45466,353.304342,10,0
0,0,25,25,18,48,66,125,89,214,0.000333,0.431167,9,11641.50307,646.750171,1293.500342,343.13685,10,0
0,0,23,23,18,48,66,117,83,200,0.000333,0.40296,9,10879.90942,604.439412,1208.878824,343.13685,10,0
0,0,23,23,18,48,66,117,83,200,0.000333,0.40296,9,10879.90942,604.439412,1208.878824,343.13685,10,0
0,0,23,23,19,47,66,117,82,199,0.000333,0.400945,9,10825.50987,601.417215,1202.83443,341.776299,10,0
0,0,10,10,12,18,30,37,32,69,0.000333,0.112858,6,2031.452707,112.858484,338.575451,118.0782,1,0
0,0,25,25,19,47,66,121,85,206,0.000333,0.415048,9,11206.3067,622.572594,1245.145189,341.776299,10,0
0,0,25,25,20,48,68,126,86,212,0.000333,0.430181,10,12905.42122,716.967846,1290.542122,354.516762,10,0
0,0,23,23,18,48,66,117,83,200,0.000333,0.40296,9,10879.90942,604.439412,1208.878824,343.13685,10,0
0,0,23,23,18,48,66,117,83,200,0.000333,0.40296,9,10879.90942,604.439412,1208.878824,343.13685,10,0
0,0,23,23,19,47,66,117,82,199,0.000333,0.400945,9,10825.50987,601.417215,1202.83443,341.776299,10,0
0,0,23,23,18,46,64,117,82,199,0.000333,0.398,9,10746,597,1194,329.1425,10,0
0,0,24,24,21,47,68,123,88,211,0.000333,0.428152,10,12844.5466,713.585922,1284.45466,353.304342,10,0
0,0,25,25,19,48,67,126,89,215,0.000333,0.434736,9,11737.88258,652.104588,1304.209176,348.788823,10,0
0,0,11,11,14,15,29,40,30,70,0.000333,0.113353,14,4760.821375,264.490076,340.05867,111.906328,1,0
0,0,25,25,19,48,67,126,89,215,0.000333,0.434736,9,11737.88258,652.104588,1304.209176,348.788823,10,0
0,0,30,30,19,47,66,149,96,245,0.000333,0.493626,18,26655.77807,1480.876559,1480.876559,341.776299,11,0
0,0,36,36,22,51,73,181,119,300,0.000333,0.618982,22,40852.84209,2269.602338,1856.947368,387.401188,12,0
0,0,36,36,23,52,75,182,122,304,0.000333,0.631187,22,41658.3394,2314.352189,1893.560882,400.46479,12,0
0,0,32,32,19,48,67,158,103,261,0.000333,0.52775,18,28498.48702,1583.249279,1583.249279,348.788823,11,0
0,0,32,32,20,49,69,159,104,263,0.000333,0.535514,20,32130.83864,1785.046591,1606.541932,361.559344,11,0
0,0,24,24,19,47,66,131,89,220,0.000333,0.443256,9,11967.90036,664.883353,1329.766706,341.776299,9,0
0,0,24,24,19,48,67,132,92,224,0.000333,0.452935,9,12229.23581,679.401989,1358.803979,348.788823,9,0
0,0,14,14,15,17,32,49,38,87,0.000333,0.145,14,6090,338.333333,435,128.090227,1,0
0,0,14,14,14,17,31,46,38,84,0.000333,0.138717,14,5826.134861,323.674159,416.15249,122.789837,1,0
0,0,15,15,15,20,35,49,41,90,0.000333,0.153878,14,6462.896601,359.049811,461.635472,145.041921,1,0
0,0,14,14,15,17,32,47,38,85,0.000333,0.141667,14,5950,330.555556,425,128.090227,1,0
0,0,12,12,13,17,30,47,40,87,0.000333,0.1423,12,5122.793782,284.599655,426.899482,117.592585,1,0
0,0,13,13,13,16,29,44,36,80,0.000333,0.129546,12,4663.661755,259.09232,388.63848,112.105716,1,0
0,0,33,33,20,48,68,159,103,262,0.000333,0.531638,20,31898.30529,1772.128072,1594.915264,354.516762,12,0
0,0,33,33,21,48,69,160,103,263,0.000333,0.535514,20,32130.83864,1785.046591,1606.541932,360.316866,12,0
0,0,32,32,21,47,68,157,102,259,0.000333,0.525551,20,31533.05752,1751.836529,1576.652876,353.304342,11,0
0,0,23,23,18,46,64,117,82,199,0.000333,0.398,9,10746,597,1194,329.1425,10,0
0,0,34,34,20,54,74,168,111,279,0.000333,0.577479,20,34648.74978,1924.930543,1732.437489,397.202487,12,0
0,0,30,30,19,47,66,148,96,244,0.000333,0.491611,18,26546.97897,1474.832165,1474.832165,341.776299,11,0
0,0,38,38,20,56,76,180,123,303,0.000333,0.631041,20,37862.44073,2103.46893,1893.122037,411.650438,12,0
0,0,36,36,20,55,75,174,117,291,0.000333,0.604195,20,36251.72478,2013.98471,1812.586239,404.413346,12,0
0,0,32,32,20,47,67,156,102,258,0.000333,0.521684,20,31301.02022,1738.945568,1565.051011,347.504238,11,0
0,0,40,40,20,57,77,186,129,315,0.000333,0.658013,20,39480.75521,2193.375289,1974.03776,418.913293,12,0
0,0,35,35,20,55,75,174,114,288,0.000333,0.597967,20,35877.99566,1993.221981,1793.899783,404.413346,12,0
0,0,31,31,19,47,66,153,100,253,0.000333,0.509744,18,27526.17082,1529.231712,1529.231712,341.776299,11,0
0,0,21,21,18,43,61,108,77,185,0.000333,0.365729,9,9874.677667,548.593204,1097.186407,308.388034,7,0
0,0,21,21,19,44,63,109,80,189,0.000333,0.376569,9,10167.35315,564.852953,1129.705906,320.925614,7,0
0,0,14,14,16,20,36,57,44,101,0.000333,0.174054,16,8354.598802,464.144378,522.162425,150.438562,3,0
0,0,14,14,17,21,38,59,46,105,0.000333,0.183677,16,8816.518223,489.806568,551.032389,161.725534,4,0
0,0,14,14,15,20,35,58,44,102,0.000333,0.174396,14,7324.616148,406.923119,523.186868,145.041921,3,0
0,0,14,14,16,21,37,60,46,106,0.000333,0.184067,16,8835.232908,490.846273,552.202057,156.238666,4,0
0,0,13,13,15,17,32,45,33,78,0.000333,0.13,7,2730,151.666667,390,128.090227,2,0
0,0,13,13,15,17,32,45,33,78,0.000333,0.13,7,2730,151.666667,390,128.090227,2,0
0,0,13,13,15,16,31,45,33,78,0.000333,0.128809,14,5409.982371,300.554576,386.427312,122.603359,2,0
0,0,13,13,15,16,31,45,33,78,0.000333,0.128809,14,5409.982371,300.554576,386.427312,122.603359,2,0
0,0,12,12,14,16,30,42,32,74,0.000333,0.121037,14,5083.538657,282.418814,363.109904,117.302969,1,0
0,0,13,13,15,17,32,45,33,78,0.000333,0.13,7,2730,151.666667,390,128.090227,2,0
0,0,13,13,15,17,32,45,33,78,0.000333,0.13,7,2730,151.666667,390,128.090227,2,0
0,0,20,20,18,43,61,104,72,176,0.000333,0.347937,9,9394.287943,521.904886,1043.809771,308.388034,8,0
0,0,20,20,18,43,61,104,72,176,0.000333,0.347937,9,9394.287943,521.904886,1043.809771,308.388034,8,0
0,0,20,20,18,44,62,104,73,177,0.000333,0.351298,9,9485.034722,526.946373,1053.892747,315.273641,8,0
0,0,22,22,20,43,63,109,75,184,0.000333,0.366607,10,10998.19506,611.010837,1099.819506,319.767946,8,0
0,0,20,20,18,43,61,104,72,176,0.000333,0.347937,9,9394.287943,521.904886,1043.809771,308.388034,8,0
0,0,20,20,18,43,61,104,73,177,0.000333,0.349914,9,9447.664579,524.870254,1049.740509,308.388034,8,0
0,0,20,20,18,43,61,104,72,176,0.000333,0.347937,9,9394.287943,521.904886,1043.809771,308.388034,8,0
0,0,20,20,18,42,60,104,72,176,0.000333,0.346538,9,9356.514703,519.806372,1039.612745,301.535982,8,0
0,0,12,12,14,16,30,42,32,74,0.000333,0.121037,14,5083.538657,282.418814,363.109904,117.302969,1,0
0,0,22,22,18,46,64,114,81,195,0.000333,0.39,9,10530,585,1170,329.1425,9,0
0,0,22,22,19,47,66,115,82,197,0.000333,0.396915,9,10716.71077,595.372821,1190.745642,341.776299,9,0
0,0,13,13,15,16,31,45,33,78,0.000333,0.128809,14,5409.982371,300.554576,386.427312,122.603359,2,0
0,0,13,13,15,17,32,45,33,78,0.000333,0.13,7,2730,151.666667,390,128.090227,2,0
0,0,13,13,15,17,32,45,33,78,0.000333,0.13,7,2730,151.666667,390,128.090227,2,0
0,0,13,13,16,18,34,46,34,80,0.000333,0.135666,8,3255.976218,180.887568,406.997027,139.05865,2,0
0,0,13,13,15,18,33,45,34,79,0.000333,0.132836,7,2789.549948,154.974997,398.507135,133.662009,2,0
0,0,13,13,16,18,34,46,34,80,0.000333,0.135666,8,3255.976218,180.887568,406.997027,139.05865,2,0
0,0,13,13,15,18,33,45,34,79,0.000333,0.132836,7,2789.549948,154.974997,398.507135,133.662009,2,0
0,0,16,16,16,19,35,56,39,95,0.000333,0.162427,16,7796.510186,433.139455,487.281887,144.710623,2,0
0,0,32,32,19,48,67,158,103,261,0.000333,0.52775,18,28498.48702,1583.249279,1583.249279,348.788823,11,0
0,0,15,15,15,17,32,51,42,93,0.000333,0.155,14,6510,361.666667,465,128.090227,1,0
0,0,23,23,18,48,66,117,83,200,0.000333,0.40296,9,10879.90942,604.439412,1208.878824,343.13685,10,0
0,0,9,9,13,14,27,38,28,66,0.000333,0.104608,12,3765.870902,209.21505,313.822575,101.408685,1,0
0,0,11,11,14,15,29,40,30,70,0.000333,0.113353,14,4760.821375,264.490076,340.05867,111.906328,1,0
0,0,14,14,14,17,31,47,40,87,0.000333,0.143672,14,6034.211106,335.23395,431.015079,122.789837,1,0
0,0,10,10,13,15,28,38,30,68,0.000333,0.108967,12,3922.801616,217.933423,326.900135,106.709075,1,0
0,0,18,18,14,19,33,57,56,113,0.000333,0.190006,14,7980.231497,443.346194,570.016535,134.013592,1,0
0,0,30,30,19,49,68,148,98,246,0.000333,0.499172,18,26955.28546,1497.515859,1497.515859,355.831405,12,0
0,0,15,15,12,17,29,52,52,104,0.000333,0.16841,18,9094.140423,505.230023,505.230023,112.506418,1,0
0,0,21,21,18,43,61,109,78,187,0.000333,0.369683,9,9981.430939,554.523941,1109.047882,308.388034,7,0
0,0,21,21,18,43,61,108,77,185,0.000333,0.365729,9,9874.677667,548.593204,1097.186407,308.388034,7,0
0,0,18,18,16,41,57,98,67,165,0.000333,0.320809,8,7699.414819,427.745268,962.426852,283.659632,7,0
0,0,33,33,22,47,69,168,109,277,0.000333,0.56402,22,37225.34804,2068.074891,1692.061275,359.173172,10,0
0,0,33,33,23,48,71,169,112,281,0.000333,0.576026,22,38017.73669,2112.096483,1728.078941,372.120125,10,0
0,0,29,29,19,44,63,145,93,238,0.000333,0.474198,18,25606.66719,1422.592622,1422.592622,320.925614,9,0
0,0,29,29,20,45,65,146,94,240,0.000333,0.481789,20,28907.3655,1605.96475,1445.368275,333.571951,9,0
0,0,14,14,14,17,31,47,40,87,0.000333,0.143672,14,6034.211106,335.23395,431.015079,122.789837,1,0
0,0,25,25,20,48,68,126,86,212,0.000333,0.430181,10,12905.42122,716.967846,1290.542122,354.516762,10,0
0,0,16,16,14,18,32,52,48,100,0.000333,0.166667,14,7000,388.888889,500,128.361619,1,0
0,0,23,23,18,47,65,117,82,199,0.000333,0.399484,9,10786.06075,599.225597,1198.451195,336.124326,10,0
0,0,25,25,19,47,66,121,85,206,0.000333,0.415048,9,11206.3067,622.572594,1245.145189,341.776299,10,0
0,0,19,19,17,24,41,76,61,137,0.000333,0.244662,16,11743.75399,652.430777,733.984625,179.525968,4,0
0,0,13,13,16,18,34,46,34,80,0.000333,0.135666,8,3255.976218,180.887568,406.997027,139.05865,2,0
0,0,13,13,15,18,33,45,34,79,0.000333,0.132836,7,2789.549948,154.974997,398.507135,133.662009,2,0
0,0,22,22,18,46,64,114,81,195,0.000333,0.39,9,10530,585,1170,329.1425,9,0
0,0,17,17,15,20,35,54,49,103,0.000333,0.176105,14,7396.42611,410.912562,528.316151,145.041921,1,0
0,0,17,17,14,20,34,60,50,110,0.000333,0.18654,14,7834.692776,435.26071,559.620913,139.741531,1,0
0,0,13,13,16,18,34,46,34,80,0.000333,0.135666,8,3255.976218,180.887568,406.997027,139.05865,2,0
0,0,13,13,15,18,33,45,34,79,0.000333,0.132836,7,2789.549948,154.974997,398.507135,133.662009,2,0
0,0,13,13,16,18,34,46,34,80,0.000333,0.135666,8,3255.976218,180.887568,406.997027,139.05865,2,0
0,0,13,13,15,18,33,45,34,79,0.000333,0.132836,7,2789.549948,154.974997,398.507135,133.662009,2,0
0,0,13,13,15,17,32,45,33,78,0.000333,0.13,7,2730,151.666667,390,128.090227,2,0
0,0,13,13,15,17,32,45,33,78,0.000333,0.13,7,2730,151.666667,390,128.090227,2,0
0,0,16,16,16,19,35,56,39,95,0.000333,0.162427,16,7796.510186,433.139455,487.281887,144.710623,2,0
0,0,13,13,15,17,32,45,33,78,0.000333,0.13,7,2730,151.666667,390,128.090227,2,0
0,0,13,13,15,17,32,45,33,78,0.000333,0.13,7,2730,151.666667,390,128.090227,2,0
0,0,13,13,16,18,34,46,34,80,0.000333,0.135666,8,3255.976218,180.887568,406.997027,139.05865,2,0
0,0,13,13,15,18,33,45,34,79,0.000333,0.132836,7,2789.549948,154.974997,398.507135,133.662009,2,0
0,0,23,23,18,48,66,117,83,200,0.000333,0.40296,9,10879.90942,604.439412,1208.878824,343.13685,10,0
0,0,14,14,17,17,34,51,39,90,0.000333,0.152624,16,7325.946491,406.997027,457.871656,138.973737,2,0
0,0,25,25,20,47,67,122,85,207,0.000333,0.41856,10,12556.80462,697.600257,1255.680462,347.504238,10,0
0,0,23,23,18,48,66,117,83,200,0.000333,0.40296,9,10879.90942,604.439412,1208.878824,343.13685,10,0
0,0,23,23,18,47,65,117,82,199,0.000333,0.399484,9,10786.06075,599.225597,1198.451195,336.124326,10,0
0,0,23,23,18,47,65,117,82,199,0.000333,0.399484,9,10786.06075,599.225597,1198.451195,336.124326,10,0
0,0,36,36,21,51,72,179,119,298,0.000333,0.612879,20,36772.75301,2042.930723,1838.63765,381.532358,11,0
0,0,15,15,16,17,33,49,36,85,0.000333,0.142925,16,6860.376002,381.132,428.7735,133.486868,2,0
0,0,15,15,16,17,33,49,36,85,0.000333,0.142925,16,6860.376002,381.132,428.7735,133.486868,2,0
0,0,32,32,19,49,68,173,112,285,0.000333,0.578309,18,31228.68438,1734.92691,1734.92691,355.831405,11,0
0,0,23,23,18,48,66,117,83,200,0.000333,0.40296,9,10879.90942,604.439412,1208.878824,343.13685,10,0
0,0,34,34,19,52,71,165,111,276,0.000333,0.565777,18,30551.94369,1697.330205,1697.330205,377.133488,11,0
0,0,34,34,19,50,69,170,111,281,0.000333,0.572165,18,30896.9167,1716.495372,1716.495372,362.903432,11,0
0,0,24,24,19,47,66,122,87,209,0.000333,0.421093,9,11369.50534,631.639185,1263.278371,341.776299,9,0
0,0,24,24,19,48,67,123,90,213,0.000333,0.430692,9,11628.69298,646.038499,1292.076998,348.788823,9,0
0,0,16,16,16,18,34,53,47,100,0.000333,0.169582,16,8139.940546,452.218919,508.746284,139.05865,2,0
0,0,16,16,16,18,34,53,47,100,0.000333,0.169582,16,8139.940546,452.218919,508.746284,139.05865,2,0
0,0,16,16,16,18,34,54,47,101,0.000333,0.171278,16,8221.339951,456.741108,513.833747,139.05865,2,0
0,0,16,16,16,18,34,54,47,101,0.000333,0.171278,16,8221.339951,456.741108,513.833747,139.05865,2,0
0,0,24,24,18,47,65,121,87,208,0.000333,0.417551,9,11273.87255,626.326253,1252.652505,336.124326,9,0
0,0,24,24,18,47,65,122,88,210,0.000333,0.421566,9,11382.27517,632.34862,1264.697241,336.124326,9,0
0,0,21,21,16,45,61,111,77,188,0.000333,0.37166,8,8919.828956,495.546053,1114.978619,311.133389,9,0
0,0,24,24,18,47,65,121,87,208,0.000333,0.417551,9,11273.87255,626.326253,1252.652505,336.124326,9,0
0,0,21,21,16,45,61,111,77,188,0.000333,0.37166,8,8919.828956,495.546053,1114.978619,311.133389,9,0
0,0,19,19,18,42,60,101,71,172,0.000333,0.338662,9,9143.866642,507.992591,1015.985182,301.535982,7,0
0,0,19,19,18,42,60,101,71,172,0.000333,0.338662,9,9143.866642,507.992591,1015.985182,301.535982,7,0
0,0,19,19,18,42,60,101,71,172,0.000333,0.338662,9,9143.866642,507.992591,1015.985182,301.535982,7,0
0,0,19,19,18,42,60,101,71,172,0.000333,0.338662,9,9143.866642,507.992591,1015.985182,301.535982,7,0
0,0,21,21,19,43,62,110,78,188,0.000333,0.37313,9,10074.50016,559.694453,1119.388906,314.040007,7,0
0,0,21,21,18,43,61,108,77,185,0.000333,0.365729,9,9874.677667,548.593204,1097.186407,308.388034,7,0
0,0,18,18,16,41,57,98,67,165,0.000333,0.320809,8,7699.414819,427.745268,962.426852,283.659632,7,0
0,0,13,13,16,18,34,51,42,93,0.000333,0.157711,16,7570.144708,420.563595,473.134044,139.05865,1,0
0,0,20,20,18,42,60,104,72,176,0.000333,0.346538,9,9356.514703,519.806372,1039.612745,301.535982,8,0
0,0,20,20,19,43,62,104,72,176,0.000333,0.349313,9,9431.446956,523.969275,1047.938551,314.040007,8,0
0,0,24,24,21,47,68,123,88,211,0.000333,0.428152,10,12844.5466,713.585922,1284.45466,353.304342,10,0
0,0,19,19,18,42,60,101,71,172,0.000333,0.338662,9,9143.866642,507.992591,1015.985182,301.535982,7,0
0,0,21,21,21,43,64,110,78,188,0.000333,0.376,10,11280,626.666667,1128,325.56805,8,0
0,0,14,14,14,17,31,47,40,87,0.000333,0.143672,14,6034.211106,335.23395,431.015079,122.789837,1,0
0,0,20,20,18,43,61,104,72,176,0.000333,0.347937,9,9394.287943,521.904886,1043.809771,308.388034,8,0
0,0,20,20,18,43,61,104,72,176,0.000333,0.347937,9,9394.287943,521.904886,1043.809771,308.388034,8,0
0,0,22,22,20,44,64,113,76,189,0.000333,0.378,10,11340,630,1134,326.653553,8,0
0,0,22,22,19,43,62,108,75,183,0.000333,0.363206,9,9806.561323,544.808962,1089.617925,314.040007,8,0
0,0,20,20,18,44,62,104,73,177,0.000333,0.351298,9,9485.034722,526.946373,1053.892747,315.273641,8,0
0,0,20,20,18,44,62,104,73,177,0.000333,0.351298,9,9485.034722,526.946373,1053.892747,315.273641,8,0
0,0,19,19,18,42,60,101,71,172,0.000333,0.338662,9,9143.866642,507.992591,1015.985182,301.535982,7,0
0,0,19,19,18,42,60,101,71,172,0.000333,0.338662,9,9143.866642,507.992591,1015.985182,301.535982,7,0
0,0,14,14,14,17,31,46,38,84,0.000333,0.138717,14,5826.134861,323.674159,416.15249,122.789837,1,0
0,0,17,17,15,20,35,54,49,103,0.000333,0.176105,14,7396.42611,410.912562,528.316151,145.041921,1,0
0,0,21,21,18,43,61,108,77,185,0.000333,0.365729,9,9874.677667,548.593204,1097.186407,308.388034,7,0
0,0,16,16,16,18,34,54,47,101,0.000333,0.171278,16,8221.339951,456.741108,513.833747,139.05865,2,0
0,0,16,16,16,18,34,54,47,101,0.000333,0.171278,16,8221.339951,456.741108,513.833747,139.05865,2,0
0,0,23,23,18,48,66,117,83,200,0.000333,0.40296,9,10879.90942,604.439412,1208.878824,343.13685,10,0
0,0,23,23,18,48,66,117,83,200,0.000333,0.40296,9,10879.90942,604.439412,1208.878824,343.13685,10,0
0,0,19,19,18,42,60,110,73,183,0.000333,0.36032,9,9728.648811,540.480489,1080.960979,301.535982,7,0
0,0,19,19,19,43,62,111,74,185,0.000333,0.367175,9,9913.736857,550.763159,1101.526317,314.040007,7,0
0,0,23,23,19,47,66,117,82,199,0.000333,0.400945,9,10825.50987,601.417215,1202.83443,341.776299,10,0
0,0,23,23,18,46,64,117,82,199,0.000333,0.398,9,10746,597,1194,329.1425,10,0
0,0,9,9,13,14,27,38,28,66,0.000333,0.104608,12,3765.870902,209.21505,313.822575,101.408685,1,0
0,0,11,11,14,15,29,40,30,70,0.000333,0.113353,14,4760.821375,264.490076,340.05867,111.906328,1,0
0,0,21,21,16,45,61,111,77,188,0.000333,0.37166,8,8919.828956,495.546053,1114.978619,311.133389,9,0
0,0,23,23,18,47,65,117,82,199,0.000333,0.399484,9,10786.06075,599.225597,1198.451195,336.124326,10,0
0,0,23,23,18,47,65,117,82,199,0.000333,0.399484,9,10786.06075,599.225597,1198.451195,336.124326,10,0
0,0,24,24,18,47,65,122,88,210,0.000333,0.421566,9,11382.27517,632.34862,1264.697241,336.124326,9,0
0,0,22,22,18,46,64,114,81,195,0.000333,0.39,9,10530,585,1170,329.1425,9,0
0,0,15,15,15,20,35,49,41,90,0.000333,0.153878,14,6462.896601,359.049811,461.635472,145.041921,1,0
0,0,14,14,15,17,32,47,38,85,0.000333,0.141667,14,5950,330.555556,425,128.090227,1,0
0,0,22,22,18,46,64,114,81,195,0.000333,0.39,9,10530,585,1170,329.1425,9,0
0,0,28,28,20,43,63,141,90,231,0.000333,0.460251,20,27615.03325,1534.168514,1380.751662,319.767946,9,0
0,0,28,28,20,44,64,142,93,235,0.000333,0.47,20,28200,1566.666667,1410,326.653553,9,0
0,0,10,10,12,18,30,37,32,69,0.000333,0.112858,6,2031.452707,112.858484,338.575451,118.0782,1,0
0,0,27,27,20,44,64,142,88,230,0.000333,0.46,20,27600,1533.333333,1380,326.653553,10,0
0,0,27,27,21,45,66,143,89,232,0.000333,0.467433,10,14022.99436,779.055242,1402.299436,339.372055,10,0
0,0,20,20,18,42,60,104,72,176,0.000333,0.346538,9,9356.514703,519.806372,1039.612745,301.535982,8,0
0,0,19,19,16,20,36,70,59,129,0.000333,0.222307,16,10670.7252,592.818067,666.920325,150.438562,1,0
0,0,16,16,16,18,34,53,47,100,0.000333,0.169582,16,8139.940546,452.218919,508.746284,139.05865,2,0
0,0,16,16,16,18,34,53,47,100,0.000333,0.169582,16,8139.940546,452.218919,508.746284,139.05865,2,0
0,0,15,15,15,17,32,51,42,93,0.000333,0.155,14,6510,361.666667,465,128.090227,1,0
0,0,32,32,21,48,69,158,99,257,0.000333,0.523297,20,31397.81571,1744.323095,1569.890785,360.316866,12,0
0,0,33,33,20,48,68,159,103,262,0.000333,0.531638,20,31898.30529,1772.128072,1594.915264,354.516762,12,0
0,0,33,33,21,48,69,160,103,263,0.000333,0.535514,20,32130.83864,1785.046591,1606.541932,360.316866,12,0
0,0,9,9,12,14,26,37,28,65,0.000333,0.101843,12,3666.34298,203.685721,305.528582,96.322519,1,0
0,0,10,10,12,18,30,37,32,69,0.000333,0.112858,6,2031.452707,112.858484,338.575451,118.0782,1,0
0,0,13,13,15,18,33,50,42,92,0.000333,0.154695,14,6497.179626,360.954424,464.084259,133.662009,1,0
0,0,17,17,15,20,35,54,49,103,0.000333,0.176105,14,7396.42611,410.912562,528.316151,145.041921,1,0
0,0,16,16,16,19,35,56,39,95,0.000333,0.162427,16,7796.510186,433.139455,487.281887,144.710623,2,0
0,0,15,15,16,17,33,49,36,85,0.000333,0.142925,16,6860.376002,381.132,428.7735,133.486868,2,0
0,0,15,15,16,17,33,49,36,85,0.000333,0.142925,16,6860.376002,381.132,428.7735,133.486868,2,0
0,0,13,13,15,17,32,45,33,78,0.000333,0.13,7,2730,151.666667,390,128.090227,2,0
0,0,13,13,15,17,32,45,33,78,0.000333,0.13,7,2730,151.666667,390,128.090227,2,0
0,0,13,13,15,17,32,45,33,78,0.000333,0.13,7,2730,151.666667,390,128.090227,2,0
0,0,13,13,15,17,32,45,33,78,0.000333,0.13,7,2730,151.666667,390,128.090227,2,0
0,0,13,13,16,17,33,46,34,80,0.000333,0.134517,16,6456.824473,358.712471,403.55153,133.486868,2,0
0,0,13,13,15,17,32,45,34,79,0.000333,0.131667,14,5530,307.222222,395,128.090227,2,0
0,0,13,13,16,18,34,46,34,80,0.000333,0.135666,8,3255.976218,180.887568,406.997027,139.05865,2,0
0,0,13,13,15,18,33,45,34,79,0.000333,0.132836,7,2789.549948,154.974997,398.507135,133.662009,2,0
0,0,32,32,20,47,67,156,102,258,0.000333,0.521684,20,31301.02022,1738.945568,1565.051011,347.504238,11,0
0,0,13,13,13,16,29,44,36,80,0.000333,0.129546,12,4663.661755,259.09232,388.63848,112.105716,1,0
0,0,38,38,20,57,77,184,126,310,0.000333,0.647568,20,38854.07655,2158.559808,1942.703828,418.913293,12,0
0,0,36,36,20,56,76,178,120,298,0.000333,0.620627,20,37237.64798,2068.758221,1861.882399,411.650438,12,0
0,0,30,30,19,47,66,149,96,245,0.000333,0.493626,18,26655.77807,1480.876559,1480.876559,341.776299,11,0
0,0,36,36,20,57,77,187,121,308,0.000333,0.64339,20,38603.40509,2144.633616,1930.170255,418.913293,12,0
0,0,35,35,20,56,76,178,117,295,0.000333,0.61438,20,36862.77233,2047.931796,1843.138616,411.650438,12,0
0,0,31,31,19,47,66,153,100,253,0.000333,0.509744,18,27526.17082,1529.231712,1529.231712,341.776299,11,0
0,0,36,36,20,56,76,183,121,304,0.000333,0.633123,20,37987.39928,2110.411071,1899.369964,411.650438,12,0
0,0,19,19,18,42,60,101,71,172,0.000333,0.338662,9,9143.866642,507.992591,1015.985182,301.535982,7,0
0,0,19,19,18,42,60,101,71,172,0.000333,0.338662,9,9143.866642,507.992591,1015.985182,301.535982,7,0
0,0,19,19,18,42,60,101,71,172,0.000333,0.338662,9,9143.866642,507.992591,1015.985182,301.535982,7,0
0,0,21,21,21,43,64,110,78,188,0.000333,0.376,10,11280,626.666667,1128,325.56805,8,0
0,0,22,22,18,44,62,112,79,191,0.000333,0.379084,9,10235.26346,568.625748,1137.251495,315.273641,8,0
0,0,22,22,19,44,63,113,79,192,0.000333,0.382546,9,10328.73971,573.818873,1147.637745,320.925614,8,0
0,0,12,12,13,17,30,46,32,78,0.000333,0.127579,6,2296.424799,127.579155,382.737466,117.592585,3,0
0,0,12,12,15,18,33,48,34,82,0.000333,0.13788,7,2895.482225,160.860124,413.640318,133.662009,4,0
0,0,15,15,14,19,33,53,40,93,0.000333,0.156376,14,6567.801143,364.877841,469.128653,134.013592,3,0
0,0,31,31,23,52,75,143,103,246,0.000333,0.510763,11,16855.18338,936.399076,1532.289398,400.46479,10,0
0,0,10,10,12,14,26,37,28,65,0.000333,0.101843,12,3666.34298,203.685721,305.528582,96.322519,1,0
0,0,22,22,20,44,64,113,76,189,0.000333,0.378,10,11340,630,1134,326.653553,8,0
0,0,22,22,19,43,62,108,75,183,0.000333,0.363206,9,9806.561323,544.808962,1089.617925,314.040007,8,0
0,0,40,40,20,58,78,190,132,322,0.000333,0.674633,20,40477.99029,2248.777238,2023.899514,426.20146,12,0
0,0,20,20,18,43,61,104,72,176,0.000333,0.347937,9,9394.287943,521.904886,1043.809771,308.388034,8,0
0,0,20,20,18,43,61,104,73,177,0.000333,0.349914,9,9447.664579,524.870254,1049.740509,308.388034,8,0
0,0,20,20,18,44,62,104,73,177,0.000333,0.351298,9,9485.034722,526.946373,1053.892747,315.273641,8,0
0,0,22,22,20,43,63,109,75,184,0.000333,0.366607,10,10998.19506,611.010837,1099.819506,319.767946,8,0
0,0,20,20,18,44,62,104,73,177,0.000333,0.351298,9,9485.034722,526.946373,1053.892747,315.273641,8,0
0,0,20,20,18,43,61,104,72,176,0.000333,0.347937,9,9394.287943,521.904886,1043.809771,308.388034,8,0
0,0,20,20,18,43,61,104,72,176,0.000333,0.347937,9,9394.287943,521.904886,1043.809771,308.388034,8,0
0,0,19,19,18,42,60,101,71,172,0.000333,0.338662,9,9143.866642,507.992591,1015.985182,301.535982,7,0
0,0,13,13,15,17,32,45,33,78,0.000333,0.13,7,2730,151.666667,390,128.090227,2,0
0,0,13,13,15,17,32,45,33,78,0.000333,0.13,7,2730,151.666667,390,128.090227,2,0
0,0,13,13,16,17,33,46,34,80,0.000333,0.134517,16,6456.824473,358.712471,403.55153,133.486868,2,0
0,0,13,13,15,17,32,45,34,79,0.000333,0.131667,14,5530,307.222222,395,128.090227,2,0
0,0,19,19,16,20,36,70,59,129,0.000333,0.222307,16,10670.7252,592.818067,666.920325,150.438562,1,0
0,0,13,13,16,18,34,51,42,93,0.000333,0.157711,16,7570.144708,420.563595,473.134044,139.05865,1,0
0,0,13,13,15,16,31,45,33,78,0.000333,0.128809,14,5409.982371,300.554576,386.427312,122.603359,2,0
0,0,13,13,15,16,31,45,33,78,0.000333,0.128809,14,5409.982371,300.554576,386.427312,122.603359,2,0
0,0,12,12,14,16,30,42,32,74,0.000333,0.121037,14,5083.538657,282.418814,363.109904,117.302969,1,0
0,0,22,22,18,46,64,114,81,195,0.000333,0.39,9,10530,585,1170,329.1425,9,0
0,0,24,24,19,47,66,123,88,211,0.000333,0.425122,9,11478.30443,637.68358,1275.367159,341.776299,9,0
0,0,25,25,19,48,67,126,89,215,0.000333,0.434736,9,11737.88258,652.104588,1304.209176,348.788823,10,0
0,0,25,25,18,48,66,125,89,214,0.000333,0.431167,9,11641.50307,646.750171,1293.500342,343.13685,10,0
0,0,24,24,21,47,68,123,88,211,0.000333,0.428152,10,12844.5466,713.585922,1284.45466,353.304342,10,0
0,0,22,22,18,46,64,114,81,195,0.000333,0.39,9,10530,585,1170,329.1425,9,0
0,0,22,22,18,46,64,114,81,195,0.000333,0.39,9,10530,585,1170,329.1425,9,0
0,0,22,22,18,46,64,114,81,195,0.000333,0.39,9,10530,585,1170,329.1425,9,0
0,0,22,22,18,46,64,115,81,196,0.000333,0.392,9,10584,588,1176,329.1425,9,0
0,0,28,28,19,43,62,149,92,241,0.000333,0.47832,18,25829.30359,1434.961311,1434.961311,314.040007,9,0
0,0,28,28,20,44,64,150,95,245,0.000333,0.49,20,29400,1633.333333,1470,326.653553,9,0
0,0,21,21,19,43,62,110,78,188,0.000333,0.37313,9,10074.50016,559.694453,1119.388906,314.040007,7,0
0,0,19,19,18,42,60,101,71,172,0.000333,0.338662,9,9143.866642,507.992591,1015.985182,301.535982,7,0
0,0,18,18,16,41,57,98,67,165,0.000333,0.320809,8,7699.414819,427.745268,962.426852,283.659632,7,0
0,0,19,19,18,42,60,101,71,172,0.000333,0.338662,9,9143.866642,507.992591,1015.985182,301.535982,7,0
0,0,21,21,18,43,61,109,78,187,0.000333,0.369683,9,9981.430939,554.523941,1109.047882,308.388034,7,0
0,0,19,19,18,42,60,101,71,172,0.000333,0.338662,9,9143.866642,507.992591,1015.985182,301.535982,7,0
0,0,22,22,18,46,64,115,81,196,0.000333,0.392,9,10584,588,1176,329.1425,9,0
0,0,20,20,18,44,62,104,73,177,0.000333,0.351298,9,9485.034722,526.946373,1053.892747,315.273641,8,0
0,0,20,20,18,43,61,104,72,176,0.000333,0.347937,9,9394.287943,521.904886,1043.809771,308.388034,8,0
0,0,20,20,18,43,61,104,72,176,0.000333,0.347937,9,9394.287943,521.904886,1043.809771,308.388034,8,0
0,0,20,20,18,43,61,104,73,177,0.000333,0.349914,9,9447.664579,524.870254,1049.740509,308.388034,8,0
0,0,31,31,19,47,66,153,100,253,0.000333,0.509744,18,27526.17082,1529.231712,1529.231712,341.776299,11,0
0,0,31,31,20,48,68,154,103,257,0.000333,0.521493,20,31289.559,1738.308834,1564.47795,354.516762,11,0
0,0,14,14,16,20,36,57,44,101,0.000333,0.174054,16,8354.598802,464.144378,522.162425,150.438562,3,0
0,0,14,14,17,21,38,59,46,105,0.000333,0.183677,16,8816.518223,489.806568,551.032389,161.725534,4,0
0,0,14,14,15,20,35,58,44,102,0.000333,0.174396,14,7324.616148,406.923119,523.186868,145.041921,3,0
0,0,14,14,16,21,37,60,46,106,0.000333,0.184067,16,8835.232908,490.846273,552.202057,156.238666,4,0
0,0,18,18,14,19,33,67,57,124,0.000333,0.208502,21,13135.60229,729.755683,625.504871,134.013592,1,0
0,0,14,14,14,17,31,47,40,87,0.000333,0.143672,14,6034.211106,335.23395,431.015079,122.789837,1,0
0,0,10,10,13,15,28,38,30,68,0.000333,0.108967,12,3922.801616,217.933423,326.900135,106.709075,1,0
0,0,9,9,13,14,27,38,28,66,0.000333,0.104608,12,3765.870902,209.21505,313.822575,101.408685,1,0
0,0,11,11,14,15,29,40,30,70,0.000333,0.113353,14,4760.821375,264.490076,340.05867,111.906328,1,0
0,0,15,15,15,17,32,51,42,93,0.000333,0.155,14,6510,361.666667,465,128.090227,1,0
0,0,14,14,14,17,31,47,40,87,0.000333,0.143672,14,6034.211106,335.23395,431.015079,122.789837,1,0
0,0,15,15,15,20,35,49,41,90,0.000333,0.153878,14,6462.896601,359.049811,461.635472,145.041921,1,0
0,0,14,14,15,17,32,47,38,85,0.000333,0.141667,14,5950,330.555556,425,128.090227,1,0
0,0,18,18,14,19,33,57,56,113,0.000333,0.190006,14,7980.231497,443.346194,570.016535,134.013592,1,0
0,0,14,14,15,20,35,58,44,102,0.000333,0.174396,14,7324.616148,406.923119,523.186868,145.041921,3,0
0,0,14,14,16,21,37,60,46,106,0.000333,0.184067,16,8835.232908,490.846273,552.202057,156.238666,4,0
0,0,14,14,16,20,36,57,44,101,0.000333,0.174054,16,8354.598802,464.144378,522.162425,150.438562,3,0
0,0,14,14,17,21,38,59,46,105,0.000333,0.183677,16,8816.518223,489.806568,551.032389,161.725534,4,0
0,0,12,12,14,17,31,48,40,88,0.000333,0.145323,14,6103.569854,339.087214,435.969275,122.789837,1,0
0,0,19,19,18,42,60,101,71,172,0.000333,0.338662,9,9143.866642,507.992591,1015.985182,301.535982,7,0
0,0,18,18,16,41,57,98,67,165,0.000333,0.320809,8,7699.414819,427.745268,962.426852,283.659632,7,0
0,0,21,21,18,43,61,108,77,185,0.000333,0.365729,9,9874.677667,548.593204,1097.186407,308.388034,7,0
0,0,21,21,19,43,62,110,78,188,0.000333,0.37313,9,10074.50016,559.694453,1119.388906,314.040007,7,0
0,0,19,19,18,42,60,101,71,172,0.000333,0.338662,9,9143.866642,507.992591,1015.985182,301.535982,7,0
0,0,19,19,18,42,60,101,71,172,0.000333,0.338662,9,9143.866642,507.992591,1015.985182,301.535982,7,0
0,0,19,19,18,42,60,101,71,172,0.000333,0.338662,9,9143.866642,507.992591,1015.985182,301.535982,7,0
0,0,16,16,16,19,35,56,39,95,0.000333,0.162427,16,7796.510186,433.139455,487.281887,144.710623,2,0
0,0,21,21,16,45,61,111,77,188,0.000333,0.37166,8,8919.828956,495.546053,1114.978619,311.133389,9,0
0,0,21,21,16,45,61,111,77,188,0.000333,0.37166,8,8919.828956,495.546053,1114.978619,311.133389,9,0
0,0,24,24,18,47,65,121,87,208,0.000333,0.417551,9,11273.87255,626.326253,1252.652505,336.124326,9,0
0,0,24,24,19,47,66,123,88,211,0.000333,0.425122,9,11478.30443,637.68358,1275.367159,341.776299,9,0
0,0,29,29,19,44,63,154,95,249,0.000333,0.496114,18,26790.16862,1488.342701,1488.342701,320.925614,9,0
0,0,29,29,20,45,65,155,96,251,0.000333,0.503871,20,30232.28642,1679.571468,1511.614321,333.571951,9,0
0,0,15,15,16,17,33,49,36,85,0.000333,0.142925,16,6860.376002,381.132,428.7735,133.486868,2,0
0,0,15,15,16,17,33,49,36,85,0.000333,0.142925,16,6860.376002,381.132,428.7735,133.486868,2,0
0,0,13,13,16,18,34,46,34,80,0.000333,0.135666,8,3255.976218,180.887568,406.997027,139.05865,2,0
0,0,13,13,15,18,33,45,34,79,0.000333,0.132836,7,2789.549948,154.974997,398.507135,133.662009,2,0
0,0,13,13,16,18,34,46,34,80,0.000333,0.135666,8,3255.976218,180.887568,406.997027,139.05865,2,0
0,0,13,13,15,18,33,45,34,79,0.000333,0.132836,7,2789.549948,154.974997,398.507135,133.662009,2,0
0,0,13,13,15,16,31,45,33,78,0.000333,0.128809,14,5409.982371,300.554576,386.427312,122.603359,2,0
0,0,13,13,15,17,32,45,33,78,0.000333,0.13,7,2730,151.666667,390,128.090227,2,0
0,0,13,13,15,17,32,45,33,78,0.000333,0.13,7,2730,151.666667,390,128.090227,2,0
0,0,12,12,14,16,30,42,32,74,0.000333,0.121037,14,5083.538657,282.418814,363.109904,117.302969,1,0
0,0,14,14,17,17,34,51,39,90,0.000333,0.152624,16,7325.946491,406.997027,457.871656,138.973737,2,0
0,0,16,16,16,18,34,53,47,100,0.000333,0.169582,16,8139.940546,452.218919,508.746284,139.05865,2,0
0,0,16,16,16,18,34,53,47,100,0.000333,0.169582,16,8139.940546,452.218919,508.746284,139.05865,2,0
0,0,16,16,16,18,34,54,47,101,0.000333,0.171278,16,8221.339951,456.741108,513.833747,139.05865,2,0
0,0,16,16,16,18,34,54,47,101,0.000333,0.171278,16,8221.339951,456.741108,513.833747,139.05865,2,0
0,0,14,14,14,17,31,47,40,87,0.000333,0.143672,14,6034.211106,335.23395,431.015079,122.789837,1,0
0,0,15,15,15,17,32,51,42,93,0.000333,0.155,14,6510,361.666667,465,128.090227,1,0
0,0,29,29,19,45,64,169,104,273,0.000333,0.546,18,29484,1638,1638,327.844012,9,0
0,0,29,29,20,46,66,170,105,275,0.000333,0.554069,20,33244.16766,1846.898203,1662.208383,340.522412,9,0
0,0,23,23,18,47,65,117,83,200,0.000333,0.401491,9,10840.26206,602.236781,1204.473563,336.124326,10,0
0,0,23,23,18,47,65,117,82,199,0.000333,0.399484,9,10786.06075,599.225597,1198.451195,336.124326,10,0
0,0,22,22,18,46,64,114,81,195,0.000333,0.39,9,10530,585,1170,329.1425,9,0
0,0,23,23,18,46,64,117,82,199,0.000333,0.398,9,10746,597,1194,329.1425,10,0
0,0,23,23,18,48,66,117,83,200,0.000333,0.40296,9,10879.90942,604.439412,1208.878824,343.13685,10,0
0,0,25,25,20,47,67,122,85,207,0.000333,0.41856,10,12556.80462,697.600257,1255.680462,347.504238,10,0
0,0,23,23,18,47,65,117,82,199,0.000333,0.399484,9,10786.06075,599.225597,1198.451195,336.124326,10,0
0,0,23,23,18,48,66,117,83,200,0.000333,0.40296,9,10879.90942,604.439412,1208.878824,343.13685,10,0
0,0,23,23,18,47,65,117,82,199,0.000333,0.399484,9,10786.06075,599.225597,1198.451195,336.124326,10,0
0,0,23,23,18,47,65,117,82,199,0.000333,0.399484,9,10786.06075,599.225597,1198.451195,336.124326,10,0
0,0,22,22,18,46,64,114,81,195,0.000333,0.39,9,10530,585,1170,329.1425,9,0
0,0,35,35,23,47,70,183,113,296,0.000333,0.604756,22,39913.89101,2217.438389,1814.267773,365.107601,11,0
0,0,35,35,24,49,73,187,121,308,0.000333,0.635489,24,45755.18314,2541.954619,1906.465964,385.159882,11,0
0,0,20,20,18,42,60,104,72,176,0.000333,0.346538,9,9356.514703,519.806372,1039.612745,301.535982,8,0
0,0,19,19,18,42,60,101,71,172,0.000333,0.338662,9,9143.866642,507.992591,1015.985182,301.535982,7,0
0,0,32,32,23,50,73,174,108,282,0.000333,0.581844,22,38401.67156,2133.426198,1745.530526,386.234734,13,0
0,0,19,19,18,42,60,101,71,172,0.000333,0.338662,9,9143.866642,507.992591,1015.985182,301.535982,7,0
0,0,36,36,21,50,71,176,117,293,0.000333,0.600625,20,36037.51812,2002.08434,1801.875906,374.431475,11,0
0,0,6,6,12,16,28,31,25,56,0.000333,0.089737,6,1615.271254,89.737292,269.211876,107.01955,2,0
0,0,4,4,12,14,26,23,20,43,0.000333,0.067373,6,1212.713447,67.372969,202.118908,96.322519,2,0
0,0,49,49,29,61,90,216,183,399,0.000333,0.863416,42,108790.4742,6043.915233,2590.249385,502.656426,19,0
0,0,49,49,29,61,90,216,183,399,0.000333,0.863416,42,108790.4742,6043.915233,2590.249385,502.656426,19,0
0,0,49,49,29,61,90,216,183,399,0.000333,0.863416,42,108790.4742,6043.915233,2590.249385,502.656426,19,0
0,0,50,50,29,61,90,220,187,407,0.000333,0.880728,42,110971.7368,6165.09649,2642.18421,502.656426,19,0
0,0,7,7,14,26,40,34,36,70,0.000333,0.124178,7,2607.744766,144.874709,372.534967,175.514402,2,0
0,0,10,10,18,27,45,57,52,109,0.000333,0.199537,9,5387.507887,299.305994,598.611987,203.440613,4,0
0,0,5,5,13,24,37,29,32,61,0.000333,0.105926,6,1906.659932,105.925552,317.776655,158.144816,2,0
0,0,29,29,21,40,61,139,94,233,0.000333,0.460621,20,27637.23599,1535.402,1381.8618,305.11579,13,0
0,0,12,12,14,25,39,56,47,103,0.000333,0.181465,7,3810.775,211.709722,544.396429,169.399374,6,0
0,0,12,12,14,25,39,56,47,103,0.000333,0.181465,7,3810.775,211.709722,544.396429,169.399374,6,0
0,0,13,13,15,26,41,63,52,115,0.000333,0.205373,14,8625.658727,479.203263,616.118481,180.814792,6,0
0,0,12,12,15,25,40,59,48,107,0.000333,0.189815,7,3986.124143,221.451341,569.446306,174.699764,6,0
0,0,57,57,23,45,68,404,228,632,0.000333,1.282426,55,211600.2084,11755.56713,3847.276516,351.175314,39,0
0,0,47,47,21,43,64,341,202,543,0.000333,1.086,40,130320,7240,3258,325.56805,35,0
0,0,27,27,29,36,65,129,102,231,0.000333,0.463722,28,38952.67502,2164.037501,1391.166965,326.998749,12,0
0,0,6,6,11,16,27,21,27,48,0.000333,0.076078,5,1141.173001,63.3985,228.2346,102.053748,1,0
0,0,4,4,11,14,25,17,21,38,0.000333,0.058822,5,882.332676,49.018482,176.466535,91.356717,1,0
0,0,60,60,30,46,76,437,309,746,0.000333,1.553651,90,419485.8533,23304.76963,4660.953925,401.290568,28,0
0,0,38,38,30,43,73,238,175,413,0.000333,0.852133,60,153383.8526,8521.325143,2556.397543,380.536102,27,0
1,0,14,15,15,31,46,51,46,97,0.000333,0.178595,7,3750.498568,208.361032,535.78551,212.183445,3,0
0,0,49,49,25,65,90,267,218,485,0.000333,1.049516,36,113347.7551,6297.097503,3148.548752,507.550313,19,0
0,0,65,65,25,78,103,326,260,586,0.000333,1.306096,36,141058.4151,7836.578618,3918.289309,606.357778,23,0
1,0,35,36,24,62,86,151,114,265,0.000333,0.567653,12,20435.52192,1135.306773,1702.96016,479.199271,11,0
1,0,30,31,22,55,77,133,99,232,0.000333,0.484631,11,15992.83925,888.49107,1453.894477,416.08228,10,0
1,0,31,32,24,74,98,190,126,316,0.000333,0.696749,12,25082.97973,1393.498874,2090.248311,569.538649,16,0
1,0,8,9,15,31,46,57,48,105,0.000333,0.193325,7,4059.818038,225.545447,579.974005,212.183445,3,0
0,0,29,29,19,43,62,108,92,200,0.000333,0.396946,18,21435.10672,1190.839262,1190.839262,314.040007,7,0
0,0,12,12,11,26,37,38,36,74,0.000333,0.1285,5,1927.497745,107.083208,385.499549,160.26518,4,0
0,0,9,9,9,13,22,11,16,27,0.000333,0.040135,4,481.618615,26.75659,120.404654,76.635041,2,0
0,0,15,15,14,28,42,57,50,107,0.000333,0.192326,7,4038.84575,224.380319,576.977964,187.908907,5,0
0,0,15,15,14,28,42,57,50,107,0.000333,0.192326,7,4038.84575,224.380319,576.977964,187.908907,5,0
0,0,12,12,13,23,36,45,39,84,0.000333,0.144758,6,2605.642201,144.7579,434.2737,152.147641,3,0
0,0,45,45,22,59,81,178,150,328,0.000333,0.693157,22,45748.35762,2541.575423,2079.470801,445.183436,14,0
0,0,45,45,22,59,81,178,150,328,0.000333,0.693157,22,45748.35762,2541.575423,2079.470801,445.183436,14,0
0,0,79,79,28,117,145,503,410,913,0.000333,2.185086,42,275320.794,15295.59967,6555.256999,938.43861,55,0
0,0,8,8,12,20,32,48,51,99,0.000333,0.165,12,5940,330,495,129.458112,3,0
0,0,8,8,12,21,33,50,53,103,0.000333,0.173191,12,6234.871132,346.38173,519.572594,135.258216,3,0
0,0,7,7,12,20,32,45,48,93,0.000333,0.155,12,5580,310,465,129.458112,3,0
0,0,5,5,9,20,29,33,39,72,0.000333,0.116592,4,1399.098527,77.727696,349.774632,114.967887,2,0
0,0,4,4,9,19,28,27,33,60,0.000333,0.096147,4,1153.765181,64.098066,288.441295,109.239948,2,0
0,0,3,3,8,14,22,14,23,37,0.000333,0.055,4,659.99588,36.666438,164.99897,77.302969,2,0
0,0,45,45,23,48,71,303,225,528,0.000333,1.082355,44,142870.9251,7937.273616,3247.066479,372.120125,20,0
0,0,44,44,23,48,71,296,220,516,0.000333,1.057757,44,139623.8586,7756.881033,3173.269514,372.120125,20,0
0,0,41,41,23,46,69,269,202,471,0.000333,0.959038,44,126593.0608,7032.947825,2877.115019,358.125775,20,0
0,0,19,19,22,29,51,118,92,210,0.000333,0.39707,33,39309.90762,2183.883757,1191.209322,238.988944,10,0
0,0,14,14,18,31,49,79,68,147,0.000333,0.275121,18,14856.52225,825.362347,825.362347,228.638736,8,0
0,0,9,9,18,27,45,49,45,94,0.000333,0.172078,9,4646.107719,258.117096,516.234191,203.440613,5,0
0,0,8,8,18,20,38,46,38,84,0.000333,0.146942,9,3967.4332,220.412956,440.825911,161.497212,6,0
0,0,34,34,26,37,63,162,114,276,0.000333,0.54991,39,64339.4411,3574.413394,1649.729259,314.961207,19,0
0,0,18,18,20,30,50,85,69,154,0.000333,0.289718,20,17383.07707,965.726504,869.153853,233.64528,9,0
0,0,6,6,11,18,29,25,27,52,0.000333,0.084205,5,1263.075059,70.170837,252.615012,113.112398,1,0
0,0,8,8,10,16,26,21,23,44,0.000333,0.06894,5,1034.096738,57.449819,206.819348,97.219281,1,0
0,0,15,15,19,26,45,63,52,115,0.000333,0.210521,18,11368.13591,631.563106,631.563106,202.922055,5,0
0,0,21,21,17,50,67,101,98,199,0.000333,0.402384,8,9657.213991,536.511888,1207.151749,351.679678,4,0
0,0,16,16,17,43,60,76,76,152,0.000333,0.299282,8,7182.778964,399.043276,897.847371,302.816253,3,0
0,0,15,15,22,35,57,87,69,156,0.000333,0.30331,11,10009.23926,556.068848,909.930842,277.632401,9,0
1,0,64,65,19,74,93,310,215,525,0.000333,1.144353,18,61795.05077,3433.058376,3433.058376,540.210172,51,0
1,0,60,61,19,72,91,295,206,501,0.000333,1.086802,18,58687.29207,3260.405115,3260.405115,524.945223,50,0
1,0,60,61,19,72,91,295,206,501,0.000333,1.086802,18,58687.29207,3260.405115,3260.405115,524.945223,50,0
0,0,16,16,26,35,61,87,72,159,0.000333,0.314329,26,24517.66815,1362.092675,942.987237,301.736338,5,0
0,0,48,48,25,79,104,300,236,536,0.000333,1.197145,24,86194.45653,4788.580919,3591.435689,614.095084,40,0
0,0,43,43,25,76,101,271,216,487,0.000333,1.08085,24,77821.17581,4323.398656,3242.548992,590.938896,37,0
0,0,3,3,10,11,21,18,14,32,0.000333,0.046851,5,702.770788,39.042822,140.554158,71.273029,1,0
0,0,18,18,15,32,47,90,57,147,0.000333,0.272175,7,5715.671928,317.537329,816.524561,218.603359,10,0
0,0,66,66,31,70,101,326,257,583,0.000333,1.293912,45,174678.1783,9704.343236,3881.737294,582.629897,46,0
0,0,62,62,29,62,91,304,238,542,0.000333,1.175742,42,148143.4372,8230.190955,3527.224695,510.04162,45,0
0,0,25,25,20,40,60,113,100,213,0.000333,0.419389,20,25163.35394,1397.964108,1258.167697,299.315686,21,0
0,0,43,43,28,63,91,225,182,407,0.000333,0.882891,28,74162.82772,4120.157096,2648.672419,511.174573,16,0
0,0,27,27,26,49,75,154,126,280,0.000333,0.581356,26,45345.80007,2519.211115,1744.069233,397.332215,12,0
0,0,24,24,26,43,69,136,109,245,0.000333,0.498863,26,38911.30079,2161.738933,1496.588492,355.540817,12,0
0,0,42,42,24,59,83,222,193,415,0.000333,0.88188,36,95243.0891,5291.282728,2645.641364,457.11504,13,0
0,0,42,42,24,59,83,224,195,419,0.000333,0.890381,36,96161.09478,5342.283043,2671.141522,457.11504,13,0
0,0,39,39,22,55,77,196,169,365,0.000333,0.762459,33,75483.44388,4193.52466,2287.377087,416.08228,13,0
0,0,21,21,20,41,61,153,103,256,0.000333,0.50609,20,30365.37517,1686.965287,1518.268758,306.098194,18,0
0,0,20,20,20,40,60,149,101,250,0.000333,0.492241,20,29534.45298,1640.802943,1476.722649,299.315686,17,0
0,0,21,21,20,41,61,149,103,252,0.000333,0.498182,20,29890.91618,1660.606455,1494.545809,306.098194,18,0
0,0,21,21,20,41,61,149,103,252,0.000333,0.498182,20,29890.91618,1660.606455,1494.545809,306.098194,18,0
0,0,20,20,20,40,60,145,101,246,0.000333,0.484365,20,29061.90173,1614.550096,1453.095087,299.315686,17,0
0,0,19,19,20,40,60,140,98,238,0.000333,0.468613,20,28116.79924,1562.044402,1405.839962,299.315686,16,0
0,0,27,27,28,49,77,211,145,356,0.000333,0.743659,28,62467.32824,3470.407124,2230.976008,409.72672,21,0
0,0,26,26,29,48,77,207,143,350,0.000333,0.731125,28,61414.5081,3411.917117,2193.375289,408.959649,20,0
0,0,22,22,20,41,61,162,106,268,0.000333,0.529813,20,31788.75213,1766.041785,1589.437606,306.098194,19,0
0,0,22,22,20,41,61,162,106,268,0.000333,0.529813,20,31788.75213,1766.041785,1589.437606,306.098194,19,0
0,0,21,21,20,40,60,158,104,262,0.000333,0.515868,20,30952.10672,1719.561484,1547.605336,299.315686,18,0
0,0,25,25,27,53,80,193,139,332,0.000333,0.699627,26,54570.88332,3031.71574,2098.880128,431.961747,16,0
0,0,26,26,26,51,77,192,141,333,0.000333,0.695613,26,54257.83787,3014.324326,2086.839918,411.505125,19,0
0,0,21,21,20,42,62,159,112,271,0.000333,0.537862,20,32271.744,1792.874667,1613.5872,312.915894,17,0
0,0,25,25,27,50,77,199,149,348,0.000333,0.726947,26,56701.88462,3150.104701,2180.841716,410.574772,18,0
0,0,6,6,14,19,33,36,38,74,0.000333,0.124428,14,5225.992308,290.332906,373.285165,134.013592,1,0
0,0,4,4,13,14,27,18,21,39,0.000333,0.061814,6,1112.643676,61.813538,185.440613,101.408685,1,0
0,0,4,4,13,16,29,19,22,41,0.000333,0.066392,6,1195.063325,66.392407,199.177221,112.105716,1,0
0,0,21,21,22,38,60,95,80,175,0.000333,0.344569,22,22741.52879,1263.418266,1033.705854,297.528741,10,0
0,0,21,21,22,38,60,95,80,175,0.000333,0.344569,22,22741.52879,1263.418266,1033.705854,297.528741,10,0
0,0,5,5,12,18,30,25,29,54,0.000333,0.088324,6,1589.832553,88.324031,264.972092,118.0782,2,0
0,0,5,5,12,17,29,25,29,54,0.000333,0.087444,6,1573.985842,87.443658,262.330974,112.506418,2,0
0,0,3,3,10,19,29,22,29,51,0.000333,0.082586,5,1238.785154,68.821397,247.757031,113.929904,1,0
0,0,3,3,9,13,22,14,20,34,0.000333,0.05054,4,606.4827,33.693483,151.620675,76.635041,1,0
0,0,5,5,16,20,36,37,29,66,0.000333,0.113738,8,2729.720401,151.651133,341.21505,150.438562,3,0
0,0,10,10,14,25,39,53,46,99,0.000333,0.174418,7,3662.783738,203.487985,523.25482,169.399374,4,0
1,0,4,5,13,18,31,20,19,39,0.000333,0.064405,6,1159.281937,64.404552,193.213656,123.164366,1,0
0,0,30,30,25,44,69,163,93,256,0.000333,0.521261,24,37530.77426,2085.043015,1563.782261,356.311396,20,0
0,0,25,25,23,39,62,133,76,209,0.000333,0.414809,11,13688.69732,760.483184,1244.427029,310.172612,17,0
0,0,27,27,23,37,60,139,78,217,0.000333,0.427265,22,28199.4957,1566.63865,1281.795259,296.7917,18,0
0,0,25,25,23,40,63,135,78,213,0.000333,0.424387,11,14004.76686,778.042603,1273.160624,316.919049,16,0
0,0,49,49,26,75,101,270,160,430,0.000333,0.954344,26,74438.80438,4135.489132,2863.030938,589.372834,35,0
0,0,13,13,15,28,43,50,47,97,0.000333,0.175449,7,3684.433768,204.690765,526.347681,193.209297,3,0
1,0,89,90,31,75,106,321,251,572,0.000333,1.28279,45,173176.6725,9620.92625,3848.3705,620.741487,75,0
1,0,79,80,28,68,96,278,215,493,0.000333,1.082129,42,136348.2335,7574.901863,3246.386513,548.553411,71,0
1,0,71,72,26,64,90,246,189,435,0.000333,0.941319,26,73422.85852,4079.047696,2823.956097,506.211433,70,0
1,0,74,75,30,66,96,265,202,467,0.000333,1.025059,45,138382.987,7687.94372,3075.177488,546.13673,71,0
0,0,17,17,20,32,52,81,65,146,0.000333,0.277421,20,16645.28398,924.737999,832.264199,246.438562,10,0
0,0,17,17,18,27,45,75,58,133,0.000333,0.243472,18,13147.49631,730.416462,730.416462,203.440613,10,0
0,0,22,22,22,33,55,97,75,172,0.000333,0.331465,22,21876.66516,1215.370286,994.393871,264.572502,14,0
0,0,24,24,26,39,65,118,86,204,0.000333,0.409521,26,31942.63888,1774.591049,1228.563034,328.342119,15,0
0,0,20,20,22,31,53,87,67,154,0.000333,0.294033,22,19406.1945,1078.121917,882.09975,251.687581,12,0
1,0,16,17,22,30,52,89,58,147,0.000333,0.279322,11,9217.611024,512.089501,837.964639,245.314213,8,0
0,0,13,13,17,35,52,83,62,145,0.000333,0.275521,8,6612.510073,367.361671,826.563759,249.011774,5,0
0,0,29,29,28,45,73,196,150,346,0.000333,0.713893,42,89950.53049,4997.251694,2141.679297,381.739327,18,0
0,0,15,15,22,32,54,95,67,162,0.000333,0.310764,22,20510.41906,1139.467725,932.291775,258.107496,7,0
0,0,8,8,12,24,36,36,35,71,0.000333,0.122355,6,2202.388051,122.354892,367.064675,153.05865,2,0
0,0,18,18,19,27,46,89,72,161,0.000333,0.296431,18,16007.28255,889.293475,889.293475,209.092585,8,0
0,0,9,9,11,21,32,47,39,86,0.000333,0.143333,5,2150,119.444444,430,130.292414,5,0
0,0,40,40,20,75,95,272,247,519,0.000333,1.136585,30,102292.6518,5682.925101,3409.755061,553.599964,18,0
0,0,25,25,14,55,69,169,168,337,0.000333,0.686191,21,43230.02758,2401.668199,2058.572742,371.277753,15,0
0,0,11,11,19,28,47,57,44,101,0.000333,0.187004,9,5049.121266,280.506737,561.013474,215.316561,3,0
0,0,9,9,13,20,33,24,26,50,0.000333,0.084073,6,1513.318236,84.073235,252.219706,134.544278,3,0
0,0,16,16,19,23,42,76,59,135,0.000333,0.242654,18,13103.33134,727.962852,727.962852,184.752548,8,0
0,0,80,80,29,95,124,460,273,733,0.000333,1.699142,28,142727.9251,7929.329171,5097.425896,765.017732,47,0
0,0,80,80,29,95,124,460,273,733,0.000333,1.699142,28,142727.9251,7929.329171,5097.425896,765.017732,47,0
0,0,5,5,11,17,28,16,24,40,0.000333,0.064098,5,961.470984,53.415055,192.294197,107.540616,1,0
0,0,19,19,15,41,56,96,72,168,0.000333,0.325212,7,6829.449388,379.413855,975.635627,278.262991,6,0
0,0,16,16,15,39,54,84,65,149,0.000333,0.285826,7,6002.347665,333.463759,857.478238,264.734045,5,0
0,0,15,15,19,23,42,60,58,118,0.000333,0.212098,18,11453.28221,636.293456,636.293456,184.752548,4,0
0,0,17,17,20,26,46,68,65,133,0.000333,0.244878,20,14692.6748,816.259711,734.63374,208.649995,5,0
0,0,5,5,9,15,24,17,20,37,0.000333,0.056548,4,678.57445,37.698581,169.643613,87.132684,2,0
0,0,5,5,12,19,31,34,31,65,0.000333,0.107341,6,1932.136561,107.34092,322.02276,123.730173,2,0
0,0,4,4,8,20,28,29,29,58,0.000333,0.092942,4,1115.306342,61.961463,278.826585,110.438562,1,0
0,0,4,4,9,17,26,20,21,41,0.000333,0.064239,4,770.872114,42.826229,192.718028,98.016193,2,0
0,0,78,78,25,53,78,410,301,711,0.000333,1.48964,60,268135.2587,14896.40326,4468.920978,419.676189,29,0
0,0,78,78,25,53,78,410,301,711,0.000333,1.48964,60,268135.2587,14896.40326,4468.920978,419.676189,29,0
0,0,78,78,25,53,78,410,301,711,0.000333,1.48964,60,268135.2587,14896.40326,4468.920978,419.676189,29,0
0,0,78,78,25,53,78,410,301,711,0.000333,1.48964,60,268135.2587,14896.40326,4468.920978,419.676189,29,0
0,0,78,78,25,53,78,410,301,711,0.000333,1.48964,60,268135.2587,14896.40326,4468.920978,419.676189,29,0
0,0,42,42,23,42,65,215,158,373,0.000333,0.748781,33,74129.32541,4118.295856,2246.343194,330.519257,15,0
0,0,26,26,18,36,54,112,89,201,0.000333,0.385577,18,20821.18298,1156.732388,1156.732388,261.17595,7,0
0,0,78,78,25,53,78,410,301,711,0.000333,1.48964,60,268135.2587,14896.40326,4468.920978,419.676189,29,0
0,0,32,32,20,37,57,141,113,254,0.000333,0.493851,30,44446.62191,2469.256773,1481.554064,279.188336,9,0
0,0,117,117,27,63,90,522,346,868,0.000333,1.878309,65,366270.3517,20348.35287,5634.928488,504.950598,36,0
0,0,17,17,15,19,34,75,54,129,0.000333,0.218761,14,9187.957891,510.442105,656.282707,139.313982,8,0
0,0,22,22,13,40,53,98,87,185,0.000333,0.353222,12,12715.98341,706.443523,1059.665284,260.98284,5,0
0,0,14,14,13,38,51,79,70,149,0.000333,0.28173,6,5071.148256,281.730459,845.191376,247.526962,4,0
0,0,9,9,13,26,39,44,42,86,0.000333,0.151515,6,2727.267545,151.514864,454.544591,170.317149,4,0
0,0,5,5,8,14,22,15,23,38,0.000333,0.056486,4,677.833606,37.657423,169.458402,77.302969,2,0
0,0,5,5,8,13,21,15,23,38,0.000333,0.055636,4,667.632248,37.09068,166.908062,72.105716,2,0
0,0,5,5,8,14,22,15,23,38,0.000333,0.056486,4,677.833606,37.657423,169.458402,77.302969,2,0
0,0,5,5,8,13,21,15,23,38,0.000333,0.055636,4,667.632248,37.09068,166.908062,72.105716,2,0
0,0,5,5,8,14,22,15,23,38,0.000333,0.056486,4,677.833606,37.657423,169.458402,77.302969,2,0
0,0,5,5,8,13,21,15,23,38,0.000333,0.055636,4,667.632248,37.09068,166.908062,72.105716,2,0
0,0,3,3,8,16,24,14,19,33,0.000333,0.050435,4,605.21505,33.623058,151.303763,88,1,0
0,0,44,44,23,70,93,225,177,402,0.000333,0.876247,22,57832.32053,3212.906696,2628.741842,533.091736,12,0
0,0,43,43,23,70,93,228,176,404,0.000333,0.880607,22,58120.04351,3228.891306,2641.82016,533.091736,12,0
0,0,6,6,13,23,36,38,34,72,0.000333,0.124078,6,2233.407601,124.0782,372.2346,152.147641,1,0
0,0,7,7,13,25,38,48,39,87,0.000333,0.15219,6,2739.418162,152.189898,456.569694,164.202121,1,0
0,0,6,6,13,24,37,42,35,77,0.000333,0.133709,6,2406.767455,133.709303,401.127909,158.144816,1,0
0,0,5,5,13,22,35,37,32,69,0.000333,0.117974,6,2123.523169,117.973509,353.920528,146.213212,1,0
0,0,7,7,12,25,37,53,41,94,0.000333,0.16323,6,2938.131698,163.229539,489.688616,159.115955,1,0
0,0,7,7,18,27,45,62,49,111,0.000333,0.203199,9,5486.361243,304.797847,609.595694,203.440613,2,0
0,0,3,3,12,17,29,26,24,50,0.000333,0.080966,6,1457.394299,80.96635,242.89905,112.506418,1,0
0,0,62,62,26,92,118,351,278,629,0.000333,1.443061,39,168838.1166,9379.895369,4329.182478,722.379133,24,0
0,0,8,8,17,27,44,44,43,87,0.000333,0.158324,8,3799.764407,211.098023,474.970551,197.868831,3,0
0,0,7,7,17,28,45,45,43,88,0.000333,0.161094,8,3866.26458,214.792477,483.283072,204.092806,2,0
0,0,30,30,17,44,61,177,123,300,0.000333,0.593074,16,28467.53922,1581.529957,1779.221201,309.70186,9,0
0,0,28,28,17,41,58,159,110,269,0.000333,0.525266,16,25212.7502,1400.708345,1575.796888,289.1465,7,0
0,0,24,24,15,39,54,129,90,219,0.000333,0.420107,14,17644.48508,980.249171,1260.320363,264.734045,6,0
0,0,11,11,12,25,37,57,43,100,0.000333,0.173648,6,3125.672019,173.648446,520.945337,159.115955,4,0
0,0,14,14,15,25,40,75,53,128,0.000333,0.227069,14,9536.895146,529.827508,681.206796,174.699764,10,0
0,0,81,81,23,88,111,471,375,846,0.000333,1.916025,44,252915.3362,14050.85201,5748.075823,672.471907,26,0
0,0,6,6,12,15,27,26,24,50,0.000333,0.079248,6,1426.466251,79.248125,237.744375,101.622909,6,0
0,0,4,4,9,12,21,10,15,25,0.000333,0.036603,4,439.231742,24.401763,109.807936,71.548875,1,0
0,0,109,109,25,109,134,535,396,931,0.000333,2.192843,36,236827.0453,13157.05807,6578.529036,853.828496,47,0
0,0,9,9,17,26,43,48,35,83,0.000333,0.150127,8,3603.039797,200.168878,450.379975,191.698301,3,0
0,0,16,16,15,33,48,70,55,125,0.000333,0.232707,7,4886.842188,271.491233,698.120313,225.068365,4,0
0,0,12,12,15,29,44,52,42,94,0.000333,0.171062,7,3592.306005,199.572556,513.186572,199.484808,3,0
0,0,69,69,34,63,97,361,243,604,0.000333,1.328782,51,203303.7152,11294.65084,3986.347357,549.542372,33,0
0,0,52,52,30,58,88,294,202,496,0.000333,1.067959,45,144174.5137,8009.695207,3203.878083,486.969616,27,0
0,0,23,23,24,40,64,122,95,217,0.000333,0.434,24,31248,1736,1302,322.916224,7,0
0,0,22,22,24,38,62,117,89,206,0.000333,0.408855,24,29437.54656,1635.419253,1226.56444,309.460346,7,0
0,0,10,10,19,31,50,61,49,110,0.000333,0.206941,9,5587.417628,310.41209,620.824181,234.290708,2,0
0,0,10,10,19,31,50,61,49,110,0.000333,0.206941,9,5587.417628,310.41209,620.824181,234.290708,2,0
0,0,2,2,9,13,22,13,13,26,0.000333,0.038648,4,463.780888,25.765605,115.945222,76.635041,1,0
0,0,19,19,19,25,44,87,73,160,0.000333,0.29117,18,15723.16306,873.509059,873.509059,196.807027,5,0
0,0,17,17,19,25,44,79,65,144,0.000333,0.262053,18,14150.84676,786.158153,786.158153,196.807027,5,0
0,0,4,4,12,12,24,20,17,37,0.000333,0.056548,6,1017.861675,56.547871,169.643613,86.0391,2,0
0,0,6,6,15,21,36,67,51,118,0.000333,0.20335,14,8540.716102,474.484228,610.05115,150.842025,4,0
0,0,6,6,13,20,33,37,34,71,0.000333,0.119384,6,2148.911895,119.383994,358.151982,134.544278,4,0
1,0,31,32,23,54,77,210,166,376,0.000333,0.785437,33,77758.2874,4319.904855,2356.311739,414.80585,15,0
1,0,31,32,23,54,77,210,166,376,0.000333,0.785437,33,77758.2874,4319.904855,2356.311739,414.80585,15,0
1,0,11,12,19,24,43,56,48,104,0.000333,0.188111,18,10157.96762,564.331534,564.331534,190.749723,7,0
1,0,10,11,20,23,43,55,45,100,0.000333,0.180875,10,5426.264755,301.459153,542.626475,190.480487,7,0
1,0,10,11,18,20,38,51,43,94,0.000333,0.164435,18,8879.493353,493.305186,493.305186,161.497212,7,0
1,0,9,10,20,21,41,45,37,82,0.000333,0.14644,10,4393.192644,244.066258,439.319264,178.677228,6,0
1,0,9,10,18,18,36,41,35,76,0.000333,0.130971,9,3536.228701,196.45715,392.9143,150.1173,6,0
0,0,9,9,11,23,34,30,34,64,0.000333,0.108533,5,1627.988109,90.443784,325.597622,142.095673,2,0
0,0,11,11,16,36,52,72,52,124,0.000333,0.235618,8,5654.8362,314.157567,706.854525,250.1173,4,0
0,0,81,81,21,49,70,378,269,647,0.000333,1.321882,50,198282.3056,11015.68364,3965.646112,367.359448,28,0
0,0,79,79,21,49,70,373,264,637,0.000333,1.301451,50,195217.6641,10845.42578,3904.353282,367.359448,28,0
0,0,74,74,20,49,69,349,250,599,0.000333,1.219669,50,182950.3075,10163.90597,3659.00615,361.559344,26,0
0,0,68,68,18,49,67,321,234,555,0.000333,1.122227,36,121200.462,6733.359001,3366.679501,350.179432,23,0
0,0,68,68,18,49,67,321,234,555,0.000333,1.122227,36,121200.462,6733.359001,3366.679501,350.179432,23,0
0,0,65,65,17,50,67,311,228,539,0.000333,1.089874,32,104627.9064,5812.661464,3269.622074,351.679678,22,0
0,0,54,54,17,47,64,255,190,445,0.000333,0.89,32,85440,4746.666667,2670,330.552544,18,0
0,0,51,51,17,47,64,240,180,420,0.000333,0.84,24,60480,3360,2520,330.552544,17,0
0,0,59,59,21,58,79,316,229,545,0.000333,1.145187,30,103066.8152,5725.93418,3435.560508,432.001564,19,0
0,0,49,49,17,47,64,228,173,401,0.000333,0.802,24,57744,3208,2406,330.552544,16,0
0,0,34,34,17,41,58,164,123,287,0.000333,0.560414,24,40349.77309,2241.654061,1681.240546,289.1465,10,0
0,0,28,28,17,36,53,131,101,232,0.000333,0.442959,16,21262.04073,1181.224485,1328.877545,255.604168,8,0
0,0,17,17,13,27,40,87,70,157,0.000333,0.278514,12,10026.51253,557.028474,835.542711,176.487679,5,0
0,0,14,14,12,27,39,71,60,131,0.000333,0.230796,12,8308.652288,461.591794,692.387691,171.401513,4,0
0,0,6,6,10,23,33,34,32,66,0.000333,0.110977,5,1664.650059,92.480559,332.930012,137.261206,2,0
0,0,11,11,16,23,39,55,34,89,0.000333,0.1568,8,3763.20638,209.067021,470.400797,168.041925,5,0
0,0,8,8,14,21,35,39,34,73,0.000333,0.124813,7,2621.063622,145.614646,374.43766,145.541635,5,0
0,0,8,8,14,21,35,39,35,74,0.000333,0.126522,7,2656.968603,147.609367,379.566943,145.541635,3,0
0,0,14,14,14,25,39,54,53,107,0.000333,0.188513,14,7917.532524,439.862918,565.538037,169.399374,4,0
0,0,7,7,11,17,28,25,28,53,0.000333,0.08493,5,1273.949054,70.774947,254.789811,107.540616,2,0
0,0,27,27,22,46,68,133,107,240,0.000333,0.486997,22,32141.8038,1785.655767,1460.991082,352.191346,10,0
0,0,24,24,22,41,63,116,93,209,0.000333,0.416417,22,27483.53309,1526.862949,1249.251504,317.767128,9,0
0,0,17,17,26,35,61,91,74,165,0.000333,0.326191,26,25442.86318,1413.492399,978.571661,301.736338,6,0
0,0,45,45,22,58,80,222,173,395,0.000333,0.832387,22,54937.55515,3052.086397,2497.161597,437.870393,21,0
0,0,47,47,24,58,82,215,170,385,0.000333,0.815886,24,58743.78052,3263.543362,2447.657522,449.801998,19,0
0,0,36,36,22,54,76,175,136,311,0.000333,0.647702,22,42748.32005,2374.906669,1943.105457,408.871421,17,0
0,0,36,36,22,54,76,175,136,311,0.000333,0.647702,22,42748.32005,2374.906669,1943.105457,408.871421,17,0
0,0,36,36,22,54,76,175,136,311,0.000333,0.647702,22,42748.32005,2374.906669,1943.105457,408.871421,17,0
0,0,23,23,14,38,52,83,77,160,0.000333,0.304023,14,12768.98497,709.388054,912.070355,252.724214,7,0
0,0,22,22,14,38,52,80,74,154,0.000333,0.292623,7,6145.074016,341.393001,877.867717,252.724214,7,0
0,0,36,36,15,33,48,106,107,213,0.000333,0.396532,21,24981.53727,1387.863181,1189.597013,225.068365,11,0
0,0,25,25,14,28,42,76,78,154,0.000333,0.276806,14,11625.83636,645.879798,830.416883,187.908907,9,0
0,0,13,13,13,24,37,42,45,87,0.000333,0.151074,6,2719.334657,151.074148,453.222443,158.144816,7,0
0,0,8,8,13,15,28,25,22,47,0.000333,0.075315,6,1355.674088,75.315227,225.945681,106.709075,2,0
0,0,63,63,25,57,82,271,205,476,0.000333,1.008732,36,108943.0112,6052.389508,3026.194754,448.571136,25,0
0,0,14,14,14,31,45,61,54,115,0.000333,0.210521,7,4420.941743,245.607875,631.563106,206.883055,5,0
1,0,10,11,15,26,41,49,52,101,0.000333,0.180371,14,7575.578535,420.865474,541.112752,180.814792,4,0
0,0,7,7,13,17,30,25,27,52,0.000333,0.085053,6,1530.949866,85.05277,255.158311,117.592585,5,0
0,0,83,83,21,44,65,266,226,492,0.000333,0.987668,50,148150.2482,8230.569344,2963.004964,332.453657,20,0
0,0,74,74,21,43,64,238,205,443,0.000333,0.886,40,106320,5906.666667,2658,325.56805,18,0
0,0,9,9,14,23,37,32,38,70,0.000333,0.121554,7,2552.632149,141.812897,364.661736,157.344894,2,0
0,0,13,13,23,48,71,114,100,214,0.000333,0.438682,22,28953.00944,1608.500524,1316.045884,372.120125,10,0
0,0,16,16,23,52,75,129,111,240,0.000333,0.498305,22,32888.16269,1827.120149,1494.916486,400.46479,11,0
0,0,34,34,13,34,47,102,105,207,0.000333,0.383267,18,20696.39806,1149.799892,1149.799892,221.079453,6,0
0,0,34,34,13,35,48,109,107,216,0.000333,0.402117,18,21714.3342,1206.3519,1206.3519,227.630622,7,0
0,0,31,31,13,33,46,95,96,191,0.000333,0.351667,12,12660.004,703.333556,1055.000334,214.570722,6,0
0,0,31,31,13,33,46,95,96,191,0.000333,0.351667,12,12660.004,703.333556,1055.000334,214.570722,6,0
0,0,26,26,17,39,56,132,107,239,0.000333,0.462653,16,22207.32522,1233.74029,1387.957826,275.617555,5,0
0,0,21,21,17,37,54,108,89,197,0.000333,0.377904,16,18139.40541,1007.744745,1133.712838,262.236643,4,0
0,0,16,16,16,35,51,76,67,143,0.000333,0.270386,8,6489.254591,360.514144,811.156824,243.524906,3,0
0,0,17,17,15,27,42,72,64,136,0.000333,0.244452,14,10266.97237,570.387354,733.355169,186.985321,4,0
0,0,8,8,8,13,21,20,16,36,0.000333,0.052708,4,632.493709,35.138539,158.123427,72.105716,1,0
0,0,14,14,13,31,44,105,90,195,0.000333,0.354863,12,12775.06999,709.72611,1064.589166,201.685802,9,0
0,0,13,13,13,30,43,98,84,182,0.000333,0.329193,12,11850.96222,658.38679,987.580185,195.312434,9,0
0,0,12,12,13,27,40,87,76,163,0.000333,0.289158,12,10409.69135,578.316186,867.474279,176.487679,9,0
0,0,11,11,13,27,40,80,70,150,0.000333,0.266096,12,9579.470571,532.192809,798.289214,176.487679,9,0
0,0,6,6,13,20,33,38,38,76,0.000333,0.127791,6,2300.243718,127.791318,383.373953,134.544278,4,0
0,0,8,8,19,18,37,52,43,95,0.000333,0.164966,18,8908.165255,494.89807,494.89807,155.769273,5,0
0,0,10,10,20,23,43,69,56,125,0.000333,0.226094,20,13565.66189,753.647883,678.283094,190.480487,6,0
0,0,8,8,20,23,43,61,48,109,0.000333,0.197154,20,11829.25717,657.180954,591.462858,190.480487,5,0
0,0,29,29,21,42,63,162,130,292,0.000333,0.581789,30,52360.97213,2908.942896,1745.365738,318.715998,21,0
0,0,15,15,17,33,50,76,69,145,0.000333,0.272786,16,13093.74636,727.430353,818.359148,235.951874,10,0
0,0,12,12,14,22,36,58,41,99,0.000333,0.170608,7,3582.758026,199.042113,511.822575,151.410465,6,0
0,0,40,40,26,61,87,296,244,540,0.000333,1.15973,52,180917.8534,10050.99185,3479.189488,483.98641,15,0
0,0,34,34,25,57,82,238,199,437,0.000333,0.926083,36,100017.0081,5556.500452,2778.250226,448.571136,14,0
0,0,41,41,25,61,86,294,245,539,0.000333,1.154586,48,166260.3217,9236.684541,3463.756703,477.871382,15,0
0,0,35,35,24,57,81,239,201,440,0.000333,0.929845,36,100423.224,5579.068003,2789.534001,442.513831,14,0
0,0,13,13,16,35,51,87,83,170,0.000333,0.321437,16,15428.99693,857.166496,964.312308,243.524906,6,0
0,0,28,28,19,47,66,182,159,341,0.000333,0.687046,27,55650.73666,3091.707592,2061.138395,341.776299,13,0
0,0,28,28,19,47,66,182,159,341,0.000333,0.687046,27,55650.73666,3091.707592,2061.138395,341.776299,13,0
0,0,28,28,19,47,66,182,159,341,0.000333,0.687046,27,55650.73666,3091.707592,2061.138395,341.776299,13,0
0,0,28,28,19,47,66,182,159,341,0.000333,0.687046,27,55650.73666,3091.707592,2061.138395,341.776299,13,0
0,0,17,17,16,42,58,116,108,224,0.000333,0.437396,16,20995.00389,1166.389105,1312.187743,290.477332,8,0
0,0,15,15,16,37,53,100,94,194,0.000333,0.370406,16,17779.46509,987.748061,1111.216568,256.749775,7,0
0,0,11,11,16,31,47,80,75,155,0.000333,0.286987,16,13775.38035,765.298908,860.961272,217.580086,6,0
0,0,8,8,12,26,38,42,47,89,0.000333,0.155689,6,2802.393292,155.688516,467.065549,165.230983,3,0
0,0,5,5,12,19,31,23,28,51,0.000333,0.084221,6,1515.984071,84.221337,252.664012,123.730173,2,0
0,0,5,5,12,19,31,23,28,51,0.000333,0.084221,6,1515.984071,84.221337,252.664012,123.730173,2,0
0,0,120,120,35,66,101,533,363,896,0.000333,1.988586,85,507089.3865,28171.63259,5965.757489,578.454917,72,0
0,0,120,120,35,66,101,533,363,896,0.000333,1.988586,85,507089.3865,28171.63259,5965.757489,578.454917,72,0
0,0,66,66,34,53,87,321,224,545,0.000333,1.170468,68,238775.486,13265.30478,3511.404205,476.553521,48,0
0,0,24,24,26,35,61,121,92,213,0.000333,0.421082,26,32844.42338,1824.690188,1263.247053,301.736338,22,0
0,0,48,48,33,47,80,249,178,427,0.000333,0.899821,48,129574.2382,7198.568791,2699.463297,427.530682,40,0
0,0,35,35,30,44,74,189,140,329,0.000333,0.68097,45,91930.95708,5107.275393,2042.910157,387.421709,31,0
0,0,34,34,30,42,72,177,134,311,0.000333,0.639616,45,86348.1004,4797.116689,1918.846675,373.68405,28,0
0,0,33,33,30,41,71,174,130,304,0.000333,0.623174,45,84128.5406,4673.807811,1869.523124,366.86635,28,0
0,0,13,13,21,22,43,57,46,103,0.000333,0.186302,20,11178.1054,621.005855,558.90527,190.346161,11,0
0,0,4,4,13,13,26,19,17,36,0.000333,0.056405,6,1015.294979,56.405277,169.21583,96.211433,4,0
0,0,2,2,11,12,23,14,14,28,0.000333,0.04222,5,633.298674,35.18326,126.659735,81.073298,1,0
0,0,63,63,28,71,99,413,343,756,0.000333,1.670598,56,280660.4419,15592.24677,5011.793605,571.237983,19,0
0,0,53,53,28,69,97,346,290,636,0.000333,1.399182,56,235062.4958,13059.02754,4197.544568,556.094125,16,0
0,0,43,43,26,64,90,280,234,514,0.000333,1.112271,39,130135.6872,7229.760398,3336.812492,506.211433,14,0
0,0,21,21,22,38,60,127,106,233,0.000333,0.458769,22,30278.72119,1682.151177,1376.305509,297.528741,10,0
0,0,9,9,17,27,44,60,51,111,0.000333,0.201999,8,4847.975277,269.33196,605.99691,197.868831,3,0
0,0,7,7,16,24,40,52,46,98,0.000333,0.17385,8,4172.391626,231.799535,521.548953,174.0391,3,0
0,0,108,108,26,45,71,428,310,738,0.000333,1.512838,78,354004.0432,19666.89129,4538.513374,369.344822,28,0
0,0,107,107,26,45,71,424,307,731,0.000333,1.498488,78,350646.2813,19480.34896,4495.465144,369.344822,28,0
0,0,106,106,26,45,71,420,304,724,0.000333,1.484139,78,347288.5193,19293.80663,4452.416915,369.344822,28,0
0,0,105,105,26,45,71,416,301,717,0.000333,1.46979,78,343930.7574,19107.2643,4409.368685,369.344822,28,0
0,0,104,104,26,45,71,412,298,710,0.000333,1.45544,78,340572.9955,18920.72197,4366.320455,369.344822,28,0
0,0,104,104,26,45,71,412,298,710,0.000333,1.45544,78,340572.9955,18920.72197,4366.320455,369.344822,28,0
0,0,104,104,26,45,71,412,298,710,0.000333,1.45544,78,340572.9955,18920.72197,4366.320455,369.344822,28,0
0,0,104,104,26,45,71,412,298,710,0.000333,1.45544,78,340572.9955,18920.72197,4366.320455,369.344822,28,0
0,0,61,61,30,54,84,281,213,494,0.000333,1.052602,45,142101.2163,7894.512017,3157.804807,457.970643,25,0
0,0,6,6,11,13,24,28,28,56,0.000333,0.085586,10,2567.579,142.643278,256.7579,86.159464,4,0
0,0,5,5,11,12,23,23,23,46,0.000333,0.069361,5,1040.41925,57.801069,208.08385,81.073298,4,0
0,0,10,10,11,20,31,39,36,75,0.000333,0.123855,5,1857.823616,103.212423,371.564723,124.49231,4,0
0,0,10,10,18,26,44,64,49,113,0.000333,0.205639,9,5552.241956,308.457886,616.915773,197.270083,7,0
1,0,7,8,12,12,24,44,24,68,0.000333,0.103926,12,3741.329401,207.851633,311.77745,86.0391,2,0
0,0,4,4,10,10,20,19,13,32,0.000333,0.046101,5,691.508495,38.417139,138.301699,66.438562,1,0
0,0,59,59,20,41,61,239,171,410,0.000333,0.810534,40,97264.09234,5403.560685,2431.602308,306.098194,15,0
0,0,8,8,19,21,40,63,40,103,0.000333,0.18272,9,4933.427344,274.079297,548.158594,172.949289,5,0
0,0,129,129,28,91,119,514,438,952,0.000333,2.187956,56,367576.5246,20420.91803,6563.866511,726.81525,41,0
0,0,129,129,28,91,119,514,438,952,0.000333,2.187956,56,367576.5246,20420.91803,6563.866511,726.81525,41,0
0,0,129,129,28,91,119,514,438,952,0.000333,2.187956,56,367576.5246,20420.91803,6563.866511,726.81525,41,0
0,0,110,110,28,78,106,431,363,794,0.000333,1.780656,56,299150.2551,16619.45862,5341.968841,624.867311,39,0
0,0,110,110,28,78,106,431,363,794,0.000333,1.780656,56,299150.2551,16619.45862,5341.968841,624.867311,39,0
0,0,110,110,28,78,106,431,363,794,0.000333,1.780656,56,299150.2551,16619.45862,5341.968841,624.867311,39,0
0,0,117,117,28,86,114,466,395,861,0.000333,1.961039,56,329454.6249,18303.03472,5883.118302,687.264707,39,0
0,0,112,112,28,82,110,441,372,813,0.000333,1.837748,56,308741.745,17152.31917,5513.245447,655.925202,39,0
0,0,32,32,23,44,67,143,130,273,0.000333,0.552014,22,36432.93168,2024.05176,1656.042349,344.256916,11,0
0,0,12,12,16,26,42,50,43,93,0.000333,0.167162,8,4011.884163,222.882453,501.48552,186.211433,2,0
1,0,13,14,20,32,52,86,64,150,0.000333,0.285022,20,17101.31915,950.073286,855.065958,246.438562,21,0
1,0,15,16,21,34,55,91,70,161,0.000333,0.310266,20,18615.97828,1034.221015,930.798914,265.212402,22,0
1,0,6,7,10,19,29,31,28,59,0.000333,0.09554,5,1433.104394,79.616911,286.620879,113.929904,5,0
0,0,10,10,13,18,31,31,27,58,0.000333,0.095781,6,1724.060316,95.781129,287.343386,123.164366,5,0
0,0,10,10,12,22,34,49,44,93,0.000333,0.157711,12,5677.608531,315.422696,473.134044,141.127046,2,0
0,0,10,10,12,24,36,38,37,75,0.000333,0.129248,6,2326.466251,129.248125,387.744375,153.05865,2,0
0,0,10,10,18,33,51,72,57,129,0.000333,0.243914,9,6585.685822,365.871435,731.742869,241.523656,6,0
0,0,10,10,18,33,51,72,57,129,0.000333,0.243914,9,6585.685822,365.871435,731.742869,241.523656,6,0
0,0,16,16,12,45,57,90,80,170,0.000333,0.33053,6,5949.547814,330.530434,991.591302,290.152939,6,0
0,0,3,3,9,23,32,24,27,51,0.000333,0.085,4,1020,56.666667,255,132.57125,1,0
0,0,16,16,15,48,63,86,78,164,0.000333,0.326758,7,6861.917352,381.217631,980.273907,326.681559,4,0
0,0,11,11,12,36,48,55,59,114,0.000333,0.212229,6,3820.11435,212.228575,636.685725,229.13685,3,0
0,0,9,9,12,34,46,47,52,99,0.000333,0.182278,6,3280.995802,182.277545,546.832634,215.993287,2,0
0,0,15,15,13,40,53,69,69,138,0.000333,0.263484,6,4742.718136,263.484341,790.453023,260.98284,4,0
0,0,11,11,12,33,45,52,56,108,0.000333,0.197707,6,3558.720806,197.706711,593.120134,209.484556,3,0
0,0,9,9,11,31,42,44,49,93,0.000333,0.167162,5,2507.427602,139.301533,501.48552,191.633833,2,0
0,0,4,4,9,16,25,15,19,34,0.000333,0.05263,4,631.564442,35.086913,157.89111,92.529325,1,0
0,0,7,7,11,15,26,25,25,50,0.000333,0.078341,5,1175.10993,65.283885,235.021986,96.657107,3,0
1,0,31,32,23,53,76,210,166,376,0.000333,0.783074,33,77524.28459,4306.904699,2349.220745,407.621709,15,0
1,0,31,32,23,53,76,210,166,376,0.000333,0.783074,33,77524.28459,4306.904699,2349.220745,407.621709,15,0
1,0,11,12,19,23,42,56,48,104,0.000333,0.186934,18,10094.41822,560.801012,560.801012,184.752548,7,0
1,0,10,11,20,22,42,55,45,100,0.000333,0.179744,20,10784.63485,599.14638,539.231742,184.546058,7,0
1,0,10,11,18,19,37,51,43,94,0.000333,0.16323,18,8814.395095,489.688616,489.688616,155.769273,7,0
1,0,9,10,20,20,40,45,37,82,0.000333,0.145466,10,4363.981038,242.443391,436.398104,172.877124,6,0
1,0,9,10,18,17,35,41,35,76,0.000333,0.129942,18,7016.859167,389.825509,389.825509,144.545518,6,0
0,0,6,6,17,18,35,41,32,73,0.000333,0.124813,8,2995.501282,166.416738,374.43766,144.545518,2,0
0,0,7,7,12,23,35,26,30,56,0.000333,0.095747,6,1723.439094,95.746616,287.239849,147.061475,1,0
0,0,3,3,15,18,33,27,24,51,0.000333,0.085755,7,1800.848701,100.04715,257.2641,133.662009,1,0
0,0,51,51,29,74,103,282,229,511,0.000333,1.138934,42,143505.6743,7972.537462,3416.801769,600.380998,24,0
0,0,32,32,25,36,61,146,106,252,0.000333,0.498182,24,35869.09942,1992.727745,1494.545809,302.213705,12,0
0,0,11,11,17,16,33,52,37,89,0.000333,0.14965,16,7183.217226,399.067624,448.951077,133.486868,4,0
1,0,39,40,26,40,66,200,147,347,0.000333,0.699135,39,81798.78562,4544.376979,2097.404759,335.088556,13,0
1,0,36,37,26,40,66,188,140,328,0.000333,0.660854,39,77319.88958,4295.549421,1982.561271,335.088556,12,0
1,0,36,37,26,40,66,188,140,328,0.000333,0.660854,39,77319.88958,4295.549421,1982.561271,335.088556,12,0
1,0,36,37,26,40,66,188,140,328,0.000333,0.660854,39,77319.88958,4295.549421,1982.561271,335.088556,12,0
1,0,36,37,26,40,66,188,140,328,0.000333,0.660854,39,77319.88958,4295.549421,1982.561271,335.088556,12,0
1,0,8,9,13,20,33,30,32,62,0.000333,0.104251,6,1876.514612,104.250812,312.752435,134.544278,2,0
1,0,9,10,14,26,40,56,52,108,0.000333,0.191589,14,8046.755279,447.04196,574.768234,175.514402,3,0
1,0,8,9,14,23,37,43,44,87,0.000333,0.151074,7,3172.5571,176.253172,453.222443,157.344894,3,0
0,0,10,10,10,18,28,36,34,70,0.000333,0.112172,5,1682.574223,93.476346,336.514845,108.277931,4,0
0,0,51,51,20,40,60,209,146,355,0.000333,0.698982,30,62908.38484,3494.910269,2096.946161,299.315686,20,0
0,0,50,50,20,40,60,205,143,348,0.000333,0.685199,30,61667.93782,3425.996545,2055.597927,299.315686,20,0
0,0,49,49,20,40,60,201,140,341,0.000333,0.671417,30,60427.49079,3357.082822,2014.249693,299.315686,20,0
0,0,48,48,20,40,60,197,137,334,0.000333,0.657634,30,59187.04377,3288.169098,1972.901459,299.315686,20,0
0,0,48,48,20,40,60,197,137,334,0.000333,0.657634,30,59187.04377,3288.169098,1972.901459,299.315686,20,0
0,0,11,11,11,30,41,53,49,102,0.000333,0.182157,5,2732.351522,151.797307,546.470304,185.260466,2,0
0,0,11,11,11,30,41,53,49,102,0.000333,0.182157,5,2732.351522,151.797307,546.470304,185.260466,2,0
0,0,10,10,11,29,40,50,45,95,0.000333,0.168528,5,2527.915845,140.439769,505.583169,178.935197,2,0
0,0,8,8,10,25,35,39,34,73,0.000333,0.124813,5,1872.188301,104.010461,374.43766,149.315686,2,0
0,0,4,4,8,17,25,19,18,37,0.000333,0.057274,4,687.290716,38.182818,171.822679,93.486868,1,0
0,0,33,33,24,57,81,173,158,331,0.000333,0.699497,24,50363.76842,2797.987135,2098.490351,442.513831,12,0
0,0,33,33,24,55,79,174,153,327,0.000333,0.687112,24,49472.07131,2748.448406,2061.336305,428.013884,12,0
0,0,29,29,22,45,67,130,114,244,0.000333,0.493375,22,32562.76677,1809.042599,1480.125762,345.240885,15,0
0,0,13,13,18,29,47,71,48,119,0.000333,0.220332,9,5948.96466,330.498037,660.996073,215.940099,7,0
0,0,8,8,9,17,26,24,30,54,0.000333,0.084608,4,1015.294979,56.405277,253.823745,98.016193,2,0
0,0,8,8,9,17,26,24,30,54,0.000333,0.084608,4,1015.294979,56.405277,253.823745,98.016193,2,0
0,0,20,20,27,44,71,125,106,231,0.000333,0.473531,26,36935.3812,2051.965622,1420.591585,368.596954,9,0
0,0,23,23,26,47,73,147,119,266,0.000333,0.548831,26,42808.82665,2378.268147,1646.493333,383.277109,10,0
0,0,7,7,14,27,41,44,43,87,0.000333,0.155369,7,3262.749171,181.263843,466.107024,181.684931,5,0
0,0,7,7,14,27,41,40,41,81,0.000333,0.144654,7,3037.731987,168.762888,433.961712,181.684931,5,0
1,0,19,20,17,34,51,115,72,187,0.000333,0.353581,16,16971.89662,942.883146,1060.743539,242.460605,12,0
0,0,4,4,12,13,25,26,20,46,0.000333,0.071206,6,1281.704308,71.205795,213.617385,91.125266,2,0
0,0,7,7,12,21,33,40,36,76,0.000333,0.127791,6,2300.243718,127.791318,383.373953,135.258216,2,0
0,0,4,4,9,22,31,31,33,64,0.000333,0.10569,4,1268.274255,70.459681,317.068564,126.636821,2,0
0,0,4,4,9,17,26,22,24,46,0.000333,0.072073,4,864.880908,48.048939,216.220227,98.016193,1,0
0,0,3,3,8,15,23,17,20,37,0.000333,0.055791,4,669.487169,37.193732,167.371792,82.603359,1,0
0,0,3,3,8,15,23,19,21,40,0.000333,0.060314,4,723.769913,40.20944,180.942478,82.603359,1,0
0,0,18,18,16,29,45,74,65,139,0.000333,0.254456,16,12213.88129,678.54896,763.36758,204.881449,5,0
0,0,18,18,16,29,45,74,65,139,0.000333,0.254456,16,12213.88129,678.54896,763.36758,204.881449,5,0
0,0,7,7,12,21,33,40,36,76,0.000333,0.127791,6,2300.243718,127.791318,383.373953,135.258216,2,0
0,0,4,4,9,22,31,31,33,64,0.000333,0.10569,4,1268.274255,70.459681,317.068564,126.636821,2,0
0,0,4,4,9,17,26,22,24,46,0.000333,0.072073,4,864.880908,48.048939,216.220227,98.016193,1,0
0,0,3,3,8,15,23,17,20,37,0.000333,0.055791,4,669.487169,37.193732,167.371792,82.603359,1,0
0,0,3,3,8,15,23,19,21,40,0.000333,0.060314,4,723.769913,40.20944,180.942478,82.603359,1,0
0,0,18,18,16,29,45,74,65,139,0.000333,0.254456,16,12213.88129,678.54896,763.36758,204.881449,5,0
0,0,18,18,16,29,45,74,65,139,0.000333,0.254456,16,12213.88129,678.54896,763.36758,204.881449,5,0
0,0,6,6,12,15,27,26,24,50,0.000333,0.079248,6,1426.466251,79.248125,237.744375,101.622909,6,0
0,0,10,10,12,16,28,28,29,57,0.000333,0.09134,6,1644.115383,91.339744,274.019231,107.01955,2,0
0,0,7,7,9,19,28,24,28,52,0.000333,0.083327,4,999.929824,55.551657,249.982456,109.239948,8,0
0,0,13,13,16,30,46,66,52,118,0.000333,0.21726,8,5214.242487,289.680138,651.780311,211.206718,4,0
0,0,12,12,15,28,43,60,46,106,0.000333,0.191728,7,4026.288448,223.682692,575.184064,193.209297,4,0
0,0,18,18,17,39,56,100,71,171,0.000333,0.331019,8,7944.461533,441.358974,993.057692,275.617555,3,0
0,0,17,17,17,38,55,93,66,159,0.000333,0.306412,8,7353.889556,408.54942,919.236194,268.908114,3,0
0,0,24,24,19,48,67,142,96,238,0.000333,0.481243,18,25987.12609,1443.729227,1443.729227,348.788823,7,0
0,0,6,6,12,20,32,33,27,60,0.000333,0.1,6,1800,100,300,129.458112,1,0
0,0,6,6,13,18,31,35,24,59,0.000333,0.097433,6,1753.785494,97.432527,292.297582,123.164366,2,0
0,0,8,8,14,24,38,39,33,72,0.000333,0.12595,7,2644.955467,146.94197,377.850781,163.342069,2,0
0,0,8,8,15,17,32,44,34,78,0.000333,0.13,14,5460,303.333333,390,128.090227,4,0
0,0,5,5,8,14,22,15,23,38,0.000333,0.056486,4,677.833606,37.657423,169.458402,77.302969,2,0
0,0,5,5,8,13,21,15,23,38,0.000333,0.055636,4,667.632248,37.09068,166.908062,72.105716,2,0
0,0,15,15,16,34,50,80,53,133,0.000333,0.250211,8,6005.062986,333.61461,750.632873,236.973737,6,0
0,0,14,14,16,31,47,68,48,116,0.000333,0.214777,8,5154.658454,286.369914,644.332307,217.580086,6,0
0,0,64,64,25,68,93,396,305,701,0.000333,1.527983,48,220029.6157,12223.86754,4583.950327,530.043878,25,0
0,0,64,64,25,68,93,396,305,701,0.000333,1.527983,48,220029.6157,12223.86754,4583.950327,530.043878,25,0
0,0,64,64,25,68,93,396,305,701,0.000333,1.527983,48,220029.6157,12223.86754,4583.950327,530.043878,25,0
0,0,33,33,26,63,89,169,151,320,0.000333,0.690745,26,53878.10215,2993.227897,2072.234698,498.780068,7,0
0,0,31,31,22,61,83,148,132,280,0.000333,0.595004,22,39270.2429,2181.680161,1785.011041,459.882473,8,0
0,0,28,28,22,57,79,133,122,255,0.000333,0.535821,22,35364.21,1964.678333,1607.464091,430.582226,8,0
0,0,4,4,8,20,28,18,24,42,0.000333,0.067303,4,807.635627,44.868646,201.908907,110.438562,1,0
0,0,4,4,16,14,30,26,23,49,0.000333,0.080146,8,1923.501113,106.861173,240.437639,117.302969,3,0
0,0,74,74,24,102,126,436,377,813,0.000333,1.890843,36,204211.0288,11345.05716,5672.528578,790.626485,51,0
0,0,74,74,24,102,126,436,377,813,0.000333,1.890843,36,204211.0288,11345.05716,5672.528578,790.626485,51,0
0,0,56,56,30,72,102,294,239,533,0.000333,1.185468,45,160038.1218,8891.006768,3556.402707,591.441318,27,0
0,0,62,62,30,72,102,310,255,565,0.000333,1.25664,45,169646.4143,9424.800796,3769.920318,591.441318,27,0
0,0,41,41,24,66,90,242,198,440,0.000333,0.952138,36,102830.953,5712.830725,2856.415362,508.969112,22,0
0,0,32,32,23,52,75,187,156,343,0.000333,0.712162,33,70503.99876,3916.88882,2136.484811,400.46479,20,0
0,0,20,20,21,50,71,143,121,264,0.000333,0.541178,20,32470.66479,1803.925822,1623.53324,374.431475,16,0
0,0,19,19,18,38,56,118,102,220,0.000333,0.425873,18,22997.12549,1277.618083,1277.618083,274.479896,14,0
0,0,19,19,18,38,56,118,102,220,0.000333,0.425873,18,22997.12549,1277.618083,1277.618083,274.479896,14,0
0,0,39,39,28,50,78,255,187,442,0.000333,0.926049,42,116682.2068,6482.344822,2778.147781,416.798747,19,0
0,0,37,37,28,50,78,241,176,417,0.000333,0.873671,42,110082.5345,6115.696359,2621.012725,416.798747,18,0
0,0,35,35,28,49,77,227,165,392,0.000333,0.81886,42,103176.3736,5732.020756,2456.580324,409.72672,17,0
0,0,33,33,27,47,74,213,154,367,0.000333,0.759623,39,88875.90602,4937.550335,2278.869385,389.447639,16,0
0,0,3,3,9,13,22,16,19,35,0.000333,0.052027,4,624.320427,34.684468,156.080107,76.635041,1,0
0,0,63,63,22,104,126,302,254,556,0.000333,1.293123,22,85346.08802,4741.449335,3879.367637,794.953226,13,0
0,0,49,49,21,90,111,232,194,426,0.000333,0.964807,20,57888.42318,3216.02351,2894.421159,676.505445,9,0
0,0,49,49,21,90,111,232,194,426,0.000333,0.964807,20,57888.42318,3216.02351,2894.421159,676.505445,9,0
0,0,23,23,14,55,69,108,92,200,0.000333,0.407235,7,8551.934239,475.107458,1221.704891,371.277753,5,0
0,0,9,9,12,33,45,56,44,100,0.000333,0.183062,6,3295.111858,183.06177,549.18531,209.484556,5,0
1,0,5,6,8,13,21,14,19,33,0.000333,0.048315,4,579.7859,32.210328,144.946475,72.105716,2,0
0,0,17,17,21,50,71,76,91,167,0.000333,0.342336,10,10270.07769,570.559872,1027.007769,374.431475,8,0
0,0,17,17,21,50,71,76,91,167,0.000333,0.342336,10,10270.07769,570.559872,1027.007769,374.431475,8,0
0,0,13,13,16,34,50,62,59,121,0.000333,0.227636,8,5463.252792,303.514044,682.906599,236.973737,6,0
0,0,12,12,16,32,48,56,53,109,0.000333,0.20292,8,4870.087301,270.560406,608.760913,224,6,0
0,0,35,35,25,64,89,214,159,373,0.000333,0.80515,24,57970.76567,3220.598093,2415.44857,500.096405,23,0
0,0,20,20,24,38,62,120,85,205,0.000333,0.40687,24,29294.64585,1627.480325,1220.610244,309.460346,13,0
0,0,18,18,23,38,61,101,72,173,0.000333,0.342006,11,11286.19315,627.010731,1026.017559,303.463171,11,0
0,0,62,62,25,104,129,315,266,581,0.000333,1.357841,24,97764.55285,5431.364047,4073.523035,812.942135,37,0
0,0,24,24,22,50,72,136,123,259,0.000333,0.53267,22,35156.23266,1953.124037,1598.010575,380.300305,19,0
0,0,18,18,13,31,44,76,72,148,0.000333,0.269332,12,9695.950555,538.66392,807.99588,201.685802,4,0
0,0,19,19,13,32,45,82,78,160,0.000333,0.292899,12,10544.35795,585.797664,878.696495,208.105716,4,0
0,0,16,16,13,30,43,66,65,131,0.000333,0.236947,12,8530.088194,473.893789,710.840683,195.312434,3,0
0,0,5,5,9,19,28,23,28,51,0.000333,0.081725,4,980.700404,54.483356,245.175101,109.239948,1,0
0,0,29,29,16,39,55,127,116,243,0.000333,0.46829,16,22477.92657,1248.773698,1404.87041,270.130687,7,0
0,0,18,18,17,35,52,77,63,140,0.000333,0.266021,8,6384.492484,354.694027,798.061561,249.011774,6,0
0,0,20,20,19,32,51,88,87,175,0.000333,0.330891,18,17868.13983,992.674435,992.674435,240.710623,3,0
0,0,16,16,19,28,47,62,66,128,0.000333,0.236996,18,12797.77271,710.987373,710.987373,215.316561,3,0
0,0,16,16,19,28,47,62,66,128,0.000333,0.236996,18,12797.77271,710.987373,710.987373,215.316561,3,0
0,0,11,11,13,23,36,38,45,83,0.000333,0.143035,6,2574.622651,143.034592,429.103775,152.147641,2,0
0,0,46,46,32,73,105,278,197,475,0.000333,1.063089,32,102056.5319,5669.807326,3189.266621,611.857193,21,0
0,0,51,51,25,54,79,255,198,453,0.000333,0.951871,36,102802.0564,5711.225358,2855.612679,426.86033,19,0
0,0,51,51,25,54,79,255,198,453,0.000333,0.951871,36,102802.0564,5711.225358,2855.612679,426.86033,19,0
0,0,51,51,25,54,79,255,198,453,0.000333,0.951871,36,102802.0564,5711.225358,2855.612679,426.86033,19,0
0,0,13,13,15,31,46,78,65,143,0.000333,0.26329,14,11058.17104,614.342835,789.86936,212.183445,4,0
0,0,10,10,14,31,45,63,54,117,0.000333,0.214182,7,4497.827686,249.879316,642.546812,206.883055,3,0
0,0,8,8,14,24,38,50,42,92,0.000333,0.160936,7,3379.665319,187.759184,482.809331,163.342069,3,0
0,0,3,3,10,16,26,21,23,44,0.000333,0.06894,5,1034.096738,57.449819,206.819348,97.219281,1,0
0,0,12,12,14,26,40,66,48,114,0.000333,0.202233,7,4246.89862,235.938812,606.699803,175.514402,3,0
0,0,36,36,25,44,69,155,135,290,0.000333,0.590491,36,63772.99533,3542.944185,1771.472092,356.311396,15,0
0,0,38,38,27,45,72,162,142,304,0.000333,0.625219,39,73150.63082,4063.923934,1875.6572,375.515352,15,0
1,0,9,10,16,35,51,59,54,113,0.000333,0.213661,8,5127.872509,284.881806,640.984064,243.524906,2,0
0,0,9,9,16,35,51,59,55,114,0.000333,0.215552,8,5173.251912,287.402884,646.656489,243.524906,2,0
0,0,17,17,17,44,61,90,86,176,0.000333,0.347937,8,8350.478171,463.915454,1043.809771,309.70186,4,0
0,0,13,13,17,39,56,73,70,143,0.000333,0.276817,8,6643.614031,369.089668,830.451754,275.617555,3,0
0,0,12,12,17,40,57,71,67,138,0.000333,0.268313,8,6439.510576,357.750588,804.938822,282.363992,3,0
0,0,10,10,16,34,50,62,55,117,0.000333,0.22011,8,5282.649394,293.480522,660.331174,236.973737,3,0
0,0,10,10,16,35,51,68,59,127,0.000333,0.240133,8,5763.184147,320.176897,720.398018,243.524906,3,0
0,0,7,7,12,28,40,40,40,80,0.000333,0.141918,6,2554.525486,141.918083,425.754248,177.625488,1,0
0,0,61,61,24,65,89,422,309,731,0.000333,1.57792,48,227220.5346,12623.36304,4733.761138,501.493008,47,0
0,0,41,41,22,56,78,171,164,335,0.000333,0.70187,22,46323.41435,2573.52302,2105.609743,423.319371,15,0
0,0,19,19,20,36,56,91,75,166,0.000333,0.32134,20,19280.41834,1071.134352,964.020917,272.555862,4,0
0,0,18,18,20,30,50,77,64,141,0.000333,0.265261,20,15915.67446,884.204136,795.783723,233.64528,4,0
0,0,15,15,20,27,47,62,52,114,0.000333,0.211074,10,6332.231291,351.790627,633.223129,214.820524,4,0
0,0,17,17,20,28,48,68,57,125,0.000333,0.232707,20,13962.40625,775.689236,698.120313,221.0445,4,0
0,0,51,51,27,47,74,233,195,428,0.000333,0.885882,52,138197.5941,7677.644117,2657.64604,389.447639,36,0
0,0,11,11,15,25,40,40,41,81,0.000333,0.143692,7,3017.53323,167.640735,431.076176,174.699764,6,0
0,0,6,6,8,24,32,27,29,56,0.000333,0.093333,4,1120,62.222222,280,134.0391,1,0
0,0,25,25,13,55,68,134,124,258,0.000333,0.523522,12,18846.78496,1047.043609,1570.565413,366.080501,3,0
0,0,19,19,13,48,61,92,87,179,0.000333,0.353867,6,6369.611901,353.867328,1061.601983,316.183916,3,0
0,0,22,22,13,51,64,108,101,209,0.000333,0.418,6,7524,418,1254,337.399409,3,0
0,0,15,15,13,40,53,73,70,143,0.000333,0.273031,6,4914.55575,273.030875,819.092625,260.98284,3,0
0,0,14,14,12,34,46,54,54,108,0.000333,0.198848,6,3579.268148,198.84823,596.544691,215.993287,2,0
0,0,10,10,12,30,42,45,44,89,0.000333,0.159972,6,2879.497504,159.972084,479.916251,190.226268,2,0
0,0,16,16,16,23,39,54,47,101,0.000333,0.177942,16,8541.209986,474.511666,533.825624,168.041925,4,0
0,0,24,24,18,33,51,85,65,150,0.000333,0.283621,9,7657.774212,425.431901,850.863801,241.523656,13,0
0,0,10,10,12,22,34,43,39,82,0.000333,0.139057,6,2503.031718,139.057318,417.171953,141.127046,2,0
0,0,15,15,14,27,41,62,58,120,0.000333,0.214302,14,9000.687368,500.038187,642.906241,181.684931,3,0
0,0,10,10,12,22,34,43,39,82,0.000333,0.139057,6,2503.031718,139.057318,417.171953,141.127046,2,0
0,0,15,15,14,27,41,62,58,120,0.000333,0.214302,14,9000.687368,500.038187,642.906241,181.684931,3,0
0,0,11,11,13,24,37,55,54,109,0.000333,0.189277,12,6813.965002,378.553611,567.830417,158.144816,6,0
0,0,8,8,12,20,32,35,38,73,0.000333,0.121667,6,2190,121.666667,365,129.458112,4,0
0,0,6,6,12,16,28,21,26,47,0.000333,0.075315,6,1355.674088,75.315227,225.945681,107.01955,3,0
0,0,6,6,15,20,35,70,48,118,0.000333,0.201752,14,8473.575544,470.754197,605.255396,145.041921,2,0
0,0,6,6,15,20,35,70,48,118,0.000333,0.201752,14,8473.575544,470.754197,605.255396,145.041921,2,0
0,0,14,14,13,30,43,106,90,196,0.000333,0.354516,18,19143.86206,1063.547892,1063.547892,195.312434,9,0
0,0,13,13,13,29,42,99,84,183,0.000333,0.328931,12,11841.52906,657.862726,986.794088,188.987165,9,0
0,0,12,12,12,26,38,88,76,164,0.000333,0.286887,12,10327.92135,573.773408,860.660112,165.230983,9,0
0,0,11,11,12,26,38,81,70,151,0.000333,0.264146,12,9509.244654,528.29137,792.437055,165.230983,9,0
0,0,6,6,12,19,31,39,38,77,0.000333,0.127158,12,4577.677391,254.315411,381.473116,123.730173,4,0
0,0,52,52,28,54,82,297,236,533,0.000333,1.129525,56,189760.2122,10542.23401,3388.575218,445.369863,57,0
0,0,6,6,15,18,33,68,44,112,0.000333,0.188324,14,7909.609979,439.422777,564.972141,133.662009,2,0
0,0,6,6,15,18,33,68,44,112,0.000333,0.188324,14,7909.609979,439.422777,564.972141,133.662009,2,0
0,0,7,7,18,20,38,85,51,136,0.000333,0.237906,18,12846.92655,713.718142,713.718142,161.497212,4,0
0,0,7,7,18,20,38,85,51,136,0.000333,0.237906,18,12846.92655,713.718142,713.718142,161.497212,4,0
0,0,6,6,15,21,36,39,37,76,0.000333,0.130971,7,2750.400101,152.800006,392.9143,150.842025,4,0
0,0,9,9,15,27,42,56,47,103,0.000333,0.185136,7,3887.860862,215.99227,555.408695,186.985321,2,0
0,0,7,7,14,24,38,48,42,90,0.000333,0.157438,7,3306.194333,183.677463,472.313476,163.342069,2,0
0,0,8,8,17,18,35,38,30,68,0.000333,0.116264,8,2790.329961,155.018331,348.791245,144.545518,4,0
0,0,2,2,8,9,17,13,12,25,0.000333,0.034062,4,408.746284,22.708127,102.186571,52.529325,1,0
0,0,8,8,17,18,35,38,30,68,0.000333,0.116264,8,2790.329961,155.018331,348.791245,144.545518,4,0
0,0,2,2,8,9,17,13,12,25,0.000333,0.034062,4,408.746284,22.708127,102.186571,52.529325,1,0
0,0,5,5,11,14,25,23,19,42,0.000333,0.065014,5,975.2098,54.178322,195.04196,91.356717,2,0
0,0,14,14,17,25,42,76,54,130,0.000333,0.233667,16,11216.02024,623.112236,701.001265,185.583273,9,0
0,0,43,43,24,55,79,179,146,325,0.000333,0.68291,24,49169.48984,2731.638324,2048.728743,428.013884,15,0
0,0,43,43,24,55,79,179,146,325,0.000333,0.68291,24,49169.48984,2731.638324,2048.728743,428.013884,15,0
0,0,40,40,19,71,90,183,154,337,0.000333,0.729251,18,39379.58088,2187.754493,2187.754493,517.342668,25,0
0,0,14,14,22,40,62,107,76,183,0.000333,0.363206,11,11985.79717,665.877621,1089.617925,310.984619,7,0
0,0,9,9,16,26,42,70,48,118,0.000333,0.212098,8,5090.347647,282.797092,636.293456,186.211433,7,0
0,0,7,7,15,26,41,60,43,103,0.000333,0.183943,7,3862.794995,214.599722,551.827856,180.814792,6,0
0,0,5,5,14,20,34,40,32,72,0.000333,0.122099,7,2564.081272,142.44896,366.297325,139.741531,4,0
0,0,13,13,15,28,43,50,47,97,0.000333,0.175449,7,3684.433768,204.690765,526.347681,193.209297,3,0
0,0,10,10,14,25,39,47,44,91,0.000333,0.160324,7,3366.801213,187.044512,480.971602,169.399374,4,0
0,0,7,7,13,23,36,35,34,69,0.000333,0.118908,6,2140.348951,118.908275,356.724825,152.147641,3,0
0,0,14,14,18,25,43,79,61,140,0.000333,0.253226,18,13674.18718,759.677066,759.677066,191.155055,8,0
0,0,7,7,14,21,35,37,31,68,0.000333,0.116264,7,2441.538716,135.64104,348.791245,145.541635,2,0
0,0,10,10,15,24,39,46,40,86,0.000333,0.151515,7,3181.812136,176.767341,454.544591,168.642459,3,0
1,0,12,13,10,24,34,21,31,52,0.000333,0.088183,5,1322.740339,73.485574,264.548068,143.258381,1,0
0,0,19,19,13,32,45,95,78,173,0.000333,0.316697,12,11401.08703,633.393724,950.090586,208.105716,6,0
0,0,18,18,13,31,44,90,73,163,0.000333,0.296629,12,10678.64825,593.258236,889.887354,201.685802,6,0
0,0,17,17,13,30,43,85,68,153,0.000333,0.27674,12,9962.62209,553.479005,830.218507,195.312434,6,0
0,0,16,16,13,29,42,80,63,143,0.000333,0.257034,12,9253.216697,514.067594,771.101391,188.987165,6,0
0,0,11,11,13,24,37,48,38,86,0.000333,0.149338,6,2688.077937,149.337663,448.012989,158.144816,4,0
0,0,30,30,16,41,57,157,112,269,0.000333,0.523016,16,25104.75862,1394.708812,1569.047414,283.659632,17,0
0,0,28,28,16,39,55,150,103,253,0.000333,0.487561,16,23402.94412,1300.163562,1462.684008,270.130687,17,0
0,0,37,37,17,56,73,253,181,434,0.000333,0.895461,24,64473.21261,3581.845145,2686.383859,394.698744,17,0
0,0,33,33,17,51,68,208,147,355,0.000333,0.72035,16,34576.78894,1920.932719,2161.049309,358.780561,17,0
0,0,30,30,17,51,68,178,121,299,0.000333,0.606717,16,29122.42223,1617.912346,1820.15139,358.780561,17,0
0,0,32,32,23,47,70,162,120,282,0.000333,0.576153,22,38026.07184,2112.559547,1728.457811,365.107601,17,0
0,0,25,25,16,38,54,120,91,211,0.000333,0.40476,16,19428.50021,1079.361123,1214.281263,263.421246,13,0
0,0,38,38,24,47,71,217,152,369,0.000333,0.756419,36,81693.24074,4538.513374,2269.256687,371.104776,25,0
0,0,37,37,24,47,71,212,148,360,0.000333,0.73797,36,79700.72267,4427.817926,2213.908963,371.104776,24,0
0,0,44,44,18,70,88,320,234,554,0.000333,1.192842,27,96620.17815,5367.787675,3578.525117,504.108461,19,0
0,0,4,4,11,18,29,24,28,52,0.000333,0.084205,5,1263.075059,70.170837,252.615012,113.112398,2,0
0,0,95,95,27,55,82,407,316,723,0.000333,1.53217,65,298773.1565,16598.50869,4596.510099,446.356747,37,0
0,0,95,95,27,55,82,407,316,723,0.000333,1.53217,65,298773.1565,16598.50869,4596.510099,446.356747,37,0
0,0,9,9,16,30,46,42,46,88,0.000333,0.162024,8,3888.587617,216.032645,486.073452,211.206718,2,0
0,0,9,9,16,29,45,42,45,87,0.000333,0.159264,8,3822.329755,212.351653,477.791219,204.881449,2,0
0,0,22,22,20,39,59,131,94,225,0.000333,0.441198,20,26471.89372,1470.660762,1323.594686,292.569248,13,0
0,0,2,2,12,15,27,21,21,42,0.000333,0.066568,6,1198.231651,66.568425,199.705275,101.622909,2,0
0,0,40,40,24,49,73,270,186,456,0.000333,0.940853,36,101612.16,5645.119998,2822.559999,385.159882,22,0
0,0,20,20,22,41,63,145,101,246,0.000333,0.490137,22,32349.03895,1797.16883,1470.410861,317.767128,12,0
0,0,2,2,12,15,27,21,21,42,0.000333,0.066568,6,1198.231651,66.568425,199.705275,101.622909,2,0
0,0,21,21,16,40,56,87,81,168,0.000333,0.325212,16,15610.17003,867.231668,975.635627,276.877124,10,0
0,0,23,23,17,43,60,90,89,179,0.000333,0.352444,16,16917.33467,939.851926,1057.333417,302.816253,10,0
0,0,10,10,11,28,39,39,42,81,0.000333,0.142706,5,2140.587899,118.92155,428.11758,172.659686,4,0
0,0,11,11,12,29,41,38,44,82,0.000333,0.14644,6,2635.915586,146.439755,439.319264,183.900999,4,0
0,0,9,9,13,23,36,45,41,86,0.000333,0.148205,6,2667.681301,148.204517,444.61355,152.147641,3,0
0,0,7,7,13,19,32,35,31,66,0.000333,0.11,6,1980,110,330,128.816339,3,0
1,0,17,18,13,35,48,54,49,103,0.000333,0.19175,6,3451.506825,191.750379,575.251138,227.630622,5,0
0,0,6,6,15,19,34,36,29,65,0.000333,0.110228,7,2314.795593,128.599755,330.685085,139.313982,4,0
0,0,27,27,22,43,65,111,92,203,0.000333,0.407514,22,26895.89465,1494.21637,1222.540666,331.43688,7,0
0,0,44,44,28,64,92,201,162,363,0.000333,0.789351,28,66305.48372,3683.637985,2368.05299,518.605938,10,0
0,0,27,27,22,43,65,111,92,203,0.000333,0.407514,22,26895.89465,1494.21637,1222.540666,331.43688,7,0
0,0,37,37,24,57,81,171,138,309,0.000333,0.653005,24,47016.32762,2612.018201,1959.013651,442.513831,9,0
0,0,27,27,22,43,65,111,92,203,0.000333,0.407514,22,26895.89465,1494.21637,1222.540666,331.43688,7,0
0,0,10,10,11,24,35,39,39,78,0.000333,0.133361,5,2000.420377,111.134465,400.084075,148.092848,1,0
0,0,9,9,11,21,32,29,31,60,0.000333,0.1,5,1500,83.333333,300,130.292414,1,0
0,0,26,26,21,45,66,123,101,224,0.000333,0.451315,20,27078.88566,1504.382536,1353.944283,339.372055,5,0
0,0,45,45,27,62,89,209,169,378,0.000333,0.815942,26,63643.50816,3535.750453,2447.827237,497.542134,8,0
0,0,26,26,21,45,66,123,101,224,0.000333,0.451315,20,27078.88566,1504.382536,1353.944283,339.372055,5,0
0,0,34,34,24,58,82,166,134,300,0.000333,0.635755,24,45774.37443,2543.020802,1907.265601,449.801998,7,0
0,0,26,26,21,45,66,123,101,224,0.000333,0.451315,20,27078.88566,1504.382536,1353.944283,339.372055,5,0
0,0,26,26,21,45,66,123,101,224,0.000333,0.451315,20,27078.88566,1504.382536,1353.944283,339.372055,5,0
0,0,9,9,11,23,34,33,35,68,0.000333,0.115316,5,1729.737366,96.09652,345.947473,142.095673,1,0
0,0,8,8,11,22,33,29,31,60,0.000333,0.100888,5,1513.318236,84.073235,302.663647,136.161243,1,0
0,0,9,9,15,20,35,48,33,81,0.000333,0.138491,7,2908.303471,161.572415,415.471924,145.041921,3,0
0,0,7,7,15,16,31,35,26,61,0.000333,0.100735,7,2115.441825,117.524546,302.205975,122.603359,3,0
0,0,2,2,9,9,18,14,10,24,0.000333,0.033359,4,400.3128,22.2396,100.0782,57.05865,1,0
0,0,11,11,15,25,40,54,47,101,0.000333,0.179172,7,3762.603163,209.033509,537.514738,174.699764,6,0
0,0,10,10,14,23,37,49,43,92,0.000333,0.159757,7,3354.887967,186.382665,479.26971,157.344894,6,0
0,0,20,20,17,41,58,99,76,175,0.000333,0.341716,8,8201.173393,455.620744,1025.146674,289.1465,5,0
0,0,21,21,18,45,63,104,86,190,0.000333,0.378561,9,10221.14867,567.841593,1135.683185,322.192039,5,0
0,0,10,10,13,23,36,41,38,79,0.000333,0.136141,6,2450.544451,136.141358,408.424075,152.147641,3,0
0,0,30,30,25,35,60,142,121,263,0.000333,0.517837,36,55926.44016,3107.024453,1553.512227,295.62131,26,0
0,0,20,20,23,25,48,85,73,158,0.000333,0.294141,22,19413.32965,1078.518314,882.424075,220.13833,24,0
0,0,15,15,20,23,43,59,53,112,0.000333,0.202581,20,12154.83305,675.268503,607.741653,190.480487,17,0
0,0,9,9,17,25,42,59,51,110,0.000333,0.197718,16,9490.478664,527.248815,593.154917,185.583273,5,0
0,0,7,7,17,19,36,40,29,69,0.000333,0.118908,8,2853.798601,158.544367,356.724825,150.197491,8,0
0,0,28,28,23,51,74,126,101,227,0.000333,0.469849,11,15505.00505,861.38917,1409.545914,393.335617,8,0
0,0,18,18,20,32,52,77,61,138,0.000333,0.26222,10,7866.606811,437.033712,786.660681,246.438562,6,0
0,0,2,2,11,14,25,15,16,31,0.000333,0.047987,5,719.797709,39.988762,143.959542,91.356717,1,0
0,0,6,6,10,15,25,19,24,43,0.000333,0.066562,5,998.429081,55.468282,199.685816,91.82264,1,0
0,0,31,31,24,28,52,153,122,275,0.000333,0.52254,48,75245.80428,4180.32246,1567.620922,244.645038,11,0
0,0,4,4,11,11,22,21,18,39,0.000333,0.057973,5,869.589166,48.310509,173.917833,76.107496,2,0
0,0,28,28,14,31,45,96,86,182,0.000333,0.333172,14,13993.24169,777.402316,999.517264,206.883055,4,0
0,0,39,39,17,54,71,158,140,298,0.000333,0.610875,16,29321.99427,1628.999681,1832.624642,380.250793,13,0
0,0,14,14,11,28,39,55,50,105,0.000333,0.184989,5,2774.836165,154.157565,554.967233,172.659686,3,0
0,0,12,12,10,24,34,42,40,82,0.000333,0.139057,5,2085.859765,115.881098,417.171953,143.258381,3,0
0,0,12,12,10,23,33,41,39,80,0.000333,0.134517,5,2017.757648,112.097647,403.55153,137.261206,3,0
0,0,8,8,11,16,27,36,33,69,0.000333,0.109362,10,3280.872376,182.270688,328.087238,102.053748,2,0
0,0,7,7,11,22,33,23,27,50,0.000333,0.084073,5,1261.09853,70.061029,252.219706,136.161243,2,0
1,0,17,18,15,25,40,61,54,115,0.000333,0.204007,14,8568.304233,476.016902,612.021731,174.699764,5,0
0,0,65,65,17,49,66,320,223,543,0.000333,1.094035,32,105027.3922,5834.855123,3282.106007,344.607651,32,0
0,0,16,16,10,20,30,25,29,54,0.000333,0.088324,5,1324.860461,73.603359,264.972092,119.657843,3,0
0,0,17,17,11,22,33,25,35,60,0.000333,0.100888,5,1513.318236,84.073235,302.663647,136.161243,2,0
0,0,15,15,11,21,32,20,29,49,0.000333,0.081667,5,1225,68.055556,245,130.292414,2,0
0,0,15,15,9,19,28,16,27,43,0.000333,0.068905,4,826.865047,45.936947,206.716262,109.239948,2,0
1,0,14,15,19,41,60,85,61,146,0.000333,0.287469,9,7761.654243,431.203013,862.406027,300.370255,2,0
0,0,91,91,29,97,126,444,329,773,0.000333,1.797812,42,226524.37,12584.68722,5393.437381,781.072995,42,0
0,0,91,91,29,97,126,444,329,773,0.000333,1.797812,42,226524.37,12584.68722,5393.437381,781.072995,42,0
0,0,101,101,29,104,133,497,372,869,0.000333,2.04368,42,257503.6983,14305.76102,6131.040436,837.72718,45,0
0,0,95,95,29,97,126,465,346,811,0.000333,1.886191,42,237660.1088,13203.33938,5658.574018,781.072995,44,0
0,0,91,91,29,97,126,444,329,773,0.000333,1.797812,42,226524.37,12584.68722,5393.437381,781.072995,42,0
0,0,35,35,22,54,76,202,138,340,0.000333,0.708098,22,46734.4978,2596.360989,2124.295355,408.871421,22,0
0,0,30,30,20,50,70,163,118,281,0.000333,0.57411,20,34446.57056,1913.698364,1722.328528,368.631371,17,0
0,0,27,27,19,45,64,138,100,238,0.000333,0.476,18,25704,1428,1428,327.844012,16,0
1,0,14,15,24,29,53,81,57,138,0.000333,0.263484,12,9485.436273,526.968682,790.453023,250.920549,8,0
1,0,8,9,13,18,31,38,29,67,0.000333,0.110644,6,1991.586917,110.643718,331.931153,123.164366,4,0
1,0,7,8,13,17,30,34,25,59,0.000333,0.096502,6,1737.039271,96.502182,289.506545,117.592585,4,0
0,0,10,10,16,22,38,44,42,86,0.000333,0.150441,8,3610.574129,200.587452,451.321766,162.107496,8,0
1,0,6,7,13,16,29,33,28,61,0.000333,0.098779,6,1778.021044,98.778947,296.336841,112.105716,3,0
0,0,8,8,14,20,34,40,39,79,0.000333,0.13397,7,2813.366951,156.298164,401.909564,139.741531,3,0
0,0,7,7,14,19,33,35,33,68,0.000333,0.11434,7,2401.131601,133.3962,343.0188,134.013592,3,0
1,0,97,98,31,132,163,568,405,973,0.000333,2.383437,45,321764.0622,17875.78124,7150.312494,1083.440109,77,0
1,0,60,61,29,81,110,287,218,505,0.000333,1.141529,28,95888.42635,5327.134797,3424.586655,654.409299,42,0
1,0,61,62,28,79,107,290,221,511,0.000333,1.148297,28,96456.90964,5358.717202,3444.88963,632.604617,41,0
1,0,56,57,28,72,100,267,200,467,0.000333,1.034227,28,86875.06354,4826.392419,3102.680841,578.840538,36,0
1,0,57,58,28,73,101,270,204,474,0.000333,1.051997,28,88367.7828,4909.321267,3155.992243,586.463131,38,0
1,0,56,57,28,72,100,267,200,467,0.000333,1.034227,28,86875.06354,4826.392419,3102.680841,578.840538,36,0
1,0,41,42,26,73,99,183,141,324,0.000333,0.715971,13,27922.85008,1551.269449,2147.911545,574.068625,28,0
0,0,93,93,29,98,127,450,333,783,0.000333,1.824047,42,229829.8846,12768.32692,5472.14011,789.123014,42,0
0,0,93,93,29,98,127,450,333,783,0.000333,1.824047,42,229829.8846,12768.32692,5472.14011,789.123014,42,0
0,0,103,103,29,105,134,503,376,879,0.000333,2.070364,42,260865.8807,14492.54893,6211.092398,845.877228,45,0
0,0,97,97,29,98,127,471,350,821,0.000333,1.91257,42,240983.8254,13387.9903,5737.710128,789.123014,44,0
0,0,93,93,29,98,127,450,333,783,0.000333,1.824047,42,229829.8846,12768.32692,5472.14011,789.123014,42,0
0,0,35,35,22,54,76,202,138,340,0.000333,0.708098,22,46734.4978,2596.360989,2124.295355,408.871421,22,0
0,0,30,30,20,50,70,163,118,281,0.000333,0.57411,20,34446.57056,1913.698364,1722.328528,368.631371,17,0
0,0,27,27,19,45,64,138,100,238,0.000333,0.476,18,25704,1428,1428,327.844012,16,0
0,0,7,7,14,17,31,37,32,69,0.000333,0.113947,7,2392.876818,132.937601,341.839545,122.789837,4,0
0,0,75,75,21,51,72,371,270,641,0.000333,1.318307,50,197746.0963,10985.89424,3954.921926,381.532358,32,0
0,0,74,74,21,51,72,367,267,634,0.000333,1.303911,50,195586.6225,10865.92348,3911.732451,381.532358,32,0
1,0,8,9,17,20,37,34,31,65,0.000333,0.112871,8,2708.91575,150.495319,338.614469,155.92543,3,0
1,0,8,9,17,23,40,35,33,68,0.000333,0.12063,8,2895.128884,160.840494,361.89111,173.528793,3,0
1,0,21,22,18,56,74,161,123,284,0.000333,0.587828,18,31742.72561,1763.484756,1763.484756,400.270526,14,0
1,0,15,16,17,44,61,95,80,175,0.000333,0.34596,8,8303.032273,461.279571,1037.879034,309.70186,7,0
0,0,65,65,24,40,64,285,210,495,0.000333,0.99,60,178200,9900,2970,322.916224,30,0
0,0,53,53,24,39,63,242,176,418,0.000333,0.832834,48,119928.1444,6662.674688,2498.503008,316.169787,26,0
0,0,45,45,24,38,62,202,149,351,0.000333,0.696641,36,75237.22458,4179.84581,2089.922905,309.460346,23,0
0,0,30,30,20,34,54,118,93,211,0.000333,0.40476,20,24285.62526,1349.201403,1214.281263,259.412299,14,0
0,0,27,27,20,33,53,106,84,190,0.000333,0.362768,20,21766.09773,1209.227652,1088.304886,252.903568,13,0
0,0,14,14,17,23,40,44,43,87,0.000333,0.154336,8,3704.061954,205.78122,463.007744,173.528793,6,0
0,0,6,6,8,12,20,9,14,23,0.000333,0.033135,4,397.617385,22.089855,99.404346,67.01955,1,0
0,0,11,11,12,20,32,36,35,71,0.000333,0.118333,6,2130,118.333333,355,129.458112,4,0
0,0,26,26,20,42,62,131,102,233,0.000333,0.462443,20,27746.55481,1541.475267,1387.32774,312.915894,19,0
0,0,15,15,17,27,44,55,53,108,0.000333,0.19654,8,4716.948919,262.052718,589.618615,197.868831,5,0
0,0,5,5,10,15,25,16,23,39,0.000333,0.06037,5,905.551957,50.308442,181.110391,91.82264,1,0
0,0,5,5,10,14,24,14,21,35,0.000333,0.053491,5,802.368438,44.576024,160.473688,86.52225,1,0
0,0,4,4,9,13,22,11,17,28,0.000333,0.041621,4,499.456341,27.747575,124.864085,76.635041,1,0
0,0,36,36,21,35,56,136,106,242,0.000333,0.46846,30,42161.39673,2342.299819,1405.379891,271.763571,12,0
0,0,13,13,11,20,31,40,37,77,0.000333,0.127158,5,1907.365579,105.964754,381.473116,124.49231,4,0
0,0,27,27,25,40,65,132,111,243,0.000333,0.487812,24,35122.44909,1951.247171,1463.435379,328.973529,17,0
0,0,27,27,25,40,65,132,111,243,0.000333,0.487812,24,35122.44909,1951.247171,1463.435379,328.973529,17,0
0,0,27,27,25,40,65,132,111,243,0.000333,0.487812,24,35122.44909,1951.247171,1463.435379,328.973529,17,0
0,0,87,87,31,73,104,550,445,995,0.000333,2.222313,90,600024.3768,33334.6876,6666.93752,605.437278,45,0
0,0,43,43,26,48,74,186,155,341,0.000333,0.705808,39,82579.52031,4587.751128,2117.423598,390.289633,27,0
0,0,42,42,26,48,74,183,153,336,0.000333,0.695459,39,81368.6769,4520.48205,2086.376331,390.289633,26,0
0,0,46,46,28,51,79,213,179,392,0.000333,0.823694,42,103785.4462,5765.858124,2471.082053,423.89963,32,0
0,0,35,35,25,43,68,153,127,280,0.000333,0.568163,24,40907.75029,2272.652794,1704.489596,349.425789,23,0
0,0,23,23,12,39,51,92,78,170,0.000333,0.321437,12,11571.7477,642.874872,964.312308,249.150237,11,0
0,0,81,81,23,108,131,326,290,616,0.000333,1.444196,22,95316.94852,5295.386029,4332.588569,833.569775,27,0
0,0,79,79,23,108,131,322,286,608,0.000333,1.42544,22,94079.06607,5226.614782,4276.321185,833.569775,27,0
0,0,76,76,23,103,126,291,254,545,0.000333,1.267539,22,83657.58628,4647.643682,3802.617558,792.751479,26,0
0,0,76,76,23,101,124,288,247,535,0.000333,1.240165,22,81850.89057,4547.271699,3720.495026,776.521285,26,0
0,0,45,45,17,62,79,155,131,286,0.000333,0.60096,16,28846.1007,1602.56115,1802.881294,438.64704,16,0
0,0,45,45,21,62,83,166,136,302,0.000333,0.641754,20,38505.23817,2139.179898,1925.261908,461.398837,17,0
0,0,43,43,17,60,77,151,127,278,0.000333,0.580722,16,27874.66653,1548.592585,1742.166658,423.900304,15,0
0,0,3,3,8,12,20,11,15,26,0.000333,0.037457,4,449.480522,24.97114,112.37013,67.01955,1,0
0,0,64,64,34,96,130,368,224,592,0.000333,1.385747,34,141346.2193,7852.567741,4157.241745,805.130137,40,0
0,0,61,61,34,94,128,356,215,571,0.000333,1.332333,34,135898,7549.888889,3997,789.105089,39,0
0,0,61,61,34,92,126,354,213,567,0.000333,1.318706,34,134508.0024,7472.666798,3956.117717,773.141437,39,0
0,0,25,25,27,46,73,147,90,237,0.000333,0.488996,13,19070.84947,1059.491637,1466.98842,382.465813,16,0
0,0,24,24,25,41,66,132,80,212,0.000333,0.427137,12,15376.93864,854.274369,1281.411553,335.756037,16,0
0,0,25,25,25,40,65,132,80,212,0.000333,0.425581,24,30641.80743,1702.322635,1276.741976,328.973529,16,0
0,0,24,24,25,43,68,135,83,218,0.000333,0.442356,12,15924.80279,884.711266,1327.066899,349.425789,15,0
0,0,22,22,18,33,51,106,69,175,0.000333,0.330891,18,17868.13983,992.674435,992.674435,241.523656,14,0
0,0,14,14,15,25,40,71,45,116,0.000333,0.205781,7,4321.405613,240.07809,617.343659,174.699764,7,0
0,0,45,45,28,78,106,261,161,422,0.000333,0.946394,28,79497.10809,4416.506005,2839.182432,624.867311,31,0
0,0,7,7,16,25,41,47,40,87,0.000333,0.155369,8,3728.856195,207.158678,466.107024,180.096405,4,0
0,0,65,65,25,62,87,273,204,477,0.000333,1.024428,36,110638.2257,6146.568095,3073.284048,485.256576,33,0
0,0,65,65,25,62,87,273,204,477,0.000333,1.024428,36,110638.2257,6146.568095,3073.284048,485.256576,33,0
0,0,2,2,9,13,22,11,16,27,0.000333,0.040135,4,481.618615,26.75659,120.404654,76.635041,1,0
0,0,97,97,31,102,133,509,365,874,0.000333,2.055439,45,277484.2582,15415.79212,6166.316849,834.167471,51,0
0,0,97,97,31,102,133,509,365,874,0.000333,2.055439,45,277484.2582,15415.79212,6166.316849,834.167471,51,0
0,0,98,98,31,102,133,516,370,886,0.000333,2.08366,45,281294.1107,15627.4506,6250.980238,834.167471,51,0
0,0,97,97,31,102,133,509,365,874,0.000333,2.055439,45,277484.2582,15415.79212,6166.316849,834.167471,51,0
0,0,103,103,31,105,136,528,381,909,0.000333,2.147501,45,289912.6675,16106.25931,6442.503723,858.575865,53,0
0,0,101,101,31,105,136,520,375,895,0.000333,2.114426,45,285447.5659,15858.19811,6343.279243,858.575865,52,0
0,0,97,97,31,102,133,509,365,874,0.000333,2.055439,45,277484.2582,15415.79212,6166.316849,834.167471,51,0
0,0,13,13,22,35,57,115,70,185,0.000333,0.359695,22,23739.86236,1318.881242,1079.084653,277.632401,11,0
0,0,16,16,10,20,30,25,29,54,0.000333,0.088324,5,1324.860461,73.603359,264.972092,119.657843,3,0
0,0,17,17,11,22,33,25,35,60,0.000333,0.100888,5,1513.318236,84.073235,302.663647,136.161243,2,0
0,0,15,15,11,21,32,20,29,49,0.000333,0.081667,5,1225,68.055556,245,130.292414,2,0
0,0,15,15,9,19,28,16,27,43,0.000333,0.068905,4,826.865047,45.936947,206.716262,109.239948,2,0
1,0,57,58,20,65,85,306,228,534,0.000333,1.140872,30,102678.4428,5704.357933,3422.61476,477.89247,31,0
1,0,57,58,20,65,85,306,228,534,0.000333,1.140872,30,102678.4428,5704.357933,3422.61476,477.89247,31,0
1,0,7,8,10,31,41,48,46,94,0.000333,0.16787,5,2518.049442,139.891636,503.609888,186.799367,3,0
1,0,53,54,24,52,76,202,167,369,0.000333,0.768495,36,82997.46909,4610.970505,2305.485252,406.461965,18,0
1,0,53,54,24,52,76,202,167,369,0.000333,0.768495,36,82997.46909,4610.970505,2305.485252,406.461965,18,0
1,0,53,54,24,52,76,202,167,369,0.000333,0.768495,36,82997.46909,4610.970505,2305.485252,406.461965,18,0
0,0,22,22,20,42,62,115,87,202,0.000333,0.400916,20,24054.95309,1336.386283,1202.747655,312.915894,8,0
0,0,27,27,28,31,59,128,92,220,0.000333,0.431394,28,36237.08118,2013.171177,1294.181471,288.186023,13,0
0,0,27,27,28,31,59,128,92,220,0.000333,0.431394,28,36237.08118,2013.171177,1294.181471,288.186023,13,0
0,0,27,27,28,31,59,128,92,220,0.000333,0.431394,28,36237.08118,2013.171177,1294.181471,288.186023,13,0
0,0,8,8,18,15,33,43,29,72,0.000333,0.121065,9,3268.767389,181.598188,363.196377,133.662009,5,0
0,0,6,6,19,13,32,33,24,57,0.000333,0.095,9,2565,142.5,285,128.816339,4,0
0,0,45,45,22,60,82,221,176,397,0.000333,0.841316,22,55526.85921,3084.825512,2523.948146,452.520931,37,0
0,0,45,45,21,60,81,220,174,394,0.000333,0.832634,20,49958.01802,2775.445446,2497.900901,446.652102,37,0
0,0,18,18,16,36,52,79,63,142,0.000333,0.269821,8,6475.69952,359.761084,809.46244,250.1173,7,0
0,0,10,10,20,27,47,66,47,113,0.000333,0.209223,10,6276.685402,348.704745,627.66854,214.820524,3,0
0,0,7,7,14,21,35,39,29,68,0.000333,0.116264,7,2441.538716,135.64104,348.791245,145.541635,2,0
0,0,4,4,8,18,26,20,21,41,0.000333,0.064239,4,770.872114,42.826229,192.718028,99.05865,1,0
0,0,4,4,8,18,26,20,21,41,0.000333,0.064239,4,770.872114,42.826229,192.718028,99.05865,1,0
0,0,26,26,22,35,57,135,106,241,0.000333,0.468575,33,46388.97428,2577.165238,1405.726493,277.632401,9,0
0,0,13,13,13,20,33,53,46,99,0.000333,0.166465,12,5992.740214,332.930012,499.395018,134.544278,3,0
0,0,22,22,21,30,51,118,92,210,0.000333,0.39707,30,35736.27965,1985.34887,1191.209322,239.445384,10,0
0,0,12,12,15,22,37,58,47,105,0.000333,0.182331,14,7657.896447,425.438692,546.992603,156.710855,4,0
0,0,22,22,21,30,51,118,92,210,0.000333,0.39707,30,35736.27965,1985.34887,1191.209322,239.445384,10,0
0,0,10,10,13,25,38,58,40,98,0.000333,0.171432,6,3085.781378,171.432299,514.296896,164.202121,5,0
0,0,11,11,17,23,40,58,48,106,0.000333,0.188041,16,9025.990049,501.443892,564.124378,173.528793,7,0
0,0,22,22,22,35,57,117,90,207,0.000333,0.402469,22,26562.98113,1475.721174,1207.408233,277.632401,13,0
0,0,4,4,9,11,20,15,21,36,0.000333,0.051863,4,622.357646,34.575425,155.589411,66.583073,1,0
0,0,3,3,9,11,20,13,20,33,0.000333,0.047541,4,570.494509,31.694139,142.623627,66.583073,1,0
0,0,30,30,25,53,78,221,115,336,0.000333,0.703965,24,50685.48349,2815.860194,2111.895146,419.676189,17,0
0,0,14,14,18,30,48,99,52,151,0.000333,0.28111,9,7589.964038,421.664669,843.329338,222.265368,9,0
0,0,17,17,17,45,62,127,76,203,0.000333,0.402901,8,9669.614808,537.200823,1208.701851,316.620258,8,0
0,0,17,17,17,42,59,120,71,191,0.000333,0.374528,8,8988.678579,499.371032,1123.584822,295.9642,8,0
0,0,15,15,17,39,56,107,64,171,0.000333,0.331019,8,7944.461533,441.358974,993.057692,275.617555,8,0
0,0,8,8,17,26,43,72,38,110,0.000333,0.198963,8,4775.112984,265.284055,596.889123,191.698301,6,0
0,0,19,19,18,37,55,83,66,149,0.000333,0.287141,9,7752.803376,430.711299,861.422597,267.808425,5,0
0,0,17,17,22,22,44,88,60,148,0.000333,0.269332,22,17775.90935,987.550519,807.99588,196.214991,8,0
0,0,28,28,17,38,55,126,97,223,0.000333,0.429748,16,20627.89146,1145.99397,1289.243216,268.908114,10,0
0,0,28,28,17,38,55,126,97,223,0.000333,0.429748,16,20627.89146,1145.99397,1289.243216,268.908114,10,0
0,0,10,10,15,21,36,40,36,76,0.000333,0.130971,7,2750.400101,152.800006,392.9143,150.842025,3,0
0,0,52,52,26,70,96,215,166,381,0.000333,0.83629,26,65230.63853,3623.924363,2508.870713,551.261244,28,0
0,0,9,9,18,24,42,59,37,96,0.000333,0.172554,9,4658.962253,258.831236,517.662473,185.09775,6,0
0,0,12,12,12,15,27,29,24,53,0.000333,0.084003,6,1512.054226,84.003013,252.009038,101.622909,2,0
1,0,87,88,26,129,155,433,291,724,0.000333,1.755971,26,136965.7658,7609.209211,5267.914069,1026.659749,51,0
0,0,10,10,15,18,33,45,34,79,0.000333,0.132836,7,2789.549948,154.974997,398.507135,133.662009,4,0
0,0,8,8,15,17,32,44,29,73,0.000333,0.121667,7,2555,141.944444,365,128.090227,4,0
0,0,5,5,12,15,27,26,20,46,0.000333,0.072908,6,1312.348951,72.908275,218.724825,101.622909,3,0
0,0,12,12,13,22,35,42,45,87,0.000333,0.148749,12,5354.97147,297.498415,446.247622,146.213212,4,0
0,0,84,84,27,111,138,546,457,1003,0.000333,2.376617,52,370752.2016,20597.34453,7129.85003,882.562124,59,0
0,0,41,41,22,65,87,221,193,414,0.000333,0.889126,22,58682.32936,3260.129409,2667.378607,489.561403,16,0
0,0,41,41,25,37,62,187,143,330,0.000333,0.654962,36,70735.85217,3929.769565,1964.884782,308.846179,18,0
0,0,41,41,25,37,62,187,143,330,0.000333,0.654962,36,70735.85217,3929.769565,1964.884782,308.846179,18,0
0,0,41,41,25,37,62,187,143,330,0.000333,0.654962,36,70735.85217,3929.769565,1964.884782,308.846179,18,0
0,0,18,18,15,31,46,79,67,146,0.000333,0.268813,14,11290.16064,627.231147,806.440046,212.183445,3,0
0,0,17,17,15,30,45,71,62,133,0.000333,0.243472,14,10225.83047,568.101693,730.416462,205.810077,3,0
0,0,21,21,25,39,64,100,76,176,0.000333,0.352,12,12672,704,1056,322.227091,10,0
0,0,30,30,17,28,45,116,96,212,0.000333,0.388091,24,27942.54855,1552.363809,1164.272856,204.092806,8,0
0,0,43,43,17,30,47,167,137,304,0.000333,0.562865,32,54035.04035,3001.946686,1688.595011,216.693586,8,0
0,0,7,7,11,18,29,41,36,77,0.000333,0.124688,10,3740.645366,207.813631,374.064537,113.112398,2,0
0,0,18,18,21,39,60,99,75,174,0.000333,0.3426,10,10277.98964,570.999424,1027.798964,298.369352,8,0
0,0,22,22,20,42,62,115,87,202,0.000333,0.400916,20,24054.95309,1336.386283,1202.747655,312.915894,8,0
0,0,5,5,12,16,28,25,23,48,0.000333,0.076918,6,1384.518218,76.917679,230.753036,107.01955,2,0
0,0,3,3,9,15,24,14,18,32,0.000333,0.048906,4,586.8752,32.604178,146.7188,87.132684,1,0
0,0,9,9,11,22,33,38,34,72,0.000333,0.121065,5,1815.981883,100.887882,363.196377,136.161243,3,0
0,0,43,43,28,60,88,200,170,370,0.000333,0.796663,28,66919.71157,3717.761754,2389.989699,489.019374,19,0
0,0,43,43,28,60,88,200,170,370,0.000333,0.796663,28,66919.71157,3717.761754,2389.989699,489.019374,19,0
0,0,43,43,28,60,88,200,170,370,0.000333,0.796663,28,66919.71157,3717.761754,2389.989699,489.019374,19,0
0,0,43,43,28,60,88,200,170,370,0.000333,0.796663,28,66919.71157,3717.761754,2389.989699,489.019374,19,0
0,0,7,7,14,26,40,34,36,70,0.000333,0.124178,7,2607.744766,144.874709,372.534967,175.514402,2,0
0,0,9,9,17,25,42,55,51,106,0.000333,0.190529,16,9145.370349,508.076131,571.585647,185.583273,6,0
0,0,5,5,13,24,37,29,32,61,0.000333,0.105926,6,1906.659932,105.925552,317.776655,158.144816,2,0
0,0,36,36,24,46,70,165,111,276,0.000333,0.563894,24,40600.3707,2255.57615,1691.682113,364.12295,16,0
0,0,12,12,14,25,39,54,46,100,0.000333,0.17618,7,3699.781553,205.54342,528.540222,169.399374,6,0
0,0,12,12,14,25,39,54,46,100,0.000333,0.17618,7,3699.781553,205.54342,528.540222,169.399374,6,0
0,0,13,13,15,26,41,61,51,112,0.000333,0.200015,7,4200.320772,233.351154,600.045825,180.814792,6,0
0,0,12,12,15,25,40,57,47,104,0.000333,0.184494,7,3874.363653,215.242425,553.480522,174.699764,6,0
0,0,55,55,22,42,64,386,220,606,0.000333,1.212,55,199980,11110,3636,324.584827,35,0
0,0,45,45,20,40,60,323,194,517,0.000333,1.017954,40,122154.4975,6786.360973,3053.862438,299.315686,31,0
0,0,6,6,11,16,27,21,27,48,0.000333,0.076078,5,1141.173001,63.3985,228.2346,102.053748,1,0
0,0,4,4,11,14,25,17,21,38,0.000333,0.058822,5,882.332676,49.018482,176.466535,91.356717,1,0
0,0,59,59,30,45,75,433,307,740,0.000333,1.536442,90,414839.3248,23046.62916,4609.325831,394.340107,27,0
1,0,14,15,15,31,46,51,46,97,0.000333,0.178595,7,3750.498568,208.361032,535.78551,212.183445,3,0
0,0,47,47,25,64,89,262,213,475,0.000333,1.025324,36,110735.0417,6151.946759,3075.97338,500.096405,19,0
0,0,65,65,25,78,103,324,259,583,0.000333,1.29941,36,140336.2731,7796.459615,3898.229807,606.357778,23,0
1,0,8,9,13,30,43,56,47,103,0.000333,0.186302,6,3353.431618,186.301757,558.90527,195.312434,3,0
0,0,30,30,20,45,65,116,96,212,0.000333,0.425581,20,25534.83953,1418.602196,1276.741976,333.571951,8,0
0,0,17,17,12,36,48,60,54,114,0.000333,0.212229,6,3820.11435,212.228575,636.685725,229.13685,5,0
0,0,9,9,9,13,22,11,16,27,0.000333,0.040135,4,481.618615,26.75659,120.404654,76.635041,2,0
0,0,15,15,14,28,42,57,50,107,0.000333,0.192326,7,4038.84575,224.380319,576.977964,187.908907,5,0
0,0,15,15,14,28,42,57,50,107,0.000333,0.192326,7,4038.84575,224.380319,576.977964,187.908907,5,0
0,0,12,12,13,23,36,45,39,84,0.000333,0.144758,6,2605.642201,144.7579,434.2737,152.147641,3,0
0,0,44,44,20,57,77,172,144,316,0.000333,0.660102,20,39606.09094,2200.338385,1980.304547,418.913293,12,0
0,0,44,44,20,57,77,172,144,316,0.000333,0.660102,20,39606.09094,2200.338385,1980.304547,418.913293,12,0
0,0,78,78,28,117,145,496,406,902,0.000333,2.158759,42,272003.676,15111.31533,6476.277999,938.43861,53,0
0,0,8,8,12,20,32,48,51,99,0.000333,0.165,12,5940,330,495,129.458112,3,0
0,0,8,8,12,21,33,50,53,103,0.000333,0.173191,12,6234.871132,346.38173,519.572594,135.258216,3,0
0,0,7,7,12,20,32,45,48,93,0.000333,0.155,12,5580,310,465,129.458112,3,0
0,0,5,5,9,20,29,33,39,72,0.000333,0.116592,4,1399.098527,77.727696,349.774632,114.967887,2,0
0,0,4,4,9,19,28,27,33,60,0.000333,0.096147,4,1153.765181,64.098066,288.441295,109.239948,2,0
0,0,3,3,8,14,22,14,23,37,0.000333,0.055,4,659.99588,36.666438,164.99897,77.302969,2,0
0,0,9,9,13,21,34,61,61,122,0.000333,0.20689,12,7448.0456,413.780311,620.670467,140.344382,3,0
0,0,8,8,13,21,34,52,53,105,0.000333,0.178061,12,6410.20318,356.122399,534.183598,140.344382,3,0
0,0,34,34,26,37,63,162,114,276,0.000333,0.54991,39,64339.4411,3574.413394,1649.729259,314.961207,19,0
0,0,18,18,20,30,50,85,69,154,0.000333,0.289718,20,17383.07707,965.726504,869.153853,233.64528,9,0
0,0,6,6,11,18,29,25,27,52,0.000333,0.084205,5,1263.075059,70.170837,252.615012,113.112398,1,0
0,0,8,8,10,16,26,21,23,44,0.000333,0.06894,5,1034.096738,57.449819,206.819348,97.219281,1,0
0,0,15,15,19,26,45,59,51,110,0.000333,0.201368,9,5436.934565,302.05192,604.103841,202.922055,5,0
0,0,20,20,17,48,65,96,94,190,0.000333,0.381417,8,9153.999076,508.555504,1144.249884,337.565068,4,0
0,0,15,15,17,41,58,71,72,143,0.000333,0.27923,8,6701.530258,372.307237,837.691282,289.1465,3,0
0,0,15,15,22,35,57,85,67,152,0.000333,0.295533,11,9752.592104,541.810672,886.599282,277.632401,8,0
1,0,64,65,19,75,94,312,217,529,0.000333,1.155793,18,62412.79505,3467.377503,3467.377503,547.872025,53,0
1,0,60,61,19,73,92,297,208,505,0.000333,1.098133,18,59299.17818,3294.398788,3294.398788,532.567816,52,0
1,0,60,61,19,73,92,297,208,505,0.000333,1.098133,18,59299.17818,3294.398788,3294.398788,532.567816,52,0
0,0,15,15,26,34,60,87,70,157,0.000333,0.309127,26,24111.92741,1339.551523,927.381824,295.185169,5,0
0,0,47,47,25,79,104,292,228,520,0.000333,1.16141,24,83621.48768,4645.638205,3484.228653,614.095084,39,0
0,0,42,42,25,76,101,263,208,471,0.000333,1.045339,24,75264.4226,4181.356811,3136.017608,590.938896,36,0
0,0,3,3,10,11,21,18,14,32,0.000333,0.046851,5,702.770788,39.042822,140.554158,71.273029,1,0
0,0,18,18,15,33,48,93,59,152,0.000333,0.282971,7,5942.400101,330.133339,848.9143,225.068365,10,0
0,0,66,66,31,70,101,326,257,583,0.000333,1.293912,45,174678.1783,9704.343236,3881.737294,582.629897,46,0
0,0,62,62,29,62,91,304,238,542,0.000333,1.175742,42,148143.4372,8230.190955,3527.224695,510.04162,45,0
0,0,41,41,24,58,82,216,190,406,0.000333,0.860389,36,92921.9801,5162.332228,2581.166114,449.801998,12,0
0,0,41,41,24,58,82,218,192,410,0.000333,0.868865,36,93837.46759,5213.192644,2606.596322,449.801998,12,0
0,0,38,38,22,54,76,190,166,356,0.000333,0.741421,33,73400.65243,4077.814024,2224.262195,408.871421,12,0
0,0,21,21,20,41,61,153,103,256,0.000333,0.50609,20,30365.37517,1686.965287,1518.268758,306.098194,18,0
0,0,20,20,20,40,60,149,101,250,0.000333,0.492241,20,29534.45298,1640.802943,1476.722649,299.315686,17,0
0,0,21,21,20,41,61,149,103,252,0.000333,0.498182,20,29890.91618,1660.606455,1494.545809,306.098194,18,0
0,0,21,21,20,41,61,149,103,252,0.000333,0.498182,20,29890.91618,1660.606455,1494.545809,306.098194,18,0
0,0,20,20,20,40,60,145,101,246,0.000333,0.484365,20,29061.90173,1614.550096,1453.095087,299.315686,17,0
0,0,19,19,20,40,60,140,98,238,0.000333,0.468613,20,28116.79924,1562.044402,1405.839962,299.315686,16,0
0,0,27,27,28,49,77,211,145,356,0.000333,0.743659,28,62467.32824,3470.407124,2230.976008,409.72672,21,0
0,0,26,26,29,48,77,207,143,350,0.000333,0.731125,28,61414.5081,3411.917117,2193.375289,408.959649,20,0
0,0,22,22,20,41,61,162,106,268,0.000333,0.529813,20,31788.75213,1766.041785,1589.437606,306.098194,19,0
0,0,22,22,20,41,61,162,106,268,0.000333,0.529813,20,31788.75213,1766.041785,1589.437606,306.098194,19,0
0,0,21,21,20,40,60,158,104,262,0.000333,0.515868,20,30952.10672,1719.561484,1547.605336,299.315686,18,0
0,0,25,25,27,53,80,193,139,332,0.000333,0.699627,26,54570.88332,3031.71574,2098.880128,431.961747,16,0
0,0,26,26,26,51,77,192,141,333,0.000333,0.695613,26,54257.83787,3014.324326,2086.839918,411.505125,19,0
0,0,21,21,20,42,62,159,112,271,0.000333,0.537862,20,32271.744,1792.874667,1613.5872,312.915894,17,0
0,0,25,25,27,50,77,199,149,348,0.000333,0.726947,26,56701.88462,3150.104701,2180.841716,410.574772,18,0
0,0,6,6,14,19,33,36,38,74,0.000333,0.124428,14,5225.992308,290.332906,373.285165,134.013592,1,0
0,0,4,4,13,14,27,18,21,39,0.000333,0.061814,6,1112.643676,61.813538,185.440613,101.408685,1,0
0,0,4,4,13,16,29,19,22,41,0.000333,0.066392,6,1195.063325,66.392407,199.177221,112.105716,1,0
0,0,6,6,8,19,27,24,27,51,0.000333,0.080833,4,969.99705,53.888725,242.499263,104.710623,1,0
0,0,21,21,22,38,60,95,80,175,0.000333,0.344569,22,22741.52879,1263.418266,1033.705854,297.528741,10,0
0,0,21,21,22,38,60,95,80,175,0.000333,0.344569,22,22741.52879,1263.418266,1033.705854,297.528741,10,0
0,0,5,5,12,18,30,25,29,54,0.000333,0.088324,6,1589.832553,88.324031,264.972092,118.0782,2,0
0,0,5,5,12,17,29,25,29,54,0.000333,0.087444,6,1573.985842,87.443658,262.330974,112.506418,2,0
0,0,3,3,10,19,29,22,29,51,0.000333,0.082586,5,1238.785154,68.821397,247.757031,113.929904,1,0
0,0,3,3,9,13,22,14,20,34,0.000333,0.05054,4,606.4827,33.693483,151.620675,76.635041,1,0
0,0,5,5,16,20,36,37,29,66,0.000333,0.113738,8,2729.720401,151.651133,341.21505,150.438562,3,0
0,0,10,10,13,25,38,50,42,92,0.000333,0.160936,6,2896.855987,160.936444,482.809331,164.202121,3,0
1,0,4,5,13,18,31,20,19,39,0.000333,0.064405,6,1159.281937,64.404552,193.213656,123.164366,1,0
0,0,30,30,25,44,69,163,93,256,0.000333,0.521261,24,37530.77426,2085.043015,1563.782261,356.311396,20,0
0,0,25,25,23,39,62,133,76,209,0.000333,0.414809,11,13688.69732,760.483184,1244.427029,310.172612,17,0
0,0,27,27,23,37,60,139,78,217,0.000333,0.427265,22,28199.4957,1566.63865,1281.795259,296.7917,18,0
0,0,25,25,23,40,63,135,78,213,0.000333,0.424387,11,14004.76686,778.042603,1273.160624,316.919049,16,0
0,0,11,11,14,21,35,48,37,85,0.000333,0.14533,7,3051.923395,169.5513,435.989056,145.541635,3,0
0,0,7,7,12,17,29,29,27,56,0.000333,0.090682,6,1632.281614,90.682312,272.046936,112.506418,2,0
1,0,89,90,31,75,106,321,251,572,0.000333,1.28279,45,173176.6725,9620.92625,3848.3705,620.741487,75,0
1,0,79,80,28,68,96,278,215,493,0.000333,1.082129,42,136348.2335,7574.901863,3246.386513,548.553411,71,0
1,0,71,72,26,64,90,246,189,435,0.000333,0.941319,26,73422.85852,4079.047696,2823.956097,506.211433,70,0
1,0,74,75,30,66,96,265,202,467,0.000333,1.025059,45,138382.987,7687.94372,3075.177488,546.13673,71,0
0,0,17,17,20,32,52,81,65,146,0.000333,0.277421,20,16645.28398,924.737999,832.264199,246.438562,10,0
0,0,17,17,18,27,45,75,58,133,0.000333,0.243472,18,13147.49631,730.416462,730.416462,203.440613,10,0
0,0,22,22,22,33,55,97,75,172,0.000333,0.331465,22,21876.66516,1215.370286,994.393871,264.572502,14,0
0,0,24,24,26,39,65,118,86,204,0.000333,0.409521,26,31942.63888,1774.591049,1228.563034,328.342119,15,0
0,0,20,20,22,31,53,87,67,154,0.000333,0.294033,22,19406.1945,1078.121917,882.09975,251.687581,12,0
1,0,16,17,22,30,52,89,58,147,0.000333,0.279322,11,9217.611024,512.089501,837.964639,245.314213,8,0
0,0,13,13,17,35,52,83,62,145,0.000333,0.275521,8,6612.510073,367.361671,826.563759,249.011774,5,0
0,0,41,41,30,54,84,288,230,518,0.000333,1.10374,60,198673.2255,11037.40142,3311.220425,457.970643,18,0
0,0,15,15,22,32,54,95,67,162,0.000333,0.310764,22,20510.41906,1139.467725,932.291775,258.107496,7,0
0,0,8,8,12,24,36,36,35,71,0.000333,0.122355,6,2202.388051,122.354892,367.064675,153.05865,2,0
0,0,10,10,11,22,33,47,40,87,0.000333,0.146287,5,2194.311442,121.906191,438.862288,136.161243,5,0
0,0,41,41,20,75,95,272,248,520,0.000333,1.138775,30,102489.7475,5693.874861,3416.324916,553.599964,18,0
0,0,25,25,14,55,69,169,168,337,0.000333,0.686191,21,43230.02758,2401.668199,2058.572742,371.277753,15,0
0,0,10,10,16,24,40,49,35,84,0.000333,0.149014,8,3576.33568,198.685316,447.04196,174.0391,3,0
0,0,8,8,13,18,31,25,24,49,0.000333,0.080919,6,1456.533715,80.91854,242.755619,123.164366,3,0
0,0,13,13,18,22,40,66,50,116,0.000333,0.205781,18,11112.18586,617.343659,617.343659,173.166146,8,0
0,0,83,83,29,95,124,462,278,740,0.000333,1.715368,28,144090.9476,8005.052642,5146.10527,765.017732,46,0
0,0,83,83,29,95,124,462,278,740,0.000333,1.715368,28,144090.9476,8005.052642,5146.10527,765.017732,46,0
0,0,10,10,18,23,41,50,42,92,0.000333,0.164298,9,4436.05306,246.447392,492.894784,179.100575,2,0
0,0,19,19,15,41,56,96,72,168,0.000333,0.325212,7,6829.449388,379.413855,975.635627,278.262991,6,0
0,0,16,16,15,39,54,84,65,149,0.000333,0.285826,7,6002.347665,333.463759,857.478238,264.734045,5,0
0,0,15,15,17,23,40,48,46,94,0.000333,0.166754,16,8004.179855,444.676659,500.261241,173.528793,4,0
0,0,17,17,18,26,44,56,53,109,0.000333,0.198359,18,10711.40484,595.078046,595.078046,197.270083,5,0
0,0,5,5,12,19,31,34,31,65,0.000333,0.107341,6,1932.136561,107.34092,322.02276,123.730173,2,0
0,0,4,4,8,20,28,29,29,58,0.000333,0.092942,4,1115.306342,61.961463,278.826585,110.438562,1,0
0,0,4,4,9,17,26,20,21,41,0.000333,0.064239,4,770.872114,42.826229,192.718028,98.016193,2,0
0,0,78,78,25,53,78,410,301,711,0.000333,1.48964,60,268135.2587,14896.40326,4468.920978,419.676189,29,0
0,0,78,78,25,53,78,410,301,711,0.000333,1.48964,60,268135.2587,14896.40326,4468.920978,419.676189,29,0
0,0,78,78,25,53,78,410,301,711,0.000333,1.48964,60,268135.2587,14896.40326,4468.920978,419.676189,29,0
0,0,78,78,25,53,78,410,301,711,0.000333,1.48964,60,268135.2587,14896.40326,4468.920978,419.676189,29,0
0,0,78,78,25,53,78,410,301,711,0.000333,1.48964,60,268135.2587,14896.40326,4468.920978,419.676189,29,0
0,0,42,42,23,42,65,215,158,373,0.000333,0.748781,33,74129.32541,4118.295856,2246.343194,330.519257,15,0
0,0,26,26,18,36,54,112,89,201,0.000333,0.385577,18,20821.18298,1156.732388,1156.732388,261.17595,7,0
0,0,78,78,25,53,78,410,301,711,0.000333,1.48964,60,268135.2587,14896.40326,4468.920978,419.676189,29,0
0,0,32,32,20,37,57,141,113,254,0.000333,0.493851,30,44446.62191,2469.256773,1481.554064,279.188336,9,0
0,0,116,116,27,63,90,518,345,863,0.000333,1.86749,65,364160.4994,20231.13886,5602.469222,504.950598,35,0
0,0,17,17,15,19,34,74,53,127,0.000333,0.215369,14,9045.508932,502.528274,646.107781,139.313982,7,0
0,0,22,22,13,40,53,98,87,185,0.000333,0.353222,12,12715.98341,706.443523,1059.665284,260.98284,5,0
0,0,14,14,13,38,51,79,70,149,0.000333,0.28173,6,5071.148256,281.730459,845.191376,247.526962,4,0
0,0,9,9,13,26,39,44,42,86,0.000333,0.151515,6,2727.267545,151.514864,454.544591,170.317149,4,0
0,0,5,5,8,14,22,15,23,38,0.000333,0.056486,4,677.833606,37.657423,169.458402,77.302969,2,0
0,0,5,5,8,13,21,15,23,38,0.000333,0.055636,4,667.632248,37.09068,166.908062,72.105716,2,0
0,0,5,5,8,14,22,15,23,38,0.000333,0.056486,4,677.833606,37.657423,169.458402,77.302969,2,0
0,0,5,5,8,13,21,15,23,38,0.000333,0.055636,4,667.632248,37.09068,166.908062,72.105716,2,0
0,0,5,5,8,14,22,15,23,38,0.000333,0.056486,4,677.833606,37.657423,169.458402,77.302969,2,0
0,0,5,5,8,13,21,15,23,38,0.000333,0.055636,4,667.632248,37.09068,166.908062,72.105716,2,0
0,0,3,3,8,16,24,14,19,33,0.000333,0.050435,4,605.21505,33.623058,151.303763,88,1,0
0,0,44,44,23,71,94,225,177,402,0.000333,0.878315,22,57968.7838,3220.487989,2634.944718,540.67397,12,0
0,0,43,43,23,71,94,228,176,404,0.000333,0.882685,22,58257.18571,3236.510317,2648.053896,540.67397,12,0
0,0,6,6,13,23,36,38,34,72,0.000333,0.124078,6,2233.407601,124.0782,372.2346,152.147641,1,0
0,0,7,7,13,25,38,48,39,87,0.000333,0.15219,6,2739.418162,152.189898,456.569694,164.202121,1,0
0,0,6,6,13,24,37,42,35,77,0.000333,0.133709,6,2406.767455,133.709303,401.127909,158.144816,1,0
0,0,5,5,13,22,35,37,32,69,0.000333,0.117974,6,2123.523169,117.973509,353.920528,146.213212,1,0
0,0,7,7,12,25,37,53,41,94,0.000333,0.16323,6,2938.131698,163.229539,489.688616,159.115955,1,0
0,0,7,7,18,27,45,62,49,111,0.000333,0.203199,9,5486.361243,304.797847,609.595694,203.440613,2,0
0,0,3,3,12,17,29,26,24,50,0.000333,0.080966,6,1457.394299,80.96635,242.89905,112.506418,1,0
0,0,62,62,26,92,118,351,278,629,0.000333,1.443061,39,168838.1166,9379.895369,4329.182478,722.379133,24,0
0,0,29,29,16,44,60,162,118,280,0.000333,0.55131,16,26462.86987,1470.159437,1653.929367,304.214991,8,0
0,0,27,27,16,41,57,144,105,249,0.000333,0.48413,16,23238.23382,1291.01299,1452.389614,283.659632,6,0
0,0,23,23,14,39,53,114,85,199,0.000333,0.379952,14,15957.98639,886.554799,1139.85617,259.433655,5,0
0,0,15,15,13,31,44,81,58,139,0.000333,0.252954,6,4553.16597,252.953665,758.860995,201.685802,5,0
0,0,14,14,15,25,40,75,53,128,0.000333,0.227069,14,9536.895146,529.827508,681.206796,174.699764,10,0
0,0,81,81,23,88,111,471,375,846,0.000333,1.916025,44,252915.3362,14050.85201,5748.075823,672.471907,26,0
0,0,6,6,12,15,27,26,24,50,0.000333,0.079248,6,1426.466251,79.248125,237.744375,101.622909,6,0
0,0,109,109,25,109,134,535,396,931,0.000333,2.192843,36,236827.0453,13157.05807,6578.529036,853.828496,47,0
0,0,18,18,15,38,53,85,68,153,0.000333,0.292124,7,6134.602807,340.811267,876.37183,258.024604,4,0
0,0,14,14,15,34,49,67,55,122,0.000333,0.228332,7,4794.962207,266.386789,684.994601,231.577096,3,0
0,0,69,69,34,63,97,359,243,602,0.000333,1.324383,51,202630.5241,11257.25134,3973.147531,549.542372,33,0
0,0,52,52,30,58,88,292,202,494,0.000333,1.063653,45,143593.1649,7977.398049,3190.95922,486.969616,27,0
0,0,23,23,24,40,64,122,95,217,0.000333,0.434,24,31248,1736,1302,322.916224,7,0
0,0,22,22,24,38,62,117,89,206,0.000333,0.408855,24,29437.54656,1635.419253,1226.56444,309.460346,7,0
0,0,10,10,19,31,50,61,49,110,0.000333,0.206941,9,5587.417628,310.41209,620.824181,234.290708,2,0
0,0,10,10,19,31,50,61,49,110,0.000333,0.206941,9,5587.417628,310.41209,620.824181,234.290708,2,0
0,0,2,2,9,13,22,13,13,26,0.000333,0.038648,4,463.780888,25.765605,115.945222,76.635041,1,0
0,0,6,6,15,21,36,67,51,118,0.000333,0.20335,14,8540.716102,474.484228,610.05115,150.842025,4,0
1,0,43,44,24,56,80,299,233,532,0.000333,1.121089,48,161436.7558,8968.708657,3363.265746,435.250976,26,0
1,0,43,44,24,56,80,299,233,532,0.000333,1.121089,48,161436.7558,8968.708657,3363.265746,435.250976,26,0
1,0,43,44,24,56,80,299,233,532,0.000333,1.121089,48,161436.7558,8968.708657,3363.265746,435.250976,26,0
1,0,11,12,19,24,43,56,48,104,0.000333,0.188111,18,10157.96762,564.331534,564.331534,190.749723,7,0
1,0,10,11,20,23,43,55,45,100,0.000333,0.180875,10,5426.264755,301.459153,542.626475,190.480487,7,0
1,0,10,11,18,20,38,51,43,94,0.000333,0.164435,18,8879.493353,493.305186,493.305186,161.497212,7,0
1,0,9,10,20,21,41,45,37,82,0.000333,0.14644,10,4393.192644,244.066258,439.319264,178.677228,6,0
1,0,9,10,18,18,36,41,35,76,0.000333,0.130971,9,3536.228701,196.45715,392.9143,150.1173,6,0
0,0,9,9,11,23,34,30,34,64,0.000333,0.108533,5,1627.988109,90.443784,325.597622,142.095673,2,0
0,0,8,8,16,33,49,61,45,106,0.000333,0.198386,8,4761.273948,264.515219,595.159243,230.465006,3,0
0,0,64,64,17,49,66,300,223,523,0.000333,1.053739,32,101158.98,5619.943332,3161.218124,344.607651,20,0
0,0,80,80,21,49,70,372,267,639,0.000333,1.305537,50,195830.5924,10879.47736,3916.611848,367.359448,26,0
0,0,78,78,21,49,70,367,262,629,0.000333,1.285106,50,192765.9509,10709.21949,3855.319018,367.359448,26,0
0,0,73,73,20,49,69,343,248,591,0.000333,1.203379,50,180506.8977,10028.16098,3610.137954,361.559344,24,0
0,0,67,67,18,49,67,315,232,547,0.000333,1.10605,36,119453.4283,6636.301574,3318.150787,350.179432,21,0
0,0,67,67,18,49,67,315,232,547,0.000333,1.10605,36,119453.4283,6636.301574,3318.150787,350.179432,21,0
0,0,64,64,17,50,67,305,226,531,0.000333,1.073698,32,103074.9875,5726.388196,3221.09336,351.679678,20,0
0,0,52,52,17,47,64,247,186,433,0.000333,0.866,24,62352,3464,2598,330.552544,16,0
0,0,50,50,17,47,64,236,178,414,0.000333,0.828,24,59616,3312,2484,330.552544,16,0
0,0,59,59,21,58,79,316,229,545,0.000333,1.145187,30,103066.8152,5725.93418,3435.560508,432.001564,19,0
0,0,49,49,17,47,64,228,173,401,0.000333,0.802,24,57744,3208,2406,330.552544,16,0
0,0,34,34,17,41,58,164,123,287,0.000333,0.560414,24,40349.77309,2241.654061,1681.240546,289.1465,10,0
0,0,28,28,17,36,53,131,101,232,0.000333,0.442959,16,21262.04073,1181.224485,1328.877545,255.604168,8,0
0,0,17,17,13,27,40,87,70,157,0.000333,0.278514,12,10026.51253,557.028474,835.542711,176.487679,5,0
0,0,14,14,12,27,39,71,60,131,0.000333,0.230796,12,8308.652288,461.591794,692.387691,171.401513,4,0
0,0,6,6,10,23,33,34,32,66,0.000333,0.110977,5,1664.650059,92.480559,332.930012,137.261206,2,0
0,0,12,12,19,25,44,67,40,107,0.000333,0.19472,9,5257.432649,292.079592,584.159183,196.807027,7,0
0,0,14,14,13,25,38,51,51,102,0.000333,0.17843,12,6423.463276,356.859071,535.288606,164.202121,3,0
0,0,7,7,11,17,28,25,28,53,0.000333,0.08493,5,1273.949054,70.774947,254.789811,107.540616,2,0
0,0,26,26,22,45,67,133,106,239,0.000333,0.483265,22,31895.49696,1771.972054,1449.795317,345.240885,10,0
0,0,23,23,22,40,62,116,92,208,0.000333,0.412824,22,27246.40232,1513.689018,1238.472833,310.984619,9,0
0,0,16,16,26,35,61,87,72,159,0.000333,0.314329,26,24517.66815,1362.092675,942.987237,301.736338,5,0
0,0,45,45,22,58,80,222,173,395,0.000333,0.832387,22,54937.55515,3052.086397,2497.161597,437.870393,21,0
0,0,47,47,24,58,82,215,170,385,0.000333,0.815886,24,58743.78052,3263.543362,2447.657522,449.801998,19,0
0,0,36,36,22,54,76,175,136,311,0.000333,0.647702,22,42748.32005,2374.906669,1943.105457,408.871421,17,0
0,0,36,36,22,54,76,175,136,311,0.000333,0.647702,22,42748.32005,2374.906669,1943.105457,408.871421,17,0
0,0,36,36,22,54,76,175,136,311,0.000333,0.647702,22,42748.32005,2374.906669,1943.105457,408.871421,17,0
0,0,23,23,14,38,52,83,77,160,0.000333,0.304023,14,12768.98497,709.388054,912.070355,252.724214,7,0
0,0,22,22,14,38,52,80,74,154,0.000333,0.292623,7,6145.074016,341.393001,877.867717,252.724214,7,0
0,0,36,36,15,33,48,106,107,213,0.000333,0.396532,21,24981.53727,1387.863181,1189.597013,225.068365,11,0
0,0,25,25,14,28,42,76,78,154,0.000333,0.276806,14,11625.83636,645.879798,830.416883,187.908907,9,0
0,0,13,13,13,24,37,42,45,87,0.000333,0.151074,6,2719.334657,151.074148,453.222443,158.144816,7,0
0,0,8,8,13,15,28,25,22,47,0.000333,0.075315,6,1355.674088,75.315227,225.945681,106.709075,2,0
0,0,57,57,24,55,79,253,190,443,0.000333,0.930858,36,100532.6954,5585.149743,2792.574871,428.013884,19,0
0,0,17,17,14,34,48,80,69,149,0.000333,0.277386,14,11650.23178,647.235099,832.159413,226.276706,6,0
0,0,7,7,13,17,30,25,27,52,0.000333,0.085053,6,1530.949866,85.05277,255.158311,117.592585,5,0
0,0,83,83,21,44,65,266,226,492,0.000333,0.987668,50,148150.2482,8230.569344,2963.004964,332.453657,20,0
0,0,74,74,21,43,64,238,205,443,0.000333,0.886,40,106320,5906.666667,2658,325.56805,18,0
0,0,9,9,14,23,37,32,38,70,0.000333,0.121554,7,2552.632149,141.812897,364.661736,157.344894,2,0
0,0,13,13,23,48,71,114,100,214,0.000333,0.438682,22,28953.00944,1608.500524,1316.045884,372.120125,10,0
0,0,16,16,23,52,75,129,111,240,0.000333,0.498305,22,32888.16269,1827.120149,1494.916486,400.46479,11,0
0,0,34,34,13,34,47,102,106,208,0.000333,0.385118,18,20796.38066,1155.354481,1155.354481,221.079453,6,0
0,0,34,34,13,35,48,109,108,217,0.000333,0.403979,18,21814.86353,1211.936863,1211.936863,227.630622,7,0
0,0,31,31,13,33,46,95,97,192,0.000333,0.353508,12,12726.28675,707.01593,1060.523896,214.570722,6,0
0,0,31,31,13,33,46,95,97,192,0.000333,0.353508,12,12726.28675,707.01593,1060.523896,214.570722,6,0
0,0,26,26,17,39,56,132,107,239,0.000333,0.462653,16,22207.32522,1233.74029,1387.957826,275.617555,5,0
0,0,21,21,17,37,54,108,89,197,0.000333,0.377904,16,18139.40541,1007.744745,1133.712838,262.236643,4,0
0,0,16,16,16,35,51,76,67,143,0.000333,0.270386,8,6489.254591,360.514144,811.156824,243.524906,3,0
0,0,17,17,15,27,42,72,64,136,0.000333,0.244452,14,10266.97237,570.387354,733.355169,186.985321,4,0
0,0,8,8,8,13,21,20,16,36,0.000333,0.052708,4,632.493709,35.138539,158.123427,72.105716,1,0
0,0,8,8,19,18,37,52,43,95,0.000333,0.164966,18,8908.165255,494.89807,494.89807,155.769273,5,0
0,0,10,10,20,23,43,69,56,125,0.000333,0.226094,20,13565.66189,753.647883,678.283094,190.480487,6,0
0,0,8,8,20,23,43,61,48,109,0.000333,0.197154,20,11829.25717,657.180954,591.462858,190.480487,5,0
0,0,24,24,18,41,59,133,108,241,0.000333,0.472572,18,25518.90555,1417.716975,1417.716975,294.718282,14,0
0,0,9,9,13,26,39,45,44,89,0.000333,0.1568,6,2822.404785,156.800266,470.400797,170.317149,3,0
0,0,11,11,14,22,36,50,38,88,0.000333,0.151651,7,3184.673801,176.926322,454.9534,151.410465,5,0
0,0,13,13,16,35,51,87,83,170,0.000333,0.321437,16,15428.99693,857.166496,964.312308,243.524906,6,0
0,0,28,28,19,47,66,182,159,341,0.000333,0.687046,27,55650.73666,3091.707592,2061.138395,341.776299,13,0
0,0,28,28,19,47,66,182,159,341,0.000333,0.687046,27,55650.73666,3091.707592,2061.138395,341.776299,13,0
0,0,28,28,19,47,66,182,159,341,0.000333,0.687046,27,55650.73666,3091.707592,2061.138395,341.776299,13,0
0,0,28,28,19,47,66,182,159,341,0.000333,0.687046,27,55650.73666,3091.707592,2061.138395,341.776299,13,0
0,0,17,17,16,42,58,116,108,224,0.000333,0.437396,16,20995.00389,1166.389105,1312.187743,290.477332,8,0
0,0,15,15,16,37,53,100,94,194,0.000333,0.370406,16,17779.46509,987.748061,1111.216568,256.749775,7,0
0,0,11,11,16,31,47,80,75,155,0.000333,0.286987,16,13775.38035,765.298908,860.961272,217.580086,6,0
0,0,8,8,12,26,38,42,47,89,0.000333,0.155689,6,2802.393292,155.688516,467.065549,165.230983,3,0
0,0,5,5,12,19,31,23,28,51,0.000333,0.084221,6,1515.984071,84.221337,252.664012,123.730173,2,0
0,0,5,5,12,19,31,23,28,51,0.000333,0.084221,6,1515.984071,84.221337,252.664012,123.730173,2,0
0,0,13,13,21,22,43,57,46,103,0.000333,0.186302,20,11178.1054,621.005855,558.90527,190.346161,11,0
0,0,4,4,13,13,26,19,17,36,0.000333,0.056405,6,1015.294979,56.405277,169.21583,96.211433,4,0
0,0,9,9,15,24,39,53,48,101,0.000333,0.177942,14,7473.558737,415.197708,533.825624,168.642459,2,0
0,0,2,2,11,12,23,14,14,28,0.000333,0.04222,5,633.298674,35.18326,126.659735,81.073298,1,0
0,0,61,61,28,71,99,407,337,744,0.000333,1.64408,56,276205.5142,15344.75079,4932.241325,571.237983,19,0
0,0,51,51,28,69,97,340,284,624,0.000333,1.372782,56,230627.3544,12812.6308,4118.345614,556.094125,16,0
0,0,41,41,26,64,90,274,228,502,0.000333,1.086303,39,127097.4999,7060.972218,3258.910254,506.211433,14,0
0,0,19,19,22,38,60,121,100,221,0.000333,0.435141,22,28719.30208,1595.516782,1305.422822,297.528741,10,0
0,0,9,9,15,27,42,56,47,103,0.000333,0.185136,7,3887.860862,215.99227,555.408695,186.985321,2,0
0,0,7,7,14,24,38,48,42,90,0.000333,0.157438,7,3306.194333,183.677463,472.313476,163.342069,2,0
0,0,108,108,26,45,71,425,307,732,0.000333,1.500538,78,351125.9615,19506.99786,4501.614891,369.344822,28,0
0,0,107,107,26,45,71,421,304,725,0.000333,1.486189,78,347768.1996,19320.45553,4458.566662,369.344822,28,0
0,0,106,106,26,45,71,417,301,718,0.000333,1.471839,78,344410.4377,19133.9132,4415.518432,369.344822,28,0
0,0,105,105,26,45,71,413,298,711,0.000333,1.45749,78,341052.6758,18947.37088,4372.470202,369.344822,28,0
0,0,104,104,26,45,71,409,295,704,0.000333,1.443141,78,337694.9138,18760.82855,4329.421972,369.344822,28,0
0,0,104,104,26,45,71,409,295,704,0.000333,1.443141,78,337694.9138,18760.82855,4329.421972,369.344822,28,0
0,0,104,104,26,45,71,409,295,704,0.000333,1.443141,78,337694.9138,18760.82855,4329.421972,369.344822,28,0
0,0,104,104,26,45,71,409,295,704,0.000333,1.443141,78,337694.9138,18760.82855,4329.421972,369.344822,28,0
0,0,60,60,30,54,84,276,210,486,0.000333,1.035555,45,139799.982,7766.665669,3106.666267,457.970643,24,0
0,0,6,6,10,13,23,28,28,56,0.000333,0.08444,10,2533.194695,140.733039,253.31947,81.324997,4,0
0,0,5,5,10,12,22,23,23,46,0.000333,0.068378,5,1025.669272,56.981626,205.133854,76.238831,4,0
0,0,10,10,11,20,31,39,36,75,0.000333,0.123855,5,1857.823616,103.212423,371.564723,124.49231,4,0
0,0,10,10,18,26,44,64,49,113,0.000333,0.205639,9,5552.241956,308.457886,616.915773,197.270083,7,0
1,0,7,8,12,12,24,44,24,68,0.000333,0.103926,12,3741.329401,207.851633,311.77745,86.0391,2,0
0,0,4,4,10,10,20,19,13,32,0.000333,0.046101,5,691.508495,38.417139,138.301699,66.438562,1,0
0,0,56,56,19,41,60,227,164,391,0.000333,0.769865,36,83145.39202,4619.188446,2309.594223,300.370255,13,0
0,0,8,8,19,21,40,63,40,103,0.000333,0.18272,9,4933.427344,274.079297,548.158594,172.949289,5,0
0,0,10,10,14,28,42,41,37,78,0.000333,0.1402,7,2944.205313,163.566962,420.600759,187.908907,1,0
0,0,12,12,16,26,42,50,43,93,0.000333,0.167162,8,4011.884163,222.882453,501.48552,186.211433,2,0
1,0,13,14,21,32,53,85,63,148,0.000333,0.282577,10,8477.322273,470.962348,847.732227,252.238666,20,0
1,0,15,16,22,34,56,90,69,159,0.000333,0.30779,22,20314.12752,1128.56264,923.369433,271.081232,21,0
0,0,10,10,13,18,31,31,27,58,0.000333,0.095781,6,1724.060316,95.781129,287.343386,123.164366,5,0
0,0,10,10,12,22,34,49,44,93,0.000333,0.157711,12,5677.608531,315.422696,473.134044,141.127046,2,0
0,0,10,10,12,26,38,40,39,79,0.000333,0.138195,6,2487.517641,138.195425,414.586274,165.230983,2,0
0,0,9,9,17,32,49,65,53,118,0.000333,0.220845,8,5300.286093,294.460338,662.535762,229.486868,5,0
0,0,9,9,17,32,49,65,53,118,0.000333,0.220845,8,5300.286093,294.460338,662.535762,229.486868,5,0
0,0,16,16,12,45,57,90,80,170,0.000333,0.33053,6,5949.547814,330.530434,991.591302,290.152939,6,0
0,0,3,3,9,23,32,24,27,51,0.000333,0.085,4,1020,56.666667,255,132.57125,1,0
0,0,15,15,15,47,62,81,76,157,0.000333,0.311603,7,6543.661745,363.536764,934.808821,319.669035,3,0
0,0,11,11,12,36,48,55,59,114,0.000333,0.212229,6,3820.11435,212.228575,636.685725,229.13685,3,0
0,0,9,9,12,34,46,47,52,99,0.000333,0.182278,6,3280.995802,182.277545,546.832634,215.993287,2,0
0,0,14,14,13,39,52,64,67,131,0.000333,0.248919,6,4480.545618,248.919201,746.757603,254.236403,3,0
0,0,11,11,12,33,45,52,56,108,0.000333,0.197707,6,3558.720806,197.706711,593.120134,209.484556,3,0
0,0,9,9,11,31,42,44,49,93,0.000333,0.167162,5,2507.427602,139.301533,501.48552,191.633833,2,0
0,0,13,13,13,31,44,60,59,119,0.000333,0.216557,6,3898.034176,216.557454,649.672363,201.685802,3,0
0,0,4,4,9,16,25,15,19,34,0.000333,0.05263,4,631.564442,35.086913,157.89111,92.529325,1,0
0,0,7,7,12,18,30,27,28,55,0.000333,0.08996,6,1619.273897,89.959661,269.878983,118.0782,3,0
1,0,31,32,23,54,77,210,166,376,0.000333,0.785437,33,77758.2874,4319.904855,2356.311739,414.80585,15,0
1,0,31,32,23,54,77,210,166,376,0.000333,0.785437,33,77758.2874,4319.904855,2356.311739,414.80585,15,0
1,0,11,12,19,24,43,56,48,104,0.000333,0.188111,18,10157.96762,564.331534,564.331534,190.749723,7,0
1,0,10,11,20,23,43,55,45,100,0.000333,0.180875,10,5426.264755,301.459153,542.626475,190.480487,7,0
1,0,10,11,18,20,38,51,43,94,0.000333,0.164435,18,8879.493353,493.305186,493.305186,161.497212,7,0
1,0,9,10,20,21,41,45,37,82,0.000333,0.14644,10,4393.192644,244.066258,439.319264,178.677228,6,0
1,0,9,10,18,18,36,41,35,76,0.000333,0.130971,9,3536.228701,196.45715,392.9143,150.1173,6,0
0,0,6,6,15,18,33,32,29,61,0.000333,0.102569,7,2153.956289,119.664238,307.708041,133.662009,2,0
0,0,7,7,12,23,35,26,30,56,0.000333,0.095747,6,1723.439094,95.746616,287.239849,147.061475,1,0
0,0,32,32,25,36,61,146,106,252,0.000333,0.498182,24,35869.09942,1992.727745,1494.545809,302.213705,12,0
0,0,11,11,17,16,33,52,37,89,0.000333,0.14965,16,7183.217226,399.067624,448.951077,133.486868,4,0
0,0,10,10,10,18,28,36,34,70,0.000333,0.112172,5,1682.574223,93.476346,336.514845,108.277931,4,0
0,0,47,47,19,39,58,197,138,335,0.000333,0.654141,27,52985.4381,2943.63545,1962.423633,286.841309,20,0
0,0,48,48,19,39,58,201,141,342,0.000333,0.66781,27,54092.59651,3005.144251,2003.4295,286.841309,20,0
0,0,47,47,19,39,58,197,138,335,0.000333,0.654141,27,52985.4381,2943.63545,1962.423633,286.841309,20,0
0,0,46,46,19,39,58,193,135,328,0.000333,0.640473,27,51878.27969,2882.12665,1921.417766,286.841309,20,0
0,0,46,46,19,39,58,193,135,328,0.000333,0.640473,27,51878.27969,2882.12665,1921.417766,286.841309,20,0
0,0,5,5,11,17,28,16,24,40,0.000333,0.064098,5,961.470984,53.415055,192.294197,107.540616,1,0
0,0,33,33,24,57,81,173,158,331,0.000333,0.699497,24,50363.76842,2797.987135,2098.490351,442.513831,12,0
0,0,33,33,24,55,79,174,153,327,0.000333,0.687112,24,49472.07131,2748.448406,2061.336305,428.013884,12,0
0,0,29,29,22,45,67,130,114,244,0.000333,0.493375,22,32562.76677,1809.042599,1480.125762,345.240885,15,0
0,0,13,13,18,29,47,71,48,119,0.000333,0.220332,9,5948.96466,330.498037,660.996073,215.940099,7,0
0,0,13,13,9,21,30,49,48,97,0.000333,0.158656,8,3807.747102,211.541506,475.968388,120.767991,4,0
0,0,13,13,9,21,30,49,48,97,0.000333,0.158656,8,3807.747102,211.541506,475.968388,120.767991,4,0
0,0,8,8,9,18,27,25,31,56,0.000333,0.088758,4,1065.0948,59.171933,266.2737,103.587975,2,0
0,0,8,8,9,18,27,25,31,56,0.000333,0.088758,4,1065.0948,59.171933,266.2737,103.587975,2,0
0,0,19,19,26,43,69,120,103,223,0.000333,0.454067,26,35417.2248,1967.6236,1362.200954,355.540817,8,0
0,0,22,22,25,46,71,142,116,258,0.000333,0.528878,24,38079.23416,2115.513009,1586.634757,370.180255,9,0
0,0,7,7,14,27,41,44,43,87,0.000333,0.155369,7,3262.749171,181.263843,466.107024,181.684931,5,0
0,0,7,7,14,27,41,40,41,81,0.000333,0.144654,7,3037.731987,168.762888,433.961712,181.684931,5,0
1,0,19,20,17,34,51,115,72,187,0.000333,0.353581,16,16971.89662,942.883146,1060.743539,242.460605,12,0
0,0,4,4,12,13,25,26,20,46,0.000333,0.071206,6,1281.704308,71.205795,213.617385,91.125266,2,0
0,0,7,7,12,21,33,40,36,76,0.000333,0.127791,6,2300.243718,127.791318,383.373953,135.258216,2,0
0,0,4,4,9,22,31,31,33,64,0.000333,0.10569,4,1268.274255,70.459681,317.068564,126.636821,2,0
0,0,4,4,9,17,26,22,24,46,0.000333,0.072073,4,864.880908,48.048939,216.220227,98.016193,1,0
0,0,3,3,8,15,23,17,20,37,0.000333,0.055791,4,669.487169,37.193732,167.371792,82.603359,1,0
0,0,3,3,8,15,23,19,21,40,0.000333,0.060314,4,723.769913,40.20944,180.942478,82.603359,1,0
0,0,17,17,16,29,45,70,62,132,0.000333,0.241642,16,11598.79374,644.37743,724.924609,204.881449,4,0
0,0,7,7,12,21,33,40,36,76,0.000333,0.127791,6,2300.243718,127.791318,383.373953,135.258216,2,0
0,0,4,4,9,22,31,31,33,64,0.000333,0.10569,4,1268.274255,70.459681,317.068564,126.636821,2,0
0,0,4,4,9,17,26,22,24,46,0.000333,0.072073,4,864.880908,48.048939,216.220227,98.016193,1,0
0,0,3,3,8,15,23,17,20,37,0.000333,0.055791,4,669.487169,37.193732,167.371792,82.603359,1,0
0,0,3,3,8,15,23,19,21,40,0.000333,0.060314,4,723.769913,40.20944,180.942478,82.603359,1,0
0,0,17,17,16,29,45,70,62,132,0.000333,0.241642,16,11598.79374,644.37743,724.924609,204.881449,4,0
0,0,6,6,12,15,27,26,24,50,0.000333,0.079248,6,1426.466251,79.248125,237.744375,101.622909,6,0
0,0,10,10,12,16,28,28,29,57,0.000333,0.09134,6,1644.115383,91.339744,274.019231,107.01955,2,0
0,0,7,7,9,16,25,21,24,45,0.000333,0.069658,4,835.894114,46.438562,208.973529,92.529325,8,0
0,0,13,13,16,30,46,66,52,118,0.000333,0.21726,8,5214.242487,289.680138,651.780311,211.206718,4,0
0,0,12,12,15,28,43,60,46,106,0.000333,0.191728,7,4026.288448,223.682692,575.184064,193.209297,4,0
0,0,18,18,17,39,56,100,71,171,0.000333,0.331019,8,7944.461533,441.358974,993.057692,275.617555,3,0
0,0,17,17,17,38,55,93,66,159,0.000333,0.306412,8,7353.889556,408.54942,919.236194,268.908114,3,0
0,0,24,24,19,48,67,142,96,238,0.000333,0.481243,18,25987.12609,1443.729227,1443.729227,348.788823,7,0
0,0,6,6,12,20,32,33,27,60,0.000333,0.1,6,1800,100,300,129.458112,1,0
0,0,6,6,13,18,31,35,24,59,0.000333,0.097433,6,1753.785494,97.432527,292.297582,123.164366,2,0
0,0,8,8,14,24,38,39,33,72,0.000333,0.12595,7,2644.955467,146.94197,377.850781,163.342069,2,0
0,0,5,5,8,14,22,15,23,38,0.000333,0.056486,4,677.833606,37.657423,169.458402,77.302969,2,0
0,0,5,5,8,13,21,15,23,38,0.000333,0.055636,4,667.632248,37.09068,166.908062,72.105716,2,0
0,0,15,15,14,33,47,78,51,129,0.000333,0.238847,7,5015.793733,278.655207,716.541962,219.767975,5,0
0,0,14,14,14,30,44,66,46,112,0.000333,0.203819,7,4280.194389,237.788577,611.456341,200.509687,5,0
0,0,64,64,25,68,93,396,305,701,0.000333,1.527983,48,220029.6157,12223.86754,4583.950327,530.043878,25,0
0,0,64,64,25,68,93,396,305,701,0.000333,1.527983,48,220029.6157,12223.86754,4583.950327,530.043878,25,0
0,0,64,64,25,68,93,396,305,701,0.000333,1.527983,48,220029.6157,12223.86754,4583.950327,530.043878,25,0
0,0,4,4,15,13,28,23,21,44,0.000333,0.070508,7,1480.665316,82.259184,211.523617,106.709075,2,0
0,0,74,74,24,102,126,434,374,808,0.000333,1.879214,36,202955.1184,11275.28436,5637.642178,790.626485,50,0
0,0,74,74,24,102,126,434,374,808,0.000333,1.879214,36,202955.1184,11275.28436,5637.642178,790.626485,50,0
0,0,41,41,24,66,90,242,198,440,0.000333,0.952138,36,102830.953,5712.830725,2856.415362,508.969112,22,0
0,0,32,32,23,52,75,187,156,343,0.000333,0.712162,33,70503.99876,3916.88882,2136.484811,400.46479,20,0
0,0,20,20,21,50,71,143,121,264,0.000333,0.541178,20,32470.66479,1803.925822,1623.53324,374.431475,16,0
0,0,19,19,18,38,56,118,102,220,0.000333,0.425873,18,22997.12549,1277.618083,1277.618083,274.479896,14,0
0,0,19,19,18,38,56,118,102,220,0.000333,0.425873,18,22997.12549,1277.618083,1277.618083,274.479896,14,0
0,0,39,39,28,51,79,255,188,443,0.000333,0.930858,42,117288.1446,6516.008033,2792.574871,423.89963,19,0
0,0,37,37,28,51,79,241,177,418,0.000333,0.878327,42,110669.1748,6148.28749,2634.980353,423.89963,18,0
0,0,35,35,28,50,78,227,166,393,0.000333,0.823388,42,103746.849,5763.713835,2470.163072,416.798747,17,0
0,0,33,33,27,48,75,213,155,368,0.000333,0.764068,39,89396.00585,4966.444769,2292.205278,396.460163,16,0
0,0,3,3,9,13,22,16,19,35,0.000333,0.052027,4,624.320427,34.684468,156.080107,76.635041,1,0
0,0,63,63,22,104,126,303,254,557,0.000333,1.295448,22,85499.58818,4749.977121,3886.344917,794.953226,13,0
0,0,49,49,21,89,110,233,194,427,0.000333,0.965214,20,57912.81195,3217.378442,2895.640598,668.578941,9,0
0,0,49,49,21,89,110,233,194,427,0.000333,0.965214,20,57912.81195,3217.378442,2895.640598,668.578941,9,0
0,0,23,23,14,55,69,108,92,200,0.000333,0.407235,7,8551.934239,475.107458,1221.704891,371.277753,5,0
0,0,9,9,12,33,45,56,44,100,0.000333,0.183062,6,3295.111858,183.06177,549.18531,209.484556,5,0
1,0,5,6,8,13,21,14,19,33,0.000333,0.048315,4,579.7859,32.210328,144.946475,72.105716,2,0
0,0,6,6,12,18,30,37,25,62,0.000333,0.101409,6,1825.363302,101.409072,304.227217,118.0782,3,0
0,0,13,13,16,34,50,62,59,121,0.000333,0.227636,8,5463.252792,303.514044,682.906599,236.973737,6,0
0,0,12,12,16,32,48,56,53,109,0.000333,0.20292,8,4870.087301,270.560406,608.760913,224,6,0
0,0,30,30,23,61,84,181,135,316,0.000333,0.673324,22,44439.39072,2468.85504,2019.972306,465.816903,20,0
0,0,15,15,22,32,54,88,60,148,0.000333,0.283908,11,9368.956854,520.497603,851.72335,258.107496,10,0
0,0,61,61,24,103,127,302,257,559,0.000333,1.302225,24,93760.19376,5208.899653,3906.67474,798.748654,35,0
0,0,19,19,22,45,67,112,104,216,0.000333,0.436758,22,28826.05583,1601.447546,1310.275265,345.240885,15,0
0,0,18,18,13,31,44,76,72,148,0.000333,0.269332,12,9695.950555,538.66392,807.99588,201.685802,4,0
0,0,19,19,13,32,45,82,78,160,0.000333,0.292899,12,10544.35795,585.797664,878.696495,208.105716,4,0
0,0,16,16,13,30,43,66,65,131,0.000333,0.236947,12,8530.088194,473.893789,710.840683,195.312434,3,0
0,0,5,5,9,19,28,23,28,51,0.000333,0.081725,4,980.700404,54.483356,245.175101,109.239948,1,0
0,0,29,29,16,38,54,127,116,243,0.000333,0.466146,24,33562.50391,1864.583551,1398.437663,263.421246,7,0
0,0,18,18,17,35,52,77,63,140,0.000333,0.266021,8,6384.492484,354.694027,798.061561,249.011774,6,0
0,0,46,46,32,73,105,274,196,470,0.000333,1.051898,32,100982.2526,5610.125144,3155.695393,611.857193,20,0
0,0,13,13,15,31,46,78,65,143,0.000333,0.26329,14,11058.17104,614.342835,789.86936,212.183445,4,0
0,0,10,10,14,31,45,63,54,117,0.000333,0.214182,7,4497.827686,249.879316,642.546812,206.883055,3,0
0,0,8,8,14,24,38,50,42,92,0.000333,0.160936,7,3379.665319,187.759184,482.809331,163.342069,3,0
0,0,3,3,10,16,26,21,23,44,0.000333,0.06894,5,1034.096738,57.449819,206.819348,97.219281,1,0
0,0,12,12,14,26,40,66,48,114,0.000333,0.202233,7,4246.89862,235.938812,606.699803,175.514402,3,0
0,0,36,36,25,44,69,153,133,286,0.000333,0.582346,36,62893.36781,3494.075989,1747.037995,356.311396,15,0
0,0,38,38,27,45,72,160,140,300,0.000333,0.616993,39,72188.12252,4010.451251,1850.9775,375.515352,15,0
0,0,61,61,24,65,89,424,311,735,0.000333,1.586555,48,228463.8754,12692.43753,4759.664072,501.493008,46,0
0,0,40,40,19,51,70,153,150,303,0.000333,0.619058,18,33429.10957,1857.172754,1857.172754,370.004315,11,0
0,0,15,15,20,27,47,62,52,114,0.000333,0.211074,10,6332.231291,351.790627,633.223129,214.820524,4,0
0,0,17,17,20,28,48,68,57,125,0.000333,0.232707,20,13962.40625,775.689236,698.120313,221.0445,4,0
0,0,51,51,27,47,74,232,193,425,0.000333,0.879673,52,137228.9194,7623.828854,2639.01768,389.447639,35,0
0,0,11,11,15,25,40,40,41,81,0.000333,0.143692,7,3017.53323,167.640735,431.076176,174.699764,6,0
0,0,6,6,8,24,32,27,29,56,0.000333,0.093333,4,1120,62.222222,280,134.0391,1,0
0,0,25,25,13,55,68,134,124,258,0.000333,0.523522,12,18846.78496,1047.043609,1570.565413,366.080501,3,0
0,0,19,19,13,48,61,92,87,179,0.000333,0.353867,6,6369.611901,353.867328,1061.601983,316.183916,3,0
0,0,22,22,13,51,64,108,101,209,0.000333,0.418,6,7524,418,1254,337.399409,3,0
0,0,15,15,13,40,53,73,70,143,0.000333,0.273031,6,4914.55575,273.030875,819.092625,260.98284,3,0
0,0,14,14,12,34,46,54,54,108,0.000333,0.198848,6,3579.268148,198.84823,596.544691,215.993287,2,0
0,0,10,10,12,30,42,45,44,89,0.000333,0.159972,6,2879.497504,159.972084,479.916251,190.226268,2,0
0,0,29,29,20,37,57,119,86,205,0.000333,0.398581,20,23914.84906,1328.602725,1195.742453,279.188336,17,0
0,0,10,10,12,21,33,42,37,79,0.000333,0.132836,6,2391.042813,132.835712,398.507135,135.258216,2,0
0,0,15,15,14,26,40,61,56,117,0.000333,0.207555,14,8717.318219,484.295457,622.665587,175.514402,3,0
0,0,10,10,12,21,33,42,37,79,0.000333,0.132836,6,2391.042813,132.835712,398.507135,135.258216,2,0
0,0,15,15,14,26,40,61,56,117,0.000333,0.207555,14,8717.318219,484.295457,622.665587,175.514402,3,0
0,0,8,8,12,20,32,35,38,73,0.000333,0.121667,6,2190,121.666667,365,129.458112,4,0
0,0,6,6,12,16,28,21,26,47,0.000333,0.075315,6,1355.674088,75.315227,225.945681,107.01955,3,0
0,0,6,6,15,20,35,68,47,115,0.000333,0.196623,14,8258.145657,458.78587,589.867547,145.041921,2,0
0,0,6,6,15,20,35,68,47,115,0.000333,0.196623,14,8258.145657,458.78587,589.867547,145.041921,2,0
0,0,14,14,13,30,43,106,90,196,0.000333,0.354516,18,19143.86206,1063.547892,1063.547892,195.312434,9,0
0,0,13,13,13,29,42,99,84,183,0.000333,0.328931,12,11841.52906,657.862726,986.794088,188.987165,9,0
0,0,12,12,12,26,38,88,76,164,0.000333,0.286887,12,10327.92135,573.773408,860.660112,165.230983,9,0
0,0,11,11,12,26,38,81,70,151,0.000333,0.264146,12,9509.244654,528.29137,792.437055,165.230983,9,0
0,0,6,6,12,19,31,39,38,77,0.000333,0.127158,12,4577.677391,254.315411,381.473116,123.730173,4,0
0,0,6,6,15,18,33,66,43,109,0.000333,0.18328,14,7697.745426,427.652524,549.838959,133.662009,2,0
0,0,6,6,15,18,33,66,43,109,0.000333,0.18328,14,7697.745426,427.652524,549.838959,133.662009,2,0
0,0,7,7,18,20,38,83,50,133,0.000333,0.232658,18,12563.53847,697.974359,697.974359,161.497212,4,0
0,0,7,7,18,20,38,83,50,133,0.000333,0.232658,18,12563.53847,697.974359,697.974359,161.497212,4,0
0,0,6,6,14,21,35,39,37,76,0.000333,0.129942,7,2728.778565,151.598809,389.825509,145.541635,4,0
0,0,9,9,15,26,41,58,48,106,0.000333,0.1893,7,3975.303587,220.850199,567.900512,180.814792,2,0
0,0,7,7,14,23,37,50,43,93,0.000333,0.161493,7,3391.354141,188.408563,484.479163,157.344894,2,0
0,0,6,6,15,17,32,30,23,53,0.000333,0.088333,7,1855,103.055556,265,128.090227,3,0
0,0,2,2,8,9,17,13,12,25,0.000333,0.034062,4,408.746284,22.708127,102.186571,52.529325,1,0
0,0,6,6,15,17,32,30,23,53,0.000333,0.088333,7,1855,103.055556,265,128.090227,3,0
0,0,2,2,8,9,17,13,12,25,0.000333,0.034062,4,408.746284,22.708127,102.186571,52.529325,1,0
0,0,5,5,11,14,25,23,19,42,0.000333,0.065014,5,975.2098,54.178322,195.04196,91.356717,2,0
0,0,14,14,17,25,42,76,54,130,0.000333,0.233667,16,11216.02024,623.112236,701.001265,185.583273,9,0
0,0,43,43,22,55,77,175,144,319,0.000333,0.666368,22,43980.30794,2443.350441,1999.104906,416.08228,14,0
0,0,43,43,22,55,77,175,144,319,0.000333,0.666368,22,43980.30794,2443.350441,1999.104906,416.08228,14,0
0,0,40,40,19,71,90,183,154,337,0.000333,0.729251,18,39379.58088,2187.754493,2187.754493,517.342668,25,0
0,0,14,14,22,40,62,107,76,183,0.000333,0.363206,11,11985.79717,665.877621,1089.617925,310.984619,7,0
0,0,7,7,15,26,41,60,43,103,0.000333,0.183943,7,3862.794995,214.599722,551.827856,180.814792,6,0
0,0,5,5,14,20,34,40,32,72,0.000333,0.122099,7,2564.081272,142.44896,366.297325,139.741531,4,0
0,0,11,11,14,21,35,48,37,85,0.000333,0.14533,7,3051.923395,169.5513,435.989056,145.541635,3,0
0,0,7,7,12,17,29,29,27,56,0.000333,0.090682,6,1632.281614,90.682312,272.046936,112.506418,2,0
0,0,10,10,14,25,39,47,44,91,0.000333,0.160324,7,3366.801213,187.044512,480.971602,169.399374,4,0
0,0,7,7,13,23,36,35,34,69,0.000333,0.118908,6,2140.348951,118.908275,356.724825,152.147641,3,0
0,0,13,13,18,23,41,76,58,134,0.000333,0.239304,18,12922.41544,717.911969,717.911969,179.100575,8,0
0,0,5,5,13,19,32,30,25,55,0.000333,0.091667,6,1650,91.666667,275,128.816339,2,0
0,0,10,10,15,24,39,46,40,86,0.000333,0.151515,7,3181.812136,176.767341,454.544591,168.642459,3,0
0,0,19,19,13,32,45,95,78,173,0.000333,0.316697,12,11401.08703,633.393724,950.090586,208.105716,6,0
0,0,18,18,13,31,44,90,73,163,0.000333,0.296629,12,10678.64825,593.258236,889.887354,201.685802,6,0
0,0,17,17,13,30,43,85,68,153,0.000333,0.27674,12,9962.62209,553.479005,830.218507,195.312434,6,0
0,0,16,16,13,29,42,80,63,143,0.000333,0.257034,12,9253.216697,514.067594,771.101391,188.987165,6,0
0,0,11,11,13,24,37,48,38,86,0.000333,0.149338,6,2688.077937,149.337663,448.012989,158.144816,4,0
0,0,30,30,16,41,57,157,112,269,0.000333,0.523016,16,25104.75862,1394.708812,1569.047414,283.659632,17,0
0,0,28,28,16,39,55,150,103,253,0.000333,0.487561,16,23402.94412,1300.163562,1462.684008,270.130687,17,0
0,0,37,37,17,56,73,253,181,434,0.000333,0.895461,24,64473.21261,3581.845145,2686.383859,394.698744,17,0
0,0,33,33,17,51,68,208,147,355,0.000333,0.72035,16,34576.78894,1920.932719,2161.049309,358.780561,17,0
0,0,30,30,17,51,68,178,121,299,0.000333,0.606717,16,29122.42223,1617.912346,1820.15139,358.780561,17,0
0,0,32,32,23,47,70,162,120,282,0.000333,0.576153,22,38026.07184,2112.559547,1728.457811,365.107601,17,0
0,0,25,25,16,38,54,120,91,211,0.000333,0.40476,16,19428.50021,1079.361123,1214.281263,263.421246,13,0
0,0,38,38,23,46,69,213,150,363,0.000333,0.739131,33,73174.01447,4065.223026,2217.394378,358.125775,25,0
0,0,37,37,23,46,69,208,146,354,0.000333,0.720806,33,71359.7827,3964.432372,2162.417658,358.125775,24,0
0,0,44,44,18,70,88,320,234,554,0.000333,1.192842,27,96620.17815,5367.787675,3578.525117,504.108461,19,0
0,0,4,4,11,18,29,24,28,52,0.000333,0.084205,5,1263.075059,70.170837,252.615012,113.112398,2,0
0,0,95,95,27,55,82,407,316,723,0.000333,1.53217,65,298773.1565,16598.50869,4596.510099,446.356747,37,0
0,0,95,95,27,55,82,407,316,723,0.000333,1.53217,65,298773.1565,16598.50869,4596.510099,446.356747,37,0
0,0,9,9,16,29,45,42,45,87,0.000333,0.159264,8,3822.329755,212.351653,477.791219,204.881449,2,0
0,0,9,9,16,28,44,42,44,86,0.000333,0.156504,8,3756.088954,208.671609,469.511119,198.605938,2,0
0,0,20,20,19,39,58,123,88,211,0.000333,0.412011,18,22248.61182,1236.03399,1236.03399,286.841309,12,0
0,0,2,2,12,15,27,21,21,42,0.000333,0.066568,6,1198.231651,66.568425,199.705275,101.622909,2,0
0,0,40,40,24,49,73,264,183,447,0.000333,0.922284,36,99606.6568,5533.703156,2766.851578,385.159882,21,0
0,0,20,20,21,41,62,139,98,237,0.000333,0.470382,20,28222.89051,1567.938362,1411.144526,311.898298,11,0
0,0,2,2,12,15,27,21,21,42,0.000333,0.066568,6,1198.231651,66.568425,199.705275,101.622909,2,0
0,0,21,21,19,39,58,87,82,169,0.000333,0.33,18,17819.97819,989.998788,989.998788,286.841309,11,0
0,0,23,23,19,42,61,90,90,180,0.000333,0.355844,18,19215.58897,1067.532721,1067.532721,307.187955,11,0
0,0,10,10,11,28,39,39,42,81,0.000333,0.142706,5,2140.587899,118.92155,428.11758,172.659686,4,0
0,0,11,11,12,29,41,38,44,82,0.000333,0.14644,6,2635.915586,146.439755,439.319264,183.900999,4,0
0,0,9,9,13,23,36,45,41,86,0.000333,0.148205,6,2667.681301,148.204517,444.61355,152.147641,3,0
0,0,7,7,13,19,32,35,31,66,0.000333,0.11,6,1980,110,330,128.816339,3,0
1,0,17,18,13,35,48,54,49,103,0.000333,0.19175,6,3451.506825,191.750379,575.251138,227.630622,5,0
0,0,6,6,15,19,34,36,29,65,0.000333,0.110228,7,2314.795593,128.599755,330.685085,139.313982,4,0
0,0,26,26,22,43,65,108,90,198,0.000333,0.397476,22,26233.43419,1457.413011,1192.428827,331.43688,6,0
0,0,43,43,28,64,92,198,160,358,0.000333,0.778478,28,65392.18505,3632.899169,2335.43518,518.605938,9,0
0,0,26,26,22,43,65,108,90,198,0.000333,0.397476,22,26233.43419,1457.413011,1192.428827,331.43688,6,0
0,0,36,36,24,57,81,168,136,304,0.000333,0.642438,24,46255.54562,2569.752535,1927.314401,442.513831,8,0
0,0,26,26,22,43,65,108,90,198,0.000333,0.397476,22,26233.43419,1457.413011,1192.428827,331.43688,6,0
0,0,10,10,11,24,35,39,39,78,0.000333,0.133361,5,2000.420377,111.134465,400.084075,148.092848,1,0
0,0,9,9,11,21,32,29,31,60,0.000333,0.1,5,1500,83.333333,300,130.292414,1,0
0,0,26,26,21,45,66,125,103,228,0.000333,0.459374,20,27562.43718,1531.24651,1378.121859,339.372055,5,0
0,0,44,44,27,62,89,210,171,381,0.000333,0.822418,26,64148.61537,3563.811965,2467.254437,497.542134,8,0
0,0,26,26,21,45,66,125,103,228,0.000333,0.459374,20,27562.43718,1531.24651,1378.121859,339.372055,5,0
0,0,35,35,24,58,82,171,139,310,0.000333,0.656947,24,47300.18691,2627.788162,1970.841121,449.801998,7,0
0,0,34,34,24,58,82,168,136,304,0.000333,0.644232,24,46384.69943,2576.927746,1932.695809,449.801998,7,0
0,0,26,26,21,45,66,125,103,228,0.000333,0.459374,20,27562.43718,1531.24651,1378.121859,339.372055,5,0
0,0,26,26,21,45,66,125,103,228,0.000333,0.459374,20,27562.43718,1531.24651,1378.121859,339.372055,5,0
0,0,9,9,11,23,34,33,35,68,0.000333,0.115316,5,1729.737366,96.09652,345.947473,142.095673,1,0
0,0,8,8,11,22,33,29,31,60,0.000333,0.100888,5,1513.318236,84.073235,302.663647,136.161243,1,0
0,0,25,25,29,31,60,134,88,222,0.000333,0.43711,28,36717.23194,2039.846219,1311.329712,294.461534,8,0
0,0,19,19,24,26,50,99,59,158,0.000333,0.297243,24,21401.50267,1188.972371,891.729278,232.250533,8,0
0,0,8,8,15,20,35,46,30,76,0.000333,0.129942,7,2728.778565,151.598809,389.825509,145.041921,3,0
0,0,6,6,14,16,30,33,23,56,0.000333,0.091595,7,1923.501113,106.861173,274.785873,117.302969,3,0
0,0,2,2,9,9,18,14,10,24,0.000333,0.033359,4,400.3128,22.2396,100.0782,57.05865,1,0
0,0,10,10,14,23,37,49,43,92,0.000333,0.159757,7,3354.887967,186.382665,479.26971,157.344894,6,0
0,0,20,20,17,41,58,100,76,176,0.000333,0.343668,8,8248.037241,458.224291,1031.004655,289.1465,5,0
0,0,21,21,18,45,63,105,86,191,0.000333,0.380553,9,10274.94419,570.830233,1141.660465,322.192039,5,0
0,0,10,10,13,23,36,41,38,79,0.000333,0.136141,6,2450.544451,136.141358,408.424075,152.147641,3,0
0,0,15,15,20,23,43,59,53,112,0.000333,0.202581,20,12154.83305,675.268503,607.741653,190.480487,17,0
0,0,7,7,15,18,33,38,27,65,0.000333,0.109295,7,2295.199324,127.511074,327.885618,133.662009,7,0
0,0,28,28,23,51,74,126,101,227,0.000333,0.469849,11,15505.00505,861.38917,1409.545914,393.335617,8,0
0,0,18,18,20,32,52,77,61,138,0.000333,0.26222,10,7866.606811,437.033712,786.660681,246.438562,6,0
0,0,2,2,11,14,25,15,16,31,0.000333,0.047987,5,719.797709,39.988762,143.959542,91.356717,1,0
0,0,6,6,10,15,25,19,24,43,0.000333,0.066562,5,998.429081,55.468282,199.685816,91.82264,1,0
0,0,31,31,24,28,52,151,120,271,0.000333,0.51494,48,74151.31985,4119.51777,1544.819164,244.645038,10,0
0,0,2,2,8,10,18,11,12,23,0.000333,0.031969,4,383.6331,21.31295,95.908275,57.219281,1,0
0,0,30,30,15,32,47,97,87,184,0.000333,0.340681,14,14308.62088,794.923382,1022.044349,218.603359,4,0
0,0,33,33,16,52,68,142,128,270,0.000333,0.547872,16,26297.83947,1460.991082,1643.614967,360.422865,11,0
0,0,14,14,11,28,39,55,50,105,0.000333,0.184989,5,2774.836165,154.157565,554.967233,172.659686,3,0
0,0,12,12,10,24,34,42,40,82,0.000333,0.139057,5,2085.859765,115.881098,417.171953,143.258381,3,0
0,0,12,12,10,23,33,41,39,80,0.000333,0.134517,5,2017.757648,112.097647,403.55153,137.261206,3,0
0,0,8,8,11,16,27,36,33,69,0.000333,0.109362,10,3280.872376,182.270688,328.087238,102.053748,2,0
0,0,7,7,11,22,33,23,27,50,0.000333,0.084073,5,1261.09853,70.061029,252.219706,136.161243,2,0
0,0,67,67,18,49,67,321,224,545,0.000333,1.102006,36,119016.6699,6612.037218,3306.018609,350.179432,32,0
0,0,16,16,10,20,30,25,29,54,0.000333,0.088324,5,1324.860461,73.603359,264.972092,119.657843,3,0
0,0,17,17,11,22,33,25,35,60,0.000333,0.100888,5,1513.318236,84.073235,302.663647,136.161243,2,0
0,0,15,15,11,21,32,20,29,49,0.000333,0.081667,5,1225,68.055556,245,130.292414,2,0
0,0,15,15,9,19,28,16,27,43,0.000333,0.068905,4,826.865047,45.936947,206.716262,109.239948,2,0
1,0,14,15,19,41,60,85,61,146,0.000333,0.287469,9,7761.654243,431.203013,862.406027,300.370255,2,0
0,0,91,91,29,95,124,439,326,765,0.000333,1.77332,42,223438.3275,12413.24041,5319.960177,765.017732,41,0
0,0,91,91,29,95,124,439,326,765,0.000333,1.77332,42,223438.3275,12413.24041,5319.960177,765.017732,41,0
0,0,101,101,29,102,131,492,369,861,0.000333,2.018592,42,254342.6426,14130.14681,6055.777204,821.468834,44,0
0,0,95,95,29,95,124,460,343,803,0.000333,1.861407,42,234537.2248,13029.84582,5584.219637,765.017732,43,0
0,0,91,91,29,95,124,439,326,765,0.000333,1.77332,42,223438.3275,12413.24041,5319.960177,765.017732,41,0
0,0,35,35,22,52,74,197,135,332,0.000333,0.68718,22,45353.84738,2519.658188,2061.538517,394.530361,21,0
0,0,30,30,20,48,68,158,115,273,0.000333,0.553959,20,33237.54711,1846.530395,1661.877356,354.516762,16,0
0,0,27,27,19,43,62,133,97,230,0.000333,0.456488,18,24650.37273,1369.465151,1369.465151,314.040007,15,0
1,0,14,15,24,29,53,81,57,138,0.000333,0.263484,12,9485.436273,526.968682,790.453023,250.920549,8,0
1,0,8,9,13,18,31,38,29,67,0.000333,0.110644,6,1991.586917,110.643718,331.931153,123.164366,4,0
1,0,7,8,13,17,30,34,25,59,0.000333,0.096502,6,1737.039271,96.502182,289.506545,117.592585,4,0
0,0,10,10,16,22,38,44,42,86,0.000333,0.150441,8,3610.574129,200.587452,451.321766,162.107496,8,0
1,0,6,7,13,16,29,33,28,61,0.000333,0.098779,6,1778.021044,98.778947,296.336841,112.105716,3,0
0,0,8,8,14,20,34,40,39,79,0.000333,0.13397,7,2813.366951,156.298164,401.909564,139.741531,3,0
0,0,7,7,14,19,33,35,33,68,0.000333,0.11434,7,2401.131601,133.3962,343.0188,134.013592,3,0
1,0,42,43,27,74,101,185,143,328,0.000333,0.727964,13,28390.61376,1577.25632,2183.893366,587.881512,29,0
0,0,89,89,29,93,122,433,322,755,0.000333,1.744236,42,219773.681,12209.64894,5232.70669,749.023218,41,0
0,0,89,89,29,93,122,433,322,755,0.000333,1.744236,42,219773.681,12209.64894,5232.70669,749.023218,41,0
0,0,99,99,29,100,129,486,365,851,0.000333,1.988851,42,250595.2846,13921.96025,5966.554394,805.267068,44,0
0,0,93,93,29,93,122,454,339,793,0.000333,1.832025,42,230835.1378,12824.17432,5496.074709,749.023218,43,0
0,0,89,89,29,93,122,433,322,755,0.000333,1.744236,42,219773.681,12209.64894,5232.70669,749.023218,41,0
0,0,35,35,22,52,74,197,135,332,0.000333,0.68718,22,45353.84738,2519.658188,2061.538517,394.530361,21,0
0,0,30,30,20,48,68,158,115,273,0.000333,0.553959,20,33237.54711,1846.530395,1661.877356,354.516762,16,0
0,0,27,27,19,43,62,133,97,230,0.000333,0.456488,18,24650.37273,1369.465151,1369.465151,314.040007,15,0
0,0,75,75,22,50,72,348,252,600,0.000333,1.233985,55,203607.525,11311.52917,3701.955001,380.300305,32,0
0,0,74,74,22,50,72,344,249,593,0.000333,1.219589,44,160985.6831,8943.649063,3658.765526,380.300305,32,0
1,0,7,8,17,19,36,33,29,62,0.000333,0.106845,8,2564.282801,142.460156,320.53535,150.197491,3,0
1,0,7,8,17,22,39,34,31,65,0.000333,0.114517,8,2748.409154,152.689397,343.551144,167.594364,3,0
1,0,21,22,18,56,74,161,123,284,0.000333,0.587828,18,31742.72561,1763.484756,1763.484756,400.270526,14,0
1,0,15,16,17,44,61,95,80,175,0.000333,0.34596,8,8303.032273,461.279571,1037.879034,309.70186,7,0
0,0,30,30,20,34,54,118,93,211,0.000333,0.40476,20,24285.62526,1349.201403,1214.281263,259.412299,14,0
0,0,27,27,20,33,53,106,84,190,0.000333,0.362768,20,21766.09773,1209.227652,1088.304886,252.903568,13,0
0,0,14,14,17,23,40,44,43,87,0.000333,0.154336,8,3704.061954,205.78122,463.007744,173.528793,6,0
0,0,6,6,8,12,20,9,14,23,0.000333,0.033135,4,397.617385,22.089855,99.404346,67.01955,1,0
0,0,11,11,12,20,32,36,35,71,0.000333,0.118333,6,2130,118.333333,355,129.458112,4,0
0,0,26,26,20,42,62,131,102,233,0.000333,0.462443,20,27746.55481,1541.475267,1387.32774,312.915894,19,0
0,0,11,11,11,30,41,53,49,102,0.000333,0.182157,5,2732.351522,151.797307,546.470304,185.260466,2,0
0,0,11,11,11,30,41,53,49,102,0.000333,0.182157,5,2732.351522,151.797307,546.470304,185.260466,2,0
0,0,10,10,11,29,40,50,45,95,0.000333,0.168528,5,2527.915845,140.439769,505.583169,178.935197,2,0
0,0,8,8,10,25,35,39,34,73,0.000333,0.124813,5,1872.188301,104.010461,374.43766,149.315686,2,0
0,0,4,4,8,17,25,19,18,37,0.000333,0.057274,4,687.290716,38.182818,171.822679,93.486868,1,0
0,0,16,16,17,27,44,59,57,116,0.000333,0.211098,16,10132.70508,562.92806,633.294068,197.868831,5,0
0,0,15,15,17,27,44,55,53,108,0.000333,0.19654,8,4716.948919,262.052718,589.618615,197.868831,5,0
0,0,5,5,10,15,25,16,23,39,0.000333,0.06037,5,905.551957,50.308442,181.110391,91.82264,1,0
0,0,5,5,10,14,24,14,21,35,0.000333,0.053491,5,802.368438,44.576024,160.473688,86.52225,1,0
0,0,4,4,9,13,22,11,17,28,0.000333,0.041621,4,499.456341,27.747575,124.864085,76.635041,1,0
0,0,13,13,11,20,31,40,37,77,0.000333,0.127158,5,1907.365579,105.964754,381.473116,124.49231,4,0
0,0,23,23,12,39,51,92,78,170,0.000333,0.321437,12,11571.7477,642.874872,964.312308,249.150237,11,0
0,0,81,81,23,108,131,326,290,616,0.000333,1.444196,22,95316.94852,5295.386029,4332.588569,833.569775,27,0
0,0,79,79,23,108,131,322,286,608,0.000333,1.42544,22,94079.06607,5226.614782,4276.321185,833.569775,27,0
0,0,76,76,23,103,126,291,254,545,0.000333,1.267539,22,83657.58628,4647.643682,3802.617558,792.751479,26,0
0,0,76,76,23,101,124,288,247,535,0.000333,1.240165,22,81850.89057,4547.271699,3720.495026,776.521285,26,0
0,0,45,45,17,62,79,155,131,286,0.000333,0.60096,16,28846.1007,1602.56115,1802.881294,438.64704,16,0
0,0,45,45,21,62,83,166,136,302,0.000333,0.641754,20,38505.23817,2139.179898,1925.261908,461.398837,17,0
0,0,43,43,17,60,77,151,127,278,0.000333,0.580722,16,27874.66653,1548.592585,1742.166658,423.900304,15,0
0,0,3,3,8,12,20,11,15,26,0.000333,0.037457,4,449.480522,24.97114,112.37013,67.01955,1,0
0,0,64,64,34,96,130,368,224,592,0.000333,1.385747,34,141346.2193,7852.567741,4157.241745,805.130137,40,0
0,0,61,61,34,94,128,356,215,571,0.000333,1.332333,34,135898,7549.888889,3997,789.105089,39,0
0,0,61,61,34,92,126,354,213,567,0.000333,1.318706,34,134508.0024,7472.666798,3956.117717,773.141437,39,0
0,0,25,25,27,46,73,147,90,237,0.000333,0.488996,13,19070.84947,1059.491637,1466.98842,382.465813,16,0
0,0,24,24,25,41,66,132,80,212,0.000333,0.427137,12,15376.93864,854.274369,1281.411553,335.756037,16,0
0,0,25,25,25,40,65,132,80,212,0.000333,0.425581,24,30641.80743,1702.322635,1276.741976,328.973529,16,0
0,0,24,24,25,43,68,135,83,218,0.000333,0.442356,12,15924.80279,884.711266,1327.066899,349.425789,15,0
0,0,22,22,18,33,51,106,69,175,0.000333,0.330891,18,17868.13983,992.674435,992.674435,241.523656,14,0
0,0,14,14,15,25,40,71,45,116,0.000333,0.205781,7,4321.405613,240.07809,617.343659,174.699764,7,0
0,0,45,45,28,78,106,261,161,422,0.000333,0.946394,28,79497.10809,4416.506005,2839.182432,624.867311,31,0
0,0,65,65,25,62,87,273,204,477,0.000333,1.024428,36,110638.2257,6146.568095,3073.284048,485.256576,33,0
0,0,65,65,25,62,87,273,204,477,0.000333,1.024428,36,110638.2257,6146.568095,3073.284048,485.256576,33,0
0,0,2,2,9,13,22,11,16,27,0.000333,0.040135,4,481.618615,26.75659,120.404654,76.635041,1,0
0,0,97,97,31,102,133,509,365,874,0.000333,2.055439,45,277484.2582,15415.79212,6166.316849,834.167471,51,0
0,0,97,97,31,102,133,509,365,874,0.000333,2.055439,45,277484.2582,15415.79212,6166.316849,834.167471,51,0
0,0,98,98,31,102,133,516,370,886,0.000333,2.08366,45,281294.1107,15627.4506,6250.980238,834.167471,51,0
0,0,97,97,31,102,133,509,365,874,0.000333,2.055439,45,277484.2582,15415.79212,6166.316849,834.167471,51,0
0,0,103,103,31,105,136,528,381,909,0.000333,2.147501,45,289912.6675,16106.25931,6442.503723,858.575865,53,0
0,0,101,101,31,105,136,520,375,895,0.000333,2.114426,45,285447.5659,15858.19811,6343.279243,858.575865,52,0
0,0,97,97,31,102,133,509,365,874,0.000333,2.055439,45,277484.2582,15415.79212,6166.316849,834.167471,51,0
0,0,13,13,22,35,57,115,70,185,0.000333,0.359695,22,23739.86236,1318.881242,1079.084653,277.632401,11,0
0,0,16,16,10,20,30,25,29,54,0.000333,0.088324,5,1324.860461,73.603359,264.972092,119.657843,3,0
0,0,17,17,11,22,33,25,35,60,0.000333,0.100888,5,1513.318236,84.073235,302.663647,136.161243,2,0
0,0,15,15,11,21,32,20,29,49,0.000333,0.081667,5,1225,68.055556,245,130.292414,2,0
0,0,15,15,9,19,28,16,27,43,0.000333,0.068905,4,826.865047,45.936947,206.716262,109.239948,2,0
1,0,57,58,20,65,85,306,228,534,0.000333,1.140872,30,102678.4428,5704.357933,3422.61476,477.89247,31,0
1,0,57,58,20,65,85,306,228,534,0.000333,1.140872,30,102678.4428,5704.357933,3422.61476,477.89247,31,0
1,0,7,8,10,31,41,48,46,94,0.000333,0.16787,5,2518.049442,139.891636,503.609888,186.799367,3,0
1,0,53,54,24,52,76,202,167,369,0.000333,0.768495,36,82997.46909,4610.970505,2305.485252,406.461965,18,0
1,0,53,54,24,52,76,202,167,369,0.000333,0.768495,36,82997.46909,4610.970505,2305.485252,406.461965,18,0
1,0,53,54,24,52,76,202,167,369,0.000333,0.768495,36,82997.46909,4610.970505,2305.485252,406.461965,18,0
0,0,22,22,20,42,62,115,87,202,0.000333,0.400916,20,24054.95309,1336.386283,1202.747655,312.915894,8,0
0,0,27,27,28,31,59,128,92,220,0.000333,0.431394,28,36237.08118,2013.171177,1294.181471,288.186023,13,0
0,0,27,27,28,31,59,128,92,220,0.000333,0.431394,28,36237.08118,2013.171177,1294.181471,288.186023,13,0
0,0,27,27,28,31,59,128,92,220,0.000333,0.431394,28,36237.08118,2013.171177,1294.181471,288.186023,13,0
0,0,8,8,18,15,33,43,29,72,0.000333,0.121065,9,3268.767389,181.598188,363.196377,133.662009,5,0
0,0,6,6,19,13,32,33,24,57,0.000333,0.095,9,2565,142.5,285,128.816339,4,0
0,0,45,45,22,60,82,221,176,397,0.000333,0.841316,22,55526.85921,3084.825512,2523.948146,452.520931,37,0
0,0,45,45,21,60,81,220,174,394,0.000333,0.832634,20,49958.01802,2775.445446,2497.900901,446.652102,37,0
0,0,18,18,16,36,52,79,63,142,0.000333,0.269821,8,6475.69952,359.761084,809.46244,250.1173,7,0
0,0,8,8,17,26,43,59,44,103,0.000333,0.186302,8,4471.242158,248.402342,558.90527,191.698301,2,0
0,0,5,5,11,20,31,32,26,58,0.000333,0.095781,5,1436.71693,79.817607,287.343386,124.49231,1,0
0,0,4,4,8,18,26,20,21,41,0.000333,0.064239,4,770.872114,42.826229,192.718028,99.05865,1,0
0,0,4,4,8,18,26,20,21,41,0.000333,0.064239,4,770.872114,42.826229,192.718028,99.05865,1,0
0,0,26,26,22,35,57,135,106,241,0.000333,0.468575,33,46388.97428,2577.165238,1405.726493,277.632401,9,0
0,0,13,13,13,20,33,53,46,99,0.000333,0.166465,12,5992.740214,332.930012,499.395018,134.544278,3,0
0,0,12,12,15,22,37,58,47,105,0.000333,0.182331,14,7657.896447,425.438692,546.992603,156.710855,4,0
0,0,10,10,13,25,38,58,40,98,0.000333,0.171432,6,3085.781378,171.432299,514.296896,164.202121,5,0
0,0,18,18,20,33,53,98,75,173,0.000333,0.33031,20,19818.60477,1101.033598,990.930239,252.903568,12,0
0,0,4,4,9,11,20,15,21,36,0.000333,0.051863,4,622.357646,34.575425,155.589411,66.583073,1,0
0,0,3,3,9,11,20,13,20,33,0.000333,0.047541,4,570.494509,31.694139,142.623627,66.583073,1,0
0,0,30,30,23,52,75,204,112,316,0.000333,0.656102,22,43302.74754,2405.708196,1968.306706,400.46479,16,0
0,0,14,14,16,29,45,82,49,131,0.000333,0.239811,8,5755.462045,319.747891,719.432756,204.881449,8,0
0,0,16,16,15,40,55,110,70,180,0.000333,0.346882,7,7284.513239,404.69518,1040.644748,271.480483,7,0
0,0,16,16,15,38,53,103,65,168,0.000333,0.320764,7,6736.034455,374.224136,962.290636,258.024604,7,0
0,0,14,14,15,34,49,90,58,148,0.000333,0.276992,7,5816.839399,323.157744,830.977057,231.577096,7,0
0,0,7,7,15,21,36,55,32,87,0.000333,0.149928,7,3148.484326,174.915796,449.783475,150.842025,5,0
0,0,19,19,18,37,55,83,66,149,0.000333,0.287141,9,7752.803376,430.711299,861.422597,267.808425,5,0
0,0,27,27,17,37,54,123,95,218,0.000333,0.418188,16,20073.04761,1115.169312,1254.565475,262.236643,10,0
0,0,27,27,17,37,54,123,95,218,0.000333,0.418188,16,20073.04761,1115.169312,1254.565475,262.236643,10,0
0,0,10,10,15,21,36,40,36,76,0.000333,0.130971,7,2750.400101,152.800006,392.9143,150.842025,3,0
0,0,49,49,24,70,94,198,158,356,0.000333,0.777811,24,56002.40715,3111.244842,2333.433631,539.088911,25,0
0,0,8,8,16,23,39,50,33,83,0.000333,0.146229,8,3509.507073,194.972615,438.688384,168.041925,5,0
0,0,12,12,12,15,27,29,24,53,0.000333,0.084003,6,1512.054226,84.003013,252.009038,101.622909,2,0
0,0,10,10,15,18,33,45,34,79,0.000333,0.132836,7,2789.549948,154.974997,398.507135,133.662009,4,0
0,0,5,5,12,15,27,26,20,46,0.000333,0.072908,6,1312.348951,72.908275,218.724825,101.622909,3,0
0,0,6,6,13,17,30,38,26,64,0.000333,0.10468,6,1884.245989,104.680333,314.040998,117.592585,3,0
0,0,10,10,16,18,34,46,34,80,0.000333,0.135666,8,3255.976218,180.887568,406.997027,139.05865,4,0
0,0,5,5,13,15,28,27,20,47,0.000333,0.075315,6,1355.674088,75.315227,225.945681,106.709075,3,0
0,0,6,6,14,17,31,39,26,65,0.000333,0.107341,7,2254.159321,125.231073,322.02276,122.789837,3,0
0,0,10,10,17,26,43,66,42,108,0.000333,0.195346,8,4688.292748,260.460708,586.036594,191.698301,6,0
0,0,12,12,13,20,33,42,43,85,0.000333,0.142925,12,5145.282002,285.849,428.7735,134.544278,4,0
0,0,84,84,27,111,138,546,457,1003,0.000333,2.376617,52,370752.2016,20597.34453,7129.85003,882.562124,59,0
0,0,41,41,22,65,87,221,193,414,0.000333,0.889126,22,58682.32936,3260.129409,2667.378607,489.561403,16,0
0,0,19,19,15,31,46,82,68,150,0.000333,0.276178,14,11599.48011,644.415562,828.534293,212.183445,4,0
0,0,18,18,15,30,45,74,63,137,0.000333,0.250795,14,10533.37424,585.187458,752.383874,205.810077,4,0
0,0,21,21,25,39,64,100,76,176,0.000333,0.352,12,12672,704,1056,322.227091,10,0
0,0,6,6,11,16,27,40,34,74,0.000333,0.117287,10,3518.616752,195.478708,351.861675,102.053748,2,0
0,0,22,22,20,42,62,115,87,202,0.000333,0.400916,20,24054.95309,1336.386283,1202.747655,312.915894,8,0
0,0,22,22,20,42,62,115,87,202,0.000333,0.400916,20,24054.95309,1336.386283,1202.747655,312.915894,8,0
0,0,70,70,23,75,98,280,239,519,0.000333,1.144345,33,113290.1355,6293.896417,3433.034409,571.203327,15,0
0,0,61,61,28,70,98,239,220,459,0.000333,1.012051,42,127518.3764,7084.354243,3036.151818,563.655749,13,0
0,0,70,70,23,75,98,280,239,519,0.000333,1.144345,33,113290.1355,6293.896417,3433.034409,571.203327,15,0
0,0,61,61,28,70,98,239,220,459,0.000333,1.012051,42,127518.3764,7084.354243,3036.151818,563.655749,13,0
0,0,15,15,23,30,53,81,60,141,0.000333,0.269212,22,17768.00925,987.111625,807.636784,251.248643,6,0
0,0,5,5,13,13,26,27,20,47,0.000333,0.07364,6,1325.524001,73.640222,220.920667,96.211433,2,0
0,0,28,28,22,49,71,136,117,253,0.000333,0.518629,22,34229.49247,1901.63847,1555.886021,373.228278,8,0
0,0,34,34,22,49,71,144,132,276,0.000333,0.565777,22,37341.26451,2074.514695,1697.330205,373.228278,9,0
0,0,16,16,18,41,59,85,72,157,0.000333,0.307858,9,8312.174629,461.787479,923.574959,294.718282,2,0
0,0,16,16,19,37,56,81,66,147,0.000333,0.28456,9,7683.130562,426.840587,853.681174,273.460397,2,0
0,0,7,7,15,18,33,36,27,63,0.000333,0.105932,7,2224.577807,123.587656,317.79683,133.662009,4,0
0,0,22,22,19,40,59,102,84,186,0.000333,0.364724,18,19695.08893,1094.171607,1094.171607,293.587747,6,0
0,0,25,25,18,38,56,99,93,192,0.000333,0.371671,18,20070.21861,1115.012145,1115.012145,274.479896,5,0
0,0,31,31,19,55,74,172,124,296,0.000333,0.612666,18,33083.96753,1837.998196,1837.998196,398.685407,3,0
0,0,31,31,18,50,68,187,143,330,0.000333,0.669621,18,36159.52928,2008.862738,2008.862738,357.25146,3,0
0,0,30,30,20,53,73,172,120,292,0.000333,0.602476,20,36148.57542,2008.25419,1807.428771,390.018346,3,0
0,0,15,15,16,29,45,88,60,148,0.000333,0.270931,16,13004.70813,722.483785,812.794258,204.881449,3,0
0,0,25,25,26,54,80,162,119,281,0.000333,0.592154,26,46188.00666,2566.00037,1776.461795,432.975358,9,0
0,0,70,70,23,75,98,280,239,519,0.000333,1.144345,33,113290.1355,6293.896417,3433.034409,571.203327,15,0
0,0,36,36,19,47,66,138,134,272,0.000333,0.548025,18,29593.35361,1644.0752,1644.0752,341.776299,8,0
0,0,70,70,23,75,98,280,239,519,0.000333,1.144345,33,113290.1355,6293.896417,3433.034409,571.203327,15,0
0,0,36,36,19,47,66,138,134,272,0.000333,0.548025,18,29593.35361,1644.0752,1644.0752,341.776299,8,0
0,0,15,15,23,30,53,81,60,141,0.000333,0.269212,22,17768.00925,987.111625,807.636784,251.248643,6,0
0,0,5,5,13,13,26,27,20,47,0.000333,0.07364,6,1325.524001,73.640222,220.920667,96.211433,2,0
0,0,28,28,22,49,71,136,117,253,0.000333,0.518629,22,34229.49247,1901.63847,1555.886021,373.228278,8,0
0,0,34,34,22,49,71,144,132,276,0.000333,0.565777,22,37341.26451,2074.514695,1697.330205,373.228278,9,0
0,0,16,16,18,41,59,85,72,157,0.000333,0.307858,9,8312.174629,461.787479,923.574959,294.718282,2,0
0,0,16,16,19,37,56,81,66,147,0.000333,0.28456,9,7683.130562,426.840587,853.681174,273.460397,2,0
0,0,7,7,15,18,33,36,27,63,0.000333,0.105932,7,2224.577807,123.587656,317.79683,133.662009,4,0
0,0,30,30,20,50,70,136,111,247,0.000333,0.504644,20,30278.6581,1682.147672,1513.932905,368.631371,8,0
0,0,33,33,21,46,67,133,120,253,0.000333,0.511574,20,30694.4113,1705.245072,1534.720565,346.322516,7,0
0,0,31,31,19,55,74,172,124,296,0.000333,0.612666,18,33083.96753,1837.998196,1837.998196,398.685407,3,0
0,0,31,31,18,50,68,187,143,330,0.000333,0.669621,18,36159.52928,2008.862738,2008.862738,357.25146,3,0
0,0,30,30,20,53,73,172,120,292,0.000333,0.602476,20,36148.57542,2008.25419,1807.428771,390.018346,3,0
0,0,15,15,16,29,45,88,60,148,0.000333,0.270931,16,13004.70813,722.483785,812.794258,204.881449,3,0
0,0,25,25,26,54,80,162,119,281,0.000333,0.592154,26,46188.00666,2566.00037,1776.461795,432.975358,9,0
0,0,49,49,30,48,78,209,143,352,0.000333,0.737487,30,66373.84743,3687.435968,2212.461581,415.284918,23,0
0,0,49,49,30,47,77,212,144,356,0.000333,0.743659,45,100393.9204,5577.440021,2230.976008,408.272394,23,0
0,0,103,103,33,100,133,523,407,930,0.000333,2.187138,64,419930.4106,23329.46725,6561.412665,830.850625,66,0
0,0,103,103,33,100,133,523,407,930,0.000333,2.187138,64,419930.4106,23329.46725,6561.412665,830.850625,66,0
0,0,103,103,32,100,132,531,411,942,0.000333,2.21194,64,424692.4327,23594.02404,6635.81926,824.385619,66,0
0,0,103,103,32,100,132,531,411,942,0.000333,2.21194,64,424692.4327,23594.02404,6635.81926,824.385619,66,0
0,0,102,102,32,98,130,491,384,875,0.000333,2.048191,48,294939.4481,16385.5249,6144.571836,808.241565,63,0
0,0,96,96,31,83,114,452,348,800,0.000333,1.822104,60,327978.7207,18221.04004,5466.312011,682.708358,62,0
0,0,90,90,31,78,109,426,326,752,0.000333,1.696558,60,305380.4767,16965.58204,5089.674612,643.841459,61,0
0,0,14,14,19,22,41,66,59,125,0.000333,0.223231,18,12054.49201,669.694001,669.694001,178.818118,5,0
0,0,14,14,13,22,35,61,53,114,0.000333,0.194913,12,7016.859167,389.825509,584.738264,146.213212,4,0
0,0,96,96,31,94,125,463,366,829,0.000333,1.924878,45,259858.5827,14436.58793,5774.635172,769.711438,60,0
0,0,10,10,15,26,41,71,57,128,0.000333,0.228589,14,9600.733192,533.374066,685.766657,180.814792,6,0
0,0,20,20,21,43,64,99,95,194,0.000333,0.388,20,23280,1293.333333,1164,325.56805,5,0
0,0,50,50,25,80,105,300,233,533,0.000333,1.192898,24,85888.62866,4771.590481,3578.692861,621.850652,29,0
0,0,47,47,25,79,104,293,224,517,0.000333,1.154709,24,83139.05602,4618.836446,3464.127334,614.095084,28,0
0,0,26,26,23,37,60,129,86,215,0.000333,0.423327,22,27939.59252,1552.199584,1269.981478,296.7917,12,0
0,0,30,30,15,46,61,143,118,261,0.000333,0.515974,14,21670.91423,1203.93968,1547.922445,312.687209,8,0
0,0,30,30,15,46,61,143,118,261,0.000333,0.515974,14,21670.91423,1203.93968,1547.922445,312.687209,8,0
0,0,29,29,15,44,59,137,114,251,0.000333,0.492181,14,20671.60768,1148.422649,1476.543405,298.81835,8,0
0,0,99,99,27,131,158,500,369,869,0.000333,2.115662,26,165021.6222,9167.867901,6346.98547,1049.760376,48,0
0,0,40,40,20,65,85,215,171,386,0.000333,0.824675,20,49480.49803,2748.916557,2474.024901,477.89247,13,0
0,0,112,112,27,134,161,555,409,964,0.000333,2.355668,39,275613.151,15311.84172,7067.003871,1075.237914,52,0
0,0,90,90,25,120,145,455,328,783,0.000333,1.873956,24,134924.8516,7495.82509,5621.868817,944.923276,45,0
0,0,31,31,18,51,69,170,130,300,0.000333,0.610852,18,32986.03207,1832.557337,1832.557337,364.352342,10,0
0,0,110,110,25,128,153,544,398,942,0.000333,2.27882,36,246112.5365,13672.9187,6836.459348,1012.096405,50,0
0,0,28,28,15,43,58,134,112,246,0.000333,0.480354,14,20174.88655,1120.82703,1441.063325,291.932743,8,0
0,0,49,49,30,48,78,209,143,352,0.000333,0.737487,30,66373.84743,3687.435968,2212.461581,415.284918,23,0
0,0,49,49,30,47,77,212,144,356,0.000333,0.743659,45,100393.9204,5577.440021,2230.976008,408.272394,23,0
0,0,103,103,33,100,133,523,407,930,0.000333,2.187138,64,419930.4106,23329.46725,6561.412665,830.850625,66,0
0,0,103,103,33,100,133,523,407,930,0.000333,2.187138,64,419930.4106,23329.46725,6561.412665,830.850625,66,0
0,0,103,103,32,100,132,531,411,942,0.000333,2.21194,64,424692.4327,23594.02404,6635.81926,824.385619,66,0
0,0,103,103,32,100,132,531,411,942,0.000333,2.21194,64,424692.4327,23594.02404,6635.81926,824.385619,66,0
0,0,102,102,32,98,130,491,384,875,0.000333,2.048191,48,294939.4481,16385.5249,6144.571836,808.241565,63,0
0,0,96,96,31,83,114,452,348,800,0.000333,1.822104,60,327978.7207,18221.04004,5466.312011,682.708358,62,0
0,0,90,90,31,78,109,426,326,752,0.000333,1.696558,60,305380.4767,16965.58204,5089.674612,643.841459,61,0
0,0,14,14,19,22,41,66,59,125,0.000333,0.223231,18,12054.49201,669.694001,669.694001,178.818118,5,0
0,0,14,14,13,22,35,61,53,114,0.000333,0.194913,12,7016.859167,389.825509,584.738264,146.213212,4,0
0,0,96,96,31,94,125,463,366,829,0.000333,1.924878,45,259858.5827,14436.58793,5774.635172,769.711438,60,0
0,0,10,10,15,26,41,71,57,128,0.000333,0.228589,14,9600.733192,533.374066,685.766657,180.814792,6,0
1,0,21,22,22,31,53,123,85,208,0.000333,0.397136,22,26210.964,1456.164667,1191.407455,251.687581,13,0
1,0,13,14,18,24,42,59,51,110,0.000333,0.197718,18,10676.7885,593.154917,593.154917,185.09775,5,0
1,0,13,14,18,23,41,59,51,110,0.000333,0.196444,18,10607.95297,589.330721,589.330721,179.100575,5,0
0,0,2,2,7,7,14,11,10,21,0.000333,0.026651,3,239.86336,13.325742,79.954453,39.302969,1,0
0,0,3,3,12,9,21,21,15,36,0.000333,0.052708,6,948.740563,52.707809,158.123427,71.548875,1,0
0,0,3,3,8,9,17,15,11,26,0.000333,0.035425,4,425.096135,23.616452,106.274034,52.529325,2,0
1,0,10,11,16,21,37,49,42,91,0.000333,0.15802,16,7584.9641,421.386894,474.060256,156.238666,5,0
1,0,11,12,16,21,37,52,45,97,0.000333,0.168439,16,8085.071623,449.170646,505.316976,156.238666,5,0
0,0,7,7,14,18,32,44,38,82,0.000333,0.136667,14,5740,318.888889,410,128.361619,2,0
0,0,5,5,9,10,19,22,16,38,0.000333,0.053807,4,645.684982,35.871388,161.421246,61.748606,3,0
0,0,4,4,10,14,24,22,18,40,0.000333,0.061133,5,916.9925,50.944028,183.3985,86.52225,2,0
0,0,5,5,11,14,25,25,19,44,0.000333,0.06811,5,1021.648362,56.758242,204.329672,91.356717,3,0
0,0,4,4,10,14,24,22,18,40,0.000333,0.061133,5,916.9925,50.944028,183.3985,86.52225,2,0
0,0,5,5,11,14,25,25,19,44,0.000333,0.06811,5,1021.648362,56.758242,204.329672,91.356717,3,0
1,0,4,5,15,12,27,20,16,36,0.000333,0.057059,7,1198.231651,66.568425,171.17595,101.622909,3,0
1,0,4,5,15,13,28,32,27,59,0.000333,0.094545,14,3970.875166,220.604176,283.63394,106.709075,4,0
1,0,6,7,12,12,24,21,18,39,0.000333,0.059605,6,1072.881225,59.604513,178.813538,86.0391,2,0
1,0,4,5,15,13,28,20,17,37,0.000333,0.059291,7,1245.104925,69.172496,177.872132,106.709075,3,0
1,0,5,6,10,14,24,21,21,42,0.000333,0.064189,5,962.842125,53.491229,192.568425,86.52225,2,0
1,0,23,24,22,40,62,107,89,196,0.000333,0.389007,22,25674.49449,1426.360805,1167.022477,310.984619,9,0
1,0,14,15,11,22,33,40,42,82,0.000333,0.13788,5,2068.201589,114.900088,413.640318,136.161243,3,0
1,0,37,38,17,32,49,146,134,280,0.000333,0.52404,32,50307.8002,2794.877789,1572.118756,229.486868,8,0
1,0,31,32,17,30,47,120,108,228,0.000333,0.422149,24,30394.7102,1688.595011,1266.446258,216.693586,8,0
1,0,27,28,16,31,47,92,86,178,0.000333,0.329572,16,15819.46905,878.859392,988.716816,217.580086,7,0
1,0,38,39,17,35,52,144,134,278,0.000333,0.528241,24,38033.3338,2112.962989,1584.722242,249.011774,8,0
1,0,33,34,16,33,49,121,112,233,0.000333,0.436076,24,31397.45745,1744.303192,1308.227394,230.465006,8,0
1,0,29,30,16,33,49,101,94,195,0.000333,0.364956,16,17517.89471,973.216373,1094.86842,230.465006,7,0
1,0,7,8,9,11,20,19,21,40,0.000333,0.057626,4,691.508495,38.417139,172.877124,66.583073,2,0
1,0,7,8,9,11,20,19,21,40,0.000333,0.057626,4,691.508495,38.417139,172.877124,66.583073,2,0
1,0,6,7,8,10,18,15,18,33,0.000333,0.045869,4,550.4301,30.57945,137.607525,57.219281,1,0
1,0,7,8,9,12,21,18,20,38,0.000333,0.055636,4,667.632248,37.09068,166.908062,71.548875,2,0
1,0,7,8,9,12,21,18,20,38,0.000333,0.055636,4,667.632248,37.09068,166.908062,71.548875,2,0
0,0,8,8,12,18,30,37,25,62,0.000333,0.101409,6,1825.363302,101.409072,304.227217,118.0782,3,0
0,0,77,77,27,101,128,393,289,682,0.000333,1.591333,26,124124,6895.777778,4774,800.861322,14,0
1,0,63,64,26,80,106,309,229,538,0.000333,1.20654,26,94110.15132,5228.34174,3619.621205,627.96568,16,0
0,0,68,68,22,81,103,320,215,535,0.000333,1.192426,22,78700.11121,4372.2284,3577.277782,611.635346,25,0
0,0,45,45,20,56,76,195,144,339,0.000333,0.706016,20,42360.94854,2353.38603,2118.047427,411.650438,7,0
0,0,84,84,28,111,139,432,312,744,0.000333,1.765497,28,148301.7804,8238.987801,5296.492158,888.786099,16,0
0,0,77,77,27,103,130,393,289,682,0.000333,1.596418,26,124520.6261,6917.812559,4789.254848,817.091517,14,0
1,0,63,64,26,80,106,309,229,538,0.000333,1.20654,26,94110.15132,5228.34174,3619.621205,627.96568,16,0
0,0,68,68,22,83,105,320,215,535,0.000333,1.197374,22,79026.66974,4390.370541,3592.121352,627.235768,25,0
0,0,77,77,27,101,128,393,289,682,0.000333,1.591333,26,124124,6895.777778,4774,800.861322,14,0
1,0,63,64,26,80,106,309,229,538,0.000333,1.20654,26,94110.15132,5228.34174,3619.621205,627.96568,16,0
0,0,68,68,22,81,103,320,215,535,0.000333,1.192426,22,78700.11121,4372.2284,3577.277782,611.635346,25,0
0,0,45,45,20,56,76,195,144,339,0.000333,0.706016,20,42360.94854,2353.38603,2118.047427,411.650438,7,0
0,0,84,84,28,111,139,432,312,744,0.000333,1.765497,28,148301.7804,8238.987801,5296.492158,888.786099,16,0
0,0,77,77,27,103,130,393,289,682,0.000333,1.596418,26,124520.6261,6917.812559,4789.254848,817.091517,14,0
1,0,63,64,26,80,106,309,229,538,0.000333,1.20654,26,94110.15132,5228.34174,3619.621205,627.96568,16,0
0,0,68,68,22,83,105,320,215,535,0.000333,1.197374,22,79026.66974,4390.370541,3592.121352,627.235768,25,0
0,0,5,5,8,14,22,20,15,35,0.000333,0.052027,4,624.320427,34.684468,156.080107,77.302969,1,0
1,0,10,11,16,21,37,53,43,96,0.000333,0.166703,16,8001.72037,444.540021,500.107523,156.238666,4,0
1,0,6,7,7,17,24,20,18,38,0.000333,0.058076,3,522.685725,29.038096,174.228575,89.138353,1,0
1,0,13,14,11,29,40,55,43,98,0.000333,0.17385,5,2607.744766,144.874709,521.548953,178.935197,7,0
2,0,16,18,20,29,49,64,53,117,0.000333,0.218974,10,6569.210518,364.95614,656.921052,227.320011,3,0
1,0,18,19,20,43,63,111,83,194,0.000333,0.386531,10,11595.92305,644.217947,1159.592305,319.767946,15,0
1,0,48,49,31,92,123,367,258,625,0.000333,1.446357,30,130172.147,7231.785943,4339.071566,753.747786,33,0
1,0,48,49,31,92,123,367,258,625,0.000333,1.446357,30,130172.147,7231.785943,4339.071566,753.747786,33,0
1,0,36,37,19,52,71,281,208,489,0.000333,1.002409,36,108260.1483,6014.452683,3007.226341,377.133488,18,0
1,0,32,33,19,52,71,257,190,447,0.000333,0.916312,27,74221.29799,4123.405444,2748.936962,377.133488,18,0
1,0,31,32,19,52,71,254,185,439,0.000333,0.899913,27,72892.95261,4049.608478,2699.738985,377.133488,18,0
1,0,31,32,19,52,71,254,185,439,0.000333,0.899913,27,72892.95261,4049.608478,2699.738985,377.133488,18,0
1,0,26,27,17,51,68,217,160,377,0.000333,0.764991,24,55079.36379,3059.964655,2294.973491,358.780561,18,0
1,0,26,27,17,51,68,217,160,377,0.000333,0.764991,24,55079.36379,3059.964655,2294.973491,358.780561,18,0
1,0,29,30,19,52,71,243,177,420,0.000333,0.860965,27,69738.13234,3874.340685,2582.89379,377.133488,18,0
1,0,29,30,19,52,71,243,177,420,0.000333,0.860965,27,69738.13234,3874.340685,2582.89379,377.133488,18,0
1,0,21,22,17,49,66,147,116,263,0.000333,0.529892,16,25434.81045,1413.045025,1589.675653,344.607651,18,0
1,0,21,22,17,49,66,147,116,263,0.000333,0.529892,16,25434.81045,1413.045025,1589.675653,344.607651,18,0
1,0,25,26,19,51,70,187,144,331,0.000333,0.676264,18,36518.26822,2028.792679,2028.792679,370.004315,18,0
1,0,25,26,19,51,70,187,144,331,0.000333,0.676264,18,36518.26822,2028.792679,2028.792679,370.004315,18,0
1,0,32,33,19,52,71,256,190,446,0.000333,0.914262,27,74055.25481,4114.180823,2742.787215,377.133488,18,0
1,0,32,33,19,52,71,256,190,446,0.000333,0.914262,27,74055.25481,4114.180823,2742.787215,377.133488,18,0
1,0,30,31,19,52,71,218,168,386,0.000333,0.791267,27,64092.66448,3560.703582,2373.802388,377.133488,18,0
1,0,32,33,19,52,71,230,174,404,0.000333,0.828166,27,67081.44158,3726.746754,2484.497836,377.133488,18,0
1,0,32,33,19,52,71,236,180,416,0.000333,0.852765,27,69073.95965,3837.442203,2558.294802,377.133488,18,0
1,0,22,23,18,49,67,154,121,275,0.000333,0.556058,18,30027.14149,1668.174527,1668.174527,350.179432,18,0
1,0,30,31,19,52,71,230,165,395,0.000333,0.809717,27,65587.05303,3643.725168,2429.150112,377.133488,17,0
1,0,76,77,21,120,141,398,256,654,0.000333,1.556422,20,93385.33169,5188.073983,4669.266584,921.065537,27,0
0,0,4,4,13,16,29,21,19,40,0.000333,0.064773,6,1165.915439,64.77308,194.31924,112.105716,2,0
0,0,27,27,25,75,100,186,144,330,0.000333,0.730824,12,26309.67051,1461.648362,2192.472543,583.257807,16,0
0,0,35,35,26,80,106,219,170,389,0.000333,0.872387,26,68046.18748,3780.343749,2617.161057,627.96568,18,0
0,0,35,35,27,80,107,222,173,395,0.000333,0.887626,26,69234.86595,3846.381442,2662.87946,634.13621,18,0
0,0,34,34,26,79,105,215,166,381,0.000333,0.852709,26,66511.3161,3695.073117,2558.127542,620.210112,18,0
0,0,34,34,27,79,106,218,169,387,0.000333,0.867902,26,67696.33561,3760.907534,2603.705216,626.380642,18,0
0,0,34,34,26,79,105,215,166,381,0.000333,0.852709,26,66511.3161,3695.073117,2558.127542,620.210112,18,0
0,0,34,34,27,79,106,222,170,392,0.000333,0.879115,26,68570.96527,3809.498071,2637.344818,626.380642,18,0
1,0,43,44,21,98,119,250,171,421,0.000333,0.967573,10,29027.18278,1612.621266,2902.718278,740.480231,31,0
1,0,62,63,27,121,148,361,265,626,0.000333,1.504373,26,117341.063,6518.947943,4513.117807,965.564414,30,0
1,0,94,95,25,144,169,513,385,898,0.000333,2.21533,24,159503.7536,8861.319645,6645.989734,1148.565605,65,0
1,0,94,95,26,145,171,511,388,899,0.000333,2.222883,26,173384.8847,9632.493593,6668.649411,1163.298251,65,0
2,0,14,16,21,39,60,83,68,151,0.000333,0.297313,10,8919.404799,495.522489,891.94048,298.369352,4,0
1,0,49,50,22,66,88,258,198,456,0.000333,0.981834,33,97201.527,5400.084833,2945.500818,497.037507,11,0
1,0,30,31,18,45,63,260,196,456,0.000333,0.908547,36,98123.02722,5451.27929,2725.639645,322.192039,12,0
1,0,26,27,18,45,63,236,178,414,0.000333,0.824865,27,66814.03499,3711.890832,2474.593888,322.192039,12,0
1,0,25,26,18,45,63,233,173,406,0.000333,0.808925,27,65522.94252,3640.163473,2426.775649,322.192039,12,0
1,0,25,26,18,45,63,233,173,406,0.000333,0.808925,27,65522.94252,3640.163473,2426.775649,322.192039,12,0
1,0,20,21,16,44,60,196,148,344,0.000333,0.677323,24,48767.28876,2709.29382,2031.970365,304.214991,12,0
1,0,20,21,16,44,60,196,148,344,0.000333,0.677323,24,48767.28876,2709.29382,2031.970365,304.214991,12,0
1,0,23,24,18,45,63,222,165,387,0.000333,0.771069,27,62456.59792,3469.810996,2313.20733,322.192039,12,0
1,0,23,24,18,45,63,222,165,387,0.000333,0.771069,27,62456.59792,3469.810996,2313.20733,322.192039,12,0
1,0,15,16,16,42,58,126,104,230,0.000333,0.449112,16,21557.37006,1197.63167,1347.335629,290.477332,12,0
1,0,15,16,16,42,58,126,104,230,0.000333,0.449112,16,21557.37006,1197.63167,1347.335629,290.477332,12,0
1,0,19,20,18,44,62,166,132,298,0.000333,0.59145,27,47907.46351,2661.525751,1774.3505,315.273641,12,0
1,0,19,20,18,44,62,166,132,298,0.000333,0.59145,27,47907.46351,2661.525751,1774.3505,315.273641,12,0
1,0,26,27,18,45,63,235,178,413,0.000333,0.822872,27,66652.64843,3702.924913,2468.616608,322.192039,12,0
1,0,26,27,18,45,63,235,178,413,0.000333,0.822872,27,66652.64843,3702.924913,2468.616608,322.192039,12,0
1,0,24,25,18,45,63,197,156,353,0.000333,0.703327,27,56969.45495,3164.969719,2109.979813,322.192039,12,0
1,0,26,27,18,45,63,209,162,371,0.000333,0.73919,27,59874.41299,3326.356277,2217.570852,322.192039,12,0
1,0,26,27,18,45,63,215,168,383,0.000333,0.763099,27,61811.05169,3433.947316,2289.298211,322.192039,12,0
1,0,16,17,17,42,59,133,109,242,0.000333,0.474533,16,22777.59389,1265.421883,1423.599618,295.9642,12,0
0,0,44,44,24,57,81,299,251,550,0.000333,1.162306,48,167372.0401,9298.446671,3486.917502,442.513831,6,0
0,0,25,25,21,32,53,154,121,275,0.000333,0.525059,30,47255.34375,2625.296875,1575.178125,252.238666,4,0
0,0,44,44,24,57,81,299,251,550,0.000333,1.162306,48,167372.0401,9298.446671,3486.917502,442.513831,6,0
0,0,25,25,21,32,53,154,121,275,0.000333,0.525059,30,47255.34375,2625.296875,1575.178125,252.238666,4,0
0,0,44,44,24,57,81,299,251,550,0.000333,1.162306,48,167372.0401,9298.446671,3486.917502,442.513831,6,0
0,0,25,25,21,32,53,154,121,275,0.000333,0.525059,30,47255.34375,2625.296875,1575.178125,252.238666,4,0
0,0,44,44,24,57,81,299,251,550,0.000333,1.162306,48,167372.0401,9298.446671,3486.917502,442.513831,6,0
0,0,25,25,21,32,53,154,121,275,0.000333,0.525059,30,47255.34375,2625.296875,1575.178125,252.238666,4,0
0,0,44,44,24,57,81,299,251,550,0.000333,1.162306,48,167372.0401,9298.446671,3486.917502,442.513831,6,0
0,0,25,25,21,32,53,154,121,275,0.000333,0.525059,30,47255.34375,2625.296875,1575.178125,252.238666,4,0
0,0,44,44,24,57,81,299,251,550,0.000333,1.162306,48,167372.0401,9298.446671,3486.917502,442.513831,6,0
0,0,25,25,21,32,53,154,121,275,0.000333,0.525059,30,47255.34375,2625.296875,1575.178125,252.238666,4,0
0,0,44,44,24,57,81,299,251,550,0.000333,1.162306,48,167372.0401,9298.446671,3486.917502,442.513831,6,0
0,0,25,25,21,32,53,154,121,275,0.000333,0.525059,30,47255.34375,2625.296875,1575.178125,252.238666,4,0
0,0,44,44,24,57,81,299,251,550,0.000333,1.162306,48,167372.0401,9298.446671,3486.917502,442.513831,6,0
0,0,25,25,21,32,53,154,121,275,0.000333,0.525059,30,47255.34375,2625.296875,1575.178125,252.238666,4,0
0,0,44,44,24,57,81,299,251,550,0.000333,1.162306,48,167372.0401,9298.446671,3486.917502,442.513831,6,0
0,0,25,25,21,32,53,154,121,275,0.000333,0.525059,30,47255.34375,2625.296875,1575.178125,252.238666,4,0
0,0,42,42,21,51,72,256,208,464,0.000333,0.954282,40,114513.808,6361.878224,2862.845201,381.532358,3,0
0,0,42,42,21,51,72,256,208,464,0.000333,0.954282,40,114513.808,6361.878224,2862.845201,381.532358,3,0
0,0,42,42,21,51,72,256,208,464,0.000333,0.954282,40,114513.808,6361.878224,2862.845201,381.532358,3,0
0,0,42,42,21,51,72,256,208,464,0.000333,0.954282,40,114513.808,6361.878224,2862.845201,381.532358,3,0
0,0,41,41,21,50,71,251,203,454,0.000333,0.930662,40,111679.4077,6204.411538,2791.985192,374.431475,3,0
0,0,39,39,21,49,70,241,194,435,0.000333,0.888746,30,79987.14337,4443.730187,2666.238112,367.359448,3,0
0,0,38,38,21,48,69,236,189,425,0.000333,0.865374,30,77883.68682,4326.87149,2596.122894,360.316866,3,0
0,0,36,36,21,47,68,226,180,406,0.000333,0.823837,30,74145.29741,4119.183189,2471.509914,353.304342,3,0
0,0,35,35,21,46,67,221,175,396,0.000333,0.800724,30,72065.13958,4003.618866,2402.171319,346.322516,3,0
1,0,6,7,15,16,31,38,26,64,0.000333,0.10569,7,2219.479947,123.304442,317.068564,122.603359,6,0
1,0,20,21,22,46,68,119,92,211,0.000333,0.428152,22,28258.00251,1569.889028,1284.45466,352.191346,17,0
0,0,27,27,24,74,98,198,140,338,0.000333,0.745257,12,26829.26313,1490.514618,2235.771927,569.538649,17,0
0,0,21,21,22,56,78,132,119,251,0.000333,0.525879,22,34707.99105,1928.221725,1577.635957,423.319371,7,0
1,0,94,95,25,145,170,513,385,898,0.000333,2.217878,24,159687.1935,8871.510748,6653.633061,1157.183223,65,0
1,0,92,93,25,145,170,505,381,886,0.000333,2.18824,24,157553.2889,8752.960493,6564.720369,1157.183223,64,0
1,0,92,93,25,145,170,504,382,886,0.000333,2.18824,24,157553.2889,8752.960493,6564.720369,1157.183223,63,0
2,0,9,11,10,19,29,48,47,95,0.000333,0.153836,10,4615.081945,256.393441,461.508195,113.929904,1,0
1,0,28,29,17,90,107,199,138,337,0.000333,0.757291,8,18174.995,1009.721944,2271.874374,653.753647,24,0
1,0,28,29,17,90,107,199,138,337,0.000333,0.757291,8,18174.995,1009.721944,2271.874374,653.753647,24,0
1,0,38,39,22,68,90,220,165,385,0.000333,0.833121,22,54985.99573,3054.77754,2499.363442,512.054969,10,0
1,0,43,44,26,75,101,277,241,518,0.000333,1.149651,39,134509.1884,7472.732687,3448.953548,589.372834,16,0
1,0,43,44,26,75,101,277,241,518,0.000333,1.149651,39,134509.1884,7472.732687,3448.953548,589.372834,16,0
1,0,25,26,16,36,52,127,109,236,0.000333,0.448435,24,32287.29056,1793.738365,1345.303773,250.1173,14,0
0,0,32,32,21,43,64,200,159,359,0.000333,0.718,30,64620,3590,2154,325.56805,3,0
0,0,32,32,21,43,64,200,159,359,0.000333,0.718,30,64620,3590,2154,325.56805,3,0
0,0,53,53,24,62,86,257,214,471,0.000333,1.008924,36,108963.7452,6053.541399,3026.770699,479.199271,8,0
0,0,44,44,23,50,73,198,165,363,0.000333,0.748969,33,74147.90839,4119.328244,2246.906315,386.234734,9,0
0,0,76,76,23,72,95,352,280,632,0.000333,1.38405,33,137020.9086,7612.272698,4152.148744,548.276525,16,0
0,0,56,56,22,69,91,290,222,512,0.000333,1.110664,33,109955.6982,6108.649902,3331.990856,519.595683,17,0
0,0,38,38,22,46,68,166,122,288,0.000333,0.584396,22,38570.16456,2142.78692,1753.189298,352.191346,14,0
0,0,30,30,22,43,65,135,107,242,0.000333,0.485804,22,32063.08624,1781.282569,1457.413011,331.43688,8,0
0,0,28,28,21,41,62,134,101,235,0.000333,0.466412,20,27984.72266,1554.706814,1399.236133,311.898298,10,0
0,0,31,31,19,45,64,147,119,266,0.000333,0.532,18,28728,1596,1596,327.844012,9,0
0,0,38,38,21,52,73,193,145,338,0.000333,0.697387,20,41843.21402,2324.623001,2092.160701,388.661531,14,0
0,0,29,29,19,51,70,183,149,332,0.000333,0.678307,18,36628.59531,2034.921962,2034.921962,370.004315,5,0
0,0,20,20,17,34,51,145,90,235,0.000333,0.44434,16,21328.31929,1184.906627,1333.019955,242.460605,3,0
0,0,50,50,23,46,69,268,193,461,0.000333,0.938677,44,123905.3101,6883.628338,2816.029775,358.125775,10,0
0,0,55,55,22,48,70,283,216,499,0.000333,1.019504,44,134574.5379,7476.363218,3058.512225,366.185696,11,0
0,0,37,37,22,42,64,195,143,338,0.000333,0.676,33,66924,3718,2028,324.584827,8,0
0,0,39,39,24,54,78,177,136,313,0.000333,0.655777,24,47215.94147,2623.107859,1967.330895,420.803025,13,0
0,0,31,31,25,50,75,146,121,267,0.000333,0.554365,24,39914.27017,2217.459454,1663.09459,398.289214,7,0
0,0,29,29,24,49,73,145,115,260,0.000333,0.536451,24,38624.50525,2145.805847,1609.354385,385.159882,9,0
0,0,27,27,20,47,67,138,113,251,0.000333,0.507529,20,30451.76774,1691.764874,1522.588387,347.504238,8,0
0,0,59,59,24,61,85,273,221,494,0.000333,1.055413,36,113984.6084,6332.478245,3166.239122,471.814078,11,0
0,0,50,50,23,49,72,214,172,386,0.000333,0.793864,33,78592.50467,4366.250259,2381.591051,379.162707,12,0
0,0,93,93,29,87,116,441,337,778,0.000333,1.778503,42,224091.387,12449.5215,5335.509214,701.417533,19,0
0,0,53,53,22,65,87,263,205,468,0.000333,1.005099,33,99504.81935,5528.045519,3015.297556,489.561403,15,0
0,0,37,37,27,53,80,223,152,375,0.000333,0.790241,26,61638.79893,3424.377718,2370.723036,431.961747,24,0
0,0,37,37,27,53,80,223,152,375,0.000333,0.790241,26,61638.79893,3424.377718,2370.723036,431.961747,24,0
0,0,32,32,22,53,75,176,121,297,0.000333,0.616653,22,40699.10132,2261.061185,1849.959151,401.68728,18,0
0,0,28,28,19,47,66,153,125,278,0.000333,0.560114,18,30246.14817,1680.341565,1680.341565,341.776299,6,0
0,0,13,13,17,26,43,67,57,124,0.000333,0.224286,16,10765.70927,598.09496,672.85683,191.698301,5,0
0,0,33,33,21,49,70,172,147,319,0.000333,0.651747,30,58657.23847,3258.735471,1955.241282,367.359448,6,0
0,0,7,7,11,21,32,36,33,69,0.000333,0.115,5,1725,95.833333,345,130.292414,1,0
0,0,9,9,20,24,44,77,64,141,0.000333,0.256593,20,15395.59717,855.310954,769.779858,196.477662,4,0
0,0,8,8,14,22,36,60,54,114,0.000333,0.196457,14,8251.200302,458.400017,589.37145,151.410465,1,0
0,0,8,8,14,23,37,59,53,112,0.000333,0.194486,14,8168.422877,453.801271,583.458777,157.344894,1,0
0,0,9,9,20,24,44,77,64,141,0.000333,0.256593,20,15395.59717,855.310954,769.779858,196.477662,4,0
0,0,8,8,14,22,36,60,54,114,0.000333,0.196457,14,8251.200302,458.400017,589.37145,151.410465,1,0
0,0,8,8,14,23,37,59,53,112,0.000333,0.194486,14,8168.422877,453.801271,583.458777,157.344894,1,0
0,0,64,64,24,57,81,324,292,616,0.000333,1.301783,60,234320.8561,13017.82534,3905.347602,442.513831,6,0
0,0,22,22,22,41,63,135,105,240,0.000333,0.478182,22,31560.038,1753.335444,1434.547182,317.767128,5,0
0,0,11,11,16,28,44,60,53,113,0.000333,0.205639,8,4935.326183,274.184788,616.915773,198.605938,3,0
0,0,64,64,24,54,78,283,272,555,0.000333,1.162799,60,209303.8939,11627.99411,3488.398231,420.803025,8,0
0,0,30,30,21,39,60,149,143,292,0.000333,0.574937,30,51744.36162,2874.686757,1724.812054,298.369352,3,0
0,0,54,54,22,51,73,285,246,531,0.000333,1.095599,44,144619.061,8034.392277,3286.796841,387.401188,6,0
0,0,11,11,17,28,45,65,53,118,0.000333,0.216013,8,5184.309323,288.017185,648.038665,204.092806,4,0
0,0,56,56,24,54,78,243,234,477,0.000333,0.999379,48,143910.5692,7995.031622,2998.136858,420.803025,8,0
0,0,30,30,21,41,62,131,122,253,0.000333,0.502137,20,30128.23333,1673.790741,1506.411667,311.898298,7,0
0,0,31,31,22,41,63,141,126,267,0.000333,0.531978,33,52665.81341,2925.878523,1595.93374,317.767128,8,0
0,0,30,30,21,41,62,131,122,253,0.000333,0.502137,20,30128.23333,1673.790741,1506.411667,311.898298,7,0
0,0,39,39,23,46,69,198,182,380,0.000333,0.773746,33,76600.89669,4255.605372,2321.239294,358.125775,5,0
0,0,10,10,16,27,43,55,49,104,0.000333,0.188111,8,4514.652276,250.814015,564.331534,192.381963,3,0
0,0,18,18,19,33,52,100,83,183,0.000333,0.347727,18,18777.24843,1043.180468,1043.180468,247.175629,5,0
0,0,53,53,23,51,74,239,231,470,0.000333,0.972814,44,128411.4956,7133.971978,2918.443082,393.335617,7,0
0,0,30,30,21,41,62,131,122,253,0.000333,0.502137,20,30128.23333,1673.790741,1506.411667,311.898298,7,0
0,0,33,33,22,42,64,145,135,280,0.000333,0.56,33,55440,3080,1680,324.584827,8,0
0,0,51,51,23,48,71,251,236,487,0.000333,0.998309,44,131776.7813,7320.932293,2994.926847,372.120125,5,0
0,0,66,66,24,54,78,299,289,588,0.000333,1.231939,60,221748.9903,12319.38835,3695.816505,420.803025,8,0
0,0,14,14,16,29,45,88,66,154,0.000333,0.281915,16,13531.92603,751.773668,845.745377,204.881449,9,0
0,0,18,18,19,33,52,92,86,178,0.000333,0.338226,18,18264.20886,1014.67827,1014.67827,247.175629,3,0
0,0,6,6,11,17,28,25,25,50,0.000333,0.080123,5,1201.838731,66.768818,240.367746,107.540616,1,0
0,0,8,8,14,24,38,39,35,74,0.000333,0.129449,7,2718.426452,151.023692,388.346636,163.342069,4,0
0,0,8,8,14,22,36,40,40,80,0.000333,0.137865,7,2895.158001,160.842111,413.594,151.410465,2,0
0,0,10,10,16,30,46,55,54,109,0.000333,0.200689,8,4816.546026,267.58589,602.068253,211.206718,3,0
0,0,8,8,16,25,41,52,42,94,0.000333,0.16787,8,4028.879107,223.826617,503.609888,180.096405,8,0
0,0,75,75,24,56,80,338,326,664,0.000333,1.399253,60,251865.6153,13992.53418,4197.760255,435.250976,8,0
0,0,34,34,24,51,75,153,147,300,0.000333,0.622882,24,44847.49457,2491.527476,1868.645607,399.332792,8,0
0,0,6,6,13,18,31,31,31,62,0.000333,0.102387,6,1842.961027,102.386724,307.160171,123.164366,1,0
0,0,18,18,18,29,47,87,90,177,0.000333,0.327721,27,26545.38012,1474.74334,983.162227,215.940099,2,0
0,0,75,75,26,57,83,341,329,670,0.000333,1.423759,65,277632.9672,15424.05374,4271.276419,454.686163,8,0
0,0,15,15,15,32,47,72,76,148,0.000333,0.274026,14,11509.1081,639.394894,822.07915,218.603359,1,0
0,0,15,15,15,30,45,71,75,146,0.000333,0.26727,14,11225.34773,623.630429,801.810552,205.810077,1,0
0,0,10,10,13,23,36,44,47,91,0.000333,0.156821,12,5645.558102,313.642117,470.463175,152.147641,1,0
0,0,9,9,12,23,35,34,37,71,0.000333,0.121393,6,2185.074565,121.393031,364.179094,147.061475,1,0
0,0,4,4,10,16,26,18,20,38,0.000333,0.059539,5,893.083546,49.615753,178.616709,97.219281,1,0
0,0,9,9,14,24,38,44,39,83,0.000333,0.145193,7,3049.045885,169.391438,435.577984,163.342069,5,0
0,0,9,9,14,24,38,45,39,84,0.000333,0.146942,7,3085.781378,171.432299,440.825911,163.342069,5,0
0,0,26,26,20,40,60,131,125,256,0.000333,0.504055,30,45364.91977,2520.273321,1512.163992,299.315686,5,0
0,0,9,9,16,26,42,49,43,92,0.000333,0.165364,8,3968.745623,220.485868,496.093203,186.211433,6,0
0,0,18,18,15,33,48,97,100,197,0.000333,0.366746,21,23104.98987,1283.610548,1100.237613,225.068365,1,0
0,0,5,5,12,11,23,22,21,43,0.000333,0.064838,6,1167.078985,64.837721,194.513164,81.073298,2,0
0,0,5,5,12,11,23,22,21,43,0.000333,0.064838,6,1167.078985,64.837721,194.513164,81.073298,2,0
0,0,5,5,12,10,22,22,21,43,0.000333,0.063919,12,2301.066715,127.83704,191.75556,76.238831,2,0
0,0,12,12,16,23,39,56,59,115,0.000333,0.202607,16,9725.140083,540.28556,607.821255,168.041925,2,0
0,0,107,107,28,117,145,569,375,944,0.000333,2.259278,42,284669.0356,15814.94642,6777.834181,938.43861,60,0
0,0,106,106,28,116,144,561,368,929,0.000333,2.220287,42,279756.1337,15542.00743,6660.860326,930.131733,60,0
0,0,13,13,14,18,32,56,45,101,0.000333,0.168333,14,7070,392.777778,505,128.361619,4,0
0,0,27,27,20,33,53,144,100,244,0.000333,0.465871,30,41928.37773,2329.354318,1397.612591,252.903568,9,0
0,0,21,21,18,28,46,107,78,185,0.000333,0.34062,18,18393.46131,1021.858962,1021.858962,209.664588,5,0
0,0,20,20,22,36,58,104,75,179,0.000333,0.349526,22,23068.72916,1281.596064,1048.578598,284.224796,9,0
0,0,72,72,27,93,120,401,277,678,0.000333,1.560957,26,121754.6674,6764.14819,4682.871824,736.523732,36,0
0,0,88,88,27,92,119,466,324,790,0.000333,1.815635,39,212429.3353,11801.62974,5446.906033,728.549663,43,0
0,0,87,87,32,97,129,432,303,735,0.000333,1.717751,48,247356.0976,13742.00542,5153.252033,800.191546,42,0
0,0,63,63,26,84,110,353,244,597,0.000333,1.349491,26,105260.2655,5847.792526,4048.471749,659.166096,33,0
0,0,51,51,26,77,103,288,198,486,0.000333,1.083213,26,84490.62066,4693.92337,3249.639256,604.753996,25,0
0,0,73,73,30,93,123,409,278,687,0.000333,1.589836,30,143085.224,7949.179109,4769.507465,755.348487,38,0
0,0,89,89,30,92,122,474,325,799,0.000333,1.845886,45,249194.661,13844.14783,5537.659133,747.374418,45,0
0,0,88,88,33,97,130,440,304,744,0.000333,1.741547,48,250782.7993,13932.37774,5224.641653,806.656552,44,0
0,0,64,64,29,84,113,361,245,606,0.000333,1.377676,28,115724.7966,6429.155369,4133.028451,677.836112,35,0
0,0,52,52,29,77,106,296,199,495,0.000333,1.110107,28,93248.9775,5180.49875,3330.320625,623.424012,27,0
0,0,9,9,15,20,35,57,39,96,0.000333,0.164137,7,3446.878187,191.493233,492.41117,145.041921,7,0
0,0,10,10,15,20,35,62,41,103,0.000333,0.176105,14,7396.42611,410.912562,528.316151,145.041921,8,0
0,0,24,24,16,22,38,105,80,185,0.000333,0.323622,24,23300.79816,1294.488787,970.86659,162.107496,8,0
0,0,25,25,20,33,53,137,89,226,0.000333,0.431503,20,25890.20046,1438.34447,1294.510023,252.903568,9,0
0,0,19,19,18,28,46,100,67,167,0.000333,0.307478,18,16603.82724,922.434847,922.434847,209.664588,5,0
0,0,8,8,16,25,41,52,47,99,0.000333,0.176799,8,4243.181188,235.732288,530.397648,180.096405,12,0
0,0,7,7,11,17,28,26,22,48,0.000333,0.076918,5,1153.765181,64.098066,230.753036,107.540616,7,0
0,0,80,80,34,87,121,365,296,661,0.000333,1.524456,51,233241.7986,12957.8777,4573.3686,733.509821,65,0
0,0,11,11,17,21,38,36,34,70,0.000333,0.122452,8,2938.839408,163.268856,367.354926,161.725534,2,0
0,0,3,3,17,16,33,43,29,72,0.000333,0.121065,8,2905.571013,161.420612,363.196377,133.486868,5,0
0,0,58,58,34,66,100,445,314,759,0.000333,1.680896,68,342902.7057,19050.15032,5042.686848,571.903748,22,0
0,0,19,19,21,27,48,133,100,233,0.000333,0.433765,30,39038.88788,2168.827104,1301.296263,220.620628,6,0
0,0,17,17,21,27,48,127,96,223,0.000333,0.415149,30,37363.39913,2075.744396,1245.446638,220.620628,6,0
0,0,18,18,22,31,53,92,68,160,0.000333,0.305489,22,20162.28,1120.126667,916.467273,251.687581,9,0
0,0,60,60,34,68,102,454,318,772,0.000333,1.717037,68,350275.6408,19459.75782,5151.112364,586.92121,23,0
0,0,53,53,34,64,98,397,279,676,0.000333,1.490515,68,304064.9821,16892.49901,4471.543855,556.973737,20,0
0,0,15,15,22,34,56,128,91,219,0.000333,0.423937,22,27979.83601,1554.435334,1271.810728,271.081232,4,0
0,0,11,11,20,23,43,67,47,114,0.000333,0.206198,20,12371.88364,687.326869,618.594182,190.480487,7,0
0,0,27,27,27,38,65,161,114,275,0.000333,0.55205,39,64589.8948,3588.327489,1656.151149,327.803208,14,0
0,0,45,45,32,59,91,374,264,638,0.000333,1.383991,64,265726.2707,14762.5706,4151.97298,507.07594,20,0
0,0,14,14,20,25,45,101,71,172,0.000333,0.314866,20,18891.97465,1049.554147,944.598733,202.534967,6,0
1,0,76,77,33,92,125,443,320,763,0.000333,1.771631,48,255114.8836,14173.04909,5314.893409,766.632706,23,0
1,0,76,77,33,92,125,443,320,763,0.000333,1.771631,48,255114.8836,14173.04909,5314.893409,766.632706,23,0
1,0,76,77,33,92,125,443,320,763,0.000333,1.771631,48,255114.8836,14173.04909,5314.893409,766.632706,23,0
1,0,54,55,27,72,99,299,221,520,0.000333,1.149088,39,134443.3523,7469.075125,3447.265442,572.616563,19,0
1,0,55,56,27,73,100,305,225,530,0.000333,1.173748,39,137328.5074,7629.361525,3521.243781,580.239155,19,0
1,0,76,77,33,92,125,443,320,763,0.000333,1.771631,48,255114.8836,14173.04909,5314.893409,766.632706,23,0
1,0,53,54,27,71,98,295,218,513,0.000333,1.131115,39,132340.4999,7352.249992,3393.34615,565.014008,19,0
1,0,76,77,33,92,125,443,320,763,0.000333,1.771631,48,255114.8836,14173.04909,5314.893409,766.632706,23,0
1,0,76,77,33,92,125,443,320,763,0.000333,1.771631,48,255114.8836,14173.04909,5314.893409,766.632706,23,0
1,0,76,77,33,92,125,443,320,763,0.000333,1.771631,48,255114.8836,14173.04909,5314.893409,766.632706,23,0
0,0,10,10,17,19,36,38,29,67,0.000333,0.115462,8,2771.079801,153.948878,346.384975,150.197491,2,0
0,0,10,10,17,19,36,38,29,67,0.000333,0.115462,8,2771.079801,153.948878,346.384975,150.197491,2,0
0,0,10,10,13,16,29,34,29,63,0.000333,0.102018,6,1836.316816,102.017601,306.052803,112.105716,2,0
0,0,28,28,19,39,58,116,101,217,0.000333,0.423727,18,22881.27377,1271.181876,1271.181876,286.841309,9,0
0,0,21,21,16,32,48,92,81,173,0.000333,0.322066,16,15459.1762,858.843122,966.198513,224,7,0
0,0,21,21,16,31,47,96,81,177,0.000333,0.327721,16,15730.59563,873.921979,983.162227,217.580086,7,0
0,0,17,17,17,32,49,87,75,162,0.000333,0.303194,16,14553.32792,808.518218,909.582995,229.486868,6,0
0,0,31,31,19,43,62,144,127,271,0.000333,0.537862,18,29044.5696,1613.5872,1613.5872,314.040007,12,0
0,0,40,40,24,50,74,177,152,329,0.000333,0.68097,36,73544.76566,4085.820315,2042.910157,392.23191,14,0
0,0,23,23,17,30,47,89,83,172,0.000333,0.318463,16,15286.22852,849.234918,955.389282,216.693586,6,0
0,0,22,22,18,36,54,100,88,188,0.000333,0.36064,18,19474.53931,1081.91885,1081.91885,261.17595,7,0
0,0,22,22,19,34,53,106,87,193,0.000333,0.368496,18,19898.79566,1105.488648,1105.488648,253.684359,7,0
0,0,22,22,18,34,52,100,88,188,0.000333,0.357228,18,19290.28801,1071.682667,1071.682667,248.032387,7,0
1,0,14,15,18,20,38,54,41,95,0.000333,0.166184,18,8973.956048,498.553114,498.553114,161.497212,5,0
1,0,14,15,18,20,38,54,41,95,0.000333,0.166184,18,8973.956048,498.553114,498.553114,161.497212,5,0
0,0,72,72,24,77,101,383,319,702,0.000333,1.558021,48,224355.0941,12464.1719,4674.064461,592.581664,60,0
0,0,52,52,22,58,80,285,226,511,0.000333,1.076835,33,106606.6735,5922.59297,3230.505256,437.870393,54,0
0,0,72,72,25,80,105,378,308,686,0.000333,1.535324,36,165815.0073,9211.94485,4605.972425,621.850652,61,0
0,0,53,53,23,59,82,293,230,523,0.000333,1.108333,33,109724.99,6095.83278,3324.999698,451.117865,54,0
0,0,71,71,24,74,98,377,314,691,0.000333,1.523588,48,219396.6961,12188.70534,4570.764502,569.538649,60,0
0,0,51,51,22,54,76,279,221,500,0.000333,1.041321,44,137454.4053,7636.35585,3123.963757,408.871421,54,0
0,0,71,71,25,76,101,372,303,675,0.000333,1.498098,36,161794.539,8988.585502,4494.292751,590.938896,61,0
0,0,52,52,23,55,78,287,225,512,0.000333,1.072709,44,141597.5412,7866.530066,3218.125936,422.016709,54,0
0,0,98,98,29,86,115,510,413,923,0.000333,2.106129,56,353829.6898,19657.20499,6318.387317,693.540218,69,0
0,0,78,78,26,65,91,412,328,740,0.000333,1.605256,65,313024.9222,17390.27346,4815.768034,513.665341,61,0
0,0,98,98,28,86,114,505,410,915,0.000333,2.084031,56,350117.2843,19450.96024,6252.094363,687.264707,68,0
0,0,79,79,27,66,93,420,332,752,0.000333,1.639149,65,319634.0827,17757.44904,4917.447426,527.311974,61,0
0,0,48,48,23,70,93,272,221,493,0.000333,1.074602,33,106385.5747,5910.309705,3223.805294,533.091736,16,0
0,0,78,78,23,78,101,407,343,750,0.000333,1.664553,44,219720.9789,12206.72105,4993.658612,594.303298,55,0
0,0,98,98,25,99,124,500,425,925,0.000333,2.144211,48,308766.3162,17153.68423,6432.631587,772.40271,62,0
0,0,79,79,24,79,103,415,347,762,0.000333,1.698371,48,244565.4433,13586.96907,5095.113402,608.037779,55,0
0,0,69,69,25,74,99,365,301,666,0.000333,1.471717,48,211927.2724,11773.73736,4415.151509,575.595954,56,0
0,0,53,53,23,57,80,287,230,517,0.000333,1.089479,44,143811.2203,7989.512239,3268.436825,436.516656,50,0
0,0,73,73,25,79,104,380,312,692,0.000333,1.545568,36,166921.3543,9273.40857,4636.704285,614.095084,57,0
0,0,54,54,24,58,82,295,234,529,0.000333,1.121048,48,161430.9605,8968.386695,3363.14501,449.801998,50,0
0,0,82,82,28,80,108,441,361,802,0.000333,1.805807,56,303375.5075,16854.19486,5417.419777,640.360185,63,0
0,0,66,66,26,64,90,363,290,653,0.000333,1.41306,52,220437.3637,12246.52021,4239.180072,506.211433,57,0
0,0,86,86,28,85,113,456,372,828,0.000333,1.882369,56,316238.0581,17568.78101,5647.108181,679.404167,64,0
0,0,67,67,27,65,92,371,294,665,0.000333,1.446056,52,225584.7724,12532.48736,4338.168701,519.83587,57,0
0,0,84,84,25,79,104,420,349,769,0.000333,1.717546,48,247326.6309,13740.36838,5152.638143,614.095084,60,0
0,0,68,68,23,62,85,342,278,620,0.000333,1.324607,44,174848.1847,9713.788041,3973.82238,473.202096,54,0
0,0,88,88,25,84,109,435,360,795,0.000333,1.793569,48,258273.9138,14348.55077,5380.706538,653.051068,61,0
0,0,69,69,24,63,87,350,282,632,0.000333,1.357313,48,195453.1339,10858.50744,4071.940289,486.607735,54,0
0,0,92,92,25,94,119,476,410,886,0.000333,2.03627,48,293222.8098,16290.1561,6108.808538,732.227757,59,0
0,0,76,76,23,78,101,398,339,737,0.000333,1.635701,44,215912.482,11995.13789,4907.101863,594.303298,53,0
0,0,96,96,25,99,124,491,421,912,0.000333,2.114076,48,304426.8977,16912.60543,6342.227035,772.40271,60,0
0,0,77,77,24,79,103,406,343,749,0.000333,1.669396,48,240393.067,13355.17039,5008.188895,608.037779,53,0
0,0,73,73,25,74,99,376,311,687,0.000333,1.518123,48,218609.6639,12144.98133,4554.367998,575.595954,56,0
0,0,57,57,23,57,80,298,240,538,0.000333,1.133732,44,149652.6819,8314.037881,3401.197315,436.516656,50,0
0,0,77,77,25,79,104,391,322,713,0.000333,1.592471,48,229315.8489,12739.76938,4777.413519,614.095084,57,0
0,0,58,58,24,58,82,306,244,550,0.000333,1.165551,48,167839.3729,9324.409607,3496.653603,449.801998,50,0
0,0,46,46,26,48,74,203,181,384,0.000333,0.79481,39,92992.7736,5166.2652,2384.430092,390.289633,11,0
0,0,65,65,30,58,88,309,264,573,0.000333,1.233751,60,222075.259,12337.51439,3701.254317,486.969616,17,0
0,0,119,119,30,95,125,524,443,967,0.000333,2.245304,60,404154.8042,22453.04468,6735.913403,771.343001,25,0
0,0,114,114,30,93,123,500,420,920,0.000333,2.129038,60,383226.8007,21290.37782,6387.113345,755.348487,25,0
0,0,50,50,28,58,86,228,192,420,0.000333,0.899677,42,113359.3103,6297.73946,2699.031197,474.368836,17,0
0,0,58,58,29,63,92,252,218,470,0.000333,1.022025,42,128775.113,7154.172945,3066.074119,517.450084,21,0
0,0,48,48,27,50,77,208,181,389,0.000333,0.812593,39,95073.41861,5281.856589,2437.779964,410.574772,16,0
0,0,48,48,27,53,80,221,186,407,0.000333,0.857675,39,100347.9647,5574.886925,2573.024735,431.961747,16,0
0,0,49,49,27,53,80,226,191,417,0.000333,0.878748,39,102813.5166,5711.862034,2636.244016,431.961747,16,0
0,0,50,50,28,58,86,228,192,420,0.000333,0.899677,42,113359.3103,6297.73946,2699.031197,474.368836,17,0
0,0,83,83,26,70,96,427,346,773,0.000333,1.696725,52,264689.1527,14704.95293,5090.176013,551.261244,61,0
0,0,103,103,28,91,119,520,428,948,0.000333,2.178762,56,366032.0854,20335.11586,6536.28724,726.81525,68,0
0,0,84,84,27,71,98,435,350,785,0.000333,1.730849,52,270012.4558,15000.69199,5192.547228,565.014008,61,0
0,0,91,91,28,84,112,474,392,866,0.000333,1.965056,56,330129.4843,18340.52691,5895.169363,671.560601,65,0
0,0,75,75,26,68,94,396,321,717,0.000333,1.566547,52,244381.2907,13576.73838,4699.640207,536.158906,59,0
0,0,95,95,28,89,117,489,403,892,0.000333,2.042788,56,343188.4585,19066.02547,6128.36533,710.946213,66,0
0,0,76,76,27,69,96,404,325,729,0.000333,1.600146,52,249622.7585,13867.93103,4800.437663,549.87015,59,0
0,0,54,54,28,45,73,239,201,440,0.000333,0.907841,56,152517.2771,8473.182063,2723.522806,381.739327,14,0
0,0,75,75,33,60,93,327,274,601,0.000333,1.310011,64,251522.2045,13973.45581,3930.034445,520.878442,22,0
0,0,68,68,32,62,94,306,250,556,0.000333,1.214784,64,233238.4897,12957.69387,3644.351402,529.160171,22,0
0,0,76,76,33,66,99,330,276,606,0.000333,1.33913,64,257112.9672,14284.05373,4017.390112,565.395018,26,0
0,0,66,66,32,53,85,286,239,525,0.000333,1.121643,64,215355.5355,11964.19641,3364.930241,463.579784,21,0
0,0,66,66,32,57,89,299,244,543,0.000333,1.172108,64,225044.6882,12502.48268,3516.323253,492.474731,21,0
0,0,67,67,32,56,88,304,249,553,0.000333,1.190689,64,228612.2038,12700.67799,3572.065685,485.211876,21,0
0,0,68,68,32,62,94,306,250,556,0.000333,1.214784,64,233238.4897,12957.69387,3644.351402,529.160171,22,0
0,0,12,12,17,27,44,64,56,120,0.000333,0.218377,16,10482.10871,582.339373,655.131794,197.868831,5,0
0,0,18,18,17,35,52,90,77,167,0.000333,0.317324,16,15231.57493,846.198607,951.973433,249.011774,7,0
0,0,18,18,16,32,48,88,80,168,0.000333,0.312758,16,15012.3792,834.021067,938.2737,224,6,0
0,0,17,17,18,33,51,86,74,160,0.000333,0.302529,18,16336.58499,907.588055,907.588055,241.523656,6,0
0,0,82,82,27,84,111,439,369,808,0.000333,1.829963,52,285474.177,15859.6765,5489.88802,665.336626,59,0
0,0,66,66,25,67,92,361,298,659,0.000333,1.433009,48,206353.3118,11464.07288,4299.027329,522.524381,53,0
0,0,86,86,28,89,117,454,380,834,0.000333,1.909961,56,320873.5139,17826.30633,5729.884176,710.946213,60,0
0,0,67,67,26,68,94,369,302,671,0.000333,1.466043,52,228702.7142,12705.70635,4398.129119,536.158906,53,0
0,0,84,84,27,86,113,455,383,838,0.000333,1.905103,52,297196.1185,16510.89547,5715.309971,681.040731,59,0
0,0,68,68,25,69,94,377,312,689,0.000333,1.505371,48,216773.3625,12042.96458,4516.111719,537.584592,53,0
0,0,88,88,28,91,119,470,394,864,0.000333,1.985708,56,333598.8627,18533.27015,5957.122547,726.81525,60,0
0,0,69,69,26,70,96,385,316,701,0.000333,1.538686,52,240035.0531,13335.28073,4616.058713,551.261244,53,0
0,0,83,83,27,85,112,447,376,823,0.000333,1.867484,52,291327.5612,16184.86451,5602.453101,673.180192,59,0
0,0,67,67,25,68,93,369,305,674,0.000333,1.469131,48,211554.8659,11753.0481,4407.393039,530.043878,53,0
0,0,87,87,28,90,118,462,387,849,0.000333,1.947788,56,327228.3811,18179.35451,5843.363949,718.872716,60,0
0,0,68,68,26,69,95,377,309,686,0.000333,1.502307,52,234359.8893,13019.99385,4506.920947,543.69962,53,0
0,0,83,83,27,70,97,445,354,799,0.000333,1.757777,65,342766.4735,19042.58186,5273.330361,557.431774,61,0
0,0,84,84,27,70,97,451,357,808,0.000333,1.777577,65,346627.4225,19257.07903,5332.729576,557.431774,62,0
0,0,28,28,18,43,61,128,113,241,0.000333,0.476436,18,25727.53857,1429.307698,1429.307698,308.388034,7,0
0,0,27,27,16,46,62,120,113,233,0.000333,0.462443,16,22197.24385,1233.180214,1387.32774,318.08385,5,0
0,0,55,55,24,65,89,262,228,490,0.000333,1.057703,36,114231.9377,6346.218762,3173.109381,501.493008,13,0
0,0,109,109,27,101,128,477,407,884,0.000333,2.062667,52,321776,17876.44444,6188,800.861322,21,0
0,0,104,104,27,100,127,453,384,837,0.000333,1.949843,39,228131.6342,12673.97968,5849.529083,792.767582,21,0
0,0,40,40,24,64,88,181,156,337,0.000333,0.725609,24,52243.88293,2902.437941,2176.828455,494.0391,13,0
0,0,48,48,25,69,94,205,182,387,0.000333,0.845542,24,60879.02125,3382.167847,2536.625886,537.584592,17,0
0,0,38,38,23,54,77,161,145,306,0.000333,0.639212,22,42188.00699,2343.778166,1917.636681,414.80585,12,0
0,0,132,132,29,112,141,563,466,1029,0.000333,2.448866,56,411409.5071,22856.08373,7346.598342,903.3052,34,0
0,0,38,38,23,60,83,174,150,324,0.000333,0.688504,22,45441.28107,2524.515615,2065.512776,458.455361,12,0
0,0,39,39,23,59,82,179,155,334,0.000333,0.707807,22,46715.29213,2595.294007,2123.42237,451.117865,12,0
0,0,40,40,24,64,88,181,156,337,0.000333,0.725609,24,52243.88293,2902.437941,2176.828455,494.0391,13,0
0,0,43,43,21,50,71,199,177,376,0.000333,0.770768,30,69369.14751,3853.841528,2312.304917,374.431475,13,0
0,0,62,62,21,48,69,286,253,539,0.000333,1.097498,50,164624.7341,9145.818562,3292.494682,360.316866,18,0
0,0,88,88,29,78,107,474,391,865,0.000333,1.94379,70,408195.826,22677.54589,5831.368943,631.142822,64,0
0,0,72,72,27,62,89,396,320,716,0.000333,1.545542,65,301380.6339,16743.36855,4636.625137,497.542134,58,0
0,0,92,92,30,83,113,489,402,891,0.000333,2.025593,60,364606.7673,20255.93152,6076.779456,676.334991,65,0
0,0,73,73,28,63,91,404,324,728,0.000333,1.579225,70,331637.2149,18424.28972,4737.674498,511.174573,58,0
0,0,80,80,29,76,105,443,366,809,0.000333,1.810608,56,304182.1789,16899.00994,5431.824624,615.72394,62,0
0,0,64,64,27,60,87,365,295,660,0.000333,1.417448,52,221121.8208,12284.5456,4252.342707,482.795398,56,0
0,0,84,84,30,81,111,458,377,835,0.000333,1.891112,60,340400.2349,18911.12416,5673.337248,660.734568,63,0
0,0,65,65,28,61,89,373,299,672,0.000333,1.450564,56,243694.8005,13538.60003,4351.692866,496.380915,56,0
0,0,37,37,22,43,65,240,199,439,0.000333,0.881273,44,116328.0567,6462.669815,2643.81947,331.43688,9,0
0,0,43,43,22,51,73,266,220,486,0.000333,1.002752,44,132363.2084,7353.511576,3008.254736,387.401188,11,0
0,0,53,53,25,63,88,319,263,582,0.000333,1.25313,48,180450.6817,10025.03787,3759.389202,492.66504,15,0
0,0,43,43,22,49,71,268,227,495,0.000333,1.014708,44,133941.4923,7441.194015,3044.124824,373.228278,10,0
0,0,26,26,18,43,61,136,118,254,0.000333,0.502136,18,27115.33111,1506.407284,1506.407284,308.388034,6,0
0,0,104,104,29,87,116,559,456,1015,0.000333,2.320284,70,487259.5497,27069.97498,6960.85071,701.417533,69,0
0,0,88,88,27,71,98,481,385,866,0.000333,1.909446,65,372342.0171,20685.66762,5728.338725,565.014008,63,0
0,0,89,89,28,72,100,489,389,878,0.000333,1.944435,70,408331.4014,22685.07786,5833.305735,578.840538,63,0
0,0,92,92,27,75,102,489,400,889,0.000333,1.977262,65,385566.0984,21420.3388,5931.786129,595.543364,62,0
0,0,93,93,28,76,104,497,404,901,0.000333,2.012365,70,422596.733,23477.59628,6037.096186,609.448429,62,0
0,0,100,100,29,89,118,536,446,982,0.000333,2.252918,70,473112.8832,26284.04907,6758.755474,717.221724,66,0
0,0,84,84,27,73,100,458,375,833,0.000333,1.844777,65,359731.5934,19985.08852,5534.332206,580.239155,60,0
0,0,104,104,30,94,124,551,457,1008,0.000333,2.33661,60,420589.7929,23366.0996,7009.829881,763.33807,67,0
0,0,85,85,28,74,102,466,379,845,0.000333,1.8794,70,394673.959,21926.33105,5638.199414,594.105487,60,0
0,0,60,60,21,63,84,277,246,523,0.000333,1.114394,30,100295.4604,5571.97002,3343.182012,468.807301,15,0
0,0,79,79,21,61,82,364,322,686,0.000333,1.45376,50,218064.0338,12114.66854,4361.280675,454.013643,20,0
0,0,33,33,22,43,65,214,178,392,0.000333,0.786923,44,103873.8,5770.766669,2360.768183,331.43688,9,0
0,0,39,39,22,51,73,240,199,439,0.000333,0.905778,33,89671.98838,4981.777132,2717.332981,387.401188,11,0
0,0,49,49,25,63,88,293,242,535,0.000333,1.151932,36,124408.653,6911.591832,3455.795916,492.66504,15,0
0,0,39,39,22,49,71,242,206,448,0.000333,0.918362,44,121223.8152,6734.656401,2755.08671,373.228278,10,0
0,0,22,22,18,43,61,110,97,207,0.000333,0.409221,18,22097.92732,1227.662629,1227.662629,308.388034,6,0
0,0,100,100,29,87,116,533,435,968,0.000333,2.212842,70,464696.7922,25816.48846,6638.525603,701.417533,69,0
0,0,84,84,27,71,98,455,364,819,0.000333,1.805816,65,352134.0786,19563.00436,5417.447362,565.014008,63,0
0,0,104,104,30,92,122,548,446,994,0.000333,2.296384,60,413349.1748,22963.84305,6889.152914,747.374418,70,0
0,0,85,85,28,72,100,463,368,831,0.000333,1.840348,70,386473.1146,21470.72859,5521.044494,578.840538,63,0
0,0,88,88,27,75,102,463,379,842,0.000333,1.872727,65,365181.839,20287.87994,5618.182138,595.543364,62,0
0,0,108,108,30,96,126,556,461,1017,0.000333,2.365298,60,425753.6209,23652.97894,7095.893682,779.363118,69,0
0,0,89,89,28,76,104,471,383,854,0.000333,1.907392,70,400552.2864,22252.9048,5722.175519,609.448429,62,0
0,0,96,96,29,89,118,510,425,935,0.000333,2.14509,56,360375.1901,20020.84389,6435.271251,717.221724,66,0
0,0,80,80,27,73,100,432,354,786,0.000333,1.74069,52,271547.6902,15085.98279,5222.070965,580.239155,60,0
0,0,100,100,30,94,124,525,436,961,0.000333,2.227661,60,400978.9593,22276.60885,6682.982654,763.33807,67,0
0,0,81,81,28,74,102,440,358,798,0.000333,1.774865,56,298177.3437,16565.40798,5324.595423,594.105487,60,0
0,0,56,56,21,63,84,251,225,476,0.000333,1.014248,30,91282.2928,5071.238489,3042.743093,468.807301,15,0
0,0,75,75,21,61,82,338,301,639,0.000333,1.354159,40,162499.0292,9027.723847,4062.475731,454.013643,20,0
0,0,35,35,22,43,65,221,185,406,0.000333,0.815027,44,107583.5786,5976.865478,2445.081332,331.43688,9,0
0,0,41,41,22,51,73,247,206,453,0.000333,0.934664,44,123375.5831,6854.199062,2803.990525,387.401188,11,0
0,0,51,51,25,63,88,300,249,549,0.000333,1.182076,36,127664.2065,7092.455917,3546.227959,492.66504,15,0
0,0,41,41,22,49,71,249,213,462,0.000333,0.947061,44,125012.0594,6945.114414,2841.183169,373.228278,10,0
0,0,24,24,18,43,61,117,104,221,0.000333,0.436898,18,23592.47313,1310.692952,1310.692952,308.388034,6,0
0,0,102,102,29,87,116,540,442,982,0.000333,2.244846,70,471417.6136,26189.86742,6734.537337,701.417533,69,0
0,0,86,86,27,71,98,462,371,833,0.000333,1.836684,65,358153.4645,19897.4147,5510.0533,565.014008,63,0
0,0,106,106,30,92,122,555,453,1008,0.000333,2.328728,60,419170.9942,23287.27745,6986.183236,747.374418,70,0
0,0,87,87,28,72,100,470,375,845,0.000333,1.871353,70,392984.0936,21832.44965,5614.05848,578.840538,63,0
0,0,90,90,27,75,102,470,386,856,0.000333,1.903865,65,371253.746,20625.20811,5711.596093,595.543364,62,0
0,0,91,91,28,76,104,478,390,868,0.000333,1.938661,70,407118.7173,22617.70652,5815.981675,609.448429,62,0
0,0,98,98,29,89,118,517,432,949,0.000333,2.177209,56,365771.1822,20320.62123,6531.628254,717.221724,66,0
0,0,82,82,27,73,100,439,361,800,0.000333,1.771695,52,276384.4175,15354.68986,5315.084952,580.239155,60,0
0,0,102,102,30,94,124,532,443,975,0.000333,2.260114,60,406820.4842,22601.13801,6780.341403,763.33807,67,0
0,0,83,83,28,74,102,447,365,812,0.000333,1.806003,56,303408.5252,16856.02918,5418.009378,594.105487,60,0
0,0,58,58,21,63,84,258,232,490,0.000333,1.044079,30,93967.06612,5220.392562,3132.235537,468.807301,15,0
0,0,77,77,21,61,82,345,308,653,0.000333,1.383827,50,207574.073,11531.89294,4151.481459,454.013643,20,0
0,0,33,33,24,39,63,160,139,299,0.000333,0.595736,36,64339.4411,3574.413394,1787.206697,316.169787,14,0
0,0,109,109,35,81,116,499,411,910,0.000333,2.080254,85,530464.83,29470.26833,6240.762706,693.052756,29,0
0,0,65,65,31,58,89,293,238,531,0.000333,1.146205,60,206316.8671,11462.04817,3438.614452,493.342983,21,0
0,0,73,73,32,62,94,317,264,581,0.000333,1.269405,64,243725.8319,13540.32399,3808.216123,529.160171,25,0
0,0,63,63,31,48,79,273,227,500,0.000333,1.05063,60,189113.4224,10506.30125,3151.890374,421.658286,20,0
0,0,63,63,31,53,84,286,232,518,0.000333,1.10374,60,198673.2255,11037.40142,3311.220425,457.15987,20,0
0,0,64,64,31,52,83,291,237,528,0.000333,1.122007,60,201961.2492,11220.0694,3366.02082,450.002951,20,0
0,0,65,65,31,58,89,293,238,531,0.000333,1.146205,60,206316.8671,11462.04817,3438.614452,493.342983,21,0
0,0,78,78,32,62,94,422,337,759,0.000333,1.658311,80,397994.6351,22110.81306,4974.932938,529.160171,21,0
0,0,70,70,31,58,89,326,271,597,0.000333,1.288671,60,231960.7715,12886.70953,3866.012858,493.342983,21,0
0,0,65,65,31,54,85,294,247,541,0.000333,1.155827,60,208048.8298,11558.26832,3467.480496,464.344011,20,0
0,0,110,110,34,80,114,507,423,930,0.000333,2.118196,85,540139.9556,30007.77531,6354.587713,678.727984,28,0
0,0,122,122,32,92,124,541,450,991,0.000333,2.297203,64,441062.9468,24503.49704,6891.608544,760.1677,27,0
0,0,58,58,29,57,86,269,222,491,0.000333,1.051765,42,132522.4318,7362.357321,3155.295995,473.35618,19,0
0,0,66,66,30,61,91,293,248,541,0.000333,1.173572,60,211243.014,11735.723,3520.7169,508.981695,23,0
0,0,56,56,29,47,76,249,211,460,0.000333,0.958016,56,160946.6127,8941.478486,2874.046656,401.947125,18,0
0,0,56,56,29,52,81,262,216,478,0.000333,1.010149,56,169705.1049,9428.061382,3030.448301,437.304314,18,0
0,0,57,57,29,51,80,267,221,488,0.000333,1.028367,56,172765.651,9598.091721,3085.10091,430.175141,18,0
0,0,58,58,29,57,86,269,222,491,0.000333,1.051765,42,132522.4318,7362.357321,3155.295995,473.35618,19,0
0,0,71,71,31,61,92,398,321,719,0.000333,1.56348,75,351783.0785,19543.50436,4690.441046,515.355063,19,0
0,0,63,63,30,57,87,302,255,557,0.000333,1.19624,60,215323.1716,11962.39842,3588.719527,479.681449,19,0
0,0,58,58,29,53,82,270,231,501,0.000333,1.061711,56,178367.479,9909.304391,3185.133554,444.461233,18,0
0,0,32,32,19,42,61,145,129,274,0.000333,0.541674,27,43875.59482,2437.533046,1625.02203,307.187955,10,0
0,0,27,27,17,37,54,113,105,218,0.000333,0.418188,16,20073.04761,1115.169312,1254.565475,262.236643,9,0
0,0,52,52,29,51,80,226,192,418,0.000333,0.880855,42,110987.7696,6165.987202,2642.565944,430.175141,20,0
0,0,59,59,22,79,101,393,314,707,0.000333,1.569119,33,155342.7321,8630.151784,4707.355518,596.106175,15,0
0,0,32,32,19,45,64,148,132,280,0.000333,0.56,18,30240,1680,1680,327.844012,10,0
0,0,27,27,17,40,57,116,108,224,0.000333,0.435522,16,20905.07781,1161.393212,1306.567363,282.363992,9,0
0,0,44,44,19,47,66,161,146,307,0.000333,0.618543,27,50101.98286,2783.443492,1855.628995,341.776299,10,0
0,0,14,14,17,20,37,54,41,95,0.000333,0.164966,16,7918.369116,439.909395,494.89807,155.92543,7,0
0,0,64,64,21,85,106,285,247,532,0.000333,1.193085,20,71585.07364,3976.948535,3579.253682,637.036895,9,0
0,0,39,39,20,65,85,202,161,363,0.000333,0.775536,20,46532.1782,2585.121011,2326.60891,477.89247,8,0
0,0,33,33,16,51,67,157,131,288,0.000333,0.582345,16,27952.53899,1552.918833,1747.033687,353.293692,5,0
0,0,34,34,19,62,81,178,142,320,0.000333,0.676251,18,36517.53602,2028.752001,2028.752001,449.870794,6,0
0,0,34,34,19,61,80,178,142,320,0.000333,0.674339,18,36414.30583,2023.01699,2023.01699,442.4856,6,0
0,0,36,36,20,65,85,190,153,343,0.000333,0.732807,20,43968.42182,2442.690101,2198.421091,477.89247,5,0
0,0,33,33,16,50,66,158,131,289,0.000333,0.582277,16,27949.27841,1552.737689,1746.8299,346.192809,5,0
0,0,34,34,19,62,81,178,142,320,0.000333,0.676251,18,36517.53602,2028.752001,2028.752001,449.870794,6,0
0,0,39,39,20,64,84,202,161,363,0.000333,0.77347,20,46408.22449,2578.234694,2320.411224,470.438562,8,0
0,0,33,33,19,55,74,162,133,295,0.000333,0.610596,18,32972.19737,1831.788743,1831.788743,398.685407,6,0
0,0,8,8,17,20,37,39,36,75,0.000333,0.130236,8,3125.672019,173.648446,390.709002,155.92543,8,0
0,0,19,19,18,28,46,83,76,159,0.000333,0.292749,18,15808.43432,878.246351,878.246351,209.664588,7,0
0,0,21,21,17,31,48,89,80,169,0.000333,0.31462,16,15101.7386,838.985478,943.858663,223.066954,8,0
0,0,54,54,22,60,82,302,255,557,0.000333,1.180385,44,155810.8845,8656.160252,3541.156467,452.520931,17,0
0,0,71,71,20,42,62,311,274,585,0.000333,1.161068,60,208992.2905,11610.68281,3483.204842,312.915894,22,0
0,0,90,90,20,40,60,398,350,748,0.000333,1.472785,80,353468.3332,19637.12963,4418.354166,299.315686,27,0
1,0,17,18,17,25,42,69,57,126,0.000333,0.226477,16,10870.91192,603.939551,679.431995,185.583273,4,0
1,0,17,18,17,25,42,69,57,126,0.000333,0.226477,16,10870.91192,603.939551,679.431995,185.583273,4,0
0,0,47,47,25,51,76,266,214,480,0.000333,0.999668,48,143952.2499,7997.347217,2999.005206,405.390097,43,0
0,0,25,25,22,35,57,108,92,200,0.000333,0.388859,22,25664.71606,1425.817559,1166.578003,277.632401,5,0
0,0,27,27,22,38,60,118,100,218,0.000333,0.429234,22,28329.4473,1573.858183,1287.70215,297.528741,6,0
0,0,27,27,20,37,57,119,104,223,0.000333,0.433578,20,26014.68946,1445.260526,1300.734473,279.188336,7,0
0,0,20,20,17,31,48,95,84,179,0.000333,0.333236,16,15995.3326,888.629589,999.708288,223.066954,5,0
0,0,38,38,23,51,74,174,151,325,0.000333,0.672691,22,44397.59156,2466.532865,2018.072344,393.335617,13,0
0,0,21,21,16,31,47,86,82,168,0.000333,0.311057,16,14930.73483,829.485269,933.170927,217.580086,5,0
0,0,20,20,17,37,54,97,87,184,0.000333,0.352966,16,16942.38881,941.243823,1058.8993,262.236643,6,0
0,0,20,20,18,35,53,103,86,189,0.000333,0.360859,18,19486.38539,1082.576966,1082.576966,254.583556,6,0
0,0,20,20,17,35,52,97,87,184,0.000333,0.349627,16,16782.09453,932.338585,1048.880908,249.011774,6,0
0,0,20,20,21,43,64,99,95,194,0.000333,0.388,20,23280,1293.333333,1164,325.56805,5,0
0,0,50,50,25,80,105,300,233,533,0.000333,1.192898,24,85888.62866,4771.590481,3578.692861,621.850652,29,0
0,0,47,47,25,79,104,293,224,517,0.000333,1.154709,24,83139.05602,4618.836446,3464.127334,614.095084,28,0
0,0,26,26,23,37,60,129,86,215,0.000333,0.423327,22,27939.59252,1552.199584,1269.981478,296.7917,12,0
0,0,30,30,15,46,61,143,118,261,0.000333,0.515974,14,21670.91423,1203.93968,1547.922445,312.687209,8,0
0,0,30,30,15,46,61,143,118,261,0.000333,0.515974,14,21670.91423,1203.93968,1547.922445,312.687209,8,0
0,0,29,29,15,44,59,137,114,251,0.000333,0.492181,14,20671.60768,1148.422649,1476.543405,298.81835,8,0
0,0,108,108,27,132,159,542,400,942,0.000333,2.296245,39,268660.694,14925.59411,6888.735744,1058.241986,51,0
0,0,40,40,20,65,85,215,171,386,0.000333,0.824675,20,49480.49803,2748.916557,2474.024901,477.89247,13,0
0,0,99,99,27,131,158,500,369,869,0.000333,2.115662,26,165021.6222,9167.867901,6346.98547,1049.760376,48,0
0,0,31,31,18,51,69,170,130,300,0.000333,0.610852,18,32986.03207,1832.557337,1832.557337,364.352342,10,0
0,0,90,90,25,120,145,455,328,783,0.000333,1.873956,24,134924.8516,7495.82509,5621.868817,944.923276,45,0
0,0,106,106,25,126,151,531,389,920,0.000333,2.219777,36,239735.965,13318.66472,6659.33236,995.233675,49,0
0,0,28,28,15,43,58,134,112,246,0.000333,0.480354,14,20174.88655,1120.82703,1441.063325,291.932743,8,0
1,0,12,13,18,30,48,85,49,134,0.000333,0.249462,9,6735.464776,374.192488,748.384975,222.265368,7,0
1,0,6,7,12,16,28,26,27,53,0.000333,0.08493,6,1528.738865,84.929937,254.789811,107.01955,1,0
1,0,5,6,10,16,26,31,25,56,0.000333,0.087742,5,1316.123121,73.117951,263.224624,97.219281,1,0
1,0,77,78,30,71,101,359,262,621,0.000333,1.37825,45,186063.7199,10336.87333,4134.749331,583.838763,31,0
0,0,17,17,18,27,45,106,88,194,0.000333,0.35514,27,28766.32652,1598.129251,1065.419501,203.440613,6,0
1,0,22,23,19,49,68,152,130,282,0.000333,0.572222,18,30899.96138,1716.664521,1716.664521,355.831405,7,0
1,0,22,23,19,49,68,152,130,282,0.000333,0.572222,18,30899.96138,1716.664521,1716.664521,355.831405,7,0
2,0,5,7,11,9,20,17,12,29,0.000333,0.041779,5,626.679574,34.815532,125.335915,66.583073,2,0
2,0,6,8,12,13,25,23,16,39,0.000333,0.06037,6,1086.662348,60.37013,181.110391,91.125266,2,0
2,0,15,17,20,30,50,86,56,142,0.000333,0.267143,10,8014.275789,445.237544,801.427579,233.64528,2,0
1,0,16,17,18,46,64,116,99,215,0.000333,0.43,18,23220,1290,1290,329.1425,6,0
1,0,67,68,28,64,92,274,214,488,0.000333,1.061166,42,133706.9259,7428.162547,3183.498235,518.605938,17,0
1,0,67,68,28,64,92,274,214,488,0.000333,1.061166,42,133706.9259,7428.162547,3183.498235,518.605938,17,0
1,0,67,68,28,64,92,274,214,488,0.000333,1.061166,42,133706.9259,7428.162547,3183.498235,518.605938,17,0
1,0,18,19,16,44,60,116,74,190,0.000333,0.374103,8,8978.473705,498.804095,1122.309213,304.214991,12,0
1,0,24,25,20,49,69,128,102,230,0.000333,0.46832,20,28099.2125,1561.067361,1404.960625,361.559344,8,0
1,0,12,13,16,29,45,64,48,112,0.000333,0.205029,8,4920.700374,273.372243,615.087547,204.881449,4,0
1,0,7,8,13,20,33,33,26,59,0.000333,0.099206,6,1785.715518,99.206418,297.619253,134.544278,4,0
1,0,33,34,26,45,71,199,125,324,0.000333,0.664173,26,51805.46974,2878.081652,1992.518067,369.344822,10,0
1,0,39,40,30,67,97,228,174,402,0.000333,0.884388,30,79594.94888,4421.941604,2653.164963,553.634694,9,0
1,0,39,40,31,59,90,186,137,323,0.000333,0.698956,30,62906.0565,3494.780917,2096.86855,500.656026,19,0
1,0,42,43,32,61,93,210,154,364,0.000333,0.793418,32,76168.12183,4231.562324,2380.253807,521.774978,20,0
1,0,54,55,25,72,97,346,233,579,0.000333,1.273783,36,137568.5833,7642.699071,3821.349536,560.331005,31,0
1,0,54,55,25,72,97,346,233,579,0.000333,1.273783,36,137568.5833,7642.699071,3821.349536,560.331005,31,0
1,0,47,48,25,72,97,311,206,517,0.000333,1.137385,24,81891.71855,4549.539919,3412.154939,560.331005,27,0
1,0,37,38,23,68,91,245,167,412,0.000333,0.893737,22,58986.65062,3277.036145,2681.211392,517.989398,19,0
1,0,36,37,27,57,84,170,123,293,0.000333,0.624316,26,48696.67413,2705.370785,1872.949005,460.856693,19,0
1,0,36,37,27,57,84,170,123,293,0.000333,0.624316,26,48696.67413,2705.370785,1872.949005,460.856693,19,0
1,0,35,36,26,57,83,166,121,287,0.000333,0.609879,26,47570.54424,2642.808013,1829.636317,454.686163,18,0
1,0,18,19,17,31,48,74,53,127,0.000333,0.23643,8,5674.321901,315.240106,709.290238,223.066954,7,0
1,0,24,25,20,42,62,114,98,212,0.000333,0.420763,20,25245.79236,1402.54402,1262.289618,312.915894,10,0
1,0,44,45,28,53,81,198,149,347,0.000333,0.733309,28,61597.98263,3422.110146,2199.927951,438.185722,15,0
1,0,22,23,20,33,53,98,82,180,0.000333,0.343675,20,20620.51364,1145.584091,1031.025682,252.903568,4,0
1,0,18,19,18,37,55,89,82,171,0.000333,0.329538,18,17795.0252,988.612511,988.612511,267.808425,5,0
1,0,24,25,20,42,62,114,98,212,0.000333,0.420763,20,25245.79236,1402.54402,1262.289618,312.915894,10,0
1,0,44,45,28,53,81,198,149,347,0.000333,0.733309,28,61597.98263,3422.110146,2199.927951,438.185722,15,0
1,0,22,23,20,33,53,98,82,180,0.000333,0.343675,20,20620.51364,1145.584091,1031.025682,252.903568,4,0
1,0,18,19,18,37,55,89,82,171,0.000333,0.329538,18,17795.0252,988.612511,988.612511,267.808425,5,0
1,0,15,16,18,42,60,86,77,163,0.000333,0.320941,9,8665.408504,481.411584,962.823167,301.535982,4,0
1,0,10,11,14,26,40,54,48,102,0.000333,0.180946,7,3799.85666,211.103148,542.836666,175.514402,3,0
1,0,9,10,13,26,39,44,42,86,0.000333,0.151515,6,2727.267545,151.514864,454.544591,170.317149,3,0
1,0,9,10,18,23,41,50,38,88,0.000333,0.157155,9,4243.181188,235.732288,471.464576,179.100575,6,0
1,0,10,11,18,27,45,74,51,125,0.000333,0.228827,9,6178.334733,343.240819,686.481637,203.440613,13,0
1,0,13,14,23,31,54,73,58,131,0.000333,0.251297,11,8292.792891,460.710716,753.890263,257.622011,9,0
1,0,16,17,16,44,60,113,64,177,0.000333,0.348507,8,8364.157083,464.675394,1045.519635,304.214991,12,0
1,0,12,13,14,23,37,59,30,89,0.000333,0.154547,7,3245.489447,180.304969,463.64135,157.344894,10,0
1,0,18,19,21,43,64,105,71,176,0.000333,0.352,10,10560,586.666667,1056,325.56805,4,0
1,0,12,13,18,21,39,44,32,76,0.000333,0.133897,9,3615.215118,200.845284,401.690569,167.297316,5,0
1,0,37,38,26,46,72,208,135,343,0.000333,0.705428,26,55023.39116,3056.855065,2116.284275,376.295283,10,0
1,0,39,40,30,67,97,228,174,402,0.000333,0.884388,30,79594.94888,4421.941604,2653.164963,553.634694,9,0
1,0,32,33,30,58,88,188,137,325,0.000333,0.699772,30,62979.45828,3498.858793,2099.315276,486.969616,9,0
1,0,39,40,30,67,97,228,174,402,0.000333,0.884388,30,79594.94888,4421.941604,2653.164963,553.634694,9,0
1,0,39,40,30,67,97,228,174,402,0.000333,0.884388,30,79594.94888,4421.941604,2653.164963,553.634694,9,0
1,0,54,55,25,72,97,346,233,579,0.000333,1.273783,36,137568.5833,7642.699071,3821.349536,560.331005,31,0
1,0,54,55,25,72,97,346,233,579,0.000333,1.273783,36,137568.5833,7642.699071,3821.349536,560.331005,31,0
1,0,33,34,22,59,81,225,154,379,0.000333,0.800934,22,52861.66932,2936.759407,2402.803151,445.183436,17,0
1,0,32,33,25,56,81,152,108,260,0.000333,0.549454,12,19780.33201,1098.907334,1648.361001,441.30828,15,0
1,0,33,34,26,56,82,153,108,261,0.000333,0.553107,13,21571.17395,1198.398553,1659.321073,447.423308,16,0
1,0,17,18,19,41,60,129,94,223,0.000333,0.439079,18,23710.25885,1317.236603,1317.236603,300.370255,9,0
1,0,24,25,18,57,75,155,129,284,0.000333,0.589662,18,31841.72115,1768.984508,1768.984508,407.533381,9,0
1,0,13,14,18,36,54,104,80,184,0.000333,0.352966,18,19060.18741,1058.8993,1058.8993,261.17595,5,0
0,0,16,16,22,40,62,105,71,176,0.000333,0.349313,11,11527.32406,640.406892,1047.938551,310.984619,6,0
0,0,10,10,12,24,36,41,37,78,0.000333,0.134418,6,2419.524901,134.41805,403.25415,153.05865,3,0
0,0,87,87,25,104,129,498,257,755,0.000333,1.764492,24,127043.4379,7057.96877,5293.476578,812.942135,56,0
0,0,40,40,24,60,84,251,147,398,0.000333,0.848047,24,61059.41602,3392.189779,2544.142334,464.452536,22,0
0,0,4,4,16,25,41,35,29,64,0.000333,0.114294,8,2743.066626,152.39259,342.883328,180.096405,2,0
0,0,43,43,20,59,79,259,155,414,0.000333,0.869922,20,52195.3046,2899.739144,2609.76523,433.514502,35,0
0,0,44,44,19,57,76,257,155,412,0.000333,0.858049,18,46334.63044,2574.146136,2574.146136,413.185354,32,0
0,0,85,85,27,109,136,494,268,762,0.000333,1.800216,26,140416.8138,7800.934101,5400.646685,866.114054,64,0
0,0,61,61,19,54,73,396,233,629,0.000333,1.2978,36,140162.3873,7786.799295,3893.399648,391.474548,58,0
0,0,41,41,19,58,77,255,151,406,0.000333,0.848105,18,45797.67604,2544.315336,2544.315336,420.47352,33,0
0,0,80,80,22,89,111,477,297,774,0.000333,1.752959,33,173542.9701,9641.276114,5258.877881,674.447771,43,0
0,0,49,49,21,67,88,302,179,481,0.000333,1.035662,20,62139.73217,3452.207343,3106.986609,498.666642,42,0
0,0,42,42,19,59,78,262,155,417,0.000333,0.873671,18,47178.22906,2621.012725,2621.012725,427.786563,33,0
0,0,48,48,28,78,106,289,183,472,0.000333,1.058526,28,88916.19673,4939.788707,3175.578455,624.867311,13,0
0,0,67,67,28,87,115,384,255,639,0.000333,1.458089,28,122479.508,6804.417111,4374.268143,695.142022,12,0
0,0,69,69,28,98,126,403,271,674,0.000333,1.567562,28,131675.2267,7315.290373,4702.686668,782.847503,12,0
0,0,27,27,15,29,44,100,64,164,0.000333,0.298449,14,12534.855,696.380833,895.346785,199.484808,7,0
0,0,29,29,17,32,49,106,69,175,0.000333,0.327525,16,15721.18756,873.399309,982.574223,229.486868,7,0
0,0,26,26,17,27,44,99,66,165,0.000333,0.300269,16,14412.89947,800.716637,900.806217,197.868831,5,0
0,0,28,28,15,30,45,103,66,169,0.000333,0.309374,14,12993.72443,721.873579,928.123173,205.810077,7,0
0,0,30,30,17,33,50,109,71,180,0.000333,0.338631,16,16254.30583,903.01699,1015.894114,235.951874,7,0
0,0,27,27,17,28,45,102,68,170,0.000333,0.311205,16,14937.84042,829.880023,933.615026,204.092806,5,0
0,0,26,26,14,27,41,89,58,147,0.000333,0.26252,14,11025.84203,612.546779,787.560145,181.684931,6,0
0,0,28,28,16,30,46,95,63,158,0.000333,0.290908,16,13963.56463,775.75359,872.722789,211.206718,6,0
0,0,25,25,16,25,41,88,60,148,0.000333,0.264306,16,12686.68315,704.81573,792.917697,180.096405,4,0
0,0,25,25,19,30,49,100,75,175,0.000333,0.327525,18,17686.33601,982.574223,982.574223,227.917341,12,0
0,0,23,23,19,29,48,94,70,164,0.000333,0.305311,18,16486.8093,915.93385,915.93385,221.592072,12,0
0,0,24,24,16,29,45,78,64,142,0.000333,0.259948,16,12477.49024,693.193902,779.84314,204.881449,10,0
0,0,7,7,13,18,31,31,25,56,0.000333,0.092478,6,1664.60996,92.478331,277.434993,123.164366,5,0
0,0,27,27,19,26,45,104,77,181,0.000333,0.331342,18,17892.45739,994.02541,994.02541,202.922055,12,0
0,0,31,31,21,27,48,125,93,218,0.000333,0.405841,30,36525.65476,2029.203042,1217.521825,220.620628,13,0
0,0,32,32,22,27,49,131,96,227,0.000333,0.424846,33,42059.79144,2336.65508,1274.539135,226.489458,13,0
0,0,25,25,18,26,44,96,74,170,0.000333,0.309368,18,16705.86075,928.103375,928.103375,197.270083,11,0
0,0,4,4,10,10,20,20,14,34,0.000333,0.048982,5,734.727776,40.81821,146.945555,66.438562,3,0
0,0,4,4,10,9,19,20,14,34,0.000333,0.048143,5,722.147677,40.119315,144.429535,61.748606,3,0
0,0,22,22,15,27,42,121,91,212,0.000333,0.381057,21,24006.59717,1333.699843,1143.171294,186.985321,7,0
0,0,22,22,15,27,42,121,91,212,0.000333,0.381057,21,24006.59717,1333.699843,1143.171294,186.985321,7,0
0,0,22,22,15,27,42,121,91,212,0.000333,0.381057,21,24006.59717,1333.699843,1143.171294,186.985321,7,0
0,0,127,127,24,107,131,576,406,982,0.000333,2.302274,36,248645.57,13813.64278,6906.821388,831.376068,46,0
0,0,128,128,25,104,129,574,405,979,0.000333,2.287997,36,247103.6934,13727.98297,6863.991483,812.942135,48,0
0,0,129,129,25,109,134,586,414,1000,0.000333,2.355363,36,254379.2109,14132.17838,7066.08919,853.828496,46,0
0,0,130,130,25,106,131,584,413,997,0.000333,2.337441,36,252443.6184,14024.64547,7012.322733,829.255973,48,0
0,0,69,69,32,61,93,495,235,730,0.000333,1.591195,48,229132.1247,12729.56249,4773.585932,521.774978,45,0
0,0,70,70,29,55,84,302,202,504,0.000333,1.073909,42,135312.5752,7517.365289,3221.727981,458.856233,23,0
0,0,61,61,29,53,82,265,180,445,0.000333,0.943037,42,118822.647,6601.258165,2829.110642,444.461233,19,0
0,0,62,62,28,53,81,262,175,437,0.000333,0.923505,42,116361.607,6464.53372,2770.514451,438.185722,20,0
0,0,110,110,32,100,132,478,322,800,0.000333,1.878505,48,270504.7342,15028.04079,5635.515295,824.385619,41,0
0,0,128,128,30,96,126,541,364,905,0.000333,2.104813,45,284149.7249,15786.09583,6314.438331,779.363118,47,0
0,0,127,127,27,70,97,574,390,964,0.000333,2.120772,65,413550.5387,22975.02993,6362.31598,557.431774,51,0
0,0,118,118,28,71,99,541,364,905,0.000333,1.999856,70,419969.7419,23331.65233,5999.567741,571.237983,50,0
0,0,103,103,32,99,131,463,307,770,0.000333,1.805245,48,259955.3141,14441.9619,5415.735711,816.306305,41,0
0,0,121,121,30,96,126,526,349,875,0.000333,2.03504,45,274730.397,15262.79983,6105.119933,779.363118,47,0
0,0,120,120,27,69,96,559,375,934,0.000333,2.050118,65,399773.0734,22209.61519,6150.354976,549.87015,51,0
0,0,111,111,28,70,98,526,349,875,0.000333,1.92929,56,324120.7824,18006.71013,5787.871114,563.655749,50,0
0,0,104,104,32,99,131,466,310,776,0.000333,1.819312,48,261980.94,14554.49667,5457.936249,816.306305,41,0
0,0,122,122,30,96,126,529,352,881,0.000333,2.048995,45,276614.2626,15367.45903,6146.983613,779.363118,47,0
0,0,121,121,27,69,96,562,378,940,0.000333,2.063288,65,402341.2088,22352.28938,6189.864751,549.87015,51,0
0,0,112,112,28,70,98,529,352,881,0.000333,1.94252,70,407929.1561,22662.73089,5827.559373,563.655749,50,0
0,0,54,54,25,56,81,317,184,501,0.000333,1.058755,36,114345.5347,6352.529703,3176.264851,441.30828,23,0
0,0,84,84,22,67,89,437,258,695,0.000333,1.500212,33,148520.9462,8251.16368,4500.634735,504.535471,28,0
0,0,98,98,25,79,104,587,348,935,0.000333,2.088304,48,300715.7346,16706.4297,6264.911136,614.095084,34,0
0,0,77,77,23,72,95,503,303,806,0.000333,1.765101,44,232993.3593,12944.07552,5295.30362,548.276525,28,0
0,0,77,77,23,72,95,503,303,806,0.000333,1.765101,44,232993.3593,12944.07552,5295.30362,548.276525,28,0
0,0,65,65,25,60,85,356,212,568,0.000333,1.213511,36,131059.2259,7281.068103,3640.534052,470.50984,28,0
0,0,52,52,25,53,78,301,174,475,0.000333,0.995189,36,107480.3779,5971.132108,2985.566054,419.676189,23,0
0,0,77,77,23,72,95,503,303,806,0.000333,1.765101,44,232993.3593,12944.07552,5295.30362,548.276525,28,0
0,0,53,53,20,58,78,301,182,483,0.000333,1.01195,30,91075.47815,5059.748786,3035.849272,426.20146,18,0
0,0,44,44,20,52,72,235,153,388,0.000333,0.797977,20,47878.61801,2659.923223,2393.930901,382.861427,14,0
0,0,87,87,26,75,101,441,258,699,0.000333,1.551363,39,181509.5032,10083.86129,4654.089826,589.372834,33,0
0,0,119,119,29,82,111,602,402,1004,0.000333,2.273865,56,382009.2377,21222.73543,6821.59353,662.200713,48,0
0,0,87,87,30,89,119,419,285,704,0.000333,1.617984,45,218427.8267,12134.87926,4853.951705,723.546993,35,0
0,0,60,60,25,60,85,330,198,528,0.000333,1.128053,36,121829.7029,6768.316829,3384.158414,470.50984,25,0
0,0,43,43,24,43,67,205,126,331,0.000333,0.669292,24,48189.01253,2677.167363,2007.875522,343.368484,18,0
0,0,18,18,20,30,50,83,58,141,0.000333,0.265261,10,7957.837228,442.102068,795.783723,233.64528,6,0
0,0,94,94,21,64,85,360,232,592,0.000333,1.264786,30,113830.783,6323.93239,3794.359434,476.238666,24,0
0,0,12,12,12,24,36,48,38,86,0.000333,0.148205,6,2667.681301,148.204517,444.61355,153.05865,2,0
0,0,31,31,17,39,56,126,93,219,0.000333,0.423937,16,20348.97165,1130.498425,1271.810728,275.617555,10,0
0,0,33,33,16,42,58,141,89,230,0.000333,0.449112,16,21557.37006,1197.63167,1347.335629,290.477332,12,0
0,0,70,70,21,68,89,460,265,725,0.000333,1.564969,30,140847.2021,7824.844562,4694.906737,506.186139,26,0
0,0,30,30,20,33,53,149,107,256,0.000333,0.488783,30,43990.42909,2443.912727,1466.347636,252.903568,11,0
0,0,35,35,19,38,57,190,140,330,0.000333,0.641618,27,51971.05003,2887.280557,1924.853705,280.131868,13,0
0,0,36,36,19,36,55,181,135,316,0.000333,0.60897,27,49326.56108,2740.364504,1826.909669,266.827923,12,0
0,0,41,41,20,39,59,218,159,377,0.000333,0.739252,40,88710.25718,4928.347621,2217.75643,292.569248,14,0
0,0,42,42,22,51,73,242,170,412,0.000333,0.850069,33,84156.8547,4675.380817,2550.207718,387.401188,17,0
0,0,50,50,22,52,74,279,192,471,0.000333,0.974884,33,96513.53366,5361.862981,2924.652535,394.530361,22,0
0,0,38,38,20,37,57,198,145,343,0.000333,0.666894,30,60020.43825,3334.468791,2000.681275,279.188336,13,0
0,0,36,36,19,39,58,196,142,338,0.000333,0.659999,27,53459.93456,2969.996365,1979.997576,286.841309,13,0
0,0,38,38,22,49,71,221,156,377,0.000333,0.772818,33,76509.00391,4250.500217,2318.454664,373.228278,15,0
0,0,76,76,26,74,100,411,293,704,0.000333,1.559092,39,182413.7155,10134.09531,4677.274758,581.710982,38,0
0,0,83,83,29,75,104,415,286,701,0.000333,1.565669,42,197274.3462,10959.6859,4697.008242,608.042851,35,0
0,0,110,110,26,69,95,580,390,970,0.000333,2.124253,65,414229.3961,23012.74423,6372.75994,543.69962,50,0
0,0,84,84,29,77,106,420,290,710,0.000333,1.592275,42,200626.588,11145.92155,4776.823523,623.424012,39,0
0,0,44,44,22,48,70,226,165,391,0.000333,0.79885,33,79086.13877,4393.674376,2396.54966,366.185696,17,0
0,0,77,77,26,74,100,420,300,720,0.000333,1.594525,52,248745.9757,13819.22088,4783.576457,581.710982,39,0
0,0,50,50,23,49,72,254,184,438,0.000333,0.900809,33,89180.09597,4954.449776,2702.427151,379.162707,18,0
0,0,54,54,24,60,84,280,203,483,0.000333,1.029163,36,111149.6153,6174.97863,3087.489315,464.452536,22,0
0,0,50,50,24,58,82,264,190,454,0.000333,0.96211,36,103907.83,5772.65722,2886.32861,449.801998,18,0
0,0,84,84,29,75,104,424,293,717,0.000333,1.601405,42,201777.0417,11209.83565,4804.215278,608.042851,36,0
0,0,111,111,26,69,95,589,397,986,0.000333,2.159293,65,421062.0459,23392.33589,6477.87763,543.69962,51,0
0,0,85,85,29,77,106,429,297,726,0.000333,1.628157,42,205147.7505,11397.09725,4884.47025,623.424012,40,0
0,0,62,62,24,61,85,317,225,542,0.000333,1.157963,36,125060.0359,6947.779775,3473.889887,471.814078,27,0
0,0,58,58,24,59,83,301,212,513,0.000333,1.090132,36,117734.2282,6540.790457,3270.395228,457.11504,23,0
0,0,47,47,23,47,70,234,170,404,0.000333,0.82541,33,81715.60118,4539.755621,2476.230339,365.107601,17,0
0,0,86,86,27,87,114,488,333,821,0.000333,1.869934,39,218782.3054,12154.57252,5609.802702,688.918047,32,0
0,0,50,50,24,58,82,259,189,448,0.000333,0.949394,36,102534.5987,5696.366596,2848.183298,449.801998,20,0
0,0,46,46,24,56,80,243,176,419,0.000333,0.882963,36,95359.96338,5297.775744,2648.887872,435.250976,16,0
0,0,98,98,29,81,110,461,323,784,0.000333,1.772195,42,223296.6126,12405.36737,5316.586015,654.409299,40,0
0,0,123,123,33,111,144,581,396,977,0.000333,2.335006,48,336240.8029,18680.0446,7005.016726,920.645167,49,0
0,0,98,98,29,81,110,461,323,784,0.000333,1.772195,42,223296.6126,12405.36737,5316.586015,654.409299,40,0
0,0,89,89,30,82,112,428,297,725,0.000333,1.645111,45,222089.9543,12338.3308,4935.332318,668.525982,39,0
0,0,37,37,19,38,57,199,144,343,0.000333,0.666894,27,54018.39442,3001.021912,2000.681275,280.131868,15,0
0,0,84,84,27,85,112,472,319,791,0.000333,1.794873,39,210000.092,11666.67178,5384.617743,673.180192,33,0
0,0,77,77,26,73,99,417,291,708,0.000333,1.564528,39,183049.795,10169.43306,4693.584487,574.068625,41,0
0,0,38,38,19,36,55,190,139,329,0.000333,0.634022,27,51355.81834,2853.101019,1902.067346,266.827923,14,0
0,0,43,43,20,39,59,227,163,390,0.000333,0.764744,40,91769.23157,5098.290643,2294.230789,292.569248,16,0
0,0,44,44,22,51,73,251,174,425,0.000333,0.876892,33,86812.28944,4822.904969,2630.675438,387.401188,19,0
0,0,74,74,26,69,95,393,267,660,0.000333,1.445368,39,169108.0834,9394.89352,4336.104701,543.69962,34,0
0,0,52,52,22,52,74,288,196,484,0.000333,1.001792,33,99177.38916,5509.854953,3005.375429,394.530361,24,0
0,0,40,40,20,37,57,207,149,356,0.000333,0.69217,40,83060.3538,4614.4641,2076.508845,279.188336,15,0
0,0,38,38,19,39,58,205,146,351,0.000333,0.685384,27,55516.08589,3084.226994,2056.151329,286.841309,15,0
0,0,40,40,22,49,71,230,160,390,0.000333,0.799467,33,79147.24543,4397.06919,2398.401377,373.228278,17,0
0,0,78,78,26,74,100,420,297,717,0.000333,1.587882,52,247709.5342,13761.64079,4763.644888,581.710982,40,0
0,0,85,85,29,75,104,424,290,714,0.000333,1.594705,42,200932.7863,11162.93257,4784.113959,608.042851,37,0
0,0,112,112,26,69,95,589,394,983,0.000333,2.152723,65,419780.9241,23321.16245,6458.168063,543.69962,52,0
0,0,86,86,29,77,106,429,294,723,0.000333,1.621429,42,204300.0325,11350.00181,4864.286489,623.424012,41,0
0,0,30,30,20,33,53,149,107,256,0.000333,0.488783,30,43990.42909,2443.912727,1466.347636,252.903568,11,0
0,0,35,35,19,38,57,190,140,330,0.000333,0.641618,27,51971.05003,2887.280557,1924.853705,280.131868,13,0
0,0,36,36,19,36,55,181,135,316,0.000333,0.60897,27,49326.56108,2740.364504,1826.909669,266.827923,12,0
0,0,41,41,20,39,59,218,159,377,0.000333,0.739252,40,88710.25718,4928.347621,2217.75643,292.569248,14,0
0,0,42,42,22,51,73,242,170,412,0.000333,0.850069,33,84156.8547,4675.380817,2550.207718,387.401188,17,0
0,0,50,50,22,52,74,279,192,471,0.000333,0.974884,33,96513.53366,5361.862981,2924.652535,394.530361,22,0
0,0,38,38,20,37,57,198,145,343,0.000333,0.666894,30,60020.43825,3334.468791,2000.681275,279.188336,13,0
0,0,36,36,19,39,58,196,142,338,0.000333,0.659999,27,53459.93456,2969.996365,1979.997576,286.841309,13,0
0,0,38,38,22,49,71,221,156,377,0.000333,0.772818,33,76509.00391,4250.500217,2318.454664,373.228278,15,0
0,0,76,76,26,74,100,411,293,704,0.000333,1.559092,39,182413.7155,10134.09531,4677.274758,581.710982,38,0
0,0,83,83,29,75,104,415,286,701,0.000333,1.565669,42,197274.3462,10959.6859,4697.008242,608.042851,35,0
0,0,110,110,26,69,95,580,390,970,0.000333,2.124253,65,414229.3961,23012.74423,6372.75994,543.69962,50,0
0,0,84,84,29,77,106,420,290,710,0.000333,1.592275,42,200626.588,11145.92155,4776.823523,623.424012,39,0
0,0,44,44,22,48,70,226,165,391,0.000333,0.79885,33,79086.13877,4393.674376,2396.54966,366.185696,17,0
0,0,77,77,26,74,100,420,300,720,0.000333,1.594525,52,248745.9757,13819.22088,4783.576457,581.710982,39,0
0,0,50,50,23,49,72,254,184,438,0.000333,0.900809,33,89180.09597,4954.449776,2702.427151,379.162707,18,0
0,0,54,54,24,60,84,280,203,483,0.000333,1.029163,36,111149.6153,6174.97863,3087.489315,464.452536,22,0
0,0,50,50,24,58,82,264,190,454,0.000333,0.96211,36,103907.83,5772.65722,2886.32861,449.801998,18,0
0,0,84,84,29,75,104,424,293,717,0.000333,1.601405,42,201777.0417,11209.83565,4804.215278,608.042851,36,0
0,0,111,111,26,69,95,589,397,986,0.000333,2.159293,65,421062.0459,23392.33589,6477.87763,543.69962,51,0
0,0,85,85,29,77,106,429,297,726,0.000333,1.628157,42,205147.7505,11397.09725,4884.47025,623.424012,40,0
0,0,62,62,24,61,85,317,225,542,0.000333,1.157963,36,125060.0359,6947.779775,3473.889887,471.814078,27,0
0,0,58,58,24,59,83,301,212,513,0.000333,1.090132,36,117734.2282,6540.790457,3270.395228,457.11504,23,0
0,0,47,47,23,47,70,234,170,404,0.000333,0.82541,33,81715.60118,4539.755621,2476.230339,365.107601,17,0
0,0,86,86,27,87,114,488,333,821,0.000333,1.869934,39,218782.3054,12154.57252,5609.802702,688.918047,32,0
0,0,50,50,24,58,82,259,189,448,0.000333,0.949394,36,102534.5987,5696.366596,2848.183298,449.801998,20,0
0,0,46,46,24,56,80,243,176,419,0.000333,0.882963,36,95359.96338,5297.775744,2648.887872,435.250976,16,0
0,0,98,98,29,81,110,461,323,784,0.000333,1.772195,42,223296.6126,12405.36737,5316.586015,654.409299,40,0
0,0,123,123,33,111,144,581,396,977,0.000333,2.335006,48,336240.8029,18680.0446,7005.016726,920.645167,49,0
0,0,98,98,29,81,110,461,323,784,0.000333,1.772195,42,223296.6126,12405.36737,5316.586015,654.409299,40,0
0,0,89,89,30,82,112,428,297,725,0.000333,1.645111,45,222089.9543,12338.3308,4935.332318,668.525982,39,0
0,0,37,37,19,38,57,199,144,343,0.000333,0.666894,27,54018.39442,3001.021912,2000.681275,280.131868,15,0
0,0,84,84,27,85,112,472,319,791,0.000333,1.794873,39,210000.092,11666.67178,5384.617743,673.180192,33,0
0,0,77,77,26,73,99,417,291,708,0.000333,1.564528,39,183049.795,10169.43306,4693.584487,574.068625,41,0
0,0,38,38,19,36,55,190,139,329,0.000333,0.634022,27,51355.81834,2853.101019,1902.067346,266.827923,14,0
0,0,43,43,20,39,59,227,163,390,0.000333,0.764744,40,91769.23157,5098.290643,2294.230789,292.569248,16,0
0,0,44,44,22,51,73,251,174,425,0.000333,0.876892,33,86812.28944,4822.904969,2630.675438,387.401188,19,0
0,0,74,74,26,69,95,393,267,660,0.000333,1.445368,39,169108.0834,9394.89352,4336.104701,543.69962,34,0
0,0,52,52,22,52,74,288,196,484,0.000333,1.001792,33,99177.38916,5509.854953,3005.375429,394.530361,24,0
0,0,40,40,20,37,57,207,149,356,0.000333,0.69217,40,83060.3538,4614.4641,2076.508845,279.188336,15,0
0,0,38,38,19,39,58,205,146,351,0.000333,0.685384,27,55516.08589,3084.226994,2056.151329,286.841309,15,0
0,0,40,40,22,49,71,230,160,390,0.000333,0.799467,33,79147.24543,4397.06919,2398.401377,373.228278,17,0
0,0,78,78,26,74,100,420,297,717,0.000333,1.587882,52,247709.5342,13761.64079,4763.644888,581.710982,40,0
0,0,85,85,29,75,104,424,290,714,0.000333,1.594705,42,200932.7863,11162.93257,4784.113959,608.042851,37,0
0,0,112,112,26,69,95,589,394,983,0.000333,2.152723,65,419780.9241,23321.16245,6458.168063,543.69962,52,0
0,0,86,86,29,77,106,429,294,723,0.000333,1.621429,42,204300.0325,11350.00181,4864.286489,623.424012,41,0
0,0,30,30,20,33,53,149,107,256,0.000333,0.488783,30,43990.42909,2443.912727,1466.347636,252.903568,11,0
0,0,35,35,19,38,57,190,140,330,0.000333,0.641618,27,51971.05003,2887.280557,1924.853705,280.131868,13,0
0,0,36,36,19,36,55,181,135,316,0.000333,0.60897,27,49326.56108,2740.364504,1826.909669,266.827923,12,0
0,0,41,41,20,39,59,218,159,377,0.000333,0.739252,40,88710.25718,4928.347621,2217.75643,292.569248,14,0
0,0,42,42,22,51,73,242,170,412,0.000333,0.850069,33,84156.8547,4675.380817,2550.207718,387.401188,17,0
0,0,50,50,22,52,74,279,192,471,0.000333,0.974884,33,96513.53366,5361.862981,2924.652535,394.530361,22,0
0,0,38,38,20,37,57,198,145,343,0.000333,0.666894,30,60020.43825,3334.468791,2000.681275,279.188336,13,0
0,0,36,36,19,39,58,196,142,338,0.000333,0.659999,27,53459.93456,2969.996365,1979.997576,286.841309,13,0
0,0,38,38,22,49,71,221,156,377,0.000333,0.772818,33,76509.00391,4250.500217,2318.454664,373.228278,15,0
0,0,76,76,26,74,100,411,293,704,0.000333,1.559092,39,182413.7155,10134.09531,4677.274758,581.710982,38,0
0,0,83,83,29,75,104,415,286,701,0.000333,1.565669,42,197274.3462,10959.6859,4697.008242,608.042851,35,0
0,0,110,110,26,69,95,580,390,970,0.000333,2.124253,65,414229.3961,23012.74423,6372.75994,543.69962,50,0
0,0,84,84,29,77,106,420,290,710,0.000333,1.592275,42,200626.588,11145.92155,4776.823523,623.424012,39,0
0,0,44,44,22,48,70,226,165,391,0.000333,0.79885,33,79086.13877,4393.674376,2396.54966,366.185696,17,0
0,0,77,77,26,74,100,420,300,720,0.000333,1.594525,52,248745.9757,13819.22088,4783.576457,581.710982,39,0
0,0,50,50,23,49,72,254,184,438,0.000333,0.900809,33,89180.09597,4954.449776,2702.427151,379.162707,18,0
0,0,54,54,24,60,84,280,203,483,0.000333,1.029163,36,111149.6153,6174.97863,3087.489315,464.452536,22,0
0,0,50,50,24,58,82,264,190,454,0.000333,0.96211,36,103907.83,5772.65722,2886.32861,449.801998,18,0
0,0,84,84,29,75,104,424,293,717,0.000333,1.601405,42,201777.0417,11209.83565,4804.215278,608.042851,36,0
0,0,111,111,26,69,95,589,397,986,0.000333,2.159293,65,421062.0459,23392.33589,6477.87763,543.69962,51,0
0,0,85,85,29,77,106,429,297,726,0.000333,1.628157,42,205147.7505,11397.09725,4884.47025,623.424012,40,0
0,0,62,62,24,61,85,317,225,542,0.000333,1.157963,36,125060.0359,6947.779775,3473.889887,471.814078,27,0
0,0,58,58,24,59,83,301,212,513,0.000333,1.090132,36,117734.2282,6540.790457,3270.395228,457.11504,23,0
0,0,47,47,23,47,70,234,170,404,0.000333,0.82541,33,81715.60118,4539.755621,2476.230339,365.107601,17,0
0,0,86,86,27,87,114,488,333,821,0.000333,1.869934,39,218782.3054,12154.57252,5609.802702,688.918047,32,0
0,0,50,50,24,58,82,259,189,448,0.000333,0.949394,36,102534.5987,5696.366596,2848.183298,449.801998,20,0
0,0,46,46,24,56,80,243,176,419,0.000333,0.882963,36,95359.96338,5297.775744,2648.887872,435.250976,16,0
0,0,98,98,29,81,110,461,323,784,0.000333,1.772195,42,223296.6126,12405.36737,5316.586015,654.409299,40,0
0,0,123,123,33,111,144,581,396,977,0.000333,2.335006,48,336240.8029,18680.0446,7005.016726,920.645167,49,0
0,0,98,98,29,81,110,461,323,784,0.000333,1.772195,42,223296.6126,12405.36737,5316.586015,654.409299,40,0
0,0,89,89,30,82,112,428,297,725,0.000333,1.645111,45,222089.9543,12338.3308,4935.332318,668.525982,39,0
0,0,37,37,19,38,57,199,144,343,0.000333,0.666894,27,54018.39442,3001.021912,2000.681275,280.131868,15,0
0,0,84,84,27,85,112,472,319,791,0.000333,1.794873,39,210000.092,11666.67178,5384.617743,673.180192,33,0
0,0,77,77,26,73,99,417,291,708,0.000333,1.564528,39,183049.795,10169.43306,4693.584487,574.068625,41,0
0,0,38,38,19,36,55,190,139,329,0.000333,0.634022,27,51355.81834,2853.101019,1902.067346,266.827923,14,0
0,0,43,43,20,39,59,227,163,390,0.000333,0.764744,40,91769.23157,5098.290643,2294.230789,292.569248,16,0
0,0,44,44,22,51,73,251,174,425,0.000333,0.876892,33,86812.28944,4822.904969,2630.675438,387.401188,19,0
0,0,74,74,26,69,95,393,267,660,0.000333,1.445368,39,169108.0834,9394.89352,4336.104701,543.69962,34,0
0,0,52,52,22,52,74,288,196,484,0.000333,1.001792,33,99177.38916,5509.854953,3005.375429,394.530361,24,0
0,0,40,40,20,37,57,207,149,356,0.000333,0.69217,40,83060.3538,4614.4641,2076.508845,279.188336,15,0
0,0,38,38,19,39,58,205,146,351,0.000333,0.685384,27,55516.08589,3084.226994,2056.151329,286.841309,15,0
0,0,40,40,22,49,71,230,160,390,0.000333,0.799467,33,79147.24543,4397.06919,2398.401377,373.228278,17,0
0,0,78,78,26,74,100,420,297,717,0.000333,1.587882,52,247709.5342,13761.64079,4763.644888,581.710982,40,0
0,0,85,85,29,75,104,424,290,714,0.000333,1.594705,42,200932.7863,11162.93257,4784.113959,608.042851,37,0
0,0,112,112,26,69,95,589,394,983,0.000333,2.152723,65,419780.9241,23321.16245,6458.168063,543.69962,52,0
0,0,86,86,29,77,106,429,294,723,0.000333,1.621429,42,204300.0325,11350.00181,4864.286489,623.424012,41,0
0,0,22,22,18,30,48,119,87,206,0.000333,0.383501,18,20709.04095,1150.502275,1150.502275,222.265368,9,0
0,0,27,27,17,35,52,160,120,280,0.000333,0.532041,24,38306.95491,2128.164161,1596.123121,249.011774,11,0
0,0,28,28,17,33,50,151,115,266,0.000333,0.500422,24,36030.37792,2001.687662,1501.265746,235.951874,10,0
0,0,33,33,18,37,55,188,139,327,0.000333,0.630168,27,51043.62491,2835.756939,1890.504626,267.808425,12,0
0,0,34,34,21,48,69,212,150,362,0.000333,0.737095,30,66338.5756,3685.476422,2211.285853,360.316866,15,0
0,0,42,42,21,49,70,249,172,421,0.000333,0.860143,30,77412.8445,4300.713584,2580.42815,367.359448,20,0
0,0,30,30,18,35,53,168,125,293,0.000333,0.559427,27,45313.57872,2517.42104,1678.280693,254.583556,11,0
0,0,28,28,17,36,53,166,122,288,0.000333,0.54988,24,39591.38618,2199.521455,1649.641091,255.604168,11,0
0,0,30,30,21,46,67,191,136,327,0.000333,0.661204,20,39672.22331,2204.012406,1983.611165,346.322516,13,0
0,0,68,68,24,72,96,381,273,654,0.000333,1.435522,36,155036.3571,8613.130951,4306.565475,554.2737,36,0
0,0,75,75,28,73,101,385,266,651,0.000333,1.444832,42,182048.8184,10113.82324,4334.495675,586.463131,33,0
0,0,102,102,25,67,92,550,370,920,0.000333,2.000559,60,360100.62,20005.59,6001.677,522.524381,48,0
0,0,76,76,28,75,103,390,270,660,0.000333,1.47103,42,185349.7946,10297.21081,4413.090348,601.76734,37,0
0,0,36,36,20,45,65,196,145,341,0.000333,0.684542,30,61608.82273,3422.712374,2053.627424,333.571951,15,0
0,0,69,69,24,72,96,390,280,670,0.000333,1.470642,36,158829.2955,8823.849751,4411.924875,554.2737,37,0
0,0,42,42,21,47,68,224,164,388,0.000333,0.787312,30,70858.06747,3936.559304,2361.935582,353.304342,16,0
0,0,46,46,23,57,80,250,183,433,0.000333,0.912465,33,90334.03055,5018.557253,2737.394865,436.516656,20,0
0,0,42,42,23,55,78,234,170,404,0.000333,0.846434,33,83796.98238,4655.38791,2539.302496,422.016709,16,0
0,0,76,76,28,73,101,394,273,667,0.000333,1.480342,42,186523.1365,10362.39647,4441.027059,586.463131,34,0
0,0,103,103,25,67,92,559,377,936,0.000333,2.035351,60,366363.2395,20353.5133,6106.053991,522.524381,49,0
0,0,77,77,28,75,103,399,277,676,0.000333,1.506691,42,189843.123,10546.84017,4520.074356,601.76734,38,0
0,0,54,54,23,58,81,287,205,492,0.000333,1.039735,33,102933.8046,5718.544703,3119.206201,443.804823,25,0
0,0,50,50,23,56,79,271,192,463,0.000333,0.972883,33,96315.46605,5350.859225,2918.650486,429.253801,21,0
0,0,39,39,21,45,66,204,150,354,0.000333,0.713239,30,64191.46555,3566.19253,2139.715518,339.372055,15,0
0,0,78,78,25,83,108,458,313,771,0.000333,1.736006,36,187488.6575,10416.03653,5208.018264,645.224678,30,0
0,0,42,42,23,55,78,229,169,398,0.000333,0.833863,33,82552.47274,4586.248486,2501.590083,422.016709,18,0
0,0,38,38,23,53,76,213,156,369,0.000333,0.768495,22,50720.67555,2817.815309,2305.485252,407.621709,14,0
0,0,88,88,22,74,96,606,352,958,0.000333,2.102798,44,277569.3393,15420.51885,6308.394076,557.607045,41,0
0,0,90,90,28,79,107,431,303,734,0.000333,1.649412,42,207825.9443,11545.88579,4948.236768,632.604617,38,0
0,0,113,113,28,73,101,581,394,975,0.000333,2.163919,70,454422.9337,25245.71854,6491.756196,586.463131,50,0
0,0,114,114,28,75,103,586,398,984,0.000333,2.193172,70,460566.1563,25587.00868,6579.516519,601.76734,54,0
0,0,115,115,32,108,140,551,376,927,0.000333,2.202948,48,317224.5771,17623.58762,6608.845357,889.52785,47,0
0,0,90,90,28,79,107,431,303,734,0.000333,1.649412,42,207825.9443,11545.88579,4948.236768,632.604617,38,0
0,0,113,113,28,73,101,581,394,975,0.000333,2.163919,70,454422.9337,25245.71854,6491.756196,586.463131,50,0
0,0,114,114,28,75,103,586,398,984,0.000333,2.193172,70,460566.1563,25587.00868,6579.516519,601.76734,54,0
0,0,81,81,29,80,109,398,277,675,0.000333,1.522841,42,191878.0256,10659.89031,4568.524419,646.635696,37,0
0,0,29,29,17,35,52,169,124,293,0.000333,0.556743,24,40085.4921,2226.971783,1670.228837,249.011774,13,0
0,0,76,76,25,81,106,442,299,741,0.000333,1.661796,36,179474.006,9970.778114,4985.389057,629.624255,31,0
0,0,69,69,24,71,95,387,271,658,0.000333,1.440988,36,155626.7397,8645.929981,4322.96499,546.671146,39,0
0,0,30,30,17,33,50,160,119,279,0.000333,0.524879,24,37791.26105,2099.514503,1574.635877,235.951874,12,0
0,0,35,35,18,37,55,197,143,340,0.000333,0.655221,27,53072.88217,2948.493454,1965.662303,267.808425,14,0
0,0,36,36,21,48,69,221,154,375,0.000333,0.763566,30,68720.90014,3817.827785,2290.696671,360.316866,17,0
0,0,66,66,25,67,92,363,247,610,0.000333,1.326458,36,143257.4206,7958.745586,3979.372793,522.524381,32,0
0,0,44,44,21,49,70,258,176,434,0.000333,0.886703,30,79803.26488,4433.514716,2660.108829,367.359448,22,0
0,0,32,32,18,35,53,177,129,306,0.000333,0.584248,27,47324.0788,2629.115489,1752.743659,254.583556,13,0
0,0,30,30,17,36,53,175,126,301,0.000333,0.574701,24,41378.49736,2298.805409,1724.104057,255.604168,13,0
0,0,32,32,21,46,67,200,140,340,0.000333,0.68749,30,61874.10974,3437.450541,2062.470325,346.322516,15,0
0,0,70,70,24,72,96,390,277,667,0.000333,1.464057,36,158118.1196,8784.339976,4392.169988,554.2737,38,0
0,0,77,77,28,73,101,394,270,664,0.000333,1.473684,42,185684.2018,10315.78899,4421.052425,586.463131,35,0
0,0,104,104,25,67,92,559,374,933,0.000333,2.028828,60,365188.9983,20288.27768,6086.483305,522.524381,50,0
0,0,78,78,28,75,103,399,274,673,0.000333,1.500005,42,189000.6239,10500.03466,4500.014855,601.76734,39,0
0,0,22,22,18,30,48,119,87,206,0.000333,0.383501,18,20709.04095,1150.502275,1150.502275,222.265368,9,0
0,0,27,27,17,35,52,160,120,280,0.000333,0.532041,24,38306.95491,2128.164161,1596.123121,249.011774,11,0
0,0,28,28,17,33,50,151,115,266,0.000333,0.500422,24,36030.37792,2001.687662,1501.265746,235.951874,10,0
0,0,33,33,18,37,55,188,139,327,0.000333,0.630168,27,51043.62491,2835.756939,1890.504626,267.808425,12,0
0,0,34,34,21,48,69,212,150,362,0.000333,0.737095,30,66338.5756,3685.476422,2211.285853,360.316866,15,0
0,0,42,42,21,49,70,249,172,421,0.000333,0.860143,30,77412.8445,4300.713584,2580.42815,367.359448,20,0
0,0,30,30,18,35,53,168,125,293,0.000333,0.559427,27,45313.57872,2517.42104,1678.280693,254.583556,11,0
0,0,28,28,17,36,53,166,122,288,0.000333,0.54988,24,39591.38618,2199.521455,1649.641091,255.604168,11,0
0,0,30,30,21,46,67,191,136,327,0.000333,0.661204,20,39672.22331,2204.012406,1983.611165,346.322516,13,0
0,0,68,68,24,72,96,381,273,654,0.000333,1.435522,36,155036.3571,8613.130951,4306.565475,554.2737,36,0
0,0,75,75,28,73,101,385,266,651,0.000333,1.444832,42,182048.8184,10113.82324,4334.495675,586.463131,33,0
0,0,102,102,25,67,92,550,370,920,0.000333,2.000559,60,360100.62,20005.59,6001.677,522.524381,48,0
0,0,76,76,28,75,103,390,270,660,0.000333,1.47103,42,185349.7946,10297.21081,4413.090348,601.76734,37,0
0,0,36,36,20,45,65,196,145,341,0.000333,0.684542,30,61608.82273,3422.712374,2053.627424,333.571951,15,0
0,0,69,69,24,72,96,390,280,670,0.000333,1.470642,36,158829.2955,8823.849751,4411.924875,554.2737,37,0
0,0,42,42,21,47,68,224,164,388,0.000333,0.787312,30,70858.06747,3936.559304,2361.935582,353.304342,16,0
0,0,46,46,23,57,80,250,183,433,0.000333,0.912465,33,90334.03055,5018.557253,2737.394865,436.516656,20,0
0,0,42,42,23,55,78,234,170,404,0.000333,0.846434,33,83796.98238,4655.38791,2539.302496,422.016709,16,0
0,0,76,76,28,73,101,394,273,667,0.000333,1.480342,42,186523.1365,10362.39647,4441.027059,586.463131,34,0
0,0,103,103,25,67,92,559,377,936,0.000333,2.035351,60,366363.2395,20353.5133,6106.053991,522.524381,49,0
0,0,77,77,28,75,103,399,277,676,0.000333,1.506691,42,189843.123,10546.84017,4520.074356,601.76734,38,0
0,0,54,54,23,58,81,287,205,492,0.000333,1.039735,33,102933.8046,5718.544703,3119.206201,443.804823,25,0
0,0,50,50,23,56,79,271,192,463,0.000333,0.972883,33,96315.46605,5350.859225,2918.650486,429.253801,21,0
0,0,39,39,21,45,66,204,150,354,0.000333,0.713239,30,64191.46555,3566.19253,2139.715518,339.372055,15,0
0,0,78,78,25,83,108,458,313,771,0.000333,1.736006,36,187488.6575,10416.03653,5208.018264,645.224678,30,0
0,0,42,42,23,55,78,229,169,398,0.000333,0.833863,33,82552.47274,4586.248486,2501.590083,422.016709,18,0
0,0,38,38,23,53,76,213,156,369,0.000333,0.768495,22,50720.67555,2817.815309,2305.485252,407.621709,14,0
0,0,88,88,22,74,96,606,352,958,0.000333,2.102798,44,277569.3393,15420.51885,6308.394076,557.607045,41,0
0,0,90,90,28,79,107,431,303,734,0.000333,1.649412,42,207825.9443,11545.88579,4948.236768,632.604617,38,0
0,0,113,113,28,73,101,581,394,975,0.000333,2.163919,70,454422.9337,25245.71854,6491.756196,586.463131,50,0
0,0,114,114,28,75,103,586,398,984,0.000333,2.193172,70,460566.1563,25587.00868,6579.516519,601.76734,54,0
0,0,115,115,32,108,140,551,376,927,0.000333,2.202948,48,317224.5771,17623.58762,6608.845357,889.52785,47,0
0,0,90,90,28,79,107,431,303,734,0.000333,1.649412,42,207825.9443,11545.88579,4948.236768,632.604617,38,0
0,0,113,113,28,73,101,581,394,975,0.000333,2.163919,70,454422.9337,25245.71854,6491.756196,586.463131,50,0
0,0,114,114,28,75,103,586,398,984,0.000333,2.193172,70,460566.1563,25587.00868,6579.516519,601.76734,54,0
0,0,81,81,29,80,109,398,277,675,0.000333,1.522841,42,191878.0256,10659.89031,4568.524419,646.635696,37,0
0,0,29,29,17,35,52,169,124,293,0.000333,0.556743,24,40085.4921,2226.971783,1670.228837,249.011774,13,0
0,0,76,76,25,81,106,442,299,741,0.000333,1.661796,36,179474.006,9970.778114,4985.389057,629.624255,31,0
0,0,69,69,24,71,95,387,271,658,0.000333,1.440988,36,155626.7397,8645.929981,4322.96499,546.671146,39,0
0,0,30,30,17,33,50,160,119,279,0.000333,0.524879,24,37791.26105,2099.514503,1574.635877,235.951874,12,0
0,0,35,35,18,37,55,197,143,340,0.000333,0.655221,27,53072.88217,2948.493454,1965.662303,267.808425,14,0
0,0,36,36,21,48,69,221,154,375,0.000333,0.763566,30,68720.90014,3817.827785,2290.696671,360.316866,17,0
0,0,66,66,25,67,92,363,247,610,0.000333,1.326458,36,143257.4206,7958.745586,3979.372793,522.524381,32,0
0,0,44,44,21,49,70,258,176,434,0.000333,0.886703,30,79803.26488,4433.514716,2660.108829,367.359448,22,0
0,0,32,32,18,35,53,177,129,306,0.000333,0.584248,27,47324.0788,2629.115489,1752.743659,254.583556,13,0
0,0,30,30,17,36,53,175,126,301,0.000333,0.574701,24,41378.49736,2298.805409,1724.104057,255.604168,13,0
0,0,32,32,21,46,67,200,140,340,0.000333,0.68749,30,61874.10974,3437.450541,2062.470325,346.322516,15,0
0,0,70,70,24,72,96,390,277,667,0.000333,1.464057,36,158118.1196,8784.339976,4392.169988,554.2737,38,0
0,0,77,77,28,73,101,394,270,664,0.000333,1.473684,42,185684.2018,10315.78899,4421.052425,586.463131,35,0
0,0,104,104,25,67,92,559,374,933,0.000333,2.028828,60,365188.9983,20288.27768,6086.483305,522.524381,50,0
0,0,78,78,28,75,103,399,274,673,0.000333,1.500005,42,189000.6239,10500.03466,4500.014855,601.76734,39,0
0,0,22,22,18,30,48,119,87,206,0.000333,0.383501,18,20709.04095,1150.502275,1150.502275,222.265368,9,0
0,0,27,27,17,35,52,160,120,280,0.000333,0.532041,24,38306.95491,2128.164161,1596.123121,249.011774,11,0
0,0,28,28,17,33,50,151,115,266,0.000333,0.500422,24,36030.37792,2001.687662,1501.265746,235.951874,10,0
0,0,33,33,18,37,55,188,139,327,0.000333,0.630168,27,51043.62491,2835.756939,1890.504626,267.808425,12,0
0,0,34,34,21,48,69,212,150,362,0.000333,0.737095,30,66338.5756,3685.476422,2211.285853,360.316866,15,0
0,0,42,42,21,49,70,249,172,421,0.000333,0.860143,30,77412.8445,4300.713584,2580.42815,367.359448,20,0
0,0,30,30,18,35,53,168,125,293,0.000333,0.559427,27,45313.57872,2517.42104,1678.280693,254.583556,11,0
0,0,28,28,17,36,53,166,122,288,0.000333,0.54988,24,39591.38618,2199.521455,1649.641091,255.604168,11,0
0,0,30,30,21,46,67,191,136,327,0.000333,0.661204,20,39672.22331,2204.012406,1983.611165,346.322516,13,0
0,0,68,68,24,72,96,381,273,654,0.000333,1.435522,36,155036.3571,8613.130951,4306.565475,554.2737,36,0
0,0,75,75,28,73,101,385,266,651,0.000333,1.444832,42,182048.8184,10113.82324,4334.495675,586.463131,33,0
0,0,102,102,25,67,92,550,370,920,0.000333,2.000559,60,360100.62,20005.59,6001.677,522.524381,48,0
0,0,76,76,28,75,103,390,270,660,0.000333,1.47103,42,185349.7946,10297.21081,4413.090348,601.76734,37,0
0,0,36,36,20,45,65,196,145,341,0.000333,0.684542,30,61608.82273,3422.712374,2053.627424,333.571951,15,0
0,0,69,69,24,72,96,390,280,670,0.000333,1.470642,36,158829.2955,8823.849751,4411.924875,554.2737,37,0
0,0,42,42,21,47,68,224,164,388,0.000333,0.787312,30,70858.06747,3936.559304,2361.935582,353.304342,16,0
0,0,46,46,23,57,80,250,183,433,0.000333,0.912465,33,90334.03055,5018.557253,2737.394865,436.516656,20,0
0,0,42,42,23,55,78,234,170,404,0.000333,0.846434,33,83796.98238,4655.38791,2539.302496,422.016709,16,0
0,0,76,76,28,73,101,394,273,667,0.000333,1.480342,42,186523.1365,10362.39647,4441.027059,586.463131,34,0
0,0,103,103,25,67,92,559,377,936,0.000333,2.035351,60,366363.2395,20353.5133,6106.053991,522.524381,49,0
0,0,77,77,28,75,103,399,277,676,0.000333,1.506691,42,189843.123,10546.84017,4520.074356,601.76734,38,0
0,0,54,54,23,58,81,287,205,492,0.000333,1.039735,33,102933.8046,5718.544703,3119.206201,443.804823,25,0
0,0,50,50,23,56,79,271,192,463,0.000333,0.972883,33,96315.46605,5350.859225,2918.650486,429.253801,21,0
0,0,39,39,21,45,66,204,150,354,0.000333,0.713239,30,64191.46555,3566.19253,2139.715518,339.372055,15,0
0,0,78,78,25,83,108,458,313,771,0.000333,1.736006,36,187488.6575,10416.03653,5208.018264,645.224678,30,0
0,0,42,42,23,55,78,229,169,398,0.000333,0.833863,33,82552.47274,4586.248486,2501.590083,422.016709,18,0
0,0,38,38,23,53,76,213,156,369,0.000333,0.768495,22,50720.67555,2817.815309,2305.485252,407.621709,14,0
0,0,88,88,22,74,96,606,352,958,0.000333,2.102798,44,277569.3393,15420.51885,6308.394076,557.607045,41,0
0,0,90,90,28,79,107,431,303,734,0.000333,1.649412,42,207825.9443,11545.88579,4948.236768,632.604617,38,0
0,0,113,113,28,73,101,581,394,975,0.000333,2.163919,70,454422.9337,25245.71854,6491.756196,586.463131,50,0
0,0,114,114,28,75,103,586,398,984,0.000333,2.193172,70,460566.1563,25587.00868,6579.516519,601.76734,54,0
0,0,115,115,32,108,140,551,376,927,0.000333,2.202948,48,317224.5771,17623.58762,6608.845357,889.52785,47,0
0,0,90,90,28,79,107,431,303,734,0.000333,1.649412,42,207825.9443,11545.88579,4948.236768,632.604617,38,0
0,0,113,113,28,73,101,581,394,975,0.000333,2.163919,70,454422.9337,25245.71854,6491.756196,586.463131,50,0
0,0,114,114,28,75,103,586,398,984,0.000333,2.193172,70,460566.1563,25587.00868,6579.516519,601.76734,54,0
0,0,81,81,29,80,109,398,277,675,0.000333,1.522841,42,191878.0256,10659.89031,4568.524419,646.635696,37,0
0,0,29,29,17,35,52,169,124,293,0.000333,0.556743,24,40085.4921,2226.971783,1670.228837,249.011774,13,0
0,0,76,76,25,81,106,442,299,741,0.000333,1.661796,36,179474.006,9970.778114,4985.389057,629.624255,31,0
0,0,69,69,24,71,95,387,271,658,0.000333,1.440988,36,155626.7397,8645.929981,4322.96499,546.671146,39,0
0,0,30,30,17,33,50,160,119,279,0.000333,0.524879,24,37791.26105,2099.514503,1574.635877,235.951874,12,0
0,0,35,35,18,37,55,197,143,340,0.000333,0.655221,27,53072.88217,2948.493454,1965.662303,267.808425,14,0
0,0,36,36,21,48,69,221,154,375,0.000333,0.763566,30,68720.90014,3817.827785,2290.696671,360.316866,17,0
0,0,66,66,25,67,92,363,247,610,0.000333,1.326458,36,143257.4206,7958.745586,3979.372793,522.524381,32,0
0,0,44,44,21,49,70,258,176,434,0.000333,0.886703,30,79803.26488,4433.514716,2660.108829,367.359448,22,0
0,0,32,32,18,35,53,177,129,306,0.000333,0.584248,27,47324.0788,2629.115489,1752.743659,254.583556,13,0
0,0,30,30,17,36,53,175,126,301,0.000333,0.574701,24,41378.49736,2298.805409,1724.104057,255.604168,13,0
0,0,32,32,21,46,67,200,140,340,0.000333,0.68749,30,61874.10974,3437.450541,2062.470325,346.322516,15,0
0,0,70,70,24,72,96,390,277,667,0.000333,1.464057,36,158118.1196,8784.339976,4392.169988,554.2737,38,0
0,0,77,77,28,73,101,394,270,664,0.000333,1.473684,42,185684.2018,10315.78899,4421.052425,586.463131,35,0
0,0,104,104,25,67,92,559,374,933,0.000333,2.028828,60,365188.9983,20288.27768,6086.483305,522.524381,50,0
0,0,78,78,28,75,103,399,274,673,0.000333,1.500005,42,189000.6239,10500.03466,4500.014855,601.76734,39,0
0,0,22,22,17,26,43,107,82,189,0.000333,0.341855,24,24613.53693,1367.418718,1025.564039,191.698301,6,0
0,0,27,27,17,31,48,148,115,263,0.000333,0.489615,24,35252.28331,1958.460184,1468.845138,223.066954,8,0
0,0,28,28,17,29,46,139,110,249,0.000333,0.458456,24,33008.80625,1833.822569,1375.366927,210.368317,7,0
0,0,33,33,18,33,51,176,134,310,0.000333,0.586151,36,63304.26682,3516.903712,1758.451856,241.523656,9,0
0,0,34,34,21,45,66,200,145,345,0.000333,0.695105,30,62559.47914,3475.526619,2085.315971,339.372055,12,0
0,0,42,42,21,46,67,237,167,404,0.000333,0.8169,30,73521.00099,4084.500055,2450.700033,346.322516,17,0
0,0,30,30,18,31,49,156,120,276,0.000333,0.516553,27,41840.81776,2324.489875,1549.659917,228.638736,8,0
0,0,28,28,17,32,49,154,117,271,0.000333,0.507195,24,36518.07283,2028.781824,1521.586368,229.486868,8,0
0,0,30,30,21,43,64,179,131,310,0.000333,0.62,30,55800,3100,1860,325.56805,10,0
0,0,108,108,24,67,91,586,413,999,0.000333,2.167096,72,468092.6529,26005.14738,6501.286846,516.467076,59,0
0,0,68,68,24,68,92,369,268,637,0.000333,1.38517,36,149598.3228,8311.017932,4155.508966,523.986573,33,0
0,0,75,75,28,69,97,373,261,634,0.000333,1.394782,42,175742.4792,9763.471065,4184.344742,556.094125,30,0
0,0,102,102,25,63,88,538,365,903,0.000333,1.944289,60,349972.0051,19442.88917,5832.866752,492.66504,45,0
0,0,76,76,28,71,99,378,265,643,0.000333,1.420892,42,179032.4049,9946.244716,4262.676307,571.237983,34,0
0,0,36,36,20,42,62,184,140,324,0.000333,0.643053,30,57874.78814,3215.266008,1929.159605,312.915894,12,0
0,0,69,69,24,68,92,378,275,653,0.000333,1.419962,48,204474.526,11359.69589,4259.885957,523.986573,34,0
0,0,42,42,21,44,65,212,159,371,0.000333,0.744766,30,67028.95376,3723.830764,2234.298459,332.453657,13,0
0,0,46,46,23,54,77,238,178,416,0.000333,0.868994,33,86030.44563,4779.469202,2606.983201,414.80585,17,0
0,0,42,42,23,52,75,222,165,387,0.000333,0.803518,33,79548.2435,4419.346861,2410.552833,400.46479,13,0
0,0,76,76,28,69,97,382,268,650,0.000333,1.429981,42,180177.6206,10009.86781,4289.943347,556.094125,31,0
0,0,103,103,25,63,88,547,372,919,0.000333,1.978739,60,356173.0595,19787.39219,5936.217658,492.66504,46,0
0,0,77,77,28,71,99,387,272,659,0.000333,1.456249,42,183487.3325,10193.7407,4368.746013,571.237983,35,0
0,0,54,54,23,55,78,275,200,475,0.000333,0.995189,33,98523.67978,5473.537766,2985.566054,422.016709,22,0
0,0,50,50,23,53,76,259,187,446,0.000333,0.928859,33,91956.99714,5108.722063,2786.575671,407.621709,18,0
0,0,39,39,21,42,63,192,145,337,0.000333,0.671448,30,60430.30003,3357.23889,2014.343334,318.715998,12,0
0,0,78,78,25,82,107,446,308,754,0.000333,1.694355,36,182990.3799,10166.13222,5083.066108,637.415669,27,0
0,0,42,42,23,52,75,217,164,381,0.000333,0.79106,33,78314.9374,4350.829855,2373.179921,400.46479,15,0
0,0,38,38,23,50,73,201,151,352,0.000333,0.726273,33,71901.00208,3994.500115,2178.818245,386.234734,11,0
0,0,88,88,22,71,93,594,347,941,0.000333,2.051116,44,270747.3314,15041.51841,6153.348441,534.739541,38,0
0,0,90,90,28,75,103,419,298,717,0.000333,1.598074,42,201357.2769,11186.51538,4794.220878,601.76734,35,0
0,0,113,113,28,69,97,569,389,958,0.000333,2.107572,70,442590.1552,24588.34196,6322.716503,556.094125,47,0
0,0,114,114,28,71,99,574,393,967,0.000333,2.136863,70,448741.1496,24930.06387,6410.587852,571.237983,51,0
0,0,115,115,32,105,137,539,371,910,0.000333,2.15307,48,310042.0414,17224.55786,6459.209195,864.995779,44,0
0,0,90,90,28,75,103,419,298,717,0.000333,1.598074,42,201357.2769,11186.51538,4794.220878,601.76734,35,0
0,0,113,113,28,69,97,569,389,958,0.000333,2.107572,70,442590.1552,24588.34196,6322.716503,556.094125,47,0
0,0,114,114,28,71,99,574,393,967,0.000333,2.136863,70,448741.1496,24930.06387,6410.587852,571.237983,51,0
0,0,81,81,29,76,105,386,272,658,0.000333,1.472658,42,185554.8891,10308.60495,4417.973551,615.72394,34,0
0,0,29,29,17,31,48,157,119,276,0.000333,0.513817,24,36994.79161,2055.2662,1541.44965,223.066954,10,0
0,0,76,76,25,80,105,430,294,724,0.000333,1.620371,36,175000.0952,9722.22751,4861.113755,621.850652,28,0
0,0,69,69,24,67,91,375,266,641,0.000333,1.390499,36,150173.8691,8342.992729,4171.496364,516.467076,36,0
0,0,30,30,17,29,46,148,114,262,0.000333,0.482391,24,34732.15758,1929.56431,1447.173232,210.368317,9,0
0,0,35,35,18,33,51,185,138,323,0.000333,0.610731,36,65958.96188,3664.386771,1832.193385,241.523656,11,0
0,0,36,36,21,45,66,209,149,358,0.000333,0.721298,30,64916.79284,3606.488491,2163.893095,339.372055,14,0
0,0,66,66,25,63,88,351,242,593,0.000333,1.276814,36,137895.9462,7660.8859,3830.44295,492.66504,29,0
0,0,44,44,21,46,67,246,171,417,0.000333,0.843186,30,75886.77577,4215.931987,2529.559192,346.322516,19,0
0,0,32,32,18,31,49,165,124,289,0.000333,0.540884,36,58415.44122,3245.30229,1622.651145,228.638736,10,0
0,0,30,30,17,32,49,163,121,284,0.000333,0.531526,24,38269.8623,2126.103461,1594.577596,229.486868,10,0
0,0,32,32,21,43,64,188,135,323,0.000333,0.646,30,58140,3230,1938,325.56805,12,0
0,0,70,70,24,68,92,378,272,650,0.000333,1.413438,48,203535.133,11307.50739,4240.315271,523.986573,35,0
0,0,77,77,28,69,97,382,265,647,0.000333,1.423381,42,179346.0316,9963.668421,4270.143609,556.094125,32,0
0,0,104,104,25,63,88,547,369,916,0.000333,1.97228,60,355010.3618,19722.79788,5916.839363,492.66504,47,0
0,0,78,78,28,71,99,387,269,656,0.000333,1.449619,42,182652.0336,10147.3352,4348.857943,571.237983,36,0
0,0,22,22,17,26,43,107,82,189,0.000333,0.341855,24,24613.53693,1367.418718,1025.564039,191.698301,6,0
0,0,27,27,17,31,48,148,115,263,0.000333,0.489615,24,35252.28331,1958.460184,1468.845138,223.066954,8,0
0,0,28,28,17,29,46,139,110,249,0.000333,0.458456,24,33008.80625,1833.822569,1375.366927,210.368317,7,0
0,0,33,33,18,33,51,176,134,310,0.000333,0.586151,36,63304.26682,3516.903712,1758.451856,241.523656,9,0
0,0,34,34,21,45,66,200,145,345,0.000333,0.695105,30,62559.47914,3475.526619,2085.315971,339.372055,12,0
0,0,42,42,21,46,67,237,167,404,0.000333,0.8169,30,73521.00099,4084.500055,2450.700033,346.322516,17,0
0,0,30,30,18,31,49,156,120,276,0.000333,0.516553,27,41840.81776,2324.489875,1549.659917,228.638736,8,0
0,0,28,28,17,32,49,154,117,271,0.000333,0.507195,24,36518.07283,2028.781824,1521.586368,229.486868,8,0
0,0,30,30,21,43,64,179,131,310,0.000333,0.62,30,55800,3100,1860,325.56805,10,0
0,0,108,108,24,67,91,586,413,999,0.000333,2.167096,72,468092.6529,26005.14738,6501.286846,516.467076,59,0
0,0,68,68,24,68,92,369,268,637,0.000333,1.38517,36,149598.3228,8311.017932,4155.508966,523.986573,33,0
0,0,75,75,28,69,97,373,261,634,0.000333,1.394782,42,175742.4792,9763.471065,4184.344742,556.094125,30,0
0,0,102,102,25,63,88,538,365,903,0.000333,1.944289,60,349972.0051,19442.88917,5832.866752,492.66504,45,0
0,0,76,76,28,71,99,378,265,643,0.000333,1.420892,42,179032.4049,9946.244716,4262.676307,571.237983,34,0
0,0,36,36,20,42,62,184,140,324,0.000333,0.643053,30,57874.78814,3215.266008,1929.159605,312.915894,12,0
0,0,69,69,24,68,92,378,275,653,0.000333,1.419962,48,204474.526,11359.69589,4259.885957,523.986573,34,0
0,0,42,42,21,44,65,212,159,371,0.000333,0.744766,30,67028.95376,3723.830764,2234.298459,332.453657,13,0
0,0,46,46,23,54,77,238,178,416,0.000333,0.868994,33,86030.44563,4779.469202,2606.983201,414.80585,17,0
0,0,42,42,23,52,75,222,165,387,0.000333,0.803518,33,79548.2435,4419.346861,2410.552833,400.46479,13,0
0,0,76,76,28,69,97,382,268,650,0.000333,1.429981,42,180177.6206,10009.86781,4289.943347,556.094125,31,0
0,0,103,103,25,63,88,547,372,919,0.000333,1.978739,60,356173.0595,19787.39219,5936.217658,492.66504,46,0
0,0,77,77,28,71,99,387,272,659,0.000333,1.456249,42,183487.3325,10193.7407,4368.746013,571.237983,35,0
0,0,54,54,23,55,78,275,200,475,0.000333,0.995189,33,98523.67978,5473.537766,2985.566054,422.016709,22,0
0,0,50,50,23,53,76,259,187,446,0.000333,0.928859,33,91956.99714,5108.722063,2786.575671,407.621709,18,0
0,0,39,39,21,42,63,192,145,337,0.000333,0.671448,30,60430.30003,3357.23889,2014.343334,318.715998,12,0
0,0,78,78,25,82,107,446,308,754,0.000333,1.694355,36,182990.3799,10166.13222,5083.066108,637.415669,27,0
0,0,42,42,23,52,75,217,164,381,0.000333,0.79106,33,78314.9374,4350.829855,2373.179921,400.46479,15,0
0,0,38,38,23,50,73,201,151,352,0.000333,0.726273,33,71901.00208,3994.500115,2178.818245,386.234734,11,0
0,0,88,88,22,71,93,594,347,941,0.000333,2.051116,44,270747.3314,15041.51841,6153.348441,534.739541,38,0
0,0,90,90,28,75,103,419,298,717,0.000333,1.598074,42,201357.2769,11186.51538,4794.220878,601.76734,35,0
0,0,113,113,28,69,97,569,389,958,0.000333,2.107572,70,442590.1552,24588.34196,6322.716503,556.094125,47,0
0,0,114,114,28,71,99,574,393,967,0.000333,2.136863,70,448741.1496,24930.06387,6410.587852,571.237983,51,0
0,0,115,115,32,105,137,539,371,910,0.000333,2.15307,48,310042.0414,17224.55786,6459.209195,864.995779,44,0
0,0,90,90,28,75,103,419,298,717,0.000333,1.598074,42,201357.2769,11186.51538,4794.220878,601.76734,35,0
0,0,113,113,28,69,97,569,389,958,0.000333,2.107572,70,442590.1552,24588.34196,6322.716503,556.094125,47,0
0,0,114,114,28,71,99,574,393,967,0.000333,2.136863,70,448741.1496,24930.06387,6410.587852,571.237983,51,0
0,0,81,81,29,76,105,386,272,658,0.000333,1.472658,42,185554.8891,10308.60495,4417.973551,615.72394,34,0
0,0,29,29,17,31,48,157,119,276,0.000333,0.513817,24,36994.79161,2055.2662,1541.44965,223.066954,10,0
0,0,76,76,25,80,105,430,294,724,0.000333,1.620371,36,175000.0952,9722.22751,4861.113755,621.850652,28,0
0,0,69,69,24,67,91,375,266,641,0.000333,1.390499,36,150173.8691,8342.992729,4171.496364,516.467076,36,0
0,0,30,30,17,29,46,148,114,262,0.000333,0.482391,24,34732.15758,1929.56431,1447.173232,210.368317,9,0
0,0,35,35,18,33,51,185,138,323,0.000333,0.610731,36,65958.96188,3664.386771,1832.193385,241.523656,11,0
0,0,36,36,21,45,66,209,149,358,0.000333,0.721298,30,64916.79284,3606.488491,2163.893095,339.372055,14,0
0,0,66,66,25,63,88,351,242,593,0.000333,1.276814,36,137895.9462,7660.8859,3830.44295,492.66504,29,0
0,0,44,44,21,46,67,246,171,417,0.000333,0.843186,30,75886.77577,4215.931987,2529.559192,346.322516,19,0
0,0,32,32,18,31,49,165,124,289,0.000333,0.540884,36,58415.44122,3245.30229,1622.651145,228.638736,10,0
0,0,30,30,17,32,49,163,121,284,0.000333,0.531526,24,38269.8623,2126.103461,1594.577596,229.486868,10,0
0,0,32,32,21,43,64,188,135,323,0.000333,0.646,30,58140,3230,1938,325.56805,12,0
0,0,70,70,24,68,92,378,272,650,0.000333,1.413438,48,203535.133,11307.50739,4240.315271,523.986573,35,0
0,0,77,77,28,69,97,382,265,647,0.000333,1.423381,42,179346.0316,9963.668421,4270.143609,556.094125,32,0
0,0,104,104,25,63,88,547,369,916,0.000333,1.97228,60,355010.3618,19722.79788,5916.839363,492.66504,47,0
0,0,78,78,28,71,99,387,269,656,0.000333,1.449619,42,182652.0336,10147.3352,4348.857943,571.237983,36,0
0,0,19,19,13,23,36,70,55,125,0.000333,0.215414,12,7754.887502,430.827083,646.240625,152.147641,5,0
0,0,24,24,15,29,44,111,88,199,0.000333,0.362142,21,22814.96473,1267.498041,1086.426892,199.484808,7,0
0,0,25,25,14,27,41,102,83,185,0.000333,0.330382,21,20814.08954,1156.338308,991.147121,181.684931,6,0
0,0,30,30,16,32,48,139,107,246,0.000333,0.457967,24,32973.6186,1831.8677,1373.900775,224,8,0
0,0,31,31,19,42,61,163,118,281,0.000333,0.555512,18,29997.66945,1666.537192,1666.537192,307.187955,11,0
0,0,39,39,19,43,62,200,140,340,0.000333,0.674809,27,54659.52213,3036.640118,2024.426746,314.040007,16,0
0,0,27,27,15,30,45,119,93,212,0.000333,0.388091,21,24449.72999,1358.318332,1164.272856,205.810077,7,0
0,0,25,25,14,30,44,117,90,207,0.000333,0.376701,21,23732.14925,1318.452736,1130.102345,200.509687,7,0
0,0,27,27,18,40,58,142,104,246,0.000333,0.480354,18,25939.13985,1441.063325,1441.063325,287.935774,9,0
0,0,105,105,23,65,88,549,386,935,0.000333,2.01319,55,332176.271,18454.23728,6039.568563,495.495833,58,0
0,0,65,65,23,66,89,332,241,573,0.000333,1.236865,33,122449.6434,6802.757969,3710.595256,502.971937,32,0
0,0,72,72,27,67,94,336,234,570,0.000333,1.245372,39,145708.5102,8094.917232,3736.115645,534.809938,29,0
0,0,99,99,24,61,85,501,338,839,0.000333,1.792493,60,322648.7397,17924.92999,5377.478995,471.814078,44,0
0,0,73,73,27,69,96,341,238,579,0.000333,1.270898,39,148695.0382,8260.835457,3812.693288,549.87015,33,0
0,0,33,33,18,39,57,147,113,260,0.000333,0.505517,18,27297.92527,1516.551404,1516.551404,281.189337,11,0
0,0,106,106,23,65,88,558,393,951,0.000333,2.04764,66,405432.685,22524.03805,6142.919469,495.495833,59,0
0,0,66,66,23,66,89,341,248,589,0.000333,1.271402,33,125868.8307,6992.712817,3814.206991,502.971937,33,0
0,0,39,39,19,42,61,175,132,307,0.000333,0.606912,27,49159.88179,2731.104544,1820.736363,307.187955,12,0
0,0,43,43,21,51,72,201,151,352,0.000333,0.723938,20,43436.27201,2413.126223,2171.813601,381.532358,16,0
0,0,39,39,21,49,70,185,138,323,0.000333,0.659919,20,39595.16829,2199.731572,1979.758414,367.359448,12,0
0,0,73,73,27,67,94,345,241,586,0.000333,1.28033,39,149798.5736,8322.142979,3840.989067,534.809938,30,0
0,0,100,100,24,61,85,510,345,855,0.000333,1.826676,60,328801.755,18266.76417,5480.02925,471.814078,45,0
0,0,74,74,27,69,96,350,245,595,0.000333,1.306018,39,152804.0548,8489.114157,3918.052688,549.87015,34,0
0,0,51,51,21,52,73,238,173,411,0.000333,0.848006,30,76320.53681,4240.029823,2544.017894,388.661531,21,0
0,0,47,47,21,50,71,222,160,382,0.000333,0.783068,30,70476.10199,3915.338999,2349.2034,374.431475,17,0
0,0,36,36,18,40,58,155,118,273,0.000333,0.533076,18,28786.11861,1599.228812,1599.228812,287.935774,11,0
0,0,75,75,25,79,104,409,281,690,0.000333,1.541101,36,166438.9226,9246.606811,4623.303406,614.095084,26,0
0,0,39,39,20,49,69,180,137,317,0.000333,0.645467,20,38728.04506,2151.558059,1936.402253,361.559344,14,0
0,0,35,35,20,47,67,164,124,288,0.000333,0.582345,20,34940.67374,1941.148541,1747.033687,347.504238,10,0
0,0,85,85,21,69,90,557,320,877,0.000333,1.897785,40,227734.2066,12651.90037,5693.355165,513.726853,37,0
0,0,87,87,27,73,100,382,271,653,0.000333,1.446146,39,169199.0856,9399.949199,4338.438092,580.239155,34,0
0,0,110,110,27,67,94,532,362,894,0.000333,1.953267,65,380887.1582,21160.39768,5859.802433,534.809938,46,0
0,0,111,111,27,69,96,537,366,903,0.000333,1.982074,65,386504.374,21472.46522,5946.221138,549.87015,50,0
0,0,112,112,32,102,134,502,344,846,0.000333,1.992637,48,286939.7498,15941.09721,5977.911455,840.587385,43,0
0,0,87,87,27,73,100,382,271,653,0.000333,1.446146,39,169199.0856,9399.949199,4338.438092,580.239155,34,0
0,0,110,110,27,67,94,532,362,894,0.000333,1.953267,65,380887.1582,21160.39768,5859.802433,534.809938,46,0
0,0,111,111,27,69,96,537,366,903,0.000333,1.982074,65,386504.374,21472.46522,5946.221138,549.87015,50,0
0,0,78,78,28,74,102,349,245,594,0.000333,1.32114,42,166463.6674,9247.981524,3963.420653,594.105487,33,0
0,0,26,26,15,29,44,120,92,212,0.000333,0.3858,21,24305.38957,1350.29942,1157.399503,199.484808,9,0
0,0,73,73,25,77,102,393,267,660,0.000333,1.467934,36,158536.8261,8807.601451,4403.800726,598.638968,27,0
0,0,66,66,23,65,88,338,239,577,0.000333,1.242364,33,122994.0375,6833.002081,3727.092044,495.495833,35,0
0,0,27,27,14,27,41,111,87,198,0.000333,0.353598,21,22276.70124,1237.594513,1060.795297,181.684931,8,0
0,0,32,32,16,32,48,148,111,259,0.000333,0.482168,24,34716.1269,1928.673717,1446.505288,224,10,0
0,0,33,33,19,42,61,172,122,294,0.000333,0.581212,18,31385.46199,1743.636777,1743.636777,307.187955,13,0
0,0,63,63,24,61,85,314,215,529,0.000333,1.130189,36,122060.441,6781.13561,3390.567805,471.814078,28,0
0,0,41,41,19,43,62,209,144,353,0.000333,0.70061,27,56749.44503,3152.746946,2101.831298,314.040007,18,0
0,0,29,29,15,30,45,128,97,225,0.000333,0.411889,21,25949.00588,1441.611438,1235.666947,205.810077,9,0
0,0,27,27,14,30,44,126,94,220,0.000333,0.400358,21,25222.57408,1401.254115,1201.074956,200.509687,9,0
0,0,29,29,18,40,58,151,108,259,0.000333,0.505739,18,27309.9074,1517.217078,1517.217078,287.935774,11,0
0,0,107,107,23,65,88,558,390,948,0.000333,2.04118,66,404153.7175,22452.98431,6123.541174,495.495833,60,0
0,0,67,67,23,66,89,341,245,586,0.000333,1.264927,33,125227.7331,6957.096283,3794.779791,502.971937,34,0
0,0,74,74,27,67,94,345,238,583,0.000333,1.273775,39,149031.6867,8279.538151,3821.325301,534.809938,31,0
0,0,101,101,24,61,85,510,342,852,0.000333,1.820267,60,327648.0647,18202.67026,5460.801078,471.814078,46,0
0,0,75,75,27,69,96,350,242,592,0.000333,1.299433,39,152033.6142,8446.311901,3898.2978,549.87015,35,0
0,0,25,25,19,27,46,124,85,209,0.000333,0.384808,27,31169.46012,1731.636673,1154.424449,209.092585,9,0
0,0,25,25,21,28,49,129,90,219,0.000333,0.409874,30,36888.64368,2049.369093,1229.621456,226.844604,9,0
0,0,32,32,22,27,49,132,97,229,0.000333,0.42859,33,42430.36229,2357.24235,1285.768554,226.489458,13,0
0,0,30,30,22,26,48,126,95,221,0.000333,0.411426,33,40731.13152,2262.84064,1234.276713,220.318928,11,0
0,0,22,22,21,23,44,92,71,163,0.000333,0.296629,30,26696.62062,1483.14559,889.887354,196.280591,9,0
0,0,21,21,22,24,46,86,65,151,0.000333,0.278019,22,18349.27282,1019.404045,834.057855,208.146596,10,0
0,0,14,14,17,21,38,54,43,97,0.000333,0.169683,16,8144.783501,452.487972,509.048969,161.725534,8,0
0,0,22,22,15,27,42,121,91,212,0.000333,0.381057,21,24006.59717,1333.699843,1143.171294,186.985321,7,0
0,0,128,128,25,106,131,589,413,1002,0.000333,2.349163,36,253709.6345,14094.9797,7047.489848,829.255973,48,0
0,0,126,126,24,107,131,573,404,977,0.000333,2.290551,36,247379.5538,13743.30855,6871.654273,831.376068,46,0
0,0,127,127,25,104,129,571,403,974,0.000333,2.276312,36,245841.6725,13657.87069,6828.935347,812.942135,48,0
0,0,68,68,31,65,96,391,242,633,0.000333,1.389427,45,187572.6568,10420.70316,4168.281263,545.033993,29,0
0,0,98,98,29,76,105,511,316,827,0.000333,1.850894,56,310950.1384,17275.00769,5552.681043,615.72394,34,0
0,0,91,91,30,81,111,577,361,938,0.000333,2.124387,60,382389.725,21243.87361,6373.162083,660.734568,34,0
0,0,91,91,30,81,111,577,361,938,0.000333,2.124387,60,382389.725,21243.87361,6373.162083,660.734568,34,0
0,0,79,79,31,69,100,430,270,700,0.000333,1.550233,45,209281.47,11626.74833,4650.699333,575.068273,34,0
0,0,66,66,31,62,93,375,232,607,0.000333,1.32309,45,178617.1229,9923.173496,3969.269398,522.740257,29,0
0,0,91,91,30,81,111,577,361,938,0.000333,2.124387,60,382389.725,21243.87361,6373.162083,660.734568,34,0
0,0,67,67,28,67,95,375,240,615,0.000333,1.34682,42,169699.3704,9427.742798,4040.461199,541.033914,24,0
0,0,58,58,28,61,89,309,211,520,0.000333,1.12246,42,141430.0181,7857.22323,3367.381384,496.380915,20,0
0,0,101,101,32,84,116,515,316,831,0.000333,1.899661,48,273551.1459,15197.28589,5698.982207,696.954664,39,0
0,0,101,101,36,97,133,493,343,836,0.000333,1.966072,54,318503.6703,17694.64835,5898.216116,826.308846,41,0
0,0,74,74,31,69,100,404,256,660,0.000333,1.461648,45,197322.5288,10962.36271,4384.945085,575.068273,31,0
0,0,28,28,20,33,53,145,103,248,0.000333,0.473508,30,42615.72818,2367.540455,1420.524273,252.903568,11,0
0,0,33,33,19,38,57,186,136,322,0.000333,0.626064,27,50711.14578,2817.285877,1878.190585,280.131868,13,0
0,0,34,34,19,36,55,177,131,308,0.000333,0.593553,27,48077.78738,2670.988188,1780.658792,266.827923,12,0
0,0,39,39,20,39,59,214,155,369,0.000333,0.723565,30,65120.85856,3617.825475,2170.695285,292.569248,14,0
0,0,40,40,22,51,73,238,166,404,0.000333,0.833563,33,82522.74102,4584.596723,2500.689122,387.401188,17,0
0,0,48,48,22,52,74,275,188,463,0.000333,0.958326,33,94874.23797,5270.790999,2874.976908,394.530361,22,0
0,0,36,36,20,37,57,194,141,335,0.000333,0.651339,30,58620.54464,3256.696925,1954.018155,279.188336,13,0
0,0,34,34,19,39,58,192,138,330,0.000333,0.644378,27,52194.61067,2899.700593,1933.133728,286.841309,13,0
0,0,36,36,22,49,71,217,152,369,0.000333,0.756419,33,74885.47067,4160.303926,2269.256687,373.228278,15,0
0,0,74,74,26,74,100,407,289,696,0.000333,1.541375,39,180340.8324,10018.93513,4624.123908,581.710982,38,0
0,0,81,81,29,75,104,411,282,693,0.000333,1.547802,42,195022.9984,10834.61102,4643.404725,608.042851,35,0
0,0,108,108,26,69,95,576,386,962,0.000333,2.106734,65,410813.0712,22822.9484,6320.201095,543.69962,50,0
0,0,82,82,29,77,106,416,286,702,0.000333,1.574333,42,198366.0067,11020.33371,4723.000159,623.424012,39,0
0,0,42,42,22,48,70,222,161,383,0.000333,0.782505,33,77468.00805,4303.778225,2347.515395,366.185696,17,0
0,0,75,75,26,74,100,416,296,712,0.000333,1.576809,52,245982.1316,13665.67398,4730.425607,581.710982,39,0
0,0,48,48,23,49,72,250,180,430,0.000333,0.884356,33,87551.23577,4863.957543,2653.067751,379.162707,18,0
0,0,52,52,24,60,84,276,199,475,0.000333,1.012117,36,109308.6279,6072.701552,3036.350776,464.452536,22,0
0,0,48,48,24,58,82,260,186,446,0.000333,0.945156,36,102076.855,5670.936388,2835.468194,449.801998,18,0
0,0,82,82,29,75,104,420,289,709,0.000333,1.583537,42,199525.6939,11084.76077,4750.61176,608.042851,36,0
0,0,109,109,26,69,95,585,393,978,0.000333,2.141773,65,417645.721,23202.54006,6425.318785,543.69962,51,0
0,0,83,83,29,77,106,425,293,718,0.000333,1.610216,42,202887.1692,11271.5094,4830.646886,623.424012,40,0
0,0,60,60,24,61,85,313,221,534,0.000333,1.140872,36,123214.1314,6845.22952,3422.61476,471.814078,27,0
0,0,56,56,24,59,83,297,208,505,0.000333,1.073132,36,115898.2169,6438.789826,3219.394913,457.11504,23,0
0,0,45,45,23,47,70,230,166,396,0.000333,0.809065,33,80097.47047,4449.85947,2427.196075,365.107601,17,0
0,0,84,84,27,87,114,484,329,813,0.000333,1.851713,39,216650.4437,12036.13576,5555.139582,688.918047,32,0
0,0,48,48,24,58,82,255,185,440,0.000333,0.932441,36,100703.6238,5594.645764,2797.322882,449.801998,20,0
0,0,44,44,24,56,80,239,172,411,0.000333,0.866104,36,93539.24809,5196.624894,2598.312447,435.250976,16,0
0,0,96,96,29,81,110,457,319,776,0.000333,1.754112,42,221018.0758,12278.78199,5262.335138,654.409299,40,0
0,0,121,121,33,111,144,577,392,969,0.000333,2.315886,48,333487.5517,18527.0862,6947.657326,920.645167,49,0
0,0,96,96,29,81,110,457,319,776,0.000333,1.754112,42,221018.0758,12278.78199,5262.335138,654.409299,40,0
0,0,87,87,30,82,112,424,293,717,0.000333,1.626958,45,219639.3066,12202.1837,4880.873479,668.525982,39,0
0,0,35,35,19,38,57,195,140,335,0.000333,0.651339,27,52758.49018,2931.027232,1954.018155,280.131868,15,0
0,0,82,82,27,85,112,468,315,783,0.000333,1.77672,39,207876.1973,11548.67763,5330.158904,673.180192,33,0
0,0,75,75,26,73,99,413,287,700,0.000333,1.54685,39,180981.4357,10054.52421,4640.549634,574.068625,41,0
0,0,36,36,19,36,55,186,135,321,0.000333,0.618605,27,50107.04464,2783.724702,1855.816468,266.827923,14,0
0,0,41,41,20,39,59,223,159,382,0.000333,0.749057,40,89886.78579,4993.710322,2247.169645,292.569248,16,0
0,0,42,42,22,51,73,247,170,417,0.000333,0.860386,33,85178.17576,4732.120875,2581.156841,387.401188,19,0
0,0,72,72,26,69,95,389,263,652,0.000333,1.427849,39,167058.2884,9281.016023,4283.545857,543.69962,34,0
0,0,50,50,22,52,74,284,192,476,0.000333,0.985233,33,97538.09347,5418.78297,2955.699802,394.530361,24,0
0,0,38,38,20,37,57,203,145,348,0.000333,0.676615,30,60895.37175,3383.076208,2029.845725,279.188336,15,0
0,0,36,36,19,39,58,201,142,343,0.000333,0.669762,27,54250.762,3013.931222,2009.287481,286.841309,15,0
0,0,38,38,22,49,71,226,156,382,0.000333,0.783068,33,77523.71219,4306.872899,2349.2034,373.228278,17,0
0,0,76,76,26,74,100,416,293,709,0.000333,1.570165,39,183709.2675,10206.07042,4710.494039,581.710982,40,0
0,0,83,83,29,75,104,420,286,706,0.000333,1.576837,42,198681.4385,11037.8577,4730.510441,608.042851,37,0
0,0,110,110,26,69,95,585,390,975,0.000333,2.135203,65,416364.5992,23131.36662,6405.609218,543.69962,52,0
0,0,84,84,29,77,106,425,290,715,0.000333,1.603488,42,202039.4513,11224.41396,4810.463125,623.424012,41,0
0,0,22,22,18,30,48,119,87,206,0.000333,0.383501,18,20709.04095,1150.502275,1150.502275,222.265368,9,0
0,0,27,27,17,35,52,160,120,280,0.000333,0.532041,24,38306.95491,2128.164161,1596.123121,249.011774,11,0
0,0,28,28,17,33,50,151,115,266,0.000333,0.500422,24,36030.37792,2001.687662,1501.265746,235.951874,10,0
0,0,33,33,18,37,55,188,139,327,0.000333,0.630168,27,51043.62491,2835.756939,1890.504626,267.808425,12,0
0,0,34,34,21,48,69,212,150,362,0.000333,0.737095,30,66338.5756,3685.476422,2211.285853,360.316866,15,0
0,0,42,42,21,49,70,249,172,421,0.000333,0.860143,30,77412.8445,4300.713584,2580.42815,367.359448,20,0
0,0,30,30,18,35,53,168,125,293,0.000333,0.559427,27,45313.57872,2517.42104,1678.280693,254.583556,11,0
0,0,28,28,17,36,53,166,122,288,0.000333,0.54988,24,39591.38618,2199.521455,1649.641091,255.604168,11,0
0,0,30,30,21,46,67,191,136,327,0.000333,0.661204,20,39672.22331,2204.012406,1983.611165,346.322516,13,0
0,0,68,68,24,72,96,381,273,654,0.000333,1.435522,36,155036.3571,8613.130951,4306.565475,554.2737,36,0
0,0,75,75,28,73,101,385,266,651,0.000333,1.444832,42,182048.8184,10113.82324,4334.495675,586.463131,33,0
0,0,102,102,25,67,92,550,370,920,0.000333,2.000559,60,360100.62,20005.59,6001.677,522.524381,48,0
0,0,76,76,28,75,103,390,270,660,0.000333,1.47103,42,185349.7946,10297.21081,4413.090348,601.76734,37,0
0,0,36,36,20,45,65,196,145,341,0.000333,0.684542,30,61608.82273,3422.712374,2053.627424,333.571951,15,0
0,0,69,69,24,72,96,390,280,670,0.000333,1.470642,36,158829.2955,8823.849751,4411.924875,554.2737,37,0
0,0,42,42,21,47,68,224,164,388,0.000333,0.787312,30,70858.06747,3936.559304,2361.935582,353.304342,16,0
0,0,46,46,23,57,80,250,183,433,0.000333,0.912465,33,90334.03055,5018.557253,2737.394865,436.516656,20,0
0,0,42,42,23,55,78,234,170,404,0.000333,0.846434,33,83796.98238,4655.38791,2539.302496,422.016709,16,0
0,0,76,76,28,73,101,394,273,667,0.000333,1.480342,42,186523.1365,10362.39647,4441.027059,586.463131,34,0
0,0,103,103,25,67,92,559,377,936,0.000333,2.035351,60,366363.2395,20353.5133,6106.053991,522.524381,49,0
0,0,77,77,28,75,103,399,277,676,0.000333,1.506691,42,189843.123,10546.84017,4520.074356,601.76734,38,0
0,0,54,54,23,58,81,287,205,492,0.000333,1.039735,33,102933.8046,5718.544703,3119.206201,443.804823,25,0
0,0,50,50,23,56,79,271,192,463,0.000333,0.972883,33,96315.46605,5350.859225,2918.650486,429.253801,21,0
0,0,39,39,21,45,66,204,150,354,0.000333,0.713239,30,64191.46555,3566.19253,2139.715518,339.372055,15,0
0,0,78,78,25,83,108,458,313,771,0.000333,1.736006,36,187488.6575,10416.03653,5208.018264,645.224678,30,0
0,0,42,42,23,55,78,229,169,398,0.000333,0.833863,33,82552.47274,4586.248486,2501.590083,422.016709,18,0
0,0,38,38,23,53,76,213,156,369,0.000333,0.768495,22,50720.67555,2817.815309,2305.485252,407.621709,14,0
0,0,88,88,22,74,96,606,352,958,0.000333,2.102798,44,277569.3393,15420.51885,6308.394076,557.607045,41,0
0,0,90,90,28,79,107,431,303,734,0.000333,1.649412,42,207825.9443,11545.88579,4948.236768,632.604617,38,0
0,0,113,113,28,73,101,581,394,975,0.000333,2.163919,70,454422.9337,25245.71854,6491.756196,586.463131,50,0
0,0,114,114,28,75,103,586,398,984,0.000333,2.193172,70,460566.1563,25587.00868,6579.516519,601.76734,54,0
0,0,115,115,32,108,140,551,376,927,0.000333,2.202948,48,317224.5771,17623.58762,6608.845357,889.52785,47,0
0,0,90,90,28,79,107,431,303,734,0.000333,1.649412,42,207825.9443,11545.88579,4948.236768,632.604617,38,0
0,0,113,113,28,73,101,581,394,975,0.000333,2.163919,70,454422.9337,25245.71854,6491.756196,586.463131,50,0
0,0,114,114,28,75,103,586,398,984,0.000333,2.193172,70,460566.1563,25587.00868,6579.516519,601.76734,54,0
0,0,81,81,29,80,109,398,277,675,0.000333,1.522841,42,191878.0256,10659.89031,4568.524419,646.635696,37,0
0,0,29,29,17,35,52,169,124,293,0.000333,0.556743,24,40085.4921,2226.971783,1670.228837,249.011774,13,0
0,0,76,76,25,81,106,442,299,741,0.000333,1.661796,36,179474.006,9970.778114,4985.389057,629.624255,31,0
0,0,69,69,24,71,95,387,271,658,0.000333,1.440988,36,155626.7397,8645.929981,4322.96499,546.671146,39,0
0,0,30,30,17,33,50,160,119,279,0.000333,0.524879,24,37791.26105,2099.514503,1574.635877,235.951874,12,0
0,0,35,35,18,37,55,197,143,340,0.000333,0.655221,27,53072.88217,2948.493454,1965.662303,267.808425,14,0
0,0,36,36,21,48,69,221,154,375,0.000333,0.763566,30,68720.90014,3817.827785,2290.696671,360.316866,17,0
0,0,66,66,25,67,92,363,247,610,0.000333,1.326458,36,143257.4206,7958.745586,3979.372793,522.524381,32,0
0,0,44,44,21,49,70,258,176,434,0.000333,0.886703,30,79803.26488,4433.514716,2660.108829,367.359448,22,0
0,0,32,32,18,35,53,177,129,306,0.000333,0.584248,27,47324.0788,2629.115489,1752.743659,254.583556,13,0
0,0,30,30,17,36,53,175,126,301,0.000333,0.574701,24,41378.49736,2298.805409,1724.104057,255.604168,13,0
0,0,32,32,21,46,67,200,140,340,0.000333,0.68749,30,61874.10974,3437.450541,2062.470325,346.322516,15,0
0,0,70,70,24,72,96,390,277,667,0.000333,1.464057,36,158118.1196,8784.339976,4392.169988,554.2737,38,0
0,0,77,77,28,73,101,394,270,664,0.000333,1.473684,42,185684.2018,10315.78899,4421.052425,586.463131,35,0
0,0,104,104,25,67,92,559,374,933,0.000333,2.028828,60,365188.9983,20288.27768,6086.483305,522.524381,50,0
0,0,78,78,28,75,103,399,274,673,0.000333,1.500005,42,189000.6239,10500.03466,4500.014855,601.76734,39,0
0,0,55,55,23,36,59,243,171,414,0.000333,0.811805,44,107158.2258,5953.234766,2435.414222,290.159225,7,0
0,0,12,12,15,26,41,52,50,102,0.000333,0.182157,7,3825.292131,212.51623,546.470304,180.814792,2,0
0,0,19,19,19,38,57,76,73,149,0.000333,0.2897,9,7821.905509,434.550306,869.100612,280.131868,5,0
0,0,44,44,22,67,89,210,183,393,0.000333,0.848321,22,55989.19124,3110.510625,2544.963238,504.535471,7,0
0,0,12,12,15,26,41,52,50,102,0.000333,0.182157,7,3825.292131,212.51623,546.470304,180.814792,2,0
0,0,19,19,19,38,57,76,73,149,0.000333,0.2897,9,7821.905509,434.550306,869.100612,280.131868,5,0
0,0,44,44,22,67,89,210,183,393,0.000333,0.848321,22,55989.19124,3110.510625,2544.963238,504.535471,7,0
0,0,12,12,19,24,43,63,47,110,0.000333,0.198963,9,5372.002107,298.444562,596.889123,190.749723,4,0
0,0,10,10,17,19,36,50,37,87,0.000333,0.149928,8,3598.267801,199.903767,449.783475,150.197491,4,0
0,0,10,10,17,19,36,50,37,87,0.000333,0.149928,8,3598.267801,199.903767,449.783475,150.197491,4,0
0,0,12,12,19,24,43,63,47,110,0.000333,0.198963,9,5372.002107,298.444562,596.889123,190.749723,4,0
0,0,10,10,17,19,36,50,37,87,0.000333,0.149928,8,3598.267801,199.903767,449.783475,150.197491,4,0
0,0,10,10,17,19,36,50,37,87,0.000333,0.149928,8,3598.267801,199.903767,449.783475,150.197491,4,0
0,0,36,36,29,54,83,187,156,343,0.000333,0.72888,28,61225.8787,3401.437705,2186.638525,451.645374,13,0
0,0,37,37,28,63,91,202,163,365,0.000333,0.791782,28,66509.66122,3694.981179,2375.345044,511.174573,12,0
0,0,20,20,19,34,53,108,90,198,0.000333,0.378043,18,20414.3085,1134.12825,1134.12825,253.684359,6,0
0,0,31,31,25,48,73,157,133,290,0.000333,0.59835,24,43081.17893,2393.398829,1795.049122,384.174605,12,0
0,0,33,33,25,56,81,179,147,326,0.000333,0.68893,24,49602.98642,2755.721468,2066.791101,441.30828,11,0
0,0,20,20,19,33,52,108,91,199,0.000333,0.378129,18,20418.97507,1134.387504,1134.387504,247.175629,6,0
0,0,65,65,34,77,111,300,255,555,0.000333,1.256967,51,192315.9411,10684.21895,3770.900806,655.5163,22,0
0,0,67,67,34,78,112,308,261,569,0.000333,1.291128,51,197542.6325,10974.59069,3873.384951,663.23511,23,0
0,0,60,60,34,76,110,286,241,527,0.000333,1.191259,51,182262.605,10125.70028,3573.776569,647.816228,22,0
0,0,67,67,34,78,112,308,261,569,0.000333,1.291128,51,197542.6325,10974.59069,3873.384951,663.23511,23,0
0,0,68,68,34,79,113,311,264,575,0.000333,1.307201,51,200001.7481,11111.20823,3921.602903,670.972416,23,0
0,0,45,45,29,70,99,234,187,421,0.000333,0.93032,28,78146.85584,4341.491991,2790.959137,569.93126,23,0
0,0,24,24,21,43,64,133,110,243,0.000333,0.486,20,29160,1620,1458,325.56805,10,0
0,0,44,44,27,63,90,233,182,415,0.000333,0.89804,26,70047.09491,3891.505273,2694.119035,504.950598,15,0
0,0,36,36,28,53,81,196,144,340,0.000333,0.718516,28,60355.37203,3353.076224,2155.549001,438.185722,16,0
0,0,83,83,30,91,121,431,352,783,0.000333,1.805823,45,243786.1462,13543.67479,5417.469915,739.41603,24,0
0,0,65,65,34,76,110,300,256,556,0.000333,1.256812,51,192292.236,10682.902,3770.436001,647.816228,22,0
0,0,67,67,34,77,111,308,262,570,0.000333,1.290939,51,197513.6692,10972.98162,3872.817044,655.5163,23,0
0,0,60,60,34,75,109,286,242,528,0.000333,1.1912,51,182253.6675,10125.20375,3573.601323,640.135138,22,0
0,0,67,67,34,77,111,308,262,570,0.000333,1.290939,51,197513.6692,10972.98162,3872.817044,655.5163,23,0
0,0,68,68,34,78,112,311,265,576,0.000333,1.307012,51,199972.8582,11109.60323,3921.036435,663.23511,23,0
0,0,43,43,26,66,92,217,176,393,0.000333,0.854587,26,66657.75607,3703.20867,2563.759849,521.141445,22,0
0,0,24,24,21,42,63,133,111,244,0.000333,0.486152,20,29169.12603,1620.507001,1458.456301,318.715998,10,0
0,0,27,27,22,48,70,150,123,273,0.000333,0.557765,22,36812.4738,2045.137433,1673.294264,366.185696,11,0
0,0,30,30,24,50,74,158,127,285,0.000333,0.589898,24,42472.66102,2359.592279,1769.694209,392.23191,13,0
0,0,25,25,26,43,69,131,110,241,0.000333,0.490718,26,38276.01425,2126.445236,1472.154394,355.540817,10,0
0,0,32,32,28,58,86,174,138,312,0.000333,0.668332,28,56139.8489,3118.880494,2004.994603,474.368836,12,0
0,0,15,15,19,29,48,80,65,145,0.000333,0.26994,18,14576.75213,809.819563,809.819563,221.592072,6,0
0,0,40,40,29,65,94,206,162,368,0.000333,0.80403,28,67538.48353,3752.137974,2412.088697,532.335357,23,0
0,0,39,39,27,58,85,205,157,362,0.000333,0.7734,26,60325.18749,3351.399305,2320.199519,468.14486,15,0
0,0,89,89,38,93,131,405,326,731,0.000333,1.713811,57,293061.6362,16281.20201,5141.432214,807.563015,29,0
0,0,86,86,37,91,128,399,318,717,0.000333,1.673,54,271026,15057,5019,784.959087,31,0
0,0,85,85,35,90,125,401,326,727,0.000333,1.688042,51,258270.3839,14348.35466,5064.125175,763.791684,35,0
0,0,64,64,34,79,113,292,247,539,0.000333,1.225359,51,187479.8995,10415.54997,3676.076461,670.972416,23,0
0,0,84,84,35,90,125,396,322,718,0.000333,1.667144,51,255073.0889,14170.72716,5001.433116,763.791684,34,0
0,0,78,78,37,84,121,347,281,628,0.000333,1.448349,54,234632.4901,13035.13834,4345.046113,729.704438,27,0
0,0,80,80,36,89,125,375,301,676,0.000333,1.569623,54,254278.9895,14126.61053,4708.870176,762.457575,30,0
0,0,79,79,34,88,122,377,309,686,0.000333,1.584829,51,242478.7765,13471.04314,4754.485814,741.403719,34,0
0,0,66,66,34,80,114,300,253,553,0.000333,1.259529,51,192707.9971,10705.99984,3778.588178,678.727984,24,0
0,0,78,78,34,88,122,372,305,677,0.000333,1.564036,51,239297.5681,13294.30934,4692.109178,741.403719,33,0
0,0,70,70,34,86,120,331,277,608,0.000333,1.399796,51,214168.8636,11898.2702,4199.389482,725.632506,25,0
0,0,59,59,34,78,112,279,234,513,0.000333,1.164058,51,178100.8268,9894.490379,3492.173075,663.23511,23,0
0,0,78,78,37,84,121,347,281,628,0.000333,1.448349,54,234632.4901,13035.13834,4345.046113,729.704438,27,0
0,0,80,80,36,89,125,375,301,676,0.000333,1.569623,54,254278.9895,14126.61053,4708.870176,762.457575,30,0
0,0,79,79,34,88,122,377,309,686,0.000333,1.584829,51,242478.7765,13471.04314,4754.485814,741.403719,34,0
0,0,66,66,34,80,114,300,253,553,0.000333,1.259529,51,192707.9971,10705.99984,3778.588178,678.727984,24,0
0,0,78,78,34,88,122,372,305,677,0.000333,1.564036,51,239297.5681,13294.30934,4692.109178,741.403719,33,0
0,0,79,79,37,85,122,350,284,634,0.000333,1.464696,54,237280.7235,13182.26242,4394.087472,737.548004,27,0
0,0,81,81,36,90,126,378,304,682,0.000333,1.586168,54,256959.265,14275.51472,4758.504908,770.384079,30,0
0,0,80,80,34,89,123,380,312,692,0.000333,1.601407,51,245015.2219,13611.95677,4804.220038,749.314012,34,0
0,0,67,67,34,81,115,303,256,559,0.000333,1.275543,51,195158.0759,10842.11533,3826.628938,686.501587,24,0
0,0,79,79,34,89,123,375,308,683,0.000333,1.580579,51,241828.6078,13434.92265,4741.737407,749.314012,33,0
0,0,36,36,24,53,77,180,141,321,0.000333,0.670546,24,48279.32351,2682.184639,2011.63848,413.618884,14,0
0,0,33,33,23,55,78,163,136,299,0.000333,0.626445,22,41345.3758,2296.965322,1879.335263,422.016709,12,0
0,0,36,36,24,53,77,180,141,321,0.000333,0.670546,24,48279.32351,2682.184639,2011.63848,413.618884,14,0
0,0,38,38,28,56,84,193,139,332,0.000333,0.707416,28,59422.98276,3301.27682,2122.249384,459.817813,19,0
0,0,31,31,25,54,79,151,119,270,0.000333,0.56734,24,40848.49925,2269.361069,1702.020802,426.86033,15,0
0,0,85,85,29,96,125,405,339,744,0.000333,1.727515,42,217666.8273,12092.60152,5182.543508,773.037849,15,0
0,0,45,45,23,54,77,206,184,390,0.000333,0.814682,33,80653.54278,4480.752377,2444.046751,414.80585,4,0
0,0,69,69,28,78,106,351,276,627,0.000333,1.406135,42,177173.0573,9842.947625,4218.406125,624.867311,25,0
0,0,48,48,25,70,95,232,183,415,0.000333,0.90883,24,65435.76186,3635.320103,2726.490077,545.146216,24,0
0,0,37,37,21,53,74,185,144,329,0.000333,0.68097,20,40858.20315,2269.900175,2042.910157,395.81845,18,0
0,0,41,41,21,60,81,204,162,366,0.000333,0.773462,20,46407.70202,2578.205668,2320.385101,446.652102,20,0
0,0,55,55,24,60,84,232,179,411,0.000333,0.875747,24,63053.81906,3502.989948,2627.242461,464.452536,15,0
0,0,57,57,26,76,102,260,199,459,0.000333,1.020881,26,79628.72403,4423.818002,3062.643232,597.053924,18,0
0,0,48,48,22,58,80,230,184,414,0.000333,0.872426,33,86370.18163,4798.343424,2617.278231,437.870393,20,0
0,0,35,35,19,55,74,153,128,281,0.000333,0.581619,18,31407.41512,1744.856396,1744.856396,398.685407,10,0
0,0,47,47,22,58,80,225,180,405,0.000333,0.85346,33,84492.56899,4694.03161,2560.380878,437.870393,19,0
0,0,46,46,23,56,79,197,153,350,0.000333,0.735441,22,48539.11176,2696.61732,2206.323262,429.253801,13,0
0,0,48,48,26,72,98,225,173,398,0.000333,0.877552,26,68449.01747,3802.723193,2632.654518,566.446033,16,0
0,0,47,47,22,57,79,227,181,408,0.000333,0.857314,33,84874.10399,4715.228,2571.942545,430.582226,20,0
0,0,34,34,19,54,73,150,125,275,0.000333,0.567401,18,30639.63157,1702.201754,1702.201754,391.474548,10,0
0,0,46,46,22,57,79,222,177,399,0.000333,0.838403,33,83001.88111,4611.215617,2515.208519,430.582226,19,0
0,0,46,46,23,56,79,197,153,350,0.000333,0.735441,22,48539.11176,2696.61732,2206.323262,429.253801,13,0
0,0,48,48,26,72,98,225,173,398,0.000333,0.877552,26,68449.01747,3802.723193,2632.654518,566.446033,16,0
0,0,47,47,22,57,79,227,181,408,0.000333,0.857314,33,84874.10399,4715.228,2571.942545,430.582226,20,0
0,0,34,34,19,54,73,150,125,275,0.000333,0.567401,18,30639.63157,1702.201754,1702.201754,391.474548,10,0
0,0,46,46,22,57,79,222,177,399,0.000333,0.838403,33,83001.88111,4611.215617,2515.208519,430.582226,19,0
0,0,53,53,26,58,84,264,196,460,0.000333,0.980155,39,114678.1746,6371.009698,2940.466014,461.97433,24,0
0,0,15,15,15,56,71,138,137,275,0.000333,0.563727,14,23676.52641,1315.362578,1691.180458,383.815235,2,0
0,0,15,15,15,56,71,138,137,275,0.000333,0.563727,14,23676.52641,1315.362578,1691.180458,383.815235,2,0
0,0,15,15,15,56,71,138,137,275,0.000333,0.563727,14,23676.52641,1315.362578,1691.180458,383.815235,2,0
0,0,15,15,15,56,71,138,137,275,0.000333,0.563727,14,23676.52641,1315.362578,1691.180458,383.815235,2,0
0,0,15,15,15,56,71,138,137,275,0.000333,0.563727,14,23676.52641,1315.362578,1691.180458,383.815235,2,0
0,0,15,15,15,56,71,138,137,275,0.000333,0.563727,14,23676.52641,1315.362578,1691.180458,383.815235,2,0
0,0,7,7,13,20,33,36,31,67,0.000333,0.112658,6,2027.846436,112.658135,337.974406,134.544278,2,0
0,0,25,25,25,42,67,143,111,254,0.000333,0.513596,24,36978.87971,2054.382206,1540.786654,342.573737,6,0
0,0,28,28,26,44,70,165,128,293,0.000333,0.598627,26,46692.87802,2594.048779,1795.879924,362.426424,6,0
0,0,36,36,24,42,66,222,166,388,0.000333,0.781742,36,84428.09706,4690.449837,2345.224918,336.516432,7,0
0,0,5,5,11,18,29,30,29,59,0.000333,0.09554,5,1433.104394,79.616911,286.620879,113.112398,1,0
0,0,24,24,25,42,67,119,102,221,0.000333,0.446869,24,32174.53707,1787.474281,1340.605711,342.573737,10,0
0,0,21,21,22,39,61,110,87,197,0.000333,0.389452,22,25703.81562,1427.989757,1168.355255,304.238182,8,0
0,0,74,74,27,90,117,347,268,615,0.000333,1.408425,26,109857.1319,6103.173993,4225.274303,712.648741,22,0
0,0,67,67,27,84,111,312,244,556,0.000333,1.259232,26,98220.07576,5456.670876,3777.695222,665.336626,22,0
0,0,65,65,27,82,109,309,239,548,0.000333,1.236322,26,96433.09026,5357.393903,3708.96501,649.701227,22,0
0,0,64,64,27,82,109,296,234,530,0.000333,1.195713,26,93265.58,5181.421111,3587.137692,649.701227,14,0
0,0,22,22,21,44,65,167,104,271,0.000333,0.544021,20,32641.23355,1813.401864,1632.061677,332.453657,16,0
0,0,13,13,18,26,44,84,63,147,0.000333,0.267512,18,14445.65606,802.536448,802.536448,197.270083,5,0
0,0,5,5,14,19,33,42,31,73,0.000333,0.122747,7,2577.685395,143.204744,368.240771,134.013592,2,0
0,0,6,6,14,18,32,41,34,75,0.000333,0.125,7,2625,145.833333,375,128.361619,3,0
0,0,6,6,14,18,32,35,34,69,0.000333,0.115,7,2415,134.166667,345,128.361619,3,0
0,0,4,4,13,17,30,35,27,62,0.000333,0.101409,6,1825.363302,101.409072,304.227217,117.592585,2,0
0,0,57,57,29,59,88,350,237,587,0.000333,1.263895,56,212334.4362,11796.35757,3791.68636,487.957389,32,0
0,0,47,47,29,53,82,288,211,499,0.000333,1.057473,42,133241.5749,7402.309717,3172.41845,444.461233,31,0
0,0,45,45,29,45,74,265,192,457,0.000333,0.945907,56,158912.3305,8828.462807,2837.720188,388.014838,27,0
0,0,48,48,30,47,77,274,200,474,0.000333,0.990152,60,178227.4092,9901.522734,2970.45682,408.272394,27,0
0,0,41,41,29,44,73,249,182,431,0.000333,0.889271,56,149397.6056,8299.866975,2667.814385,381.09644,25,0
0,0,47,47,29,50,79,273,194,467,0.000333,0.981289,42,123642.3556,6869.019755,2943.865609,423.074258,29,0
0,0,41,41,28,43,71,248,180,428,0.000333,0.877364,56,147397.139,8188.729942,2632.091767,367.935322,26,0
0,0,42,42,28,44,72,246,182,428,0.000333,0.880243,56,147880.7624,8215.597913,2640.727901,374.820929,25,0
0,0,55,55,28,58,86,348,234,582,0.000333,1.246695,56,209444.8209,11635.82338,3740.086087,474.368836,33,0
0,0,45,45,29,52,81,286,208,494,0.000333,1.043962,56,175385.6105,9743.645027,3131.885901,437.304314,32,0
0,0,43,43,29,44,73,263,189,452,0.000333,0.9326,56,156676.8392,8704.268846,2797.800701,381.09644,28,0
0,0,46,46,29,46,75,272,197,469,0.000333,0.973772,56,163593.6941,9088.53856,2921.315966,394.965299,28,0
0,0,39,39,28,43,71,247,179,426,0.000333,0.873264,56,146708.3673,8150.464849,2619.792273,367.935322,26,0
0,0,45,45,28,49,77,271,191,462,0.000333,0.965085,42,121600.726,6755.595891,2895.255382,409.72672,30,0
0,0,39,39,27,42,69,246,177,423,0.000333,0.861302,52,134363.104,7464.616886,2583.905845,354.859294,27,0
0,0,40,40,27,43,70,244,179,423,0.000333,0.864229,52,134819.7092,7489.983847,2592.686716,361.711347,26,0
0,0,63,63,32,69,101,408,282,690,0.000333,1.531389,64,294026.6191,16334.81217,4594.165923,581.488188,34,0
0,0,53,53,32,64,96,346,256,602,0.000333,1.321382,64,253705.4352,14094.7464,3964.147425,544,33,0
0,0,51,51,31,55,86,323,237,560,0.000333,1.199569,60,215922.4958,11995.69421,3598.708263,471.55487,29,0
0,0,54,54,33,58,91,332,245,577,0.000333,1.251666,64,240319.8405,13351.10225,3754.997507,506.227904,29,0
0,0,47,47,31,55,86,307,227,534,0.000333,1.143875,60,205897.5227,11438.75126,3431.625379,471.55487,27,0
0,0,53,53,32,61,93,331,239,570,0.000333,1.24244,48,178911.3851,9939.521393,3727.320522,521.774978,31,0
0,0,47,47,31,54,85,306,225,531,0.000333,1.134462,60,204203.1952,11344.62196,3403.386587,464.344011,28,0
0,0,48,48,31,55,86,304,227,531,0.000333,1.137449,60,204740.7951,11374.48862,3412.346585,471.55487,27,0
0,0,63,63,32,69,101,408,282,690,0.000333,1.531389,64,294026.6191,16334.81217,4594.165923,581.488188,34,0
0,0,53,53,32,64,96,346,256,602,0.000333,1.321382,64,253705.4352,14094.7464,3964.147425,544,33,0
0,0,51,51,31,55,86,323,237,560,0.000333,1.199569,60,215922.4958,11995.69421,3598.708263,471.55487,29,0
0,0,54,54,33,58,91,332,245,577,0.000333,1.251666,64,240319.8405,13351.10225,3754.997507,506.227904,29,0
0,0,47,47,31,55,86,307,227,534,0.000333,1.143875,60,205897.5227,11438.75126,3431.625379,471.55487,27,0
0,0,53,53,32,61,93,331,239,570,0.000333,1.24244,48,178911.3851,9939.521393,3727.320522,521.774978,31,0
0,0,47,47,31,54,85,306,225,531,0.000333,1.134462,60,204203.1952,11344.62196,3403.386587,464.344011,28,0
0,0,48,48,31,55,86,304,227,531,0.000333,1.137449,60,204740.7951,11374.48862,3412.346585,471.55487,27,0
0,0,47,47,26,59,85,316,225,541,0.000333,1.155827,39,135231.7394,7512.874409,3467.480496,469.287373,15,0
0,0,12,12,19,32,51,87,81,168,0.000333,0.317656,18,17153.41423,952.967457,952.967457,240.710623,4,0
0,0,12,12,19,32,51,87,81,168,0.000333,0.317656,18,17153.41423,952.967457,952.967457,240.710623,4,0
0,0,16,16,21,30,51,87,79,166,0.000333,0.313874,20,18832.45214,1046.247341,941.622607,239.445384,6,0
0,0,16,16,21,31,52,87,80,167,0.000333,0.317324,20,19039.46866,1057.748259,951.973433,245.818752,6,0
0,0,16,16,21,30,51,87,79,166,0.000333,0.313874,20,18832.45214,1046.247341,941.622607,239.445384,6,0
0,0,16,16,21,30,51,87,79,166,0.000333,0.313874,20,18832.45214,1046.247341,941.622607,239.445384,6,0
0,0,19,19,22,34,56,108,96,204,0.000333,0.3949,22,26063.40889,1447.967161,1184.700404,271.081232,6,0
0,0,19,19,22,35,57,108,97,205,0.000333,0.398581,22,26306.33396,1461.462998,1195.742453,277.632401,6,0
0,0,19,19,22,34,56,108,96,204,0.000333,0.3949,22,26063.40889,1447.967161,1184.700404,271.081232,6,0
0,0,19,19,22,34,56,108,96,204,0.000333,0.3949,22,26063.40889,1447.967161,1184.700404,271.081232,6,0
0,0,10,10,19,28,47,68,57,125,0.000333,0.231441,18,12497.82492,694.323606,694.323606,215.316561,6,0
0,0,15,15,17,28,45,78,60,138,0.000333,0.252625,16,12126.01164,673.667313,757.875727,204.092806,5,0
0,0,16,16,18,28,46,92,68,160,0.000333,0.29459,18,15907.85843,883.769913,883.769913,209.664588,5,0
0,0,13,13,17,25,42,71,53,124,0.000333,0.222882,16,10698.35777,594.353209,668.64736,185.583273,4,0
0,0,14,14,17,25,42,71,53,124,0.000333,0.222882,16,10698.35777,594.353209,668.64736,185.583273,5,0
0,0,31,31,24,45,69,157,112,269,0.000333,0.547731,24,39436.63389,2190.924105,1643.193079,357.172489,15,0
0,0,30,30,24,44,68,155,109,264,0.000333,0.535697,24,38570.16456,2142.78692,1607.09019,350.254091,15,0
0,0,27,27,23,41,64,143,102,245,0.000333,0.49,22,32340,1796.666667,1470,323.701557,13,0
0,0,15,15,18,30,48,79,62,141,0.000333,0.262493,18,14174.63483,787.479713,787.479713,222.265368,4,0
0,0,21,21,24,36,60,123,90,213,0.000333,0.419389,24,30196.02473,1677.556929,1258.167697,296.1564,13,0
0,0,66,66,31,83,114,431,312,743,0.000333,1.692279,45,228457.6776,12692.0932,5076.837281,682.708358,44,0
0,0,16,16,21,30,51,157,107,264,0.000333,0.499173,30,44925.60871,2495.86715,1497.52029,239.445384,18,0
0,0,39,39,27,54,81,216,162,378,0.000333,0.798821,39,93462.06874,5192.337152,2396.463301,439.145888,14,0
0,0,34,34,27,60,87,197,152,349,0.000333,0.749529,26,58463.26928,3247.959405,2248.58728,482.795398,12,0
0,0,31,31,28,58,86,191,149,340,0.000333,0.72831,28,61178.04047,3398.780026,2184.930017,474.368836,11,0
0,0,34,34,28,60,88,217,167,384,0.000333,0.826807,28,69451.80876,3858.43382,2480.421742,489.019374,11,0
0,0,7,7,11,14,25,34,28,62,0.000333,0.095973,10,2879.190838,159.955047,287.919084,91.356717,3,0
0,0,8,8,11,16,27,35,31,66,0.000333,0.104608,5,1569.112876,87.172938,313.822575,102.053748,3,0
0,0,59,59,31,57,88,323,233,556,0.000333,1.197148,60,215486.6388,11971.47993,3591.44398,486.054816,32,0
0,0,55,55,29,78,107,334,276,610,0.000333,1.370765,42,172716.3842,9595.354677,4112.294862,631.142822,29,0
0,0,54,54,30,79,109,325,267,592,0.000333,1.335588,45,180304.4304,10016.9128,4006.76512,645.205397,30,0
0,0,34,34,20,35,55,159,142,301,0.000333,0.580063,40,69607.57095,3867.087275,1740.189274,265.963467,13,0
0,0,25,25,20,32,52,112,103,215,0.000333,0.408532,30,36767.83618,2042.657566,1225.594539,246.438562,10,0
0,0,67,67,26,56,82,255,189,444,0.000333,0.940918,39,110087.3705,6115.965028,2822.75309,447.423308,18,0
0,0,33,33,20,34,54,156,139,295,0.000333,0.565897,40,67907.67253,3772.648474,1697.691813,259.412299,13,0
0,0,24,24,20,31,51,109,100,209,0.000333,0.395179,30,35566.10689,1975.894827,1185.536896,240.018648,10,0
1,0,9,10,20,21,41,52,37,89,0.000333,0.158941,10,4768.221284,264.901182,476.822128,178.677228,9,0
1,0,5,6,13,16,29,33,26,59,0.000333,0.09554,6,1719.725272,95.540293,286.620879,112.105716,4,0
3,0,9,12,20,37,57,64,49,113,0.000333,0.219706,10,6591.165716,366.175873,659.116572,279.188336,5,0
0,0,35,35,18,77,95,251,187,438,0.000333,0.959199,18,51796.74162,2877.596756,2877.596756,557.601214,10,0
1,0,7,8,11,17,28,34,27,61,0.000333,0.09775,5,1466.243251,81.457958,293.24865,107.540616,2,0
1,0,13,14,19,24,43,66,47,113,0.000333,0.204389,9,5518.511256,306.583959,613.167917,190.749723,11,0
1,0,5,6,9,13,22,14,19,33,0.000333,0.049054,4,588.644974,32.702499,147.161243,76.635041,2,0
1,0,11,12,19,24,43,45,46,91,0.000333,0.164597,9,4444.110834,246.895046,493.790093,190.749723,8,0
1,0,2,3,11,10,21,13,11,24,0.000333,0.035139,5,527.078091,29.282116,105.415618,71.273029,1,0
1,0,63,64,25,84,109,346,194,540,0.000333,1.218273,24,87715.66885,4873.092714,3654.819535,653.051068,28,0
1,0,56,57,24,66,90,278,170,448,0.000333,0.96945,24,69800.40449,3877.80025,2908.350187,508.969112,18,0
1,0,66,67,24,83,107,352,217,569,0.000333,1.278632,24,92061.47317,5114.526287,3835.894715,639.167373,26,0
0,0,26,26,24,45,69,165,122,287,0.000333,0.584382,24,42075.51646,2337.528692,1753.146519,357.172489,11,0
0,0,6,6,10,16,26,22,22,44,0.000333,0.06894,5,1034.096738,57.449819,206.819348,97.219281,2,0
0,0,61,61,32,71,103,292,170,462,0.000333,1.029721,32,98853.22379,5491.845766,3089.163244,596.632045,23,0
0,0,61,61,32,71,103,292,170,462,0.000333,1.029721,32,98853.22379,5491.845766,3089.163244,596.632045,23,0
0,0,62,62,32,71,103,297,174,471,0.000333,1.049781,32,100778.9359,5598.829775,3149.341748,596.632045,23,0
1,0,27,28,26,35,61,152,118,270,0.000333,0.533766,39,62450.66417,3469.481342,1601.299081,301.736338,9,0
1,0,22,23,25,31,56,110,87,197,0.000333,0.38135,24,27457.17407,1525.39856,1144.04892,269.67649,8,0
1,0,27,28,26,35,61,152,118,270,0.000333,0.533766,39,62450.66417,3469.481342,1601.299081,301.736338,9,0
1,0,12,13,18,26,44,71,49,120,0.000333,0.218377,9,5896.186148,327.565897,655.131794,197.270083,5,0
1,0,12,13,18,26,44,71,49,120,0.000333,0.218377,9,5896.186148,327.565897,655.131794,197.270083,5,0
1,0,17,18,17,33,50,98,67,165,0.000333,0.310412,16,14899.78034,827.765575,931.236271,235.951874,6,0
1,0,17,18,17,32,49,95,65,160,0.000333,0.299451,16,14373.6572,798.536511,898.353575,229.486868,6,0
1,0,8,9,16,20,36,48,32,80,0.000333,0.137865,8,3308.752001,183.819556,413.594,150.438562,3,0
1,0,8,9,16,20,36,48,32,80,0.000333,0.137865,8,3308.752001,183.819556,413.594,150.438562,3,0
1,0,7,8,13,22,35,41,28,69,0.000333,0.117974,6,2123.523169,117.973509,353.920528,146.213212,4,0
1,0,8,9,15,23,38,61,38,99,0.000333,0.173182,7,3636.813767,202.045209,519.544824,162.645284,4,0
0,0,5,5,14,14,28,39,25,64,0.000333,0.102557,7,2153.695005,119.649723,307.670715,106.605938,3,0
0,0,22,22,25,37,62,89,82,171,0.000333,0.339389,24,24436.02166,1357.556759,1018.167569,308.846179,7,0
0,0,21,21,23,33,56,94,80,174,0.000333,0.336827,22,22230.55464,1235.030813,1010.479756,270.506931,10,0
0,0,27,27,26,35,61,170,121,291,0.000333,0.575282,39,67307.93804,3739.329891,1725.844565,301.736338,9,0
1,0,10,11,17,23,40,44,39,83,0.000333,0.14724,8,3533.760255,196.320014,441.720032,173.528793,4,0
1,0,10,11,17,23,40,44,39,83,0.000333,0.14724,8,3533.760255,196.320014,441.720032,173.528793,4,0
0,0,10,10,15,24,39,44,42,86,0.000333,0.151515,7,3181.812136,176.767341,454.544591,168.642459,6,0
0,0,31,31,28,40,68,136,121,257,0.000333,0.521493,42,65708.07391,3650.44855,1564.47795,347.483062,9,0
0,0,87,87,30,111,141,556,477,1033,0.000333,2.458386,60,442509.3928,24583.85516,7375.156547,901.386879,45,0
0,0,77,77,31,100,131,493,399,892,0.000333,2.091271,45,282321.5993,15684.53329,6273.813317,817.965705,37,0
0,0,81,81,31,102,133,524,424,948,0.000333,2.229469,60,401304.4649,22294.6925,6688.407749,834.167471,39,0
0,0,77,77,30,100,130,499,403,902,0.000333,2.111392,60,380050.546,21113.91923,6334.175767,811.592337,38,0
0,0,81,81,30,102,132,530,428,958,0.000333,2.24951,60,404911.774,22495.09855,6748.529566,827.794103,40,0
0,0,62,62,27,88,115,435,363,798,0.000333,1.8209,52,284060.4552,15781.1364,5462.701061,696.811945,32,0
0,0,62,62,27,88,115,435,363,798,0.000333,1.8209,52,284060.4552,15781.1364,5462.701061,696.811945,32,0
0,0,62,62,27,88,115,435,363,798,0.000333,1.8209,52,284060.4552,15781.1364,5462.701061,696.811945,32,0
0,0,50,50,27,88,115,341,289,630,0.000333,1.437553,39,168193.6906,9344.09392,4312.658732,696.811945,25,0
0,0,50,50,27,88,115,341,289,630,0.000333,1.437553,39,168193.6906,9344.09392,4312.658732,696.811945,25,0
0,0,50,50,27,88,115,341,289,630,0.000333,1.437553,39,168193.6906,9344.09392,4312.658732,696.811945,25,0
0,0,26,26,23,56,79,182,149,331,0.000333,0.695517,22,45904.13141,2550.229523,2086.551428,429.253801,16,0
0,0,26,26,23,56,79,182,149,331,0.000333,0.695517,22,45904.13141,2550.229523,2086.551428,429.253801,16,0
0,0,27,27,17,30,47,84,66,150,0.000333,0.277729,16,13331.01324,740.611847,833.188328,216.693586,7,0
0,0,43,43,21,51,72,209,158,367,0.000333,0.754787,30,67930.87427,3773.937459,2264.362476,381.532358,23,0
0,0,13,13,26,25,51,73,62,135,0.000333,0.255259,26,19910.21295,1106.122942,765.777421,238.307837,5,0
0,0,26,26,24,47,71,258,176,434,0.000333,0.889663,36,96083.649,5337.9805,2668.99025,371.104776,14,0
0,0,5,5,12,16,28,41,36,77,0.000333,0.123389,12,4441.995948,246.777553,370.166329,107.01955,2,0
0,0,47,47,15,43,58,197,128,325,0.000333,0.634615,14,26653.81353,1480.767418,1903.843823,291.932743,25,0
0,0,25,25,19,50,69,139,118,257,0.000333,0.523297,18,28258.03414,1569.890785,1569.890785,362.903432,16,0
0,0,24,24,19,50,69,129,106,235,0.000333,0.478501,18,25839.05845,1435.503247,1435.503247,362.903432,12,0
0,0,22,22,18,46,64,120,100,220,0.000333,0.44,18,23760,1320,1320,329.1425,9,0
0,0,22,22,19,49,68,124,102,226,0.000333,0.458589,18,24763.79884,1375.766602,1375.766602,355.831405,13,0
1,0,20,21,23,29,52,106,92,198,0.000333,0.376229,33,37246.67312,2069.259618,1128.687064,244.923374,6,0
1,0,22,23,23,29,52,110,96,206,0.000333,0.39143,33,38751.5892,2152.866067,1174.290582,244.923374,6,0
0,0,23,23,19,38,57,133,106,239,0.000333,0.464687,18,25093.09284,1394.060713,1394.060713,280.131868,5,0
0,0,23,23,19,38,57,133,106,239,0.000333,0.464687,18,25093.09284,1394.060713,1394.060713,280.131868,5,0
0,0,23,23,19,38,57,133,106,239,0.000333,0.464687,18,25093.09284,1394.060713,1394.060713,280.131868,5,0
0,0,23,23,19,38,57,133,106,239,0.000333,0.464687,18,25093.09284,1394.060713,1394.060713,280.131868,5,0
0,0,23,23,19,38,57,133,106,239,0.000333,0.464687,18,25093.09284,1394.060713,1394.060713,280.131868,5,0
0,0,23,23,19,38,57,133,106,239,0.000333,0.464687,18,25093.09284,1394.060713,1394.060713,280.131868,5,0
0,0,7,7,16,22,38,37,32,69,0.000333,0.120702,8,2896.855987,160.936444,362.106998,162.107496,3,0
2,0,98,100,34,116,150,480,335,815,0.000333,1.963829,34,200310.5659,11128.36477,5891.487233,968.499532,42,0
5,0,112,117,34,129,163,556,386,942,0.000333,2.307501,34,235365.0653,13075.83696,6922.501921,1077.422053,44,0
6,0,115,121,35,139,174,572,402,974,0.000333,2.416476,34,246480.5168,13693.36205,7249.426965,1169.057715,45,0
4,0,122,126,37,133,170,546,395,941,0.000333,2.324079,36,251000.5274,13944.47374,6972.236871,1131.102338,44,0
2,0,103,105,35,133,168,528,363,891,0.000333,2.195518,34,223942.864,12441.27022,6586.554824,1117.87747,41,0
2,0,89,91,36,117,153,439,314,753,0.000333,1.821604,36,196733.2696,10929.62609,5464.813046,989.949972,36,0
2,0,79,81,34,100,134,380,269,649,0.000333,1.528631,34,155920.3241,8662.240226,4585.891885,837.359356,29,0
2,0,83,85,34,102,136,406,285,691,0.000333,1.632479,34,166512.852,9250.714,4897.436823,853.561121,31,0
2,0,94,96,36,124,160,486,327,813,0.000333,1.984243,36,214298.1915,11905.45508,5952.727541,1048.437643,41,0
2,0,84,86,35,112,147,412,293,705,0.000333,1.691923,34,172576.1461,9587.563673,5075.769003,941.948657,32,0
2,0,99,101,37,133,170,500,362,862,0.000333,2.128965,36,229928.2195,12773.78997,6386.894987,1131.102338,43,0
1,0,47,48,30,48,78,237,216,453,0.000333,0.949096,60,170837.2323,9490.95735,2847.287205,415.284918,12,0
1,0,107,108,35,115,150,528,388,916,0.000333,2.207199,51,337701.4939,18761.19411,6621.59792,966.756261,42,0
1,0,88,89,35,101,136,428,322,750,0.000333,1.771866,51,271095.4537,15060.85854,5315.597131,852.004265,29,0
2,0,120,122,36,144,180,584,418,1002,0.000333,2.502279,36,270246.1249,15013.67361,7506.836803,1218.5865,48,0
1,0,104,105,36,117,153,506,365,871,0.000333,2.107062,54,341343.9798,18963.55443,6321.184811,989.949972,43,0
2,0,114,116,38,135,173,580,418,998,0.000333,2.473253,57,422926.2614,23495.90341,7419.758971,1154.791351,49,0
2,0,104,106,36,122,158,521,373,894,0.000333,2.176527,54,352597.3194,19588.73997,6529.579989,1031.667255,42,0
2,0,108,110,36,124,160,547,389,936,0.000333,2.284442,54,370079.5336,20559.97409,6853.324697,1048.437643,44,0
1,0,109,110,36,123,159,516,368,884,0.000333,2.154863,36,232725.1872,12929.17707,6464.588532,1040.046584,44,0
2,0,109,111,37,134,171,553,397,950,0.000333,2.348987,36,253690.556,14093.91978,7046.959889,1139.605726,45,0
2,0,101,103,36,131,167,484,352,836,0.000333,2.057592,36,222219.9644,12345.55358,6172.776789,1107.495713,35,0
2,0,109,111,38,140,178,569,401,970,0.000333,2.417154,38,275555.5343,15308.64079,7251.461428,1197.520868,41,0
1,0,85,86,36,103,139,406,299,705,0.000333,1.672951,36,180678.7244,10037.70691,5018.853456,874.826854,30,0
2,0,95,97,38,124,162,480,352,832,0.000333,2.035585,38,232056.6977,12892.03876,6106.755202,1061.741588,36,0
2,0,85,87,36,108,144,421,307,728,0.000333,1.739902,36,187909.3944,10439.4108,5219.705401,915.64515,29,0
2,0,89,91,36,110,146,447,323,770,0.000333,1.845388,36,199301.9368,11072.32982,5536.16491,932.066869,31,0
1,0,90,91,36,109,145,416,302,718,0.000333,1.718392,36,185586.2902,10310.34945,5155.174727,923.849391,31,0
2,0,100,102,39,131,170,527,365,892,0.000333,2.203059,38,251148.7152,13952.7064,6609.176715,1127.5091,41,0
2,0,90,92,37,120,157,453,331,784,0.000333,1.906328,36,205883.376,11437.96533,5718.982667,1021.576646,32,0
2,0,105,107,40,141,181,541,400,941,0.000333,2.352452,40,282294.1992,15683.01107,7057.35498,1219.553864,43,0
2,0,109,111,35,123,158,538,370,908,0.000333,2.210611,51,338223.4789,18790.19327,6631.832919,1033.45419,50,0
2,0,111,113,35,116,151,571,381,952,0.000333,2.296987,51,351439.0269,19524.39038,6890.961312,975.050701,47,0
2,0,90,92,35,107,142,438,304,742,0.000333,1.768371,34,180373.8203,10020.7678,5305.112363,900.861873,37,0
2,0,87,89,34,103,137,416,291,707,0.000333,1.67277,34,170622.4952,9479.027512,5018.308683,861.683291,34,0
2,0,92,94,36,110,146,465,322,787,0.000333,1.886131,36,203702.1094,11316.78386,5658.391928,932.066869,39,0
2,0,106,108,35,133,168,531,363,894,0.000333,2.202911,34,224696.8804,12483.16002,6608.731776,1117.87747,44,0
2,0,98,100,34,116,150,480,335,815,0.000333,1.963829,34,200310.5659,11128.36477,5891.487233,968.499532,42,0
5,0,112,117,34,129,163,556,386,942,0.000333,2.307501,34,235365.0653,13075.83696,6922.501921,1077.422053,44,0
6,0,115,121,35,139,174,572,402,974,0.000333,2.416476,34,246480.5168,13693.36205,7249.426965,1169.057715,45,0
4,0,122,126,37,133,170,546,395,941,0.000333,2.324079,36,251000.5274,13944.47374,6972.236871,1131.102338,44,0
2,0,103,105,35,133,168,528,363,891,0.000333,2.195518,34,223942.864,12441.27022,6586.554824,1117.87747,41,0
2,0,89,91,36,117,153,439,314,753,0.000333,1.821604,36,196733.2696,10929.62609,5464.813046,989.949972,36,0
2,0,79,81,34,100,134,380,269,649,0.000333,1.528631,34,155920.3241,8662.240226,4585.891885,837.359356,29,0
2,0,83,85,34,102,136,406,285,691,0.000333,1.632479,34,166512.852,9250.714,4897.436823,853.561121,31,0
2,0,94,96,36,124,160,486,327,813,0.000333,1.984243,36,214298.1915,11905.45508,5952.727541,1048.437643,41,0
2,0,84,86,35,112,147,412,293,705,0.000333,1.691923,34,172576.1461,9587.563673,5075.769003,941.948657,32,0
2,0,99,101,37,133,170,500,362,862,0.000333,2.128965,36,229928.2195,12773.78997,6386.894987,1131.102338,43,0
1,0,47,48,30,48,78,237,216,453,0.000333,0.949096,60,170837.2323,9490.95735,2847.287205,415.284918,12,0
1,0,107,108,35,115,150,528,388,916,0.000333,2.207199,51,337701.4939,18761.19411,6621.59792,966.756261,42,0
1,0,88,89,35,101,136,428,322,750,0.000333,1.771866,51,271095.4537,15060.85854,5315.597131,852.004265,29,0
2,0,120,122,36,144,180,584,418,1002,0.000333,2.502279,36,270246.1249,15013.67361,7506.836803,1218.5865,48,0
1,0,104,105,36,117,153,506,365,871,0.000333,2.107062,54,341343.9798,18963.55443,6321.184811,989.949972,43,0
2,0,114,116,38,135,173,580,418,998,0.000333,2.473253,57,422926.2614,23495.90341,7419.758971,1154.791351,49,0
2,0,104,106,36,122,158,521,373,894,0.000333,2.176527,54,352597.3194,19588.73997,6529.579989,1031.667255,42,0
2,0,108,110,36,124,160,547,389,936,0.000333,2.284442,54,370079.5336,20559.97409,6853.324697,1048.437643,44,0
1,0,109,110,36,123,159,516,368,884,0.000333,2.154863,36,232725.1872,12929.17707,6464.588532,1040.046584,44,0
2,0,109,111,37,134,171,553,397,950,0.000333,2.348987,36,253690.556,14093.91978,7046.959889,1139.605726,45,0
2,0,101,103,36,131,167,484,352,836,0.000333,2.057592,36,222219.9644,12345.55358,6172.776789,1107.495713,35,0
2,0,109,111,38,140,178,569,401,970,0.000333,2.417154,38,275555.5343,15308.64079,7251.461428,1197.520868,41,0
1,0,85,86,36,103,139,406,299,705,0.000333,1.672951,36,180678.7244,10037.70691,5018.853456,874.826854,30,0
2,0,95,97,38,124,162,480,352,832,0.000333,2.035585,38,232056.6977,12892.03876,6106.755202,1061.741588,36,0
2,0,85,87,36,108,144,421,307,728,0.000333,1.739902,36,187909.3944,10439.4108,5219.705401,915.64515,29,0
2,0,89,91,36,110,146,447,323,770,0.000333,1.845388,36,199301.9368,11072.32982,5536.16491,932.066869,31,0
1,0,90,91,36,109,145,416,302,718,0.000333,1.718392,36,185586.2902,10310.34945,5155.174727,923.849391,31,0
2,0,100,102,39,131,170,527,365,892,0.000333,2.203059,38,251148.7152,13952.7064,6609.176715,1127.5091,41,0
2,0,90,92,37,120,157,453,331,784,0.000333,1.906328,36,205883.376,11437.96533,5718.982667,1021.576646,32,0
2,0,105,107,40,141,181,541,400,941,0.000333,2.352452,40,282294.1992,15683.01107,7057.35498,1219.553864,43,0
2,0,109,111,35,123,158,538,370,908,0.000333,2.210611,51,338223.4789,18790.19327,6631.832919,1033.45419,50,0
2,0,111,113,35,116,151,571,381,952,0.000333,2.296987,51,351439.0269,19524.39038,6890.961312,975.050701,47,0
2,0,90,92,35,107,142,438,304,742,0.000333,1.768371,34,180373.8203,10020.7678,5305.112363,900.861873,37,0
2,0,87,89,34,103,137,416,291,707,0.000333,1.67277,34,170622.4952,9479.027512,5018.308683,861.683291,34,0
2,0,92,94,36,110,146,465,322,787,0.000333,1.886131,36,203702.1094,11316.78386,5658.391928,932.066869,39,0
2,0,106,108,35,133,168,531,363,894,0.000333,2.202911,34,224696.8804,12483.16002,6608.731776,1117.87747,44,0
2,0,97,99,34,116,150,474,332,806,0.000333,1.942143,34,198098.5474,11005.47486,5826.427865,968.499532,42,0
5,0,111,116,34,129,163,550,383,933,0.000333,2.285454,34,233116.3545,12950.90858,6856.363368,1077.422053,44,0
6,0,114,120,35,139,174,566,399,965,0.000333,2.394147,34,244202.9761,13566.83201,7182.440473,1169.057715,45,0
4,0,121,125,37,133,170,540,392,932,0.000333,2.301851,36,248599.8847,13811.10471,6905.552352,1131.102338,44,0
2,0,102,104,35,133,168,522,360,882,0.000333,2.173341,34,221680.8149,12315.60083,6520.023967,1117.87747,41,0
2,0,88,90,36,117,153,433,311,744,0.000333,1.799832,36,194381.876,10798.99311,5399.496555,989.949972,36,0
2,0,78,80,34,100,134,374,266,640,0.000333,1.507432,34,153758.1008,8542.11671,4522.297082,837.359356,29,0
2,0,82,84,34,102,136,400,282,682,0.000333,1.611217,34,164344.0884,9130.227131,4833.649658,853.561121,31,0
2,0,93,95,36,124,160,480,324,804,0.000333,1.962277,36,211925.8868,11773.66038,5886.830188,1048.437643,41,0
2,0,83,85,35,112,147,406,290,696,0.000333,1.670324,34,170373.0464,9465.169243,5010.971952,941.948657,32,0
2,0,98,100,37,133,170,494,359,853,0.000333,2.106737,36,227527.5769,12640.42094,6320.210469,1131.102338,43,0
1,0,46,47,30,48,78,231,213,444,0.000333,0.93024,60,167443.1151,9302.395284,2790.718585,415.284918,12,0
1,0,106,107,35,115,150,522,385,907,0.000333,2.185513,51,334383.4662,18576.85923,6556.538552,966.756261,42,0
1,0,87,88,35,101,136,422,319,741,0.000333,1.750603,51,267842.3082,14880.12824,5251.809965,852.004265,29,0
2,0,119,121,36,144,180,578,415,993,0.000333,2.479803,36,267818.7645,14878.82025,7439.410125,1218.5865,48,0
1,0,103,104,36,117,153,500,362,862,0.000333,2.085289,54,337816.8893,18767.60496,6255.86832,989.949972,43,0
2,0,113,115,38,135,173,574,415,989,0.000333,2.450949,57,419112.2971,23284.0165,7352.847317,1154.791351,49,0
2,0,103,105,36,122,158,515,370,885,0.000333,2.154615,54,349047.682,19391.53789,6463.845962,1031.667255,42,0
2,0,107,109,36,124,160,541,386,927,0.000333,2.262476,54,366521.0766,20362.28203,6787.427344,1048.437643,44,0
1,0,108,109,36,123,159,510,365,875,0.000333,2.132924,36,230355.8131,12797.54517,6398.772586,1040.046584,44,0
2,0,108,110,37,134,171,547,394,941,0.000333,2.326733,36,251287.1718,13960.39843,6980.199217,1139.605726,45,0
2,0,100,102,36,131,167,478,349,827,0.000333,2.035441,36,219827.6442,12212.6469,6106.32345,1107.495713,35,0
2,0,108,110,38,140,178,563,398,961,0.000333,2.394727,38,272998.8334,15166.60186,7184.179827,1197.520868,41,0
1,0,84,85,36,103,139,400,296,696,0.000333,1.651594,36,178372.1875,9909.565973,4954.782987,874.826854,30,0
2,0,94,96,38,124,162,474,349,823,0.000333,2.013566,38,229546.469,12752.58161,6040.696552,1061.741588,36,0
2,0,84,86,36,108,144,415,304,719,0.000333,1.718392,36,185586.3387,10310.35215,5155.176076,915.64515,29,0
2,0,88,90,36,110,146,441,320,761,0.000333,1.823819,36,196972.4336,10942.91298,5471.456489,932.066869,31,0
1,0,89,90,36,109,145,410,299,709,0.000333,1.696852,36,183259.9996,10181.11109,5090.555545,923.849391,31,0
2,0,99,101,39,131,170,521,362,883,0.000333,2.180831,38,248614.7035,13811.92797,6542.492197,1127.5091,41,0
2,0,89,91,37,120,157,447,328,775,0.000333,1.884444,36,203519.9189,11306.66216,5653.33108,1021.576646,32,0
2,0,104,106,40,141,181,535,397,932,0.000333,2.329952,40,279594.2547,15533.01415,6989.856367,1219.553864,43,0
2,0,108,110,35,123,158,532,367,899,0.000333,2.1887,34,223247.3623,12402.63124,6566.098893,1033.45419,50,0
2,0,110,112,35,116,151,565,378,943,0.000333,2.275272,51,348116.5991,19339.81106,6825.815669,975.050701,47,0
2,0,89,91,35,107,142,432,301,733,0.000333,1.746922,34,178185.9977,9899.222095,5240.764639,900.861873,37,0
2,0,86,88,34,103,137,410,288,698,0.000333,1.651475,34,168450.4974,9358.360966,4954.426394,861.683291,34,0
2,0,91,93,36,110,146,459,319,778,0.000333,1.864561,36,201372.6062,11187.36701,5593.683507,932.066869,39,0
2,0,105,107,35,133,168,525,360,885,0.000333,2.180734,34,222434.8313,12357.49063,6542.200919,1117.87747,44,0
4,0,41,45,33,57,90,205,150,355,0.000333,0.768203,32,73747.45117,4097.080621,2304.607849,498.939737,22,0
4,0,41,45,33,58,91,206,152,358,0.000333,0.776597,32,74553.2954,4141.849744,2329.790481,506.227904,22,0
6,0,78,84,37,84,121,394,260,654,0.000333,1.508312,54,244346.5741,13574.80967,4524.936557,729.704438,34,0
2,0,64,66,37,72,109,314,207,521,0.000333,1.175408,36,126944.0652,7052.448066,3526.224033,636.984375,31,0
6,0,80,86,37,89,126,419,280,699,0.000333,1.625706,54,263364.408,14631.356,4877.118667,769.09005,36,0
1,0,41,42,33,40,73,176,115,291,0.000333,0.600413,32,57639.64629,3202.202572,1801.238947,379.34213,23,0
1,0,41,42,33,39,72,176,115,291,0.000333,0.598483,32,57454.34161,3191.907867,1795.448175,372.595692,23,0
1,0,42,43,32,50,82,191,138,329,0.000333,0.697212,32,66932.30751,3718.461528,2091.63461,442.192809,23,0
1,0,42,43,32,49,81,190,136,326,0.000333,0.68893,32,66137.31523,3674.295291,2066.791101,435.120782,23,0
5,0,70,75,35,68,103,327,208,535,0.000333,1.192426,51,182441.1669,10135.62038,3577.277782,593.472379,33,0
0,0,69,69,32,44,76,302,178,480,0.000333,0.999668,64,191936.3332,10663.12962,2999.005206,400.214991,39,0
0,0,55,55,32,45,77,241,151,392,0.000333,0.81886,48,117915.8556,6550.880864,2456.580324,407.133389,31,0
1,0,58,59,33,51,84,254,156,410,0.000333,0.873617,48,125800.8069,6988.933716,2620.850143,455.758698,32,0
2,0,45,47,33,48,81,232,152,384,0.000333,0.811501,48,116856.1153,6492.006403,2434.502401,434.543206,28,0
2,0,47,49,33,48,81,226,151,377,0.000333,0.796708,48,114725.9257,6373.662536,2390.123451,434.543206,27,0
1,0,47,48,33,45,78,211,140,351,0.000333,0.735392,48,105896.4566,5883.136477,2206.176179,413.598395,27,0
1,0,51,52,33,51,84,251,160,411,0.000333,0.875747,48,126107.6381,7005.979895,2627.242461,455.758698,30,0
6,0,96,102,30,118,148,536,355,891,0.000333,2.141208,45,289063.0327,16059.05737,6423.622949,959.358598,34,0
2,0,11,13,15,24,39,61,39,100,0.000333,0.17618,7,3699.781553,205.54342,528.540222,168.642459,5,0
4,0,23,27,27,49,76,137,99,236,0.000333,0.491504,26,38337.28322,2129.849068,1474.510893,403.502745,12,0
4,0,23,27,27,50,77,138,101,239,0.000333,0.499254,26,38941.81156,2163.433976,1497.761983,410.574772,12,0
6,0,60,66,31,75,106,326,209,535,0.000333,1.199812,30,107983.1233,5999.062405,3599.437443,620.741487,24,0
2,0,46,48,31,63,94,246,156,402,0.000333,0.878315,30,79048.34155,4391.574531,2634.944718,530.148721,21,0
6,0,62,68,31,80,111,351,229,580,0.000333,1.313587,30,118222.8361,6567.935337,3940.761202,659.334333,26,0
1,0,23,24,27,31,58,108,64,172,0.000333,0.335858,26,26196.89101,1455.382834,1007.572731,281.962048,13,0
1,0,23,24,27,31,58,108,64,172,0.000333,0.335858,26,26196.89101,1455.382834,1007.572731,281.962048,13,0
1,0,24,25,26,41,67,123,87,210,0.000333,0.424626,26,33120.84698,1840.047054,1273.87873,341.871065,13,0
1,0,24,25,26,40,66,122,85,207,0.000333,0.417063,26,32530.92915,1807.273842,1251.189583,335.088556,13,0
5,0,52,57,29,59,88,259,157,416,0.000333,0.895708,28,75239.45949,4179.969972,2687.123553,487.957389,23,0
0,0,51,51,26,35,61,234,127,361,0.000333,0.713665,39,83498.85098,4638.825054,2140.996179,301.736338,29,0
0,0,37,37,26,36,62,173,100,273,0.000333,0.541832,26,42262.88541,2347.938078,1625.495593,308.328733,21,0
1,0,40,41,27,43,70,186,105,291,0.000333,0.59454,26,46374.15531,2576.341961,1783.621358,361.711347,22,0
2,0,27,29,27,39,66,164,101,265,0.000333,0.533921,26,41645.87548,2313.659749,1601.764442,334.512649,18,0
2,0,29,31,27,39,66,158,100,258,0.000333,0.519818,26,40545.79575,2252.544208,1559.453683,334.512649,17,0
1,0,29,30,27,36,63,143,89,232,0.000333,0.462243,26,36054.9525,2003.052917,1386.728942,314.499263,17,0
1,0,33,34,27,42,69,183,109,292,0.000333,0.594563,26,46375.91768,2576.439871,1783.689141,354.859294,20,0
3,0,36,39,35,60,95,188,132,320,0.000333,0.700785,34,71480.02902,3971.112723,2102.353795,533.938341,6,0
2,0,20,22,25,38,63,92,69,161,0.000333,0.320781,12,11548.10481,641.561378,962.342068,315.51765,4,0
2,0,26,28,27,44,71,126,90,216,0.000333,0.442782,26,34536.97982,1918.721101,1328.345378,368.596954,9,0
5,0,42,47,31,59,90,200,142,342,0.000333,0.740071,30,66606.41277,3700.356265,2220.213759,500.656026,7,0
2,0,20,22,26,40,66,97,71,168,0.000333,0.338486,13,13200.95676,733.386486,1015.458212,335.088556,4,0
2,0,26,28,28,46,74,131,92,223,0.000333,0.461569,28,38771.82682,2153.990379,1384.708101,388.689788,9,0
7,0,45,52,32,58,90,215,150,365,0.000333,0.789842,32,75824.84417,4212.491343,2369.52638,499.762898,10,0
2,0,25,27,28,44,72,112,87,199,0.000333,0.409272,14,17189.41105,954.967281,1227.815075,374.820929,4,0
1,0,43,44,31,43,74,187,137,324,0.000333,0.670621,45,90533.83007,5029.657226,2011.86289,386.90947,9,0
2,0,57,59,33,71,104,281,198,479,0.000333,1.069837,32,102704.34,5705.796667,3209.510625,603.097051,14,0
2,0,40,42,34,53,87,190,138,328,0.000333,0.704428,34,71851.70587,3991.761437,2113.285467,476.553521,11,0
2,0,36,38,31,49,80,162,123,285,0.000333,0.600583,30,54052.48521,3002.915845,1801.749507,428.700868,7,0
3,0,49,52,32,57,89,213,160,373,0.000333,0.80515,32,77294.35423,4294.130791,2415.44857,492.474731,9,0
2,0,46,48,32,53,85,197,149,346,0.000333,0.739216,32,70964.77645,3942.48758,2217.649264,463.579784,8,0
1,0,42,43,31,44,75,177,132,309,0.000333,0.641568,45,86611.72389,4811.762438,1924.704975,393.795077,8,0
1,0,54,55,32,65,97,266,187,453,0.000333,0.996587,32,95672.33656,5315.129809,2989.760518,551.453908,14,0
1,0,62,63,32,65,97,316,214,530,0.000333,1.165985,48,167901.7827,9327.876817,3497.953806,551.453908,16,0
2,0,50,52,34,75,109,259,180,439,0.000333,0.990411,34,101021.9192,5612.328846,2971.232919,640.135138,15,0
2,0,46,48,32,71,103,231,165,396,0.000333,0.882618,32,84731.33468,4707.296371,2647.854209,596.632045,11,0
1,0,53,54,32,69,101,251,179,430,0.000333,0.954344,32,91616.99,5089.832778,2863.030938,581.488188,13,0
1,0,53,54,32,68,100,251,180,431,0.000333,0.954501,32,91632.06457,5090.670254,2863.502018,573.947473,12,0
1,0,52,53,32,66,98,246,174,420,0.000333,0.926059,32,88901.70031,4938.98335,2778.178135,558.930012,12,0
1,0,43,44,31,48,79,182,137,319,0.000333,0.670302,30,60327.18176,3351.510098,2010.906059,421.658286,9,0
1,0,53,54,32,69,101,251,179,430,0.000333,0.954344,32,91616.99,5089.832778,2863.030938,581.488188,13,0
2,0,39,41,30,53,83,175,130,305,0.000333,0.648129,30,58331.6108,3240.645044,1944.387027,450.786502,10,0
2,0,35,37,28,49,77,147,115,262,0.000333,0.547299,28,45973.14606,2554.06367,1641.898074,409.72672,6,0
1,0,42,43,27,43,70,167,129,296,0.000333,0.604756,39,70756.44315,3930.913508,1814.267773,361.711347,8,0
1,0,42,43,27,43,70,167,130,297,0.000333,0.606799,39,70995.48519,3944.193621,1820.397056,361.711347,7,0
1,0,41,42,29,48,77,162,124,286,0.000333,0.597434,28,50184.42662,2788.023701,1792.300951,408.959649,7,0
1,0,43,44,31,47,78,182,138,320,0.000333,0.670443,30,60339.8613,3352.214517,2011.32871,414.645762,8,0
1,0,53,54,32,68,100,251,180,431,0.000333,0.954501,32,91632.06457,5090.670254,2863.502018,573.947473,12,0
2,0,39,41,30,52,82,175,131,306,0.000333,0.64847,30,58362.3274,3242.351522,1945.410913,443.629583,9,0
2,0,35,37,28,48,76,147,116,263,0.000333,0.547735,28,46009.73821,2556.096567,1643.204936,402.684138,5,0
1,0,42,43,27,43,70,167,130,297,0.000333,0.606799,39,70995.48519,3944.193621,1820.397056,361.711347,7,0
1,0,42,43,27,42,69,167,131,298,0.000333,0.60678,39,70993.27124,3944.070624,1820.340288,354.859294,6,0
1,0,41,42,29,47,76,162,125,287,0.000333,0.597718,28,50208.3455,2789.352528,1793.155196,401.947125,6,0
1,0,42,43,31,44,75,177,132,309,0.000333,0.641568,45,86611.72389,4811.762438,1924.704975,393.795077,8,0
1,0,52,53,32,66,98,246,174,420,0.000333,0.926059,32,88901.70031,4938.98335,2778.178135,558.930012,12,0
2,0,38,40,32,53,85,170,125,295,0.000333,0.630257,32,60504.65044,3361.369469,1890.770326,463.579784,9,0
2,0,34,36,29,49,78,142,110,252,0.000333,0.527974,28,44349.79806,2463.87767,1583.921359,416.002231,5,0
1,0,41,42,29,48,77,162,124,286,0.000333,0.597434,28,50184.42662,2788.023701,1792.300951,408.959649,7,0
1,0,41,42,29,47,76,162,125,287,0.000333,0.597718,28,50208.3455,2789.352528,1793.155196,401.947125,6,0
1,0,40,41,29,43,72,157,119,276,0.000333,0.567633,28,47681.18041,2648.954467,1702.8993,374.210833,6,0
3,0,34,37,32,57,89,178,123,301,0.000333,0.649732,32,62374.26441,3465.236912,1949.195763,492.474731,6,0
2,0,18,20,23,35,58,82,60,142,0.000333,0.277278,11,9150.166314,508.342573,831.833301,283.566831,4,0
2,0,24,26,25,42,67,116,81,197,0.000333,0.39834,12,14340.23485,796.679714,1195.019571,342.573737,9,0
5,0,40,45,28,56,84,190,133,323,0.000333,0.68824,28,57812.11877,3211.784376,2064.718528,459.817813,7,0
2,0,18,20,24,37,61,87,62,149,0.000333,0.29456,12,10604.15836,589.119909,883.679863,302.788875,4,0
2,0,24,26,26,44,70,121,83,204,0.000333,0.416791,13,16254.85856,903.047698,1250.373735,362.426424,9,0
7,0,43,50,29,55,84,205,141,346,0.000333,0.737247,28,61928.77119,3440.487288,2211.741828,458.856233,10,0
2,0,23,25,25,41,66,102,78,180,0.000333,0.362664,12,13055.8913,725.327294,1087.990941,335.756037,4,0
1,0,41,42,28,40,68,177,128,305,0.000333,0.618892,42,77980.399,4332.244389,1856.676167,347.483062,9,0
2,0,55,57,31,68,99,271,189,460,0.000333,1.016501,30,91485.12136,5082.506742,3049.504045,567.527559,14,0
2,0,38,40,31,50,81,180,129,309,0.000333,0.653005,30,58770.40953,3265.022751,1959.013651,435.772895,11,0
2,0,34,36,28,46,74,152,114,266,0.000333,0.550572,28,46248.00867,2569.333815,1651.714595,388.689788,7,0
3,0,47,50,29,54,83,203,151,354,0.000333,0.752255,28,63189.39084,3510.521714,2256.763959,451.645374,9,0
2,0,44,46,29,50,79,187,140,327,0.000333,0.687112,28,57717.41653,3206.523141,2061.336305,423.074258,8,0
1,0,40,41,28,41,69,167,123,290,0.000333,0.590491,42,74401.82788,4133.434882,1771.472092,354.26557,8,0
1,0,52,53,30,62,92,256,178,434,0.000333,0.943742,30,84936.77667,4718.709815,2831.225889,516.366889,14,0
1,0,60,61,30,62,92,306,205,511,0.000333,1.11118,45,150009.3072,8333.850399,3333.54016,516.366889,16,0
2,0,48,50,32,72,104,249,171,420,0.000333,0.938062,32,90053.90981,5002.99499,2814.184682,604.2346,15,0
2,0,44,46,30,68,98,221,156,377,0.000333,0.831249,30,74812.36834,4156.242685,2493.745611,561.154191,11,0
1,0,51,52,30,66,96,241,170,411,0.000333,0.90214,30,81192.58763,4510.699313,2706.419588,546.13673,13,0
1,0,51,52,30,65,95,241,171,412,0.000333,0.90226,30,81203.41532,4511.300851,2706.780511,538.660626,12,0
1,0,50,51,30,63,93,236,165,401,0.000333,0.874068,30,78666.0805,4370.337805,2622.202683,523.775353,12,0
1,0,41,42,28,45,73,172,128,300,0.000333,0.618982,28,51994.5263,2888.584794,1856.947368,381.739327,9,0
1,0,51,52,30,66,96,241,170,411,0.000333,0.90214,30,81192.58763,4510.699313,2706.419588,546.13673,13,0
2,0,37,39,27,50,77,165,121,286,0.000333,0.597434,26,46599.82472,2588.879151,1792.300951,410.574772,10,0
2,0,33,35,25,46,71,137,106,243,0.000333,0.49813,24,35865.3252,1992.518067,1494.38855,370.180255,6,0
1,0,40,41,24,40,64,157,120,277,0.000333,0.554,36,59832,3324,1662,322.916224,8,0
1,0,40,41,24,40,64,157,121,278,0.000333,0.556,36,60048,3336,1668,322.916224,7,0
1,0,39,40,26,45,71,152,115,267,0.000333,0.547327,26,42691.5445,2371.752472,1641.982481,369.344822,7,0
1,0,41,42,28,44,72,172,129,301,0.000333,0.619049,28,52000.12791,2888.895995,1857.147425,374.820929,8,0
1,0,51,52,30,65,95,241,171,412,0.000333,0.90226,30,81203.41532,4511.300851,2706.780511,538.660626,12,0
2,0,37,39,27,49,76,165,122,287,0.000333,0.597718,26,46622.03511,2590.113061,1793.155196,403.502745,9,0
2,0,33,35,25,45,70,137,107,244,0.000333,0.498515,24,35893.08135,1994.060075,1495.545056,363.229794,5,0
1,0,40,41,24,40,64,157,121,278,0.000333,0.556,36,60048,3336,1668,322.916224,7,0
1,0,40,41,24,39,63,157,122,279,0.000333,0.555887,36,60035.79955,3335.322197,1667.661099,316.169787,6,0
1,0,39,40,26,44,70,152,116,268,0.000333,0.547549,26,42708.84406,2372.713559,1642.647849,362.426424,6,0
1,0,40,41,28,41,69,167,123,290,0.000333,0.590491,42,74401.82788,4133.434882,1771.472092,354.26557,8,0
1,0,50,51,30,63,93,236,165,401,0.000333,0.874068,30,78666.0805,4370.337805,2622.202683,523.775353,12,0
2,0,36,38,29,50,79,160,116,276,0.000333,0.579948,28,48715.61762,2706.423201,1739.843486,423.074258,9,0
2,0,32,34,26,46,72,132,101,233,0.000333,0.479198,26,37377.40566,2076.522537,1437.592525,376.295283,5,0
1,0,39,40,26,45,71,152,115,267,0.000333,0.547327,26,42691.5445,2371.752472,1641.982481,369.344822,7,0
1,0,39,40,26,44,70,152,116,268,0.000333,0.547549,26,42708.84406,2372.713559,1642.647849,362.426424,6,0
1,0,38,39,26,40,66,147,110,257,0.000333,0.517803,26,40388.64151,2243.813417,1553.409289,335.088556,6,0
1,0,9,10,20,19,39,59,37,96,0.000333,0.169133,10,5073.98613,281.888118,507.398613,167.149185,1,0
8,0,95,103,27,118,145,516,331,847,0.000333,2.027128,26,158115.958,8784.219888,6081.382999,940.533842,34,0
1,0,38,39,19,58,77,209,137,346,0.000333,0.722769,18,39029.54658,2168.308143,2168.308143,420.47352,18,0
4,0,52,56,20,72,92,285,188,473,0.000333,1.028548,20,61712.8961,3428.494228,3085.644805,530.673162,20,0
7,0,91,98,28,114,142,491,312,803,0.000333,1.913749,28,160754.9142,8930.828569,5741.246937,913.555399,35,0
5,0,55,60,23,83,106,301,204,505,0.000333,1.132533,22,74747.19625,4152.622014,3397.59983,633.170198,21,0
2,0,64,66,30,102,132,361,253,614,0.000333,1.441753,30,129757.7397,7208.763315,4325.257989,827.794103,32,0
1,0,107,108,28,96,124,582,385,967,0.000333,2.241569,56,376583.6386,20921.31326,6724.707832,766.762338,57,0
1,0,97,98,26,83,109,523,340,863,0.000333,1.946981,52,303729.0398,16873.83554,5840.943072,651.339705,50,0
1,0,101,102,26,84,110,549,356,905,0.000333,2.04571,52,319130.7881,17729.48823,6137.130541,659.166096,52,0
1,0,102,103,27,95,122,555,364,919,0.000333,2.123116,39,248404.5569,13800.25316,6369.347613,752.518245,53,0
1,0,49,50,24,69,93,267,172,439,0.000333,0.956897,24,68896.57723,3827.587624,2870.690718,531.527288,26,0
2,0,68,70,25,83,108,334,219,553,0.000333,1.245151,24,89650.86693,4980.603718,3735.452789,645.224678,27,0
6,0,84,90,26,96,122,439,292,731,0.000333,1.68879,39,197588.3908,10977.13282,5066.368994,754.367833,32,0
7,0,89,96,25,109,134,538,348,886,0.000333,2.086852,36,225379.9808,12521.11005,6260.555023,853.828496,42,0
1,0,65,66,24,95,119,360,231,591,0.000333,1.358279,24,97796.09516,5433.116397,4074.837298,734.175383,33,0
1,0,108,109,29,93,122,581,375,956,0.000333,2.208595,56,371043.9541,20613.55301,6625.784895,749.023218,58,0
1,0,105,106,29,89,118,559,362,921,0.000333,2.112971,56,354979.1979,19721.06655,6338.914248,717.221724,55,0
8,0,91,99,27,114,141,482,313,795,0.000333,1.891981,26,147574.5265,8198.584803,5675.943325,907.331424,30,0
1,0,34,35,17,53,70,175,119,294,0.000333,0.60067,16,28832.14731,1601.785962,1802.009207,373.066652,14,0
4,0,48,52,20,68,88,251,170,421,0.000333,0.906474,20,54388.41423,3021.578568,2719.420711,500.386035,16,0
7,0,87,94,28,108,136,457,294,751,0.000333,1.774228,28,149035.1686,8279.73159,5322.684594,864.133788,31,0
5,0,51,56,23,77,100,267,186,453,0.000333,1.003222,22,66212.67079,3678.48171,3009.666854,586.584489,17,0
2,0,60,62,30,97,127,327,235,562,0.000333,1.309214,30,117829.2238,6546.06799,3927.640794,787.398264,28,0
2,0,114,116,28,111,139,581,384,965,0.000333,2.289926,42,288530.6817,16029.48232,6869.778135,888.786099,53,0
1,0,103,104,28,95,123,548,367,915,0.000333,2.117467,42,266800.8324,14822.26847,6352.400772,758.742221,53,0
1,0,93,94,26,82,108,489,322,811,0.000333,1.826071,39,213650.3368,11869.46316,5478.213764,643.530697,46,0
1,0,97,98,26,83,109,515,338,853,0.000333,1.92442,52,300209.5839,16678.31022,5773.261229,651.339705,48,0
1,0,98,99,27,94,121,521,346,867,0.000333,1.999551,39,233947.5226,12997.08459,5998.654427,744.513315,49,0
1,0,45,46,24,63,87,233,154,387,0.000333,0.83114,24,59842.05919,3324.558844,2493.419133,486.607735,22,0
2,0,64,66,25,77,102,300,201,501,0.000333,1.114295,24,80229.24231,4457.180128,3342.885096,598.638968,23,0
6,0,80,86,26,92,118,405,274,679,0.000333,1.557772,26,121506.1804,6750.343355,4673.314631,722.379133,28,0
7,0,85,92,24,104,128,504,330,834,0.000333,1.946,36,210168,11676,5838,806.884831,38,0
1,0,61,62,23,90,113,326,213,539,0.000333,1.225359,22,80873.68214,4492.982341,3676.076461,688.308704,29,0
1,0,104,105,29,92,121,547,357,904,0.000333,2.084884,42,262695.3994,14594.18886,6254.652366,741.049149,54,0
1,0,101,102,29,88,117,525,344,869,0.000333,1.990116,42,250754.5715,13930.80953,5970.346941,709.311431,51,0
1,0,106,107,30,94,124,574,375,949,0.000333,2.199844,45,296978.9534,16498.83075,6599.532299,763.33807,56,0
1,0,62,63,26,82,108,348,226,574,0.000333,1.292435,26,100809.9411,5600.552282,3877.305426,643.530697,33,0
4,0,76,80,26,94,120,424,277,701,0.000333,1.61391,26,125884.988,6993.610444,4841.730308,738.342785,35,0
5,0,79,84,27,106,133,440,293,733,0.000333,1.723841,26,134459.5727,7469.976259,5171.522025,841.541531,36,0
2,0,88,90,32,123,155,500,342,842,0.000333,2.042166,32,196047.896,10891.54978,6126.496749,1013.929284,47,0
1,0,73,74,29,92,121,406,261,667,0.000333,1.538294,28,129216.6898,7178.70499,4614.881779,741.049149,41,0
2,0,92,94,30,105,135,473,308,781,0.000333,1.842331,30,165809.7894,9211.654969,5526.992981,852.202497,42,0
6,0,108,114,30,117,147,578,381,959,0.000333,2.301495,45,310701.86,17261.21445,6904.485779,951.03939,47,0
1,0,89,90,28,116,144,499,320,819,0.000333,1.95739,28,164420.7201,9134.484452,5872.168576,930.131733,48,0
8,0,92,100,27,118,145,489,321,810,0.000333,1.938575,26,151208.8854,8400.493635,5815.726363,940.533842,29,0
1,0,35,36,18,58,76,182,127,309,0.000333,0.643537,18,34750.97283,1930.609602,1930.609602,414.821548,13,0
4,0,49,53,21,72,93,258,178,436,0.000333,0.950358,20,57021.46483,3167.859157,2851.073242,536.473266,15,0
7,0,88,95,28,113,141,464,302,766,0.000333,1.822965,28,153129.0974,8507.172078,5468.896336,905.286161,30,0
5,0,52,57,24,82,106,274,194,468,0.000333,1.049556,24,75568.00255,4198.222364,3148.666773,631.358364,16,0
2,0,61,63,31,101,132,334,243,577,0.000333,1.354872,30,121938.4622,6774.359011,4064.615407,826.059445,27,0
1,0,110,111,27,104,131,559,375,934,0.000333,2.189739,39,256199.4663,14233.30368,6569.217083,825.227693,51,0
1,0,104,105,28,96,124,555,375,930,0.000333,2.155801,42,271630.9079,15090.60599,6467.402569,766.762338,52,0
1,0,94,95,26,83,109,496,330,826,0.000333,1.863507,39,218030.2898,12112.79388,5590.520252,651.339705,45,0
1,0,98,99,26,84,110,522,346,868,0.000333,1.962073,52,306083.452,17004.63622,5886.220231,659.166096,47,0
1,0,99,100,27,95,122,528,354,882,0.000333,2.037637,39,238403.5029,13244.63905,6112.910332,752.518245,48,0
1,0,46,47,24,68,92,240,162,402,0.000333,0.874157,24,62939.32575,3496.629208,2622.471906,523.986573,21,0
2,0,65,67,26,82,108,307,209,516,0.000333,1.161841,26,90623.57073,5034.642818,3485.521951,643.530697,22,0
6,0,81,87,26,97,123,412,282,694,0.000333,1.606035,26,125270.7317,6959.485096,4818.105067,762.402978,27,0
7,0,86,93,24,108,132,511,338,849,0.000333,1.993564,36,215304.8619,11961.38122,5980.690607,839.56695,37,0
1,0,62,63,23,94,117,333,221,554,0.000333,1.268727,22,83736.0052,4652.000289,3806.182055,720.173277,28,0
1,0,105,106,29,93,122,554,365,919,0.000333,2.123116,42,267512.5998,14861.8111,6369.347613,749.023218,53,0
1,0,102,103,29,89,118,532,352,884,0.000333,2.028085,42,255538.7711,14196.5984,6084.256456,717.221724,50,0
1,0,107,108,30,95,125,581,383,964,0.000333,2.238339,60,402900.963,22383.38684,6715.01605,771.343001,55,0
8,0,34,42,18,54,72,204,136,340,0.000333,0.699258,18,37759.94101,2097.7745,2097.7745,385.822575,6,0
4,0,45,49,21,44,65,225,154,379,0.000333,0.760826,30,68474.32203,3804.129002,2282.477401,332.453657,19,0
0,0,88,88,26,78,104,414,301,715,0.000333,1.596938,39,186841.7615,10380.09786,4790.814398,612.472806,34,0
0,0,87,87,26,78,104,405,295,700,0.000333,1.563436,39,182922.0043,10162.33357,4690.307803,612.472806,33,0
0,0,88,88,26,78,104,414,301,715,0.000333,1.596938,39,186841.7615,10380.09786,4790.814398,612.472806,34,0
0,0,35,35,14,60,74,326,279,605,0.000333,1.25224,28,105188.14,5843.785556,3756.719286,407.716405,1,0
0,0,36,36,20,54,74,147,106,253,0.000333,0.523664,10,15709.91702,872.773168,1570.991702,397.202487,25,0
0,0,15,15,18,26,44,83,56,139,0.000333,0.252954,18,13659.49791,758.860995,758.860995,197.270083,4,0
0,0,27,27,24,48,72,152,96,248,0.000333,0.510047,24,36723.39361,2040.188534,1530.1414,378.1173,21,0
0,0,18,18,23,35,58,97,71,168,0.000333,0.328047,22,21651.09776,1202.838764,984.140807,283.566831,6,0
0,0,25,25,22,48,70,148,97,245,0.000333,0.500558,22,33036.83546,1835.379748,1501.674339,366.185696,17,0
0,0,77,77,25,115,140,349,281,630,0.000333,1.497149,24,107794.7592,5988.597734,4491.448301,903.327761,55,0
0,0,55,55,23,77,100,259,187,446,0.000333,0.98772,22,65189.51693,3621.63983,2963.159861,586.584489,49,0
0,0,62,62,24,82,106,306,201,507,0.000333,1.137019,24,81865.33609,4548.074227,3411.05567,631.358364,50,0
0,0,46,46,21,67,88,229,154,383,0.000333,0.824654,20,49479.2462,2748.847011,2473.96231,498.666642,39,0
0,0,43,43,19,67,86,212,148,360,0.000333,0.771152,18,41642.19561,2313.455312,2313.455312,487.138599,31,0
0,0,54,54,26,68,94,263,179,442,0.000333,0.965709,26,75325.33508,4184.740838,2897.128272,536.158906,31,0
0,0,48,48,26,66,92,216,159,375,0.000333,0.815445,26,63604.72907,3533.59606,2446.335734,521.141445,8,0
0,0,58,58,25,65,90,315,196,511,0.000333,1.105779,36,119424.1296,6634.673864,3317.336932,507.550313,32,0
0,0,44,44,25,63,88,237,148,385,0.000333,0.82896,24,59685.14816,3315.841564,2486.881173,492.66504,28,0
0,0,32,32,21,59,80,162,127,289,0.000333,0.609012,20,36540.74439,2030.041355,1827.037219,439.314606,22,0
0,0,34,34,21,68,89,167,130,297,0.000333,0.641098,10,19232.92829,1068.496016,1923.292829,506.186139,27,0
0,0,38,38,18,75,93,185,146,331,0.000333,0.721487,9,19480.1541,1082.230783,2164.461566,542.220052,40,0
0,0,50,50,22,83,105,238,183,421,0.000333,0.942232,22,62187.34199,3454.852332,2826.697363,627.235768,58,0
0,0,57,57,22,88,110,285,197,482,0.000333,1.089538,22,71909.5384,3994.974356,3268.615382,666.537478,59,0
0,0,41,41,18,73,91,208,150,358,0.000333,0.776597,18,41936.22866,2329.790481,2329.790481,526.915843,48,0
0,0,38,38,18,73,91,191,144,335,0.000333,0.726704,9,19621.00084,1090.055602,2180.111204,526.915843,40,0
0,0,34,34,20,71,91,167,133,300,0.000333,0.650779,10,19523.38392,1084.63244,1952.338392,523.070607,42,0
0,0,46,46,25,74,99,266,195,461,0.000333,1.018711,24,73347.20165,4074.844536,3056.133402,575.595954,23,0
0,0,28,28,16,44,60,143,105,248,0.000333,0.488303,16,23438.54188,1302.141216,1464.908868,304.214991,9,0
0,0,41,41,25,59,84,223,156,379,0.000333,0.807563,24,58144.51928,3230.251071,2422.688303,463.172345,23,0
0,0,68,68,36,86,122,358,252,610,0.000333,1.40925,36,152198.9919,8455.499552,4227.749776,738.776069,34,0
0,0,82,82,34,113,147,418,310,728,0.000333,1.74712,34,178206.2899,9900.349438,5241.361467,943.653959,41,0
0,0,74,74,37,98,135,384,263,647,0.000333,1.526233,36,164833.1889,9157.399383,4578.699691,840.991339,43,0
0,0,50,50,35,75,110,282,194,476,0.000333,1.075976,34,109749.5256,6097.195867,3227.927224,646.686307,28,0
0,0,64,64,32,101,133,342,252,594,0.000333,1.396946,32,134106.8085,7450.378252,4190.837767,832.47936,35,0
0,0,52,52,32,82,114,288,196,484,0.000333,1.102373,32,105827.8005,5879.322252,3307.118767,681.319264,32,0
0,0,74,74,34,96,130,365,263,628,0.000333,1.470016,34,149941.5975,8330.088752,4410.046987,805.130137,35,0
0,0,76,76,34,99,133,377,272,649,0.000333,1.526293,34,155681.8622,8648.992346,4578.878301,829.280042,38,0
0,0,56,56,32,84,116,289,205,494,0.000333,1.129281,32,108410.9636,6022.831309,3387.842612,696.954664,29,0
0,0,58,58,32,87,119,301,214,515,0.000333,1.18361,32,113626.5967,6312.588708,3550.831148,720.536084,32,0
0,0,69,69,36,80,116,361,250,611,0.000333,1.396742,54,226272.225,12570.67916,4190.226388,691.871548,34,0
0,0,83,83,34,107,141,421,308,729,0.000333,1.734911,34,176960.9198,9831.162212,5204.732936,894.310704,41,0
0,0,75,75,37,92,129,387,261,648,0.000333,1.514425,36,163557.9094,9086.550523,4543.275262,792.917474,43,0
0,0,51,51,35,71,106,285,192,477,0.000333,1.069739,34,109113.4139,6061.85633,3209.218057,616.156951,28,0
0,0,65,65,32,97,129,345,250,595,0.000333,1.39056,32,133493.7669,7416.320386,4171.680217,800.191546,35,0
0,0,53,53,32,78,110,291,194,485,0.000333,1.09632,32,105246.7028,5847.039042,3288.959461,650.261373,32,0
0,0,75,75,34,90,124,368,261,629,0.000333,1.458063,34,148722.4423,8262.357905,4374.189479,757.240515,35,0
0,0,77,77,34,93,127,380,270,650,0.000333,1.514215,34,154449.9316,8580.551754,4542.645046,781.115506,38,0
0,0,57,57,32,80,112,292,203,495,0.000333,1.123214,32,107828.502,5990.472331,3369.640686,665.754248,29,0
0,0,59,59,32,83,115,304,212,516,0.000333,1.177424,32,113032.7317,6279.596207,3532.272866,689.128273,32,0
0,0,21,21,18,45,63,131,94,225,0.000333,0.448296,18,24207.98369,1344.887983,1344.887983,322.192039,5,0
0,0,28,28,21,43,64,169,141,310,0.000333,0.62,30,55800,3100,1860,325.56805,8,0
0,0,63,63,24,87,111,292,232,524,0.000333,1.186758,24,85446.57394,4747.031885,3560.273914,670.575184,16,0
0,0,35,35,24,60,84,199,156,355,0.000333,0.756424,24,54462.54444,3025.696913,2269.272685,464.452536,7,0
0,0,42,42,22,63,85,210,167,377,0.000333,0.805447,22,53159.48842,2953.304912,2416.340383,474.676131,10,0
0,0,39,39,26,63,89,225,174,399,0.000333,0.861273,26,67179.25861,3732.181034,2583.817639,498.780068,8,0
0,0,21,21,22,35,57,102,86,188,0.000333,0.365528,22,24124.8331,1340.268505,1096.583323,277.632401,7,0
0,0,49,49,30,48,78,209,143,352,0.000333,0.737487,30,66373.84743,3687.435968,2212.461581,415.284918,23,0
0,0,49,49,30,47,77,212,144,356,0.000333,0.743659,45,100393.9204,5577.440021,2230.976008,408.272394,23,0
0,0,102,102,33,100,133,516,402,918,0.000333,2.158916,64,414511.9537,23028.44187,6476.749276,830.850625,65,0
0,0,102,102,33,100,133,516,402,918,0.000333,2.158916,64,414511.9537,23028.44187,6476.749276,830.850625,65,0
0,0,102,102,32,100,132,524,406,930,0.000333,2.183762,64,419282.338,23293.46322,6551.286531,824.385619,65,0
0,0,102,102,32,100,132,524,406,930,0.000333,2.183762,64,419282.338,23293.46322,6551.286531,824.385619,65,0
0,0,101,101,32,98,130,484,379,863,0.000333,2.020101,48,290894.5643,16160.80913,6060.303423,808.241565,62,0
0,0,96,96,31,83,114,452,348,800,0.000333,1.822104,60,327978.7207,18221.04004,5466.312011,682.708358,62,0
0,0,89,89,31,78,109,419,321,740,0.000333,1.669485,60,300507.384,16694.85467,5008.4564,643.841459,60,0
0,0,14,14,19,22,41,66,59,125,0.000333,0.223231,18,12054.49201,669.694001,669.694001,178.818118,5,0
0,0,14,14,13,22,35,61,53,114,0.000333,0.194913,12,7016.859167,389.825509,584.738264,146.213212,4,0
0,0,95,95,31,94,125,456,361,817,0.000333,1.897015,45,256097.0592,14227.6144,5691.045761,769.711438,59,0
0,0,10,10,15,26,41,71,57,128,0.000333,0.228589,14,9600.733192,533.374066,685.766657,180.814792,6,0
1,0,20,21,19,40,59,132,100,232,0.000333,0.454924,18,24565.91737,1364.773187,1364.773187,293.587747,3,0
1,0,28,29,20,46,66,171,119,290,0.000333,0.584291,20,35057.48589,1947.638105,1752.874295,340.522412,4,0
1,0,29,30,20,47,67,174,120,294,0.000333,0.594477,20,35668.60444,1981.589136,1783.430222,347.504238,4,0
1,0,18,19,17,38,55,121,93,214,0.000333,0.412404,16,19795.37566,1099.743092,1237.210979,268.908114,2,0
2,0,14,16,11,31,42,61,62,123,0.000333,0.221085,10,6632.55043,368.475024,663.255043,191.633833,2,0
0,0,20,20,13,33,46,88,71,159,0.000333,0.292749,12,10538.95621,585.497567,878.246351,214.570722,5,0
2,0,16,18,19,40,59,94,89,183,0.000333,0.358841,18,19377.42621,1076.523678,1076.523678,293.587747,9,0
1,0,6,7,15,17,32,38,30,68,0.000333,0.113333,7,2380,132.222222,340,128.090227,3,0
1,0,8,9,15,20,35,42,34,76,0.000333,0.129942,7,2728.778565,151.598809,389.825509,145.041921,3,0
1,0,27,28,21,61,82,268,172,440,0.000333,0.932441,20,55946.45764,3108.136536,2797.322882,454.013643,13,0
1,0,27,28,21,61,82,268,172,440,0.000333,0.932441,20,55946.45764,3108.136536,2797.322882,454.013643,13,0
0,0,65,65,26,54,80,347,230,577,0.000333,1.215918,52,189683.1306,10537.9517,3647.752511,432.975358,27,0
0,0,68,68,26,53,79,344,234,578,0.000333,1.214528,52,189466.4342,10525.91301,3643.585272,425.791217,28,0
0,0,87,87,29,88,117,471,339,810,0.000333,1.854998,42,233729.8078,12984.98932,5564.995423,709.311431,39,0
0,0,16,16,19,35,54,101,93,194,0.000333,0.372149,18,20096.06716,1116.448175,1116.448175,260.235528,7,0
0,0,16,16,19,34,53,100,92,192,0.000333,0.366587,18,19795.69309,1099.760727,1099.760727,253.684359,7,0
0,0,27,27,20,46,66,113,102,215,0.000333,0.433182,20,25990.89471,1443.938595,1299.544736,340.522412,11,0
0,0,58,58,28,73,101,263,202,465,0.000333,1.032023,28,86689.91351,4816.106306,3096.068339,586.463131,29,0
0,0,58,58,28,73,101,263,202,465,0.000333,1.032023,28,86689.91351,4816.106306,3096.068339,586.463131,29,0
0,0,58,58,28,73,101,263,202,465,0.000333,1.032023,28,86689.91351,4816.106306,3096.068339,586.463131,29,0
0,0,55,55,28,70,98,243,188,431,0.000333,0.950313,28,79826.3184,4434.795467,2850.939943,563.655749,28,0
0,0,45,45,25,63,88,207,158,365,0.000333,0.785898,24,56584.62098,3143.590054,2357.692541,492.66504,23,0
0,0,45,45,25,63,88,207,158,365,0.000333,0.785898,24,56584.62098,3143.590054,2357.692541,492.66504,23,0
0,0,45,45,25,63,88,207,158,365,0.000333,0.785898,24,56584.62098,3143.590054,2357.692541,492.66504,23,0
0,0,56,56,29,73,102,261,194,455,0.000333,1.011985,28,85006.69886,4722.594381,3035.953531,592.738642,25,0
0,0,68,68,32,84,116,313,236,549,0.000333,1.255011,32,120481.0101,6693.389451,3765.031566,696.954664,29,0
0,0,68,68,32,83,115,311,234,545,0.000333,1.243597,32,119385.3465,6632.519249,3730.792078,689.128273,29,0
0,0,52,52,29,67,96,238,177,415,0.000333,0.91092,28,76517.26426,4250.959125,2732.759438,547.309425,24,0
0,0,44,44,30,63,93,207,152,359,0.000333,0.782519,30,70426.7404,3912.596689,2347.558013,523.775353,19,0
0,0,56,56,33,74,107,259,194,453,0.000333,1.017962,32,97724.30544,5429.12808,3053.884545,625.964555,23,0
0,0,56,56,33,73,106,257,192,449,0.000333,1.006945,32,96666.76109,5370.375616,3020.836284,618.322199,23,0
0,0,39,39,28,57,85,194,143,337,0.000333,0.719988,28,60479.01287,3359.94516,2159.964745,467.080669,16,0
0,0,15,15,17,28,45,52,50,102,0.000333,0.186723,8,4481.352127,248.964007,560.169016,204.092806,4,0
0,0,51,51,31,48,79,231,154,385,0.000333,0.808985,45,109213.0015,6067.38897,2426.955588,421.658286,22,0
0,0,22,22,23,33,56,113,86,199,0.000333,0.385221,22,25424.59985,1412.477769,1155.663629,270.506931,11,0
0,0,17,17,19,24,43,72,58,130,0.000333,0.235138,18,12697.45953,705.414418,705.414418,190.749723,8,0
0,0,41,41,25,53,78,257,174,431,0.000333,0.903003,36,97524.30083,5418.016713,2709.008356,419.676189,23,0
0,0,37,37,25,52,77,221,157,378,0.000333,0.789615,36,85278.43125,4737.690625,2368.845312,412.51927,21,0
0,0,32,32,24,50,74,182,137,319,0.000333,0.660272,24,47539.57497,2641.087498,1980.815624,392.23191,18,0
0,0,76,76,30,92,122,394,304,698,0.000333,1.612552,45,217694.4598,12094.13665,4837.654662,747.374418,31,0
0,0,76,76,30,92,122,394,304,698,0.000333,1.612552,45,217694.4598,12094.13665,4837.654662,747.374418,31,0
0,0,73,73,29,91,120,379,291,670,0.000333,1.542539,42,194359.9014,10797.7723,4627.616699,733.090761,31,0
0,0,10,10,16,22,38,57,46,103,0.000333,0.180179,16,8648.584542,480.476919,540.536534,162.107496,6,0
0,0,21,21,24,39,63,168,103,271,0.000333,0.539948,24,38876.22862,2159.790479,1619.842859,316.169787,18,0
0,0,17,17,18,30,48,91,71,162,0.000333,0.301588,18,16285.75065,904.763925,904.763925,222.265368,8,0
0,0,9,9,15,20,35,51,42,93,0.000333,0.159008,14,6678.326488,371.018138,477.023321,145.041921,5,0
0,0,12,12,16,22,38,61,52,113,0.000333,0.197672,16,9488.252944,527.125164,593.015809,162.107496,6,0
0,0,55,55,28,70,98,243,188,431,0.000333,0.950313,28,79826.3184,4434.795467,2850.939943,563.655749,28,0
0,0,17,17,18,27,45,61,50,111,0.000333,0.203199,9,5486.361243,304.797847,609.595694,203.440613,10,0
0,0,52,52,29,67,96,238,177,415,0.000333,0.91092,28,76517.26426,4250.959125,2732.759438,547.309425,24,0
0,0,36,36,26,41,67,161,133,294,0.000333,0.594477,39,69553.77866,3864.098814,1783.430222,341.871065,20,0
0,0,6,6,16,19,35,29,24,53,0.000333,0.090617,8,2174.815999,120.823111,271.852,144.710623,3,0
0,0,103,103,31,66,97,420,313,733,0.000333,1.612579,60,290264.1668,16125.78704,4837.736113,552.510097,30,0
0,0,23,23,15,35,50,93,88,181,0.000333,0.340513,14,14301.53159,794.529532,1021.53797,238.128265,8,0
0,0,16,16,21,26,47,76,66,142,0.000333,0.262917,20,15775.03234,876.390685,788.751617,214.450099,7,0
0,0,5,5,19,17,36,42,33,75,0.000333,0.129248,9,3489.699376,193.872188,387.744375,150.197491,7,0
0,0,27,27,21,29,50,110,93,203,0.000333,0.381901,30,34371.0842,1909.504678,1145.702807,233.120115,9,0
0,0,26,26,21,29,50,106,91,197,0.000333,0.370613,30,33355.19008,1853.066116,1111.839669,233.120115,8,0
1,0,140,141,28,69,97,566,459,1025,0.000333,2.25497,84,568252.4957,31569.5831,6764.910663,556.094125,35,0
1,0,69,70,25,55,80,294,219,513,0.000333,1.08105,36,116753.3681,6486.298225,3243.149113,434.071189,21,0
1,0,67,68,25,54,79,284,213,497,0.000333,1.044326,36,112787.2451,6265.958064,3132.979032,426.86033,20,0
1,0,61,62,24,59,83,296,216,512,0.000333,1.088007,36,117504.7268,6528.040378,3264.020189,457.11504,28,0
0,0,93,93,24,73,97,419,299,718,0.000333,1.579579,48,227459.3962,12636.63312,4738.737421,561.896293,36,0
1,0,94,95,25,78,103,432,311,743,0.000333,1.656023,36,178850.5161,9936.139783,4968.069892,606.357778,38,0
1,0,64,65,24,64,88,305,232,537,0.000333,1.156238,36,124873.7321,6937.429558,3468.714779,494.0391,27,0
1,0,81,82,22,73,95,379,263,642,0.000333,1.405949,33,139188.9609,7732.720051,4217.847301,549.964688,35,0
1,0,68,69,20,74,94,351,252,603,0.000333,1.317472,30,118572.5123,6587.361796,3952.417078,545.938111,34,0
1,0,91,92,22,78,100,401,285,686,0.000333,1.519228,33,150403.6164,8355.756468,4557.685346,588.368869,35,0
1,0,59,60,21,59,80,298,217,515,0.000333,1.085264,30,97673.78907,5426.321615,3255.792969,439.314606,17,0
1,0,86,87,23,85,108,446,315,761,0.000333,1.71349,33,169635.4898,9424.19388,5140.469389,648.840155,35,0
1,0,73,74,22,90,112,418,304,722,0.000333,1.638303,33,162192.0384,9010.668798,4914.910254,682.374274,34,0
1,0,96,97,23,89,112,468,337,805,0.000333,1.82664,33,180837.3835,10046.52131,5479.920712,680.3822,35,0
1,0,71,72,22,65,87,337,234,571,0.000333,1.226307,33,121404.3843,6744.688016,3678.920736,489.561403,33,0
1,0,136,137,29,97,126,598,422,1020,0.000333,2.372275,56,398542.2292,22141.23496,7116.825522,781.072995,48,0
1,0,58,59,20,67,87,309,223,532,0.000333,1.142549,30,102829.3782,5712.743233,3427.64594,492.866538,32,0
1,0,81,82,22,71,93,359,256,615,0.000333,1.340528,33,132712.2281,7372.90156,4021.582669,534.739541,33,0
1,0,65,66,26,65,91,258,198,456,0.000333,0.989185,39,115734.6199,6429.701105,2967.554356,513.665341,20,0
1,0,18,19,16,36,52,87,71,158,0.000333,0.300223,8,7205.355804,400.297545,900.669475,250.1173,8,0
0,0,7,7,15,13,28,29,26,55,0.000333,0.088135,14,3701.66329,205.647961,264.404521,106.709075,5,0
1,0,22,23,16,23,39,82,61,143,0.000333,0.251938,16,12093.00028,671.833349,755.812517,168.041925,7,0
1,0,72,73,23,48,71,276,203,479,0.000333,0.98191,44,129612.0703,7200.670572,2945.72887,372.120125,26,0
1,0,84,85,23,52,75,313,230,543,0.000333,1.127416,44,148818.9362,8267.718675,3382.248549,400.46479,28,0
1,0,72,73,23,52,75,279,208,487,0.000333,1.011145,44,133471.1269,7415.062606,3033.434702,400.46479,26,0
4,0,121,125,28,55,83,457,329,786,0.000333,1.67026,70,350754.6695,19486.37053,5010.780993,452.580722,35,0
0,0,5,5,12,10,22,20,18,38,0.000333,0.056486,6,1016.750409,56.486134,169.458402,76.238831,3,0
0,0,9,9,12,16,28,29,29,58,0.000333,0.092942,6,1672.959513,92.942195,278.826585,107.01955,3,0
1,0,8,9,11,16,27,29,28,57,0.000333,0.090343,5,1355.142938,75.285719,271.028588,102.053748,2,0
1,0,24,25,23,58,81,125,111,236,0.000333,0.498735,11,16458.25061,914.347256,1496.204601,443.804823,8,0
1,0,27,28,24,36,60,111,86,197,0.000333,0.387886,24,27927.77874,1551.543263,1163.657447,296.1564,14,0
1,0,7,8,11,15,26,32,26,58,0.000333,0.090875,5,1363.127518,75.729307,272.625504,96.657107,3,0
1,0,12,13,16,22,38,51,36,87,0.000333,0.15219,8,3652.557549,202.919864,456.569694,162.107496,10,0
1,0,8,9,14,21,35,37,32,69,0.000333,0.117974,7,2477.443697,137.635761,353.920528,145.541635,3,0
1,0,7,8,12,11,23,22,25,47,0.000333,0.070869,12,2551.288943,141.738275,212.607412,81.073298,1,0
1,0,7,8,12,12,24,22,25,47,0.000333,0.071831,12,2585.91885,143.662158,215.493238,86.0391,1,0
0,0,66,66,21,45,66,409,213,622,0.000333,1.253204,40,150384.5257,8354.695872,3759.613142,339.372055,33,0
0,0,63,63,21,41,62,383,199,582,0.000333,1.155114,40,138613.6901,7700.760561,3465.342253,311.898298,32,0
0,0,68,68,21,41,62,426,213,639,0.000333,1.268244,50,190236.5721,10568.69845,3804.731442,311.898298,37,0
0,0,66,66,21,44,65,407,211,618,0.000333,1.240608,40,148872.9323,8270.718463,3721.823308,332.453657,33,0
0,0,63,63,21,40,61,381,197,578,0.000333,1.142655,40,137118.6472,7617.702625,3427.966181,305.11579,32,0
0,0,68,68,21,40,61,424,211,635,0.000333,1.255339,50,188300.9105,10461.16169,3766.018209,305.11579,37,0
4,0,10,14,15,19,34,62,37,99,0.000333,0.167886,7,3525.611749,195.867319,503.658821,139.313982,4,0
0,0,10,10,14,25,39,54,56,110,0.000333,0.193798,14,8139.519417,452.195523,581.394244,169.399374,2,0
0,0,10,10,14,26,40,54,57,111,0.000333,0.196911,14,8270.276259,459.459792,590.734019,175.514402,2,0
0,0,18,18,22,40,62,134,118,252,0.000333,0.500152,22,33010.06435,1833.892464,1500.45747,310.984619,13,0
0,0,10,10,14,26,40,54,57,111,0.000333,0.196911,14,8270.276259,459.459792,590.734019,175.514402,2,0
0,0,11,11,14,24,38,53,54,107,0.000333,0.187176,14,7861.395415,436.74419,561.528244,163.342069,2,0
0,0,10,10,14,25,39,54,56,110,0.000333,0.193798,14,8139.519417,452.195523,581.394244,169.399374,2,0
0,0,17,17,20,29,49,123,94,217,0.000333,0.406131,30,36551.76109,2030.653394,1218.392036,227.320011,4,0
0,0,17,17,20,29,49,123,94,217,0.000333,0.406131,30,36551.76109,2030.653394,1218.392036,227.320011,4,0
0,0,24,24,20,31,51,161,120,281,0.000333,0.531317,30,47818.54563,2656.585868,1593.951521,240.018648,4,0
0,0,25,25,20,31,51,163,122,285,0.000333,0.53888,30,48499.23667,2694.402037,1616.641222,240.018648,4,0
0,0,40,40,20,29,49,269,206,475,0.000333,0.888996,70,186689.1023,10371.6168,2666.987176,227.320011,5,0
0,0,40,40,20,29,49,269,206,475,0.000333,0.888996,70,186689.1023,10371.6168,2666.987176,227.320011,5,0
2,0,33,35,29,55,84,241,184,425,0.000333,0.905578,42,114102.866,6339.048111,2716.734905,458.856233,32,0
0,0,24,24,27,47,74,172,132,304,0.000333,0.629225,26,49079.5194,2726.639967,1887.673823,389.447639,29,0
0,0,33,33,27,48,75,197,147,344,0.000333,0.714238,39,83565.83155,4642.546197,2142.71363,396.460163,16,0
0,0,33,33,25,46,71,195,147,342,0.000333,0.701071,36,75715.68654,4206.42703,2103.213515,370.180255,16,0
0,0,89,89,28,92,120,397,311,708,0.000333,1.630026,42,205383.2988,11410.18326,4890.078542,734.773638,25,0
0,0,75,75,29,78,107,333,254,587,0.000333,1.31908,42,166204.1271,9233.562616,3957.241121,631.142822,26,0
0,0,102,102,30,96,126,446,352,798,0.000333,1.855956,45,250554.1221,13919.67345,5567.869379,779.363118,29,0
0,0,103,103,30,97,127,454,358,812,0.000333,1.891604,45,255366.5385,14187.02991,5674.811966,787.398264,29,0
0,0,92,92,30,83,113,450,363,813,0.000333,1.848268,60,332688.3298,18482.68499,5544.805496,676.334991,22,0
0,0,87,87,32,92,124,429,333,762,0.000333,1.766366,48,254356.6842,14130.9269,5299.097589,760.1677,33,0
0,0,63,63,28,81,109,320,254,574,0.000333,1.294979,42,163167.3877,9064.854872,3884.937802,648.133788,21,0
0,0,95,95,29,102,131,473,370,843,0.000333,1.976392,42,249025.3748,13834.74304,5929.17559,821.468834,28,0
0,0,63,63,27,79,106,311,243,554,0.000333,1.242423,39,145363.4493,8075.747186,3727.267932,626.380642,20,0
0,0,65,65,27,79,106,315,248,563,0.000333,1.262606,39,147724.9494,8206.941634,3787.819216,626.380642,19,0
0,0,95,95,31,94,125,449,345,794,0.000333,1.843611,45,248887.4725,13827.08181,5530.832722,769.711438,33,0
0,0,95,95,31,97,128,474,364,838,0.000333,1.955333,45,263970,14665,5866,793.771631,28,0
0,0,90,90,30,94,124,446,344,790,0.000333,1.831272,45,247221.6788,13734.53771,5493.815085,763.33807,27,0
0,0,89,89,28,92,120,397,311,708,0.000333,1.630026,42,205383.2988,11410.18326,4890.078542,734.773638,25,0
0,0,75,75,29,78,107,333,254,587,0.000333,1.31908,42,166204.1271,9233.562616,3957.241121,631.142822,26,0
0,0,63,63,27,79,106,311,243,554,0.000333,1.242423,39,145363.4493,8075.747186,3727.267932,626.380642,20,0
0,0,65,65,27,79,106,315,248,563,0.000333,1.262606,39,147724.9494,8206.941634,3787.819216,626.380642,19,0
0,0,95,95,31,94,125,449,345,794,0.000333,1.843611,45,248887.4725,13827.08181,5530.832722,769.711438,33,0
0,0,47,47,23,67,90,232,174,406,0.000333,0.878564,22,57985.23186,3221.40177,2635.692357,510.469901,19,0
0,0,15,15,18,36,54,82,64,146,0.000333,0.280071,9,7561.922178,420.106788,840.213575,261.17595,5,0
0,0,17,17,18,35,53,86,69,155,0.000333,0.295943,9,7990.449034,443.913835,887.82767,254.583556,4,0
0,0,47,47,21,58,79,220,166,386,0.000333,0.811086,20,48665.18738,2703.621521,2433.259369,432.001564,18,0
0,0,7,7,13,18,31,34,26,60,0.000333,0.099084,6,1783.510672,99.083926,297.251779,123.164366,6,0
0,0,113,113,32,115,147,552,428,980,0.000333,2.351893,48,338672.5871,18815.14373,7055.678898,947.231356,37,0
0,0,111,111,31,115,146,538,419,957,0.000333,2.293554,45,309629.7946,17201.65526,6880.662103,940.811441,36,0
0,0,111,111,31,115,146,538,419,957,0.000333,2.293554,45,309629.7946,17201.65526,6880.662103,940.811441,36,0
0,0,112,112,32,114,146,547,425,972,0.000333,2.329503,48,335448.4546,18636.02526,6988.509471,938.949462,37,0
0,0,110,110,31,114,145,533,416,949,0.000333,2.271245,45,306618.0177,17034.33432,6813.733726,932.529547,36,0
0,0,110,110,31,114,145,533,416,949,0.000333,2.271245,45,306618.0177,17034.33432,6813.733726,932.529547,36,0
0,0,36,36,26,47,73,162,120,282,0.000333,0.581844,26,45383.79367,2521.32187,1745.530526,383.277109,13,0
0,0,13,13,18,24,42,62,44,106,0.000333,0.190529,9,5144.270821,285.792823,571.585647,185.09775,7,0
0,0,9,9,11,22,33,44,45,89,0.000333,0.14965,10,4489.510766,249.417265,448.951077,136.161243,2,0
0,0,61,61,25,81,106,323,286,609,0.000333,1.365768,36,147502.928,8194.607114,4097.303557,629.624255,14,0
0,0,69,69,28,80,108,370,309,679,0.000333,1.528856,42,192635.8818,10701.99343,4586.568614,640.360185,15,0
0,0,41,41,23,67,90,221,188,409,0.000333,0.885056,22,58413.69416,3245.205231,2655.167916,510.469901,9,0
0,0,52,52,24,77,101,285,245,530,0.000333,1.176284,36,127038.6751,7057.704172,3528.852086,592.581664,12,0
0,0,47,47,26,47,73,244,204,448,0.000333,0.924347,52,144198.1529,8011.008496,2773.041402,383.277109,15,0
0,0,52,52,26,55,81,278,225,503,0.000333,1.062982,52,165825.1167,9212.506482,3188.944551,440.186217,15,0
0,0,60,60,26,33,59,325,255,580,0.000333,1.137311,91,310485.9001,17249.21668,3411.932969,288.676439,21,0
0,0,75,75,26,27,53,416,318,734,0.000333,1.401431,143,601213.9868,33400.77704,4204.293614,250.593395,28,0
0,0,31,31,24,63,87,188,164,352,0.000333,0.755972,24,54429.98665,3023.888147,2267.916111,486.607735,8,0
0,0,20,20,22,52,74,124,107,231,0.000333,0.478128,22,31556.442,1753.135667,1434.383727,394.530361,5,0
0,0,31,31,24,63,87,188,164,352,0.000333,0.755972,24,54429.98665,3023.888147,2267.916111,486.607735,8,0
0,0,24,24,22,38,60,103,95,198,0.000333,0.389855,22,25730.41543,1429.467524,1169.564338,297.528741,5,0
0,0,32,32,25,49,74,152,126,278,0.000333,0.575409,24,41429.47286,2301.637381,1726.228036,391.217187,6,0
0,0,32,32,24,48,72,144,124,268,0.000333,0.55118,24,39684.95761,2204.719867,1653.5399,378.1173,7,0
0,0,23,23,18,38,56,108,89,197,0.000333,0.38135,18,20592.88055,1144.04892,1144.04892,274.479896,3,0
0,0,23,23,19,34,53,107,86,193,0.000333,0.368496,18,19898.79566,1105.488648,1105.488648,253.684359,3,0
0,0,26,26,19,43,62,118,102,220,0.000333,0.436641,18,23578.61739,1309.923188,1309.923188,314.040007,3,0
0,0,26,26,19,43,62,118,102,220,0.000333,0.436641,18,23578.61739,1309.923188,1309.923188,314.040007,3,0
0,0,26,26,19,43,62,118,102,220,0.000333,0.436641,18,23578.61739,1309.923188,1309.923188,314.040007,3,0
0,0,72,72,27,56,83,312,247,559,0.000333,1.187882,52,185309.6462,10294.98034,3563.647042,453.593838,25,0
0,0,39,39,21,45,66,166,143,309,0.000333,0.622573,30,56031.53349,3112.862971,1867.717783,339.372055,7,0
0,0,39,39,23,43,66,173,144,317,0.000333,0.638691,33,63230.40688,3512.800382,1916.072936,337.371309,7,0
0,0,52,52,27,58,85,233,189,422,0.000333,0.901588,39,105485.756,5860.319779,2704.762975,468.14486,15,0
0,0,26,26,21,41,62,116,97,213,0.000333,0.422748,20,25364.87628,1409.159793,1268.243814,311.898298,3,0
0,0,26,26,21,41,62,116,97,213,0.000333,0.422748,20,25364.87628,1409.159793,1268.243814,311.898298,3,0
0,0,26,26,21,41,62,116,97,213,0.000333,0.422748,20,25364.87628,1409.159793,1268.243814,311.898298,3,0
0,0,47,47,23,50,73,179,151,330,0.000333,0.680881,33,67407.18945,3744.843858,2042.642104,386.234734,8,0
0,0,26,26,19,43,62,118,102,220,0.000333,0.436641,18,23578.61739,1309.923188,1309.923188,314.040007,3,0
0,0,26,26,19,43,62,118,102,220,0.000333,0.436641,18,23578.61739,1309.923188,1309.923188,314.040007,3,0
0,0,26,26,19,43,62,118,102,220,0.000333,0.436641,18,23578.61739,1309.923188,1309.923188,314.040007,3,0
0,0,50,50,24,46,70,197,158,355,0.000333,0.725298,36,78332.23696,4351.790942,2175.895471,364.12295,15,0
0,0,26,26,21,41,62,116,97,213,0.000333,0.422748,20,25364.87628,1409.159793,1268.243814,311.898298,3,0
0,0,26,26,21,41,62,116,97,213,0.000333,0.422748,20,25364.87628,1409.159793,1268.243814,311.898298,3,0
0,0,26,26,21,41,62,116,97,213,0.000333,0.422748,20,25364.87628,1409.159793,1268.243814,311.898298,3,0
0,0,34,34,19,40,59,130,113,243,0.000333,0.476494,18,25730.6807,1429.482261,1429.482261,293.587747,4,0
0,0,26,26,21,41,62,116,97,213,0.000333,0.422748,20,25364.87628,1409.159793,1268.243814,311.898298,3,0
0,0,26,26,21,41,62,116,97,213,0.000333,0.422748,20,25364.87628,1409.159793,1268.243814,311.898298,3,0
0,0,26,26,21,41,62,116,97,213,0.000333,0.422748,20,25364.87628,1409.159793,1268.243814,311.898298,3,0
0,0,24,24,16,29,45,118,101,219,0.000333,0.400905,24,28865.17987,1603.621104,1202.715828,204.881449,5,0
0,0,9,9,8,10,18,10,17,27,0.000333,0.037529,4,450.3519,25.01955,112.587975,57.219281,1,0
0,0,11,11,12,16,28,20,24,44,0.000333,0.070508,6,1269.141699,70.507872,211.523617,107.01955,2,0
0,0,36,36,26,66,92,211,194,405,0.000333,0.880681,26,68693.1074,3816.283744,2642.042592,521.141445,8,0
0,0,13,13,14,34,48,78,70,148,0.000333,0.275525,14,11572.0423,642.891239,826.57445,226.276706,2,0
0,0,24,24,16,44,60,142,127,269,0.000333,0.529651,16,25423.25712,1412.403174,1588.95357,304.214991,5,0
0,0,38,38,26,50,76,161,116,277,0.000333,0.576892,26,44997.57395,2499.86522,1730.675921,404.404242,13,0
0,0,19,19,18,25,43,86,74,160,0.000333,0.289401,18,15627.64249,868.202361,868.202361,191.155055,5,0
0,0,10,10,17,15,32,42,32,74,0.000333,0.123333,16,5920,328.888889,370,128.090227,6,0
0,0,5,5,9,10,19,16,16,32,0.000333,0.045311,4,543.734722,30.207485,135.93368,61.748606,1,0
0,0,19,19,15,30,45,98,86,184,0.000333,0.336834,14,14147.01358,785.945199,1010.50097,205.810077,4,0
0,0,18,18,15,30,45,94,83,177,0.000333,0.324019,14,13608.81197,756.04511,972.057998,205.810077,4,0
0,0,97,97,33,81,114,424,327,751,0.000333,1.7105,64,328416.0256,18245.33476,5131.500401,679.992856,27,0
0,0,16,16,16,30,46,79,70,149,0.000333,0.274337,16,13168.1717,731.565095,823.010731,211.206718,7,0
0,0,24,24,15,29,44,109,76,185,0.000333,0.336665,14,14139.92789,785.55155,1009.994849,199.484808,9,0
0,0,59,59,19,53,72,248,212,460,0.000333,0.946055,36,102173.958,5676.331001,2838.165501,384.290407,9,0
0,0,46,46,22,51,73,217,186,403,0.000333,0.8315,33,82318.47681,4573.248712,2494.499297,387.401188,5,0
0,0,83,83,25,71,96,369,292,661,0.000333,1.450887,48,208927.6902,11607.0939,4352.660213,552.72845,15,0
0,0,49,49,21,49,70,233,198,431,0.000333,0.880574,40,105668.8392,5870.491067,2641.72098,367.359448,7,0
0,0,43,43,25,72,97,236,213,449,0.000333,0.987787,24,71120.66079,3951.147822,2963.360866,560.331005,11,0
0,0,59,59,29,80,109,318,267,585,0.000333,1.319796,42,166294.2889,9238.571603,3959.38783,646.635696,13,0
0,0,31,31,24,62,86,169,146,315,0.000333,0.674758,24,48582.56155,2699.031197,2024.273398,479.199271,7,0
0,0,42,42,24,72,96,233,203,436,0.000333,0.957015,24,68905.04761,3828.0582,2871.04365,554.2737,10,0
0,0,49,49,27,52,79,247,210,457,0.000333,0.960276,52,149803.0457,8322.391428,2880.827802,424.804828,15,0
0,0,43,43,25,55,80,234,189,423,0.000333,0.891392,36,96270.32103,5348.351168,2674.175584,434.071189,14,0
0,0,51,51,25,33,58,281,219,500,0.000333,0.97633,72,210887.3158,11715.96199,2928.990498,282.561411,20,0
0,0,66,66,25,27,52,372,282,654,0.000333,1.242696,120,447370.5091,24853.91717,3728.087576,244.478367,27,0
0,0,23,23,24,35,59,119,92,211,0.000333,0.413746,24,29789.7044,1654.983578,1241.237683,289.564006,8,0
0,0,31,31,23,39,62,163,125,288,0.000333,0.571603,33,56588.68173,3143.815652,1714.808537,310.172612,10,0
0,0,31,31,23,39,62,163,125,288,0.000333,0.571603,33,56588.68173,3143.815652,1714.808537,310.172612,10,0
0,0,43,43,23,45,68,235,168,403,0.000333,0.817749,33,80957.16833,4497.620463,2453.247525,351.175314,15,0
0,0,30,30,23,38,61,159,122,281,0.000333,0.555512,33,54995.72733,3055.318185,1666.537192,303.463171,9,0
0,0,50,50,26,61,87,281,210,491,0.000333,1.054495,39,123375.925,6854.218056,3163.485256,483.98641,22,0
0,0,40,40,23,50,73,222,165,387,0.000333,0.798487,33,79050.24944,4391.680525,2395.462104,386.234734,15,0
0,0,64,64,27,66,93,330,248,578,0.000333,1.259878,39,147405.7179,8189.206551,3779.633793,527.311974,25,0
0,0,21,21,20,48,68,125,95,220,0.000333,0.446414,10,13392.41825,744.023236,1339.241825,354.516762,3,0
0,0,36,36,26,40,66,169,134,303,0.000333,0.610484,39,71426.60531,3968.144739,1831.451418,335.088556,12,0
0,0,35,35,26,39,65,169,130,299,0.000333,0.600229,39,70226.83107,3901.490615,1800.687976,328.342119,13,0
0,0,13,13,20,22,42,55,52,107,0.000333,0.192326,20,11539.55929,641.086627,576.977964,184.546058,4,0
0,0,10,10,17,26,43,44,45,89,0.000333,0.160979,8,3863.500505,214.638917,482.937563,191.698301,4,0
0,0,10,10,15,17,32,40,34,74,0.000333,0.123333,14,5180,287.777778,370,128.090227,4,0
0,0,48,48,21,46,67,186,130,316,0.000333,0.638961,20,38337.68368,2129.871316,1916.884184,346.322516,19,0
0,0,48,48,21,54,75,235,168,403,0.000333,0.836738,30,75306.41797,4183.689887,2510.213932,403.002591,20,0
0,0,48,48,21,54,75,235,168,403,0.000333,0.836738,30,75306.41797,4183.689887,2510.213932,403.002591,20,0
0,0,20,20,22,40,62,110,79,189,0.000333,0.375114,11,12378.77413,687.709674,1125.343103,310.984619,11,0
0,0,24,24,24,43,67,128,93,221,0.000333,0.446869,24,32174.53707,1787.474281,1340.605711,343.368484,12,0
0,0,24,24,24,43,67,128,93,221,0.000333,0.446869,24,32174.53707,1787.474281,1340.605711,343.368484,12,0
0,0,22,22,17,26,43,103,65,168,0.000333,0.303871,16,14585.79966,810.322203,911.612479,191.698301,9,0
0,0,30,30,20,33,53,138,86,224,0.000333,0.427685,20,25661.08364,1425.615758,1283.054182,252.903568,11,0
0,0,51,51,25,45,70,238,166,404,0.000333,0.82541,36,89144.2922,4952.460678,2476.230339,363.229794,26,0
0,0,20,20,17,26,43,87,62,149,0.000333,0.269504,16,12936.21518,718.678621,808.513448,191.698301,7,0
0,0,27,27,22,44,66,145,105,250,0.000333,0.5037,22,33244.16766,1846.898203,1511.09853,338.322487,14,0
1,0,13,14,14,25,39,64,57,121,0.000333,0.213178,14,8953.471359,497.415075,639.533668,169.399374,5,0
0,0,20,20,21,44,65,188,121,309,0.000333,0.620304,20,37218.23309,2067.679616,1860.911654,332.453657,7,0
0,0,20,20,23,41,64,187,122,309,0.000333,0.618,22,40788,2266,1854,323.701557,8,0
0,0,11,11,16,31,47,71,55,126,0.000333,0.233293,8,5599.025562,311.056976,699.878195,217.580086,7,0
0,0,17,17,17,39,56,98,77,175,0.000333,0.338762,8,8130.296891,451.683161,1016.287111,275.617555,11,0
0,0,17,17,17,39,56,98,77,175,0.000333,0.338762,8,8130.296891,451.683161,1016.287111,275.617555,11,0
0,0,57,57,23,74,97,241,238,479,0.000333,1.053786,33,104324.8223,5795.823461,3161.358251,563.541474,11,0
0,0,110,110,27,121,148,446,413,859,0.000333,2.064307,39,241523.8972,13417.99429,6192.920441,965.564414,17,0
0,0,71,71,28,87,115,296,282,578,0.000333,1.318898,42,166181.1165,9232.284249,3956.693249,695.142022,15,0
0,0,58,58,24,74,98,244,242,486,0.000333,1.071583,36,115730.9634,6429.497968,3214.748984,569.538649,11,0
0,0,73,73,25,91,116,299,286,585,0.000333,1.337306,36,144429.0798,8023.837764,4011.918882,708.305717,13,0
0,0,101,101,29,108,137,423,380,803,0.000333,1.899907,42,239388.23,13299.34611,5699.719763,870.409299,24,0
0,0,115,115,26,120,146,475,432,907,0.000333,2.173724,39,254325.6641,14129.20356,6521.170875,951.038304,24,0
0,0,92,92,28,105,133,396,357,753,0.000333,1.770876,42,223130.3623,12396.13124,5312.627674,839.601717,21,0
0,0,106,106,25,117,142,448,409,857,0.000333,2.042444,36,220583.9981,12254.66656,6127.333281,919.929077,21,0
0,0,55,55,23,73,96,235,232,467,0.000333,1.025059,33,101480.8571,5637.825394,3075.177488,555.899118,11,0
0,0,108,108,27,120,147,440,407,847,0.000333,2.032707,39,237826.7766,13212.5987,6098.122476,957.208834,17,0
0,0,69,69,28,86,114,290,276,566,0.000333,1.289139,42,162431.4614,9023.970079,3867.415748,687.264707,15,0
0,0,56,56,24,73,97,238,236,474,0.000333,1.042786,36,112620.9127,6256.717374,3128.358687,561.896293,11,0
0,0,71,71,25,90,115,293,280,573,0.000333,1.307489,36,141208.7688,7844.931598,3922.465799,700.363183,13,0
1,0,3,4,7,7,14,11,8,19,0.000333,0.024113,3,217.019231,12.056624,72.339744,39.302969,2,0
1,0,25,26,19,51,70,127,105,232,0.000333,0.473998,18,25595.88588,1421.99366,1421.99366,370.004315,13,0
1,0,26,27,19,52,71,133,111,244,0.000333,0.500179,18,27009.68935,1500.538297,1500.538297,377.133488,13,0
1,0,25,26,19,52,71,127,105,232,0.000333,0.47558,18,25681.34397,1426.741332,1426.741332,377.133488,13,0
1,0,25,26,19,51,70,127,105,232,0.000333,0.473998,18,25595.88588,1421.99366,1421.99366,370.004315,13,0
1,0,26,27,19,52,71,133,111,244,0.000333,0.500179,18,27009.68935,1500.538297,1500.538297,377.133488,13,0
1,0,25,26,19,52,71,127,105,232,0.000333,0.47558,18,25681.34397,1426.741332,1426.741332,377.133488,13,0
1,0,70,71,29,97,126,339,242,581,0.000333,1.351267,28,113506.3898,6305.910544,4053.799636,781.072995,44,0
1,0,70,71,29,97,126,339,242,581,0.000333,1.351267,28,113506.3898,6305.910544,4053.799636,781.072995,44,0
1,0,70,71,27,98,125,342,250,592,0.000333,1.374581,26,107217.3517,5956.519539,4123.744297,776.623527,42,0
1,0,70,71,27,98,125,342,250,592,0.000333,1.374581,26,107217.3517,5956.519539,4123.744297,776.623527,42,0
1,0,67,68,29,100,129,336,237,573,0.000333,1.339144,28,112488.1301,6249.34056,4017.433217,805.267068,44,0
1,0,66,67,29,99,128,330,231,561,0.000333,1.309,28,109956,6108.666667,3927,797.187754,44,0
1,0,68,69,27,100,127,339,243,582,0.000333,1.355805,26,105752.7767,5875.15426,4067.414488,792.767582,43,0
1,0,67,68,27,99,126,333,237,570,0.000333,1.325683,26,103403.2885,5744.627137,3977.049556,784.688268,43,0
1,0,21,22,19,51,70,133,80,213,0.000333,0.435179,9,11749.83554,652.768641,1305.537283,370.004315,10,0
1,0,40,41,18,75,93,173,162,335,0.000333,0.730206,18,39431.12763,2190.618202,2190.618202,542.220052,19,0
1,0,35,36,16,70,86,144,134,278,0.000333,0.595501,8,14292.01281,794.000712,1786.501602,493.049811,19,0
1,0,34,35,16,70,86,142,131,273,0.000333,0.58479,8,14034.96222,779.720124,1754.370278,493.049811,19,0
1,0,38,39,20,77,97,192,169,361,0.000333,0.79419,20,47651.37072,2647.298373,2382.568536,568.981126,18,0
1,0,33,34,18,73,91,163,141,304,0.000333,0.659457,9,17805.32614,989.184785,1978.369571,526.915843,18,0
0,0,78,78,32,110,142,431,349,780,0.000333,1.858934,48,267686.5322,14871.47401,5576.802753,905.949568,36,0
0,0,83,83,34,118,152,463,383,846,0.000333,2.043916,51,312719.0805,17373.28225,6131.746676,985.125616,40,0
0,0,87,87,34,121,155,476,393,869,0.000333,2.107651,51,322470.5575,17915.03097,6322.952108,1010.156188,42,0
0,0,79,79,32,110,142,435,351,786,0.000333,1.873234,48,269745.6593,14985.86996,5619.701236,905.949568,37,0
0,0,96,96,34,116,150,536,425,961,0.000333,2.315632,51,354291.6328,19682.86849,6946.894762,968.499532,44,0
0,0,96,96,34,124,158,544,441,985,0.000333,2.398075,51,366905.4259,20383.63477,7194.224037,1035.294079,48,0
0,0,90,90,33,115,148,508,404,912,0.000333,2.191674,48,315601.0305,17533.39059,6575.021469,953.696362,44,0
0,0,95,95,34,124,158,540,438,978,0.000333,2.381033,51,364297.9762,20238.77645,7143.097572,1035.294079,48,0
0,0,99,99,34,127,161,553,448,1001,0.000333,2.446083,51,374250.6375,20791.70209,7338.247795,1060.536692,50,0
0,0,91,91,33,115,148,512,406,918,0.000333,2.206093,48,317677.3531,17648.74184,6618.27819,953.696362,45,0
0,0,69,69,31,84,115,389,306,695,0.000333,1.585872,45,214092.7013,11894.03896,4757.615585,690.534749,33,0
0,0,60,60,30,79,109,360,286,646,0.000333,1.457416,45,196751.1183,10930.61769,4372.247074,645.205397,30,0
0,0,65,65,31,82,113,379,299,678,0.000333,1.54136,45,208083.6601,11560.20334,4624.081337,674.89935,32,0
0,0,59,59,30,79,109,356,283,639,0.000333,1.441623,45,194619.1403,10812.17446,4324.869784,645.205397,30,0
0,0,63,63,30,83,113,369,293,662,0.000333,1.504986,45,203173.1313,11287.39618,4514.958473,676.334991,32,0
0,0,66,66,31,82,113,383,301,684,0.000333,1.555001,45,209925.1085,11662.50603,4665.00241,674.89935,33,0
0,0,55,55,30,79,109,296,241,537,0.000333,1.211505,45,163553.1742,9086.287456,3634.514982,645.205397,25,0
0,0,50,50,29,75,104,280,230,510,0.000333,1.139075,42,143523.4188,7973.523265,3417.224256,608.042851,23,0
0,0,55,55,30,79,109,299,243,542,0.000333,1.222785,45,165076.0157,9170.88976,3668.355904,645.205397,25,0
0,0,49,49,29,75,104,276,227,503,0.000333,1.12344,42,141553.4895,7864.082749,3370.321178,608.042851,23,0
0,0,53,53,29,78,107,289,237,526,0.000333,1.182004,42,148932.4887,8274.027148,3546.011635,631.142822,25,0
0,0,56,56,30,79,109,303,245,548,0.000333,1.236322,45,166903.4254,9272.412525,3708.96501,645.205397,26,0
0,0,78,78,32,110,142,428,348,776,0.000333,1.849401,48,266313.7807,14795.21004,5548.203765,905.949568,36,0
0,0,83,83,34,118,152,460,382,842,0.000333,2.034252,51,311240.5033,17291.13907,6102.754966,985.125616,40,0
0,0,87,87,34,121,155,473,392,865,0.000333,2.097949,51,320986.2281,17832.56823,6293.847611,1010.156188,42,0
0,0,79,79,32,110,142,432,350,782,0.000333,1.863701,48,268372.9079,14909.60599,5591.102247,905.949568,37,0
0,0,96,96,34,116,150,533,424,957,0.000333,2.305993,51,352816.9538,19600.94188,6917.979487,968.499532,44,0
0,0,96,96,34,124,158,541,440,981,0.000333,2.388336,51,365415.4546,20300.85859,7165.008914,1035.294079,48,0
0,0,90,90,33,115,148,505,403,908,0.000333,2.182061,48,314216.8155,17456.48975,6546.183656,953.696362,44,0
0,0,95,95,34,124,158,537,437,974,0.000333,2.371294,51,362808.0049,20156.00027,7113.882449,1035.294079,48,0
0,0,99,99,34,127,161,550,447,997,0.000333,2.436308,51,372755.1305,20708.61836,7308.924127,1060.536692,50,0
0,0,91,91,33,115,148,509,405,914,0.000333,2.19648,48,316293.1381,17571.841,6589.440376,953.696362,45,0
0,0,69,69,31,84,115,386,305,691,0.000333,1.576745,45,212860.5131,11825.58406,4730.233625,690.534749,33,0
0,0,60,60,30,79,109,357,285,642,0.000333,1.448391,45,195532.8451,10862.93584,4345.174337,645.205397,30,0
0,0,65,65,31,82,113,376,298,674,0.000333,1.532267,45,206856.0279,11492.00155,4596.800621,674.89935,32,0
0,0,59,59,30,79,109,353,282,635,0.000333,1.432599,45,193400.8671,10744.49262,4297.797046,645.205397,30,0
0,0,63,63,30,83,113,366,292,658,0.000333,1.495893,45,201945.4991,11219.19439,4487.677757,676.334991,32,0
0,0,66,66,31,82,113,380,300,680,0.000333,1.545907,45,208697.4763,11594.30424,4637.721694,674.89935,33,0
0,0,55,55,30,79,109,293,240,533,0.000333,1.202481,45,162334.901,9018.605613,3607.442245,645.205397,25,0
0,0,50,50,29,75,104,277,229,506,0.000333,1.130141,42,142397.7449,7910.985827,3390.422497,608.042851,23,0
0,0,55,55,30,79,109,296,242,538,0.000333,1.213761,45,163857.7425,9103.207917,3641.283167,645.205397,25,0
0,0,49,49,29,75,104,273,226,499,0.000333,1.114506,42,140427.8156,7801.545312,3343.519419,608.042851,23,0
0,0,53,53,29,78,107,286,236,522,0.000333,1.173015,42,147799.9222,8211.106789,3519.045767,631.142822,25,0
0,0,56,56,30,79,109,300,244,544,0.000333,1.227297,45,165685.1523,9204.730682,3681.892273,645.205397,26,0
0,0,103,103,29,93,122,555,435,990,0.000333,2.287143,56,384240.078,21346.671,6861.429964,749.023218,36,0
0,0,103,103,29,93,122,555,435,990,0.000333,2.287143,56,384240.078,21346.671,6861.429964,749.023218,36,0
0,0,105,105,29,95,124,562,442,1004,0.000333,2.327338,56,390992.7334,21721.81852,6982.013096,765.017732,36,0
0,0,95,95,29,88,117,525,409,934,0.000333,2.138974,56,359347.5563,19963.75313,6416.920648,709.311431,34,0
0,0,93,93,29,88,117,506,397,903,0.000333,2.06798,56,347420.6031,19301.14462,6203.939342,709.311431,33,0
0,0,97,97,29,90,119,532,416,948,0.000333,2.178762,56,366032.0854,20335.11586,6536.28724,725.148228,34,0
0,0,92,92,29,87,116,502,395,897,0.000333,2.050536,56,344490.1013,19138.33896,6151.608953,701.417533,32,0
0,0,95,95,29,88,117,525,409,934,0.000333,2.138974,56,359347.5563,19963.75313,6416.920648,709.311431,34,0
0,0,105,105,29,94,123,570,448,1018,0.000333,2.355827,56,395778.8669,21987.71483,7067.479766,757.012801,38,0
0,0,105,105,29,94,123,570,448,1018,0.000333,2.355827,56,395778.8669,21987.71483,7067.479766,757.012801,38,0
0,0,97,97,29,89,118,540,422,962,0.000333,2.207034,56,370781.7464,20598.98591,6621.102613,717.221724,36,0
0,0,95,95,29,89,118,521,410,931,0.000333,2.135914,56,358833.478,19935.19322,6407.740679,717.221724,35,0
0,0,99,99,29,91,120,547,429,976,0.000333,2.247042,56,377503.0124,20972.38958,6741.125221,733.090761,36,0
0,0,94,94,29,88,117,517,408,925,0.000333,2.118362,56,355884.8925,19771.38292,6355.087366,709.311431,34,0
0,0,97,97,29,89,118,540,422,962,0.000333,2.207034,56,370781.7464,20598.98591,6621.102613,717.221724,36,0
0,0,105,105,29,94,123,570,448,1018,0.000333,2.355827,56,395778.8669,21987.71483,7067.479766,757.012801,38,0
0,0,105,105,29,94,123,570,448,1018,0.000333,2.355827,56,395778.8669,21987.71483,7067.479766,757.012801,38,0
0,0,97,97,29,89,118,540,422,962,0.000333,2.207034,56,370781.7464,20598.98591,6621.102613,717.221724,36,0
0,0,95,95,29,89,118,521,410,931,0.000333,2.135914,56,358833.478,19935.19322,6407.740679,717.221724,35,0
0,0,99,99,29,91,120,547,429,976,0.000333,2.247042,56,377503.0124,20972.38958,6741.125221,733.090761,36,0
0,0,94,94,29,88,117,517,408,925,0.000333,2.118362,56,355884.8925,19771.38292,6355.087366,709.311431,34,0
0,0,97,97,29,89,118,540,422,962,0.000333,2.207034,56,370781.7464,20598.98591,6621.102613,717.221724,36,0
0,0,105,105,29,94,123,570,448,1018,0.000333,2.355827,56,395778.8669,21987.71483,7067.479766,757.012801,38,0
0,0,105,105,29,94,123,570,448,1018,0.000333,2.355827,56,395778.8669,21987.71483,7067.479766,757.012801,38,0
0,0,97,97,29,89,118,540,422,962,0.000333,2.207034,56,370781.7464,20598.98591,6621.102613,717.221724,36,0
0,0,95,95,29,89,118,521,410,931,0.000333,2.135914,56,358833.478,19935.19322,6407.740679,717.221724,35,0
0,0,99,99,29,91,120,547,429,976,0.000333,2.247042,56,377503.0124,20972.38958,6741.125221,733.090761,36,0
0,0,94,94,29,88,117,517,408,925,0.000333,2.118362,56,355884.8925,19771.38292,6355.087366,709.311431,34,0
0,0,97,97,29,89,118,540,422,962,0.000333,2.207034,56,370781.7464,20598.98591,6621.102613,717.221724,36,0
0,0,105,105,29,94,123,570,448,1018,0.000333,2.355827,56,395778.8669,21987.71483,7067.479766,757.012801,38,0
0,0,105,105,29,94,123,570,448,1018,0.000333,2.355827,56,395778.8669,21987.71483,7067.479766,757.012801,38,0
0,0,97,97,29,89,118,540,422,962,0.000333,2.207034,56,370781.7464,20598.98591,6621.102613,717.221724,36,0
0,0,95,95,29,89,118,521,410,931,0.000333,2.135914,56,358833.478,19935.19322,6407.740679,717.221724,35,0
0,0,99,99,29,91,120,547,429,976,0.000333,2.247042,56,377503.0124,20972.38958,6741.125221,733.090761,36,0
0,0,94,94,29,88,117,517,408,925,0.000333,2.118362,56,355884.8925,19771.38292,6355.087366,709.311431,34,0
0,0,97,97,29,89,118,540,422,962,0.000333,2.207034,56,370781.7464,20598.98591,6621.102613,717.221724,36,0
0,0,70,70,32,97,129,498,361,859,0.000333,2.007548,48,289086.9222,16060.38457,6022.644212,800.191546,33,0
0,0,68,68,31,96,127,479,349,828,0.000333,1.928877,45,260398.3914,14466.5773,5786.630921,785.736486,32,0
0,0,72,72,32,98,130,505,368,873,0.000333,2.043509,48,294265.3008,16348.07227,6130.527101,808.241565,33,0
0,0,67,67,31,96,127,475,347,822,0.000333,1.9149,45,258511.4466,14361.74703,5744.698813,785.736486,31,0
0,0,70,70,32,97,129,498,361,859,0.000333,2.007548,48,289086.9222,16060.38457,6022.644212,800.191546,33,0
0,0,78,78,34,105,139,526,386,912,0.000333,2.164158,51,331116.1872,18395.34373,6492.474258,877.969516,35,0
0,0,78,78,34,105,139,526,386,912,0.000333,2.164158,51,331116.1872,18395.34373,6492.474258,877.969516,35,0
0,0,80,80,34,106,140,533,393,926,0.000333,2.200572,51,336687.5198,18704.86221,6601.716074,886.133305,35,0
0,0,70,70,32,98,130,475,351,826,0.000333,1.933492,48,278422.8391,15467.9355,5800.475814,808.241565,31,0
0,0,68,68,31,97,128,456,339,795,0.000333,1.855,45,250425,13912.5,5565,793.771631,30,0
0,0,72,72,32,99,131,482,358,840,0.000333,1.969358,48,283587.6154,15754.86752,5908.075321,816.306305,31,0
0,0,67,67,31,97,128,452,337,789,0.000333,1.841,45,248535,13807.5,5523,793.771631,29,0
0,0,70,70,32,98,130,475,351,826,0.000333,1.933492,48,278422.8391,15467.9355,5800.475814,808.241565,31,0
0,0,78,78,34,105,139,503,376,879,0.000333,2.08585,51,319135.0093,17729.72274,6257.549203,877.969516,33,0
0,0,78,78,34,105,139,503,376,879,0.000333,2.08585,51,319135.0093,17729.72274,6257.549203,877.969516,33,0
0,0,80,80,34,106,140,510,383,893,0.000333,2.12215,51,324688.9364,18038.27425,6366.449734,886.133305,33,0
0,0,70,70,32,96,128,501,363,864,0.000333,2.016,48,290304,16128,6048,792.1564,33,0
0,0,68,68,31,95,126,482,351,833,0.000333,1.937358,45,261543.3379,14530.18544,5812.074176,777.716368,32,0
0,0,72,72,32,97,129,508,370,878,0.000333,2.051953,48,295481.1615,16415.62008,6155.85753,800.191546,33,0
0,0,67,67,31,95,126,478,349,827,0.000333,1.923403,45,259659.4724,14425.52624,5770.210497,777.716368,31,0
0,0,70,70,32,96,128,501,363,864,0.000333,2.016,48,290304,16128,6048,792.1564,33,0
0,0,78,78,34,104,138,529,388,917,0.000333,2.172839,51,332444.3633,18469.13129,6518.516927,869.819467,35,0
0,0,78,78,34,104,138,529,388,917,0.000333,2.172839,51,332444.3633,18469.13129,6518.516927,869.819467,35,0
0,0,80,80,34,105,139,536,395,931,0.000333,2.209245,51,338014.4411,18778.58006,6627.734139,877.969516,35,0
0,0,70,70,32,97,129,478,353,831,0.000333,1.94211,48,279663.8328,15536.8796,5826.329849,800.191546,31,0
0,0,68,68,31,96,127,459,341,800,0.000333,1.863649,45,251592.6487,13977.36937,5590.947749,785.736486,30,0
0,0,72,72,32,98,130,485,360,845,0.000333,1.977967,48,284827.2385,15823.73547,5933.900802,808.241565,31,0
0,0,67,67,31,96,127,455,339,794,0.000333,1.849672,45,249705.7039,13872.5391,5549.015641,785.736486,29,0
0,0,70,70,32,97,129,478,353,831,0.000333,1.94211,48,279663.8328,15536.8796,5826.329849,800.191546,31,0
0,0,78,78,34,104,138,506,378,884,0.000333,2.094645,51,320480.7166,17804.48426,6283.93562,869.819467,33,0
0,0,78,78,34,104,138,506,378,884,0.000333,2.094645,51,320480.7166,17804.48426,6283.93562,869.819467,33,0
0,0,80,80,34,105,139,513,385,898,0.000333,2.130936,51,326033.2632,18112.95907,6392.809083,877.969516,33,0
0,0,94,94,30,93,123,551,426,977,0.000333,2.260946,60,406970.2003,22609.45557,6782.836672,755.348487,40,0
0,0,96,96,30,95,125,558,433,991,0.000333,2.301031,60,414185.5336,23010.30742,6903.092226,771.343001,40,0
0,0,86,86,30,88,118,521,400,921,0.000333,2.112971,60,380334.8549,21129.71416,6338.914248,715.6367,38,0
0,0,84,84,30,88,118,502,388,890,0.000333,2.041851,60,367533.1388,20418.50771,6125.552314,715.6367,37,0
0,0,88,88,30,90,120,528,407,935,0.000333,2.152648,60,387476.5624,21526.47569,6457.942707,731.473497,38,0
0,0,83,83,30,87,117,498,386,884,0.000333,2.024467,60,364404.1447,20244.67471,6073.402412,707.742802,36,0
0,0,86,86,30,88,118,521,400,921,0.000333,2.112971,60,380334.8549,21129.71416,6338.914248,715.6367,38,0
0,0,94,94,30,93,123,551,426,977,0.000333,2.260946,60,406970.2003,22609.45557,6782.836672,755.348487,40,0
0,0,96,96,30,95,125,558,433,991,0.000333,2.301031,60,414185.5336,23010.30742,6903.092226,771.343001,40,0
0,0,86,86,30,88,118,521,400,921,0.000333,2.112971,60,380334.8549,21129.71416,6338.914248,715.6367,38,0
0,0,84,84,30,88,118,502,388,890,0.000333,2.041851,60,367533.1388,20418.50771,6125.552314,715.6367,37,0
0,0,88,88,30,90,120,528,407,935,0.000333,2.152648,60,387476.5624,21526.47569,6457.942707,731.473497,38,0
0,0,83,83,30,87,117,498,386,884,0.000333,2.024467,60,364404.1447,20244.67471,6073.402412,707.742802,36,0
0,0,86,86,30,88,118,521,400,921,0.000333,2.112971,60,380334.8549,21129.71416,6338.914248,715.6367,38,0
0,0,19,19,16,36,52,98,80,178,0.000333,0.338226,16,16234.85232,901.93624,1014.67827,250.1173,8,0
0,0,24,24,16,36,52,102,81,183,0.000333,0.347727,16,16690.8875,927.271527,1043.180468,250.1173,9,0
0,0,19,19,11,33,44,75,63,138,0.000333,0.251134,5,3767.007817,209.278212,753.401563,204.518754,5,0
0,0,19,19,16,36,52,98,80,178,0.000333,0.338226,16,16234.85232,901.93624,1014.67827,250.1173,8,0
0,0,24,24,16,36,52,102,81,183,0.000333,0.347727,16,16690.8875,927.271527,1043.180468,250.1173,9,0
0,0,19,19,11,33,44,75,63,138,0.000333,0.251134,5,3767.007817,209.278212,753.401563,204.518754,5,0
0,0,7,7,16,14,30,29,29,58,0.000333,0.094867,16,4553.594473,252.977471,284.599655,117.302969,3,0
0,0,5,5,12,13,25,22,23,45,0.000333,0.069658,6,1253.841171,69.657843,208.973529,91.125266,3,0
0,0,18,18,18,32,50,88,92,180,0.000333,0.338631,18,18286.09406,1015.894114,1015.894114,235.05865,2,0
0,0,21,21,18,33,51,95,100,195,0.000333,0.368708,27,29865.31943,1659.184413,1106.122942,241.523656,2,0
0,0,18,18,18,32,50,78,84,162,0.000333,0.304768,18,16457.48465,914.304703,914.304703,235.05865,2,0
0,0,18,18,18,32,50,78,84,162,0.000333,0.304768,18,16457.48465,914.304703,914.304703,235.05865,2,0
0,0,18,18,18,32,50,88,92,180,0.000333,0.338631,18,18286.09406,1015.894114,1015.894114,235.05865,2,0
1,0,3,4,10,13,23,18,16,34,0.000333,0.051267,5,769.005533,42.72253,153.801107,81.324997,1,0
1,0,3,4,10,13,23,18,16,34,0.000333,0.051267,5,769.005533,42.72253,153.801107,81.324997,1,0
1,0,3,4,10,13,23,18,16,34,0.000333,0.051267,5,769.005533,42.72253,153.801107,81.324997,1,0
1,0,3,4,10,13,23,18,16,34,0.000333,0.051267,5,769.005533,42.72253,153.801107,81.324997,1,0
1,0,4,5,14,11,25,23,20,43,0.000333,0.066562,7,1397.800713,77.655595,199.685816,91.356717,3,0
1,0,9,10,18,27,45,48,41,89,0.000333,0.162925,9,4398.97433,244.387463,488.774926,203.440613,9,0
1,0,66,67,19,56,75,238,212,450,0.000333,0.934323,27,75680.14709,4204.452616,2802.968411,405.922498,4,0
0,0,120,120,22,75,97,495,423,918,0.000333,2.019573,55,333229.5994,18512.75552,6058.719989,565.268897,19,0
3,0,18,21,18,28,46,84,70,154,0.000333,0.283543,18,15311.31374,850.628541,850.628541,209.664588,6,0
2,0,69,71,19,58,77,248,216,464,0.000333,0.969263,27,78510.30178,4361.683432,2907.788955,420.47352,5,0
0,0,121,121,22,78,100,499,422,921,0.000333,2.039664,55,336544.5353,18696.91863,6118.991551,588.368869,20,0
0,0,108,108,26,85,111,391,332,723,0.000333,1.637454,39,191582.1442,10643.45246,4912.362671,667.009662,23,0
0,0,60,60,20,50,70,229,196,425,0.000333,0.868315,30,78148.35847,4341.57547,2604.945282,368.631371,15,0
0,0,63,63,21,55,76,246,208,454,0.000333,0.94552,30,85096.77273,4727.598485,2836.559091,410.21345,16,0
0,0,106,106,24,113,137,471,413,884,0.000333,2.091553,36,225887.773,12549.32072,6274.660361,880.719323,14,0
0,0,58,58,18,78,96,309,277,586,0.000333,1.286263,27,104187.2767,5788.182038,3858.788025,565.320023,6,0
0,0,61,61,19,83,102,326,289,615,0.000333,1.367847,27,110795.6228,6155.312378,4103.541585,609.838896,7,0
0,0,98,98,26,111,137,490,388,878,0.000333,2.077357,39,243050.8146,13502.82303,6232.072169,876.391594,22,0
0,0,27,27,19,42,61,139,112,251,0.000333,0.496205,18,26795.07129,1488.615072,1488.615072,307.187955,12,0
2,0,110,112,31,92,123,435,354,789,0.000333,1.825881,45,246493.9775,13694.10986,5477.643945,753.747786,23,0
0,0,45,45,26,53,79,209,178,387,0.000333,0.813188,39,95142.96283,5285.720157,2439.56315,425.791217,17,0
0,0,53,53,24,55,79,243,208,451,0.000333,0.947668,36,102348.1842,5686.010235,2843.005117,428.013884,16,0
0,0,44,44,25,53,78,204,174,378,0.000333,0.791961,36,85531.75339,4751.764077,2375.882039,419.676189,21,0
0,0,45,45,26,54,80,209,178,387,0.000333,0.815529,39,95416.86074,5300.936708,2446.586173,432.975358,17,0
0,0,44,44,25,53,78,204,174,378,0.000333,0.791961,36,85531.75339,4751.764077,2375.882039,419.676189,16,0
0,0,45,45,25,54,79,206,173,379,0.000333,0.796378,36,86008.78453,4778.265807,2389.132904,426.86033,16,0
0,0,44,44,25,53,78,204,174,378,0.000333,0.791961,36,85531.75339,4751.764077,2375.882039,419.676189,16,0
0,0,44,44,25,54,79,206,174,380,0.000333,0.798479,36,86235.72064,4790.873369,2395.436684,426.86033,16,0
0,0,45,45,26,54,80,209,177,386,0.000333,0.813421,39,95170.30554,5287.239197,2440.264245,432.975358,17,0
0,0,45,45,26,55,81,208,176,384,0.000333,0.811501,39,94945.59364,5274.755202,2434.502401,440.186217,16,0
0,0,45,45,25,54,79,207,173,380,0.000333,0.798479,36,86235.72064,4790.873369,2395.436684,426.86033,16,0
0,0,44,44,25,53,78,205,174,379,0.000333,0.794056,36,85758.02787,4764.334882,2382.167441,419.676189,16,0
0,0,44,44,25,52,77,206,175,381,0.000333,0.795882,36,85955.24419,4775.291344,2387.645672,412.51927,16,0
0,0,45,45,26,54,80,209,177,386,0.000333,0.813421,39,95170.30554,5287.239197,2440.264245,432.975358,17,0
0,0,45,45,25,52,77,206,173,379,0.000333,0.791704,36,85504.03556,4750.224198,2375.112099,412.51927,15,0
0,0,44,44,25,53,78,208,174,382,0.000333,0.800341,36,86436.85131,4802.047295,2401.023648,419.676189,16,0
1,0,6,7,10,14,24,24,22,46,0.000333,0.070303,5,1054.541375,58.585632,210.908275,86.52225,2,0
4,0,101,105,30,77,107,412,310,722,0.000333,1.622446,60,292040.3499,16224.46388,4867.339164,629.749282,26,0
3,0,86,89,26,96,122,385,294,679,0.000333,1.568657,39,183532.8554,10196.26975,4705.970652,754.367833,36,0
2,0,84,86,26,95,121,367,285,652,0.000333,1.5037,39,175932.8544,9774.047467,4511.098831,746.347715,35,0
2,0,84,86,25,95,120,376,288,664,0.000333,1.528725,36,165102.3128,9172.350711,4586.175355,740.232688,35,0
2,0,83,85,24,93,117,361,280,641,0.000333,1.467968,36,158540.5363,8807.807571,4403.903785,718.180869,35,0
2,0,84,86,23,91,114,358,277,635,0.000333,1.446295,33,143183.2102,7954.622791,4338.885159,696.251237,36,0
2,0,83,85,24,95,119,370,285,655,0.000333,1.505369,36,162579.8029,9032.21127,4516.105635,734.175383,35,0
2,0,32,34,18,41,59,142,107,249,0.000333,0.488259,18,26366.00615,1464.778119,1464.778119,294.718282,16,0
3,0,92,95,26,101,127,416,317,733,0.000333,1.707569,39,199785.5291,11099.19606,5122.705875,794.690792,39,0
2,0,90,92,26,99,125,398,308,706,0.000333,1.639281,39,191795.9045,10655.32803,4917.843705,778.517738,38,0
2,0,90,92,25,100,125,407,311,718,0.000333,1.667144,36,180051.5922,10002.86623,5001.433116,780.482024,38,0
2,0,89,91,24,97,121,392,303,695,0.000333,1.60287,36,173109.9582,9617.2199,4808.60995,750.230646,38,0
2,0,90,92,23,95,118,389,300,689,0.000333,1.580714,33,156490.655,8693.925279,4742.141061,728.178208,39,0
2,0,89,91,24,98,122,401,308,709,0.000333,1.637964,36,176900.1398,9827.785545,4913.892772,758.280665,38,0
2,0,90,92,25,101,126,407,311,718,0.000333,1.669896,36,180348.7315,10019.37397,5009.686985,788.575765,38,0
2,0,41,43,20,60,80,197,151,348,0.000333,0.733344,20,44000.61954,2444.478863,2200.030977,440.851998,19,0
2,0,90,92,26,100,126,398,308,706,0.000333,1.641987,39,192112.4254,10672.91252,4925.959626,786.597052,38,0
2,0,90,92,25,101,126,407,311,718,0.000333,1.669896,36,180348.7315,10019.37397,5009.686985,788.575765,38,0
2,0,82,84,25,99,124,368,292,660,0.000333,1.529923,24,110154.4696,6119.692753,4589.769565,772.40271,34,0
2,0,89,91,24,98,122,392,303,695,0.000333,1.605621,36,173407.0482,9633.724899,4816.86245,758.280665,38,0
2,0,90,92,23,96,119,389,300,689,0.000333,1.58351,33,156767.4715,8709.303971,4750.529439,736.198325,39,0
2,0,89,91,24,99,123,401,308,709,0.000333,1.640748,36,177200.7402,9844.485569,4922.242784,766.345405,38,0
2,0,32,34,18,41,59,142,107,249,0.000333,0.488259,18,26366.00615,1464.778119,1464.778119,294.718282,16,0
3,0,92,95,26,100,126,416,317,733,0.000333,1.704782,39,199459.5012,11081.0834,5114.346184,786.597052,39,0
2,0,90,92,26,98,124,398,308,706,0.000333,1.636554,39,191476.8412,10637.60229,4909.662595,770.452997,38,0
2,0,90,92,25,99,124,407,311,718,0.000333,1.664371,36,179752.0662,9986.225902,4993.112951,772.40271,38,0
2,0,89,91,24,96,120,392,303,695,0.000333,1.600096,36,172810.4027,9600.577928,4800.288964,742.1955,38,0
2,0,90,92,23,94,117,389,300,689,0.000333,1.577894,33,156211.4826,8678.415702,4733.681292,720.173277,39,0
2,0,89,91,24,98,122,401,308,709,0.000333,1.637964,36,176900.1398,9827.785545,4913.892772,758.280665,38,0
2,0,90,92,25,100,125,407,311,718,0.000333,1.667144,36,180051.5922,10002.86623,5001.433116,780.482024,38,0
2,0,41,43,20,60,80,197,151,348,0.000333,0.733344,20,44000.61954,2444.478863,2200.030977,440.851998,19,0
2,0,90,92,26,99,125,398,308,706,0.000333,1.639281,39,191795.9045,10655.32803,4917.843705,778.517738,38,0
2,0,90,92,25,100,125,407,311,718,0.000333,1.667144,36,180051.5922,10002.86623,5001.433116,780.482024,38,0
2,0,82,84,25,99,124,368,292,660,0.000333,1.529923,24,110154.4696,6119.692753,4589.769565,772.40271,34,0
2,0,89,91,24,97,121,392,303,695,0.000333,1.60287,36,173109.9582,9617.2199,4808.60995,750.230646,38,0
2,0,90,92,23,95,118,389,300,689,0.000333,1.580714,33,156490.655,8693.925279,4742.141061,728.178208,39,0
2,0,89,91,24,99,123,401,308,709,0.000333,1.640748,36,177200.7402,9844.485569,4922.242784,766.345405,38,0
0,0,21,21,21,33,54,116,91,207,0.000333,0.397087,20,23825.23426,1323.624125,1191.261713,258.703672,8,0
1,0,92,93,30,74,104,487,398,885,0.000333,1.97663,75,444741.6863,24707.87146,5929.889151,606.706267,32,0
1,0,36,37,25,48,73,201,172,373,0.000333,0.769602,36,83116.96418,4617.609121,2308.80456,384.174605,11,0
0,0,7,7,12,11,23,42,32,74,0.000333,0.111581,12,4016.923017,223.16239,334.743585,81.073298,1,0
0,0,37,37,22,37,59,149,122,271,0.000333,0.531399,33,52608.47679,2922.693155,1594.196266,290.85727,10,0
0,0,34,34,19,35,54,136,113,249,0.000333,0.477656,27,38690.10868,2149.450482,1432.966988,260.235528,9,0
0,0,37,37,21,32,53,149,115,264,0.000333,0.504057,30,45365.13,2520.285,1512.171,252.238666,11,0
0,0,50,50,22,39,61,200,163,363,0.000333,0.717619,44,94725.73676,5262.540931,2152.857654,304.238182,10,0
0,0,47,47,19,37,56,187,154,341,0.000333,0.660103,36,71291.08902,3960.616057,1980.308028,273.460397,9,0
0,0,50,50,21,34,55,200,156,356,0.000333,0.686055,40,82326.56232,4573.697907,2058.164058,265.212402,11,0
0,0,72,72,28,67,95,383,312,695,0.000333,1.522017,56,255698.7803,14205.48779,4566.049648,541.033914,29,0
0,0,62,62,27,59,86,324,256,580,0.000333,1.242411,52,193816.145,10767.56361,3727.233558,475.457902,30,0
0,0,76,76,28,69,97,403,312,715,0.000333,1.572979,56,264260.5102,14681.13946,4718.937682,556.094125,35,0
0,0,71,71,28,65,93,377,309,686,0.000333,1.495288,56,251208.3249,13956.01805,4485.862944,526.059846,28,0
0,0,61,61,27,57,84,318,253,571,0.000333,1.216671,52,189800.6889,10544.48272,3650.013248,460.856693,29,0
0,0,75,75,28,67,95,397,309,706,0.000333,1.546106,56,259745.8113,14430.32285,4638.318059,541.033914,34,0
0,0,72,72,28,67,95,383,312,695,0.000333,1.522017,56,255698.7803,14205.48779,4566.049648,541.033914,29,0
0,0,62,62,27,59,86,324,256,580,0.000333,1.242411,52,193816.145,10767.56361,3727.233558,475.457902,30,0
0,0,76,76,28,69,97,403,312,715,0.000333,1.572979,56,264260.5102,14681.13946,4718.937682,556.094125,35,0
0,0,71,71,28,67,95,388,308,696,0.000333,1.524207,56,256066.6922,14225.92734,4572.619503,541.033914,27,0
0,0,61,61,27,59,86,329,252,581,0.000333,1.244553,52,194150.3108,10786.12838,3733.659822,475.457902,28,0
0,0,75,75,28,69,97,408,308,716,0.000333,1.575179,56,264630.1053,14701.67252,4725.537595,556.094125,33,0
0,0,5,5,12,17,29,29,25,54,0.000333,0.087444,6,1573.985842,87.443658,262.330974,112.506418,4,0
1,0,90,91,30,74,104,477,386,863,0.000333,1.927493,75,433685.9608,24093.66449,5782.479477,606.706267,32,0
1,0,34,35,24,48,72,191,160,351,0.000333,0.721881,36,77963.17232,4331.287351,2165.643676,378.1173,11,0
1,0,90,91,30,74,104,481,388,869,0.000333,1.940894,75,436701.1586,24261.17548,5822.682115,606.706267,32,0
1,0,34,35,24,48,72,195,162,357,0.000333,0.734221,36,79295.87612,4405.326451,2202.663226,378.1173,11,0
1,0,37,38,31,47,78,211,164,375,0.000333,0.785675,45,106066.1624,5892.56458,2357.025832,414.645762,16,0
1,0,39,40,31,49,80,249,193,442,0.000333,0.931431,45,125743.1498,6985.730545,2794.292218,428.700868,15,0
0,0,26,26,21,29,50,82,76,158,0.000333,0.297243,20,17834.58556,990.810309,891.729278,233.120115,9,0
0,0,28,28,23,29,52,96,86,182,0.000333,0.345827,22,22824.56063,1268.031146,1037.480029,244.923374,9,0
0,0,20,20,16,35,51,85,75,160,0.000333,0.302529,16,14521.40888,806.744938,907.588055,243.524906,2,0
0,0,28,28,20,46,66,141,101,242,0.000333,0.487581,20,29254.86754,1625.270419,1462.743377,340.522412,12,0
0,0,29,29,20,52,72,149,107,256,0.000333,0.5265,20,31590.01601,1755.000889,1579.5008,382.861427,12,0
0,0,11,11,14,31,45,60,53,113,0.000333,0.20686,7,4344.055799,241.336433,620.5794,206.883055,4,0
0,0,5,5,10,16,26,23,20,43,0.000333,0.067373,5,1010.594539,56.144141,202.118908,97.219281,4,0
0,0,32,32,26,47,73,167,145,312,0.000333,0.643742,39,75317.78523,4184.321402,1931.225262,383.277109,12,0
0,0,36,36,30,52,82,220,186,406,0.000333,0.860389,45,116152.4751,6452.915285,2581.166114,443.629583,12,0
0,0,36,36,30,52,82,220,186,406,0.000333,0.860389,45,116152.4751,6452.915285,2581.166114,443.629583,12,0
0,0,34,34,30,52,82,215,182,397,0.000333,0.841316,45,113577.6666,6309.870365,2523.948146,443.629583,11,0
0,0,9,9,13,17,30,41,35,76,0.000333,0.124308,12,4475.084223,248.61579,372.923685,117.592585,3,0
0,0,9,9,13,16,29,40,33,73,0.000333,0.118211,12,4255.591352,236.421742,354.632613,112.105716,3,0
0,0,9,9,13,17,30,41,35,76,0.000333,0.124308,12,4475.084223,248.61579,372.923685,117.592585,3,0
0,0,9,9,13,16,29,40,33,73,0.000333,0.118211,12,4255.591352,236.421742,354.632613,112.105716,3,0
0,0,9,9,13,16,29,40,33,73,0.000333,0.118211,12,4255.591352,236.421742,354.632613,112.105716,3,0
0,0,9,9,13,17,30,41,35,76,0.000333,0.124308,12,4475.084223,248.61579,372.923685,117.592585,3,0
0,0,18,18,20,30,50,95,77,172,0.000333,0.323581,20,19414.86529,1078.603627,970.743265,233.64528,5,0
0,0,37,37,30,74,104,282,247,529,0.000333,1.181511,45,159503.9675,8861.331527,3544.532611,606.706267,9,0
0,0,91,91,32,77,109,481,378,859,0.000333,1.937957,64,372087.7014,20671.53897,5813.870335,642.542564,37,0
0,0,83,83,32,81,113,450,352,802,0.000333,1.823261,64,350066.1458,19448.11921,5469.783528,673.52785,36,0
0,0,35,35,24,53,77,175,135,310,0.000333,0.647568,24,46624.89186,2590.27177,1942.703828,413.618884,12,0
0,0,92,92,33,99,132,544,435,979,0.000333,2.298821,64,441373.5579,24520.75322,6896.461843,822.771311,37,0
0,0,82,82,31,72,103,449,350,799,0.000333,1.780838,60,320550.8353,17808.37974,5342.513921,597.814686,37,0
0,0,11,11,14,24,38,56,40,96,0.000333,0.167934,7,3526.607289,195.922627,503.801041,163.342069,4,0
0,0,19,19,18,30,48,95,66,161,0.000333,0.299726,18,16185.22133,899.178963,899.178963,222.265368,9,0
0,0,19,19,18,30,48,95,66,161,0.000333,0.299726,18,16185.22133,899.178963,899.178963,222.265368,9,0
0,0,13,13,18,26,44,67,47,114,0.000333,0.207458,9,5601.376841,311.187602,622.375205,197.270083,9,0
0,0,13,13,18,26,44,67,47,114,0.000333,0.207458,9,5601.376841,311.187602,622.375205,197.270083,9,0
0,0,51,51,25,65,90,246,168,414,0.000333,0.895876,24,64503.05237,3583.502909,2687.627182,507.550313,19,0
0,0,50,50,25,68,93,259,178,437,0.000333,0.952537,24,68582.69761,3810.149867,2857.6124,530.043878,21,0
1,0,44,45,24,54,78,224,153,377,0.000333,0.789866,24,56870.31928,3159.462182,2369.596637,420.803025,18,0
0,0,114,114,35,81,116,489,348,837,0.000333,1.913377,68,390328.8463,21684.93591,5740.130093,693.052756,39,0
0,0,111,111,33,67,100,463,328,791,0.000333,1.751763,64,336338.5758,18685.47643,5255.290246,572.892982,37,0
0,0,122,122,35,86,121,501,353,854,0.000333,1.96957,68,401792.2259,22321.79033,5908.709205,732.183674,39,0
0,0,115,115,35,83,118,508,358,866,0.000333,1.98679,68,405305.0839,22516.94911,5960.368881,708.653178,41,0
0,0,112,112,33,68,101,482,338,820,0.000333,1.819911,64,349422.9386,19412.38548,5459.733416,580.412479,39,0
0,0,123,123,35,87,122,520,363,883,0.000333,2.039947,68,416149.1927,23119.39959,6119.841069,740.06099,41,0
0,0,117,117,35,83,118,513,362,875,0.000333,2.007438,68,409517.2614,22750.95897,6022.312668,708.653178,42,0
0,0,114,114,33,68,101,487,342,829,0.000333,1.839886,80,441572.5855,24531.81031,5519.657319,580.412479,40,0
0,0,125,125,35,87,122,525,367,892,0.000333,2.060739,68,420390.8039,23355.04466,6182.217705,740.06099,42,0
0,0,117,117,35,83,118,513,362,875,0.000333,2.007438,68,409517.2614,22750.95897,6022.312668,708.653178,42,0
0,0,114,114,33,68,101,487,342,829,0.000333,1.839886,80,441572.5855,24531.81031,5519.657319,580.412479,40,0
0,0,125,125,35,87,122,525,367,892,0.000333,2.060739,68,420390.8039,23355.04466,6182.217705,740.06099,42,0
0,0,81,81,34,82,116,433,301,734,0.000333,1.677919,51,256721.6606,14262.31448,5033.75805,694.293001,33,0
0,0,31,31,20,38,58,156,108,264,0.000333,0.515502,20,30930.13965,1718.341092,1546.506983,285.859807,14,0
0,0,81,81,34,82,116,434,302,736,0.000333,1.682491,51,257421.1746,14301.17637,5047.474012,694.293001,33,0
0,0,31,31,20,39,59,157,109,266,0.000333,0.521594,20,31295.66102,1738.647835,1564.783051,292.569248,14,0
0,0,25,25,16,47,63,131,111,242,0.000333,0.482167,16,23144.02786,1285.779326,1446.501741,325.065676,5,0
0,0,46,46,26,71,97,261,186,447,0.000333,0.983387,26,76704.18705,4261.343725,2950.16104,558.843478,29,0
0,0,43,43,25,59,84,235,166,401,0.000333,0.85444,24,61519.66288,3417.759049,2563.319287,463.172345,27,0
0,0,54,54,26,72,98,273,191,464,0.000333,1.023075,26,79799.85956,4433.325531,3069.225368,566.446033,29,0
0,0,54,54,27,75,102,293,209,502,0.000333,1.116519,26,87088.49556,4838.249754,3349.557522,595.543364,30,0
0,0,51,51,26,63,89,267,189,456,0.000333,0.984311,39,115164.4433,6398.02463,2952.934445,498.780068,28,0
0,0,62,62,26,76,102,305,214,519,0.000333,1.15433,26,90037.70757,5002.094865,3462.988752,597.053924,30,0
0,0,19,19,21,28,49,89,62,151,0.000333,0.282607,20,16956.42373,942.023541,847.821186,226.844604,5,0
0,0,15,15,21,29,50,112,67,179,0.000333,0.33675,20,20205.00516,1122.500287,1010.250258,233.120115,11,0
0,0,15,15,21,29,50,112,67,179,0.000333,0.33675,20,20205.00516,1122.500287,1010.250258,233.120115,11,0
0,0,6,6,13,12,25,43,21,64,0.000333,0.099069,6,1783.240777,99.068932,297.206796,91.125266,4,0
0,0,6,6,13,8,21,46,21,67,0.000333,0.098095,12,3531.423208,196.190178,294.285267,72.105716,4,0
1,0,19,20,19,36,55,100,71,171,0.000333,0.329538,9,8897.512599,494.306256,988.612511,266.827923,6,0
0,0,4,4,11,11,22,37,18,55,0.000333,0.081756,5,1226.343695,68.130205,245.268739,76.107496,2,0
1,0,15,16,15,30,45,68,49,117,0.000333,0.214182,7,4497.827686,249.879316,642.546812,205.810077,5,0
10,0,36,46,30,30,60,177,126,303,0.000333,0.596596,60,107387.271,5965.959502,1789.78785,294.413436,11,0
1,0,9,10,17,21,38,62,45,107,0.000333,0.187176,16,8984.451903,499.136217,561.528244,161.725534,6,0
1,0,9,10,18,21,39,72,50,122,0.000333,0.21494,18,11606.74327,644.819071,644.819071,167.297316,5,0
1,0,10,11,18,23,41,77,55,132,0.000333,0.235732,18,12729.54356,707.196865,707.196865,179.100575,5,0
1,0,7,8,14,19,33,47,38,85,0.000333,0.142925,14,6002.829002,333.4905,428.7735,134.013592,3,0
1,0,3,4,11,14,25,27,19,46,0.000333,0.071206,5,1068.086924,59.338162,213.617385,91.356717,1,0
1,0,7,8,13,11,24,38,22,60,0.000333,0.091699,12,3301.173001,183.3985,275.09775,86.159464,6,0
0,0,8,8,14,13,27,33,22,55,0.000333,0.087173,7,1830.631688,101.70176,261.518813,101.408685,4,0
1,0,8,9,12,13,25,32,26,58,0.000333,0.089781,12,3232.123908,179.562439,269.343659,91.125266,5,0
1,0,5,6,13,11,24,25,20,45,0.000333,0.068774,6,1237.939875,68.774438,206.323313,86.159464,3,0
1,0,7,8,14,18,32,42,31,73,0.000333,0.121667,7,2555,141.944444,365,128.361619,4,0
0,0,80,80,28,98,126,301,297,598,0.000333,1.390804,42,175241.3626,9735.631253,4172.413394,782.847503,30,0
0,0,76,76,26,82,108,293,262,555,0.000333,1.249654,39,146209.54,8122.752221,3748.962564,643.530697,26,0
0,0,78,78,28,98,126,295,288,583,0.000333,1.355918,28,113897.1175,6327.617637,4067.754195,782.847503,30,0
0,0,74,74,26,82,108,287,253,540,0.000333,1.21588,39,142257.9308,7903.218378,3647.639251,643.530697,26,0
0,0,39,39,20,49,69,169,150,319,0.000333,0.64954,30,58458.57905,3247.698836,1948.619302,361.559344,9,0
0,0,44,44,21,61,82,199,184,383,0.000333,0.811647,30,73048.27253,4058.237363,2434.942418,454.013643,16,0
0,0,44,44,21,61,82,199,184,383,0.000333,0.811647,30,73048.27253,4058.237363,2434.942418,454.013643,16,0
0,0,44,44,21,61,82,199,184,383,0.000333,0.811647,30,73048.27253,4058.237363,2434.942418,454.013643,16,0
0,0,45,45,22,60,82,206,189,395,0.000333,0.837078,33,82870.69038,4603.927243,2511.233042,452.520931,16,0
0,0,3,3,10,12,22,18,16,34,0.000333,0.05054,5,758.103375,42.116854,151.620675,76.238831,1,0
1,0,13,14,17,38,55,79,56,135,0.000333,0.260161,8,6243.868491,346.881583,780.483561,268.908114,11,0
1,0,14,15,17,41,58,92,65,157,0.000333,0.306568,8,7357.62413,408.756896,919.703016,289.1465,11,0
1,0,16,17,17,44,61,111,77,188,0.000333,0.37166,8,8919.828956,495.546053,1114.978619,309.70186,11,0
1,0,17,18,17,48,65,125,88,213,0.000333,0.427588,8,10262.11475,570.117486,1282.764344,337.565068,11,0
1,0,19,20,18,58,76,157,112,269,0.000333,0.560231,9,15126.23251,840.346251,1680.692501,414.821548,11,0
0,0,56,56,19,54,73,231,200,431,0.000333,0.889271,27,72030.98839,4001.721577,2667.814385,391.474548,11,0
0,0,56,56,19,55,74,232,200,432,0.000333,0.894161,27,72427.06406,4023.725781,2682.483854,398.685407,11,0
0,0,120,120,25,83,108,502,400,902,0.000333,2.03097,48,292459.6093,16247.75607,6092.908527,645.224678,25,0
0,0,121,121,26,81,107,506,400,906,0.000333,2.035923,52,317603.9927,17644.66626,6107.76909,635.739283,26,0
0,0,121,121,26,81,107,506,400,906,0.000333,2.035923,52,317603.9927,17644.66626,6107.76909,635.739283,26,0
0,0,121,121,26,81,107,506,400,906,0.000333,2.035923,52,317603.9927,17644.66626,6107.76909,635.739283,26,0
0,0,121,121,25,79,104,502,397,899,0.000333,2.007898,60,361421.7184,20078.98436,6023.695307,614.095084,25,0
0,0,121,121,26,81,107,506,400,906,0.000333,2.035923,52,317603.9927,17644.66626,6107.76909,635.739283,26,0
0,0,120,120,25,79,104,500,395,895,0.000333,1.998965,60,359813.6129,19989.64516,5996.893548,614.095084,25,0
0,0,52,52,19,53,72,221,192,413,0.000333,0.849393,27,68800.83369,3822.268538,2548.179026,384.290407,10,0
0,0,40,40,17,44,61,159,136,295,0.000333,0.583189,24,41989.62035,2332.756686,1749.567515,309.70186,7,0
0,0,33,33,14,37,51,123,104,227,0.000333,0.429214,14,18026.96774,1001.498208,1287.640553,246.052743,6,0
0,0,28,28,18,45,63,127,102,229,0.000333,0.456266,18,24638.34785,1368.797102,1368.797102,322.192039,6,0
0,0,28,28,18,45,63,128,102,230,0.000333,0.458258,18,24745.93888,1374.774382,1374.774382,322.192039,6,0
0,0,44,44,20,79,99,232,186,418,0.000333,0.92369,20,55421.42134,3078.967852,2771.071067,584.437241,11,0
0,0,41,41,20,79,99,219,176,395,0.000333,0.872865,20,52371.9173,2909.550961,2618.595865,584.437241,10,0
0,0,4,4,12,15,27,25,21,46,0.000333,0.072908,6,1312.348951,72.908275,218.724825,101.622909,1,0
0,0,4,4,12,15,27,25,21,46,0.000333,0.072908,6,1312.348951,72.908275,218.724825,101.622909,1,0
0,0,4,4,12,16,28,25,22,47,0.000333,0.075315,6,1355.674088,75.315227,225.945681,107.01955,2,0
0,0,47,47,19,45,64,178,154,332,0.000333,0.664,27,53784,2988,1992,327.844012,9,0
0,0,47,47,19,46,65,179,154,333,0.000333,0.668483,27,54147.10901,3008.172723,2005.448482,334.794473,9,0
0,0,70,70,26,90,116,249,251,500,0.000333,1.142997,26,89153.75294,4952.986274,3428.990498,706.478211,22,0
0,0,77,77,26,83,109,296,265,561,0.000333,1.26565,39,148081.1048,8226.728047,3796.951406,651.339705,26,0
0,0,68,68,26,90,116,243,242,485,0.000333,1.108707,26,86479.14035,4804.396686,3326.120783,706.478211,22,0
0,0,75,75,26,83,109,290,256,546,0.000333,1.23181,39,144121.717,8006.762056,3695.428641,651.339705,26,0
0,0,57,57,23,61,84,236,224,460,0.000333,0.980155,33,97035.37848,5390.85436,2940.466014,465.816903,21,0
0,0,61,61,27,71,98,245,235,480,0.000333,1.058354,39,123827.3683,6879.298238,3175.060725,565.014008,20,0
0,0,40,40,21,51,72,172,153,325,0.000333,0.668409,30,60156.76876,3342.042709,2005.225625,381.532358,9,0
0,0,45,45,22,63,85,202,187,389,0.000333,0.831084,22,54851.56763,3047.309313,2493.253074,474.676131,16,0
0,0,45,45,22,63,85,202,187,389,0.000333,0.831084,22,54851.56763,3047.309313,2493.253074,474.676131,16,0
0,0,45,45,22,63,85,202,187,389,0.000333,0.831084,22,54851.56763,3047.309313,2493.253074,474.676131,16,0
0,0,46,46,23,62,85,209,192,401,0.000333,0.856722,33,84815.47026,4711.97057,2570.165765,473.202096,16,0
0,0,3,3,10,12,22,18,16,34,0.000333,0.05054,5,758.103375,42.116854,151.620675,76.238831,1,0
1,0,27,28,28,38,66,204,134,338,0.000333,0.681002,42,85806.21892,4767.012162,2043.005212,334.027183,20,0
0,0,15,15,20,27,47,72,67,139,0.000333,0.257363,20,15441.75701,857.875389,772.08785,214.820524,5,0
0,0,9,9,20,24,44,69,49,118,0.000333,0.214738,20,12884.25862,715.792146,644.212931,196.477662,7,0
2,0,4,6,10,15,25,23,26,49,0.000333,0.07585,5,1137.744766,63.208043,227.548953,91.82264,2,0
2,0,4,6,10,15,25,23,26,49,0.000333,0.07585,5,1137.744766,63.208043,227.548953,91.82264,2,0
0,0,26,26,20,23,43,116,120,236,0.000333,0.426866,50,64029.92411,3557.218006,1280.598482,190.480487,19,0
0,0,36,36,21,32,53,133,117,250,0.000333,0.477327,30,42959.40341,2386.633523,1431.980114,252.238666,15,0
0,0,77,77,37,75,112,481,341,822,0.000333,1.865215,72,402886.4937,22382.58298,5595.645746,659.911176,35,0
0,0,77,77,37,75,112,481,341,822,0.000333,1.865215,72,402886.4937,22382.58298,5595.645746,659.911176,35,0
0,0,77,77,37,75,112,481,341,822,0.000333,1.865215,72,402886.4937,22382.58298,5595.645746,659.911176,35,0
0,0,77,77,37,75,112,481,341,822,0.000333,1.865215,72,402886.4937,22382.58298,5595.645746,659.911176,35,0
0,0,72,72,27,79,106,366,273,639,0.000333,1.433047,39,167666.5056,9314.805869,4299.14117,626.380642,20,0
0,0,66,66,27,60,87,299,201,500,0.000333,1.073824,39,125637.3982,6979.855454,3221.471748,482.795398,15,0
0,0,38,38,27,46,73,192,140,332,0.000333,0.685007,39,80145.84839,4452.547133,2055.021754,382.465813,15,0
0,0,61,61,25,64,89,294,190,484,0.000333,1.044752,24,75222.11953,4179.006641,3134.254981,500.096405,19,0
0,0,50,50,25,54,79,257,158,415,0.000333,0.872023,24,62785.65625,3488.092014,2616.06901,426.86033,17,0
0,0,37,37,23,46,69,176,114,290,0.000333,0.590491,22,38972.38603,2165.132557,1771.472092,358.125775,11,0
0,0,37,37,23,49,72,180,120,300,0.000333,0.616993,22,40721.50501,2262.305834,1850.9775,379.162707,11,0
0,0,37,37,23,49,72,180,120,300,0.000333,0.616993,22,40721.50501,2262.305834,1850.9775,379.162707,11,0
0,0,30,30,21,35,56,133,96,229,0.000333,0.443295,20,26597.68554,1477.649197,1329.884277,271.763571,12,0
0,0,31,31,21,36,57,131,95,226,0.000333,0.439411,20,26364.66286,1464.703492,1318.233143,278.355966,12,0
0,0,117,117,32,99,131,487,330,817,0.000333,1.915436,48,275822.7164,15323.48425,5746.306592,816.306305,29,0
0,0,77,77,37,75,112,481,341,822,0.000333,1.865215,72,402886.4937,22382.58298,5595.645746,659.911176,35,0
1,0,48,49,20,36,56,145,139,284,0.000333,0.549763,30,49478.66394,2748.814663,1649.288798,272.555862,17,0
1,0,10,11,18,15,33,46,38,84,0.000333,0.141243,18,7627.123908,423.729106,423.729106,133.662009,6,0
0,0,19,19,22,33,55,71,60,131,0.000333,0.252453,11,8330.939347,462.829964,757.358122,264.572502,4,0
0,0,19,19,22,33,55,71,60,131,0.000333,0.252453,11,8330.939347,462.829964,757.358122,264.572502,4,0
0,0,21,21,20,31,51,79,59,138,0.000333,0.260932,10,7827.946972,434.885943,782.794697,240.018648,2,0
0,0,27,27,25,50,75,126,103,229,0.000333,0.475466,24,34233.58752,1901.865973,1426.39948,398.289214,3,0
0,0,22,22,23,45,68,102,83,185,0.000333,0.375394,11,12387.98688,688.221493,1126.180626,351.175314,3,0
0,0,14,14,16,23,39,52,45,97,0.000333,0.170895,8,4101.472122,227.859562,512.684015,168.041925,5,0
0,0,17,17,18,27,45,62,51,113,0.000333,0.20686,9,5585.214599,310.2897,620.5794,203.440613,7,0
0,0,10,10,11,20,31,38,34,72,0.000333,0.118901,5,1783.510672,99.083926,356.702134,124.49231,2,0
0,0,14,14,17,29,46,79,70,149,0.000333,0.274337,16,13168.1717,731.565095,823.010731,210.368317,8,0
0,0,94,94,37,117,154,437,377,814,0.000333,1.971721,54,319418.8692,17745.49273,5915.164244,996.582447,27,0
0,0,75,75,29,101,130,334,292,626,0.000333,1.465334,28,123088.063,6838.225724,4396.002251,813.360809,23,0
0,0,77,77,29,103,132,336,292,628,0.000333,1.474627,28,123868.6262,6881.590344,4423.879507,829.591003,24,0
0,0,76,76,30,102,132,341,296,637,0.000333,1.49576,30,134618.3716,7478.798423,4487.279054,827.794103,24,0
0,0,76,76,29,100,129,337,294,631,0.000333,1.474695,28,123874.3631,6881.909064,4424.084398,805.267068,24,0
0,0,76,76,29,100,129,337,294,631,0.000333,1.474695,28,123874.3631,6881.909064,4424.084398,805.267068,24,0
0,0,76,76,30,100,130,341,296,637,0.000333,1.491083,30,134197.4489,7455.413828,4473.248297,811.592337,24,0
0,0,76,76,30,100,130,341,296,637,0.000333,1.491083,30,134197.4489,7455.413828,4473.248297,811.592337,24,0
0,0,99,99,40,113,153,465,396,861,0.000333,2.08287,60,374916.656,20828.70311,6248.610933,983.557347,30,0
0,0,79,79,31,99,130,350,300,650,0.000333,1.521513,45,205404.2585,11411.3477,4564.539078,809.886391,26,0
0,0,81,81,31,101,132,352,300,652,0.000333,1.530982,30,137788.349,7654.908276,4592.944966,826.059445,27,0
0,0,80,80,32,100,132,357,304,661,0.000333,1.552115,48,223504.5366,12416.9187,4656.344513,824.385619,27,0
0,0,80,80,31,98,129,353,302,655,0.000333,1.530785,45,206655.9234,11480.88463,4592.353852,801.82165,27,0
0,0,80,80,31,98,129,353,302,655,0.000333,1.530785,45,206655.9234,11480.88463,4592.353852,801.82165,27,0
0,0,80,80,32,99,131,357,304,661,0.000333,1.549698,48,223156.445,12397.58028,4649.092604,816.306305,27,0
0,0,80,80,32,99,131,357,304,661,0.000333,1.549698,48,223156.445,12397.58028,4649.092604,816.306305,27,0
0,0,99,99,40,113,153,465,396,861,0.000333,2.08287,60,374916.656,20828.70311,6248.610933,983.557347,30,0
0,0,79,79,31,99,130,350,300,650,0.000333,1.521513,45,205404.2585,11411.3477,4564.539078,809.886391,26,0
0,0,81,81,31,101,132,352,300,652,0.000333,1.530982,30,137788.349,7654.908276,4592.944966,826.059445,27,0
0,0,80,80,32,100,132,357,304,661,0.000333,1.552115,48,223504.5366,12416.9187,4656.344513,824.385619,27,0
0,0,80,80,31,98,129,353,302,655,0.000333,1.530785,45,206655.9234,11480.88463,4592.353852,801.82165,27,0
0,0,80,80,31,98,129,353,302,655,0.000333,1.530785,45,206655.9234,11480.88463,4592.353852,801.82165,27,0
0,0,80,80,32,99,131,357,304,661,0.000333,1.549698,48,223156.445,12397.58028,4649.092604,816.306305,27,0
0,0,80,80,32,99,131,357,304,661,0.000333,1.549698,48,223156.445,12397.58028,4649.092604,816.306305,27,0
0,0,79,79,29,99,128,342,297,639,0.000333,1.491,42,187866,10437,4473,797.187754,26,0
0,0,74,74,27,94,121,319,275,594,0.000333,1.369935,26,106854.9238,5936.384658,4109.804763,744.513315,25,0
0,0,76,76,27,96,123,321,275,596,0.000333,1.379246,26,107581.2048,5976.733599,4137.738645,760.538363,26,0
0,0,75,75,28,95,123,326,279,605,0.000333,1.400074,28,117606.1957,6533.67754,4200.221276,758.742221,26,0
0,0,75,75,27,93,120,322,277,599,0.000333,1.379076,26,107567.9141,5975.99523,4137.227467,736.523732,26,0
0,0,75,75,27,93,120,322,277,599,0.000333,1.379076,26,107567.9141,5975.99523,4137.227467,736.523732,26,0
0,0,75,75,28,93,121,326,279,605,0.000333,1.395304,42,175808.3149,9767.128603,4185.912259,742.747707,26,0
0,0,75,75,28,93,121,326,279,605,0.000333,1.395304,42,175808.3149,9767.128603,4185.912259,742.747707,26,0
0,0,83,83,28,116,144,399,353,752,0.000333,1.797261,42,226454.9112,12580.8284,5391.783601,930.131733,25,0
0,0,85,85,28,118,146,401,353,754,0.000333,1.807043,28,151791.5761,8432.865338,5421.127717,946.757818,26,0
0,0,84,84,29,117,146,406,357,763,0.000333,1.828612,42,230405.1178,12800.28432,5485.836138,944.714121,26,0
0,0,84,84,28,115,143,402,355,757,0.000333,1.806674,42,227640.9493,12646.71941,5420.022602,921.837294,26,0
0,0,84,84,28,115,143,402,355,757,0.000333,1.806674,42,227640.9493,12646.71941,5420.022602,921.837294,26,0
0,0,84,84,29,116,145,406,357,763,0.000333,1.82609,42,230087.3667,12782.63148,5478.270636,936.407244,26,0
0,0,84,84,29,116,145,406,357,763,0.000333,1.82609,42,230087.3667,12782.63148,5478.270636,936.407244,26,0
0,0,52,52,27,70,97,231,194,425,0.000333,0.934988,26,72929.03691,4051.613161,2804.962958,557.431774,20,0
0,0,47,47,25,65,90,208,172,380,0.000333,0.822301,24,59205.70024,3289.205569,2466.904177,507.550313,19,0
0,0,49,49,25,67,92,210,172,382,0.000333,0.830667,24,59808.01601,3322.667556,2492.000667,522.524381,20,0
0,0,48,48,26,66,92,215,176,391,0.000333,0.850238,26,66318.53085,3684.362825,2550.712725,521.141445,20,0
0,0,48,48,25,64,89,211,174,385,0.000333,0.831052,24,59835.7769,3324.209828,2493.157371,500.096405,20,0
0,0,48,48,25,64,89,211,174,385,0.000333,0.831052,24,59835.7769,3324.209828,2493.157371,500.096405,20,0
0,0,48,48,26,65,91,215,176,391,0.000333,0.848183,26,66158.24031,3675.457795,2544.547704,513.665341,20,0
0,0,48,48,26,65,91,215,176,391,0.000333,0.848183,26,66158.24031,3675.457795,2544.547704,513.665341,20,0
0,0,18,18,18,38,56,113,115,228,0.000333,0.441359,27,35750.0769,1986.115383,1324.076922,274.479896,2,0
0,0,15,15,15,34,49,65,75,140,0.000333,0.26202,14,11004.83129,611.379516,786.059378,231.577096,3,0
0,0,53,53,21,67,88,236,267,503,0.000333,1.083031,30,97472.82313,5415.15684,3249.094104,498.666642,5,0
0,0,32,32,17,58,75,147,158,305,0.000333,0.633263,16,30396.63521,1688.701956,1899.789701,409.249766,4,0
0,0,29,29,18,54,72,138,154,292,0.000333,0.600539,18,32429.12581,1801.6181,1801.6181,385.822575,3,0
0,0,31,31,17,56,73,140,151,291,0.000333,0.600413,16,28819.82315,1601.101286,1801.238947,394.698744,4,0
0,0,17,17,16,33,49,77,96,173,0.000333,0.323782,16,15541.51685,863.417603,971.344803,230.465006,3,0
0,0,19,19,15,35,50,79,93,172,0.000333,0.323581,14,13590.40571,755.022539,970.743265,238.128265,4,0
0,0,80,80,24,94,118,475,451,926,0.000333,2.124442,48,305919.7183,16995.5399,6373.327464,726.170452,6,0
0,0,34,34,18,53,71,149,169,318,0.000333,0.651873,27,52801.72877,2933.429376,1955.619584,378.638434,3,0
0,0,31,31,18,58,76,152,168,320,0.000333,0.666446,18,35988.06248,1999.336804,1999.336804,414.821548,3,0
0,0,33,33,17,60,77,154,165,319,0.000333,0.666368,16,31985.6785,1776.982139,1999.104906,423.900304,4,0
0,0,19,19,15,35,50,79,93,172,0.000333,0.323581,14,13590.40571,755.022539,970.743265,238.128265,4,0
0,0,17,17,16,33,49,77,96,173,0.000333,0.323782,16,15541.51685,863.417603,971.344803,230.465006,3,0
0,0,18,18,18,38,56,113,115,228,0.000333,0.441359,27,35750.0769,1986.115383,1324.076922,274.479896,2,0
0,0,15,15,15,34,49,65,75,140,0.000333,0.26202,14,11004.83129,611.379516,786.059378,231.577096,3,0
0,0,53,53,21,67,88,236,267,503,0.000333,1.083031,30,97472.82313,5415.15684,3249.094104,498.666642,5,0
0,0,32,32,17,58,75,147,158,305,0.000333,0.633263,16,30396.63521,1688.701956,1899.789701,409.249766,4,0
0,0,29,29,18,54,72,138,154,292,0.000333,0.600539,18,32429.12581,1801.6181,1801.6181,385.822575,3,0
0,0,31,31,17,56,73,140,151,291,0.000333,0.600413,16,28819.82315,1601.101286,1801.238947,394.698744,4,0
0,0,17,17,16,33,49,77,96,173,0.000333,0.323782,16,15541.51685,863.417603,971.344803,230.465006,3,0
0,0,19,19,15,35,50,79,93,172,0.000333,0.323581,14,13590.40571,755.022539,970.743265,238.128265,4,0
0,0,80,80,24,94,118,475,451,926,0.000333,2.124442,48,305919.7183,16995.5399,6373.327464,726.170452,6,0
0,0,34,34,18,53,71,149,169,318,0.000333,0.651873,27,52801.72877,2933.429376,1955.619584,378.638434,3,0
0,0,31,31,18,58,76,152,168,320,0.000333,0.666446,18,35988.06248,1999.336804,1999.336804,414.821548,3,0
0,0,33,33,17,60,77,154,165,319,0.000333,0.666368,16,31985.6785,1776.982139,1999.104906,423.900304,4,0
0,0,19,19,15,35,50,79,93,172,0.000333,0.323581,14,13590.40571,755.022539,970.743265,238.128265,4,0
0,0,17,17,16,33,49,77,96,173,0.000333,0.323782,16,15541.51685,863.417603,971.344803,230.465006,3,0
0,0,18,18,14,39,53,91,105,196,0.000333,0.374224,14,15717.41373,873.189652,1122.672409,259.433655,3,0
0,0,5,5,9,19,28,25,26,51,0.000333,0.081725,4,980.700404,54.483356,245.175101,109.239948,1,0
0,0,40,40,28,73,101,312,250,562,0.000333,1.247305,42,157160.4238,8731.134658,3741.914853,586.463131,29,0
0,0,37,37,27,67,94,288,230,518,0.000333,1.131759,39,132415.804,7356.433555,3395.277025,534.809938,29,0
0,0,38,38,27,70,97,300,238,538,0.000333,1.183584,39,138479.3713,7693.298403,3550.753109,557.431774,29,0
0,0,62,62,31,96,127,409,336,745,0.000333,1.735523,45,234295.6541,13016.42523,5206.570092,785.736486,41,0
0,0,64,64,30,95,125,416,343,759,0.000333,1.762343,45,237916.3622,13217.57568,5287.030272,771.343001,41,0
0,0,65,65,30,98,128,428,351,779,0.000333,1.817667,45,245385,13632.5,5453,795.448283,41,0
0,0,23,23,24,52,76,194,152,346,0.000333,0.720594,24,51882.79007,2882.377226,2161.78292,406.461965,22,0
0,0,51,51,28,84,112,329,272,601,0.000333,1.36374,42,171831.2529,9546.180719,4091.220308,671.560601,35,0
0,0,110,110,34,143,177,571,477,1048,0.000333,2.608684,51,399128.5814,22173.81008,7826.050616,1196.835338,59,0
0,0,94,94,31,126,157,500,405,905,0.000333,2.200544,45,297073.43,16504.07944,6601.631778,1032.717356,57,0
0,0,52,52,24,67,91,232,254,486,0.000333,1.054263,36,113860.375,6325.57639,3162.788195,516.467076,7,0
0,0,27,27,16,49,65,124,133,257,0.000333,0.515916,16,24763.97645,1375.776469,1547.748528,339.120782,5,0
0,0,15,15,14,28,42,63,75,138,0.000333,0.248047,14,10417.95726,578.775403,744.139804,187.908907,5,0
0,0,13,13,16,30,46,60,71,131,0.000333,0.241196,16,11577.38586,643.188103,723.586616,211.206718,4,0
0,0,15,15,15,32,47,62,71,133,0.000333,0.246253,14,10342.64444,574.591358,738.760317,218.603359,5,0
0,0,76,76,25,87,112,459,433,892,0.000333,2.024054,48,291463.7083,16192.42824,6072.16059,676.632489,7,0
0,0,29,29,16,53,69,138,147,285,0.000333,0.58031,16,27854.87152,1547.492862,1740.92947,367.579784,5,0
0,0,15,15,14,28,42,63,75,138,0.000333,0.248047,14,10417.95726,578.775403,744.139804,187.908907,5,0
0,0,97,97,36,117,153,469,387,856,0.000333,2.070775,54,335465.4956,18636.97198,6212.323993,989.949972,30,0
0,0,77,77,25,101,126,346,287,633,0.000333,1.472206,24,105998.8366,5888.824255,4416.618192,788.575765,26,0
0,0,79,79,25,103,128,348,287,635,0.000333,1.481667,24,106680,5926.666667,4445,804.805959,27,0
0,0,78,78,26,102,128,353,291,644,0.000333,1.502667,26,117208,6511.555556,4508,802.798818,27,0
0,0,78,78,25,100,125,349,289,638,0.000333,1.48139,24,106660.089,5925.560498,4444.170374,780.482024,27,0
0,0,78,78,25,100,125,349,289,638,0.000333,1.48139,24,106660.089,5925.560498,4444.170374,780.482024,27,0
0,0,78,78,26,100,126,353,291,644,0.000333,1.497789,26,116827.575,6490.420836,4493.368271,786.597052,27,0
0,0,78,78,26,100,126,353,291,644,0.000333,1.497789,26,116827.575,6490.420836,4493.368271,786.597052,27,0
0,0,68,68,25,87,112,297,257,554,0.000333,1.257092,24,90510.59104,5028.366169,3771.274627,676.632489,24,0
0,0,70,70,25,89,114,299,257,556,0.000333,1.266362,24,91178.08435,5065.449131,3799.086848,692.43668,25,0
0,0,69,69,26,88,114,304,261,565,0.000333,1.286861,26,100375.1543,5576.397462,3860.582858,690.641415,25,0
0,0,69,69,25,86,111,300,259,559,0.000333,1.266026,36,136730.8249,7596.156939,3798.078469,668.755174,25,0
0,0,69,69,25,86,111,300,259,559,0.000333,1.266026,36,136730.8249,7596.156939,3798.078469,668.755174,25,0
0,0,69,69,26,87,113,304,261,565,0.000333,1.284467,39,150282.6434,8349.035746,3853.401114,682.747517,25,0
0,0,69,69,26,87,113,304,261,565,0.000333,1.284467,39,150282.6434,8349.035746,3853.401114,682.747517,25,0
0,0,95,95,37,119,156,452,390,842,0.000333,2.04477,54,331252.6681,18402.92601,6134.308668,1013.233088,27,0
0,0,75,75,29,103,132,339,297,636,0.000333,1.493412,28,125446.5705,6969.253915,4480.23466,829.591003,23,0
0,0,77,77,29,105,134,341,297,638,0.000333,1.502722,28,126228.6173,7012.700961,4508.164904,845.877228,24,0
0,0,76,76,30,104,134,346,301,647,0.000333,1.52392,30,137152.7912,7619.59951,4571.759706,844.052449,24,0
0,0,76,76,29,102,131,342,299,641,0.000333,1.502808,28,126235.876,7013.104224,4508.424144,821.468834,24,0
0,0,76,76,29,102,131,342,299,641,0.000333,1.502808,28,126235.876,7013.104224,4508.424144,821.468834,24,0
0,0,76,76,30,102,132,346,301,647,0.000333,1.519241,30,136731.6899,7596.204992,4557.722995,827.794103,24,0
0,0,76,76,30,102,132,346,301,647,0.000333,1.519241,30,136731.6899,7596.204992,4557.722995,827.794103,24,0
0,0,82,82,28,115,143,393,344,737,0.000333,1.758942,28,147751.1049,8208.394717,5276.825175,921.837294,26,0
0,0,84,84,28,117,145,395,344,739,0.000333,1.768651,28,148566.6789,8253.704383,5305.952818,938.43861,27,0
0,0,83,83,29,116,145,400,348,748,0.000333,1.790191,42,225564.024,12531.33467,5370.571999,936.407244,27,0
0,0,83,83,28,114,142,396,346,742,0.000333,1.768371,42,222814.7192,12378.59551,5305.112363,913.555399,27,0
0,0,83,83,28,114,142,396,346,742,0.000333,1.768371,42,222814.7192,12378.59551,5305.112363,913.555399,27,0
0,0,83,83,29,115,144,400,348,748,0.000333,1.787701,42,225250.3638,12513.9091,5363.103901,928.112805,27,0
0,0,83,83,29,115,144,400,348,748,0.000333,1.787701,42,225250.3638,12513.9091,5363.103901,928.112805,27,0
0,0,82,82,28,115,143,395,348,743,0.000333,1.773261,42,223430.9449,12412.83027,5319.784403,921.837294,25,0
0,0,84,84,28,117,145,397,348,745,0.000333,1.783011,28,149772.9036,8320.716868,5349.032272,938.43861,26,0
0,0,83,83,29,116,145,402,352,754,0.000333,1.80455,42,227373.3611,12631.85339,5413.651454,936.407244,26,0
0,0,83,83,28,114,142,398,350,748,0.000333,1.78267,42,224616.4555,12478.69197,5348.010845,913.555399,26,0
0,0,83,83,28,114,142,398,350,748,0.000333,1.78267,42,224616.4555,12478.69197,5348.010845,913.555399,26,0
0,0,83,83,29,115,144,402,352,754,0.000333,1.802041,42,227057.1849,12614.28805,5406.123451,928.112805,26,0
0,0,83,83,29,115,144,402,352,754,0.000333,1.802041,42,227057.1849,12614.28805,5406.123451,928.112805,26,0
0,0,85,85,28,119,147,404,355,759,0.000333,1.821517,28,153007.4367,8500.413148,5464.55131,955.089252,26,0
0,0,87,87,28,121,149,406,355,761,0.000333,1.831262,28,153826.0428,8545.891269,5493.787244,971.78839,27,0
0,0,86,86,29,120,149,411,359,770,0.000333,1.85292,28,155645.2733,8646.959628,5558.759761,969.70832,27,0
0,0,86,86,28,118,146,407,357,764,0.000333,1.831009,42,230707.0904,12817.06058,5493.025963,946.757818,27,0
0,0,86,86,28,118,146,407,357,764,0.000333,1.831009,42,230707.0904,12817.06058,5493.025963,946.757818,27,0
0,0,86,86,29,119,148,411,359,770,0.000333,1.850426,42,233153.7218,12952.98455,5551.279092,961.364763,27,0
0,0,86,86,29,119,148,411,359,770,0.000333,1.850426,42,233153.7218,12952.98455,5551.279092,961.364763,27,0
0,0,85,85,36,116,152,412,348,760,0.000333,1.836142,54,297454.9452,16525.27473,5508.42491,981.643095,27,0
0,0,67,67,25,100,125,303,260,563,0.000333,1.307246,24,94121.67725,5228.98207,3921.736552,780.482024,23,0
0,0,69,69,25,102,127,305,260,565,0.000333,1.316202,24,94766.56435,5264.809131,3948.606848,796.68379,24,0
0,0,68,68,26,101,127,310,264,574,0.000333,1.337168,26,104299.1303,5794.396126,4011.50501,794.690792,24,0
0,0,68,68,25,99,124,306,262,568,0.000333,1.316661,24,94799.6041,5266.644672,3949.983504,772.40271,24,0
0,0,68,68,25,99,124,306,262,568,0.000333,1.316661,24,94799.6041,5266.644672,3949.983504,772.40271,24,0
0,0,68,68,26,99,125,310,264,574,0.000333,1.332787,26,103957.3647,5775.409148,3998.360179,778.517738,24,0
0,0,68,68,26,99,125,310,264,574,0.000333,1.332787,26,103957.3647,5775.409148,3998.360179,778.517738,24,0
0,0,13,13,19,41,60,87,100,187,0.000333,0.368196,18,19882.59375,1104.588541,1104.588541,300.370255,1,0
0,0,14,14,18,36,54,79,89,168,0.000333,0.322274,18,17402.77981,966.8211,966.8211,261.17595,2,0
0,0,16,16,18,36,54,85,94,179,0.000333,0.343375,18,18542.24753,1030.124863,1030.124863,261.17595,3,0
0,0,14,14,18,36,54,83,97,180,0.000333,0.345293,18,18645.83551,1035.87975,1035.87975,261.17595,2,0
0,0,14,14,18,36,54,83,93,176,0.000333,0.33762,18,18231.48361,1012.8602,1012.8602,261.17595,2,0
0,0,16,16,18,36,54,85,93,178,0.000333,0.341457,18,18438.65956,1024.369975,1024.369975,261.17595,3,0
0,0,43,43,20,58,78,205,236,441,0.000333,0.923954,40,110874.4951,6159.694174,2771.862379,426.20146,3,0
0,0,33,33,20,54,74,167,176,343,0.000333,0.709948,30,63895.27513,3549.737507,2129.842504,397.202487,4,0
0,0,30,30,20,52,72,158,172,330,0.000333,0.678692,30,61082.25751,3393.458751,2036.07525,382.861427,3,0
0,0,32,32,20,52,72,160,169,329,0.000333,0.676635,30,60897.15976,3383.175542,2029.905325,382.861427,4,0
0,0,18,18,18,37,55,97,114,211,0.000333,0.406622,27,32936.40629,1829.800349,1219.8669,267.808425,3,0
0,0,20,20,18,37,55,99,111,210,0.000333,0.404695,27,32780.30958,1821.12831,1214.08554,267.808425,4,0
0,0,70,70,23,85,108,444,420,864,0.000333,1.945408,44,256793.8033,14266.32241,5836.222802,648.840155,4,0
0,0,35,35,20,53,73,169,187,356,0.000333,0.734526,30,66107.32629,3672.629238,2203.577543,390.018346,3,0
0,0,32,32,20,56,76,172,186,358,0.000333,0.745586,30,67102.74149,3727.930083,2236.75805,411.650438,3,0
0,0,34,34,20,56,76,174,183,357,0.000333,0.743503,30,66915.30367,3717.51687,2230.510122,411.650438,4,0
0,0,20,20,18,37,55,99,111,210,0.000333,0.404695,27,32780.30958,1821.12831,1214.08554,267.808425,4,0
0,0,18,18,18,37,55,97,114,211,0.000333,0.406622,27,32936.40629,1829.800349,1219.8669,267.808425,3,0
0,0,19,19,20,26,46,96,64,160,0.000333,0.29459,20,17675.39826,981.96657,883.769913,208.649995,7,0
0,0,94,94,34,105,139,499,413,912,0.000333,2.164158,51,331116.1872,18395.34373,6492.474258,877.969516,43,0
0,0,79,79,34,96,130,435,363,798,0.000333,1.86795,51,285796.3253,15877.57363,5603.849515,805.130137,36,0
0,0,80,80,33,96,129,442,369,811,0.000333,1.895368,48,272933.0546,15162.94748,5686.105304,798.621406,37,0
0,0,79,79,34,96,130,435,363,798,0.000333,1.86795,51,285796.3253,15877.57363,5603.849515,805.130137,36,0
0,0,80,80,33,96,129,442,369,811,0.000333,1.895368,48,272933.0546,15162.94748,5686.105304,798.621406,37,0
0,0,79,79,34,96,130,435,363,798,0.000333,1.86795,51,285796.3253,15877.57363,5603.849515,805.130137,36,0
0,0,80,80,33,96,129,442,369,811,0.000333,1.895368,48,272933.0546,15162.94748,5686.105304,798.621406,37,0
0,0,79,79,34,96,130,435,363,798,0.000333,1.86795,51,285796.3253,15877.57363,5603.849515,805.130137,36,0
0,0,80,80,33,96,129,442,369,811,0.000333,1.895368,48,272933.0546,15162.94748,5686.105304,798.621406,37,0
0,0,79,79,34,96,130,435,363,798,0.000333,1.86795,51,285796.3253,15877.57363,5603.849515,805.130137,36,0
0,0,52,52,29,78,107,243,201,444,0.000333,0.997737,28,83809.91758,4656.106532,2993.211342,631.142822,18,0
0,0,37,37,28,69,97,179,151,330,0.000333,0.72599,28,60983.19466,3387.955259,2177.971238,556.094125,11,0
0,0,37,37,30,62,92,229,168,397,0.000333,0.863285,30,77695.6229,4316.423494,2589.854097,516.366889,9,0
0,0,48,48,29,62,91,233,178,411,0.000333,0.891568,28,74891.70072,4160.65004,2674.703597,510.04162,15,0
0,0,27,27,21,33,54,116,92,208,0.000333,0.399006,20,23940.33201,1330.018445,1197.0166,258.703672,7,0
0,0,32,32,21,38,59,132,105,237,0.000333,0.464729,20,27883.72805,1549.096003,1394.186403,291.659911,8,0
0,0,27,27,21,33,54,116,92,208,0.000333,0.399006,20,23940.33201,1330.018445,1197.0166,258.703672,7,0
0,0,46,46,26,51,77,209,158,367,0.000333,0.766637,39,89696.51576,4983.139764,2299.91066,411.505125,15,0
0,0,62,62,28,65,93,265,198,463,0.000333,1.00921,42,127160.4822,7064.471236,3027.63053,526.059846,20,0
0,0,35,35,23,49,72,154,114,268,0.000333,0.55118,22,36377.87781,2020.993212,1653.5399,379.162707,14,0
0,0,30,30,24,45,69,145,109,254,0.000333,0.517188,24,37237.56509,2068.753616,1551.565212,357.172489,13,0
0,0,13,13,13,30,43,60,51,111,0.000333,0.200772,6,3613.892327,200.771796,602.315388,195.312434,3,0
0,0,33,33,29,58,87,209,149,358,0.000333,0.768858,28,64584.0656,3588.003645,2306.573772,480.644347,11,0
0,0,12,12,15,25,40,62,40,102,0.000333,0.180946,7,3799.85666,211.103148,542.836666,174.699764,2,0
0,0,60,60,25,65,90,330,275,605,0.000333,1.30919,48,188523.4139,10473.523,3927.571123,507.550313,18,0
0,0,64,64,27,68,95,352,290,642,0.000333,1.405949,52,219328.0596,12184.8922,4217.847301,542.329436,21,0
0,0,62,62,25,69,94,346,288,634,0.000333,1.385203,48,199469.2479,11081.62489,4155.609332,537.584592,19,0
0,0,66,66,27,72,99,368,303,671,0.000333,1.482766,52,231311.5112,12850.63951,4448.298292,572.616563,22,0
0,0,60,60,25,65,90,330,275,605,0.000333,1.30919,48,188523.4139,10473.523,3927.571123,507.550313,18,0
0,0,64,64,27,68,95,352,290,642,0.000333,1.405949,52,219328.0596,12184.8922,4217.847301,542.329436,21,0
0,0,62,62,25,69,94,346,288,634,0.000333,1.385203,48,199469.2479,11081.62489,4155.609332,537.584592,19,0
0,0,66,66,27,72,99,368,303,671,0.000333,1.482766,52,231311.5112,12850.63951,4448.298292,572.616563,22,0
0,0,60,60,25,65,90,330,275,605,0.000333,1.30919,48,188523.4139,10473.523,3927.571123,507.550313,18,0
0,0,64,64,27,68,95,352,290,642,0.000333,1.405949,52,219328.0596,12184.8922,4217.847301,542.329436,21,0
0,0,62,62,25,69,94,346,288,634,0.000333,1.385203,48,199469.2479,11081.62489,4155.609332,537.584592,19,0
0,0,66,66,27,72,99,368,303,671,0.000333,1.482766,52,231311.5112,12850.63951,4448.298292,572.616563,22,0
0,0,60,60,25,65,90,330,275,605,0.000333,1.30919,48,188523.4139,10473.523,3927.571123,507.550313,18,0
0,0,64,64,27,68,95,352,290,642,0.000333,1.405949,52,219328.0596,12184.8922,4217.847301,542.329436,21,0
0,0,62,62,25,69,94,346,288,634,0.000333,1.385203,48,199469.2479,11081.62489,4155.609332,537.584592,19,0
0,0,66,66,27,72,99,368,303,671,0.000333,1.482766,52,231311.5112,12850.63951,4448.298292,572.616563,22,0
0,0,60,60,25,65,90,330,275,605,0.000333,1.30919,48,188523.4139,10473.523,3927.571123,507.550313,18,0
0,0,64,64,27,68,95,352,290,642,0.000333,1.405949,52,219328.0596,12184.8922,4217.847301,542.329436,21,0
0,0,62,62,25,69,94,346,288,634,0.000333,1.385203,48,199469.2479,11081.62489,4155.609332,537.584592,19,0
0,0,66,66,27,72,99,368,303,671,0.000333,1.482766,52,231311.5112,12850.63951,4448.298292,572.616563,22,0
0,0,74,74,29,79,108,408,333,741,0.000333,1.668457,56,280300.8118,15572.26732,5005.371639,638.880128,21,0
0,0,45,45,25,63,88,268,217,485,0.000333,1.044275,36,112781.6761,6265.64867,3132.824335,492.66504,15,0
0,0,59,59,27,74,101,349,278,627,0.000333,1.391566,39,162813.2454,9045.180299,4174.6986,587.881512,20,0
0,0,90,90,27,94,121,477,387,864,0.000333,1.992633,52,310850.6875,17269.48264,5977.897837,744.513315,42,0
0,0,49,49,27,65,92,290,232,522,0.000333,1.1351,39,132806.6743,7378.148572,3405.299341,519.83587,18,0
0,0,57,57,27,76,103,343,276,619,0.000333,1.379648,39,161418.8092,8967.711624,4138.943826,603.224454,18,0
0,0,88,88,26,94,120,471,385,856,0.000333,1.970766,52,307439.5142,17079.97301,5912.29835,738.342785,40,0
0,0,47,47,25,67,92,284,230,514,0.000333,1.117704,36,120711.9904,6706.221691,3353.110845,522.524381,16,0
0,0,61,61,27,78,105,365,291,656,0.000333,1.468182,39,171777.2573,9543.180962,4404.54506,618.643336,21,0
0,0,92,92,27,98,125,493,400,893,0.000333,2.073482,52,323463.159,17970.1755,6220.445366,776.623527,43,0
0,0,51,51,27,69,96,306,245,551,0.000333,1.209438,39,141504.2592,7861.347732,3628.314338,549.87015,19,0
0,0,34,34,25,76,101,199,164,363,0.000333,0.805644,24,58006.33844,3222.574358,2416.930768,590.938896,15,0
0,0,28,28,22,59,81,154,129,283,0.000333,0.598059,22,39471.90612,2192.883673,1794.177551,445.183436,9,0
0,0,61,61,27,80,107,335,264,599,0.000333,1.346046,39,157487.4103,8749.300571,4038.138725,634.13621,16,0
0,0,57,57,29,87,116,312,249,561,0.000333,1.282442,28,107725.1655,5984.731415,3847.327338,701.417533,24,0
0,0,57,57,31,90,121,322,253,575,0.000333,1.326115,30,119350.3908,6630.577269,3978.346361,737.846864,21,0
0,0,59,59,29,76,105,326,247,573,0.000333,1.282421,42,161585.0326,8976.946257,3847.262682,615.72394,18,0
0,0,60,60,31,94,125,346,267,613,0.000333,1.423342,30,128100.773,7116.709611,4270.025766,769.711438,24,0
0,0,53,53,29,85,114,305,242,547,0.000333,1.245864,28,104652.5435,5814.030192,3737.590838,685.679678,18,0
0,0,43,43,24,63,87,212,169,381,0.000333,0.818254,24,58914.27533,3273.015296,2454.761472,486.607735,12,0
0,0,28,28,21,60,81,152,124,276,0.000333,0.583266,20,34995.97202,1944.220668,1749.798601,446.652102,4,0
0,0,15,15,18,32,50,76,56,132,0.000333,0.24833,9,6704.901153,372.494509,744.989017,235.05865,5,0
0,0,14,14,18,31,49,75,54,129,0.000333,0.241433,9,6518.678129,362.148785,724.29757,228.638736,5,0
0,0,38,38,24,61,85,216,189,405,0.000333,0.865268,36,93448.91985,5191.606658,2595.803329,471.814078,12,0
0,0,42,42,26,63,89,238,204,442,0.000333,0.954091,39,111628.6929,6201.594049,2862.274176,498.780068,15,0
0,0,40,40,24,65,89,232,202,434,0.000333,0.936823,36,101176.8591,5620.936618,2810.468309,501.493008,13,0
0,0,44,44,26,67,93,254,217,471,0.000333,1.026648,39,120117.8082,6673.211567,3079.9438,528.639408,16,0
0,0,92,92,31,93,124,512,419,931,0.000333,2.158119,60,388461.4059,21581.18922,6474.356765,761.721855,25,0
0,0,53,53,28,77,105,283,229,512,0.000333,1.145898,28,96255.42374,5347.523541,3437.693705,617.148501,17,0
0,0,71,71,31,106,137,383,311,694,0.000333,1.642011,30,147781.028,8210.057109,4926.034266,866.739654,25,0
0,0,75,75,31,109,140,405,326,731,0.000333,1.737169,30,156345.1766,8685.843142,5211.505885,891.312177,28,0
0,0,119,119,31,91,122,587,392,979,0.000333,2.261731,60,407111.5112,22617.30618,6785.191853,745.789398,48,0
0,0,121,121,31,90,121,580,395,975,0.000333,2.248631,60,404753.4994,22486.30552,6745.891656,737.846864,48,0
0,0,108,108,35,93,128,549,388,937,0.000333,2.186333,68,446012,24778.44444,6559,787.666675,52,0
0,0,17,17,20,36,56,105,94,199,0.000333,0.385221,20,23113.27259,1284.070699,1155.663629,272.555862,8,0
0,0,17,17,20,35,55,104,93,197,0.000333,0.379643,20,22778.55727,1265.475404,1138.927864,265.963467,8,0
0,0,29,29,22,48,70,127,116,243,0.000333,0.496472,22,32767.14701,1820.397056,1489.415773,366.185696,12,0
0,0,88,88,30,90,120,433,310,743,0.000333,1.710607,45,230931.8871,12829.54928,5131.819713,731.473497,40,0
0,0,88,88,30,90,120,433,310,743,0.000333,1.710607,45,230931.8871,12829.54928,5131.819713,731.473497,40,0
0,0,88,88,30,90,120,433,310,743,0.000333,1.710607,45,230931.8871,12829.54928,5131.819713,731.473497,40,0
0,0,85,85,30,87,117,413,296,709,0.000333,1.623696,45,219198.9864,12177.72147,4871.088586,707.742802,39,0
0,0,44,44,23,61,84,198,151,349,0.000333,0.74364,22,49080.21317,2726.67851,2230.918781,465.816903,22,0
0,0,44,44,23,61,84,198,151,349,0.000333,0.74364,22,49080.21317,2726.67851,2230.918781,465.816903,22,0
0,0,44,44,23,61,84,198,151,349,0.000333,0.74364,22,49080.21317,2726.67851,2230.918781,465.816903,22,0
0,0,66,66,32,74,106,316,223,539,0.000333,1.208783,48,174064.758,9670.264333,3626.349125,619.499549,28,0
0,0,72,72,32,81,113,344,249,593,0.000333,1.348122,48,194129.574,10784.97633,4044.366125,673.52785,30,0
0,0,72,72,32,80,112,344,249,593,0.000333,1.345587,48,193764.5505,10764.69725,4036.761469,665.754248,30,0
0,0,62,62,31,69,100,293,206,499,0.000333,1.105095,30,99458.52716,5525.473731,3315.284239,575.068273,27,0
0,0,44,44,30,57,87,196,138,334,0.000333,0.717314,30,64558.29383,3586.571879,2151.943128,479.681449,20,0
0,0,50,50,32,64,96,224,164,388,0.000333,0.851655,32,81758.89441,4542.1608,2554.96545,544,22,0
0,0,50,50,32,63,95,224,164,388,0.000333,0.849701,32,81571.32723,4531.740402,2549.103976,536.568635,22,0
0,0,36,36,28,44,72,170,122,292,0.000333,0.600539,28,50445.30681,2802.517045,1801.6181,374.820929,16,0
0,0,18,18,18,34,52,76,66,142,0.000333,0.269821,9,7285.16196,404.73122,809.46244,248.032387,6,0
0,0,51,51,31,48,79,231,154,385,0.000333,0.808985,45,109213.0015,6067.38897,2426.955588,421.658286,22,0
0,0,24,24,24,35,59,121,91,212,0.000333,0.415707,24,29930.88784,1662.827102,1247.120326,289.564006,12,0
0,0,19,19,21,28,49,80,66,146,0.000333,0.273249,20,16394.95275,910.830708,819.747637,226.844604,11,0
0,0,92,92,30,80,110,439,315,754,0.000333,1.704382,45,230091.5351,12782.86306,5113.145224,652.960965,40,0
0,0,116,116,31,91,122,572,385,957,0.000333,2.210905,60,397962.9379,22109.05211,6632.715632,745.789398,47,0
0,0,82,82,30,86,116,430,294,724,0.000333,1.655059,45,223433.0208,12412.9456,4965.17824,699.865487,39,0
0,0,114,114,35,96,131,562,399,961,0.000333,2.25304,68,459620.1263,25534.45146,6759.119504,811.681306,59,0
0,0,13,13,17,27,44,73,52,125,0.000333,0.227476,8,5459.431619,303.301757,682.428952,197.868831,8,0
0,0,23,23,24,41,65,176,108,284,0.000333,0.570117,24,41048.45901,2280.469945,1710.352459,329.698732,19,0
0,0,19,19,19,32,51,99,76,175,0.000333,0.330891,18,17868.13983,992.674435,992.674435,240.710623,9,0
0,0,12,12,17,28,45,69,68,137,0.000333,0.250795,16,12038.14199,668.785666,752.383874,204.092806,6,0
0,0,12,12,17,28,45,69,68,137,0.000333,0.250795,16,12038.14199,668.785666,752.383874,204.092806,6,0
0,0,10,10,16,25,41,56,55,111,0.000333,0.198229,16,9515.01236,528.611798,594.688273,180.096405,6,0
0,0,9,9,15,20,35,51,42,93,0.000333,0.159008,14,6678.326488,371.018138,477.023321,145.041921,5,0
0,0,13,13,17,23,40,65,54,119,0.000333,0.211103,16,10132.95109,562.941727,633.309443,173.528793,7,0
0,0,85,85,30,87,117,413,296,709,0.000333,1.623696,45,219198.9864,12177.72147,4871.088586,707.742802,39,0
0,0,17,17,18,27,45,61,50,111,0.000333,0.203199,9,5486.361243,304.797847,609.595694,203.440613,10,0
0,0,62,62,31,69,100,293,206,499,0.000333,1.105095,30,99458.52716,5525.473731,3315.284239,575.068273,27,0
0,0,36,36,26,41,67,161,133,294,0.000333,0.594477,39,69553.77866,3864.098814,1783.430222,341.871065,20,0
1,0,13,14,13,14,27,71,42,113,0.000333,0.179101,18,9671.441179,537.302288,537.302288,101.408685,10,0
1,0,14,15,13,26,39,52,47,99,0.000333,0.174418,6,3139.528918,174.418273,523.25482,170.317149,12,0
1,0,7,8,14,19,33,38,30,68,0.000333,0.11434,7,2401.131601,133.3962,343.0188,134.013592,1,0
0,0,120,120,31,92,123,578,375,953,0.000333,2.205405,60,396972.9794,22054.05441,6616.216324,753.747786,45,0
0,0,25,25,21,43,64,133,94,227,0.000333,0.454,20,27240,1513.333333,1362,325.56805,8,0
0,0,22,22,19,36,55,117,83,200,0.000333,0.385424,18,20812.89497,1156.271943,1156.271943,266.827923,5,0
0,0,38,38,25,43,68,195,129,324,0.000333,0.657446,36,71004.16658,3944.675921,1972.337961,349.425789,10,0
0,0,90,90,31,90,121,471,309,780,0.000333,1.798904,45,242852.0996,13491.78331,5396.713325,737.846864,41,0
0,0,25,25,19,38,57,117,83,200,0.000333,0.388859,18,20998.40405,1166.578003,1166.578003,280.131868,13,0
0,0,27,27,19,41,60,131,94,225,0.000333,0.443017,18,23922.90691,1329.050384,1329.050384,300.370255,12,0
0,0,26,26,18,26,44,94,70,164,0.000333,0.298449,18,16116.24214,895.346785,895.346785,197.270083,9,0
0,0,120,120,31,92,123,578,375,953,0.000333,2.205405,60,396972.9794,22054.05441,6616.216324,753.747786,45,0
0,0,25,25,21,43,64,133,94,227,0.000333,0.454,20,27240,1513.333333,1362,325.56805,8,0
0,0,22,22,19,36,55,117,83,200,0.000333,0.385424,18,20812.89497,1156.271943,1156.271943,266.827923,5,0
0,0,38,38,25,43,68,195,129,324,0.000333,0.657446,36,71004.16658,3944.675921,1972.337961,349.425789,10,0
0,0,90,90,31,90,121,471,309,780,0.000333,1.798904,45,242852.0996,13491.78331,5396.713325,737.846864,41,0
0,0,25,25,19,38,57,117,83,200,0.000333,0.388859,18,20998.40405,1166.578003,1166.578003,280.131868,13,0
0,0,27,27,19,41,60,131,94,225,0.000333,0.443017,18,23922.90691,1329.050384,1329.050384,300.370255,12,0
0,0,9,9,14,18,32,50,37,87,0.000333,0.145,14,6090,338.333333,435,128.361619,2,0
0,0,51,51,27,55,82,247,161,408,0.000333,0.864627,26,67440.91167,3746.717315,2593.881218,446.356747,16,0
0,0,18,18,18,31,49,103,72,175,0.000333,0.327525,18,17686.33601,982.574223,982.574223,228.638736,5,0
0,0,33,33,25,51,76,171,116,287,0.000333,0.597718,24,43035.72471,2390.873595,1793.155196,405.390097,11,0
0,0,24,24,20,35,55,128,84,212,0.000333,0.408549,20,24512.96519,1361.831399,1225.648259,265.963467,9,0
0,0,20,20,18,32,50,111,76,187,0.000333,0.3518,18,18997.21994,1055.401107,1055.401107,235.05865,6,0
0,0,27,27,22,38,60,136,91,227,0.000333,0.446955,22,29499.01163,1638.83398,1340.864165,297.528741,10,0
3,0,37,40,31,72,103,277,201,478,0.000333,1.065382,30,95884.41756,5326.912087,3196.147252,597.814686,23,0
0,0,17,17,16,26,42,75,57,132,0.000333,0.237262,16,11388.5744,632.698578,711.7859,186.211433,4,0
0,0,14,14,16,24,40,65,49,114,0.000333,0.202233,16,9707.196845,539.288714,606.699803,174.0391,4,0
0,0,35,35,20,52,72,186,128,314,0.000333,0.645785,20,38747.12901,2152.618278,1937.35645,382.861427,17,0
0,0,52,52,29,76,105,282,213,495,0.000333,1.107851,28,93059.44288,5169.969049,3323.551531,615.72394,33,0
0,0,66,66,32,84,116,336,254,590,0.000333,1.348736,48,194218.0218,10789.8901,4046.208787,696.954664,36,0
0,0,74,74,32,84,116,372,280,652,0.000333,1.490468,48,214627.3732,11923.74296,4471.403609,696.954664,39,0
0,0,91,91,32,86,118,445,333,778,0.000333,1.784899,48,257025.422,14279.19011,5354.696292,712.658769,44,0
0,0,39,39,23,63,86,208,149,357,0.000333,0.764726,22,50471.88338,2803.993521,2294.176517,480.61056,20,0
0,0,53,53,26,71,97,262,190,452,0.000333,0.994387,26,77562.17572,4309.009762,2983.160605,558.843478,23,0
0,0,61,61,26,71,97,298,216,514,0.000333,1.130785,39,132301.8528,7350.102935,3392.355201,558.843478,26,0
0,0,78,78,26,73,99,371,269,640,0.000333,1.414263,39,165468.7412,9192.707847,4242.788237,574.068625,31,0
0,0,24,24,17,36,53,118,97,215,0.000333,0.410501,16,19704.04636,1094.669242,1231.502898,255.604168,17,0
0,0,24,24,17,37,54,122,91,213,0.000333,0.408597,16,19612.65661,1089.592034,1225.791038,262.236643,17,0
0,0,24,24,23,48,71,130,98,228,0.000333,0.467381,22,30847.13155,1713.729531,1402.142343,372.120125,16,0
0,0,20,20,18,37,55,98,83,181,0.000333,0.348809,18,18835.66995,1046.426108,1046.426108,267.808425,15,0
0,0,24,24,17,37,54,125,94,219,0.000333,0.420107,16,20165.12581,1120.284767,1260.320363,262.236643,17,0
0,0,26,26,18,40,58,122,89,211,0.000333,0.412011,18,22248.61182,1236.03399,1236.03399,287.935774,8,0
0,0,37,37,25,49,74,180,146,326,0.000333,0.674761,24,48582.76313,2699.042396,2024.281797,391.217187,22,0
0,0,52,52,28,70,98,251,184,435,0.000333,0.959133,28,80567.1659,4475.953661,2877.398782,563.655749,26,0
0,0,60,60,32,75,107,293,224,517,0.000333,1.161779,32,111530.8298,6196.157212,3485.338432,627.161402,38,0
0,0,26,26,19,43,62,118,95,213,0.000333,0.422748,18,22828.38865,1268.243814,1268.243814,314.040007,3,0
0,0,27,27,19,45,64,123,99,222,0.000333,0.444,18,23976,1332,1332,327.844012,3,0
0,0,22,22,19,37,56,89,69,158,0.000333,0.305854,9,8258.058699,458.781039,917.562078,273.460397,4,0
0,0,19,19,22,33,55,71,60,131,0.000333,0.252453,11,8330.939347,462.829964,757.358122,264.572502,4,0
0,0,19,19,22,33,55,71,60,131,0.000333,0.252453,11,8330.939347,462.829964,757.358122,264.572502,4,0
0,0,21,21,20,31,51,79,59,138,0.000333,0.260932,10,7827.946972,434.885943,782.794697,240.018648,2,0
0,0,27,27,25,50,75,126,103,229,0.000333,0.475466,24,34233.58752,1901.865973,1426.39948,398.289214,3,0
0,0,22,22,23,45,68,102,83,185,0.000333,0.375394,11,12387.98688,688.221493,1126.180626,351.175314,3,0
0,0,14,14,16,23,39,52,45,97,0.000333,0.170895,8,4101.472122,227.859562,512.684015,168.041925,5,0
0,0,17,17,18,27,45,62,51,113,0.000333,0.20686,9,5585.214599,310.2897,620.5794,203.440613,7,0
0,0,10,10,11,20,31,38,34,72,0.000333,0.118901,5,1783.510672,99.083926,356.702134,124.49231,2,0
0,0,8,8,10,21,31,35,30,65,0.000333,0.107341,5,1610.113801,89.450767,322.02276,125.457947,2,0
0,0,65,65,28,74,102,287,203,490,0.000333,1.089829,28,91545.67569,5085.870872,3269.488418,594.105487,25,0
0,0,69,69,32,91,123,292,221,513,0.000333,1.18717,32,113968.3181,6331.573229,3561.509941,752.209312,27,0
0,0,41,41,24,74,98,260,189,449,0.000333,0.990002,24,71280.11328,3960.006293,2970.00472,569.538649,10,0
0,0,21,21,28,33,61,104,78,182,0.000333,0.359798,28,30223.03747,1679.057637,1079.394195,301.070944,7,0
0,0,20,20,28,32,60,101,75,176,0.000333,0.346538,28,29109.15686,1617.175381,1039.612745,294.605938,7,0
0,0,17,17,24,28,52,91,64,155,0.000333,0.294523,24,21205.63575,1178.090875,883.568156,244.645038,8,0
0,0,16,16,24,28,52,88,61,149,0.000333,0.283122,24,20384.77243,1132.487357,849.365518,244.645038,8,0
0,0,8,8,15,26,41,67,41,108,0.000333,0.192872,7,4050.309315,225.017184,578.615616,180.814792,5,0
0,0,24,24,19,46,65,132,104,236,0.000333,0.47376,18,25583.01847,1421.278804,1421.278804,334.794473,12,0
0,0,94,94,39,109,148,504,357,861,0.000333,2.069113,57,353818.3428,19656.5746,6207.339348,943.862778,43,0
0,0,121,121,39,116,155,566,389,955,0.000333,2.316233,57,396075.832,22004.21289,6948.698807,1001.656482,46,0
0,0,95,95,36,130,166,501,376,877,0.000333,2.15597,36,232844.7449,12935.81916,6467.909581,1099.025116,45,0
0,0,81,81,33,87,120,454,303,757,0.000333,1.742839,48,250968.7767,13942.70982,5228.516181,727.00109,49,0
0,0,105,105,34,119,153,480,362,842,0.000333,2.036907,51,311646.7487,17313.70826,6110.720564,993.45705,42,0
0,0,107,107,32,114,146,492,382,874,0.000333,2.094636,48,301627.5199,16757.08444,6283.906664,938.949462,45,0
0,0,42,42,26,62,88,182,145,327,0.000333,0.704078,26,54918.08762,3051.004868,2112.234139,491.371604,10,0
0,0,72,72,31,84,115,372,267,639,0.000333,1.458089,45,196842.0664,10935.67036,4374.268143,690.534749,32,0
0,0,50,50,27,83,110,238,194,432,0.000333,0.976516,26,76168.2323,4231.568461,2929.547396,657.510235,19,0
1,0,15,16,14,24,38,67,50,117,0.000333,0.204669,14,8596.105267,477.561404,614.007519,163.342069,11,0
1,0,15,16,14,24,38,67,50,117,0.000333,0.204669,14,8596.105267,477.561404,614.007519,163.342069,11,0
1,0,12,13,18,29,47,57,47,104,0.000333,0.192559,9,5199.095165,288.83862,577.677241,215.940099,5,0
1,0,8,9,19,23,42,50,39,89,0.000333,0.159972,9,4319.246256,239.958125,479.916251,184.752548,5,0
1,0,20,21,16,35,51,93,70,163,0.000333,0.308202,16,14793.68529,821.871405,924.605331,243.524906,7,0
1,0,16,17,16,33,49,76,58,134,0.000333,0.25079,8,6018.968953,334.387164,752.371119,230.465006,6,0
1,0,16,17,16,34,50,75,57,132,0.000333,0.24833,8,5959.912136,331.10623,744.989017,236.973737,6,0
1,0,13,14,14,24,38,58,45,103,0.000333,0.180179,7,3783.755737,210.208652,540.536534,163.342069,6,0
1,0,16,17,16,41,57,85,65,150,0.000333,0.291645,8,6999.468017,388.859334,874.933502,283.659632,9,0
1,0,8,9,15,13,28,39,23,62,0.000333,0.099352,7,2086.392036,115.910669,298.056005,106.709075,6,0
1,0,35,36,21,46,67,212,140,352,0.000333,0.711754,30,64057.90185,3558.772325,2135.263395,346.322516,25,0
1,0,18,19,16,35,51,84,65,149,0.000333,0.28173,8,6761.531008,375.640612,845.191376,243.524906,6,0
0,0,23,23,17,36,53,110,89,199,0.000333,0.379952,16,18237.69873,1013.205485,1139.85617,255.604168,9,0
0,0,29,29,21,50,71,144,117,261,0.000333,0.535028,20,32101.67996,1783.426665,1605.083998,374.431475,10,0
0,0,89,89,31,69,100,379,306,685,0.000333,1.517014,60,273062.4894,15170.1383,4551.04149,575.068273,37,0
0,0,89,89,31,69,100,379,306,685,0.000333,1.517014,60,273062.4894,15170.1383,4551.04149,575.068273,37,0
0,0,34,34,26,47,73,234,155,389,0.000333,0.802614,39,93905.82838,5216.990466,2407.841753,383.277109,19,0
0,0,33,33,26,47,73,230,151,381,0.000333,0.786108,39,91974.60312,5109.700173,2358.323157,383.277109,18,0
0,0,59,59,23,44,67,400,284,684,0.000333,1.383068,66,273847.5304,15213.75169,4149.205006,344.256916,20,0
0,0,31,31,18,26,44,139,104,243,0.000333,0.442214,36,47759.1078,2653.283767,1326.641883,197.270083,20,0
0,0,59,59,23,44,67,400,284,684,0.000333,1.383068,66,273847.5304,15213.75169,4149.205006,344.256916,20,0
0,0,58,58,23,44,67,396,281,677,0.000333,1.368914,66,271044.9972,15058.0554,4106.742382,344.256916,20,0
1,0,58,59,26,38,64,211,146,357,0.000333,0.714,39,83538,4641,2142,321.632678,22,0
1,0,56,57,25,38,63,202,142,344,0.000333,0.685395,36,74022.63457,4112.368587,2056.184294,315.51765,21,0
1,0,59,60,25,38,63,214,149,363,0.000333,0.723251,36,78111.09404,4339.505224,2169.752612,315.51765,22,0
1,0,57,58,25,38,63,206,145,351,0.000333,0.699342,36,75528.90911,4196.050506,2098.025253,315.51765,21,0
1,0,59,60,25,38,63,214,149,363,0.000333,0.723251,36,78111.09404,4339.505224,2169.752612,315.51765,22,0
1,0,57,58,25,38,63,206,145,351,0.000333,0.699342,36,75528.90911,4196.050506,2098.025253,315.51765,21,0
1,0,19,20,18,21,39,59,45,104,0.000333,0.183227,18,9894.272954,549.681831,549.681831,167.297316,6,0
1,0,26,27,20,30,50,89,69,158,0.000333,0.297243,20,17834.58556,990.810309,891.729278,233.64528,7,0
1,0,16,17,14,21,35,48,39,87,0.000333,0.148749,7,3123.733357,173.540742,446.247622,145.541635,4,0
0,0,20,20,15,22,37,74,65,139,0.000333,0.241371,14,10137.59625,563.199792,724.114018,156.710855,5,0
0,0,36,36,17,33,50,123,107,230,0.000333,0.432696,24,31154.08617,1730.782565,1298.086924,235.951874,12,0
0,0,32,32,18,31,49,108,94,202,0.000333,0.378057,27,30622.62749,1701.257083,1134.171389,228.638736,11,0
0,0,36,36,18,33,51,124,106,230,0.000333,0.434886,27,35225.76137,1956.986743,1304.657829,241.523656,12,0
0,0,24,24,17,27,44,90,75,165,0.000333,0.300269,16,14412.89947,800.716637,900.806217,197.868831,10,0
0,0,4,4,7,9,16,10,12,22,0.000333,0.029333,3,264,14.666667,88,48.180809,1,0
0,0,35,35,23,31,54,120,98,218,0.000333,0.418188,33,41400.66069,2300.036705,1254.565475,257.622011,7,0
0,0,35,35,23,31,54,120,98,218,0.000333,0.418188,33,41400.66069,2300.036705,1254.565475,257.622011,7,0
0,0,35,35,23,31,54,120,98,218,0.000333,0.418188,33,41400.66069,2300.036705,1254.565475,257.622011,7,0
0,0,35,35,23,31,54,120,98,218,0.000333,0.418188,33,41400.66069,2300.036705,1254.565475,257.622011,7,0
0,0,12,12,13,14,27,42,35,77,0.000333,0.122042,12,4393.516052,244.084225,366.126338,101.408685,4,0
0,0,10,10,13,14,27,36,30,66,0.000333,0.104608,12,3765.870902,209.21505,313.822575,101.408685,4,0
0,0,20,20,17,21,38,77,63,140,0.000333,0.244903,24,17633.03645,979.613136,734.709852,161.725534,5,0
0,0,20,20,17,23,40,78,65,143,0.000333,0.253679,16,12176.57148,676.476193,761.035718,173.528793,5,0
1,0,4,5,7,8,15,10,12,22,0.000333,0.028651,3,257.854779,14.325266,85.951593,43.651484,1,0
0,0,21,21,24,32,56,104,82,186,0.000333,0.360056,24,25924.03237,1440.224021,1080.168016,270.0391,7,0
0,0,21,21,17,51,68,101,79,180,0.000333,0.365248,8,8765.946491,486.997027,1095.743311,358.780561,8,0
1,0,13,14,19,39,58,72,61,133,0.000333,0.259704,9,7012.003251,389.555736,779.111472,286.841309,14,0
1,0,14,15,18,22,40,97,62,159,0.000333,0.282062,18,15231.35821,846.186567,846.186567,173.166146,9,0
1,0,13,14,19,22,41,91,56,147,0.000333,0.26252,18,14176.0826,787.560145,787.560145,178.818118,9,0
0,0,113,113,32,95,127,558,424,982,0.000333,2.287629,64,439224.8552,24401.38084,6862.888362,784.136283,49,0
0,0,5,5,12,15,27,27,25,52,0.000333,0.082418,6,1483.524901,82.41805,247.25415,101.622909,1,0
1,0,13,14,13,24,37,42,36,78,0.000333,0.135446,6,2438.024175,135.445788,406.337363,158.144816,5,0
1,0,37,38,23,64,87,205,140,345,0.000333,0.740939,22,48901.94113,2716.774507,2222.815506,488.041925,18,0
0,0,75,75,31,86,117,432,302,734,0.000333,1.680949,45,226928.1467,12607.11926,5042.847704,706.238855,26,0
0,0,75,75,31,86,117,432,302,734,0.000333,1.680949,45,226928.1467,12607.11926,5042.847704,706.238855,26,0
0,0,77,77,31,87,118,443,308,751,0.000333,1.722955,45,232598.9219,12922.16233,5168.86493,714.11617,28,0
0,0,27,27,20,32,52,128,97,225,0.000333,0.427533,30,38477.9681,2137.664894,1282.598937,246.438562,8,0
0,0,26,26,18,32,50,123,93,216,0.000333,0.406358,18,21943.31287,1219.072937,1219.072937,235.05865,7,0
0,0,6,6,14,13,27,23,22,45,0.000333,0.071323,7,1497.789563,83.210531,213.969938,101.408685,1,0
0,0,9,9,16,16,32,43,29,72,0.000333,0.12,8,2880,160,360,128,4,0
0,0,17,17,18,23,41,59,49,108,0.000333,0.192872,18,10415.0811,578.615616,578.615616,179.100575,6,0
0,0,32,32,24,67,91,175,161,336,0.000333,0.728873,24,52478.85598,2915.491999,2186.618999,516.467076,6,0
0,0,27,27,23,58,81,141,138,279,0.000333,0.589606,22,38913.99932,2161.888851,1768.818151,443.804823,6,0
0,0,26,26,21,56,77,119,125,244,0.000333,0.509699,20,30581.91832,1698.995462,1529.095916,417.450542,7,0
0,0,38,38,22,70,92,287,222,509,0.000333,1.106831,33,109576.2702,6087.570565,3320.493036,527.157307,10,0
0,0,38,38,24,67,91,293,224,517,0.000333,1.12151,36,121123.0738,6729.059658,3364.529829,516.467076,11,0
0,0,37,37,22,68,90,282,219,501,0.000333,1.084139,33,107329.8072,5962.767069,3252.418401,512.054969,9,0
0,0,27,27,19,50,69,141,104,245,0.000333,0.498863,18,26938.59285,1496.588492,1496.588492,362.903432,4,0
0,0,30,30,18,44,62,190,122,312,0.000333,0.619236,18,33438.76648,1857.709249,1857.709249,315.273641,5,0
0,0,21,21,17,34,51,84,79,163,0.000333,0.308202,16,14793.68529,821.871405,924.605331,242.460605,7,0
0,0,33,33,20,48,68,140,123,263,0.000333,0.533668,20,32020.05455,1778.891919,1601.002727,354.516762,11,0
0,0,18,18,21,32,53,80,70,150,0.000333,0.286396,20,17183.76136,954.653409,859.188068,252.238666,9,0
1,0,11,12,14,13,27,42,35,77,0.000333,0.122042,14,5125.768727,284.764929,366.126338,101.408685,7,0
1,0,9,10,14,12,26,36,29,65,0.000333,0.101843,14,4277.400144,237.633341,305.528582,96.322519,7,0
1,0,8,9,14,21,35,37,32,69,0.000333,0.117974,7,2477.443697,137.635761,353.920528,145.541635,3,0
1,0,7,8,12,11,23,22,25,47,0.000333,0.070869,12,2551.288943,141.738275,212.607412,81.073298,1,0
1,0,7,8,12,12,24,22,25,47,0.000333,0.071831,12,2585.91885,143.662158,215.493238,86.0391,1,0
0,0,18,18,19,42,61,80,70,150,0.000333,0.296537,9,8006.495406,444.8053,889.610601,307.187955,3,0
0,0,72,72,35,86,121,403,335,738,0.000333,1.70204,51,260412.1745,14467.34303,5106.121069,732.183674,33,0
0,0,61,61,33,82,115,336,290,626,0.000333,1.428426,48,205693.2851,11427.40473,4285.276772,687.78427,27,0
0,0,66,66,34,82,116,377,315,692,0.000333,1.581908,51,242031.8653,13446.21474,4745.722849,694.293001,33,0
0,0,61,61,33,82,115,336,290,626,0.000333,1.428426,48,205693.2851,11427.40473,4285.276772,687.78427,27,0
0,0,72,72,35,87,122,397,326,723,0.000333,1.670308,51,255557.0778,14197.61544,5010.923095,740.06099,30,0
0,0,61,61,33,83,116,330,281,611,0.000333,1.396742,48,201130.8666,11173.93704,4190.226388,695.593279,24,0
0,0,64,64,34,77,111,371,302,673,0.000333,1.524214,51,233204.7358,12955.81865,4572.641878,655.5163,29,0
0,0,53,53,32,73,105,304,257,561,0.000333,1.255564,48,180801.2033,10044.51129,3766.691735,611.857193,23,0
0,0,68,68,35,82,117,380,313,693,0.000333,1.587054,51,242819.3003,13489.96113,4761.162751,700.84417,27,0
0,0,57,57,33,78,111,313,268,581,0.000333,1.315852,48,189482.6697,10526.81498,3947.555618,656.726379,21,0
0,0,52,52,34,67,101,290,243,533,0.000333,1.182942,51,180990.1627,10055.00904,3548.82672,579.401712,22,0
0,0,52,52,34,67,101,290,243,533,0.000333,1.182942,51,180990.1627,10055.00904,3548.82672,579.401712,22,0
0,0,51,51,34,65,99,284,234,518,0.000333,1.144669,51,175134.3432,9729.685733,3434.006729,564.427644,22,0
0,0,83,83,42,105,147,586,416,1002,0.000333,2.404691,63,454486.5164,25249.25091,7214.07169,931.473111,35,0
0,0,17,17,22,44,66,113,96,209,0.000333,0.421093,22,27792.12416,1544.006898,1263.278371,338.322487,4,0
0,0,24,24,24,49,73,189,133,322,0.000333,0.664375,24,47834.96419,2657.498011,1993.123508,385.159882,12,0
0,0,73,73,37,75,112,467,337,804,0.000333,1.824371,72,394064.1617,21892.45343,5473.113357,659.911176,34,0
0,0,73,73,37,75,112,467,337,804,0.000333,1.824371,72,394064.1617,21892.45343,5473.113357,659.911176,34,0
0,0,73,73,37,75,112,467,337,804,0.000333,1.824371,72,394064.1617,21892.45343,5473.113357,659.911176,34,0
0,0,73,73,37,75,112,467,337,804,0.000333,1.824371,72,394064.1617,21892.45343,5473.113357,659.911176,34,0
0,0,56,56,26,66,92,273,209,482,0.000333,1.048119,39,122629.9177,6812.773203,3144.356863,521.141445,14,0
0,0,66,66,29,63,92,305,207,512,0.000333,1.113355,42,140282.6763,7793.482017,3340.063722,517.450084,16,0
0,0,38,38,29,49,78,196,145,341,0.000333,0.714441,28,60013.02039,3334.056688,2143.322157,416.002231,16,0
0,0,47,47,25,54,79,253,161,414,0.000333,0.869922,24,62634.36551,3479.686973,2609.76523,426.86033,17,0
0,0,37,37,23,46,69,172,114,286,0.000333,0.582346,22,38434.83588,2135.26866,1747.037995,358.125775,11,0
0,0,36,36,23,49,72,180,121,301,0.000333,0.619049,22,40857.24336,2269.846853,1857.147425,379.162707,11,0
0,0,37,37,23,49,72,178,120,298,0.000333,0.612879,22,40450.02831,2247.223795,1838.63765,379.162707,11,0
0,0,28,28,21,35,56,133,98,231,0.000333,0.447166,20,26829.97974,1490.55443,1341.498987,271.763571,12,0
0,0,29,29,21,36,57,131,97,228,0.000333,0.4433,20,26597.97847,1477.66547,1329.898923,278.355966,12,0
0,0,99,99,30,91,121,431,303,734,0.000333,1.692815,45,228530.0527,12696.11404,5078.445616,739.41603,27,0
0,0,73,73,37,75,112,467,337,804,0.000333,1.824371,72,394064.1617,21892.45343,5473.113357,659.911176,34,0
0,0,68,68,17,102,119,319,253,572,0.000333,1.314612,16,63101.37217,3505.631787,3943.835761,750.074253,18,0
0,0,28,28,26,51,77,206,117,323,0.000333,0.674724,26,52628.47337,2923.804076,2024.172053,411.505125,17,0
0,0,21,21,26,47,73,149,90,239,0.000333,0.493123,13,19231.7849,1068.432495,1479.36807,383.277109,11,0
0,0,17,17,18,23,41,59,49,108,0.000333,0.192872,18,10415.0811,578.615616,578.615616,179.100575,6,0
1,0,67,68,21,40,61,359,242,601,0.000333,1.188124,60,213862.3884,11881.2438,3564.37314,305.11579,26,0
1,0,66,67,21,40,61,357,240,597,0.000333,1.180217,60,212439.0114,11802.1673,3540.650191,305.11579,26,0
1,0,26,27,19,32,51,126,84,210,0.000333,0.39707,18,21441.76779,1191.209322,1191.209322,240.710623,15,0
1,0,53,54,22,99,121,382,272,654,0.000333,1.508312,22,99548.60426,5530.478014,4524.936557,754.413801,59,0
1,0,53,54,23,99,122,382,272,654,0.000333,1.510901,22,99719.44881,5539.969378,4532.702219,760.34823,59,0
1,0,53,54,21,96,117,372,266,638,0.000333,1.461098,20,87665.85382,4870.325212,4383.292691,724.395066,59,0
1,0,53,54,21,96,117,372,266,638,0.000333,1.461098,20,87665.85382,4870.325212,4383.292691,724.395066,59,0
1,0,27,28,25,43,68,141,113,254,0.000333,0.515405,24,37109.17348,2061.620749,1546.215562,349.425789,12,0
1,0,17,18,22,28,50,149,87,236,0.000333,0.443983,33,43954.35201,2441.908445,1331.950061,232.713433,18,0
1,0,59,60,21,39,60,317,218,535,0.000333,1.053395,50,158009.3234,8778.295746,3160.186469,298.369352,22,0
1,0,27,28,24,36,60,133,97,230,0.000333,0.452862,24,32606.03609,1811.446449,1358.584837,296.1564,14,0
1,0,26,27,24,36,60,129,92,221,0.000333,0.435141,24,31330.14772,1740.563762,1305.422822,296.1564,14,0
1,0,30,31,25,43,68,149,112,261,0.000333,0.529609,24,38131.86724,2118.437069,1588.827802,349.425789,15,0
1,0,29,30,25,42,67,142,106,248,0.000333,0.501463,24,36105.36286,2005.853492,1504.390119,342.573737,15,0
1,0,34,35,25,46,71,167,131,298,0.000333,0.610875,24,43982.9914,2443.499522,1832.624642,370.180255,16,0
1,0,19,20,15,28,43,73,61,134,0.000333,0.242373,14,10179.67268,565.537371,727.119477,193.209297,7,0
1,0,24,25,15,29,44,89,75,164,0.000333,0.298449,14,12534.855,696.380833,895.346785,199.484808,9,0
1,0,14,15,19,27,46,74,52,126,0.000333,0.23199,9,6263.719258,347.984403,695.968806,209.092585,5,0
1,0,14,15,16,25,41,69,50,119,0.000333,0.212516,16,10200.77902,566.709945,637.548689,180.096405,3,0
0,0,26,26,19,43,62,118,95,213,0.000333,0.422748,18,22828.38865,1268.243814,1268.243814,314.040007,3,0
0,0,27,27,19,45,64,123,99,222,0.000333,0.444,18,23976,1332,1332,327.844012,3,0
0,0,22,22,19,37,56,89,69,158,0.000333,0.305854,9,8258.058699,458.781039,917.562078,273.460397,4,0
0,0,19,19,22,33,55,71,60,131,0.000333,0.252453,11,8330.939347,462.829964,757.358122,264.572502,4,0
0,0,19,19,22,33,55,71,60,131,0.000333,0.252453,11,8330.939347,462.829964,757.358122,264.572502,4,0
0,0,21,21,20,31,51,79,59,138,0.000333,0.260932,10,7827.946972,434.885943,782.794697,240.018648,2,0
0,0,27,27,25,50,75,126,103,229,0.000333,0.475466,24,34233.58752,1901.865973,1426.39948,398.289214,3,0
0,0,22,22,23,45,68,102,83,185,0.000333,0.375394,11,12387.98688,688.221493,1126.180626,351.175314,3,0
0,0,17,17,18,27,45,62,51,113,0.000333,0.20686,9,5585.214599,310.2897,620.5794,203.440613,7,0
0,0,14,14,16,23,39,52,45,97,0.000333,0.170895,8,4101.472122,227.859562,512.684015,168.041925,5,0
0,0,10,10,11,20,31,38,34,72,0.000333,0.118901,5,1783.510672,99.083926,356.702134,124.49231,2,0
0,0,26,26,19,43,62,118,95,213,0.000333,0.422748,18,22828.38865,1268.243814,1268.243814,314.040007,3,0
0,0,27,27,19,45,64,123,99,222,0.000333,0.444,18,23976,1332,1332,327.844012,3,0
0,0,22,22,19,37,56,89,69,158,0.000333,0.305854,9,8258.058699,458.781039,917.562078,273.460397,4,0
0,0,19,19,22,33,55,71,60,131,0.000333,0.252453,11,8330.939347,462.829964,757.358122,264.572502,4,0
0,0,19,19,22,33,55,71,60,131,0.000333,0.252453,11,8330.939347,462.829964,757.358122,264.572502,4,0
0,0,21,21,20,31,51,79,59,138,0.000333,0.260932,10,7827.946972,434.885943,782.794697,240.018648,2,0
0,0,27,27,25,50,75,126,103,229,0.000333,0.475466,24,34233.58752,1901.865973,1426.39948,398.289214,3,0
0,0,22,22,23,45,68,102,83,185,0.000333,0.375394,11,12387.98688,688.221493,1126.180626,351.175314,3,0
0,0,14,14,16,23,39,52,45,97,0.000333,0.170895,8,4101.472122,227.859562,512.684015,168.041925,5,0
0,0,17,17,18,27,45,62,51,113,0.000333,0.20686,9,5585.214599,310.2897,620.5794,203.440613,7,0
0,0,10,10,11,20,31,38,34,72,0.000333,0.118901,5,1783.510672,99.083926,356.702134,124.49231,2,0
0,0,27,27,26,52,78,173,141,314,0.000333,0.657872,26,51314.02372,2850.779095,1973.616297,418.634298,11,0
0,0,18,18,19,39,58,104,95,199,0.000333,0.388579,18,20983.28793,1165.738218,1165.738218,286.841309,8,0
0,0,19,19,19,39,58,103,94,197,0.000333,0.384674,18,20772.40061,1154.022256,1154.022256,286.841309,8,0
0,0,17,17,18,35,53,95,85,180,0.000333,0.343675,18,18558.46227,1031.025682,1031.025682,254.583556,7,0
0,0,18,18,19,39,58,102,91,193,0.000333,0.376863,18,20350.62598,1130.590332,1130.590332,286.841309,8,0
0,0,18,18,19,39,58,104,95,199,0.000333,0.388579,18,20983.28793,1165.738218,1165.738218,286.841309,8,0
0,0,17,17,19,36,55,96,87,183,0.000333,0.352663,18,19043.7989,1057.988828,1057.988828,266.827923,7,0
0,0,14,14,15,28,43,74,70,144,0.000333,0.260461,14,10939.34975,607.741653,781.382125,193.209297,7,0
0,0,15,15,15,28,43,73,69,142,0.000333,0.256843,14,10787.41433,599.300796,770.529595,193.209297,7,0
0,0,13,13,14,23,37,65,60,125,0.000333,0.217061,14,9116.54339,506.474633,651.181671,157.344894,6,0
0,0,14,14,15,28,43,72,66,138,0.000333,0.249608,14,10483.54351,582.419084,748.824536,193.209297,7,0
0,0,14,14,15,28,43,74,70,144,0.000333,0.260461,14,10939.34975,607.741653,781.382125,193.209297,7,0
0,0,13,13,15,25,40,66,62,128,0.000333,0.227069,14,9536.895146,529.827508,681.206796,174.699764,6,0
0,0,38,38,22,46,68,241,205,446,0.000333,0.905003,44,119460.3708,6636.687266,2715.008427,352.191346,12,0
0,0,38,38,22,46,68,241,205,446,0.000333,0.905003,44,119460.3708,6636.687266,2715.008427,352.191346,12,0
0,0,28,28,22,45,67,168,140,308,0.000333,0.622785,33,61655.73053,3425.318363,1868.355471,345.240885,12,0
0,0,28,28,22,46,68,168,142,310,0.000333,0.629038,33,62274.74487,3459.708048,1887.113481,352.191346,12,0
0,0,26,26,19,37,56,119,93,212,0.000333,0.410386,18,22160.86638,1231.159243,1231.159243,273.460397,6,0
0,0,78,78,24,87,111,344,245,589,0.000333,1.33397,24,96045.86269,5335.88126,4001.910945,670.575184,23,0
0,0,95,95,30,110,140,424,322,746,0.000333,1.772815,30,159553.3539,8864.075218,5318.445131,893.156286,36,0
0,0,33,33,20,42,62,168,116,284,0.000333,0.563664,20,33819.83504,1878.879725,1690.991752,312.915894,21,0
0,0,33,33,20,42,62,168,116,284,0.000333,0.563664,20,33819.83504,1878.879725,1690.991752,312.915894,21,0
0,0,33,33,20,42,62,168,116,284,0.000333,0.563664,20,33819.83504,1878.879725,1690.991752,312.915894,21,0
0,0,33,33,20,42,62,168,116,284,0.000333,0.563664,20,33819.83504,1878.879725,1690.991752,312.915894,21,0
0,0,33,33,20,41,61,168,115,283,0.000333,0.559466,20,33567.97333,1864.887407,1678.398667,306.098194,21,0
0,0,33,33,20,41,61,168,115,283,0.000333,0.559466,20,33567.97333,1864.887407,1678.398667,306.098194,21,0
0,0,44,44,20,51,71,209,150,359,0.000333,0.73592,20,44155.18432,2453.065795,2207.759216,375.732254,23,0
0,0,36,36,18,41,59,175,121,296,0.000333,0.580421,18,31342.72217,1741.262343,1741.262343,294.718282,21,0
0,0,36,36,18,40,58,175,121,296,0.000333,0.577987,27,46816.98411,2600.943562,1733.962375,287.935774,21,0
0,0,34,34,20,41,61,172,116,288,0.000333,0.569351,20,34161.04706,1897.835948,1708.052353,306.098194,22,0
0,0,34,34,20,42,62,172,117,289,0.000333,0.573588,20,34415.25467,1911.958593,1720.762734,312.915894,22,0
0,0,34,34,20,42,62,172,117,289,0.000333,0.573588,20,34415.25467,1911.958593,1720.762734,312.915894,22,0
0,0,34,34,20,42,62,172,117,289,0.000333,0.573588,20,34415.25467,1911.958593,1720.762734,312.915894,22,0
0,0,34,34,20,42,62,172,117,289,0.000333,0.573588,20,34415.25467,1911.958593,1720.762734,312.915894,22,0
0,0,34,34,20,41,61,172,116,288,0.000333,0.569351,20,34161.04706,1897.835948,1708.052353,306.098194,22,0
0,0,34,34,20,41,61,172,116,288,0.000333,0.569351,20,34161.04706,1897.835948,1708.052353,306.098194,22,0
0,0,37,37,20,43,63,183,127,310,0.000333,0.617652,20,37059.13553,2058.840863,1852.956776,319.767946,22,0
0,0,36,36,18,40,58,175,120,295,0.000333,0.576035,27,46658.81863,2592.15659,1728.104394,287.935774,21,0
0,0,36,36,18,41,59,175,121,296,0.000333,0.580421,18,31342.72217,1741.262343,1741.262343,294.718282,21,0
0,0,36,36,18,40,58,175,121,296,0.000333,0.577987,27,46816.98411,2600.943562,1733.962375,287.935774,21,0
0,0,37,37,20,43,63,183,127,310,0.000333,0.617652,20,37059.13553,2058.840863,1852.956776,319.767946,22,0
0,0,95,95,30,110,140,424,322,746,0.000333,1.772815,30,159553.3539,8864.075218,5318.445131,893.156286,36,0
0,0,33,33,20,42,62,168,116,284,0.000333,0.563664,20,33819.83504,1878.879725,1690.991752,312.915894,21,0
0,0,33,33,20,42,62,168,116,284,0.000333,0.563664,20,33819.83504,1878.879725,1690.991752,312.915894,21,0
0,0,33,33,20,42,62,168,116,284,0.000333,0.563664,20,33819.83504,1878.879725,1690.991752,312.915894,21,0
0,0,33,33,20,42,62,168,116,284,0.000333,0.563664,20,33819.83504,1878.879725,1690.991752,312.915894,21,0
0,0,33,33,20,41,61,168,115,283,0.000333,0.559466,20,33567.97333,1864.887407,1678.398667,306.098194,21,0
0,0,33,33,20,41,61,168,115,283,0.000333,0.559466,20,33567.97333,1864.887407,1678.398667,306.098194,21,0
0,0,44,44,20,52,72,209,150,359,0.000333,0.738334,20,44300.06151,2461.114528,2215.003076,382.861427,23,0
0,0,36,36,18,42,60,175,121,296,0.000333,0.582813,18,31471.91309,1748.439616,1748.439616,301.535982,21,0
0,0,36,36,18,41,59,175,121,296,0.000333,0.580421,18,31342.72217,1741.262343,1741.262343,294.718282,21,0
0,0,34,34,20,41,61,172,116,288,0.000333,0.569351,20,34161.04706,1897.835948,1708.052353,306.098194,22,0
0,0,34,34,20,42,62,172,117,289,0.000333,0.573588,20,34415.25467,1911.958593,1720.762734,312.915894,22,0
0,0,34,34,20,42,62,172,117,289,0.000333,0.573588,20,34415.25467,1911.958593,1720.762734,312.915894,22,0
0,0,34,34,20,42,62,172,117,289,0.000333,0.573588,20,34415.25467,1911.958593,1720.762734,312.915894,22,0
0,0,34,34,20,42,62,172,117,289,0.000333,0.573588,20,34415.25467,1911.958593,1720.762734,312.915894,22,0
0,0,34,34,20,41,61,172,116,288,0.000333,0.569351,20,34161.04706,1897.835948,1708.052353,306.098194,22,0
0,0,34,34,20,41,61,172,116,288,0.000333,0.569351,20,34161.04706,1897.835948,1708.052353,306.098194,22,0
0,0,37,37,20,42,62,183,127,310,0.000333,0.615267,30,55374.02569,3076.33476,1845.800856,312.915894,22,0
0,0,36,36,18,41,59,175,120,295,0.000333,0.57846,18,31236.83459,1735.3797,1735.3797,294.718282,21,0
0,0,36,36,18,42,60,175,121,296,0.000333,0.582813,18,31471.91309,1748.439616,1748.439616,301.535982,21,0
0,0,36,36,18,41,59,175,121,296,0.000333,0.580421,18,31342.72217,1741.262343,1741.262343,294.718282,21,0
0,0,37,37,20,42,62,183,127,310,0.000333,0.615267,30,55374.02569,3076.33476,1845.800856,312.915894,22,0
0,0,93,93,28,108,136,412,311,723,0.000333,1.708079,28,143478.5978,7971.033209,5124.235634,864.133788,34,0
0,0,31,31,17,40,57,156,105,261,0.000333,0.507461,16,24358.1487,1353.230483,1522.384294,282.363992,19,0
0,0,31,31,17,40,57,156,105,261,0.000333,0.507461,16,24358.1487,1353.230483,1522.384294,282.363992,19,0
0,0,31,31,17,40,57,156,105,261,0.000333,0.507461,16,24358.1487,1353.230483,1522.384294,282.363992,19,0
0,0,31,31,17,40,57,156,105,261,0.000333,0.507461,16,24358.1487,1353.230483,1522.384294,282.363992,19,0
0,0,31,31,17,39,56,156,104,260,0.000333,0.503304,16,24158.59648,1342.144249,1509.91228,275.617555,19,0
0,0,31,31,17,39,56,156,104,260,0.000333,0.503304,16,24158.59648,1342.144249,1509.91228,275.617555,19,0
0,0,42,42,18,49,67,197,139,336,0.000333,0.679402,18,36687.70742,2038.205968,2038.205968,350.179432,21,0
0,0,34,34,15,39,54,163,110,273,0.000333,0.523695,14,21995.18003,1221.954446,1571.084288,264.734045,19,0
0,0,34,34,15,38,53,163,110,273,0.000333,0.521241,14,21892.11198,1216.228443,1563.722284,258.024604,19,0
0,0,32,32,17,39,56,160,105,265,0.000333,0.512983,16,24623.18487,1367.954715,1538.949054,275.617555,20,0
0,0,32,32,17,40,57,160,106,266,0.000333,0.517183,16,24824.7799,1379.154439,1551.548744,282.363992,20,0
0,0,32,32,17,40,57,160,106,266,0.000333,0.517183,16,24824.7799,1379.154439,1551.548744,282.363992,20,0
0,0,32,32,17,40,57,160,106,266,0.000333,0.517183,16,24824.7799,1379.154439,1551.548744,282.363992,20,0
0,0,32,32,17,40,57,160,106,266,0.000333,0.517183,16,24824.7799,1379.154439,1551.548744,282.363992,20,0
0,0,32,32,17,39,56,160,105,265,0.000333,0.512983,16,24623.18487,1367.954715,1538.949054,275.617555,20,0
0,0,32,32,17,39,56,160,105,265,0.000333,0.512983,16,24623.18487,1367.954715,1538.949054,275.617555,20,0
0,0,35,35,17,40,57,171,116,287,0.000333,0.558013,16,26784.63095,1488.035053,1674.039434,282.363992,20,0
0,0,34,34,15,38,53,163,109,272,0.000333,0.519331,14,21811.92109,1211.773394,1557.994364,258.024604,19,0
0,0,34,34,15,39,54,163,110,273,0.000333,0.523695,14,21995.18003,1221.954446,1571.084288,264.734045,19,0
0,0,34,34,15,38,53,163,110,273,0.000333,0.521241,14,21892.11198,1216.228443,1563.722284,258.024604,19,0
0,0,35,35,17,40,57,171,116,287,0.000333,0.558013,16,26784.63095,1488.035053,1674.039434,282.363992,20,0
0,0,93,93,28,108,136,412,311,723,0.000333,1.708079,28,143478.5978,7971.033209,5124.235634,864.133788,34,0
0,0,31,31,17,40,57,156,105,261,0.000333,0.507461,16,24358.1487,1353.230483,1522.384294,282.363992,19,0
0,0,31,31,17,40,57,156,105,261,0.000333,0.507461,16,24358.1487,1353.230483,1522.384294,282.363992,19,0
0,0,31,31,17,40,57,156,105,261,0.000333,0.507461,16,24358.1487,1353.230483,1522.384294,282.363992,19,0
0,0,31,31,17,40,57,156,105,261,0.000333,0.507461,16,24358.1487,1353.230483,1522.384294,282.363992,19,0
0,0,31,31,17,39,56,156,104,260,0.000333,0.503304,16,24158.59648,1342.144249,1509.91228,275.617555,19,0
0,0,31,31,17,39,56,156,104,260,0.000333,0.503304,16,24158.59648,1342.144249,1509.91228,275.617555,19,0
0,0,42,42,18,50,68,197,139,336,0.000333,0.681796,18,36816.97526,2045.387515,2045.387515,357.25146,21,0
0,0,34,34,15,40,55,163,110,273,0.000333,0.526104,14,22096.35683,1227.575379,1578.311202,271.480483,19,0
0,0,34,34,15,39,54,163,110,273,0.000333,0.523695,14,21995.18003,1221.954446,1571.084288,264.734045,19,0
0,0,32,32,17,39,56,160,105,265,0.000333,0.512983,16,24623.18487,1367.954715,1538.949054,275.617555,20,0
0,0,32,32,17,40,57,160,106,266,0.000333,0.517183,16,24824.7799,1379.154439,1551.548744,282.363992,20,0
0,0,32,32,17,40,57,160,106,266,0.000333,0.517183,16,24824.7799,1379.154439,1551.548744,282.363992,20,0
0,0,32,32,17,40,57,160,106,266,0.000333,0.517183,16,24824.7799,1379.154439,1551.548744,282.363992,20,0
0,0,32,32,17,40,57,160,106,266,0.000333,0.517183,16,24824.7799,1379.154439,1551.548744,282.363992,20,0
0,0,32,32,17,39,56,160,105,265,0.000333,0.512983,16,24623.18487,1367.954715,1538.949054,275.617555,20,0
0,0,32,32,17,39,56,160,105,265,0.000333,0.512983,16,24623.18487,1367.954715,1538.949054,275.617555,20,0
0,0,35,35,17,40,57,171,116,287,0.000333,0.558013,16,26784.63095,1488.035053,1674.039434,282.363992,20,0
0,0,34,34,15,39,54,163,109,272,0.000333,0.521776,14,21914.61161,1217.478423,1565.329401,264.734045,19,0
0,0,34,34,15,40,55,163,110,273,0.000333,0.526104,14,22096.35683,1227.575379,1578.311202,271.480483,19,0
0,0,34,34,15,39,54,163,110,273,0.000333,0.523695,14,21995.18003,1221.954446,1571.084288,264.734045,19,0
0,0,35,35,17,40,57,171,116,287,0.000333,0.558013,16,26784.63095,1488.035053,1674.039434,282.363992,20,0
0,0,106,106,29,117,146,465,357,822,0.000333,1.970012,42,248221.5031,13790.0835,5910.035787,944.714121,38,0
0,0,36,36,18,41,59,175,120,295,0.000333,0.57846,18,31236.83459,1735.3797,1735.3797,294.718282,21,0
0,0,36,36,18,41,59,175,120,295,0.000333,0.57846,18,31236.83459,1735.3797,1735.3797,294.718282,21,0
0,0,36,36,18,41,59,175,120,295,0.000333,0.57846,18,31236.83459,1735.3797,1735.3797,294.718282,21,0
0,0,67,67,27,98,125,351,251,602,0.000333,1.397801,26,109028.4556,6057.136424,4193.402139,776.623527,33,0
0,0,67,67,27,98,125,351,251,602,0.000333,1.397801,26,109028.4556,6057.136424,4193.402139,776.623527,33,0
0,0,67,67,27,98,125,351,251,602,0.000333,1.397801,26,109028.4556,6057.136424,4193.402139,776.623527,33,0
0,0,106,106,29,116,145,465,357,822,0.000333,1.967295,42,247879.1814,13771.06564,5901.885272,936.407244,38,0
0,0,36,36,18,40,58,175,120,295,0.000333,0.576035,27,46658.81863,2592.15659,1728.104394,287.935774,21,0
0,0,36,36,18,40,58,175,120,295,0.000333,0.576035,27,46658.81863,2592.15659,1728.104394,287.935774,21,0
0,0,36,36,18,40,58,175,120,295,0.000333,0.576035,27,46658.81863,2592.15659,1728.104394,287.935774,21,0
0,0,67,67,27,99,126,351,251,602,0.000333,1.400108,26,109208.3854,6067.13252,4200.322514,784.688268,33,0
0,0,67,67,27,99,126,351,251,602,0.000333,1.400108,26,109208.3854,6067.13252,4200.322514,784.688268,33,0
0,0,67,67,27,99,126,351,251,602,0.000333,1.400108,26,109208.3854,6067.13252,4200.322514,784.688268,33,0
0,0,104,104,28,115,143,453,346,799,0.000333,1.906912,42,240270.9623,13348.3868,5720.737198,921.837294,36,0
0,0,34,34,15,39,54,163,109,272,0.000333,0.521776,14,21914.61161,1217.478423,1565.329401,264.734045,19,0
0,0,34,34,15,39,54,163,109,272,0.000333,0.521776,14,21914.61161,1217.478423,1565.329401,264.734045,19,0
0,0,34,34,15,39,54,163,109,272,0.000333,0.521776,14,21914.61161,1217.478423,1565.329401,264.734045,19,0
0,0,65,65,26,96,122,339,240,579,0.000333,1.337632,26,104335.3199,5796.40666,4012.896918,754.367833,31,0
0,0,65,65,26,96,122,339,240,579,0.000333,1.337632,26,104335.3199,5796.40666,4012.896918,754.367833,31,0
0,0,65,65,26,96,122,339,240,579,0.000333,1.337632,26,104335.3199,5796.40666,4012.896918,754.367833,31,0
0,0,104,104,28,114,142,453,346,799,0.000333,1.904216,42,239931.2138,13329.51188,5712.647948,913.555399,36,0
0,0,34,34,15,38,53,163,109,272,0.000333,0.519331,14,21811.92109,1211.773394,1557.994364,258.024604,19,0
0,0,34,34,15,38,53,163,109,272,0.000333,0.519331,14,21811.92109,1211.773394,1557.994364,258.024604,19,0
0,0,34,34,15,38,53,163,109,272,0.000333,0.519331,14,21811.92109,1211.773394,1557.994364,258.024604,19,0
0,0,65,65,26,97,123,339,240,579,0.000333,1.339905,26,104512.6134,5806.256298,4019.715899,762.402978,31,0
0,0,65,65,26,97,123,339,240,579,0.000333,1.339905,26,104512.6134,5806.256298,4019.715899,762.402978,31,0
0,0,65,65,26,97,123,339,240,579,0.000333,1.339905,26,104512.6134,5806.256298,4019.715899,762.402978,31,0
0,0,69,69,27,102,129,364,262,626,0.000333,1.463009,26,114114.7348,6339.707489,4389.028262,808.969347,35,0
0,0,68,68,27,102,129,360,261,621,0.000333,1.451324,26,113203.2753,6289.070848,4353.972126,808.969347,34,0
0,0,75,75,29,105,134,396,291,687,0.000333,1.618134,28,135923.2917,7551.293982,4854.403274,845.877228,37,0
0,0,69,69,27,103,130,364,262,626,0.000333,1.465334,26,114296.0585,6349.781029,4396.002251,817.091517,35,0
0,0,68,68,27,102,129,360,261,621,0.000333,1.451324,26,113203.2753,6289.070848,4353.972126,808.969347,34,0
0,0,75,75,29,104,133,396,291,687,0.000333,1.61566,28,135715.4129,7539.745163,4846.979033,837.72718,37,0
0,0,67,67,26,100,126,352,251,603,0.000333,1.402433,26,109389.7946,6077.210813,4207.299794,786.597052,33,0
0,0,66,66,26,100,126,348,250,598,0.000333,1.390804,26,108482.7483,6026.819347,4172.413394,786.597052,32,0
0,0,73,73,28,102,130,384,280,664,0.000333,1.554284,28,130559.8624,7253.325688,4662.852228,815.193323,35,0
0,0,67,67,26,101,127,352,251,603,0.000333,1.404726,26,109568.5985,6087.144362,4214.176866,794.690792,33,0
0,0,66,66,26,100,126,348,250,598,0.000333,1.390804,26,108482.7483,6026.819347,4172.413394,786.597052,32,0
0,0,73,73,28,102,130,384,280,664,0.000333,1.554284,28,130559.8624,7253.325688,4662.852228,815.193323,35,0
1,0,18,19,15,32,47,70,58,128,0.000333,0.236996,7,4976.911611,276.49509,710.987373,218.603359,2,0
0,0,10,10,17,26,43,54,47,101,0.000333,0.182684,8,4384.421922,243.578996,548.05274,191.698301,2,0
0,0,18,18,18,36,54,85,73,158,0.000333,0.303091,18,16366.90006,909.272225,909.272225,261.17595,4,0
0,0,16,16,19,33,52,77,65,142,0.000333,0.269821,9,7285.16196,404.73122,809.46244,247.175629,4,0
0,0,16,16,21,33,54,85,70,155,0.000333,0.297336,20,17840.15126,991.119514,892.007563,258.703672,4,0
0,0,16,16,19,32,51,77,65,142,0.000333,0.268495,18,14498.71917,805.484399,805.484399,240.710623,4,0
0,0,16,16,21,33,54,85,70,155,0.000333,0.297336,20,17840.15126,991.119514,892.007563,258.703672,4,0
0,0,17,17,19,33,52,85,72,157,0.000333,0.298323,18,16109.44264,894.969036,894.969036,247.175629,5,0
0,0,16,16,19,31,50,78,67,145,0.000333,0.272786,18,14730.46466,818.359148,818.359148,234.290708,4,0
0,0,18,18,19,35,54,89,72,161,0.000333,0.308846,18,16677.66398,926.536888,926.536888,260.235528,5,0
0,0,16,16,21,33,54,85,70,155,0.000333,0.297336,20,17840.15126,991.119514,892.007563,258.703672,4,0
0,0,16,16,21,33,54,85,70,155,0.000333,0.297336,20,17840.15126,991.119514,892.007563,258.703672,4,0
0,0,16,16,21,33,54,85,70,155,0.000333,0.297336,20,17840.15126,991.119514,892.007563,258.703672,4,0
0,0,16,16,19,34,53,78,66,144,0.000333,0.27494,9,7423.384909,412.410273,824.820545,253.684359,4,0
0,0,16,16,19,33,52,77,65,142,0.000333,0.269821,9,7285.16196,404.73122,809.46244,247.175629,4,0
0,0,16,16,21,33,54,85,70,155,0.000333,0.297336,20,17840.15126,991.119514,892.007563,258.703672,4,0
0,0,16,16,21,33,54,85,70,155,0.000333,0.297336,20,17840.15126,991.119514,892.007563,258.703672,4,0
0,0,16,16,21,33,54,85,70,155,0.000333,0.297336,20,17840.15126,991.119514,892.007563,258.703672,4,0
0,0,16,16,21,33,54,85,70,155,0.000333,0.297336,20,17840.15126,991.119514,892.007563,258.703672,4,0
0,0,16,16,21,33,54,85,70,155,0.000333,0.297336,20,17840.15126,991.119514,892.007563,258.703672,4,0
0,0,16,16,21,33,54,85,70,155,0.000333,0.297336,20,17840.15126,991.119514,892.007563,258.703672,4,0
0,0,16,16,21,33,54,85,70,155,0.000333,0.297336,20,17840.15126,991.119514,892.007563,258.703672,4,0
0,0,16,16,21,33,54,85,70,155,0.000333,0.297336,20,17840.15126,991.119514,892.007563,258.703672,4,0
0,0,16,16,19,31,50,78,67,145,0.000333,0.272786,18,14730.46466,818.359148,818.359148,234.290708,4,0
0,0,16,16,19,33,52,77,65,142,0.000333,0.269821,9,7285.16196,404.73122,809.46244,247.175629,4,0
0,0,16,16,19,34,53,78,66,144,0.000333,0.27494,9,7423.384909,412.410273,824.820545,253.684359,4,0
0,0,30,30,22,55,77,154,132,286,0.000333,0.597434,22,39430.62091,2190.590051,1792.300951,416.08228,9,0
0,0,18,18,22,37,59,92,77,169,0.000333,0.331389,22,21871.66686,1215.092603,994.166675,290.85727,6,0
0,0,18,18,22,36,58,100,82,182,0.000333,0.355384,22,23455.3559,1303.075328,1066.152541,284.224796,6,0
0,0,18,18,22,36,58,92,77,169,0.000333,0.33,22,21779.97334,1209.998519,989.998788,284.224796,6,0
0,0,18,18,22,36,58,100,82,182,0.000333,0.355384,22,23455.3559,1303.075328,1066.152541,284.224796,6,0
0,0,19,19,22,37,59,100,84,184,0.000333,0.360802,22,23812.93906,1322.941059,1082.406321,290.85727,7,0
0,0,18,18,22,35,57,93,79,172,0.000333,0.334419,22,22071.65581,1226.203101,1003.257082,277.632401,6,0
0,0,20,20,22,39,61,104,84,188,0.000333,0.37166,22,24529.52963,1362.751646,1114.978619,304.238182,7,0
0,0,18,18,22,36,58,100,82,182,0.000333,0.355384,22,23455.3559,1303.075328,1066.152541,284.224796,6,0
0,0,18,18,22,36,58,100,82,182,0.000333,0.355384,22,23455.3559,1303.075328,1066.152541,284.224796,6,0
0,0,18,18,22,36,58,100,82,182,0.000333,0.355384,22,23455.3559,1303.075328,1066.152541,284.224796,6,0
0,0,18,18,22,38,60,93,78,171,0.000333,0.336693,22,22221.72242,1234.540134,1010.078292,297.528741,6,0
0,0,18,18,22,37,59,92,77,169,0.000333,0.331389,22,21871.66686,1215.092603,994.166675,290.85727,6,0
0,0,18,18,22,36,58,100,82,182,0.000333,0.355384,22,23455.3559,1303.075328,1066.152541,284.224796,6,0
0,0,18,18,22,35,57,100,82,182,0.000333,0.353862,22,23354.89162,1297.493979,1061.585983,277.632401,6,0
0,0,18,18,22,36,58,100,82,182,0.000333,0.355384,22,23455.3559,1303.075328,1066.152541,284.224796,6,0
0,0,18,18,22,36,58,100,82,182,0.000333,0.355384,22,23455.3559,1303.075328,1066.152541,284.224796,6,0
0,0,18,18,22,36,58,100,82,182,0.000333,0.355384,22,23455.3559,1303.075328,1066.152541,284.224796,6,0
0,0,18,18,22,36,58,100,82,182,0.000333,0.355384,22,23455.3559,1303.075328,1066.152541,284.224796,6,0
0,0,18,18,22,36,58,100,82,182,0.000333,0.355384,22,23455.3559,1303.075328,1066.152541,284.224796,6,0
0,0,18,18,22,36,58,100,82,182,0.000333,0.355384,22,23455.3559,1303.075328,1066.152541,284.224796,6,0
0,0,18,18,22,35,57,93,79,172,0.000333,0.334419,22,22071.65581,1226.203101,1003.257082,277.632401,6,0
0,0,18,18,22,36,58,92,77,169,0.000333,0.33,22,21779.97334,1209.998519,989.998788,284.224796,6,0
0,0,18,18,22,38,60,93,78,171,0.000333,0.336693,22,22221.72242,1234.540134,1010.078292,297.528741,6,0
0,0,19,19,22,47,69,110,93,203,0.000333,0.413343,11,13640.33511,757.796395,1240.030465,359.173172,9,0
0,0,17,17,19,34,53,83,70,153,0.000333,0.292124,18,15774.69293,876.37183,876.37183,253.684359,4,0
0,0,17,17,21,34,55,91,75,166,0.000333,0.319902,20,19194.11425,1066.33968,959.705712,265.212402,4,0
0,0,17,17,19,33,52,83,70,153,0.000333,0.290722,18,15699.01098,872.167277,872.167277,247.175629,4,0
0,0,17,17,21,34,55,91,75,166,0.000333,0.319902,20,19194.11425,1066.33968,959.705712,265.212402,4,0
0,0,18,18,19,34,53,91,77,168,0.000333,0.320764,18,17321.23146,962.290636,962.290636,253.684359,5,0
0,0,17,17,19,32,51,84,72,156,0.000333,0.294966,18,15928.17036,884.898353,884.898353,240.710623,4,0
0,0,19,19,19,36,55,95,77,172,0.000333,0.331465,18,17899.08967,994.393871,994.393871,266.827923,5,0
0,0,17,17,21,34,55,91,75,166,0.000333,0.319902,20,19194.11425,1066.33968,959.705712,265.212402,4,0
0,0,17,17,21,34,55,91,75,166,0.000333,0.319902,20,19194.11425,1066.33968,959.705712,265.212402,4,0
0,0,17,17,21,34,55,91,75,166,0.000333,0.319902,20,19194.11425,1066.33968,959.705712,265.212402,4,0
0,0,17,17,19,35,54,84,71,155,0.000333,0.297336,18,16056.13613,892.007563,892.007563,260.235528,4,0
0,0,17,17,19,34,53,83,70,153,0.000333,0.292124,18,15774.69293,876.37183,876.37183,253.684359,4,0
0,0,17,17,21,34,55,91,75,166,0.000333,0.319902,20,19194.11425,1066.33968,959.705712,265.212402,4,0
0,0,17,17,21,34,55,91,75,166,0.000333,0.319902,20,19194.11425,1066.33968,959.705712,265.212402,4,0
0,0,17,17,21,34,55,91,75,166,0.000333,0.319902,20,19194.11425,1066.33968,959.705712,265.212402,4,0
0,0,17,17,21,34,55,91,75,166,0.000333,0.319902,20,19194.11425,1066.33968,959.705712,265.212402,4,0
0,0,17,17,21,34,55,91,75,166,0.000333,0.319902,20,19194.11425,1066.33968,959.705712,265.212402,4,0
0,0,17,17,21,34,55,91,75,166,0.000333,0.319902,20,19194.11425,1066.33968,959.705712,265.212402,4,0
0,0,17,17,21,34,55,91,75,166,0.000333,0.319902,20,19194.11425,1066.33968,959.705712,265.212402,4,0
0,0,17,17,21,34,55,91,75,166,0.000333,0.319902,20,19194.11425,1066.33968,959.705712,265.212402,4,0
0,0,17,17,19,32,51,84,72,156,0.000333,0.294966,18,15928.17036,884.898353,884.898353,240.710623,4,0
0,0,17,17,19,34,53,83,70,153,0.000333,0.292124,18,15774.69293,876.37183,876.37183,253.684359,4,0
0,0,17,17,19,35,54,84,71,155,0.000333,0.297336,18,16056.13613,892.007563,892.007563,260.235528,4,0
0,0,18,18,20,44,64,101,86,187,0.000333,0.374,10,11220,623.333333,1122,326.653553,7,0
0,0,17,17,22,35,57,86,72,158,0.000333,0.307199,22,20275.12569,1126.395872,921.596622,277.632401,6,0
0,0,17,17,22,34,56,94,77,171,0.000333,0.331019,22,21847.26922,1213.737179,993.057692,271.081232,6,0
0,0,17,17,22,34,56,86,72,158,0.000333,0.305854,22,20186.36571,1121.464762,917.562078,271.081232,6,0
0,0,17,17,22,34,56,94,77,171,0.000333,0.331019,22,21847.26922,1213.737179,993.057692,271.081232,6,0
0,0,18,18,22,35,57,94,79,173,0.000333,0.336363,22,22199.97939,1233.332189,1009.089972,277.632401,7,0
0,0,17,17,22,33,55,87,74,161,0.000333,0.310266,22,20477.57611,1137.643117,930.798914,264.572502,6,0
0,0,19,19,22,37,59,98,79,177,0.000333,0.347076,22,22907.01203,1272.61178,1041.22782,290.85727,7,0
0,0,17,17,22,34,56,94,77,171,0.000333,0.331019,22,21847.26922,1213.737179,993.057692,271.081232,6,0
0,0,17,17,22,34,56,94,77,171,0.000333,0.331019,22,21847.26922,1213.737179,993.057692,271.081232,6,0
0,0,17,17,22,34,56,94,77,171,0.000333,0.331019,22,21847.26922,1213.737179,993.057692,271.081232,6,0
0,0,17,17,22,36,58,87,73,160,0.000333,0.312426,22,20620.0931,1145.560728,937.276959,284.224796,6,0
0,0,17,17,22,35,57,86,72,158,0.000333,0.307199,22,20275.12569,1126.395872,921.596622,277.632401,6,0
0,0,17,17,22,34,56,94,77,171,0.000333,0.331019,22,21847.26922,1213.737179,993.057692,271.081232,6,0
0,0,17,17,22,33,55,94,77,171,0.000333,0.329538,22,21749.47524,1208.30418,988.612511,264.572502,6,0
0,0,17,17,22,34,56,94,77,171,0.000333,0.331019,22,21847.26922,1213.737179,993.057692,271.081232,6,0
0,0,17,17,22,34,56,94,77,171,0.000333,0.331019,22,21847.26922,1213.737179,993.057692,271.081232,6,0
0,0,17,17,22,34,56,94,77,171,0.000333,0.331019,22,21847.26922,1213.737179,993.057692,271.081232,6,0
0,0,17,17,22,34,56,94,77,171,0.000333,0.331019,22,21847.26922,1213.737179,993.057692,271.081232,6,0
0,0,17,17,22,34,56,94,77,171,0.000333,0.331019,22,21847.26922,1213.737179,993.057692,271.081232,6,0
0,0,17,17,22,34,56,94,77,171,0.000333,0.331019,22,21847.26922,1213.737179,993.057692,271.081232,6,0
0,0,17,17,22,33,55,87,74,161,0.000333,0.310266,22,20477.57611,1137.643117,930.798914,264.572502,6,0
0,0,17,17,22,34,56,86,72,158,0.000333,0.305854,22,20186.36571,1121.464762,917.562078,271.081232,6,0
0,0,17,17,22,36,58,87,73,160,0.000333,0.312426,22,20620.0931,1145.560728,937.276959,284.224796,6,0
0,0,18,18,22,45,67,104,88,192,0.000333,0.38823,11,12811.58037,711.754465,1164.689125,345.240885,9,0
0,0,19,19,22,37,59,98,82,180,0.000333,0.352959,22,23295.26648,1294.181471,1058.875749,290.85727,6,0
0,0,19,19,22,36,58,106,87,193,0.000333,0.376863,22,24872.98731,1381.832628,1130.590332,284.224796,6,0
0,0,19,19,22,36,58,98,82,180,0.000333,0.351479,22,23197.60474,1288.755819,1054.436579,284.224796,6,0
0,0,19,19,22,36,58,106,87,193,0.000333,0.376863,22,24872.98731,1381.832628,1130.590332,284.224796,6,0
0,0,20,20,22,37,59,106,89,195,0.000333,0.382372,22,25236.53868,1402.029927,1147.115395,290.85727,7,0
0,0,19,19,22,35,57,99,84,183,0.000333,0.355806,22,23483.2152,1304.623067,1067.418873,277.632401,6,0
0,0,21,21,22,39,61,110,89,199,0.000333,0.393406,22,25964.76806,1442.487115,1180.21673,304.238182,7,0
0,0,19,19,22,36,58,106,87,193,0.000333,0.376863,22,24872.98731,1381.832628,1130.590332,284.224796,6,0
0,0,19,19,22,36,58,106,87,193,0.000333,0.376863,22,24872.98731,1381.832628,1130.590332,284.224796,6,0
0,0,19,19,22,36,58,106,87,193,0.000333,0.376863,22,24872.98731,1381.832628,1130.590332,284.224796,6,0
0,0,19,19,22,38,60,99,83,182,0.000333,0.358351,22,23651.18995,1313.954997,1075.054088,297.528741,6,0
0,0,19,19,22,37,59,98,82,180,0.000333,0.352959,22,23295.26648,1294.181471,1058.875749,290.85727,6,0
0,0,19,19,22,36,58,106,87,193,0.000333,0.376863,22,24872.98731,1381.832628,1130.590332,284.224796,6,0
0,0,19,19,22,35,57,106,87,193,0.000333,0.375249,22,24766.451,1375.913944,1125.747773,277.632401,6,0
0,0,19,19,22,36,58,106,87,193,0.000333,0.376863,22,24872.98731,1381.832628,1130.590332,284.224796,6,0
0,0,19,19,22,36,58,106,87,193,0.000333,0.376863,22,24872.98731,1381.832628,1130.590332,284.224796,6,0
0,0,19,19,22,36,58,106,87,193,0.000333,0.376863,22,24872.98731,1381.832628,1130.590332,284.224796,6,0
0,0,19,19,22,36,58,106,87,193,0.000333,0.376863,22,24872.98731,1381.832628,1130.590332,284.224796,6,0
0,0,19,19,22,36,58,106,87,193,0.000333,0.376863,22,24872.98731,1381.832628,1130.590332,284.224796,6,0
0,0,19,19,22,36,58,106,87,193,0.000333,0.376863,22,24872.98731,1381.832628,1130.590332,284.224796,6,0
0,0,19,19,22,35,57,99,84,183,0.000333,0.355806,22,23483.2152,1304.623067,1067.418873,277.632401,6,0
0,0,19,19,22,36,58,98,82,180,0.000333,0.351479,22,23197.60474,1288.755819,1054.436579,284.224796,6,0
0,0,19,19,22,38,60,99,83,182,0.000333,0.358351,22,23651.18995,1313.954997,1075.054088,297.528741,6,0
0,0,20,20,22,47,69,116,98,214,0.000333,0.435741,22,28758.93314,1597.718508,1307.224234,359.173172,9,0
0,0,18,18,19,37,56,89,75,164,0.000333,0.317469,18,17143.31173,952.406207,952.406207,273.460397,4,0
0,0,18,18,21,37,58,97,80,177,0.000333,0.345621,20,20737.25272,1152.069596,1036.862636,284.98844,4,0
0,0,18,18,19,36,55,89,75,164,0.000333,0.316048,18,17066.57387,948.142993,948.142993,266.827923,4,0
0,0,18,18,21,37,58,97,80,177,0.000333,0.345621,20,20737.25272,1152.069596,1036.862636,284.98844,4,0
0,0,19,19,19,37,56,97,82,179,0.000333,0.346506,18,18711.29756,1039.516531,1039.516531,273.460397,5,0
0,0,18,18,19,35,54,90,77,167,0.000333,0.320355,18,17299.19183,961.066213,961.066213,260.235528,4,0
0,0,20,20,19,39,58,101,82,183,0.000333,0.357337,18,19296.1894,1072.010522,1072.010522,286.841309,5,0
0,0,18,18,21,37,58,97,80,177,0.000333,0.345621,20,20737.25272,1152.069596,1036.862636,284.98844,4,0
0,0,18,18,21,37,58,97,80,177,0.000333,0.345621,20,20737.25272,1152.069596,1036.862636,284.98844,4,0
0,0,18,18,21,37,58,97,80,177,0.000333,0.345621,20,20737.25272,1152.069596,1036.862636,284.98844,4,0
0,0,18,18,19,38,57,90,76,166,0.000333,0.322753,18,17428.67536,968.259742,968.259742,280.131868,4,0
0,0,18,18,19,37,56,89,75,164,0.000333,0.317469,18,17143.31173,952.406207,952.406207,273.460397,4,0
0,0,18,18,21,37,58,97,80,177,0.000333,0.345621,20,20737.25272,1152.069596,1036.862636,284.98844,4,0
0,0,18,18,21,37,58,97,80,177,0.000333,0.345621,20,20737.25272,1152.069596,1036.862636,284.98844,4,0
0,0,18,18,21,37,58,97,80,177,0.000333,0.345621,20,20737.25272,1152.069596,1036.862636,284.98844,4,0
0,0,18,18,21,37,58,97,80,177,0.000333,0.345621,20,20737.25272,1152.069596,1036.862636,284.98844,4,0
0,0,18,18,21,37,58,97,80,177,0.000333,0.345621,20,20737.25272,1152.069596,1036.862636,284.98844,4,0
0,0,18,18,21,37,58,97,80,177,0.000333,0.345621,20,20737.25272,1152.069596,1036.862636,284.98844,4,0
0,0,18,18,21,37,58,97,80,177,0.000333,0.345621,20,20737.25272,1152.069596,1036.862636,284.98844,4,0
0,0,18,18,21,37,58,97,80,177,0.000333,0.345621,20,20737.25272,1152.069596,1036.862636,284.98844,4,0
0,0,18,18,19,35,54,90,77,167,0.000333,0.320355,18,17299.19183,961.066213,961.066213,260.235528,4,0
0,0,18,18,19,37,56,89,75,164,0.000333,0.317469,18,17143.31173,952.406207,952.406207,273.460397,4,0
0,0,18,18,19,38,57,90,76,166,0.000333,0.322753,18,17428.67536,968.259742,968.259742,280.131868,4,0
0,0,19,19,20,47,67,107,91,198,0.000333,0.400362,10,12010.8566,667.269811,1201.08566,347.504238,7,0
0,0,28,28,21,48,69,154,114,268,0.000333,0.545695,20,32741.69109,1818.982838,1637.084554,360.316866,10,0
0,0,17,17,19,42,61,99,79,178,0.000333,0.35189,9,9501.041215,527.835623,1055.671246,307.187955,9,0
0,0,17,17,19,32,51,77,66,143,0.000333,0.270386,18,14600.82283,811.156824,811.156824,240.710623,4,0
0,0,17,17,21,32,53,85,71,156,0.000333,0.297852,20,17871.11182,992.839545,893.555591,252.238666,4,0
0,0,17,17,19,31,50,77,66,143,0.000333,0.269024,18,14527.28583,807.071435,807.071435,234.290708,4,0
0,0,17,17,21,32,53,85,71,156,0.000333,0.297852,20,17871.11182,992.839545,893.555591,252.238666,4,0
0,0,18,18,19,32,51,85,73,158,0.000333,0.298748,18,16132.37767,896.243204,896.243204,240.710623,5,0
0,0,17,17,19,30,49,78,68,146,0.000333,0.273249,18,14755.45747,819.747637,819.747637,227.917341,4,0
0,0,19,19,19,34,53,89,73,162,0.000333,0.309308,18,16702.61605,927.923114,927.923114,253.684359,5,0
0,0,17,17,21,32,53,85,71,156,0.000333,0.297852,20,17871.11182,992.839545,893.555591,252.238666,4,0
0,0,17,17,21,32,53,85,71,156,0.000333,0.297852,20,17871.11182,992.839545,893.555591,252.238666,4,0
0,0,17,17,21,32,53,85,71,156,0.000333,0.297852,20,17871.11182,992.839545,893.555591,252.238666,4,0
0,0,17,17,19,33,52,78,67,145,0.000333,0.275521,18,14878.14766,826.563759,826.563759,247.175629,4,0
0,0,17,17,19,32,51,77,66,143,0.000333,0.270386,18,14600.82283,811.156824,811.156824,240.710623,4,0
0,0,17,17,21,32,53,85,71,156,0.000333,0.297852,20,17871.11182,992.839545,893.555591,252.238666,4,0
0,0,17,17,21,32,53,85,71,156,0.000333,0.297852,20,17871.11182,992.839545,893.555591,252.238666,4,0
0,0,17,17,21,32,53,85,71,156,0.000333,0.297852,20,17871.11182,992.839545,893.555591,252.238666,4,0
0,0,17,17,21,32,53,85,71,156,0.000333,0.297852,20,17871.11182,992.839545,893.555591,252.238666,4,0
0,0,17,17,21,32,53,85,71,156,0.000333,0.297852,20,17871.11182,992.839545,893.555591,252.238666,4,0
0,0,17,17,21,32,53,85,71,156,0.000333,0.297852,20,17871.11182,992.839545,893.555591,252.238666,4,0
0,0,17,17,21,32,53,85,71,156,0.000333,0.297852,20,17871.11182,992.839545,893.555591,252.238666,4,0
0,0,17,17,21,32,53,85,71,156,0.000333,0.297852,20,17871.11182,992.839545,893.555591,252.238666,4,0
0,0,17,17,19,30,49,78,68,146,0.000333,0.273249,18,14755.45747,819.747637,819.747637,227.917341,4,0
0,0,17,17,19,32,51,77,66,143,0.000333,0.270386,18,14600.82283,811.156824,811.156824,240.710623,4,0
0,0,17,17,19,33,52,78,67,145,0.000333,0.275521,18,14878.14766,826.563759,826.563759,247.175629,4,0
0,0,18,18,20,42,62,95,82,177,0.000333,0.351298,10,10538.92747,585.495971,1053.892747,312.915894,7,0
0,0,34,34,23,46,69,151,118,269,0.000333,0.547731,22,36150.24774,2008.347096,1643.193079,358.125775,8,0
0,0,22,22,15,47,62,128,108,236,0.000333,0.468397,14,19672.66461,1092.925812,1405.190329,319.669035,6,0
0,0,25,25,17,56,73,144,123,267,0.000333,0.550894,16,26442.93052,1469.051695,1652.683157,394.698744,5,0
0,0,26,26,16,51,67,137,115,252,0.000333,0.509551,16,24458.47162,1358.803979,1528.654476,353.293692,7,0
0,0,23,23,16,47,63,124,99,223,0.000333,0.444311,16,21326.93477,1184.829709,1332.933423,325.065676,5,0
0,0,24,24,16,53,69,132,111,243,0.000333,0.49479,16,23749.94309,1319.441283,1484.371443,367.579784,5,0
0,0,24,24,16,53,69,132,111,243,0.000333,0.49479,16,23749.94309,1319.441283,1484.371443,367.579784,5,0
0,0,28,28,22,38,60,114,88,202,0.000333,0.397731,22,26250.22181,1458.345656,1193.1919,297.528741,7,0
0,0,21,21,23,33,56,117,76,193,0.000333,0.373606,22,24658.029,1369.8905,1120.8195,270.506931,10,0
0,0,17,17,22,32,54,101,65,166,0.000333,0.318437,22,21016.84916,1167.602731,955.311325,258.107496,9,0
0,0,17,17,21,31,52,106,64,170,0.000333,0.323025,20,19381.49504,1076.749725,969.074752,245.818752,9,0
0,0,11,11,17,32,49,79,52,131,0.000333,0.245176,8,5884.215917,326.900884,735.52699,229.486868,6,0
0,0,7,7,9,15,24,22,22,44,0.000333,0.067246,4,806.9534,44.830744,201.73835,87.132684,1,0
1,0,64,65,25,82,107,349,199,548,0.000333,1.231441,24,88663.77381,4925.765211,3694.323909,637.415669,29,0
1,0,56,57,24,67,91,282,173,455,0.000333,0.987016,24,71065.11747,3948.062082,2961.046561,516.467076,18,0
1,0,65,66,24,81,105,349,217,566,0.000333,1.266754,24,91206.31111,5067.017284,3800.262963,623.56695,26,0
1,0,7,8,15,24,39,50,34,84,0.000333,0.147991,7,3107.816505,172.656472,443.973786,168.642459,3,0
0,0,21,21,20,39,59,176,142,318,0.000333,0.62356,30,56120.41469,3117.800816,1870.68049,292.569248,15,0
0,0,21,21,20,39,59,176,142,318,0.000333,0.62356,30,56120.41469,3117.800816,1870.68049,292.569248,15,0
0,0,21,21,20,39,59,176,142,318,0.000333,0.62356,30,56120.41469,3117.800816,1870.68049,292.569248,15,0
0,0,103,103,33,114,147,549,458,1007,0.000333,2.41669,64,464004.4833,25778.02685,7250.070051,945.414468,35,0
0,0,97,97,32,110,142,519,435,954,0.000333,2.27362,48,327401.2201,18188.95667,6820.858752,905.949568,34,0
0,0,103,103,33,114,147,549,458,1007,0.000333,2.41669,64,464004.4833,25778.02685,7250.070051,945.414468,35,0
0,0,97,97,32,110,142,519,435,954,0.000333,2.27362,48,327401.2201,18188.95667,6820.858752,905.949568,34,0
0,0,99,99,32,74,106,476,384,860,0.000333,1.928671,80,462880.9273,25715.60707,5786.011591,619.499549,35,0
0,0,90,90,29,109,138,500,447,947,0.000333,2.243924,56,376979.269,20943.29272,6731.772661,878.61354,26,0
0,0,89,89,28,111,139,498,446,944,0.000333,2.240093,56,376335.7009,20907.53894,6720.280373,888.786099,26,0
0,0,84,84,28,111,139,445,399,844,0.000333,2.002795,42,252352.2231,14019.56795,6008.386265,888.786099,22,0
0,0,89,89,29,111,140,504,450,954,0.000333,2.267112,56,380874.8159,21159.71199,6801.335998,895.06161,25,0
0,0,89,89,29,111,140,504,450,954,0.000333,2.267112,56,380874.8159,21159.71199,6801.335998,895.06161,25,0
0,0,89,89,29,111,140,504,450,954,0.000333,2.267112,56,380874.8159,21159.71199,6801.335998,895.06161,25,0
0,0,85,85,28,111,139,468,420,888,0.000333,2.107207,42,265508.0262,14750.4459,6321.619673,888.786099,24,0
0,0,85,85,28,111,139,468,420,888,0.000333,2.107207,42,265508.0262,14750.4459,6321.619673,888.786099,24,0
0,0,85,85,28,111,139,468,420,888,0.000333,2.107207,42,265508.0262,14750.4459,6321.619673,888.786099,24,0
0,0,91,91,28,111,139,539,484,1023,0.000333,2.427559,56,407829.8962,22657.21645,7282.676717,888.786099,23,0
0,0,91,91,29,111,140,546,487,1033,0.000333,2.45485,56,412414.764,22911.93133,7364.549357,895.06161,24,0
0,0,78,78,27,107,134,405,360,765,0.000333,1.801853,39,210816.771,11712.04283,5405.558231,849.71893,22,0
0,0,87,87,29,111,140,550,487,1037,0.000333,2.464355,56,414011.7234,23000.6513,7393.066489,895.06161,23,0
0,0,87,87,29,111,140,550,487,1037,0.000333,2.464355,56,414011.7234,23000.6513,7393.066489,895.06161,23,0
0,0,87,87,29,111,140,550,487,1037,0.000333,2.464355,56,414011.7234,23000.6513,7393.066489,895.06161,23,0
0,0,19,19,22,25,47,83,65,148,0.000333,0.274026,22,18085.7413,1004.763406,822.07915,214.2039,11,0
0,0,17,17,17,36,53,92,71,163,0.000333,0.311217,8,7469.208273,414.956015,933.651034,255.604168,7,0
0,0,17,17,17,32,49,77,63,140,0.000333,0.26202,8,6288.475025,349.359724,786.059378,229.486868,7,0
0,0,16,16,16,30,46,71,59,130,0.000333,0.239354,8,5744.504434,319.139135,718.063054,211.206718,5,0
0,0,15,15,12,32,44,79,63,142,0.000333,0.258413,6,4651.435739,258.413097,775.23929,203.01955,2,0
0,0,15,15,12,32,44,79,63,142,0.000333,0.258413,6,4651.435739,258.413097,775.23929,203.01955,2,0
0,0,23,23,23,36,59,144,99,243,0.000333,0.476494,22,31448.60974,1747.144986,1429.482261,290.159225,7,0
0,0,20,20,19,27,46,110,73,183,0.000333,0.336937,18,18194.61308,1010.811838,1010.811838,209.092585,7,0
0,0,22,22,19,28,47,115,77,192,0.000333,0.355494,18,19196.65907,1066.48106,1066.48106,215.316561,7,0
0,0,22,22,19,30,49,114,78,192,0.000333,0.359341,18,19404.43722,1078.02429,1078.02429,227.917341,7,0
0,0,21,21,23,36,59,135,94,229,0.000333,0.449042,22,29636.75568,1646.486427,1347.125258,290.159225,7,0
0,0,18,18,19,27,46,101,68,169,0.000333,0.311161,18,16802.67547,933.481971,933.481971,209.092585,7,0
0,0,20,20,19,28,47,106,72,178,0.000333,0.329572,18,17796.90268,988.716816,988.716816,215.316561,7,0
0,0,20,20,19,30,49,105,73,178,0.000333,0.333139,18,17989.53034,999.418352,999.418352,227.917341,7,0
0,0,50,50,25,66,91,429,335,764,0.000333,1.657318,60,298317.3063,16573.18368,4971.955105,515.026417,10,0
0,0,21,21,22,30,52,96,74,170,0.000333,0.323025,22,21319.64455,1184.424697,969.074752,245.314213,13,0