Empty_Lines,Lines_Of_Comments,Lines_Of_Program,Physic_Lines,n1_Number_Of_Distinct_Operators,n2_Number_Of_Distinct_Operands,n_Program_Vocabulary,N1_Total_Number_Of_Operators,N2_Total_Number_Of_Operands,N_Program_Length,B_Number_of_Delivered_Bugs_1,B_Number_of_Delivered_Bugs_2,D_Difficulty,E_Effort,T_Time_Required_To_Program,V_Volume,_N_Calculated_Program_Length,McCab_Number,IsVulnerable
0,0,18,18,18,26,44,116,66,182,0.000333,0.331206,18,17885.09798,993.616555,993.616555,197.270083,8,6
0,0,18,18,18,26,44,117,67,184,0.000333,0.334845,18,18081.63752,1004.535418,1004.535418,197.270083,8,6
0,0,18,18,18,26,44,116,66,182,0.000333,0.331206,18,17885.09798,993.616555,993.616555,197.270083,8,6
0,0,18,18,18,26,44,117,67,184,0.000333,0.334845,18,18081.63752,1004.535418,1004.535418,197.270083,8,6
0,0,18,18,18,26,44,116,66,182,0.000333,0.331206,18,17885.09798,993.616555,993.616555,197.270083,8,6
0,0,18,18,18,26,44,117,67,184,0.000333,0.334845,18,18081.63752,1004.535418,1004.535418,197.270083,8,6
0,0,30,30,16,27,43,170,108,278,0.000333,0.502834,32,48272.05126,2681.780625,1508.501602,192.381963,16,6
0,0,29,29,16,27,43,164,105,269,0.000333,0.486555,24,35031.96526,1946.220292,1459.665219,192.381963,15,6
0,0,28,28,16,27,43,158,102,260,0.000333,0.470276,24,33859.89207,1881.105115,1410.828836,192.381963,14,6
0,0,30,30,17,29,46,173,109,282,0.000333,0.519215,24,37383.46732,2076.859295,1557.644472,210.368317,15,6
0,0,36,36,24,45,69,228,134,362,0.000333,0.737095,24,53070.86048,2948.381138,2211.285853,357.172489,18,6
0,0,38,38,24,46,70,235,140,375,0.000333,0.76616,36,82745.32073,4596.962263,2298.481131,364.12295,18,6
0,0,36,36,22,46,68,224,133,357,0.000333,0.724408,22,47810.93316,2656.162953,2173.224234,352.191346,18,6
0,0,41,41,26,49,75,239,149,388,0.000333,0.805594,39,94254.48443,5236.360246,2416.781652,397.332215,17,6
0,0,20,20,20,40,60,107,70,177,0.000333,0.348507,10,10455.19635,580.844242,1045.519635,299.315686,10,6
0,0,17,17,20,38,58,101,64,165,0.000333,0.322189,10,9665.668642,536.981591,966.566864,285.859807,10,6
0,0,28,28,21,39,60,131,86,217,0.000333,0.427265,20,25635.90519,1424.216955,1281.795259,298.369352,15,6
0,0,26,26,20,37,57,123,82,205,0.000333,0.398581,20,23914.84906,1328.602725,1195.742453,279.188336,15,6
0,0,46,46,26,46,72,295,168,463,0.000333,0.952225,39,111410.3358,6189.463097,2856.675276,376.295283,22,6
0,0,43,43,26,45,71,289,162,451,0.000333,0.924512,39,108167.9021,6009.327894,2773.535951,369.344822,21,6
0,0,10,10,13,21,34,41,35,76,0.000333,0.128882,6,2319.883056,128.882392,386.647176,140.344382,4,6
0,0,35,35,18,53,71,192,132,324,0.000333,0.664173,18,35865.3252,1992.518067,1992.518067,378.638434,20,6
0,0,27,27,18,58,76,163,111,274,0.000333,0.570644,9,15407.38925,855.966069,1711.932139,414.821548,17,6
0,0,25,25,19,54,73,144,93,237,0.000333,0.488996,9,13202.89578,733.49421,1466.98842,391.474548,17,6
0,0,28,28,20,48,68,154,99,253,0.000333,0.513376,20,30802.56198,1711.253443,1540.128099,354.516762,15,6
0,0,43,43,27,58,85,246,152,398,0.000333,0.850313,26,66324.37741,3684.687634,2550.937593,468.14486,20,6
0,0,44,44,27,61,88,254,156,410,0.000333,0.882789,26,68857.54106,3825.418947,2648.366964,490.15694,20,6
0,0,40,40,26,52,78,228,141,369,0.000333,0.773104,26,60302.14889,3350.119383,2319.313419,418.634298,17,6
0,0,43,43,27,57,84,246,153,399,0.000333,0.850178,26,66313.90094,3684.105608,2550.534652,460.856693,20,6
0,0,14,14,15,32,47,79,55,134,0.000333,0.248105,7,5210.204343,289.455797,744.314906,218.603359,6,6
0,0,21,21,21,34,55,109,75,184,0.000333,0.35459,20,21275.40375,1181.966875,1063.770187,265.212402,11,6
0,0,22,22,21,37,58,117,79,196,0.000333,0.382721,20,22963.2855,1275.738083,1148.164275,284.98844,11,6
0,0,18,18,20,28,48,95,65,160,0.000333,0.297865,20,17871.88,992.882222,893.594,221.0445,8,6
0,0,21,21,21,33,54,109,76,185,0.000333,0.354885,20,21293.08376,1182.949098,1064.654188,258.703672,11,6
0,0,9,9,12,20,32,31,31,62,0.000333,0.103333,6,1860,103.333333,310,129.458112,2,6
0,0,12,12,13,18,31,308,43,351,0.000333,0.579641,12,20867.07486,1159.281937,1738.922905,123.164366,3,6
0,0,52,52,29,56,85,263,168,431,0.000333,0.920816,42,116022.7947,6445.710818,2762.447493,466.093324,33,6
0,0,49,49,29,50,79,245,157,402,0.000333,0.844707,42,106433.0342,5912.946342,2534.119861,423.074258,30,6
0,0,52,52,29,55,84,263,169,432,0.000333,0.920494,42,115982.2073,6443.455962,2761.481127,458.856233,33,6
0,0,26,26,21,47,68,116,86,202,0.000333,0.409889,10,12296.67494,683.148608,1229.667494,353.304342,15,6
0,0,24,24,20,45,65,108,82,190,0.000333,0.381417,10,11442.49885,635.69438,1144.249884,333.571951,15,6
0,0,16,16,19,21,40,76,51,127,0.000333,0.225295,18,12165.92763,675.884868,675.884868,172.949289,7,6
0,0,19,19,21,27,48,94,63,157,0.000333,0.29228,20,17536.78225,974.265681,876.839113,220.620628,10,6
0,0,10,10,15,18,33,58,35,93,0.000333,0.156376,7,3283.900572,182.438921,469.128653,133.662009,5,6
0,0,6,6,12,12,24,34,21,55,0.000333,0.084058,6,1513.037625,84.057646,252.172938,86.0391,4,6
0,0,19,19,22,32,54,109,67,176,0.000333,0.33762,22,22282.92441,1237.940245,1012.8602,258.107496,10,6
0,0,8,8,14,19,33,58,34,92,0.000333,0.154695,7,3248.589813,180.477212,464.084259,134.013592,2,6
0,0,17,17,19,34,53,79,57,136,0.000333,0.259666,9,7010.974636,389.498591,778.997182,253.684359,8,6
0,0,21,21,19,34,53,93,69,162,0.000333,0.309308,18,16702.61605,927.923114,927.923114,253.684359,9,6
0,0,25,25,19,34,53,107,81,188,0.000333,0.35895,18,19383.28282,1076.849045,1076.849045,253.684359,10,6
0,0,19,19,12,14,26,72,57,129,0.000333,0.202119,24,14552.56137,808.475632,606.356724,96.322519,5,6
0,0,22,22,22,36,58,107,72,179,0.000333,0.349526,22,23068.72916,1281.596064,1048.578598,284.224796,9,6
0,0,26,26,22,36,58,121,84,205,0.000333,0.400295,22,26419.49429,1467.749683,1200.886104,284.224796,10,6
0,0,30,30,22,36,58,135,96,231,0.000333,0.451065,22,29770.25942,1653.903301,1353.19361,284.224796,11,6
0,0,24,24,16,17,33,100,72,172,0.000333,0.289212,32,27764.34523,1542.463624,867.635789,133.486868,6,6
0,0,23,23,21,41,62,116,79,195,0.000333,0.387023,10,11610.68281,645.037934,1161.068281,311.898298,11,6
0,0,24,24,20,36,56,116,80,196,0.000333,0.379414,20,22764.83129,1264.71285,1138.241565,272.555862,9,6
0,0,28,28,20,36,56,130,92,222,0.000333,0.429744,20,25784.65585,1432.480881,1289.232793,272.555862,10,6
0,0,22,22,13,16,29,95,68,163,0.000333,0.26395,24,19004.42165,1055.801203,791.850902,112.105716,5,6
0,0,26,26,21,37,58,126,89,215,0.000333,0.419822,20,25189.31828,1399.406571,1259.465914,284.98844,12,6
0,0,25,25,22,44,66,158,93,251,0.000333,0.505714,22,33377.14433,1854.285796,1517.142924,338.322487,10,6
0,0,12,12,16,27,43,75,47,122,0.000333,0.220668,8,5296.034401,294.224133,662.0043,192.381963,5,6
0,0,23,23,24,39,63,132,84,216,0.000333,0.430364,24,30986.21912,1721.456618,1291.092463,316.169787,11,6
0,0,22,22,24,39,63,125,81,206,0.000333,0.41044,24,29551.67194,1641.759552,1231.319664,316.169787,11,6
0,0,23,23,23,34,57,120,78,198,0.000333,0.384971,22,25408.0689,1411.559383,1154.912223,277.015662,8,6
0,0,26,26,24,39,63,134,89,223,0.000333,0.444311,24,31990.40215,1777.244564,1332.933423,316.169787,11,6
0,0,17,17,18,28,46,94,60,154,0.000333,0.283543,18,15311.31374,850.628541,850.628541,209.664588,6,6
0,0,25,25,24,39,63,132,86,218,0.000333,0.434349,24,31273.12856,1737.396031,1303.047023,316.169787,11,6
0,0,15,15,16,30,46,87,56,143,0.000333,0.26329,8,6318.954878,351.053049,789.86936,211.206718,5,6
0,0,20,20,24,39,63,107,72,179,0.000333,0.356644,12,12839.19728,713.288738,1069.933106,316.169787,10,6
0,0,89,89,22,102,124,626,229,855,0.000333,1.981946,22,130808.4326,7267.135144,5945.837845,778.69488,34,6
0,0,74,74,20,92,112,552,178,730,0.000333,1.656456,10,49693.69093,2760.760607,4969.369093,686.606262,23,6
0,0,77,77,21,97,118,566,189,755,0.000333,1.732132,10,51963.95502,2886.88639,5196.395502,732.430212,26,6
0,0,80,80,20,95,115,574,199,773,0.000333,1.763855,20,105831.2762,5879.515344,5291.563809,710.574845,28,6
0,0,17,17,13,20,33,68,58,126,0.000333,0.211865,12,7627.123908,423.729106,635.593659,134.544278,12,6
0,0,75,75,21,95,116,553,182,735,0.000333,1.680205,10,50406.16031,2800.34224,5040.616031,716.374949,24,6
0,0,78,78,20,93,113,561,192,753,0.000333,1.711865,20,102711.8952,5706.216399,5135.594759,694.580331,26,6
0,0,15,15,11,17,28,55,51,106,0.000333,0.16986,15,7643.694326,424.649685,509.579622,107.540616,10,6
0,0,56,56,23,54,77,285,182,467,0.000333,0.97553,33,96577.44738,5365.413743,2926.589315,414.80585,16,6
0,0,9,9,12,20,32,31,31,62,0.000333,0.103333,6,1860,103.333333,310,129.458112,2,6
0,0,3,3,12,13,25,18,19,37,0.000333,0.057274,6,1030.936074,57.274226,171.822679,91.125266,1,6
0,0,3,3,10,15,25,16,16,32,0.000333,0.049534,5,743.01699,41.278722,148.603398,91.82264,1,6
0,0,5,5,15,14,29,39,23,62,0.000333,0.100398,7,2108.363752,117.13132,301.194822,111.906328,2,6
0,0,6,6,13,15,28,52,31,83,0.000333,0.133003,12,4788.125502,266.006972,399.010459,106.709075,2,6
0,0,6,6,14,14,28,51,30,81,0.000333,0.129799,14,5451.540482,302.86336,389.395749,106.605938,3,6
0,0,20,20,20,29,49,99,69,168,0.000333,0.314424,20,18865.42508,1048.079171,943.271254,227.320011,9,6
0,0,12,12,15,20,35,53,38,91,0.000333,0.155588,7,3267.353282,181.519627,466.764755,145.041921,5,6
0,0,13,13,17,21,38,64,44,108,0.000333,0.188925,16,9068.418743,503.801041,566.776171,161.725534,5,6
0,0,17,17,19,25,44,87,61,148,0.000333,0.269332,18,14543.92583,807.99588,807.99588,196.807027,7,6
0,0,18,18,16,39,55,103,70,173,0.000333,0.333392,8,8001.401844,444.522325,1000.17523,270.130687,9,6
0,0,25,25,22,39,61,133,90,223,0.000333,0.440851,22,29096.19738,1616.45541,1322.554426,304.238182,14,6
0,0,26,26,22,42,64,141,94,235,0.000333,0.47,22,31020,1723.333333,1410,324.584827,14,6
0,0,22,22,21,33,54,119,80,199,0.000333,0.381741,20,22904.45226,1272.46957,1145.222613,258.703672,11,6
0,0,25,25,22,38,60,133,91,224,0.000333,0.441048,22,29109.15686,1617.175381,1323.143493,297.528741,14,6
0,0,18,18,17,44,61,109,76,185,0.000333,0.365729,8,8777.49126,487.638403,1097.186407,309.70186,9,6
0,0,29,29,24,49,73,149,106,255,0.000333,0.526135,24,37881.7263,2104.54035,1578.405263,385.159882,14,6
0,0,30,30,24,52,76,157,110,267,0.000333,0.556066,24,40036.71951,2224.262195,1668.196646,406.461965,14,6
0,0,26,26,23,43,66,135,96,231,0.000333,0.465418,22,30717.61092,1706.53394,1396.255042,337.371309,11,6
0,0,29,29,24,48,72,149,107,256,0.000333,0.5265,24,37908.01921,2106.001067,1579.5008,378.1173,14,6
0,0,59,59,27,82,109,289,198,487,0.000333,1.098702,26,85698.74992,4761.041662,3296.105766,649.701227,24,6
0,0,55,55,27,78,105,271,183,454,0.000333,1.016089,26,79254.95409,4403.053005,3048.267465,618.643336,23,6
0,0,61,61,28,86,114,302,206,508,0.000333,1.157036,28,97191.02756,5399.501531,3471.108127,687.264707,24,6
0,0,63,63,28,87,115,317,218,535,0.000333,1.220779,28,102545.441,5696.968942,3662.337177,695.142022,25,6
0,0,50,50,24,72,96,281,203,484,0.000333,1.062374,24,76490.92441,4249.4958,3187.12185,554.2737,38,6
0,0,54,54,24,76,100,295,213,508,0.000333,1.125026,24,81001.89467,4500.105259,3375.078944,584.881591,38,6
0,0,51,51,22,71,93,268,196,464,0.000333,1.01139,22,66751.73314,3708.429619,3034.169688,534.739541,32,6
0,0,30,30,24,44,68,156,104,260,0.000333,0.52758,24,37985.76813,2110.320452,1582.740339,350.254091,13,6
0,0,22,22,19,35,54,110,73,183,0.000333,0.351048,18,18956.59943,1053.144413,1053.144413,260.235528,9,6
0,0,23,23,21,36,57,121,79,200,0.000333,0.388859,20,23331.56006,1296.197781,1166.578003,278.355966,9,6
0,0,27,27,23,40,63,144,96,240,0.000333,0.478182,22,31560.038,1753.335444,1434.547182,316.919049,11,6
0,0,3,3,11,12,23,20,15,35,0.000333,0.052775,5,791.623342,43.979075,158.324668,81.073298,1,6
0,0,62,62,32,76,108,317,211,528,0.000333,1.18886,32,114130.5792,6340.587735,3566.580601,634.842491,25,6
0,0,45,45,22,42,64,205,143,348,0.000333,0.696,33,68904,3828,2088,324.584827,13,6
0,0,58,58,26,65,91,272,186,458,0.000333,0.993523,26,77494.81858,4305.267699,2980.569945,513.665341,16,6
0,0,21,21,24,34,58,122,70,192,0.000333,0.374911,24,26993.57643,1499.643135,1124.732351,283.012837,12,6
0,0,54,54,16,54,70,254,180,434,0.000333,0.886703,24,63842.6119,3546.811772,2660.108829,374.763925,17,6
0,0,51,51,16,53,69,248,174,422,0.000333,0.859266,24,61867.1357,3437.063094,2577.797321,367.579784,17,6
0,0,19,19,18,42,60,134,85,219,0.000333,0.431203,18,23284.96273,1293.60904,1293.60904,301.535982,11,6
0,0,20,20,19,45,64,142,89,231,0.000333,0.462,9,12474,693,1386,327.844012,11,6
0,0,30,30,23,42,65,138,95,233,0.000333,0.467737,22,30870.65741,1715.036523,1403.2117,330.519257,8,6
0,0,30,30,24,40,64,135,93,228,0.000333,0.456,24,32832,1824,1368,322.916224,8,6
0,0,35,35,25,49,74,167,113,280,0.000333,0.579549,24,41727.52662,2318.195923,1738.646942,391.217187,11,6
0,0,23,23,19,36,55,108,73,181,0.000333,0.348809,18,18835.66995,1046.426108,1046.426108,266.827923,5,6
0,0,34,34,23,49,72,166,111,277,0.000333,0.56969,22,37599.52296,2088.862387,1709.069225,379.162707,10,6
0,0,18,18,18,30,48,96,64,160,0.000333,0.297865,18,16084.692,893.594,893.594,222.265368,6,6
0,0,31,31,15,43,58,166,117,283,0.000333,0.552603,14,23209.3207,1289.406706,1657.808622,291.932743,17,6
0,0,33,33,20,67,87,187,132,319,0.000333,0.6851,10,20552.98975,1141.832764,2055.298975,492.866538,17,6
0,0,31,31,21,63,84,168,114,282,0.000333,0.600878,10,18026.33513,1001.463063,1802.633513,468.807301,17,6
0,0,48,48,27,67,94,242,168,410,0.000333,0.895794,26,69871.91716,3881.773175,2687.381429,534.809938,24,6
0,0,50,50,27,68,95,249,174,423,0.000333,0.92635,26,72255.27198,4014.181777,2779.048922,542.329436,24,6
0,0,46,46,25,67,92,228,161,389,0.000333,0.845889,24,60903.97442,3383.554135,2537.665601,522.524381,21,6
0,0,24,24,22,33,55,132,81,213,0.000333,0.410477,22,27091.45162,1505.080645,1231.429619,264.572502,12,6
0,0,25,25,22,37,59,153,86,239,0.000333,0.468651,22,30930.93715,1718.385397,1405.951689,290.85727,13,6
0,0,10,10,15,22,37,58,39,97,0.000333,0.168439,7,3537.218835,196.512158,505.316976,156.710855,6,6
0,0,36,36,30,49,79,213,126,339,0.000333,0.712327,30,64109.45021,3561.636123,2136.981674,422.3275,18,6
0,0,6,6,15,25,40,43,35,78,0.000333,0.13837,7,2905.77274,161.431819,415.110391,174.699764,2,6
0,0,5,5,15,23,38,38,32,70,0.000333,0.122452,7,2571.484482,142.860249,367.354926,162.645284,2,6
0,0,7,7,13,25,38,41,38,79,0.000333,0.138195,6,2487.517641,138.195425,414.586274,164.202121,2,6
0,0,6,6,13,23,36,36,35,71,0.000333,0.122355,6,2202.388051,122.354892,367.064675,152.147641,2,6
0,0,11,11,15,25,40,59,37,96,0.000333,0.170302,7,3576.33568,198.685316,510.905097,174.699764,8,6
0,0,11,11,15,27,42,62,39,101,0.000333,0.181541,7,3812.368418,211.798245,544.62406,186.985321,8,6
0,0,15,15,17,33,50,81,52,133,0.000333,0.250211,8,6005.062986,333.61461,750.632873,235.951874,11,6
0,0,39,39,26,52,78,201,128,329,0.000333,0.689299,26,53765.33058,2986.96281,2067.89733,418.634298,19,6
0,0,32,32,24,50,74,168,108,276,0.000333,0.57127,24,41131.41909,2285.078839,1713.809129,392.23191,16,6
0,0,38,38,18,47,65,220,150,370,0.000333,0.742759,27,60163.45445,3342.414136,2228.276091,336.124326,23,6
0,0,40,40,25,69,94,243,164,407,0.000333,0.889239,24,64025.2239,3556.956884,2667.717663,537.584592,20,6
0,0,38,38,25,64,89,224,146,370,0.000333,0.798674,24,57504.51287,3194.695159,2396.021369,500.096405,20,6
0,0,45,45,21,59,80,248,163,411,0.000333,0.866104,20,51966.24894,2887.01383,2598.312447,439.314606,26,6
0,0,37,37,21,63,84,211,140,351,0.000333,0.747901,20,44874.06831,2493.003795,2243.703415,468.807301,21,6
0,0,35,35,21,59,80,192,122,314,0.000333,0.661695,20,39701.70844,2205.650469,1985.085422,439.314606,21,6
0,0,38,38,18,46,64,219,150,369,0.000333,0.738,27,59778,3321,2214,329.1425,23,6
0,0,29,29,17,46,63,176,122,298,0.000333,0.593743,16,28499.67068,1583.315038,1781.229417,323.570718,16,6
0,0,27,27,17,41,58,157,104,261,0.000333,0.509644,16,24462.92864,1359.051591,1528.93304,289.1465,16,6
0,0,3,3,10,15,25,16,16,32,0.000333,0.049534,5,743.01699,41.278722,148.603398,91.82264,1,6
0,0,3,3,10,15,25,16,16,32,0.000333,0.049534,5,743.01699,41.278722,148.603398,91.82264,1,6
0,0,3,3,10,15,25,16,16,32,0.000333,0.049534,5,743.01699,41.278722,148.603398,91.82264,1,6
0,0,3,3,10,17,27,18,21,39,0.000333,0.061814,5,927.203063,51.511281,185.440613,102.706149,1,6
0,0,3,3,10,16,26,20,18,38,0.000333,0.059539,5,893.083546,49.615753,178.616709,97.219281,1,6
0,0,17,17,16,34,50,86,64,150,0.000333,0.282193,8,6772.627428,376.257079,846.578428,236.973737,6,6
0,0,16,16,16,32,48,81,61,142,0.000333,0.264355,8,6344.517401,352.473189,793.064675,224,6,6
0,0,11,11,15,29,44,64,50,114,0.000333,0.207458,7,4356.626432,242.034802,622.375205,199.484808,4,6
0,0,17,17,16,35,51,86,64,150,0.000333,0.283621,8,6806.91041,378.161689,850.863801,243.524906,6,6
0,0,16,16,16,33,49,81,61,142,0.000333,0.265763,8,6378.310383,354.350577,797.288798,230.465006,6,6
0,0,11,11,15,29,44,64,50,114,0.000333,0.207458,7,4356.626432,242.034802,622.375205,199.484808,4,6
0,0,17,17,15,36,51,86,65,151,0.000333,0.285512,7,5995.753586,333.097421,856.536227,244.720659,6,6
0,0,16,16,15,34,49,81,62,143,0.000333,0.267635,7,5620.324554,312.240253,802.903508,231.577096,6,6
0,0,11,11,15,29,44,64,50,114,0.000333,0.207458,7,4356.626432,242.034802,622.375205,199.484808,4,6
0,0,19,19,16,35,51,90,67,157,0.000333,0.296857,8,7124.56623,395.809235,890.570779,243.524906,6,6
0,0,18,18,16,33,49,85,64,149,0.000333,0.278864,8,6692.734134,371.818563,836.591767,230.465006,6,6
0,0,11,11,15,29,44,64,50,114,0.000333,0.207458,7,4356.626432,242.034802,622.375205,199.484808,4,6
0,0,3,3,10,13,23,15,15,30,0.000333,0.045236,5,678.534293,37.69635,135.706859,81.324997,1,6
0,0,3,3,10,13,23,15,15,30,0.000333,0.045236,5,678.534293,37.69635,135.706859,81.324997,1,6
0,0,3,3,10,13,23,15,15,30,0.000333,0.045236,5,678.534293,37.69635,135.706859,81.324997,1,6
0,0,29,29,23,46,69,194,116,310,0.000333,0.631214,22,41660.1368,2314.452044,1893.642582,358.125775,18,6
0,0,31,31,25,48,73,178,111,289,0.000333,0.596286,24,42932.62314,2385.14573,1788.859298,384.174605,15,6
0,0,24,24,21,40,61,135,85,220,0.000333,0.434921,20,26095.24429,1449.735794,1304.762214,305.11579,14,6
0,0,55,55,31,69,100,278,187,465,0.000333,1.029798,30,92681.79385,5148.988547,3089.393128,575.068273,26,6
0,0,49,49,25,55,80,225,153,378,0.000333,0.796563,24,57352.53168,3186.25176,2389.68882,434.071189,17,6
0,0,47,47,22,39,61,210,145,355,0.000333,0.701804,33,69478.58791,3859.921551,2105.411755,304.238182,16,6
0,0,53,53,25,55,80,239,165,404,0.000333,0.851353,36,91946.12221,5108.117901,2554.05895,434.071189,18,6
0,0,6,6,14,11,25,47,21,68,0.000333,0.105261,7,2210.475546,122.804197,315.782221,91.356717,2,6
0,0,8,8,15,13,28,57,25,82,0.000333,0.131401,7,2759.421725,153.301207,394.203104,106.709075,2,6
0,0,28,28,22,59,81,183,115,298,0.000333,0.629758,11,20782.02831,1154.557128,1889.275301,445.183436,15,6
0,0,29,29,22,62,84,191,119,310,0.000333,0.660539,11,21797.80241,1210.989023,1981.618401,467.267667,15,6
0,0,11,11,12,24,36,53,37,90,0.000333,0.155098,6,2791.759501,155.09775,465.29325,153.05865,6,6
0,0,14,14,13,29,42,67,48,115,0.000333,0.206706,6,3720.699022,206.705501,620.116504,188.987165,9,6
0,0,12,12,13,27,40,55,42,97,0.000333,0.172076,6,3097.362151,172.075675,516.227025,176.487679,7,6
0,0,11,11,15,18,33,59,37,96,0.000333,0.161421,14,6779.665696,376.648094,484.261835,133.662009,4,6
0,0,14,14,16,23,39,73,48,121,0.000333,0.213178,16,10232.5387,568.474372,639.533668,168.041925,7,6
0,0,8,8,11,17,28,33,27,60,0.000333,0.096147,5,1442.206477,80.122582,288.441295,107.540616,4,6
0,0,37,37,20,44,64,208,130,338,0.000333,0.676,20,40560,2253.333333,2028,326.653553,16,6
0,0,27,27,20,38,58,161,95,256,0.000333,0.499881,20,29992.8627,1666.27015,1499.643135,285.859807,9,6
0,0,27,27,20,38,58,162,96,258,0.000333,0.503786,20,30227.18194,1679.287885,1511.359097,285.859807,9,6
0,0,27,27,20,38,58,161,95,256,0.000333,0.499881,20,29992.8627,1666.27015,1499.643135,285.859807,9,6
0,0,27,27,20,38,58,162,96,258,0.000333,0.503786,20,30227.18194,1679.287885,1511.359097,285.859807,9,6
0,0,27,27,20,38,58,161,95,256,0.000333,0.499881,20,29992.8627,1666.27015,1499.643135,285.859807,9,6
0,0,27,27,20,38,58,162,96,258,0.000333,0.503786,20,30227.18194,1679.287885,1511.359097,285.859807,9,6
0,0,39,39,20,43,63,215,137,352,0.000333,0.701334,30,63120.07599,3506.670888,2104.002533,319.767946,17,6
0,0,38,38,20,43,63,209,134,343,0.000333,0.683402,30,61506.21041,3417.01169,2050.207014,319.767946,16,6
0,0,37,37,20,43,63,203,131,334,0.000333,0.66547,30,59892.34483,3327.352491,1996.411494,319.767946,15,6
0,0,39,39,20,45,65,218,138,356,0.000333,0.714654,30,64318.88824,3573.271569,2143.962941,333.571951,16,6
0,0,34,34,23,49,72,229,133,362,0.000333,0.744504,22,49137.28271,2729.84904,2233.512851,379.162707,17,6
0,0,37,37,25,52,77,225,137,362,0.000333,0.756192,24,54445.84147,3024.76897,2268.576728,412.51927,14,6
0,0,23,23,22,44,66,128,81,209,0.000333,0.421093,11,13896.06208,772.003449,1263.278371,338.322487,14,6
0,0,25,25,22,45,67,135,87,222,0.000333,0.448891,11,14813.3898,822.9661,1346.6718,345.240885,16,6
0,0,21,21,19,43,62,119,75,194,0.000333,0.385038,9,10396.02676,577.557042,1155.114084,314.040007,16,6
0,0,24,24,21,38,59,119,78,197,0.000333,0.386294,20,23177.61361,1287.645201,1158.880681,291.659911,10,6
0,0,27,27,22,43,65,133,89,222,0.000333,0.445655,22,29413.2444,1634.069133,1336.965654,331.43688,13,6
0,0,28,28,22,46,68,143,94,237,0.000333,0.48091,22,31740.03125,1763.33507,1442.728693,352.191346,13,6
0,0,16,16,18,28,46,80,56,136,0.000333,0.250401,18,13521.67967,751.204426,751.204426,209.664588,8,6
0,0,38,38,20,55,75,240,115,355,0.000333,0.737077,20,44224.6127,2456.922928,2211.230635,404.413346,16,6
0,0,27,27,19,40,59,164,97,261,0.000333,0.51179,18,27636.65705,1535.369836,1535.369836,293.587747,9,6
0,0,27,27,19,40,59,165,98,263,0.000333,0.515712,18,27848.4322,1547.135122,1547.135122,293.587747,9,6
0,0,27,27,19,40,59,164,97,261,0.000333,0.51179,18,27636.65705,1535.369836,1535.369836,293.587747,9,6
0,0,27,27,19,40,59,165,98,263,0.000333,0.515712,18,27848.4322,1547.135122,1547.135122,293.587747,9,6
0,0,27,27,19,40,59,164,97,261,0.000333,0.51179,18,27636.65705,1535.369836,1535.369836,293.587747,9,6
0,0,27,27,19,40,59,165,98,263,0.000333,0.515712,18,27848.4322,1547.135122,1547.135122,293.587747,9,6
0,0,39,39,18,44,62,218,139,357,0.000333,0.708549,27,57392.49824,3188.472124,2125.648083,315.273641,17,6
0,0,38,38,18,44,62,212,136,348,0.000333,0.690687,27,55945.62853,3108.090474,2072.060316,315.273641,16,6
0,0,37,37,18,44,62,206,133,339,0.000333,0.672824,27,54498.75883,3027.708824,2018.472549,315.273641,15,6
0,0,39,39,19,46,65,221,140,361,0.000333,0.724692,27,58700.01907,3261.112171,2174.074781,334.794473,16,6
0,0,14,14,14,22,36,53,46,99,0.000333,0.170608,14,7165.516052,398.084225,511.822575,151.410465,3,6
0,0,13,13,14,21,35,50,45,95,0.000333,0.162427,14,6821.946413,378.997023,487.281887,145.541635,2,6
0,0,12,12,14,22,36,58,42,100,0.000333,0.172331,7,3618.947501,201.052639,516.9925,151.410465,3,6
0,0,9,9,14,16,30,39,33,72,0.000333,0.117765,14,4946.14572,274.785873,353.296123,117.302969,2,6
0,0,16,16,15,21,36,68,58,126,0.000333,0.217137,14,9119.747703,506.65265,651.41055,150.842025,2,6
0,0,10,10,14,17,31,39,37,76,0.000333,0.125506,14,5271.264874,292.848049,376.51892,122.789837,2,6
0,0,17,17,14,22,36,68,61,129,0.000333,0.222307,14,9336.884553,518.715808,666.920325,151.410465,2,6
0,0,4,4,10,11,21,18,19,37,0.000333,0.054172,5,812.578723,45.143262,162.515745,71.273029,1,6
0,0,16,16,15,24,39,53,55,108,0.000333,0.190274,14,7991.528155,443.973786,570.82344,168.642459,2,6
0,0,11,11,14,20,34,38,35,73,0.000333,0.123795,7,2599.693512,144.427417,371.384787,139.741531,2,6
0,0,15,15,15,21,36,54,49,103,0.000333,0.177501,14,7455.031852,414.168436,532.502275,150.842025,2,6
0,0,10,10,13,18,31,34,30,64,0.000333,0.10569,6,1902.411383,105.689521,317.068564,123.164366,2,6
0,0,5,5,7,10,17,10,14,24,0.000333,0.0327,3,294.297325,16.349851,98.099108,52.870765,1,6
0,0,9,9,14,17,31,40,32,72,0.000333,0.118901,7,2496.91494,138.717497,356.702134,122.789837,2,6
0,0,13,13,14,18,32,49,43,92,0.000333,0.153333,14,6440,357.777778,460,128.361619,3,6
0,0,10,10,12,16,28,34,32,66,0.000333,0.105762,12,3807.425098,211.523617,317.285425,107.01955,2,6
0,0,14,14,15,23,38,61,55,116,0.000333,0.20292,14,8522.634282,473.479682,608.759592,162.645284,2,6
0,0,12,12,15,18,33,43,37,80,0.000333,0.134517,14,5649.721414,313.873412,403.55153,133.662009,3,6
0,0,9,9,10,16,26,28,26,54,0.000333,0.084608,5,1269.118724,70.506596,253.823745,97.219281,2,6
0,0,12,12,15,19,34,43,38,81,0.000333,0.137361,14,5769.182862,320.510159,412.08449,139.313982,3,6
0,0,9,9,10,17,27,28,27,55,0.000333,0.087173,5,1307.594063,72.644115,261.518813,102.706149,2,6
0,0,19,19,14,19,33,75,67,142,0.000333,0.238768,21,15042.38326,835.687959,716.303965,134.013592,2,6
0,0,10,10,14,15,29,47,34,81,0.000333,0.131165,14,5508.950448,306.052803,393.496461,111.906328,2,6
0,0,21,21,14,20,34,81,77,158,0.000333,0.26794,21,16880.20171,937.788984,803.819129,139.741531,2,6
0,0,10,10,14,15,29,47,34,81,0.000333,0.131165,14,5508.950448,306.052803,393.496461,111.906328,2,6
0,0,10,10,12,18,30,31,29,60,0.000333,0.098138,6,1766.480614,98.137812,294.413436,118.0782,3,6
0,0,10,10,12,18,30,31,29,60,0.000333,0.098138,6,1766.480614,98.137812,294.413436,118.0782,3,6
0,0,11,11,15,21,36,37,35,72,0.000333,0.124078,7,2605.642201,144.7579,372.2346,150.842025,3,6
0,0,9,9,12,17,29,28,28,56,0.000333,0.090682,6,1632.281614,90.682312,272.046936,112.506418,2,6
0,0,14,14,12,23,35,64,68,132,0.000333,0.225688,12,8124.784299,451.376905,677.065358,147.061475,1,6
0,0,10,10,13,20,33,46,42,88,0.000333,0.147969,12,5326.88019,295.937788,443.906683,134.544278,2,6
0,0,12,12,12,19,31,48,75,123,0.000333,0.203122,18,10968.59063,609.366146,609.366146,123.730173,1,6
0,0,11,11,14,17,31,50,37,87,0.000333,0.143672,14,6034.211106,335.23395,431.015079,122.789837,2,6
0,0,11,11,15,18,33,52,38,90,0.000333,0.151332,14,6355.93659,353.107588,453.995471,133.662009,2,6
0,0,10,10,13,18,31,41,33,74,0.000333,0.122204,6,2199.663162,122.203509,366.610527,123.164366,2,6
0,0,10,10,13,17,30,41,32,73,0.000333,0.119401,6,2149.218081,119.401004,358.203013,117.592585,2,6
0,0,10,10,13,17,30,41,33,74,0.000333,0.121037,6,2178.659424,121.036635,363.109904,117.592585,2,6
0,0,10,10,13,17,30,41,32,73,0.000333,0.119401,6,2149.218081,119.401004,358.203013,117.592585,2,6
0,0,12,12,14,20,34,49,37,86,0.000333,0.145841,7,3062.65263,170.147368,437.521804,139.741531,3,6
0,0,11,11,14,19,33,44,32,76,0.000333,0.127791,7,2683.617671,149.089871,383.373953,134.013592,3,6
0,0,11,11,14,19,33,46,36,82,0.000333,0.13788,7,2895.482225,160.860124,413.640318,134.013592,2,6
0,0,10,10,14,18,32,41,31,72,0.000333,0.12,7,2520,140,360,128.361619,2,6
0,0,13,13,17,21,38,55,43,98,0.000333,0.171432,16,8228.750341,457.152797,514.296896,161.725534,3,6
0,0,12,12,17,20,37,50,38,88,0.000333,0.152811,8,3667.455169,203.747509,458.431896,155.92543,3,6
0,0,3,3,8,9,17,11,12,23,0.000333,0.031337,4,376.046581,20.891477,94.011645,52.529325,1,6
0,0,16,16,15,24,39,70,54,124,0.000333,0.218463,14,9175.458252,509.747681,655.389875,168.642459,6,6
0,0,16,16,14,20,34,62,50,112,0.000333,0.189932,14,7977.141735,443.174541,569.795838,139.741531,2,6
0,0,10,10,13,16,29,40,31,71,0.000333,0.114972,6,2069.499904,114.972217,344.916651,112.105716,2,6
0,0,10,10,14,14,28,41,29,70,0.000333,0.112172,14,4711.207824,261.733768,336.514845,106.605938,2,6
0,0,14,14,14,21,35,52,44,96,0.000333,0.164137,14,6893.756375,382.986465,492.41117,145.541635,3,6
0,0,14,14,14,21,35,57,41,98,0.000333,0.167557,7,3518.68815,195.482675,502.669736,145.541635,3,6
0,0,9,9,13,15,28,34,27,61,0.000333,0.09775,6,1759.491901,97.74955,293.24865,106.709075,2,6
0,0,4,4,11,13,24,21,19,40,0.000333,0.061133,5,916.9925,50.944028,183.3985,86.159464,1,6
0,0,15,15,14,22,36,64,47,111,0.000333,0.191287,14,8034.063452,446.336858,573.861675,151.410465,3,6
0,0,10,10,13,16,29,41,33,74,0.000333,0.11983,12,4313.887124,239.660396,359.490594,112.105716,2,6
0,0,14,14,10,20,30,64,55,119,0.000333,0.19464,10,5839.199809,324.399989,583.919981,119.657843,1,6
0,0,5,5,9,13,22,19,22,41,0.000333,0.060946,4,731.346785,40.630377,182.836696,76.635041,1,6
0,0,12,12,13,20,33,54,50,104,0.000333,0.174872,12,6295.403861,349.744659,524.616988,134.544278,1,6
0,0,17,17,15,21,36,62,46,108,0.000333,0.186117,14,7816.926602,434.2737,558.3519,150.842025,3,6
0,0,10,10,14,16,30,44,33,77,0.000333,0.125944,14,5289.628062,293.868226,377.830576,117.302969,2,6
0,0,14,14,15,20,35,48,36,84,0.000333,0.14362,7,3016.018414,167.556579,430.859773,145.041921,3,6
0,0,19,19,15,24,39,72,52,124,0.000333,0.218463,14,9175.458252,509.747681,655.389875,168.642459,3,6
0,0,10,10,14,16,30,44,33,77,0.000333,0.125944,14,5289.628062,293.868226,377.830576,117.302969,2,6
0,0,14,14,15,21,36,53,37,90,0.000333,0.155098,7,3257.052751,180.947375,465.29325,150.842025,3,6
0,0,14,14,15,22,37,53,37,90,0.000333,0.156284,7,3281.95562,182.330868,468.850803,156.710855,3,6
0,0,15,15,14,21,35,58,44,102,0.000333,0.174396,14,7324.616148,406.923119,523.186868,145.541635,3,6
0,0,10,10,14,16,30,44,33,77,0.000333,0.125944,14,5289.628062,293.868226,377.830576,117.302969,2,6
0,0,12,12,14,20,34,44,34,78,0.000333,0.132274,7,2777.754711,154.319706,396.822102,139.741531,3,6
0,0,8,8,14,17,31,36,35,71,0.000333,0.117249,14,4924.471133,273.58173,351.747938,122.789837,2,6
0,0,18,18,17,22,39,83,65,148,0.000333,0.260747,16,12515.83245,695.324025,782.239528,167.594364,2,6
0,0,8,8,11,14,25,24,21,45,0.000333,0.069658,5,1044.867643,58.048202,208.973529,91.356717,2,6
0,0,13,13,15,14,29,42,44,86,0.000333,0.139262,21,8773.513677,487.417427,417.786366,111.906328,3,6
0,0,13,13,14,16,30,40,43,83,0.000333,0.135757,14,5701.806872,316.767048,407.271919,117.302969,2,6
0,0,13,13,16,17,33,43,44,87,0.000333,0.146287,16,7021.796614,390.099812,438.862288,133.486868,3,6
0,0,13,13,15,19,34,41,43,84,0.000333,0.142449,14,5982.856301,332.380906,427.346879,139.313982,2,6
0,0,15,15,14,17,31,52,52,104,0.000333,0.171745,21,10819.96474,601.109152,515.236416,122.789837,3,6
0,0,15,15,13,19,32,50,51,101,0.000333,0.168333,12,6060,336.666667,505,128.816339,2,6
0,0,11,11,10,17,27,34,35,69,0.000333,0.109362,10,3280.872376,182.270688,328.087238,102.706149,1,6
0,0,13,13,14,19,33,45,38,83,0.000333,0.139562,14,5861.585967,325.643665,418.684712,134.013592,2,6
0,0,14,14,14,18,32,49,56,105,0.000333,0.175,21,11025,612.5,525,128.361619,1,6
0,0,11,11,12,16,28,32,35,67,0.000333,0.107364,12,3865.113357,214.72852,322.09278,107.01955,2,6
0,0,14,14,15,18,33,45,42,87,0.000333,0.146287,14,6144.072037,341.337335,438.862288,133.662009,2,6
0,0,12,12,12,17,29,44,39,83,0.000333,0.134404,12,4838.549071,268.808282,403.212423,112.506418,1,6
0,0,14,14,14,19,33,56,40,96,0.000333,0.161421,14,6779.665696,376.648094,484.261835,134.013592,2,6
0,0,10,10,13,16,29,37,29,66,0.000333,0.106876,6,1923.760474,106.875582,320.626746,112.105716,2,6
0,0,14,14,15,20,35,48,45,93,0.000333,0.159008,14,6678.326488,371.018138,477.023321,145.041921,2,6
0,0,12,12,11,20,31,42,43,85,0.000333,0.140369,10,4211.066864,233.948159,421.106686,124.49231,1,6
0,0,11,11,10,17,27,40,38,78,0.000333,0.123627,10,3708.812252,206.045125,370.881225,102.706149,1,6
0,0,13,13,13,16,29,44,46,90,0.000333,0.145739,12,5246.619475,291.47886,437.21829,112.105716,4,6
0,0,13,13,13,18,31,42,45,87,0.000333,0.143672,12,5172.180948,287.343386,431.015079,123.164366,3,6
0,0,14,14,12,19,31,56,47,103,0.000333,0.170094,12,6123.38664,340.188147,510.28222,123.730173,3,6
0,0,14,14,16,21,37,57,44,101,0.000333,0.175385,16,8418.476639,467.693147,526.15479,156.238666,3,6
0,0,13,13,13,19,32,50,41,91,0.000333,0.151667,12,5460,303.333333,455,128.816339,3,6
0,0,14,14,16,21,37,57,44,101,0.000333,0.175385,16,8418.476639,467.693147,526.15479,156.238666,3,6
0,0,13,13,13,20,33,50,42,92,0.000333,0.154695,12,5569.011108,309.389506,464.084259,134.544278,3,6
0,0,14,14,16,21,37,57,44,101,0.000333,0.175385,16,8418.476639,467.693147,526.15479,156.238666,3,6
0,0,15,15,14,20,34,54,44,98,0.000333,0.16619,14,6979.999018,387.777723,498.571358,139.741531,3,6
0,0,14,14,16,21,37,57,44,101,0.000333,0.175385,16,8418.476639,467.693147,526.15479,156.238666,3,6
0,0,15,15,14,18,32,72,50,122,0.000333,0.203333,14,8540,474.444444,610,128.361619,2,6
0,0,10,10,14,15,29,44,32,76,0.000333,0.123069,14,5168.891779,287.160654,369.206556,111.906328,2,6
0,0,12,12,13,21,34,37,36,73,0.000333,0.123795,6,2228.308724,123.794929,371.384787,140.344382,3,6
0,0,10,10,12,18,30,29,28,57,0.000333,0.093231,6,1678.156584,93.230921,279.692764,118.0782,3,6
0,0,17,17,14,24,38,55,48,103,0.000333,0.180179,14,7567.511474,420.417304,540.536534,163.342069,3,6
0,0,12,12,14,21,35,39,32,71,0.000333,0.121393,7,2549.253659,141.625203,364.179094,145.541635,3,6
0,0,12,12,13,20,33,38,31,69,0.000333,0.116021,6,2088.379165,116.021065,348.063194,134.544278,3,6
0,0,10,10,14,19,33,49,37,86,0.000333,0.144606,7,3036.72526,168.706959,433.817894,134.013592,2,6
0,0,18,18,15,22,37,76,61,137,0.000333,0.237898,14,9991.731555,555.096198,713.695111,156.710855,2,6
0,0,10,10,14,17,31,47,35,82,0.000333,0.135415,14,5687.417364,315.967631,406.244097,122.789837,2,6
0,0,11,11,14,17,31,47,39,86,0.000333,0.14202,14,5964.852358,331.380687,426.060883,122.789837,2,6
0,0,10,10,14,16,30,44,33,77,0.000333,0.125944,14,5289.628062,293.868226,377.830576,117.302969,2,6
0,0,19,19,14,23,37,76,64,140,0.000333,0.243108,14,10210.5286,567.251589,729.323471,157.344894,2,6
0,0,10,10,14,17,31,49,35,84,0.000333,0.138717,14,5826.134861,323.674159,416.15249,122.789837,2,6
0,0,19,19,15,23,38,68,69,137,0.000333,0.239655,21,15098.28746,838.793748,718.966069,162.645284,2,6
0,0,10,10,14,18,32,46,38,84,0.000333,0.14,14,5880,326.666667,420,128.361619,2,6
0,0,15,15,14,22,36,61,54,115,0.000333,0.19818,14,8323.579252,462.42107,594.541375,151.410465,2,6
0,0,16,16,14,23,37,53,62,115,0.000333,0.199696,14,8387.219919,465.956662,599.087137,157.344894,2,6
0,0,16,16,16,22,38,58,63,121,0.000333,0.211666,16,10159.98767,564.443759,634.999229,162.107496,4,6
0,0,16,16,14,24,38,56,62,118,0.000333,0.206418,14,8669.576252,481.643125,619.255447,163.342069,3,6
0,0,7,7,14,10,24,31,23,54,0.000333,0.082529,14,3466.231651,192.568425,247.587975,86.52225,3,6
0,0,7,7,13,12,25,29,22,51,0.000333,0.078946,6,1421.019994,78.945555,236.836666,91.125266,2,6
0,0,16,16,14,22,36,64,56,120,0.000333,0.206797,14,8685.474002,482.526333,620.391,151.410465,2,6
0,0,15,15,16,22,38,66,48,114,0.000333,0.199421,16,9572.219785,531.789988,598.263737,162.107496,3,6
0,0,17,17,15,21,36,72,52,124,0.000333,0.21369,14,8974.989803,498.610545,641.0707,150.842025,2,6
0,0,11,11,13,17,30,44,35,79,0.000333,0.129215,12,4651.732285,258.429571,387.644357,117.592585,2,6
0,0,15,15,15,24,39,78,50,128,0.000333,0.22551,14,9471.440776,526.191154,676.531484,168.642459,3,6
0,0,12,12,14,22,36,55,41,96,0.000333,0.165438,7,3474.189601,193.010533,496.3128,151.410465,3,6
0,0,11,11,14,20,34,52,39,91,0.000333,0.15432,7,3240.71383,180.039657,462.959119,139.741531,2,6
0,0,13,13,17,23,40,61,46,107,0.000333,0.189815,16,9111.140898,506.174494,569.446306,173.528793,3,6
0,0,13,13,15,15,30,54,43,97,0.000333,0.158656,14,6663.557429,370.197635,475.968388,117.206718,5,6
0,0,12,12,15,16,31,47,40,87,0.000333,0.143672,14,6034.211106,335.23395,431.015079,122.603359,4,6
0,0,12,12,15,14,29,42,32,74,0.000333,0.11983,14,5032.868311,279.603795,359.490594,111.906328,5,6
0,0,12,12,14,16,30,40,31,71,0.000333,0.11613,7,2438.724626,135.484701,348.389232,117.302969,4,6
0,0,12,12,16,15,31,43,36,79,0.000333,0.130461,16,6262.104136,347.894674,391.381509,122.603359,3,6
0,0,12,12,15,17,32,41,35,76,0.000333,0.126667,14,5320,295.555556,380,128.090227,2,6
0,0,15,15,14,22,36,64,47,111,0.000333,0.191287,14,8034.063452,446.336858,573.861675,151.410465,3,6
0,0,10,10,13,16,29,41,33,74,0.000333,0.11983,12,4313.887124,239.660396,359.490594,112.105716,2,6
0,0,18,18,15,20,35,79,54,133,0.000333,0.227398,14,9550.724978,530.595832,682.194641,145.041921,3,6
0,0,10,10,14,15,29,44,32,76,0.000333,0.123069,14,5168.891779,287.160654,369.206556,111.906328,2,6
0,0,16,16,14,20,34,75,52,127,0.000333,0.215369,14,9045.508932,502.528274,646.107781,139.741531,3,6
0,0,10,10,14,15,29,44,32,76,0.000333,0.123069,14,5168.891779,287.160654,369.206556,111.906328,2,6
0,0,17,17,17,21,38,81,57,138,0.000333,0.241405,16,11587.42395,643.745775,724.213997,161.725534,3,6
0,0,10,10,14,15,29,44,32,76,0.000333,0.123069,14,5168.891779,287.160654,369.206556,111.906328,2,6
0,0,10,10,13,14,27,36,30,66,0.000333,0.104608,12,3765.870902,209.21505,313.822575,101.408685,3,6
0,0,10,10,13,16,29,34,29,63,0.000333,0.102018,6,1836.316816,102.017601,306.052803,112.105716,2,6
0,0,13,13,18,21,39,58,48,106,0.000333,0.186751,18,10084.54743,560.252635,560.252635,167.297316,2,6
0,0,10,10,18,19,37,51,41,92,0.000333,0.159757,18,8626.854773,479.26971,479.26971,155.769273,2,6
0,0,8,8,14,19,33,36,30,66,0.000333,0.110977,7,2330.510083,129.472782,332.930012,134.013592,1,6
0,0,14,14,19,22,41,61,50,111,0.000333,0.198229,18,10704.38891,594.688273,594.688273,178.818118,3,6
0,0,10,10,18,19,37,51,41,92,0.000333,0.159757,18,8626.854773,479.26971,479.26971,155.769273,2,6
0,0,9,9,15,20,35,39,32,71,0.000333,0.121393,7,2549.253659,141.625203,364.179094,145.041921,2,6
0,0,10,10,10,15,25,41,55,96,0.000333,0.148603,15,6687.152913,371.508495,445.810194,91.82264,1,6
0,0,8,8,14,14,28,31,27,58,0.000333,0.092942,7,1951.786098,108.432561,278.826585,106.605938,3,6
0,0,8,8,13,16,29,29,26,55,0.000333,0.089063,6,1603.133728,89.062985,267.188955,112.105716,2,6
0,0,15,15,14,22,36,60,58,118,0.000333,0.20335,14,8540.716102,474.484228,610.05115,151.410465,2,6
0,0,32,32,23,53,76,140,111,251,0.000333,0.522743,22,34501.05573,1916.725318,1568.229806,407.621709,11,6
0,0,32,32,21,55,76,138,110,248,0.000333,0.516495,20,30989.72047,1721.651137,1549.486023,410.21345,10,6
0,0,29,29,19,53,72,128,99,227,0.000333,0.466858,9,12605.15678,700.286488,1400.572975,384.290407,10,6
0,0,28,28,19,53,72,127,97,224,0.000333,0.460688,9,12438.5688,691.0316,1382.0632,384.290407,10,6
0,0,10,10,15,18,33,39,36,75,0.000333,0.12611,14,5296.613825,294.256324,378.329559,133.662009,2,6
0,0,16,16,15,25,40,62,58,120,0.000333,0.212877,14,8940.839199,496.713289,638.631371,174.699764,2,6
0,0,9,9,13,15,28,37,29,66,0.000333,0.105762,6,1903.712549,105.761808,317.285425,106.709075,2,6
0,0,15,15,13,18,31,55,59,114,0.000333,0.188259,18,10166.01083,564.778379,564.778379,123.164366,2,6
0,0,9,9,13,15,28,37,29,66,0.000333,0.105762,6,1903.712549,105.761808,317.285425,106.709075,2,6
0,0,11,11,13,22,35,48,43,91,0.000333,0.155588,6,2800.588527,155.588252,466.764755,146.213212,2,6
0,0,12,12,15,20,35,56,39,95,0.000333,0.162427,7,3410.973206,189.498511,487.281887,145.041921,3,6
0,0,12,12,14,21,35,56,40,96,0.000333,0.164137,7,3446.878187,191.493233,492.41117,145.541635,3,6
0,0,13,13,17,22,39,62,45,107,0.000333,0.188513,16,9048.608599,502.700478,565.538037,167.594364,3,6
0,0,12,12,13,18,31,47,34,81,0.000333,0.133763,6,2407.739407,133.7633,401.289901,123.164366,2,6
0,0,5,5,9,12,21,21,19,40,0.000333,0.058564,4,702.770788,39.042822,175.692697,71.548875,1,6
0,0,10,10,12,17,29,43,31,74,0.000333,0.11983,6,2156.943562,119.830198,359.490594,112.506418,2,6
0,0,5,5,9,12,21,21,19,40,0.000333,0.058564,4,702.770788,39.042822,175.692697,71.548875,1,6
0,0,19,19,15,25,40,66,74,140,0.000333,0.248357,14,10430.97907,579.498837,745.069933,174.699764,2,6
0,0,12,12,16,19,35,52,40,92,0.000333,0.157298,16,7550.304601,419.461367,471.894038,144.710623,3,6
0,0,13,13,13,19,32,53,48,101,0.000333,0.168333,12,6060,336.666667,505,128.816339,1,6
0,0,13,13,13,18,31,51,47,98,0.000333,0.161837,12,5826.134861,323.674159,485.511238,123.164366,1,6
0,0,7,7,13,12,25,34,24,58,0.000333,0.089781,12,3232.123908,179.562439,269.343659,91.125266,1,6
0,0,7,7,13,13,26,34,25,59,0.000333,0.092442,6,1663.95566,92.441981,277.325943,96.211433,1,6
0,0,14,14,14,21,35,57,47,104,0.000333,0.177815,14,7468.236073,414.902004,533.445434,145.541635,3,6
0,0,14,14,14,23,37,57,48,105,0.000333,0.182331,14,7657.896447,425.438692,546.992603,157.344894,3,6
0,0,14,14,14,22,36,57,48,105,0.000333,0.180947,14,7599.789752,422.210542,542.842125,151.410465,3,6
0,0,10,10,13,19,32,46,35,81,0.000333,0.135,6,2430,135,405,128.816339,2,6
0,0,10,10,13,18,31,46,34,80,0.000333,0.132112,6,2378.014229,132.111902,396.335705,123.164366,2,6
0,0,10,10,13,18,31,46,34,80,0.000333,0.132112,6,2378.014229,132.111902,396.335705,123.164366,2,6
0,0,12,12,14,19,33,50,37,87,0.000333,0.146287,7,3072.036019,170.668668,438.862288,134.013592,2,6
0,0,10,10,10,16,26,37,32,69,0.000333,0.10811,10,3243.303406,180.183523,324.330341,97.219281,2,6
0,0,12,12,13,19,32,46,37,83,0.000333,0.138333,6,2490,138.333333,415,128.816339,2,6
0,0,14,14,13,22,35,47,68,115,0.000333,0.196623,18,10617.61585,589.867547,589.867547,146.213212,1,6
0,0,12,12,12,19,31,48,75,123,0.000333,0.203122,18,10968.59063,609.366146,609.366146,123.730173,1,6
0,0,15,15,15,22,37,61,65,126,0.000333,0.218797,14,9189.475737,510.52643,656.391124,156.710855,2,6
0,0,13,13,14,18,32,59,59,118,0.000333,0.196667,21,12390,688.333333,590,128.361619,1,6
0,0,4,4,12,11,23,22,20,42,0.000333,0.06333,6,1139.937613,63.329867,189.989602,81.073298,1,6
0,0,31,31,23,48,71,138,111,249,0.000333,0.510429,22,33688.31472,1871.57304,1531.287033,372.120125,9,6
0,0,31,31,21,50,71,136,110,246,0.000333,0.504279,20,30256.75583,1680.930879,1512.837791,374.431475,8,6
0,0,13,13,14,20,34,53,47,100,0.000333,0.169582,14,7122.447978,395.691554,508.746284,139.741531,2,6
0,0,13,13,15,20,35,56,41,97,0.000333,0.165847,14,6965.566337,386.975908,497.540453,145.041921,2,6
0,0,13,13,14,20,34,53,41,94,0.000333,0.159407,14,6695.101099,371.950061,478.221507,139.741531,2,6
0,0,13,13,17,21,38,56,42,98,0.000333,0.171432,16,8228.750341,457.152797,514.296896,161.725534,3,6
0,0,4,4,12,13,25,25,20,45,0.000333,0.069658,6,1253.841171,69.657843,208.973529,91.125266,1,6
0,0,7,7,14,12,26,30,27,57,0.000333,0.089308,14,3750.950895,208.386161,267.925064,96.322519,3,6
0,0,7,7,14,15,29,28,26,54,0.000333,0.087444,7,1836.316816,102.017601,262.330974,111.906328,2,6
0,0,7,7,12,15,27,30,29,59,0.000333,0.093513,6,1683.230176,93.512788,280.538363,101.622909,1,6
0,0,6,6,14,15,29,32,26,58,0.000333,0.093921,7,1972.340284,109.57446,281.762898,111.906328,1,6
0,0,9,9,12,17,29,29,28,57,0.000333,0.092302,6,1661.4295,92.301639,276.904917,112.506418,2,6
0,0,11,11,17,16,33,49,37,86,0.000333,0.144606,16,6941.086308,385.615906,433.817894,133.486868,2,6
0,0,20,20,18,21,39,75,71,146,0.000333,0.257223,27,20835.05555,1157.503086,771.668724,167.297316,2,6
0,0,20,20,18,22,40,90,69,159,0.000333,0.282062,27,22847.03731,1269.279851,846.186567,173.166146,3,6
0,0,10,10,13,16,29,45,33,78,0.000333,0.126308,12,4547.070211,252.615012,378.922518,112.105716,2,6
0,0,18,18,18,26,44,90,71,161,0.000333,0.292989,18,15821.43283,878.968491,878.968491,197.270083,2,6
0,0,11,11,18,21,39,57,45,102,0.000333,0.179704,18,9703.998474,539.111026,539.111026,167.297316,2,6
0,0,17,17,18,23,41,75,81,156,0.000333,0.278593,27,22566.00904,1253.667169,835.778113,179.100575,2,6
0,0,11,11,18,20,38,57,45,102,0.000333,0.17843,18,9635.194915,535.288606,535.288606,161.497212,2,6
0,0,32,32,26,53,79,143,116,259,0.000333,0.544226,26,42449.65956,2358.31442,1632.679214,425.791217,11,6
0,0,32,32,24,55,79,141,115,256,0.000333,0.537923,24,38730.42892,2151.690495,1613.767872,428.013884,10,6
0,0,9,9,13,17,30,33,29,62,0.000333,0.101409,6,1825.363302,101.409072,304.227217,117.592585,2,6
0,0,3,3,8,9,17,11,12,23,0.000333,0.031337,4,376.046581,20.891477,94.011645,52.529325,1,6
0,0,9,9,13,17,30,33,29,62,0.000333,0.101409,6,1825.363302,101.409072,304.227217,117.592585,2,6
0,0,10,10,10,15,25,41,37,78,0.000333,0.12074,10,3622.207828,201.233768,362.220783,91.82264,1,6
0,0,27,27,20,48,68,118,90,208,0.000333,0.422064,10,12661.92271,703.440151,1266.192271,354.516762,8,6
0,0,26,26,20,48,68,117,88,205,0.000333,0.415977,10,12479.29883,693.294379,1247.929882,354.516762,8,6
0,0,27,27,19,50,69,118,91,209,0.000333,0.425561,9,11490.1345,638.340806,1276.681611,362.903432,8,6
0,0,26,26,19,50,69,117,89,206,0.000333,0.419452,9,11325.20434,629.178019,1258.356038,362.903432,8,6
0,0,14,14,14,21,35,68,44,112,0.000333,0.191493,14,8042.715771,446.817543,574.479698,145.541635,2,6
0,0,11,11,13,19,32,48,35,83,0.000333,0.138333,6,2490,138.333333,415,128.816339,2,6
0,0,11,11,13,19,32,48,35,83,0.000333,0.138333,6,2490,138.333333,415,128.816339,2,6
0,0,11,11,13,20,33,48,36,84,0.000333,0.141243,6,2542.374636,141.243035,423.729106,134.544278,2,6
0,0,17,17,17,25,42,67,64,131,0.000333,0.235465,16,11302.29732,627.905407,706.393582,185.583273,2,6
0,0,14,14,14,18,32,54,67,121,0.000333,0.201667,21,12705,705.833333,605,128.361619,2,6
0,0,26,26,19,48,67,115,85,200,0.000333,0.404406,9,10918.96054,606.608919,1213.217838,348.788823,9,6
0,0,25,25,19,48,67,114,83,197,0.000333,0.39834,9,10755.17614,597.509785,1195.019571,348.788823,9,6
0,0,14,14,15,19,34,52,51,103,0.000333,0.17467,14,7336.121417,407.562301,524.008673,139.313982,2,6
0,0,14,14,18,23,41,69,52,121,0.000333,0.216088,18,11668.74827,648.263793,648.263793,179.100575,2,6
0,0,11,11,18,20,38,54,43,97,0.000333,0.169683,18,9162.881438,509.048969,509.048969,161.497212,2,6
0,0,11,11,13,22,35,38,37,75,0.000333,0.128232,6,2308.177358,128.232075,384.696226,146.213212,2,6
0,0,14,14,17,24,41,68,56,124,0.000333,0.221445,16,10629.38318,590.521288,664.336449,179.525968,2,6
0,0,12,12,14,21,35,54,39,93,0.000333,0.159008,7,3339.163244,185.509069,477.023321,145.541635,3,6
0,0,16,16,15,20,35,53,40,93,0.000333,0.159008,14,6678.326488,371.018138,477.023321,145.041921,3,6
0,0,9,9,13,15,28,34,27,61,0.000333,0.09775,6,1759.491901,97.74955,293.24865,106.709075,2,6
0,0,13,13,14,18,32,39,30,69,0.000333,0.115,7,2415,134.166667,345,128.361619,3,6
0,0,14,14,13,19,32,48,37,85,0.000333,0.141667,6,2550,141.666667,425,128.816339,3,6
0,0,9,9,13,15,28,34,27,61,0.000333,0.09775,6,1759.491901,97.74955,293.24865,106.709075,2,6
0,0,11,11,12,16,28,34,27,61,0.000333,0.09775,6,1759.491901,97.74955,293.24865,107.01955,3,6
0,0,14,14,13,20,33,48,38,86,0.000333,0.144606,6,2602.907366,144.605965,433.817894,134.544278,3,6
0,0,9,9,13,15,28,34,27,61,0.000333,0.09775,6,1759.491901,97.74955,293.24865,106.709075,2,6
0,0,11,11,12,17,29,34,28,62,0.000333,0.100398,6,1807.16893,100.398274,301.194822,112.506418,3,6
0,0,14,14,13,20,33,48,38,86,0.000333,0.144606,6,2602.907366,144.605965,433.817894,134.544278,3,6
0,0,9,9,13,15,28,34,27,61,0.000333,0.09775,6,1759.491901,97.74955,293.24865,106.709075,2,6
0,0,11,11,12,17,29,34,28,62,0.000333,0.100398,6,1807.16893,100.398274,301.194822,112.506418,3,6
0,0,14,14,16,22,38,54,43,97,0.000333,0.169683,8,4072.39175,226.243986,509.048969,162.107496,6,6
0,0,14,14,14,24,38,52,42,94,0.000333,0.164435,7,3453.136304,191.840906,493.305186,163.342069,5,6
0,0,10,10,11,23,34,39,32,71,0.000333,0.120403,5,1806.049309,100.336073,361.209862,142.095673,4,6
0,0,11,11,11,23,34,40,34,74,0.000333,0.125491,5,1882.361251,104.575625,376.47225,142.095673,4,6
0,0,14,14,16,22,38,54,43,97,0.000333,0.169683,8,4072.39175,226.243986,509.048969,162.107496,6,6
0,0,14,14,14,24,38,52,42,94,0.000333,0.164435,7,3453.136304,191.840906,493.305186,163.342069,5,6
0,0,10,10,11,23,34,39,32,71,0.000333,0.120403,5,1806.049309,100.336073,361.209862,142.095673,4,6
0,0,11,11,11,23,34,40,34,74,0.000333,0.125491,5,1882.361251,104.575625,376.47225,142.095673,4,6
0,0,15,15,15,24,39,76,60,136,0.000333,0.239605,14,10063.40583,559.078101,718.814702,168.642459,2,6
0,0,31,31,23,50,73,139,101,240,0.000333,0.495186,22,32682.27367,1815.681871,1485.557894,386.234734,13,6
0,0,31,31,21,52,73,137,100,237,0.000333,0.488996,10,14669.88421,814.993567,1466.98842,388.661531,12,6
0,0,28,28,19,51,70,125,93,218,0.000333,0.445395,9,12025.65328,668.091849,1336.183698,370.004315,11,6
0,0,27,27,19,51,70,124,91,215,0.000333,0.439265,9,11860.16264,658.897924,1317.795849,370.004315,11,6
0,0,10,10,11,17,28,46,34,80,0.000333,0.128196,10,3845.883938,213.660219,384.588394,107.540616,2,6
0,0,10,10,11,16,27,46,34,80,0.000333,0.126797,10,3803.910002,211.328333,380.391,102.053748,2,6
0,0,10,10,11,18,29,46,35,81,0.000333,0.131165,5,1967.482303,109.304572,393.496461,113.112398,2,6
0,0,15,15,19,24,43,72,53,125,0.000333,0.226094,18,12209.0957,678.283094,678.283094,190.749723,3,6
0,0,11,11,18,20,38,54,43,97,0.000333,0.169683,18,9162.881438,509.048969,509.048969,161.497212,2,6
0,0,14,14,17,24,41,63,56,119,0.000333,0.212516,16,10200.77902,566.709945,637.548689,179.525968,2,6
0,0,8,8,15,20,35,42,33,75,0.000333,0.128232,7,2692.873584,149.604088,384.696226,145.041921,2,6
0,0,10,10,13,18,31,37,32,69,0.000333,0.113947,6,2051.037273,113.946515,341.839545,123.164366,2,6
0,0,9,9,11,18,29,31,28,59,0.000333,0.09554,5,1433.104394,79.616911,286.620879,113.112398,2,6
0,0,16,16,14,22,36,59,53,112,0.000333,0.193011,14,8106.442402,450.357911,579.0316,151.410465,2,6
0,0,10,10,10,15,25,28,30,58,0.000333,0.089781,10,2693.43659,149.635366,269.343659,91.82264,2,6
0,0,10,10,12,16,28,29,26,55,0.000333,0.088135,6,1586.427124,88.13484,264.404521,107.01955,3,6
0,0,12,12,16,17,33,53,40,93,0.000333,0.156376,16,7506.05845,417.003247,469.128653,133.486868,3,6
0,0,10,10,13,15,28,44,33,77,0.000333,0.123389,12,4441.995948,246.777553,370.166329,106.709075,2,6
0,0,14,14,14,21,35,58,43,101,0.000333,0.172686,14,7252.806186,402.933677,518.057585,145.541635,3,6
0,0,9,9,13,16,29,35,29,64,0.000333,0.103637,6,1865.464702,103.636928,310.910784,112.105716,2,6
0,0,14,14,14,20,34,58,42,100,0.000333,0.169582,14,7122.447978,395.691554,508.746284,139.741531,3,6
0,0,9,9,13,16,29,35,29,64,0.000333,0.103637,6,1865.464702,103.636928,310.910784,112.105716,2,6
0,0,10,10,11,16,27,41,33,74,0.000333,0.117287,10,3518.616752,195.478708,351.861675,102.053748,2,6
0,0,12,12,14,19,33,50,38,88,0.000333,0.147969,14,6214.693555,345.260753,443.906683,134.013592,2,6
0,0,4,4,10,12,22,17,16,33,0.000333,0.049054,5,735.806217,40.878123,147.161243,76.238831,1,6
0,0,17,17,16,22,38,64,50,114,0.000333,0.199421,16,9572.219785,531.789988,598.263737,162.107496,4,6
0,0,10,10,13,16,29,41,32,73,0.000333,0.118211,12,4255.591352,236.421742,354.632613,112.105716,2,6
0,0,12,12,13,20,33,41,33,74,0.000333,0.124428,6,2239.710989,124.428388,373.285165,134.544278,3,6
0,0,17,17,16,20,36,64,49,113,0.000333,0.194734,16,9347.224403,519.290245,584.201525,150.438562,4,6
0,0,10,10,13,16,29,41,32,73,0.000333,0.118211,12,4255.591352,236.421742,354.632613,112.105716,2,6
0,0,12,12,13,18,31,41,32,73,0.000333,0.120552,6,2169.937984,120.55211,361.656331,123.164366,3,6
0,0,15,15,17,25,42,65,52,117,0.000333,0.2103,16,10094.41822,560.801012,630.901138,185.583273,4,6
0,0,14,14,12,22,34,57,71,128,0.000333,0.217065,18,11721.51439,651.195244,651.195244,141.127046,1,6
0,0,8,8,14,18,32,41,31,72,0.000333,0.12,7,2520,140,360,128.361619,2,6
0,0,8,8,13,18,31,32,32,64,0.000333,0.10569,6,1902.411383,105.689521,317.068564,123.164366,2,6
0,0,15,15,15,23,38,72,57,129,0.000333,0.225661,14,9477.757089,526.542061,676.982649,162.645284,2,6
0,0,13,13,13,20,33,50,64,114,0.000333,0.191687,18,10351.09673,575.06093,575.06093,134.544278,2,6
0,0,15,15,14,22,36,56,57,113,0.000333,0.194734,14,8178.821352,454.378964,584.201525,151.410465,2,6
0,0,16,16,15,25,40,58,57,115,0.000333,0.204007,14,8568.304233,476.016902,612.021731,174.699764,2,6
0,0,14,14,15,25,40,57,52,109,0.000333,0.193363,14,8121.262273,451.181237,580.090162,174.699764,2,6
0,0,12,12,16,20,36,52,41,93,0.000333,0.160268,16,7692.848402,427.380467,480.803025,150.438562,3,6
0,0,14,14,14,21,35,59,67,126,0.000333,0.21543,21,13572.08286,754.004603,646.28966,145.541635,2,6
0,0,9,9,15,19,34,42,32,74,0.000333,0.125491,7,2635.305752,146.405875,376.47225,139.313982,2,6
0,0,14,14,14,21,35,48,44,92,0.000333,0.157298,14,6606.516526,367.028696,471.894038,145.541635,3,6
0,0,10,10,13,18,31,34,29,63,0.000333,0.104038,6,1872.686205,104.038123,312.114368,123.164366,3,6
0,0,14,14,14,22,36,48,45,93,0.000333,0.160268,14,6731.242352,373.957908,480.803025,151.410465,3,6
0,0,10,10,13,19,32,34,30,64,0.000333,0.106667,6,1920,106.666667,320,128.816339,3,6
0,0,16,16,16,22,38,53,47,100,0.000333,0.174931,16,8396.684022,466.482446,524.792751,162.107496,3,6
0,0,12,12,15,20,35,39,32,71,0.000333,0.121393,7,2549.253659,141.625203,364.179094,145.041921,3,6
0,0,11,11,10,17,27,49,45,94,0.000333,0.148986,10,4469.594252,248.310792,446.959425,102.706149,1,6
0,0,10,10,13,20,33,46,42,88,0.000333,0.147969,12,5326.88019,295.937788,443.906683,134.544278,2,6
0,0,10,10,13,21,34,46,43,89,0.000333,0.150928,12,5433.410314,301.856129,452.784193,140.344382,2,6
0,0,16,16,15,22,37,61,52,113,0.000333,0.196223,14,8241.355224,457.853068,588.66823,156.710855,2,6
0,0,16,16,14,22,36,58,52,110,0.000333,0.189564,14,7961.684502,442.315806,568.69175,151.410465,2,6
0,0,17,17,17,22,39,75,53,128,0.000333,0.22551,16,10824.50374,601.361319,676.531484,167.594364,3,6
0,0,11,11,14,17,31,47,35,82,0.000333,0.135415,14,5687.417364,315.967631,406.244097,122.789837,2,6
0,0,18,18,15,22,37,73,50,123,0.000333,0.213588,14,8970.678696,498.371039,640.762764,156.710855,3,6
0,0,11,11,14,17,31,47,35,82,0.000333,0.135415,14,5687.417364,315.967631,406.244097,122.789837,2,6
0,0,28,28,20,48,68,119,88,207,0.000333,0.420035,10,12601.04808,700.058227,1260.104808,354.516762,9,6
0,0,27,27,20,48,68,118,86,204,0.000333,0.413947,10,12418.4242,689.912455,1241.84242,354.516762,9,6
0,0,26,26,19,49,68,115,86,201,0.000333,0.40786,9,11012.22028,611.790016,1223.580031,355.831405,9,6
0,0,25,25,19,49,68,114,84,198,0.000333,0.401773,9,10847.85878,602.658821,1205.317643,355.831405,9,6
0,0,16,16,14,23,37,67,58,125,0.000333,0.217061,14,9116.54339,506.474633,651.181671,157.344894,2,6
0,0,19,19,14,24,38,72,82,154,0.000333,0.269394,21,16971.79758,942.877643,808.180837,163.342069,2,6
0,0,16,16,15,25,40,62,58,120,0.000333,0.212877,14,8940.839199,496.713289,638.631371,174.699764,2,6
0,0,6,6,12,14,26,30,25,55,0.000333,0.086175,6,1551.145107,86.174728,258.524184,96.322519,1,6
0,0,6,6,12,15,27,30,26,56,0.000333,0.088758,6,1597.642201,88.7579,266.2737,101.622909,1,6
0,0,19,19,15,23,38,84,65,149,0.000333,0.260647,14,10947.17679,608.176489,781.9412,162.645284,2,6
0,0,11,11,13,18,31,47,37,84,0.000333,0.138717,12,4993.829881,277.434993,416.15249,123.164366,2,6
0,0,9,9,11,16,27,43,39,82,0.000333,0.129967,10,3899.007752,216.611542,389.900775,102.053748,1,6
0,0,8,8,13,18,31,34,33,67,0.000333,0.110644,6,1991.586917,110.643718,331.931153,123.164366,1,6
0,0,13,13,13,20,33,41,42,83,0.000333,0.139562,12,5024.216543,279.123141,418.684712,134.544278,2,6
0,0,9,9,12,17,29,27,27,54,0.000333,0.087444,6,1573.985842,87.443658,262.330974,112.506418,2,6
0,0,10,10,13,17,30,37,32,69,0.000333,0.112858,6,2031.452707,112.858484,338.575451,117.592585,2,6
0,0,9,9,11,17,28,31,28,59,0.000333,0.094545,5,1418.169702,78.787206,283.63394,107.540616,2,6
0,0,14,14,14,19,33,56,40,96,0.000333,0.161421,14,6779.665696,376.648094,484.261835,134.013592,2,6
0,0,10,10,13,16,29,37,29,66,0.000333,0.106876,6,1923.760474,106.875582,320.626746,112.105716,2,6
0,0,9,9,12,19,31,31,30,61,0.000333,0.100735,6,1813.23585,100.735325,302.205975,123.730173,2,6
0,0,16,16,14,22,36,53,47,100,0.000333,0.172331,14,7237.895002,402.105278,516.9925,151.410465,2,6
0,0,9,9,13,15,28,34,27,61,0.000333,0.09775,6,1759.491901,97.74955,293.24865,106.709075,2,6
0,0,12,12,13,18,31,38,33,71,0.000333,0.117249,6,2110.487628,117.249313,351.747938,123.164366,2,6
0,0,10,10,14,16,30,38,30,68,0.000333,0.111223,7,2335.679924,129.759996,333.668561,117.302969,2,6
0,0,6,6,5,10,15,13,17,30,0.000333,0.039069,2,234.413436,13.022969,117.206718,44.828921,1,6
0,0,14,14,15,23,38,67,56,123,0.000333,0.215165,14,9036.931178,502.051732,645.495084,162.645284,2,6
0,0,16,16,18,21,39,67,56,123,0.000333,0.216701,18,11701.88051,650.104473,650.104473,167.297316,4,6
0,0,11,11,17,18,35,56,45,101,0.000333,0.172686,16,8288.921355,460.495631,518.057585,144.545518,3,6
0,0,9,9,14,19,33,36,31,67,0.000333,0.112658,7,2365.820842,131.434491,337.974406,134.013592,2,6
0,0,15,15,17,20,37,64,54,118,0.000333,0.204905,16,9835.447954,546.413775,614.715497,155.92543,3,6
0,0,11,11,17,18,35,56,45,101,0.000333,0.172686,16,8288.921355,460.495631,518.057585,144.545518,3,6
0,0,8,8,13,18,31,33,29,62,0.000333,0.102387,6,1842.961027,102.386724,307.160171,123.164366,1,6
0,0,16,16,18,22,40,67,56,123,0.000333,0.218199,18,11782.7488,654.597156,654.597156,173.166146,4,6
0,0,11,11,17,18,35,56,45,101,0.000333,0.172686,16,8288.921355,460.495631,518.057585,144.545518,3,6
0,0,9,9,14,20,34,36,31,67,0.000333,0.11362,7,2386.020073,132.556671,340.86001,139.741531,2,6
0,0,15,15,13,18,31,55,59,114,0.000333,0.188259,18,10166.01083,564.778379,564.778379,123.164366,2,6
0,0,9,9,13,15,28,37,29,66,0.000333,0.105762,6,1903.712549,105.761808,317.285425,106.709075,2,6
0,0,19,19,20,24,44,68,73,141,0.000333,0.256593,30,23093.39575,1282.96643,769.779858,196.477662,3,6
0,0,18,18,18,23,41,81,64,145,0.000333,0.258948,18,13983.21073,776.845041,776.845041,179.100575,3,6
0,0,12,12,17,19,36,59,47,106,0.000333,0.182671,16,8768.192802,487.121822,548.01205,150.197491,3,6
0,0,20,20,20,24,44,88,76,164,0.000333,0.298449,30,26860.40356,1492.244642,895.346785,196.477662,4,6
0,0,12,12,17,19,36,59,47,106,0.000333,0.182671,16,8768.192802,487.121822,548.01205,150.197491,3,6
0,0,15,15,18,17,35,49,58,107,0.000333,0.182944,27,14818.49864,823.249924,548.833283,144.545518,3,6
0,0,15,15,18,19,37,47,57,104,0.000333,0.180594,27,14628.14505,812.674725,541.78315,155.769273,2,6
0,0,15,15,13,17,30,53,52,105,0.000333,0.171741,18,9274.023226,515.223513,515.223513,117.592585,3,6
0,0,15,15,13,19,32,51,51,102,0.000333,0.17,12,6120,340,510,128.816339,2,6
0,0,10,10,11,15,26,41,32,73,0.000333,0.114377,10,3431.320994,190.628944,343.132099,96.657107,2,6
0,0,12,12,14,19,33,50,38,88,0.000333,0.147969,14,6214.693555,345.260753,443.906683,134.013592,2,6
0,0,30,30,23,48,71,138,108,246,0.000333,0.504279,22,33282.43141,1849.023967,1512.837791,372.120125,9,6
0,0,30,30,21,50,71,136,107,243,0.000333,0.49813,20,29887.771,1660.431722,1494.38855,374.431475,8,6
0,0,11,11,11,22,33,42,33,75,0.000333,0.12611,5,1891.647795,105.091544,378.329559,136.161243,4,6
0,0,12,12,11,22,33,43,35,78,0.000333,0.131154,5,1967.313707,109.295206,393.462741,136.161243,4,6
0,0,13,13,13,19,32,55,48,103,0.000333,0.171667,12,6180,343.333333,515,128.816339,1,6
0,0,17,17,14,22,36,67,65,132,0.000333,0.227477,14,9554.021403,530.778967,682.4301,151.410465,2,6
0,0,9,9,13,16,29,38,31,69,0.000333,0.111734,6,2011.204132,111.733563,335.200689,112.105716,2,6
0,0,19,19,14,23,37,73,77,150,0.000333,0.260473,21,16409.7781,911.654339,781.418005,157.344894,2,6
0,0,9,9,13,16,29,38,31,69,0.000333,0.111734,6,2011.204132,111.733563,335.200689,112.105716,2,6
0,0,9,9,10,15,25,29,26,55,0.000333,0.085137,5,1277.060452,70.947803,255.41209,91.82264,2,6
0,0,11,11,13,16,29,38,31,69,0.000333,0.111734,6,2011.204132,111.733563,335.200689,112.105716,2,6
0,0,12,12,12,17,29,54,41,95,0.000333,0.153836,12,5538.098334,307.67213,461.508195,112.506418,1,6
0,0,9,9,10,16,26,43,33,76,0.000333,0.119078,10,3572.334186,198.46301,357.233419,97.219281,1,6
0,0,11,11,13,19,32,52,40,92,0.000333,0.153333,12,5520,306.666667,460,128.816339,2,6
0,0,11,11,10,17,27,49,39,88,0.000333,0.139477,10,4184.301002,232.461167,418.4301,102.706149,1,6
0,0,10,10,10,15,25,41,33,74,0.000333,0.114548,10,3436.45358,190.914088,343.645358,91.82264,1,6
0,0,15,15,14,21,35,61,47,108,0.000333,0.184654,14,7755.475922,430.859773,553.962566,145.541635,2,6
0,0,9,9,13,16,29,35,29,64,0.000333,0.103637,6,1865.464702,103.636928,310.910784,112.105716,2,6
0,0,12,12,11,18,29,45,44,89,0.000333,0.14412,10,4323.603086,240.200171,432.360309,113.112398,1,6
0,0,16,16,15,24,39,65,66,131,0.000333,0.230796,14,9693.427669,538.523759,692.387691,168.642459,2,6
0,0,10,10,11,16,27,41,32,73,0.000333,0.115702,10,3471.067877,192.837104,347.106788,102.053748,2,6
0,0,12,12,14,19,33,50,38,88,0.000333,0.147969,14,6214.693555,345.260753,443.906683,134.013592,2,6
0,0,12,12,13,18,31,47,41,88,0.000333,0.145323,12,5231.631304,290.646184,435.969275,123.164366,2,6
0,0,11,11,13,17,30,44,35,79,0.000333,0.129215,12,4651.732285,258.429571,387.644357,117.592585,2,6
0,0,9,9,10,15,25,38,31,69,0.000333,0.106809,10,3204.260771,178.014487,320.426077,91.82264,1,6
0,0,12,12,14,19,33,50,38,88,0.000333,0.147969,14,6214.693555,345.260753,443.906683,134.013592,2,6
0,0,4,4,12,11,23,22,20,42,0.000333,0.06333,6,1139.937613,63.329867,189.989602,81.073298,1,6
0,0,4,4,12,13,25,25,20,45,0.000333,0.069658,6,1253.841171,69.657843,208.973529,91.125266,1,6
0,0,17,17,14,19,33,78,60,138,0.000333,0.232042,21,14618.65416,812.147453,696.126388,134.013592,2,6
0,0,10,10,14,15,29,47,34,81,0.000333,0.131165,14,5508.950448,306.052803,393.496461,111.906328,2,6
0,0,9,9,13,17,30,33,29,62,0.000333,0.101409,6,1825.363302,101.409072,304.227217,117.592585,2,6
0,0,9,9,10,14,24,38,34,72,0.000333,0.110039,10,3301.173001,183.3985,330.1173,86.52225,1,6
0,0,12,12,14,15,29,42,36,78,0.000333,0.126308,14,5304.915247,294.717514,378.922518,111.906328,3,6
0,0,12,12,14,17,31,40,35,75,0.000333,0.123855,14,5201.906126,288.994785,371.564723,122.789837,2,6
0,0,9,9,10,14,24,38,34,72,0.000333,0.110039,10,3301.173001,183.3985,330.1173,86.52225,1,6
0,0,9,9,10,15,25,29,26,55,0.000333,0.085137,5,1277.060452,70.947803,255.41209,91.82264,2,6
0,0,11,11,13,16,29,38,31,69,0.000333,0.111734,6,2011.204132,111.733563,335.200689,112.105716,2,6
0,0,4,4,12,11,23,22,20,42,0.000333,0.06333,6,1139.937613,63.329867,189.989602,81.073298,1,6
0,0,12,12,11,15,26,39,39,78,0.000333,0.122211,10,3666.34298,203.685721,366.634298,96.657107,2,6
0,0,14,14,14,17,31,48,43,91,0.000333,0.150277,14,6311.646099,350.647006,450.831864,122.789837,2,6
0,0,12,12,11,19,30,46,43,89,0.000333,0.145571,10,4367.13263,242.618479,436.713263,118.764371,1,6
0,0,14,14,15,22,37,57,45,102,0.000333,0.177121,14,7439.099406,413.2833,531.364243,156.710855,2,6
0,0,12,12,12,16,28,49,39,88,0.000333,0.141016,12,5076.566798,282.031489,423.047233,107.01955,1,6
0,0,15,15,16,20,36,61,46,107,0.000333,0.184394,16,8850.911602,491.717311,553.181975,150.438562,2,6
0,0,16,16,14,19,33,66,49,115,0.000333,0.193368,14,8121.474532,451.19303,580.105324,134.013592,3,6
0,0,10,10,14,15,29,44,32,76,0.000333,0.123069,14,5168.891779,287.160654,369.206556,111.906328,2,6
0,0,13,13,14,19,33,52,39,91,0.000333,0.153013,14,6426.558108,357.031006,459.039865,134.013592,3,6
0,0,11,11,14,17,31,47,35,82,0.000333,0.135415,14,5687.417364,315.967631,406.244097,122.789837,2,6
0,0,10,10,12,18,30,31,29,60,0.000333,0.098138,6,1766.480614,98.137812,294.413436,118.0782,3,6
0,0,10,10,12,19,31,31,30,61,0.000333,0.100735,6,1813.23585,100.735325,302.205975,123.730173,3,6
0,0,10,10,12,18,30,31,29,60,0.000333,0.098138,6,1766.480614,98.137812,294.413436,118.0782,3,6
0,0,16,16,14,21,35,70,51,121,0.000333,0.206881,14,8689.005431,482.722524,620.643245,145.541635,2,6
0,0,10,10,14,16,30,44,33,77,0.000333,0.125944,14,5289.628062,293.868226,377.830576,117.302969,2,6
0,0,11,11,15,17,32,48,36,84,0.000333,0.14,14,5880,326.666667,420,128.090227,2,6
0,0,16,16,14,21,35,70,57,127,0.000333,0.21714,14,9119.865204,506.659178,651.418943,145.541635,2,6
0,0,10,10,14,16,30,47,35,82,0.000333,0.134122,14,5633.110404,312.950578,402.365029,117.302969,2,6
0,0,16,16,14,21,35,70,57,127,0.000333,0.21714,14,9119.865204,506.659178,651.418943,145.541635,2,6
0,0,10,10,14,16,30,47,35,82,0.000333,0.134122,14,5633.110404,312.950578,402.365029,117.302969,2,6
0,0,28,28,23,46,69,126,93,219,0.000333,0.445922,22,29430.87083,1635.04838,1337.766856,358.125775,11,6
0,0,28,28,21,48,69,124,92,216,0.000333,0.439814,10,13194.41283,733.022935,1319.441283,360.316866,10,6
0,0,25,25,19,47,66,112,84,196,0.000333,0.3949,9,10662.31123,592.350624,1184.701247,341.776299,9,6
0,0,24,24,19,47,66,111,82,193,0.000333,0.388856,9,10499.11259,583.284033,1166.568065,341.776299,9,6
0,0,13,13,11,18,29,53,55,108,0.000333,0.174887,15,7869.929212,437.21829,524.661947,113.112398,1,6
0,0,5,5,10,12,22,24,21,45,0.000333,0.066891,5,1003.372114,55.742895,200.674423,76.238831,1,6
0,0,15,15,11,19,30,59,67,126,0.000333,0.206089,15,9274.023226,515.223513,618.268215,118.764371,1,6
0,0,5,5,10,12,22,24,21,45,0.000333,0.066891,5,1003.372114,55.742895,200.674423,76.238831,1,6
0,0,5,5,11,9,20,25,18,43,0.000333,0.061948,10,1858.429081,103.24606,185.842908,66.583073,1,6
0,0,12,12,14,21,35,48,38,86,0.000333,0.147039,7,3087.828376,171.546021,441.118339,145.541635,3,6
0,0,8,8,12,16,28,40,28,68,0.000333,0.108967,6,1961.400808,108.966712,326.900135,107.01955,2,6
0,0,3,3,8,9,17,11,12,23,0.000333,0.031337,4,376.046581,20.891477,94.011645,52.529325,1,6
0,0,16,16,17,23,40,66,59,125,0.000333,0.221747,16,10643.85619,591.325344,665.241012,173.528793,3,6
0,0,18,18,19,24,43,74,56,130,0.000333,0.235138,18,12697.45953,705.414418,705.414418,190.749723,4,6
0,0,13,13,17,22,39,60,45,105,0.000333,0.184989,16,8879.475728,493.304207,554.967233,167.594364,3,6
0,0,12,12,14,22,36,54,40,94,0.000333,0.161991,7,3401.810651,188.989481,485.97295,151.410465,3,6
0,0,12,12,15,20,35,54,39,93,0.000333,0.159008,7,3339.163244,185.509069,477.023321,145.041921,3,6
0,0,9,9,9,15,24,34,30,64,0.000333,0.097813,8,2347.5008,130.416711,293.4376,87.132684,1,6
0,0,12,12,13,19,32,46,37,83,0.000333,0.138333,6,2490,138.333333,415,128.816339,2,6
0,0,12,12,13,19,32,49,48,97,0.000333,0.161667,12,5820,323.333333,485,128.816339,1,6
0,0,14,14,14,18,32,53,59,112,0.000333,0.186667,21,11760,653.333333,560,128.361619,1,6
0,0,9,9,12,15,27,26,25,51,0.000333,0.080833,6,1454.995576,80.833088,242.499263,101.622909,2,6
0,0,10,10,13,15,28,35,30,65,0.000333,0.104159,12,3749.736839,208.318713,312.47807,106.709075,4,6
0,0,10,10,13,17,30,33,29,62,0.000333,0.101409,6,1825.363302,101.409072,304.227217,117.592585,3,6
0,0,10,10,13,14,27,35,29,64,0.000333,0.101438,12,3651.753602,202.8752,304.3128,101.408685,4,6
0,0,10,10,13,16,29,33,28,61,0.000333,0.098779,6,1778.021044,98.778947,296.336841,112.105716,3,6
0,0,7,7,15,19,34,39,31,70,0.000333,0.118707,7,2492.856792,138.492044,356.122399,139.313982,2,6
0,0,12,12,13,21,34,41,38,79,0.000333,0.13397,6,2411.457387,133.969855,401.909564,140.344382,3,6
0,0,10,10,13,19,32,33,30,63,0.000333,0.105,6,1890,105,315,128.816339,3,6
0,0,12,12,13,21,34,41,39,80,0.000333,0.135666,6,2441.982164,135.665676,406.997027,140.344382,3,6
0,0,10,10,13,19,32,33,31,64,0.000333,0.106667,6,1920,106.666667,320,128.816339,3,6
0,0,10,10,13,16,29,40,31,71,0.000333,0.114972,6,2069.499904,114.972217,344.916651,112.105716,2,6
0,0,9,9,11,17,28,43,32,75,0.000333,0.120184,5,1802.758096,100.153228,360.551619,107.540616,2,6
0,0,12,12,12,17,29,53,48,101,0.000333,0.163552,12,5887.872966,327.104054,490.656081,112.506418,2,6
0,0,12,12,13,17,30,54,39,93,0.000333,0.152114,12,5476.089905,304.227217,456.340825,117.592585,2,6
0,0,13,13,14,22,36,61,53,114,0.000333,0.196457,14,8251.200302,458.400017,589.37145,151.410465,2,6
0,0,17,17,14,24,38,73,77,150,0.000333,0.262396,21,16530.97167,918.387315,787.189127,163.342069,2,6
0,0,10,10,10,15,25,41,37,78,0.000333,0.12074,10,3622.207828,201.233768,362.220783,91.82264,1,6
0,0,11,11,13,18,31,44,34,78,0.000333,0.128809,6,2318.563873,128.809104,386.427312,123.164366,2,6
0,0,19,19,16,20,36,75,59,134,0.000333,0.230923,16,11084.3192,615.795511,692.76995,150.438562,3,6
0,0,10,10,13,15,28,41,31,72,0.000333,0.115377,12,4153.554653,230.753036,346.129554,106.709075,2,6
0,0,14,14,13,18,31,52,42,94,0.000333,0.155231,12,5588.333438,310.462969,465.694453,123.164366,2,6
0,0,13,13,13,18,31,50,40,90,0.000333,0.148626,12,5350.532015,297.251779,445.877668,123.164366,2,6
0,0,9,9,12,15,27,26,25,51,0.000333,0.080833,6,1454.995576,80.833088,242.499263,101.622909,2,6
0,0,13,13,16,22,38,54,48,102,0.000333,0.17843,16,8564.617702,475.812095,535.288606,162.107496,3,6
0,0,13,13,16,22,38,54,47,101,0.000333,0.17668,16,8480.650862,471.14727,530.040679,162.107496,3,6
0,0,7,7,15,16,31,32,32,64,0.000333,0.10569,14,4438.959894,246.608883,317.068564,122.603359,1,6
0,0,10,10,13,18,31,46,34,80,0.000333,0.132112,6,2378.014229,132.111902,396.335705,123.164366,2,6
0,0,9,9,12,17,29,43,33,76,0.000333,0.123069,6,2215.239334,123.068852,369.206556,112.506418,1,6
0,0,13,13,13,19,32,40,40,80,0.000333,0.133333,12,4800,266.666667,400,128.816339,2,6
0,0,9,9,12,15,27,26,25,51,0.000333,0.080833,6,1454.995576,80.833088,242.499263,101.622909,2,6
0,0,18,18,17,24,41,72,66,138,0.000333,0.246447,16,11829.47483,657.193046,739.342177,179.525968,3,6
0,0,11,11,17,18,35,56,45,101,0.000333,0.172686,16,8288.921355,460.495631,518.057585,144.545518,3,6
0,0,10,10,14,21,35,40,36,76,0.000333,0.129942,7,2728.778565,151.598809,389.825509,145.541635,1,6
0,0,17,17,17,21,38,70,60,130,0.000333,0.22741,16,10915.68923,606.427179,682.230577,161.725534,3,6
0,0,11,11,17,18,35,56,45,101,0.000333,0.172686,16,8288.921355,460.495631,518.057585,144.545518,3,6
0,0,10,10,13,19,32,39,35,74,0.000333,0.123333,6,2220,123.333333,370,128.816339,1,6
0,0,17,17,17,21,38,70,66,136,0.000333,0.237906,24,17129.2354,951.624189,713.718142,161.725534,3,6
0,0,11,11,17,18,35,59,47,106,0.000333,0.181235,16,8699.263997,483.292444,543.704,144.545518,3,6
0,0,10,10,14,19,33,40,38,78,0.000333,0.131154,14,5508.478378,306.026577,393.462741,134.013592,2,6
0,0,11,11,12,18,30,35,34,69,0.000333,0.112858,6,2031.452707,112.858484,338.575451,118.0782,2,6
0,0,11,11,12,19,31,43,32,75,0.000333,0.123855,6,2229.38834,123.854908,371.564723,123.730173,2,6
0,0,13,13,13,19,32,54,41,95,0.000333,0.158333,12,5700,316.666667,475,128.816339,2,6
0,0,14,14,16,20,36,54,41,95,0.000333,0.163714,16,7858.286002,436.571445,491.142875,150.438562,6,6
0,0,14,14,15,22,37,52,40,92,0.000333,0.159757,7,3354.887967,186.382665,479.26971,156.710855,5,6
0,0,10,10,12,21,33,39,31,70,0.000333,0.117703,6,2118.64553,117.702529,353.107588,135.258216,4,6
0,0,11,11,12,21,33,40,33,73,0.000333,0.122747,6,2209.444624,122.746924,368.240771,135.258216,4,6
0,0,28,28,19,51,70,125,94,219,0.000333,0.447438,9,12080.81683,671.15649,1342.312981,370.004315,10,6
0,0,27,27,19,51,70,124,92,216,0.000333,0.441308,9,11915.32619,661.962566,1323.925132,370.004315,10,6
0,0,21,21,22,25,47,90,86,176,0.000333,0.325869,33,32261.05205,1792.280669,977.607638,214.2039,3,6
0,0,20,20,22,25,47,89,84,173,0.000333,0.320315,33,31711.14775,1761.730431,960.943871,214.2039,3,6
0,0,17,17,15,18,33,72,53,125,0.000333,0.210183,14,8827.689709,490.427206,630.549265,133.662009,2,6
0,0,10,10,14,15,29,44,32,76,0.000333,0.123069,14,5168.891779,287.160654,369.206556,111.906328,2,6
0,0,13,13,14,18,32,52,39,91,0.000333,0.151667,14,6370,353.888889,455,128.361619,2,6
0,0,12,12,14,18,32,50,37,87,0.000333,0.145,14,6090,338.333333,435,128.361619,2,6
0,0,17,17,14,21,35,72,58,130,0.000333,0.222269,14,9335.295091,518.627505,666.806792,145.541635,2,6
0,0,11,11,14,17,31,50,37,87,0.000333,0.143672,14,6034.211106,335.23395,431.015079,122.789837,2,6
0,0,14,14,12,20,32,59,53,112,0.000333,0.186667,12,6720,373.333333,560,129.458112,1,6
0,0,14,14,13,22,35,64,54,118,0.000333,0.201752,12,7263.064752,403.503597,605.255396,146.213212,1,6
0,0,17,17,14,19,33,75,60,135,0.000333,0.226998,21,14300.85733,794.492074,680.993206,134.013592,2,6
0,0,10,10,13,15,28,44,34,78,0.000333,0.124991,12,4499.684207,249.982456,374.973684,106.709075,2,6
0,0,11,11,14,16,30,45,35,80,0.000333,0.13085,14,5495.717467,305.317637,392.551248,117.302969,2,6
0,0,10,10,14,13,27,42,30,72,0.000333,0.114117,14,4792.926602,266.2737,342.3519,101.408685,2,6
0,0,11,11,13,19,32,48,35,83,0.000333,0.138333,6,2490,138.333333,415,128.816339,2,6
0,0,11,11,13,20,33,48,36,84,0.000333,0.141243,6,2542.374636,141.243035,423.729106,134.544278,2,6
0,0,13,13,15,22,37,56,51,107,0.000333,0.185804,14,7803.761142,433.542286,557.41151,156.710855,1,6
0,0,11,11,13,19,32,48,35,83,0.000333,0.138333,6,2490,138.333333,415,128.816339,2,6
0,0,10,10,12,18,30,45,34,79,0.000333,0.129215,6,2325.866142,129.214786,387.644357,118.0782,1,6
0,0,11,11,13,19,32,48,35,83,0.000333,0.138333,6,2490,138.333333,415,128.816339,2,6
0,0,12,12,15,21,36,51,38,89,0.000333,0.153374,7,3220.863276,178.936849,460.123325,150.842025,5,6
0,0,11,11,13,20,33,45,36,81,0.000333,0.136199,6,2451.575542,136.198641,408.595924,134.544278,4,6
0,0,11,11,13,20,33,45,36,81,0.000333,0.136199,6,2451.575542,136.198641,408.595924,134.544278,4,6
0,0,9,9,11,15,26,38,29,67,0.000333,0.104976,5,1574.647306,87.480406,314.929461,96.657107,2,6
0,0,9,9,11,15,26,38,28,66,0.000333,0.10341,5,1551.145107,86.174728,310.229021,96.657107,2,6
0,0,9,9,11,16,27,38,29,67,0.000333,0.106192,5,1592.887313,88.49374,318.577463,102.053748,2,6
0,0,3,3,9,8,17,10,12,22,0.000333,0.029975,4,359.69673,19.983152,89.924183,52.529325,1,6
0,0,8,8,10,14,24,35,27,62,0.000333,0.094756,5,1421.338375,78.963243,284.267675,86.52225,1,6
0,0,17,17,15,24,39,72,65,137,0.000333,0.241367,14,10137.40146,563.18897,724.100104,168.642459,2,6
0,0,7,7,13,14,27,31,29,60,0.000333,0.095098,12,3423.519002,190.1955,285.29325,101.408685,2,6
0,0,19,19,18,24,42,76,84,160,0.000333,0.28759,27,23294.81127,1294.156181,862.770788,185.09775,2,6
0,0,10,10,18,19,37,54,43,97,0.000333,0.168439,18,9095.705576,505.316976,505.316976,155.769273,2,6
0,0,17,17,18,23,41,70,72,142,0.000333,0.253591,27,20540.85439,1141.158577,760.772385,179.100575,2,6
0,0,10,10,18,19,37,54,43,97,0.000333,0.168439,18,9095.705576,505.316976,505.316976,155.769273,2,6
0,0,13,13,13,19,32,59,46,105,0.000333,0.175,12,6300,350,525,128.816339,2,6
0,0,13,13,13,19,32,62,47,109,0.000333,0.181667,12,6540,363.333333,545,128.816339,3,6
0,0,9,9,12,17,29,29,28,57,0.000333,0.092302,6,1661.4295,92.301639,276.904917,112.506418,2,6
0,0,9,9,12,17,29,29,28,57,0.000333,0.092302,6,1661.4295,92.301639,276.904917,112.506418,2,6
0,0,14,14,14,22,36,57,47,104,0.000333,0.179224,14,7527.410802,418.189489,537.6722,151.410465,3,6
0,0,14,14,13,21,34,49,40,89,0.000333,0.150928,6,2716.705157,150.928064,452.784193,140.344382,3,6
0,0,9,9,13,16,29,35,29,64,0.000333,0.103637,6,1865.464702,103.636928,310.910784,112.105716,2,6
0,0,11,11,12,19,31,35,30,65,0.000333,0.107341,6,1932.136561,107.34092,322.02276,123.730173,3,6
0,0,14,14,13,20,33,49,39,88,0.000333,0.147969,6,2663.440095,147.968894,443.906683,134.544278,3,6
0,0,9,9,13,16,29,35,29,64,0.000333,0.103637,6,1865.464702,103.636928,310.910784,112.105716,2,6
0,0,11,11,12,18,30,35,29,64,0.000333,0.10468,6,1884.245989,104.680333,314.040998,118.0782,3,6
0,0,14,14,13,20,33,49,39,88,0.000333,0.147969,6,2663.440095,147.968894,443.906683,134.544278,3,6
0,0,9,9,13,16,29,35,29,64,0.000333,0.103637,6,1865.464702,103.636928,310.910784,112.105716,2,6
0,0,11,11,12,18,30,35,29,64,0.000333,0.10468,6,1884.245989,104.680333,314.040998,118.0782,3,6
0,0,13,13,13,19,32,46,38,84,0.000333,0.14,12,5040,280,420,128.816339,2,6
0,0,9,9,13,16,29,35,29,64,0.000333,0.103637,6,1865.464702,103.636928,310.910784,112.105716,2,6
0,0,10,10,12,17,29,32,28,60,0.000333,0.09716,6,1748.873158,97.15962,291.47886,112.506418,2,6
0,0,14,14,13,20,33,48,38,86,0.000333,0.144606,6,2602.907366,144.605965,433.817894,134.544278,3,6
0,0,9,9,13,15,28,34,27,61,0.000333,0.09775,6,1759.491901,97.74955,293.24865,106.709075,2,6
0,0,11,11,12,17,29,34,28,62,0.000333,0.100398,6,1807.16893,100.398274,301.194822,112.506418,3,6
0,0,14,14,13,20,33,48,38,86,0.000333,0.144606,6,2602.907366,144.605965,433.817894,134.544278,3,6
0,0,9,9,13,15,28,34,27,61,0.000333,0.09775,6,1759.491901,97.74955,293.24865,106.709075,2,6
0,0,11,11,12,17,29,34,28,62,0.000333,0.100398,6,1807.16893,100.398274,301.194822,112.506418,3,6
0,0,14,14,13,19,32,48,37,85,0.000333,0.141667,6,2550,141.666667,425,128.816339,3,6
0,0,9,9,13,15,28,34,27,61,0.000333,0.09775,6,1759.491901,97.74955,293.24865,106.709075,2,6
0,0,11,11,12,16,28,34,27,61,0.000333,0.09775,6,1759.491901,97.74955,293.24865,107.01955,3,6
0,0,15,15,15,22,37,60,52,112,0.000333,0.194486,14,8168.422877,453.801271,583.458777,156.710855,2,6
0,0,15,15,14,22,36,57,58,115,0.000333,0.19818,14,8323.579252,462.42107,594.541375,151.410465,2,6
0,0,15,15,14,22,36,57,58,115,0.000333,0.19818,14,8323.579252,462.42107,594.541375,151.410465,2,6
0,0,8,8,11,14,25,35,25,60,0.000333,0.092877,5,1393.156857,77.397603,278.631371,91.356717,2,6
0,0,14,14,17,21,38,55,45,100,0.000333,0.174931,16,8396.684022,466.482446,524.792751,161.725534,4,6
0,0,14,14,16,23,39,53,44,97,0.000333,0.170895,8,4101.472122,227.859562,512.684015,168.041925,3,6
0,0,10,10,12,22,34,39,32,71,0.000333,0.120403,6,2167.25917,120.403287,361.209862,141.127046,3,6
0,0,11,11,12,22,34,40,34,74,0.000333,0.125491,6,2258.833502,125.49075,376.47225,141.127046,3,6
0,0,13,13,11,18,29,48,50,98,0.000333,0.158694,10,4760.821375,264.490076,476.082138,113.112398,1,6
0,0,14,14,14,24,38,68,53,121,0.000333,0.211666,14,8889.989208,493.888289,634.999229,163.342069,2,6
0,0,25,25,19,47,66,112,84,196,0.000333,0.3949,9,10662.31123,592.350624,1184.701247,341.776299,8,6
0,0,24,24,19,47,66,111,82,193,0.000333,0.388856,9,10499.11259,583.284033,1166.568065,341.776299,8,6
0,0,12,12,13,20,33,41,38,79,0.000333,0.132836,6,2391.042813,132.835712,398.507135,134.544278,3,6
0,0,10,10,13,18,31,33,30,63,0.000333,0.104038,6,1872.686205,104.038123,312.114368,123.164366,3,6
0,0,17,17,15,25,40,61,59,120,0.000333,0.212877,14,8940.839199,496.713289,638.631371,174.699764,2,6
0,0,16,16,18,21,39,58,62,120,0.000333,0.211416,18,11416.46879,634.248266,634.248266,167.297316,2,6
0,0,17,17,14,18,32,69,57,126,0.000333,0.21,21,13230,735,630,128.361619,2,6
0,0,10,10,14,15,29,47,34,81,0.000333,0.131165,14,5508.950448,306.052803,393.496461,111.906328,2,6
0,0,14,14,14,18,32,55,47,102,0.000333,0.17,14,7140,396.666667,510,128.361619,2,6
0,0,13,13,14,18,32,53,45,98,0.000333,0.163333,14,6860,381.111111,490,128.361619,2,6
0,0,15,15,19,25,44,72,54,126,0.000333,0.229296,18,12381.99091,687.888384,687.888384,196.807027,3,6
0,0,11,11,18,20,38,54,43,97,0.000333,0.169683,18,9162.881438,509.048969,509.048969,161.497212,2,6
0,0,14,14,14,20,34,64,45,109,0.000333,0.184844,14,7763.468296,431.303794,554.53345,139.741531,2,6
0,0,10,10,14,16,30,44,33,77,0.000333,0.125944,14,5289.628062,293.868226,377.830576,117.302969,2,6
0,0,15,15,14,22,36,67,47,114,0.000333,0.196457,14,8251.200302,458.400017,589.37145,151.410465,3,6
0,0,10,10,14,16,30,44,33,77,0.000333,0.125944,14,5289.628062,293.868226,377.830576,117.302969,2,6
0,0,21,21,14,20,34,81,77,158,0.000333,0.26794,21,16880.20171,937.788984,803.819129,139.741531,2,6
0,0,10,10,14,15,29,47,34,81,0.000333,0.131165,14,5508.950448,306.052803,393.496461,111.906328,2,6
0,0,10,10,11,18,29,37,34,71,0.000333,0.114972,5,1724.583253,95.810181,344.916651,113.112398,2,6
0,0,15,15,17,22,39,67,49,116,0.000333,0.204369,16,9809.706518,544.983695,613.106657,167.594364,4,6
0,0,14,14,13,20,33,43,41,84,0.000333,0.141243,12,5084.749272,282.486071,423.729106,134.544278,3,6
0,0,10,10,12,16,28,29,26,55,0.000333,0.088135,6,1586.427124,88.13484,264.404521,107.01955,3,6
0,0,11,11,14,19,33,39,38,77,0.000333,0.129473,14,5437.856861,302.103159,388.418347,134.013592,2,6
0,0,8,8,12,16,28,32,32,64,0.000333,0.102557,12,3692.04858,205.11381,307.670715,107.01955,2,6
0,0,12,12,12,18,30,47,45,92,0.000333,0.150478,12,5417.207218,300.955957,451.433935,118.0782,1,6
0,0,12,12,13,20,33,52,46,98,0.000333,0.164784,12,5932.207484,329.567082,494.350624,134.544278,1,6
0,0,11,11,13,21,34,48,42,90,0.000333,0.152624,12,5494.459869,305.24777,457.871656,140.344382,2,6
0,0,11,11,13,18,31,44,34,78,0.000333,0.128809,6,2318.563873,128.809104,386.427312,123.164366,2,6
0,0,11,11,17,22,39,50,41,91,0.000333,0.160324,8,3847.772815,213.765156,480.971602,167.594364,3,6
0,0,13,13,15,19,34,49,37,86,0.000333,0.145841,7,3062.65263,170.147368,437.521804,139.313982,2,6
0,0,17,17,14,23,37,64,74,138,0.000333,0.239635,21,15096.99585,838.721992,718.904564,157.344894,2,6
0,0,13,13,13,19,32,46,61,107,0.000333,0.178333,18,9630,535,535,128.816339,2,6
0,0,7,7,13,13,26,30,26,56,0.000333,0.087742,12,3158.695491,175.483083,263.224624,96.211433,3,6
0,0,7,7,12,15,27,28,25,53,0.000333,0.084003,6,1512.054226,84.003013,252.009038,101.622909,2,6
0,0,15,15,14,23,37,59,49,108,0.000333,0.18754,14,7876.693489,437.594083,562.620963,157.344894,3,6
0,0,15,15,14,23,37,59,49,108,0.000333,0.18754,14,7876.693489,437.594083,562.620963,157.344894,3,6
0,0,17,17,15,23,38,63,51,114,0.000333,0.199421,14,8375.692311,465.31624,598.263737,162.645284,3,6
0,0,16,16,18,25,43,78,59,137,0.000333,0.247799,18,13381.16889,743.398271,743.398271,191.155055,3,6
0,0,13,13,18,22,40,63,50,113,0.000333,0.200459,18,10824.80175,601.377875,601.377875,173.166146,3,6
0,0,3,3,7,12,19,9,14,23,0.000333,0.032567,3,293.106998,16.283722,97.702333,62.671034,2,6
0,0,11,11,14,18,32,49,38,87,0.000333,0.145,14,6090,338.333333,435,128.361619,2,6
0,0,15,15,14,23,37,55,48,103,0.000333,0.178858,14,7512.031753,417.335097,536.573697,157.344894,3,6
0,0,17,17,15,24,39,79,52,131,0.000333,0.230796,14,9693.427669,538.523759,692.387691,168.642459,6,6
0,0,15,15,14,20,34,59,41,100,0.000333,0.169582,14,7122.447978,395.691554,508.746284,139.741531,3,6
0,0,10,10,13,16,29,37,29,66,0.000333,0.106876,6,1923.760474,106.875582,320.626746,112.105716,2,6
0,0,17,17,15,24,39,79,52,131,0.000333,0.230796,14,9693.427669,538.523759,692.387691,168.642459,6,6
0,0,10,10,14,17,31,34,33,67,0.000333,0.110644,7,2323.51807,129.084337,331.931153,122.789837,2,6
0,0,5,5,5,9,14,9,15,24,0.000333,0.030459,2,182.753036,10.152946,91.376518,40.138965,1,6
0,0,15,15,13,20,33,46,50,96,0.000333,0.161421,12,5811.142026,322.841224,484.261835,134.544278,2,6
0,0,11,11,12,16,28,32,35,67,0.000333,0.107364,12,3865.113357,214.72852,322.09278,107.01955,2,6
0,0,11,11,17,20,37,46,42,88,0.000333,0.152811,16,7334.910339,407.495019,458.431896,155.92543,3,6
0,0,11,11,13,18,31,44,34,78,0.000333,0.128809,6,2318.563873,128.809104,386.427312,123.164366,2,6
0,0,13,13,15,16,31,50,47,97,0.000333,0.160186,14,6727.79859,373.766588,480.557042,122.603359,3,6
0,0,13,13,15,18,33,48,46,94,0.000333,0.158058,14,6638.422661,368.801259,474.173047,133.662009,2,6
0,0,8,8,13,14,27,31,27,58,0.000333,0.091928,6,1654.700851,91.927825,275.783475,101.408685,3,6
0,0,8,8,13,16,29,29,26,55,0.000333,0.089063,6,1603.133728,89.062985,267.188955,112.105716,2,6
0,0,11,11,13,14,27,37,40,77,0.000333,0.122042,12,4393.516052,244.084225,366.126338,101.408685,3,6
0,0,11,11,13,16,29,35,39,74,0.000333,0.11983,12,4313.887124,239.660396,359.490594,112.105716,2,6
0,0,15,15,13,16,29,47,64,111,0.000333,0.179745,24,12941.66137,718.981187,539.23589,112.105716,3,6
0,0,15,15,13,18,31,45,63,108,0.000333,0.178351,18,9630.957627,535.053202,535.053202,123.164366,2,6
0,0,7,7,13,10,23,31,23,54,0.000333,0.081424,12,2931.268148,162.84823,244.272346,81.324997,3,6
0,0,7,7,13,12,25,29,22,51,0.000333,0.078946,6,1421.019994,78.945555,236.836666,91.125266,2,6
0,0,12,12,14,14,28,40,42,82,0.000333,0.131401,21,8278.265176,459.903621,394.203104,106.605938,3,6
0,0,12,12,14,16,30,38,41,79,0.000333,0.129215,14,5427.020999,301.501167,387.644357,117.302969,2,6
0,0,13,13,15,17,32,43,44,87,0.000333,0.145,14,6090,338.333333,435,128.090227,3,6
0,0,13,13,15,19,34,41,43,84,0.000333,0.142449,14,5982.856301,332.380906,427.346879,139.313982,2,6
0,0,4,4,9,12,21,16,19,35,0.000333,0.051244,4,614.924439,34.162469,153.73111,71.548875,1,6
0,0,12,12,12,19,31,50,54,104,0.000333,0.171745,12,6182.836995,343.490944,515.236416,123.730173,1,6
0,0,12,12,11,19,30,58,49,107,0.000333,0.175012,10,5250.372937,291.687385,525.037294,118.764371,1,6
0,0,6,6,12,14,26,30,25,55,0.000333,0.086175,6,1551.145107,86.174728,258.524184,96.322519,1,6
0,0,6,6,12,15,27,30,26,56,0.000333,0.088758,6,1597.642201,88.7579,266.2737,101.622909,1,6
0,0,12,12,12,17,29,48,61,109,0.000333,0.176507,18,9531.358712,529.519928,529.519928,112.506418,1,6
0,0,12,12,12,18,30,48,68,116,0.000333,0.189733,18,10245.58756,569.199309,569.199309,118.0782,1,6
0,0,14,14,17,22,39,64,48,112,0.000333,0.197322,16,9471.440776,526.191154,591.965049,167.594364,3,6
0,0,16,16,16,21,37,70,52,122,0.000333,0.211851,16,10168.85297,564.936276,635.553311,156.238666,3,6
0,0,16,16,15,21,36,69,61,130,0.000333,0.22403,14,9409.263503,522.736861,672.09025,150.842025,3,6
0,0,8,8,15,17,32,30,28,58,0.000333,0.096667,7,2030,112.777778,290,128.090227,2,6
0,0,13,13,16,21,37,47,47,94,0.000333,0.16323,16,7835.017862,435.27877,489.688616,156.238666,3,6
0,0,11,11,13,17,30,40,34,74,0.000333,0.121037,12,4357.318849,242.073269,363.109904,117.592585,2,6
0,0,10,10,13,16,29,37,29,66,0.000333,0.106876,6,1923.760474,106.875582,320.626746,112.105716,2,6
0,0,11,11,15,21,36,43,43,86,0.000333,0.148205,14,6224.589702,345.810539,444.61355,150.842025,2,6
0,0,10,10,13,21,34,37,38,75,0.000333,0.127187,6,2289.358279,127.186571,381.559713,140.344382,2,6
0,0,14,14,14,23,37,51,47,98,0.000333,0.170175,14,7147.370018,397.076112,510.52643,157.344894,2,6
0,0,11,11,12,21,33,40,36,76,0.000333,0.127791,6,2300.243718,127.791318,383.373953,135.258216,2,6
0,0,11,11,12,22,34,40,36,76,0.000333,0.128882,6,2319.883056,128.882392,386.647176,141.127046,2,6
0,0,10,10,13,19,32,37,37,74,0.000333,0.123333,6,2220,123.333333,370,128.816339,2,6
0,0,9,9,11,19,30,31,32,63,0.000333,0.103045,5,1545.670538,85.870585,309.134108,118.764371,2,6
0,0,14,14,19,22,41,61,49,110,0.000333,0.196444,18,10607.95297,589.330721,589.330721,178.818118,3,6
0,0,10,10,18,19,37,51,41,92,0.000333,0.159757,18,8626.854773,479.26971,479.26971,155.769273,2,6
0,0,9,9,15,20,35,39,31,70,0.000333,0.119683,7,2513.348678,139.630482,359.049811,145.041921,2,6
0,0,10,10,13,20,33,37,38,75,0.000333,0.12611,6,2269.977354,126.109853,378.329559,134.544278,2,6
0,0,9,9,11,20,31,31,33,64,0.000333,0.10569,5,1585.342819,88.074601,317.068564,124.49231,2,6
0,0,12,12,12,19,31,38,44,82,0.000333,0.135415,12,4874.929169,270.829398,406.244097,123.730173,1,6
0,0,14,14,16,20,36,60,46,106,0.000333,0.182671,16,8768.192802,487.121822,548.01205,150.438562,2,6
0,0,14,14,15,20,35,57,46,103,0.000333,0.176105,14,7396.42611,410.912562,528.316151,145.041921,2,6
0,0,10,10,15,16,31,49,35,84,0.000333,0.138717,14,5826.134861,323.674159,416.15249,122.603359,2,6
0,0,12,12,15,19,34,50,40,90,0.000333,0.152624,14,6410.20318,356.122399,457.871656,139.313982,2,6
0,0,16,16,14,19,33,66,49,115,0.000333,0.193368,14,8121.474532,451.19303,580.105324,134.013592,3,6
0,0,10,10,14,15,29,44,32,76,0.000333,0.123069,14,5168.891779,287.160654,369.206556,111.906328,2,6
0,0,13,13,14,19,33,52,39,91,0.000333,0.153013,14,6426.558108,357.031006,459.039865,134.013592,3,6
0,0,11,11,14,17,31,47,35,82,0.000333,0.135415,14,5687.417364,315.967631,406.244097,122.789837,2,6
0,0,15,15,13,19,32,56,44,100,0.000333,0.166667,12,6000,333.333333,500,128.816339,3,6
0,0,9,9,13,15,28,34,27,61,0.000333,0.09775,6,1759.491901,97.74955,293.24865,106.709075,2,6
0,0,12,12,13,19,32,42,34,76,0.000333,0.126667,6,2280,126.666667,380,128.816339,3,6
0,0,10,10,13,17,30,37,30,67,0.000333,0.109587,6,1972.570019,109.587223,328.76167,117.592585,2,6
0,0,15,15,13,18,31,56,44,100,0.000333,0.16514,12,5945.035572,330.279754,495.419631,123.164366,3,6
0,0,9,9,13,15,28,34,27,61,0.000333,0.09775,6,1759.491901,97.74955,293.24865,106.709075,2,6
0,0,12,12,13,18,31,42,34,76,0.000333,0.125506,6,2259.113518,125.506307,376.51892,123.164366,3,6
0,0,10,10,13,17,30,37,30,67,0.000333,0.109587,6,1972.570019,109.587223,328.76167,117.592585,2,6
0,0,13,13,16,21,37,54,42,96,0.000333,0.166703,16,8001.72037,444.540021,500.107523,156.238666,3,6
0,0,8,8,14,15,29,31,25,56,0.000333,0.090682,7,1904.32855,105.796031,272.046936,111.906328,2,6
0,0,17,17,17,24,41,60,66,126,0.000333,0.225017,16,10800.82484,600.045825,675.051553,179.525968,4,6
0,0,17,17,15,26,41,58,65,123,0.000333,0.21966,14,9225.704552,512.539142,658.978897,180.814792,3,6
0,0,7,7,13,13,26,30,26,56,0.000333,0.087742,12,3158.695491,175.483083,263.224624,96.211433,3,6
0,0,7,7,12,15,27,28,25,53,0.000333,0.084003,6,1512.054226,84.003013,252.009038,101.622909,2,6
0,0,15,15,15,23,38,79,49,128,0.000333,0.223912,14,9404.286104,522.460339,671.734722,162.645284,3,6
0,0,15,15,20,24,44,58,56,114,0.000333,0.207458,20,12447.50409,691.528005,622.375205,196.477662,4,6
0,0,15,15,18,26,44,56,55,111,0.000333,0.201999,18,10907.94437,605.99691,605.99691,197.270083,3,6
0,0,11,11,12,16,28,42,31,73,0.000333,0.116979,6,2105.621456,116.97897,350.936909,107.01955,2,6
0,0,12,12,13,20,33,59,39,98,0.000333,0.164784,6,2966.103742,164.783541,494.350624,134.544278,2,6
0,0,11,11,13,19,32,56,41,97,0.000333,0.161667,12,5820,323.333333,485,128.816339,2,6
0,0,9,9,10,16,26,47,34,81,0.000333,0.126912,10,3807.356172,211.519787,380.735617,97.219281,1,6
0,0,11,11,15,19,34,40,35,75,0.000333,0.127187,7,2670.917992,148.384333,381.559713,139.313982,3,6
0,0,11,11,15,19,34,40,35,75,0.000333,0.127187,7,2670.917992,148.384333,381.559713,139.313982,3,6
0,0,14,14,19,23,42,61,50,111,0.000333,0.199516,18,10773.85021,598.547234,598.547234,184.752548,3,6
0,0,10,10,18,19,37,51,41,92,0.000333,0.159757,18,8626.854773,479.26971,479.26971,155.769273,2,6
0,0,9,9,15,21,36,39,32,71,0.000333,0.122355,7,2569.452726,142.747374,367.064675,150.842025,2,6
0,0,14,14,19,22,41,61,49,110,0.000333,0.196444,18,10607.95297,589.330721,589.330721,178.818118,3,6
0,0,10,10,18,19,37,51,41,92,0.000333,0.159757,18,8626.854773,479.26971,479.26971,155.769273,2,6
0,0,9,9,15,20,35,39,31,70,0.000333,0.119683,7,2513.348678,139.630482,359.049811,145.041921,2,6
0,0,16,16,20,25,45,69,65,134,0.000333,0.245303,20,14718.1663,817.675905,735.908315,202.534967,2,6
0,0,10,10,16,18,34,43,37,80,0.000333,0.135666,16,6511.952437,361.775135,406.997027,139.05865,2,6
0,0,9,9,13,17,30,33,29,62,0.000333,0.101409,6,1825.363302,101.409072,304.227217,117.592585,2,6
0,0,14,14,13,21,34,49,40,89,0.000333,0.150928,6,2716.705157,150.928064,452.784193,140.344382,3,6
0,0,9,9,13,16,29,35,29,64,0.000333,0.103637,6,1865.464702,103.636928,310.910784,112.105716,2,6
0,0,11,11,12,19,31,35,30,65,0.000333,0.107341,6,1932.136561,107.34092,322.02276,123.730173,3,6
0,0,14,14,13,20,33,49,39,88,0.000333,0.147969,6,2663.440095,147.968894,443.906683,134.544278,3,6
0,0,9,9,13,16,29,35,29,64,0.000333,0.103637,6,1865.464702,103.636928,310.910784,112.105716,2,6
0,0,11,11,12,18,30,35,29,64,0.000333,0.10468,6,1884.245989,104.680333,314.040998,118.0782,3,6
0,0,17,17,17,23,40,66,59,125,0.000333,0.221747,16,10643.85619,591.325344,665.241012,173.528793,2,6
0,0,13,13,13,19,32,46,38,84,0.000333,0.14,12,5040,280,420,128.816339,2,6
0,0,9,9,13,16,29,35,29,64,0.000333,0.103637,6,1865.464702,103.636928,310.910784,112.105716,2,6
0,0,10,10,12,17,29,32,28,60,0.000333,0.09716,6,1748.873158,97.15962,291.47886,112.506418,2,6
0,0,14,14,13,21,34,49,40,89,0.000333,0.150928,6,2716.705157,150.928064,452.784193,140.344382,3,6
0,0,9,9,13,16,29,35,29,64,0.000333,0.103637,6,1865.464702,103.636928,310.910784,112.105716,2,6
0,0,11,11,12,19,31,35,30,65,0.000333,0.107341,6,1932.136561,107.34092,322.02276,123.730173,3,6
0,0,17,17,14,22,36,67,57,124,0.000333,0.21369,14,8974.989803,498.610545,641.0707,151.410465,2,6
0,0,9,9,13,17,30,38,31,69,0.000333,0.112858,6,2031.452707,112.858484,338.575451,117.592585,2,6
0,0,7,7,14,12,26,30,27,57,0.000333,0.089308,14,3750.950895,208.386161,267.925064,96.322519,3,6
0,0,7,7,14,15,29,28,26,54,0.000333,0.087444,7,1836.316816,102.017601,262.330974,111.906328,2,6
0,0,8,8,13,16,29,34,28,62,0.000333,0.100398,6,1807.16893,100.398274,301.194822,112.105716,1,6
0,0,13,13,16,20,36,54,41,95,0.000333,0.163714,16,7858.286002,436.571445,491.142875,150.438562,3,6
0,0,17,17,16,21,37,64,57,121,0.000333,0.210115,16,10085.50172,560.305651,630.343857,156.238666,2,6
0,0,5,5,9,13,22,19,22,41,0.000333,0.060946,4,731.346785,40.630377,182.836696,76.635041,1,6
0,0,4,4,11,13,24,21,19,40,0.000333,0.061133,5,916.9925,50.944028,183.3985,86.159464,1,6
0,0,14,14,13,18,31,49,58,107,0.000333,0.1767,18,9541.782094,530.099005,530.099005,123.164366,1,6
0,0,5,5,10,13,23,23,23,46,0.000333,0.069361,5,1040.41925,57.801069,208.08385,81.324997,1,6
0,0,12,12,15,20,35,60,40,100,0.000333,0.170976,14,7180.996224,398.944235,512.928302,145.041921,3,6
0,0,12,12,14,21,35,60,40,100,0.000333,0.170976,7,3590.498112,199.472117,512.928302,145.541635,3,6
0,0,13,13,17,22,39,66,46,112,0.000333,0.197322,16,9471.440776,526.191154,591.965049,167.594364,3,6
0,0,19,19,18,22,40,81,58,139,0.000333,0.246583,18,13315.46409,739.748005,739.748005,173.166146,3,6
0,0,11,11,13,17,30,44,34,78,0.000333,0.127579,12,4592.849597,255.158311,382.737466,117.592585,2,6
0,0,17,17,17,21,38,72,52,124,0.000333,0.216914,16,10411.88819,578.438233,650.743012,161.725534,3,6
0,0,11,11,13,17,30,44,34,78,0.000333,0.127579,12,4592.849597,255.158311,382.737466,117.592585,2,6
0,0,15,15,14,21,35,54,59,113,0.000333,0.193203,14,8114.525733,450.806985,579.608981,145.541635,2,6
0,0,15,15,15,22,37,59,48,107,0.000333,0.185804,14,7803.761142,433.542286,557.41151,156.710855,3,6
0,0,15,15,15,21,36,59,48,107,0.000333,0.184394,14,7744.547652,430.252647,553.181975,150.842025,3,6
0,0,14,14,14,21,35,56,47,103,0.000333,0.176105,14,7396.42611,410.912562,528.316151,145.541635,2,6
0,0,18,18,17,21,38,81,57,138,0.000333,0.241405,16,11587.42395,643.745775,724.213997,161.725534,4,6
0,0,10,10,13,15,28,41,31,72,0.000333,0.115377,12,4153.554653,230.753036,346.129554,106.709075,2,6
0,0,12,12,14,20,34,56,42,98,0.000333,0.16619,14,6979.999018,387.777723,498.571358,139.741531,3,6
0,0,28,28,22,46,68,127,95,222,0.000333,0.450472,22,29731.16852,1651.731584,1351.416751,352.191346,9,6
0,0,28,28,21,48,69,125,94,219,0.000333,0.445922,10,13377.66856,743.203809,1337.766856,360.316866,8,6
0,0,25,25,19,48,67,112,84,196,0.000333,0.396318,9,10700.58133,594.476741,1188.953481,348.788823,8,6
0,0,24,24,19,48,67,111,82,193,0.000333,0.390252,9,10536.79692,585.377607,1170.755214,348.788823,8,6
0,0,28,28,23,46,69,126,95,221,0.000333,0.449995,22,29699.64591,1649.980328,1349.983905,358.125775,9,6
0,0,28,28,22,48,70,124,94,218,0.000333,0.445395,11,14698.02068,816.556704,1336.183698,366.185696,8,6
0,0,26,26,20,48,68,115,88,203,0.000333,0.411918,10,12357.54957,686.530532,1235.754957,354.516762,8,6
0,0,25,25,20,48,68,114,86,200,0.000333,0.405831,10,12174.92568,676.38476,1217.492568,354.516762,8,6
0,0,9,9,13,17,30,33,29,62,0.000333,0.101409,6,1825.363302,101.409072,304.227217,117.592585,2,6
0,0,9,9,13,17,30,33,29,62,0.000333,0.101409,6,1825.363302,101.409072,304.227217,117.592585,2,6
0,0,4,4,10,11,21,18,19,37,0.000333,0.054172,5,812.578723,45.143262,162.515745,71.273029,1,6
0,0,9,9,13,17,30,33,29,62,0.000333,0.101409,6,1825.363302,101.409072,304.227217,117.592585,2,6
0,0,19,19,18,26,44,70,65,135,0.000333,0.245674,18,13266.41883,737.023269,737.023269,197.270083,3,6
0,0,10,10,13,17,30,37,31,68,0.000333,0.111223,6,2002.011363,111.222854,333.668561,117.592585,2,6
0,0,9,9,11,17,28,31,27,58,0.000333,0.092942,5,1394.132927,77.451829,278.826585,107.540616,2,6
0,0,10,10,13,18,31,37,32,69,0.000333,0.113947,6,2051.037273,113.946515,341.839545,123.164366,2,6
0,0,9,9,11,18,29,31,28,59,0.000333,0.09554,5,1433.104394,79.616911,286.620879,113.112398,2,6
0,0,10,10,13,17,30,44,29,73,0.000333,0.119401,6,2149.218081,119.401004,358.203013,117.592585,2,6
0,0,13,13,12,17,29,51,49,100,0.000333,0.161933,12,5829.577194,323.8654,485.7981,112.506418,2,6
0,0,15,15,15,20,35,60,52,112,0.000333,0.191493,14,8042.715771,446.817543,574.479698,145.041921,2,6
0,0,10,10,11,15,26,41,32,73,0.000333,0.114377,10,3431.320994,190.628944,343.132099,96.657107,2,6
0,0,12,12,14,19,33,50,38,88,0.000333,0.147969,14,6214.693555,345.260753,443.906683,134.013592,2,6
0,0,7,7,12,17,29,30,35,65,0.000333,0.105256,12,3789.225176,210.51251,315.768765,112.506418,1,6
0,0,6,6,12,14,26,30,25,55,0.000333,0.086175,6,1551.145107,86.174728,258.524184,96.322519,1,6
0,0,6,6,12,15,27,30,26,56,0.000333,0.088758,6,1597.642201,88.7579,266.2737,101.622909,1,6
0,0,9,9,13,16,29,41,31,72,0.000333,0.116592,6,2098.64779,116.591544,349.774632,112.105716,2,6
0,0,10,10,11,17,28,50,35,85,0.000333,0.136208,10,4086.251684,227.013982,408.625168,107.540616,2,6
0,0,12,12,14,20,34,47,39,86,0.000333,0.145841,7,3062.65263,170.147368,437.521804,139.741531,3,6
0,0,10,10,14,18,32,39,31,70,0.000333,0.116667,7,2450,136.111111,350,128.361619,3,6
0,0,10,10,11,16,27,50,35,85,0.000333,0.134722,10,4041.654377,224.536354,404.165438,102.053748,2,6
0,0,10,10,16,15,31,39,30,69,0.000333,0.113947,16,5469.432727,303.857374,341.839545,122.603359,2,6
0,0,13,13,10,19,29,52,49,101,0.000333,0.163552,10,4906.560805,272.586711,490.656081,113.929904,1,6
0,0,15,15,16,23,39,56,47,103,0.000333,0.181465,16,8710.342857,483.907936,544.396429,168.041925,4,6
0,0,11,11,12,18,30,36,30,66,0.000333,0.107952,6,1943.128676,107.951593,323.854779,118.0782,3,6
0,0,15,15,16,22,38,56,46,102,0.000333,0.17843,16,8564.617702,475.812095,535.288606,162.107496,4,6
0,0,11,11,12,17,29,36,29,65,0.000333,0.105256,6,1894.612588,105.256255,315.768765,112.506418,3,6
0,0,15,15,16,22,38,56,46,102,0.000333,0.17843,16,8564.617702,475.812095,535.288606,162.107496,4,6
0,0,11,11,12,17,29,36,29,65,0.000333,0.105256,6,1894.612588,105.256255,315.768765,112.506418,3,6
0,0,13,13,15,16,31,45,45,90,0.000333,0.148626,14,6242.287351,346.793742,445.877668,122.603359,3,6
0,0,13,13,15,18,33,43,44,87,0.000333,0.146287,14,6144.072037,341.337335,438.862288,133.662009,2,6
0,0,13,13,14,22,36,61,53,114,0.000333,0.196457,14,8251.200302,458.400017,589.37145,151.410465,2,6
0,0,8,8,12,15,27,34,31,65,0.000333,0.103023,12,3708.812252,206.045125,309.067688,101.622909,2,6
0,0,14,14,13,16,29,45,54,99,0.000333,0.160313,18,8656.922133,480.940119,480.940119,112.105716,3,6
0,0,14,14,13,18,31,43,53,96,0.000333,0.158534,12,5707.23415,317.068564,475.602846,123.164366,2,6
0,0,9,9,17,18,35,41,37,78,0.000333,0.133361,16,6401.345205,355.630289,400.084075,144.545518,2,6
0,0,12,12,14,20,34,56,39,95,0.000333,0.161103,7,3383.162789,187.953488,483.30897,139.741531,3,6
0,0,14,14,16,21,37,61,42,103,0.000333,0.178858,16,8585.179147,476.954397,536.573697,156.238666,3,6
0,0,12,12,14,20,34,56,39,95,0.000333,0.161103,7,3383.162789,187.953488,483.30897,139.741531,3,6
0,0,19,19,17,27,44,80,70,150,0.000333,0.272972,16,13102.63589,727.924216,818.914743,197.868831,3,6
0,0,11,11,17,23,40,49,42,91,0.000333,0.161432,8,3874.363653,215.242425,484.295457,173.528793,3,6
0,0,20,20,17,25,42,90,60,150,0.000333,0.269616,16,12941.56182,718.975656,808.847613,185.583273,6,6
0,0,19,19,15,25,40,85,64,149,0.000333,0.264322,14,11101.54201,616.752334,792.967286,174.699764,6,6
0,0,19,19,16,27,43,86,59,145,0.000333,0.262269,16,12588.93423,699.385235,786.808389,192.381963,6,6
0,0,14,14,15,20,35,57,40,97,0.000333,0.165847,14,6965.566337,386.975908,497.540453,145.041921,3,6
0,0,9,9,13,15,28,34,27,61,0.000333,0.09775,6,1759.491901,97.74955,293.24865,106.709075,2,6
0,0,19,19,13,23,36,73,64,137,0.000333,0.236093,12,8499.356702,472.186483,708.279725,152.147641,2,6
0,0,10,10,13,17,30,46,35,81,0.000333,0.132486,12,4769.497659,264.972092,397.458138,117.592585,2,6
0,0,11,11,12,17,29,37,39,76,0.000333,0.123069,12,4430.478668,246.137704,369.206556,112.506418,1,6
0,0,11,11,9,16,25,40,42,82,0.000333,0.126932,8,3046.36966,169.242759,380.796208,92.529325,1,6
0,0,14,14,13,20,33,52,49,101,0.000333,0.169828,12,6113.805673,339.655871,509.483806,134.544278,2,6
0,0,11,11,12,23,35,42,34,76,0.000333,0.129942,6,2338.953056,129.941836,389.825509,147.061475,3,6
0,0,12,12,12,23,35,43,36,79,0.000333,0.135071,6,2431.28015,135.071119,405.213358,147.061475,3,6
0,0,14,14,14,20,34,57,40,97,0.000333,0.164495,14,6908.774538,383.820808,493.483896,139.741531,3,6
0,0,9,9,13,15,28,34,27,61,0.000333,0.09775,6,1759.491901,97.74955,293.24865,106.709075,2,6
0,0,16,16,14,18,32,62,48,110,0.000333,0.183333,14,7700,427.777778,550,128.361619,2,6
0,0,9,9,13,15,28,34,27,61,0.000333,0.09775,6,1759.491901,97.74955,293.24865,106.709075,2,6
0,0,12,12,13,18,31,42,34,76,0.000333,0.125506,6,2259.113518,125.506307,376.51892,123.164366,2,6
0,0,11,11,13,18,31,40,32,72,0.000333,0.118901,6,2140.212806,118.900711,356.702134,123.164366,2,6
0,0,16,16,13,18,31,59,52,111,0.000333,0.183305,12,6598.989485,366.610527,549.91579,123.164366,2,6
0,0,9,9,13,15,28,37,29,66,0.000333,0.105762,6,1903.712549,105.761808,317.285425,106.709075,2,6
0,0,13,13,13,18,31,45,42,87,0.000333,0.143672,12,5172.180948,287.343386,431.015079,123.164366,2,6
0,0,12,12,13,18,31,43,40,83,0.000333,0.137066,12,4934.379525,274.132196,411.198294,123.164366,2,6
0,0,10,10,14,16,30,38,30,68,0.000333,0.111223,7,2335.679924,129.759996,333.668561,117.302969,2,6
0,0,16,16,13,18,31,59,52,111,0.000333,0.183305,12,6598.989485,366.610527,549.91579,123.164366,2,6
0,0,9,9,13,15,28,37,29,66,0.000333,0.105762,6,1903.712549,105.761808,317.285425,106.709075,2,6
0,0,20,20,13,20,33,71,72,143,0.000333,0.240449,18,12984.27046,721.348359,721.348359,134.544278,2,6
0,0,9,9,13,15,28,37,29,66,0.000333,0.105762,6,1903.712549,105.761808,317.285425,106.709075,2,6
0,0,16,16,13,17,30,50,66,116,0.000333,0.189733,18,10245.58756,569.199309,569.199309,117.592585,3,6
0,0,16,16,13,19,32,48,65,113,0.000333,0.188333,18,10170,565,565,128.816339,2,6
0,0,12,12,15,23,38,54,48,102,0.000333,0.17843,14,7494.040489,416.335583,535.288606,162.645284,2,6
0,0,17,17,14,21,35,66,59,125,0.000333,0.21372,14,8976.24528,498.680293,641.160377,145.541635,2,6
0,0,9,9,13,15,28,37,29,66,0.000333,0.105762,6,1903.712549,105.761808,317.285425,106.709075,2,6
0,0,18,18,14,23,37,68,71,139,0.000333,0.241371,21,15206.39437,844.799687,724.114018,157.344894,2,6
0,0,18,18,15,23,38,67,62,129,0.000333,0.225661,14,9477.757089,526.542061,676.982649,162.645284,2,6
0,0,9,9,13,17,30,36,31,67,0.000333,0.109587,6,1972.570019,109.587223,328.76167,117.592585,2,6
0,0,8,8,12,16,28,33,31,64,0.000333,0.102557,6,1846.02429,102.556905,307.670715,107.01955,1,6
0,0,14,14,13,21,34,66,53,119,0.000333,0.201803,12,7264.896937,403.605385,605.408078,140.344382,1,6
0,0,11,11,14,16,30,47,37,84,0.000333,0.137393,14,5770.50334,320.583519,412.17881,117.302969,2,6
0,0,10,10,14,15,29,44,32,76,0.000333,0.123069,14,5168.891779,287.160654,369.206556,111.906328,2,6
0,0,11,11,12,17,29,50,44,94,0.000333,0.152217,12,5479.802563,304.433476,456.650214,112.506418,1,6
0,0,12,12,15,18,33,47,38,85,0.000333,0.142925,14,6002.829002,333.4905,428.7735,133.662009,3,6
0,0,15,15,17,20,37,67,47,114,0.000333,0.197959,16,9502.042939,527.891274,593.877684,155.92543,3,6
0,0,14,14,13,19,32,52,42,94,0.000333,0.156667,12,5640,313.333333,470,128.816339,2,6
0,0,10,10,13,16,29,41,33,74,0.000333,0.11983,12,4313.887124,239.660396,359.490594,112.105716,2,6
0,0,11,11,13,18,31,38,32,70,0.000333,0.115598,6,2080.76245,115.597914,346.793742,123.164366,2,6
0,0,15,15,13,21,34,55,44,99,0.000333,0.167886,12,6043.905855,335.772548,503.658821,140.344382,3,6
0,0,10,10,13,16,29,41,33,74,0.000333,0.11983,12,4313.887124,239.660396,359.490594,112.105716,2,6
0,0,12,12,13,20,33,41,34,75,0.000333,0.12611,6,2269.977354,126.109853,378.329559,134.544278,3,6
0,0,15,15,14,19,33,55,43,98,0.000333,0.164784,14,6920.908732,384.49493,494.350624,134.013592,3,6
0,0,10,10,13,16,29,41,33,74,0.000333,0.11983,12,4313.887124,239.660396,359.490594,112.105716,2,6
0,0,12,12,14,18,32,41,33,74,0.000333,0.123333,7,2590,143.888889,370,128.361619,3,6
0,0,15,15,14,20,34,55,43,98,0.000333,0.16619,14,6979.999018,387.777723,498.571358,139.741531,3,6
0,0,10,10,13,16,29,41,33,74,0.000333,0.11983,12,4313.887124,239.660396,359.490594,112.105716,2,6
0,0,12,12,14,19,33,41,33,74,0.000333,0.124428,7,2612.996154,145.166453,373.285165,134.013592,3,6
0,0,9,9,9,14,23,34,51,85,0.000333,0.128168,12,4614.033195,256.335178,384.502766,81.832294,1,6
0,0,12,12,16,20,36,52,41,93,0.000333,0.160268,16,7692.848402,427.380467,480.803025,150.438562,3,6
0,0,28,28,22,47,69,126,93,219,0.000333,0.445922,11,14715.43542,817.52419,1337.766856,359.173172,11,6
0,0,28,28,21,49,70,124,92,216,0.000333,0.441308,10,13239.25132,735.513962,1323.925132,367.359448,10,6
0,0,25,25,19,49,68,112,84,196,0.000333,0.397714,9,10738.28445,596.571358,1193.142717,355.831405,9,6
0,0,24,24,19,49,68,111,82,193,0.000333,0.391627,9,10573.92296,587.440164,1174.880328,355.831405,9,6
0,0,28,28,22,45,67,126,91,217,0.000333,0.43878,22,28959.5098,1608.861655,1316.341354,345.240885,11,6
0,0,28,28,21,47,68,124,90,214,0.000333,0.434239,10,13027.17048,723.731693,1302.717048,353.304342,10,6
0,0,25,25,19,47,66,112,83,195,0.000333,0.392886,9,10607.91168,589.328427,1178.656853,341.776299,9,6
0,0,24,24,19,47,66,111,81,192,0.000333,0.386841,9,10444.71304,580.261835,1160.523671,341.776299,9,6
0,0,26,26,22,45,67,120,89,209,0.000333,0.422604,11,13945.93905,774.774392,1267.812641,345.240885,9,6
0,0,26,26,21,47,68,118,88,206,0.000333,0.418006,10,12540.17345,696.676303,1254.017345,353.304342,8,6
0,0,24,24,19,47,66,109,82,191,0.000333,0.384826,9,10390.31349,577.239638,1154.479277,341.776299,8,6
0,0,23,23,19,47,66,108,80,188,0.000333,0.378782,9,10227.11485,568.173047,1136.346094,341.776299,8,6
0,0,28,28,22,46,68,126,93,219,0.000333,0.444385,22,29329.39597,1629.410887,1333.154362,352.191346,11,6
0,0,28,28,21,48,69,124,92,216,0.000333,0.439814,10,13194.41283,733.022935,1319.441283,360.316866,10,6
0,0,25,25,19,48,67,112,84,196,0.000333,0.396318,9,10700.58133,594.476741,1188.953481,348.788823,9,6
0,0,24,24,19,48,67,111,82,193,0.000333,0.390252,9,10536.79692,585.377607,1170.755214,348.788823,9,6
0,0,7,7,10,13,23,32,24,56,0.000333,0.08444,5,1266.597348,70.366519,253.31947,81.324997,1,6
0,0,16,16,14,18,32,66,48,114,0.000333,0.19,14,7980,443.333333,570,128.361619,3,6
0,0,10,10,14,15,29,44,32,76,0.000333,0.123069,14,5168.891779,287.160654,369.206556,111.906328,2,6
0,0,13,13,14,18,32,52,38,90,0.000333,0.15,14,6300,350,450,128.361619,3,6
0,0,11,11,14,17,31,47,35,82,0.000333,0.135415,14,5687.417364,315.967631,406.244097,122.789837,2,6
0,0,7,7,14,17,31,38,29,67,0.000333,0.110644,7,2323.51807,129.084337,331.931153,122.789837,2,6
0,0,15,15,15,23,38,78,58,136,0.000333,0.237906,14,9992.053986,555.11411,713.718142,162.645284,2,6
0,0,14,14,15,22,37,69,54,123,0.000333,0.213588,14,8970.678696,498.371039,640.762764,156.710855,2,6
0,0,13,13,14,20,34,56,65,121,0.000333,0.205194,21,12927.24308,718.180171,615.583004,139.741531,2,6
0,0,13,13,14,15,29,43,44,87,0.000333,0.140881,14,5917.020852,328.723381,422.644347,111.906328,3,6
0,0,13,13,14,17,31,41,43,84,0.000333,0.138717,14,5826.134861,323.674159,416.15249,122.789837,2,6
0,0,13,13,15,17,32,43,44,87,0.000333,0.145,14,6090,338.333333,435,128.090227,3,6
0,0,13,13,15,19,34,41,43,84,0.000333,0.142449,14,5982.856301,332.380906,427.346879,139.313982,2,6
0,0,16,16,15,24,39,70,66,136,0.000333,0.239605,14,10063.40583,559.078101,718.814702,168.642459,2,6
0,0,7,7,12,15,27,30,29,59,0.000333,0.093513,6,1683.230176,93.512788,280.538363,101.622909,1,6
0,0,10,10,10,15,25,41,55,96,0.000333,0.148603,15,6687.152913,371.508495,445.810194,91.82264,1,6
0,0,13,13,11,17,28,47,48,95,0.000333,0.152233,10,4566.987176,253.72151,456.698718,107.540616,2,6
0,0,15,15,14,20,34,56,51,107,0.000333,0.181453,14,7621.019336,423.389963,544.358524,139.741531,2,6
0,0,13,13,12,17,29,48,39,87,0.000333,0.140881,12,5071.732159,281.762898,422.644347,112.506418,2,6
0,0,15,15,15,20,35,57,45,102,0.000333,0.174396,14,7324.616148,406.923119,523.186868,145.041921,2,6
0,0,12,12,14,19,33,56,39,95,0.000333,0.159739,14,6709.044179,372.724677,479.217441,134.013592,3,6
0,0,12,12,12,19,31,61,49,110,0.000333,0.181654,12,6539.53913,363.307729,544.961594,123.730173,1,6
0,0,4,4,10,12,22,17,16,33,0.000333,0.049054,5,735.806217,40.878123,147.161243,76.238831,1,6
0,0,7,7,15,15,30,35,27,62,0.000333,0.101409,7,2129.590518,118.310584,304.227217,117.206718,1,6
0,0,19,19,14,25,39,77,69,146,0.000333,0.257223,14,10803.36214,600.186785,771.668724,169.399374,2,6
0,0,18,18,17,22,39,68,60,128,0.000333,0.22551,16,10824.50374,601.361319,676.531484,167.594364,2,6
0,0,9,9,13,15,28,37,29,66,0.000333,0.105762,6,1903.712549,105.761808,317.285425,106.709075,2,6
0,0,10,10,14,15,29,37,32,69,0.000333,0.111734,14,4692.809641,260.711647,335.200689,111.906328,2,6
0,0,16,16,18,21,39,65,49,114,0.000333,0.200845,18,10845.64535,602.535853,602.535853,167.297316,3,6
0,0,12,12,14,23,37,58,43,101,0.000333,0.175385,7,3683.083529,204.615752,526.15479,157.344894,3,6
0,0,14,14,16,23,39,63,45,108,0.000333,0.190274,8,4566.587517,253.699307,570.82344,168.041925,3,6
0,0,11,11,19,20,39,55,44,99,0.000333,0.174418,18,9418.586754,523.25482,523.25482,167.149185,2,6
0,0,5,5,5,10,15,9,17,26,0.000333,0.03386,2,203.158311,11.286573,101.579155,44.828921,1,6
0,0,12,12,14,22,36,58,42,100,0.000333,0.172331,7,3618.947501,201.052639,516.9925,151.410465,3,6
0,0,11,11,13,17,30,44,39,83,0.000333,0.135757,12,4887.263033,271.514613,407.271919,117.592585,2,6
0,0,10,10,13,16,29,41,33,74,0.000333,0.11983,12,4313.887124,239.660396,359.490594,112.105716,2,6
0,0,14,14,15,23,38,55,49,104,0.000333,0.181928,14,7640.98246,424.499026,545.784461,162.645284,2,6
0,0,20,20,19,24,43,76,62,138,0.000333,0.249608,18,13478.84165,748.824536,748.824536,190.749723,4,6
0,0,5,5,11,13,24,24,20,44,0.000333,0.067246,5,1008.69175,56.038431,201.73835,86.159464,1,6
0,0,4,4,11,9,20,24,16,40,0.000333,0.057626,5,864.385619,48.021423,172.877124,66.583073,1,6
0,0,19,19,15,22,37,75,68,143,0.000333,0.248317,21,15643.98846,869.11047,744.951831,156.710855,2,6
0,0,9,9,13,17,30,36,31,67,0.000333,0.109587,6,1972.570019,109.587223,328.76167,117.592585,2,6
0,0,19,19,14,22,36,83,65,148,0.000333,0.25505,14,10712.0846,595.115811,765.1489,151.410465,2,6
0,0,9,9,13,16,29,39,29,68,0.000333,0.110114,6,1982.056246,110.114236,330.342708,112.105716,2,6
0,0,16,16,17,24,41,68,55,123,0.000333,0.21966,16,10543.66235,585.759019,658.978897,179.525968,4,6
0,0,16,16,17,24,41,65,60,125,0.000333,0.223231,16,10715.10401,595.283556,669.694001,179.525968,3,6
2,0,10,12,14,15,29,39,29,68,0.000333,0.110114,7,2312.398954,128.466609,330.342708,111.906328,2,6
2,0,11,13,14,15,29,42,32,74,0.000333,0.11983,14,5032.868311,279.603795,359.490594,111.906328,2,6
0,0,12,12,16,19,35,52,40,92,0.000333,0.157298,16,7550.304601,419.461367,471.894038,144.710623,3,6
0,0,13,13,14,21,35,50,50,100,0.000333,0.170976,14,7180.996224,398.944235,512.928302,145.541635,2,6
0,0,14,14,15,24,39,52,50,102,0.000333,0.179704,14,7547.554369,419.308576,539.111026,168.642459,2,6
0,0,11,11,15,21,36,43,37,80,0.000333,0.137865,7,2895.158001,160.842111,413.594,150.842025,2,6
0,0,14,14,13,21,34,45,44,89,0.000333,0.150928,12,5433.410314,301.856129,452.784193,140.344382,3,6
0,0,10,10,13,19,32,31,29,60,0.000333,0.1,6,1800,100,300,128.816339,3,6
0,0,14,14,13,21,34,45,44,89,0.000333,0.150928,12,5433.410314,301.856129,452.784193,140.344382,3,6
0,0,10,10,13,19,32,31,29,60,0.000333,0.1,6,1800,100,300,128.816339,3,6
0,0,9,9,14,18,32,36,35,71,0.000333,0.118333,7,2485,138.055556,355,128.361619,2,6
0,0,13,13,13,20,33,42,43,85,0.000333,0.142925,12,5145.282002,285.849,428.7735,134.544278,2,6
0,0,9,9,13,18,31,28,28,56,0.000333,0.092478,6,1664.60996,92.478331,277.434993,123.164366,2,6
0,0,16,16,15,22,37,50,47,97,0.000333,0.168439,14,7074.437671,393.024315,505.316976,156.710855,3,6
0,0,12,12,15,20,35,36,32,68,0.000333,0.116264,7,2441.538716,135.64104,348.791245,145.041921,3,6
0,0,14,14,13,22,35,45,45,90,0.000333,0.153878,12,5539.625658,307.756981,461.635472,146.213212,3,6
0,0,10,10,13,20,33,31,30,61,0.000333,0.102569,6,1846.248248,102.569347,307.708041,134.544278,3,6
0,0,17,17,15,24,39,79,52,131,0.000333,0.230796,14,9693.427669,538.523759,692.387691,168.642459,6,6
0,0,18,18,17,25,42,85,54,139,0.000333,0.249844,16,11992.51395,666.250775,749.532122,185.583273,7,6
0,0,10,10,13,19,32,37,37,74,0.000333,0.123333,6,2220,123.333333,370,128.816339,2,6
0,0,9,9,11,19,30,31,32,63,0.000333,0.103045,5,1545.670538,85.870585,309.134108,118.764371,2,6
0,0,14,14,14,23,37,51,47,98,0.000333,0.170175,14,7147.370018,397.076112,510.52643,157.344894,2,6
0,0,11,11,12,21,33,40,36,76,0.000333,0.127791,6,2300.243718,127.791318,383.373953,135.258216,2,6
0,0,11,11,12,22,34,40,36,76,0.000333,0.128882,6,2319.883056,128.882392,386.647176,141.127046,2,6
0,0,10,10,13,20,33,37,38,75,0.000333,0.12611,6,2269.977354,126.109853,378.329559,134.544278,2,6
0,0,9,9,11,20,31,31,33,64,0.000333,0.10569,5,1585.342819,88.074601,317.068564,124.49231,2,6
0,0,10,10,13,19,32,37,37,74,0.000333,0.123333,6,2220,123.333333,370,128.816339,2,6
0,0,9,9,11,19,30,31,32,63,0.000333,0.103045,5,1545.670538,85.870585,309.134108,118.764371,2,6
0,0,14,14,15,18,33,45,42,87,0.000333,0.146287,14,6144.072037,341.337335,438.862288,133.662009,2,6
0,0,12,12,14,20,34,41,38,79,0.000333,0.13397,7,2813.366951,156.298164,401.909564,139.741531,3,6
0,0,10,10,14,18,32,33,30,63,0.000333,0.105,7,2205,122.5,315,128.361619,3,6
0,0,12,12,13,21,34,41,38,79,0.000333,0.13397,6,2411.457387,133.969855,401.909564,140.344382,3,6
0,0,10,10,13,19,32,33,30,63,0.000333,0.105,6,1890,105,315,128.816339,3,6
0,0,14,14,16,23,39,63,45,108,0.000333,0.190274,8,4566.587517,253.699307,570.82344,168.041925,3,6
0,0,13,13,16,22,38,47,44,91,0.000333,0.159187,16,7640.98246,424.499026,477.561404,162.107496,3,6
0,0,11,11,16,21,37,39,36,75,0.000333,0.130236,8,3125.672019,173.648446,390.709002,156.238666,3,6
0,0,7,7,15,15,30,38,27,65,0.000333,0.106316,7,2232.635221,124.03529,318.947889,117.206718,2,6
0,0,13,13,12,16,28,45,62,107,0.000333,0.171462,18,9258.96558,514.386977,514.386977,107.01955,3,6
0,0,13,13,12,18,30,43,61,104,0.000333,0.170106,18,9185.699195,510.316622,510.316622,118.0782,2,6
0,0,16,16,17,23,40,66,58,124,0.000333,0.219973,16,10558.70534,586.594741,659.919084,173.528793,4,6
0,0,16,16,16,25,41,64,57,121,0.000333,0.216088,16,10372.22068,576.234482,648.263793,180.096405,3,6
0,0,11,11,13,19,32,52,35,87,0.000333,0.145,6,2610,145,435,128.816339,2,6
0,0,9,9,11,16,27,43,31,74,0.000333,0.117287,5,1759.308376,97.739354,351.861675,102.053748,2,6
0,0,9,9,11,17,28,43,32,75,0.000333,0.120184,5,1802.758096,100.153228,360.551619,107.540616,2,6
0,0,3,3,10,10,20,13,13,26,0.000333,0.037457,5,561.850652,31.213925,112.37013,66.438562,1,6
0,0,5,5,11,13,24,20,22,42,0.000333,0.064189,5,962.842125,53.491229,192.568425,86.159464,1,6
0,0,16,16,21,25,46,75,55,130,0.000333,0.239354,20,14361.26109,797.847838,718.063054,208.335071,3,6
0,0,10,10,18,19,37,51,41,92,0.000333,0.159757,18,8626.854773,479.26971,479.26971,155.769273,2,6
0,0,15,15,14,22,36,56,62,118,0.000333,0.20335,14,8540.716102,474.484228,610.05115,151.410465,2,6
0,0,14,14,15,24,39,52,50,102,0.000333,0.179704,14,7547.554369,419.308576,539.111026,168.642459,2,6
0,0,11,11,15,21,36,43,37,80,0.000333,0.137865,7,2895.158001,160.842111,413.594,150.842025,2,6
0,0,13,13,14,21,35,50,50,100,0.000333,0.170976,14,7180.996224,398.944235,512.928302,145.541635,2,6
0,0,12,12,14,20,34,36,32,68,0.000333,0.115316,7,2421.632312,134.535128,345.947473,139.741531,3,6
0,0,14,14,14,21,35,63,47,110,0.000333,0.188074,14,7899.095846,438.838658,564.221132,145.541635,6,6
0,0,14,14,14,21,35,63,47,110,0.000333,0.188074,14,7899.095846,438.838658,564.221132,145.541635,6,6
0,0,14,14,14,21,35,63,47,110,0.000333,0.188074,14,7899.095846,438.838658,564.221132,145.541635,6,6
0,0,14,14,14,21,35,63,47,110,0.000333,0.188074,14,7899.095846,438.838658,564.221132,145.541635,6,6
0,0,10,10,19,20,39,56,44,100,0.000333,0.17618,18,9513.723994,528.540222,528.540222,167.149185,2,6
0,0,15,15,14,20,34,58,43,101,0.000333,0.171278,14,7193.672458,399.64847,513.833747,139.741531,3,6
0,0,10,10,14,16,30,44,33,77,0.000333,0.125944,14,5289.628062,293.868226,377.830576,117.302969,2,6
0,0,12,12,14,19,33,44,33,77,0.000333,0.129473,7,2718.92843,151.051579,388.418347,134.013592,3,6
0,0,13,13,15,19,34,50,41,91,0.000333,0.15432,14,6481.42766,360.079314,462.959119,139.313982,3,6
0,0,17,17,17,22,39,73,52,125,0.000333,0.220225,16,10570.80444,587.266913,660.675277,167.594364,4,6
0,0,10,10,13,16,29,41,32,73,0.000333,0.118211,12,4255.591352,236.421742,354.632613,112.105716,2,6
0,0,15,15,14,21,35,59,42,101,0.000333,0.172686,14,7252.806186,402.933677,518.057585,145.541635,3,6
0,0,10,10,13,16,29,37,29,66,0.000333,0.106876,6,1923.760474,106.875582,320.626746,112.105716,2,6
0,0,12,12,15,20,35,48,38,86,0.000333,0.147039,7,3087.828376,171.546021,441.118339,145.041921,3,6
0,0,12,12,14,22,36,58,42,100,0.000333,0.172331,7,3618.947501,201.052639,516.9925,151.410465,3,6
0,0,15,15,12,21,33,62,55,117,0.000333,0.196731,12,7082.329344,393.462741,590.194112,135.258216,1,6
0,0,15,15,13,23,36,67,56,123,0.000333,0.211967,12,7630.809302,423.93385,635.900775,152.147641,1,6
0,0,15,15,13,21,34,54,60,114,0.000333,0.193324,12,6959.649167,386.647176,579.970764,140.344382,1,6
0,0,7,7,14,16,30,35,28,63,0.000333,0.103045,7,2163.938753,120.21882,309.134108,117.302969,1,6
0,0,13,13,15,21,36,52,50,102,0.000333,0.175777,14,7382.652902,410.147383,527.33235,150.842025,1,6
0,0,15,15,16,20,36,56,61,117,0.000333,0.201627,24,14517.1494,806.5083,604.881225,150.438562,1,6
0,0,12,12,14,22,36,52,41,93,0.000333,0.160268,7,3365.621176,186.978954,480.803025,151.410465,3,6
0,0,12,12,14,23,37,52,42,94,0.000333,0.16323,7,3427.820315,190.434462,489.688616,157.344894,3,6
0,0,14,14,17,25,42,66,58,124,0.000333,0.222882,16,10698.35777,594.353209,668.64736,185.583273,2,6
0,0,14,14,16,23,39,57,44,101,0.000333,0.177942,8,4270.604993,237.255833,533.825624,168.041925,3,6
0,0,13,13,13,16,29,45,62,107,0.000333,0.173268,18,9356.471397,519.803966,519.803966,112.105716,3,6
0,0,13,13,12,18,30,43,61,104,0.000333,0.170106,18,9185.699195,510.316622,510.316622,118.0782,2,6
0,0,15,15,14,16,30,47,64,111,0.000333,0.181555,28,15250.61597,847.256443,544.664856,117.302969,3,6
0,0,15,15,13,18,31,45,63,108,0.000333,0.178351,18,9630.957627,535.053202,535.053202,123.164366,2,6
0,0,15,15,13,17,30,56,43,99,0.000333,0.161927,12,5829.386028,323.854779,485.782169,117.592585,3,6
0,0,9,9,13,15,28,34,27,61,0.000333,0.09775,6,1759.491901,97.74955,293.24865,106.709075,2,6
0,0,12,12,13,17,30,42,33,75,0.000333,0.122672,6,2208.100768,122.672265,368.016795,117.592585,3,6
0,0,10,10,13,17,30,37,30,67,0.000333,0.109587,6,1972.570019,109.587223,328.76167,117.592585,2,6
0,0,12,12,12,21,33,51,49,100,0.000333,0.168146,12,6053.272943,336.292941,504.439412,135.258216,1,6
0,0,13,13,14,21,35,56,51,107,0.000333,0.182944,14,7683.665959,426.870331,548.833283,145.541635,1,6
0,0,7,7,13,13,26,34,28,62,0.000333,0.097142,12,3497.12715,194.284842,291.427263,96.211433,1,6
0,0,10,10,13,15,28,44,34,78,0.000333,0.124991,12,4499.684207,249.982456,374.973684,106.709075,2,6
0,0,12,12,12,21,33,51,56,107,0.000333,0.179917,12,6477.002049,359.833447,539.750171,135.258216,1,6
0,0,22,22,18,25,43,85,79,164,0.000333,0.296636,27,24027.50033,1334.86113,889.90742,191.155055,3,6
0,0,11,11,13,19,32,46,39,85,0.000333,0.141667,12,5100,283.333333,425,128.816339,2,6
0,0,12,12,14,21,35,50,39,89,0.000333,0.152169,7,3195.54332,177.530184,456.506189,145.541635,3,6
0,0,12,12,14,20,34,50,39,89,0.000333,0.150928,7,3169.48935,176.082742,452.784193,139.741531,3,6
0,0,20,20,14,21,35,73,70,143,0.000333,0.244496,21,15403.2369,855.735383,733.487471,145.541635,2,6
0,0,10,10,13,17,30,43,36,79,0.000333,0.129215,12,4651.732285,258.429571,387.644357,117.592585,2,6
0,0,8,8,13,19,32,31,33,64,0.000333,0.106667,6,1920,106.666667,320,128.816339,2,6
0,0,15,15,14,23,37,59,56,115,0.000333,0.199696,14,8387.219919,465.956662,599.087137,157.344894,2,6
0,0,18,18,15,23,38,69,65,134,0.000333,0.234407,14,9845.112015,546.950668,703.222287,162.645284,3,6
0,0,14,14,12,20,32,54,58,112,0.000333,0.186667,12,6720,373.333333,560,129.458112,1,6
0,0,5,5,9,14,23,23,24,47,0.000333,0.070869,4,850.429648,47.246092,212.607412,81.832294,1,6
0,0,12,12,10,16,26,47,41,88,0.000333,0.13788,10,4136.386952,229.799275,413.638695,97.219281,1,6
0,0,15,15,15,19,34,65,46,111,0.000333,0.188236,14,7905.917255,439.217625,564.708375,139.313982,3,6
0,0,9,9,13,15,28,34,27,61,0.000333,0.09775,6,1759.491901,97.74955,293.24865,106.709075,2,6
0,0,13,13,17,22,39,66,46,112,0.000333,0.197322,16,9471.440776,526.191154,591.965049,167.594364,3,6
0,0,18,18,16,22,38,74,50,124,0.000333,0.216914,16,10411.88819,578.438233,650.743012,162.107496,3,6
0,0,11,11,14,17,31,47,35,82,0.000333,0.135415,14,5687.417364,315.967631,406.244097,122.789837,2,6
0,0,12,12,14,22,36,60,41,101,0.000333,0.174054,7,3655.136976,203.063165,522.162425,151.410465,3,6
0,0,12,12,15,21,36,60,40,100,0.000333,0.172331,7,3618.947501,201.052639,516.9925,150.842025,3,6
0,0,17,17,14,20,34,62,73,135,0.000333,0.228936,21,14422.95716,801.275397,686.807484,139.741531,2,6
0,0,8,8,15,12,27,37,28,65,0.000333,0.103023,14,4326.947627,240.385979,309.067688,101.622909,2,6
0,0,13,13,11,19,30,68,53,121,0.000333,0.197911,10,5937.337621,329.85209,593.733762,118.764371,1,6
0,0,12,12,15,23,38,54,61,115,0.000333,0.201171,14,8449.163297,469.397961,603.511664,162.645284,1,6
0,0,14,14,17,21,38,47,49,96,0.000333,0.167934,16,8060.816661,447.823148,503.801041,161.725534,2,6
0,0,11,11,10,14,24,36,36,72,0.000333,0.110039,10,3301.173001,183.3985,330.1173,86.52225,1,6
0,0,14,14,14,17,31,48,43,91,0.000333,0.150277,14,6311.646099,350.647006,450.831864,122.789837,2,6
0,0,11,11,12,23,35,42,33,75,0.000333,0.128232,6,2308.177358,128.232075,384.696226,147.061475,4,6
0,0,12,12,12,23,35,43,35,78,0.000333,0.133361,6,2400.504452,133.361358,400.084075,147.061475,4,6
0,0,14,14,11,20,31,61,52,113,0.000333,0.186608,10,5598.241831,311.013435,559.824183,124.49231,1,6
0,0,5,5,10,13,23,26,21,47,0.000333,0.070869,5,1063.03706,59.057614,212.607412,81.324997,1,6
0,0,14,14,12,20,32,53,57,110,0.000333,0.183333,12,6600,366.666667,550,129.458112,1,6
0,0,5,5,9,14,23,23,24,47,0.000333,0.070869,4,850.429648,47.246092,212.607412,81.832294,1,6
0,0,4,4,9,12,21,16,19,35,0.000333,0.051244,4,614.924439,34.162469,153.73111,71.548875,1,6
0,0,10,10,11,22,33,39,32,71,0.000333,0.119384,5,1790.759912,99.486662,358.151982,136.161243,3,6
0,0,11,11,11,22,33,40,34,74,0.000333,0.124428,5,1866.425824,103.690324,373.285165,136.161243,3,6
0,0,32,32,22,51,73,141,115,256,0.000333,0.528198,22,34861.09192,1936.727329,1584.595087,387.401188,12,6
0,0,32,32,21,53,74,139,114,253,0.000333,0.523664,20,31419.83403,1745.546335,1570.991702,395.81845,11,6
0,0,14,14,14,21,35,56,47,103,0.000333,0.176105,14,7396.42611,410.912562,528.316151,145.541635,2,6
0,0,14,14,14,18,32,62,45,107,0.000333,0.178333,14,7490,416.111111,535,128.361619,2,6
0,0,9,9,13,15,28,34,27,61,0.000333,0.09775,6,1759.491901,97.74955,293.24865,106.709075,2,6
0,0,11,11,17,22,39,45,40,85,0.000333,0.149753,8,3594.073509,199.67075,449.259189,167.594364,3,6
0,0,16,16,17,23,40,60,53,113,0.000333,0.200459,16,9622.045996,534.558111,601.377875,173.528793,3,6
0,0,10,10,12,17,29,31,29,60,0.000333,0.09716,6,1748.873158,97.15962,291.47886,112.506418,2,6
0,0,16,16,16,23,39,57,53,110,0.000333,0.193798,16,9302.307905,516.794884,581.394244,168.041925,3,6
0,0,11,11,12,17,29,34,33,67,0.000333,0.108495,6,1952.90836,108.494909,325.484727,112.506418,2,6
0,0,20,20,16,25,41,69,83,152,0.000333,0.271449,24,19544.34971,1085.797206,814.347905,180.096405,3,6
0,0,18,18,16,24,40,63,71,134,0.000333,0.237713,16,11410.21384,633.900769,713.138365,174.0391,3,6
0,0,8,8,15,19,34,38,31,69,0.000333,0.117012,7,2457.244552,136.513586,351.034936,139.313982,2,6
0,0,15,15,17,24,41,65,51,116,0.000333,0.207159,16,9943.616521,552.42314,621.476033,179.525968,4,6
0,0,17,17,19,25,44,70,54,124,0.000333,0.225657,18,12185.45137,676.969521,676.969521,196.807027,4,6
0,0,11,11,13,21,34,48,42,90,0.000333,0.152624,12,5494.459869,305.24777,457.871656,140.344382,2,6
0,0,13,13,15,18,33,52,40,92,0.000333,0.154695,14,6497.179626,360.954424,464.084259,133.662009,2,6
0,0,22,22,17,25,42,93,74,167,0.000333,0.300172,16,14408.27215,800.459564,900.51701,185.583273,3,6
0,0,11,11,13,18,31,49,36,85,0.000333,0.140369,12,5053.280237,280.737791,421.106686,123.164366,2,6
0,0,13,13,9,17,26,47,44,91,0.000333,0.14258,8,3421.920115,190.106673,427.740014,98.016193,1,6
0,0,15,15,18,23,41,73,57,130,0.000333,0.232161,18,12536.67169,696.481761,696.481761,179.100575,2,6
0,0,10,10,18,19,37,51,41,92,0.000333,0.159757,18,8626.854773,479.26971,479.26971,155.769273,2,6
0,0,15,15,18,23,41,76,57,133,0.000333,0.237518,18,12825.9795,712.554417,712.554417,179.100575,2,6
0,0,10,10,18,19,37,51,41,92,0.000333,0.159757,18,8626.854773,479.26971,479.26971,155.769273,2,6
0,0,10,10,10,16,26,37,31,68,0.000333,0.106543,5,1598.149504,88.786084,319.629901,97.219281,2,6
0,0,12,12,13,19,32,46,37,83,0.000333,0.138333,6,2490,138.333333,415,128.816339,2,6
0,0,16,16,14,24,38,49,54,103,0.000333,0.180179,14,7567.511474,420.417304,540.536534,163.342069,2,6
0,0,11,11,13,20,33,34,34,68,0.000333,0.11434,6,2058.112801,114.3396,343.0188,134.544278,2,6
0,0,19,19,13,23,36,59,78,137,0.000333,0.236093,18,12749.03505,708.279725,708.279725,152.147641,2,6
0,0,12,12,17,15,32,54,38,92,0.000333,0.153333,16,7360,408.888889,460,128.090227,3,6
0,0,10,10,14,13,27,45,31,76,0.000333,0.120457,14,5059.200302,281.066683,361.37145,101.408685,2,6
0,0,6,6,7,11,18,14,16,30,0.000333,0.041699,3,375.29325,20.849625,125.09775,57.705232,1,6
0,0,18,18,16,21,37,67,60,127,0.000333,0.220534,16,10585.60924,588.089402,661.600577,156.238666,3,6
0,0,10,10,13,16,29,44,34,78,0.000333,0.126308,12,4547.070211,252.615012,378.922518,112.105716,2,6
0,0,32,32,24,50,74,142,107,249,0.000333,0.515385,24,37107.69331,2061.538517,1546.153888,392.23191,11,6
0,0,32,32,23,52,75,140,106,246,0.000333,0.510763,22,33710.36675,1872.798153,1532.289398,400.46479,10,6
0,0,31,31,23,50,73,139,105,244,0.000333,0.503439,22,33226.97823,1845.943235,1510.317192,386.234734,11,6
0,0,31,31,22,52,74,137,104,241,0.000333,0.498826,22,32922.52175,1829.028986,1496.478261,394.530361,10,6
0,0,29,29,20,52,72,128,98,226,0.000333,0.464801,10,13944.0305,774.668361,1394.40305,382.861427,10,6
0,0,28,28,20,52,72,127,96,223,0.000333,0.458631,10,13758.93275,764.385153,1375.893275,382.861427,10,6
0,0,12,12,12,23,35,45,38,83,0.000333,0.14191,6,2554.382942,141.910163,425.73049,147.061475,3,6
0,0,13,13,12,23,35,46,40,86,0.000333,0.147039,6,2646.710037,147.039446,441.118339,147.061475,3,6
0,0,19,19,15,24,39,70,69,139,0.000333,0.24489,14,10285.39272,571.410707,734.670908,168.642459,2,6
0,0,10,10,13,19,32,40,36,76,0.000333,0.126667,6,2280,126.666667,380,128.816339,2,6
0,0,19,19,14,24,38,78,64,142,0.000333,0.248402,14,10432.8799,579.604439,745.205707,163.342069,2,6
0,0,10,10,13,18,31,43,33,76,0.000333,0.125506,6,2259.113518,125.506307,376.51892,123.164366,2,6
0,0,17,17,15,21,36,67,56,123,0.000333,0.211967,14,8902.610852,494.589492,635.900775,150.842025,2,6
0,0,10,10,13,17,30,38,31,69,0.000333,0.112858,6,2031.452707,112.858484,338.575451,117.592585,2,6
0,0,17,17,16,22,38,68,56,124,0.000333,0.216914,16,10411.88819,578.438233,650.743012,162.107496,2,6
0,0,17,17,15,22,37,69,57,126,0.000333,0.218797,14,9189.475737,510.52643,656.391124,156.710855,2,6
0,0,10,10,13,18,31,42,33,75,0.000333,0.123855,6,2229.38834,123.854908,371.564723,123.164366,2,6
0,0,18,18,15,23,38,78,61,139,0.000333,0.243154,14,10212.46694,567.359275,729.461924,162.645284,2,6
0,0,10,10,13,18,31,41,33,74,0.000333,0.122204,6,2199.663162,122.203509,366.610527,123.164366,2,6
0,0,12,12,12,19,31,45,47,92,0.000333,0.151929,12,5469.432727,303.857374,455.786061,123.730173,1,6
0,0,13,13,10,19,29,61,52,113,0.000333,0.182984,10,5489.518524,304.973251,548.951852,113.929904,1,6
0,0,5,5,9,13,22,19,22,41,0.000333,0.060946,4,731.346785,40.630377,182.836696,76.635041,1,6
0,0,3,3,11,12,23,18,16,34,0.000333,0.051267,5,769.005533,42.72253,153.801107,81.073298,1,6
0,0,12,12,14,14,28,40,32,72,0.000333,0.115377,14,4845.813761,269.211876,346.129554,106.605938,5,6
0,0,12,12,13,16,29,38,31,69,0.000333,0.111734,6,2011.204132,111.733563,335.200689,112.105716,4,6
0,0,10,10,14,13,27,34,30,64,0.000333,0.101438,14,4260.379202,236.687733,304.3128,101.408685,3,6
0,0,10,10,13,15,28,32,29,61,0.000333,0.09775,6,1759.491901,97.74955,293.24865,106.709075,2,6
0,0,15,15,18,23,41,73,63,136,0.000333,0.242876,18,13115.28731,728.627073,728.627073,179.100575,2,6
0,0,10,10,18,19,37,54,43,97,0.000333,0.168439,18,9095.705576,505.316976,505.316976,155.769273,2,6
0,0,19,19,18,25,43,85,87,172,0.000333,0.311106,27,25199.57352,1399.976307,933.317538,191.155055,2,6
0,0,10,10,18,19,37,54,43,97,0.000333,0.168439,18,9095.705576,505.316976,505.316976,155.769273,2,6
0,0,15,15,13,21,34,48,49,97,0.000333,0.164495,12,5921.806747,328.989264,493.483896,140.344382,2,6
0,0,11,11,13,19,32,34,34,68,0.000333,0.113333,6,2040,113.333333,340,128.816339,2,6
0,0,13,13,14,20,34,45,43,88,0.000333,0.149232,14,6267.75422,348.208568,447.69673,139.741531,2,6
0,0,9,9,13,17,30,31,28,59,0.000333,0.096502,6,1737.039271,96.502182,289.506545,117.592585,2,6
0,0,15,15,17,22,39,54,50,104,0.000333,0.183227,16,8794.909292,488.606072,549.681831,167.594364,3,6
0,0,11,11,16,21,37,40,35,75,0.000333,0.130236,8,3125.672019,173.648446,390.709002,156.238666,3,6
0,0,19,19,13,23,36,60,79,139,0.000333,0.23954,18,12935.15235,718.619575,718.619575,152.147641,2,6
0,0,15,15,13,20,33,52,70,122,0.000333,0.205139,18,11077.48949,615.416083,615.416083,134.544278,2,6
0,0,18,18,15,25,40,63,72,135,0.000333,0.239487,14,10058.4441,558.80245,718.460293,174.699764,2,6
0,0,15,15,17,24,41,62,49,111,0.000333,0.198229,16,9515.01236,528.611798,594.688273,179.525968,4,6
0,0,15,15,17,24,41,62,50,112,0.000333,0.200015,16,9600.733192,533.374066,600.045825,179.525968,4,6
0,0,15,15,17,23,40,62,49,111,0.000333,0.196911,16,9451.744297,525.096905,590.734019,173.528793,4,6
0,0,14,14,17,23,40,59,48,107,0.000333,0.189815,16,9111.140898,506.174494,569.446306,173.528793,3,6
0,0,33,33,22,52,74,151,118,269,0.000333,0.556781,22,36747.54502,2041.530279,1670.342955,394.530361,11,6
0,0,33,33,21,54,75,149,117,266,0.000333,0.552289,20,33137.31543,1840.961969,1656.865772,403.002591,10,6
0,0,9,9,12,17,29,30,29,59,0.000333,0.09554,6,1719.725272,95.540293,286.620879,112.506418,2,6
0,0,9,9,12,17,29,30,29,59,0.000333,0.09554,6,1719.725272,95.540293,286.620879,112.506418,2,6
0,0,16,16,14,20,34,75,52,127,0.000333,0.215369,14,9045.508932,502.528274,646.107781,139.741531,3,6
0,0,10,10,14,15,29,44,32,76,0.000333,0.123069,14,5168.891779,287.160654,369.206556,111.906328,2,6
0,0,14,14,15,20,35,49,46,95,0.000333,0.162427,14,6821.946413,378.997023,487.281887,145.041921,2,6
0,0,16,16,17,25,42,75,62,137,0.000333,0.246249,16,11819.95979,656.664433,738.747487,185.583273,3,6
0,0,12,12,16,21,37,52,47,99,0.000333,0.171912,16,8251.774131,458.431896,515.735883,156.238666,3,6
0,0,11,11,15,20,35,49,46,95,0.000333,0.162427,14,6821.946413,378.997023,487.281887,145.041921,2,6
0,0,18,18,16,21,37,71,77,148,0.000333,0.257,24,18503.97836,1027.998797,770.999098,156.238666,3,6
0,0,10,10,13,16,29,44,34,78,0.000333,0.126308,12,4547.070211,252.615012,378.922518,112.105716,2,6
0,0,20,20,18,24,42,91,70,161,0.000333,0.289388,18,15626.93589,868.163105,868.163105,185.09775,3,6
0,0,10,10,13,17,30,44,34,78,0.000333,0.127579,12,4592.849597,255.158311,382.737466,117.592585,2,6
0,0,21,21,17,25,42,91,73,164,0.000333,0.29478,16,14149.44092,786.080051,884.340057,185.583273,3,6
0,0,10,10,13,17,30,46,34,80,0.000333,0.13085,12,4710.614972,261.700832,392.551248,117.592585,2,6
0,0,13,13,16,19,35,53,45,98,0.000333,0.167557,16,8042.715771,446.817543,502.669736,144.710623,3,6
0,0,10,10,13,16,29,41,32,73,0.000333,0.118211,12,4255.591352,236.421742,354.632613,112.105716,2,6
0,0,9,9,10,13,23,29,25,54,0.000333,0.081424,5,1221.361728,67.853429,244.272346,81.324997,2,6
0,0,11,11,13,16,29,38,31,69,0.000333,0.111734,6,2011.204132,111.733563,335.200689,112.105716,2,6
0,0,11,11,13,21,34,48,42,90,0.000333,0.152624,12,5494.459869,305.24777,457.871656,140.344382,2,6
0,0,13,13,15,23,38,53,45,98,0.000333,0.171432,7,3600.078274,200.004349,514.296896,162.645284,2,6
0,0,11,11,15,18,33,52,38,90,0.000333,0.151332,14,6355.93659,353.107588,453.995471,133.662009,2,6
0,0,20,20,15,24,39,79,73,152,0.000333,0.267794,21,16871.00388,937.277993,803.381137,168.642459,2,6
0,0,11,11,14,19,33,49,40,89,0.000333,0.14965,14,6285.315073,349.184171,448.951077,134.013592,2,6
0,0,20,20,14,24,38,87,68,155,0.000333,0.271143,14,11388.0027,632.666817,813.428765,163.342069,2,6
0,0,11,11,14,18,32,52,37,89,0.000333,0.148333,14,6230,346.111111,445,128.361619,2,6
0,0,11,11,13,21,34,48,42,90,0.000333,0.152624,12,5494.459869,305.24777,457.871656,140.344382,2,6
0,0,12,12,14,20,34,49,37,86,0.000333,0.145841,7,3062.65263,170.147368,437.521804,139.741531,3,6
0,0,11,11,14,19,33,44,32,76,0.000333,0.127791,7,2683.617671,149.089871,383.373953,134.013592,3,6
0,0,19,19,15,25,40,65,56,121,0.000333,0.214651,14,9015.346193,500.852566,643.953299,174.699764,3,6
0,0,12,12,14,20,34,43,33,76,0.000333,0.128882,7,2706.530232,150.362791,386.647176,139.741531,3,6
0,0,12,12,14,21,35,43,33,76,0.000333,0.129942,7,2728.778565,151.598809,389.825509,145.541635,3,6
0,0,9,9,10,16,26,47,34,81,0.000333,0.126912,10,3807.356172,211.519787,380.735617,97.219281,1,6
0,0,10,10,11,18,29,50,36,86,0.000333,0.139262,10,4177.863656,232.103536,417.786366,113.112398,2,6
0,0,10,10,11,18,29,50,36,86,0.000333,0.139262,10,4177.863656,232.103536,417.786366,113.112398,2,6
0,0,13,13,11,18,29,65,46,111,0.000333,0.179745,10,5392.358905,299.575495,539.23589,113.112398,1,6
0,0,13,13,14,15,29,53,43,96,0.000333,0.155455,14,6529.126457,362.729248,466.366176,111.906328,5,6
0,0,12,12,14,16,30,46,40,86,0.000333,0.140664,14,5907.896277,328.21646,421.992591,117.302969,4,6
0,0,10,10,13,14,27,35,30,65,0.000333,0.103023,12,3708.812252,206.045125,309.067688,101.408685,3,6
0,0,10,10,13,16,29,33,29,62,0.000333,0.100398,6,1807.16893,100.398274,301.194822,112.105716,2,6
0,0,12,12,14,16,30,41,32,73,0.000333,0.119401,14,5014.842189,278.602344,358.203013,117.302969,5,6
0,0,12,12,14,18,32,39,31,70,0.000333,0.116667,7,2450,136.111111,350,128.361619,4,6
0,0,9,9,12,15,27,26,25,51,0.000333,0.080833,6,1454.995576,80.833088,242.499263,101.622909,2,6
0,0,10,10,11,15,26,35,29,64,0.000333,0.100276,5,1504.14071,83.563373,300.828142,96.657107,2,6
0,0,5,5,9,12,21,21,19,40,0.000333,0.058564,4,702.770788,39.042822,175.692697,71.548875,1,6
0,0,11,11,13,18,31,37,29,66,0.000333,0.108992,6,1961.861739,108.992319,326.976956,123.164366,3,6
0,0,10,10,11,16,27,35,29,64,0.000333,0.101438,5,1521.564001,84.531333,304.3128,102.053748,2,6
0,0,5,5,9,12,21,21,19,40,0.000333,0.058564,4,702.770788,39.042822,175.692697,71.548875,1,6
0,0,11,11,12,18,30,37,29,66,0.000333,0.107952,6,1943.128676,107.951593,323.854779,118.0782,3,6
0,0,8,8,16,18,34,43,31,74,0.000333,0.125491,8,3011.778002,167.321,376.47225,139.05865,2,6
0,0,13,13,9,17,26,46,54,100,0.000333,0.156681,12,5640.527662,313.362648,470.043972,98.016193,1,6
0,0,16,16,16,22,38,59,57,116,0.000333,0.20292,16,9740.153465,541.119637,608.759592,162.107496,3,6
0,0,13,13,14,21,35,51,43,94,0.000333,0.160718,14,6750.13645,375.007581,482.152604,145.541635,2,6
0,0,16,16,16,23,39,63,74,137,0.000333,0.241367,24,17378.4025,965.466805,724.100104,168.041925,3,6
0,0,14,14,15,20,35,63,52,115,0.000333,0.196623,14,8258.145657,458.78587,589.867547,145.041921,2,6
0,0,14,14,16,22,38,67,53,120,0.000333,0.209917,16,10076.02083,559.778935,629.751302,162.107496,2,6
0,0,17,17,14,23,37,63,73,136,0.000333,0.236162,21,14878.19881,826.566601,708.485658,157.344894,2,6
0,0,15,15,14,20,34,58,43,101,0.000333,0.171278,14,7193.672458,399.64847,513.833747,139.741531,3,6
0,0,10,10,14,16,30,44,33,77,0.000333,0.125944,14,5289.628062,293.868226,377.830576,117.302969,2,6
0,0,12,12,14,19,33,44,33,77,0.000333,0.129473,7,2718.92843,151.051579,388.418347,134.013592,3,6
0,0,10,10,13,17,30,41,33,74,0.000333,0.121037,6,2178.659424,121.036635,363.109904,117.592585,2,6
0,0,12,12,13,20,33,44,46,90,0.000333,0.151332,12,5447.945649,302.663647,453.995471,134.544278,1,6
0,0,10,10,11,18,29,46,35,81,0.000333,0.131165,5,1967.482303,109.304572,393.496461,113.112398,2,6
0,0,10,10,11,17,28,46,34,80,0.000333,0.128196,10,3845.883938,213.660219,384.588394,107.540616,2,6
0,0,12,12,13,20,33,55,38,93,0.000333,0.156376,6,2814.771919,156.376218,469.128653,134.544278,2,6
0,0,17,17,15,23,38,63,54,117,0.000333,0.204669,14,8596.105267,477.561404,614.007519,162.645284,2,6
0,0,10,10,14,16,30,44,33,77,0.000333,0.125944,14,5289.628062,293.868226,377.830576,117.302969,2,6
0,0,13,13,15,21,36,48,39,87,0.000333,0.149928,7,3148.484326,174.915796,449.783475,150.842025,2,6
0,0,11,11,15,17,32,48,36,84,0.000333,0.14,14,5880,326.666667,420,128.090227,2,6
0,0,10,10,15,13,28,45,30,75,0.000333,0.120184,14,5047.722668,280.429037,360.551619,106.709075,2,6
0,0,6,6,5,11,16,13,19,32,0.000333,0.042667,2,256,14.222222,128,49.663388,1,6
0,0,16,16,14,19,33,75,51,126,0.000333,0.211865,14,8898.311227,494.350624,635.593659,134.013592,3,6
0,0,10,10,14,15,29,44,32,76,0.000333,0.123069,14,5168.891779,287.160654,369.206556,111.906328,2,6
0,0,16,16,14,25,39,76,63,139,0.000333,0.24489,14,10285.39272,571.410707,734.670908,169.399374,2,6
0,0,11,11,9,16,25,31,35,66,0.000333,0.102165,8,2451.956068,136.219782,306.494509,92.529325,1,6
0,0,11,11,12,16,28,32,31,63,0.000333,0.100954,6,1817.180161,100.954453,302.86336,107.01955,2,6
0,0,11,11,10,16,26,34,35,69,0.000333,0.10811,10,3243.303406,180.183523,324.330341,97.219281,1,6
0,0,10,10,12,16,28,29,27,56,0.000333,0.089737,6,1615.271254,89.737292,269.211876,107.01955,2,6
0,0,12,12,10,19,29,33,40,73,0.000333,0.118211,10,3546.326126,197.018118,354.632613,113.929904,1,6
0,0,11,11,13,18,31,33,32,65,0.000333,0.107341,6,1932.136561,107.34092,322.02276,123.164366,2,6
0,0,12,12,13,18,31,42,36,78,0.000333,0.128809,12,4637.127747,257.618208,386.427312,123.164366,2,6
0,0,14,14,19,22,41,61,49,110,0.000333,0.196444,18,10607.95297,589.330721,589.330721,178.818118,3,6
0,0,10,10,18,19,37,51,41,92,0.000333,0.159757,18,8626.854773,479.26971,479.26971,155.769273,2,6
0,0,9,9,15,20,35,39,31,70,0.000333,0.119683,7,2513.348678,139.630482,359.049811,145.041921,2,6
0,0,10,10,11,17,28,37,33,70,0.000333,0.112172,5,1682.574223,93.476346,336.514845,107.540616,2,6
0,0,7,7,14,14,28,32,27,59,0.000333,0.094545,7,1985.437583,110.302088,283.63394,106.605938,3,6
0,0,7,7,14,16,30,30,26,56,0.000333,0.091595,7,1923.501113,106.861173,274.785873,117.302969,2,6
0,0,10,10,13,20,33,46,42,88,0.000333,0.147969,12,5326.88019,295.937788,443.906683,134.544278,2,6
0,0,7,7,12,13,25,30,26,56,0.000333,0.086685,12,3120.67136,173.370631,260.055947,91.125266,3,6
0,0,7,7,12,15,27,28,25,53,0.000333,0.084003,6,1512.054226,84.003013,252.009038,101.622909,2,6
0,0,14,14,14,20,34,51,44,95,0.000333,0.161103,14,6766.325579,375.906977,483.30897,139.741531,2,6
0,0,34,34,22,52,74,151,121,272,0.000333,0.56299,22,37157.36894,2064.298274,1688.971315,394.530361,11,6
0,0,34,34,21,54,75,149,120,269,0.000333,0.558517,20,33511.04456,1861.724697,1675.552228,403.002591,10,6
0,0,18,18,15,22,37,80,61,141,0.000333,0.244844,14,10283.46094,571.303386,734.532925,156.710855,2,6
0,0,10,10,14,15,29,44,32,76,0.000333,0.123069,14,5168.891779,287.160654,369.206556,111.906328,2,6
0,0,8,8,12,14,26,30,30,60,0.000333,0.094009,12,3384.316597,188.017589,282.026383,96.322519,3,6
0,0,8,8,12,16,28,28,29,57,0.000333,0.09134,6,1644.115383,91.339744,274.019231,107.01955,2,6
0,0,17,17,14,19,33,78,56,134,0.000333,0.225316,14,9463.283368,525.737965,675.948812,134.013592,2,6
0,0,10,10,14,15,29,44,32,76,0.000333,0.123069,14,5168.891779,287.160654,369.206556,111.906328,2,6
0,0,12,12,14,19,33,46,35,81,0.000333,0.136199,7,2860.171466,158.898415,408.595924,134.013592,3,6
0,0,15,15,15,22,37,69,45,114,0.000333,0.197959,14,8314.287572,461.904865,593.877684,156.710855,3,6
0,0,12,12,14,20,34,46,36,82,0.000333,0.139057,7,2920.203671,162.233537,417.171953,139.741531,3,6
0,0,16,16,14,20,34,62,50,112,0.000333,0.189932,14,7977.141735,443.174541,569.795838,139.741531,2,6
0,0,10,10,13,16,29,40,31,71,0.000333,0.114972,6,2069.499904,114.972217,344.916651,112.105716,2,6
0,0,18,18,14,24,38,76,63,139,0.000333,0.243154,14,10212.46694,567.359275,729.461924,163.342069,2,6
0,0,9,9,13,17,30,40,31,71,0.000333,0.11613,6,2090.335394,116.129744,348.389232,117.592585,2,6
0,0,11,11,12,20,32,48,42,90,0.000333,0.15,12,5400,300,450,129.458112,1,6
0,0,12,12,14,18,32,54,39,93,0.000333,0.155,14,6510,361.666667,465,128.361619,2,6
0,0,3,3,10,8,18,17,12,29,0.000333,0.040309,5,604.639125,33.591063,120.927825,57.219281,1,6
0,0,16,16,14,20,34,61,54,115,0.000333,0.195019,14,8190.815174,455.045287,585.058227,139.741531,2,6
0,0,10,10,14,16,30,47,35,82,0.000333,0.134122,14,5633.110404,312.950578,402.365029,117.302969,2,6
0,0,10,10,15,13,28,48,32,80,0.000333,0.128196,14,5384.237513,299.124306,384.588394,106.709075,2,6
0,0,6,6,7,11,18,14,16,30,0.000333,0.041699,3,375.29325,20.849625,125.09775,57.705232,1,6
0,0,16,16,15,20,35,64,48,112,0.000333,0.191493,14,8042.715771,446.817543,574.479698,145.041921,2,6
0,0,10,10,14,16,30,44,33,77,0.000333,0.125944,14,5289.628062,293.868226,377.830576,117.302969,2,6
0,0,12,12,14,19,33,44,34,78,0.000333,0.131154,7,2754.239189,153.013288,393.462741,134.013592,2,6
0,0,16,16,14,20,34,61,48,109,0.000333,0.184844,14,7763.468296,431.303794,554.53345,139.741531,2,6
0,0,10,10,14,16,30,44,33,77,0.000333,0.125944,14,5289.628062,293.868226,377.830576,117.302969,2,6
0,0,13,13,14,19,33,47,38,85,0.000333,0.142925,14,6002.829002,333.4905,428.7735,134.013592,2,6
0,0,21,21,14,21,35,90,80,170,0.000333,0.290659,21,18311.54037,1017.307798,871.978113,145.541635,2,6
0,0,10,10,14,15,29,47,34,81,0.000333,0.131165,14,5508.950448,306.052803,393.496461,111.906328,2,6
0,0,17,17,15,19,34,81,56,137,0.000333,0.232327,14,9757.75373,542.097429,696.982409,139.313982,2,6
0,0,10,10,14,15,29,44,32,76,0.000333,0.123069,14,5168.891779,287.160654,369.206556,111.906328,2,6
0,0,17,17,14,19,33,78,60,138,0.000333,0.232042,21,14618.65416,812.147453,696.126388,134.013592,2,6
0,0,10,10,14,15,29,47,34,81,0.000333,0.131165,14,5508.950448,306.052803,393.496461,111.906328,2,6
0,0,12,12,16,20,36,48,39,87,0.000333,0.149928,8,3598.267801,199.903767,449.783475,150.438562,4,6
0,0,12,12,14,22,36,46,38,84,0.000333,0.144758,7,3039.915901,168.884217,434.2737,151.410465,3,6
0,0,9,9,11,21,32,36,30,66,0.000333,0.11,5,1650,91.666667,330,130.292414,3,6
0,0,10,10,11,21,32,37,32,69,0.000333,0.115,5,1725,95.833333,345,130.292414,3,6
0,0,14,14,18,21,39,55,45,100,0.000333,0.17618,18,9513.723994,528.540222,528.540222,167.297316,4,6
0,0,14,14,16,23,39,53,44,97,0.000333,0.170895,8,4101.472122,227.859562,512.684015,168.041925,3,6
0,0,10,10,12,22,34,39,32,71,0.000333,0.120403,6,2167.25917,120.403287,361.209862,141.127046,3,6
0,0,11,11,12,22,34,40,34,74,0.000333,0.125491,6,2258.833502,125.49075,376.47225,141.127046,3,6
0,0,15,15,17,24,41,55,51,106,0.000333,0.1893,16,9086.4082,504.800456,567.900512,179.525968,4,6
0,0,15,15,15,26,41,53,50,103,0.000333,0.183943,7,3862.794995,214.599722,551.827856,180.814792,3,6
0,0,11,11,12,24,36,42,37,79,0.000333,0.136141,6,2450.544451,136.141358,408.424075,153.05865,3,6
0,0,12,12,12,24,36,43,39,82,0.000333,0.141311,6,2543.603101,141.311283,423.93385,153.05865,3,6
0,0,7,7,11,15,26,37,27,64,0.000333,0.100276,5,1504.14071,83.563373,300.828142,96.657107,1,6
0,0,8,8,12,14,26,30,30,60,0.000333,0.094009,12,3384.316597,188.017589,282.026383,96.322519,3,6
0,0,8,8,12,16,28,28,29,57,0.000333,0.09134,6,1644.115383,91.339744,274.019231,107.01955,2,6
0,0,7,7,14,14,28,32,27,59,0.000333,0.094545,7,1985.437583,110.302088,283.63394,106.605938,3,6
0,0,7,7,14,16,30,30,26,56,0.000333,0.091595,7,1923.501113,106.861173,274.785873,117.302969,2,6
0,0,12,12,14,21,35,55,40,95,0.000333,0.162427,7,3410.973206,189.498511,487.281887,145.541635,3,6
0,0,14,14,16,22,38,60,43,103,0.000333,0.180179,8,4324.292271,240.23846,540.536534,162.107496,3,6
0,0,16,16,15,15,30,50,38,88,0.000333,0.143935,14,6045.289214,335.849401,431.806372,117.206718,5,6
0,0,16,16,14,17,31,48,37,85,0.000333,0.140369,14,5895.493609,327.527423,421.106686,122.789837,4,6
0,0,12,12,14,16,30,42,34,76,0.000333,0.124308,14,5220.931594,290.051755,372.923685,117.302969,5,6
0,0,12,12,13,18,31,40,33,73,0.000333,0.120552,6,2169.937984,120.55211,361.656331,123.164366,4,6
0,0,12,12,18,19,37,62,50,112,0.000333,0.194486,18,10502.25799,583.458777,583.458777,155.769273,3,6
0,0,11,11,18,19,37,61,48,109,0.000333,0.189277,18,10220.9475,567.830417,567.830417,155.769273,3,6
0,0,14,14,19,23,42,70,52,122,0.000333,0.219288,18,11841.52906,657.862726,657.862726,184.752548,3,6
0,0,10,10,18,19,37,51,41,92,0.000333,0.159757,18,8626.854773,479.26971,479.26971,155.769273,2,6
0,0,14,14,19,23,42,70,53,123,0.000333,0.221085,18,11938.59077,663.255043,663.255043,184.752548,3,6
0,0,10,10,18,19,37,51,41,92,0.000333,0.159757,18,8626.854773,479.26971,479.26971,155.769273,2,6
0,0,16,16,16,24,40,72,70,142,0.000333,0.251905,16,12091.42063,671.745591,755.713789,174.0391,2,6
0,0,17,17,16,25,41,64,78,142,0.000333,0.253591,24,18258.53723,1014.36318,760.772385,180.096405,2,6
0,0,11,11,14,20,34,45,37,82,0.000333,0.139057,7,2920.203671,162.233537,417.171953,139.741531,2,6
0,0,14,14,16,23,39,51,52,103,0.000333,0.181465,16,8710.342857,483.907936,544.396429,168.041925,2,6
0,0,7,7,14,18,32,34,29,63,0.000333,0.105,7,2205,122.5,315,128.361619,2,6
0,0,11,11,14,14,28,48,34,82,0.000333,0.131401,14,5518.843451,306.602414,394.203104,106.605938,2,6
0,0,12,12,14,18,32,48,38,86,0.000333,0.143333,14,6020,334.444444,430,128.361619,2,6
0,0,11,11,14,14,28,45,32,77,0.000333,0.123389,14,5182.328606,287.907145,370.166329,106.605938,2,6
0,0,18,18,15,24,39,71,58,129,0.000333,0.227272,14,9545.436407,530.302023,681.816886,168.642459,2,6
0,0,11,11,13,17,30,44,35,79,0.000333,0.129215,12,4651.732285,258.429571,387.644357,117.592585,2,6
0,0,17,17,14,21,35,69,58,127,0.000333,0.21714,14,9119.865204,506.659178,651.418943,145.541635,2,6
0,0,11,11,13,17,30,47,37,84,0.000333,0.137393,12,4946.14572,274.785873,412.17881,117.592585,2,6
0,0,10,10,10,17,27,28,31,59,0.000333,0.093513,5,1402.691813,77.927323,280.538363,102.706149,2,6
0,0,10,10,12,17,29,29,27,56,0.000333,0.090682,6,1632.281614,90.682312,272.046936,112.506418,3,6
0,0,12,12,12,17,29,33,33,66,0.000333,0.106876,6,1923.760474,106.875582,320.626746,112.506418,2,6
0,0,12,12,14,18,32,34,29,63,0.000333,0.105,7,2205,122.5,315,128.361619,3,6
0,0,14,14,16,22,38,66,50,116,0.000333,0.20292,16,9740.153465,541.119637,608.759592,162.107496,4,6
0,0,15,15,16,22,38,76,57,133,0.000333,0.232658,16,11167.58975,620.421653,697.974359,162.107496,4,6
0,0,16,16,16,22,38,76,56,132,0.000333,0.230909,16,11083.62291,615.756828,692.726432,162.107496,4,6
0,0,15,15,14,21,35,58,44,102,0.000333,0.174396,14,7324.616148,406.923119,523.186868,145.541635,3,6
0,0,10,10,14,16,30,44,33,77,0.000333,0.125944,14,5289.628062,293.868226,377.830576,117.302969,2,6
0,0,12,12,14,20,34,44,34,78,0.000333,0.132274,7,2777.754711,154.319706,396.822102,139.741531,3,6
0,0,15,15,14,22,36,54,46,100,0.000333,0.172331,14,7237.895002,402.105278,516.9925,151.410465,3,6
0,0,19,19,15,24,39,77,57,134,0.000333,0.236081,14,9915.414563,550.856365,708.243897,168.642459,3,6
0,0,15,15,15,21,36,67,46,113,0.000333,0.194734,14,8178.821352,454.378964,584.201525,150.842025,3,6
0,0,10,10,14,16,30,44,33,77,0.000333,0.125944,14,5289.628062,293.868226,377.830576,117.302969,2,6
0,0,17,17,15,22,37,71,49,120,0.000333,0.208378,14,8751.881654,486.215647,625.134404,156.710855,3,6
0,0,10,10,14,16,30,44,33,77,0.000333,0.125944,14,5289.628062,293.868226,377.830576,117.302969,2,6
0,0,12,12,14,14,28,39,42,81,0.000333,0.129799,21,8177.310722,454.29504,389.395749,106.605938,3,6
0,0,12,12,13,16,29,37,41,78,0.000333,0.126308,12,4547.070211,252.615012,378.922518,112.105716,2,6
0,0,8,8,14,14,28,31,27,58,0.000333,0.092942,7,1951.786098,108.432561,278.826585,106.605938,3,6
0,0,8,8,13,16,29,29,26,55,0.000333,0.089063,6,1603.133728,89.062985,267.188955,112.105716,2,6
0,0,12,12,14,14,28,38,36,74,0.000333,0.118581,14,4980.419699,276.689983,355.744264,106.605938,3,6
0,0,12,12,13,16,29,36,35,71,0.000333,0.114972,12,4138.999808,229.944434,344.916651,112.105716,2,6
0,0,14,14,15,22,37,53,46,99,0.000333,0.171912,14,7220.302365,401.127909,515.735883,156.710855,3,6
0,0,15,15,15,19,34,57,53,110,0.000333,0.18654,14,7834.692776,435.26071,559.620913,139.313982,2,6
0,0,9,9,12,17,29,29,28,57,0.000333,0.092302,6,1661.4295,92.301639,276.904917,112.506418,2,6
0,0,15,15,14,22,36,60,44,104,0.000333,0.179224,14,7527.410802,418.189489,537.6722,151.410465,3,6
0,0,10,10,13,17,30,38,31,69,0.000333,0.112858,6,2031.452707,112.858484,338.575451,117.592585,2,6
0,0,17,17,15,24,39,78,50,128,0.000333,0.22551,14,9471.440776,526.191154,676.531484,168.642459,3,6
0,0,10,10,13,17,30,38,31,69,0.000333,0.112858,6,2031.452707,112.858484,338.575451,117.592585,2,6
0,0,16,16,17,22,39,66,49,115,0.000333,0.202607,16,9725.140083,540.28556,607.821255,167.594364,3,6
0,0,10,10,13,17,30,38,31,69,0.000333,0.112858,6,2031.452707,112.858484,338.575451,117.592585,2,6
0,0,12,12,14,20,34,45,37,82,0.000333,0.139057,7,2920.203671,162.233537,417.171953,139.741531,3,6
0,0,12,12,14,20,34,45,36,81,0.000333,0.137361,7,2884.591431,160.255079,412.08449,139.741531,3,6
0,0,8,8,14,19,33,37,31,68,0.000333,0.11434,7,2401.131601,133.3962,343.0188,134.013592,2,6
0,0,14,14,17,23,40,58,54,112,0.000333,0.198685,16,9536.895146,529.827508,596.055947,173.528793,2,6
0,0,12,12,14,19,33,45,36,81,0.000333,0.136199,7,2860.171466,158.898415,408.595924,134.013592,3,6
0,0,12,12,14,21,35,55,40,95,0.000333,0.162427,7,3410.973206,189.498511,487.281887,145.541635,3,6
0,0,13,13,14,20,34,52,48,100,0.000333,0.169582,14,7122.447978,395.691554,508.746284,139.741531,2,6
0,0,12,12,14,19,33,47,43,90,0.000333,0.151332,14,6355.93659,353.107588,453.995471,134.013592,2,6
0,0,8,8,15,18,33,39,30,69,0.000333,0.116021,7,2436.44236,135.357909,348.063194,133.662009,2,6
0,0,13,13,14,18,32,46,48,94,0.000333,0.156667,14,6580,365.555556,470,128.361619,2,6
0,0,7,7,13,11,24,32,26,58,0.000333,0.088643,12,3191.133901,177.285217,265.927825,86.159464,2,6
0,0,5,5,7,10,17,10,14,24,0.000333,0.0327,3,294.297325,16.349851,98.099108,52.870765,1,6
0,0,15,15,19,24,43,72,53,125,0.000333,0.226094,18,12209.0957,678.283094,678.283094,190.749723,3,6
0,0,11,11,18,20,38,54,43,97,0.000333,0.169683,18,9162.881438,509.048969,509.048969,161.497212,2,6
0,0,11,11,19,21,40,59,46,105,0.000333,0.186267,18,10058.4441,558.80245,558.80245,172.949289,2,6
0,0,19,19,22,26,48,84,80,164,0.000333,0.305311,33,30225.81705,1679.212059,915.93385,220.318928,2,6
0,0,16,16,15,22,37,57,58,115,0.000333,0.199696,14,8387.219919,465.956662,599.087137,156.710855,2,6
0,0,12,12,15,23,38,54,61,115,0.000333,0.201171,14,8449.163297,469.397961,603.511664,162.645284,1,6
0,0,14,14,17,22,39,48,45,93,0.000333,0.163847,16,7864.678502,436.926583,491.542406,167.594364,3,6
0,0,11,11,12,20,32,33,33,66,0.000333,0.11,6,1980,110,330,129.458112,2,6
0,0,19,19,17,21,38,60,64,124,0.000333,0.216914,24,15617.83228,867.657349,650.743012,161.725534,2,6
0,0,10,10,15,17,32,38,34,72,0.000333,0.12,14,5040,280,360,128.090227,2,6
0,0,15,15,14,21,35,59,42,101,0.000333,0.172686,14,7252.806186,402.933677,518.057585,145.541635,3,6
0,0,10,10,13,16,29,37,29,66,0.000333,0.106876,6,1923.760474,106.875582,320.626746,112.105716,2,6
0,0,19,19,15,22,37,79,64,143,0.000333,0.248317,14,10429.32564,579.40698,744.951831,156.710855,3,6
0,0,11,11,14,17,31,47,35,82,0.000333,0.135415,14,5687.417364,315.967631,406.244097,122.789837,2,6
0,0,14,14,13,21,34,45,44,89,0.000333,0.150928,12,5433.410314,301.856129,452.784193,140.344382,3,6
0,0,10,10,13,19,32,31,29,60,0.000333,0.1,6,1800,100,300,128.816339,3,6
0,0,13,13,14,20,34,52,48,100,0.000333,0.169582,14,7122.447978,395.691554,508.746284,139.741531,2,6
0,0,12,12,14,19,33,47,43,90,0.000333,0.151332,14,6355.93659,353.107588,453.995471,134.013592,2,6
0,0,17,17,14,22,36,64,72,136,0.000333,0.23437,21,14765.3058,820.294767,703.1098,151.410465,2,6
0,0,14,14,14,20,34,45,44,89,0.000333,0.150928,14,6338.9787,352.165483,452.784193,139.741531,3,6
0,0,10,10,14,18,32,31,29,60,0.000333,0.1,7,2100,116.666667,300,128.361619,3,6
0,0,8,8,13,16,29,33,29,62,0.000333,0.100398,6,1807.16893,100.398274,301.194822,112.105716,2,6
0,0,14,14,12,19,31,53,52,105,0.000333,0.173397,12,6242.287351,346.793742,520.190613,123.730173,2,6
0,0,14,14,12,19,31,53,46,99,0.000333,0.163488,12,5885.585217,326.976956,490.465435,123.730173,2,6
0,0,16,16,16,22,38,63,50,113,0.000333,0.197672,16,9488.252944,527.125164,593.015809,162.107496,3,6
0,0,16,16,13,20,33,65,52,117,0.000333,0.196731,12,7082.329344,393.462741,590.194112,134.544278,2,6
0,0,15,15,16,22,38,60,46,106,0.000333,0.185427,16,8900.485063,494.471392,556.280316,162.107496,3,6
0,0,15,15,17,22,39,54,50,104,0.000333,0.183227,16,8794.909292,488.606072,549.681831,167.594364,3,6
0,0,11,11,16,21,37,40,35,75,0.000333,0.130236,8,3125.672019,173.648446,390.709002,156.238666,3,6
0,0,14,14,14,23,37,42,46,88,0.000333,0.152811,14,6418.046546,356.558141,458.431896,157.344894,2,6
0,0,11,11,13,19,32,33,33,66,0.000333,0.11,6,1980,110,330,128.816339,2,6
0,0,13,13,13,20,33,40,40,80,0.000333,0.134517,12,4842.618355,269.034353,403.55153,134.544278,2,6
0,0,11,11,12,17,29,32,32,64,0.000333,0.103637,6,1865.464702,103.636928,310.910784,112.506418,2,6
0,0,7,7,14,14,28,28,23,51,0.000333,0.081725,7,1716.225707,95.345873,245.175101,106.605938,2,6
0,0,17,17,15,22,37,73,61,134,0.000333,0.232689,14,9772.934514,542.940806,698.066751,156.710855,6,6
0,0,15,15,14,20,34,58,43,101,0.000333,0.171278,14,7193.672458,399.64847,513.833747,139.741531,3,6
0,0,10,10,14,16,30,44,33,77,0.000333,0.125944,14,5289.628062,293.868226,377.830576,117.302969,2,6
0,0,12,12,14,19,33,44,33,77,0.000333,0.129473,7,2718.92843,151.051579,388.418347,134.013592,3,6
0,0,12,12,14,21,35,48,39,87,0.000333,0.148749,7,3123.733357,173.540742,446.247622,145.541635,3,6
0,0,16,16,16,22,38,57,47,104,0.000333,0.181928,16,8732.551382,485.141743,545.784461,162.107496,3,6
0,0,14,14,15,20,35,52,44,96,0.000333,0.164137,14,6893.756375,382.986465,492.41117,145.041921,3,6
0,0,14,14,13,20,33,49,63,112,0.000333,0.188324,18,10169.49855,564.972141,564.972141,134.544278,2,6
0,0,9,9,14,18,32,32,28,60,0.000333,0.1,7,2100,116.666667,300,128.361619,2,6
0,0,14,14,16,19,35,54,42,96,0.000333,0.164137,16,7878.578714,437.698817,492.41117,144.710623,2,6
0,0,13,13,14,19,33,49,46,95,0.000333,0.159739,14,6709.044179,372.724677,479.217441,134.013592,2,6
0,0,18,18,15,24,39,84,54,138,0.000333,0.243129,14,10211.39709,567.299838,729.385506,168.642459,3,6
0,0,11,11,13,17,30,44,35,79,0.000333,0.129215,12,4651.732285,258.429571,387.644357,117.592585,2,6
0,0,13,13,14,20,34,56,65,121,0.000333,0.205194,21,12927.24308,718.180171,615.583004,139.741531,2,6
0,0,8,8,15,16,31,41,29,70,0.000333,0.115598,7,2427.556192,134.864233,346.793742,122.603359,2,6
0,0,18,18,14,21,35,67,66,133,0.000333,0.227398,21,14326.08747,795.893748,682.194641,145.541635,2,6
0,0,10,10,14,16,30,47,35,82,0.000333,0.134122,14,5633.110404,312.950578,402.365029,117.302969,2,6
0,0,7,7,10,13,23,32,24,56,0.000333,0.08444,5,1266.597348,70.366519,253.31947,81.324997,1,6
0,0,19,19,18,23,41,66,67,133,0.000333,0.237518,18,12825.9795,712.554417,712.554417,179.100575,2,6
0,0,8,8,11,15,26,35,26,61,0.000333,0.095576,5,1433.634114,79.64634,286.726823,96.657107,2,6
0,0,18,18,20,27,47,92,62,154,0.000333,0.285136,20,17108.13366,950.45187,855.406683,214.820524,3,6
0,0,11,11,18,20,38,54,43,97,0.000333,0.169683,18,9162.881438,509.048969,509.048969,161.497212,2,6
0,0,15,15,19,24,43,72,53,125,0.000333,0.226094,18,12209.0957,678.283094,678.283094,190.749723,3,6
0,0,11,11,18,20,38,54,43,97,0.000333,0.169683,18,9162.881438,509.048969,509.048969,161.497212,2,6
0,0,8,8,10,15,25,44,31,75,0.000333,0.116096,10,3482.892142,193.494008,348.289214,91.82264,1,6
0,0,9,9,11,17,28,47,33,80,0.000333,0.128196,5,1922.941969,106.830109,384.588394,107.540616,2,6
0,0,11,11,13,19,32,56,36,92,0.000333,0.153333,6,2760,153.333333,460,128.816339,2,6
0,0,13,13,15,17,32,41,42,83,0.000333,0.138333,14,5810,322.777778,415,128.090227,3,6
0,0,13,13,14,19,33,39,41,80,0.000333,0.134517,14,5649.721414,313.873412,403.55153,134.013592,2,6
0,0,14,14,16,20,36,52,46,98,0.000333,0.168884,16,8106.442402,450.357911,506.65265,150.438562,2,6
0,0,14,14,14,22,36,53,46,99,0.000333,0.170608,14,7165.516052,398.084225,511.822575,151.410465,3,6
0,0,14,14,14,22,36,53,46,99,0.000333,0.170608,14,7165.516052,398.084225,511.822575,151.410465,3,6
0,0,16,16,15,23,38,66,61,127,0.000333,0.222162,14,9330.815119,518.378618,666.486794,162.645284,2,6
0,0,9,9,15,16,31,38,34,72,0.000333,0.118901,14,4993.829881,277.434993,356.702134,122.603359,2,6
0,0,14,14,14,19,33,53,51,104,0.000333,0.174872,14,7344.637838,408.035435,524.616988,134.013592,2,6
0,0,15,15,16,19,35,58,47,105,0.000333,0.179525,16,8617.195468,478.733082,538.574717,144.710623,2,6
0,0,10,10,11,17,28,46,34,80,0.000333,0.128196,10,3845.883938,213.660219,384.588394,107.540616,2,6
0,0,16,16,15,22,37,52,47,99,0.000333,0.171912,14,7220.302365,401.127909,515.735883,156.710855,3,6
0,0,12,12,14,20,34,38,32,70,0.000333,0.118707,7,2492.856792,138.492044,356.122399,139.741531,3,6
0,0,16,16,17,20,37,61,48,109,0.000333,0.189277,16,9085.28667,504.738148,567.830417,155.92543,3,6
0,0,16,16,16,20,36,60,57,117,0.000333,0.201627,16,9678.099603,537.6722,604.881225,150.438562,3,6
0,0,15,15,15,22,37,55,51,106,0.000333,0.184067,14,7730.828795,429.490489,552.202057,156.710855,2,6
0,0,11,11,14,19,33,46,36,82,0.000333,0.13788,7,2895.482225,160.860124,413.640318,134.013592,2,6
0,0,10,10,14,18,32,41,31,72,0.000333,0.12,7,2520,140,360,128.361619,2,6
0,0,16,16,14,21,35,69,47,116,0.000333,0.198332,14,8329.95562,462.775312,594.99683,145.541635,3,6
0,0,11,11,14,17,31,47,35,82,0.000333,0.135415,14,5687.417364,315.967631,406.244097,122.789837,2,6
0,0,14,14,14,21,35,45,44,89,0.000333,0.152169,14,6391.086639,355.060369,456.506189,145.541635,3,6
0,0,10,10,14,19,33,31,29,60,0.000333,0.100888,7,2118.64553,117.702529,302.663647,134.013592,3,6
0,0,20,20,14,21,35,84,67,151,0.000333,0.258174,21,16264.95645,903.608691,774.521736,145.541635,2,6
0,0,10,10,14,16,30,49,34,83,0.000333,0.135757,14,5701.806872,316.767048,407.271919,117.302969,2,6
0,0,15,15,16,22,38,56,55,111,0.000333,0.194173,16,9320.319264,517.795515,582.519954,162.107496,5,6
0,0,15,15,14,24,38,54,54,108,0.000333,0.188925,14,7934.8664,440.825911,566.776171,163.342069,4,6
0,0,10,10,13,18,31,41,33,74,0.000333,0.122204,6,2199.663162,122.203509,366.610527,123.164366,2,6
0,0,15,15,18,21,39,57,47,104,0.000333,0.183227,18,9894.272954,549.681831,549.681831,167.297316,4,6
0,0,15,15,16,23,39,55,46,101,0.000333,0.177942,16,8541.209986,474.511666,533.825624,168.041925,3,6
0,0,10,10,13,20,33,46,42,88,0.000333,0.147969,12,5326.88019,295.937788,443.906683,134.544278,2,6
0,0,16,16,15,19,34,75,51,126,0.000333,0.213673,14,8974.284452,498.571358,641.020318,139.313982,3,6
0,0,10,10,14,15,29,44,32,76,0.000333,0.123069,14,5168.891779,287.160654,369.206556,111.906328,2,6
0,0,8,8,12,16,28,40,28,68,0.000333,0.108967,6,1961.400808,108.966712,326.900135,107.01955,2,6
0,0,15,15,14,20,34,66,46,112,0.000333,0.189932,14,7977.141735,443.174541,569.795838,139.741531,2,6
0,0,11,11,14,17,31,47,35,82,0.000333,0.135415,14,5687.417364,315.967631,406.244097,122.789837,2,6
0,0,16,16,14,21,35,69,47,116,0.000333,0.198332,14,8329.95562,462.775312,594.99683,145.541635,3,6
0,0,11,11,14,17,31,47,35,82,0.000333,0.135415,14,5687.417364,315.967631,406.244097,122.789837,2,6
0,0,17,17,14,22,36,65,73,138,0.000333,0.237817,21,14982.44265,832.357925,713.44965,151.410465,2,6
0,0,12,12,14,20,34,49,38,87,0.000333,0.147536,7,3098.26487,172.125826,442.609267,139.741531,3,6
0,0,11,11,14,19,33,44,33,77,0.000333,0.129473,7,2718.92843,151.051579,388.418347,134.013592,3,6
0,0,13,13,13,20,33,46,47,93,0.000333,0.156376,12,5629.543837,312.752435,469.128653,134.544278,2,6
0,0,12,12,15,18,33,47,38,85,0.000333,0.142925,14,6002.829002,333.4905,428.7735,133.662009,3,6
0,0,19,19,14,21,35,74,54,128,0.000333,0.218849,14,9191.675166,510.64862,656.548226,145.541635,3,6
0,0,10,10,13,15,28,41,32,73,0.000333,0.116979,12,4211.242912,233.95794,350.936909,106.709075,2,6
0,0,15,15,14,20,34,57,41,98,0.000333,0.16619,14,6979.999018,387.777723,498.571358,139.741531,3,6
0,0,15,15,14,21,35,58,42,100,0.000333,0.170976,14,7180.996224,398.944235,512.928302,145.541635,3,6
0,0,12,12,13,17,30,46,37,83,0.000333,0.135757,12,4887.263033,271.514613,407.271919,117.592585,2,6
0,0,16,16,13,19,32,63,49,112,0.000333,0.186667,12,6720,373.333333,560,128.816339,3,6
0,0,10,10,13,15,28,41,32,73,0.000333,0.116979,12,4211.242912,233.95794,350.936909,106.709075,2,6
0,0,13,13,13,19,32,49,39,88,0.000333,0.146667,12,5280,293.333333,440,128.816339,3,6
0,0,11,11,13,17,30,44,35,79,0.000333,0.129215,12,4651.732285,258.429571,387.644357,117.592585,2,6
0,0,15,15,13,17,30,60,47,107,0.000333,0.175012,12,6300.447525,350.024862,525.037294,117.592585,2,6
0,0,10,10,13,15,28,41,32,73,0.000333,0.116979,12,4211.242912,233.95794,350.936909,106.709075,2,6
0,0,12,12,13,17,30,46,37,83,0.000333,0.135757,12,4887.263033,271.514613,407.271919,117.592585,2,6
0,0,11,11,13,17,30,44,35,79,0.000333,0.129215,12,4651.732285,258.429571,387.644357,117.592585,2,6
0,0,10,10,13,17,30,41,32,73,0.000333,0.119401,6,2149.218081,119.401004,358.203013,117.592585,2,6
0,0,15,15,16,23,39,54,49,103,0.000333,0.181465,16,8710.342857,483.907936,544.396429,168.041925,4,6
0,0,10,10,12,17,29,31,29,60,0.000333,0.09716,6,1748.873158,97.15962,291.47886,112.506418,3,6
0,0,15,15,16,22,38,54,48,102,0.000333,0.17843,16,8564.617702,475.812095,535.288606,162.107496,4,6
0,0,10,10,12,17,29,31,28,59,0.000333,0.09554,6,1719.725272,95.540293,286.620879,112.506418,3,6
0,0,14,14,14,21,35,63,47,110,0.000333,0.188074,14,7899.095846,438.838658,564.221132,145.541635,6,6
0,0,14,14,14,21,35,63,47,110,0.000333,0.188074,14,7899.095846,438.838658,564.221132,145.541635,6,6
0,0,15,15,14,22,36,66,49,115,0.000333,0.19818,14,8323.579252,462.42107,594.541375,151.410465,6,6
0,0,10,10,13,20,33,46,42,88,0.000333,0.147969,12,5326.88019,295.937788,443.906683,134.544278,2,6
0,0,17,17,15,21,36,68,53,121,0.000333,0.20852,14,8757.852952,486.547386,625.560925,150.842025,2,6
0,0,10,10,13,17,30,41,31,72,0.000333,0.117765,6,2119.776737,117.765374,353.296123,117.592585,2,6
0,0,11,11,14,20,34,52,39,91,0.000333,0.15432,7,3240.71383,180.039657,462.959119,139.741531,2,6
0,0,17,17,13,22,35,58,71,129,0.000333,0.220559,18,11910.19517,661.677509,661.677509,146.213212,2,6
0,0,15,15,13,21,34,52,59,111,0.000333,0.188236,12,6776.500505,376.47225,564.708375,140.344382,2,6
0,0,9,9,12,17,29,29,28,57,0.000333,0.092302,6,1661.4295,92.301639,276.904917,112.506418,2,6
0,0,19,19,17,39,56,96,68,164,0.000333,0.317469,8,7619.249658,423.291648,952.406207,275.617555,11,6
0,0,22,22,17,40,57,106,73,179,0.000333,0.348029,8,8352.6985,464.038806,1044.087313,282.363992,12,6
0,0,24,24,17,40,57,112,75,187,0.000333,0.363583,8,8726.003461,484.77797,1090.750433,282.363992,13,6
0,0,28,28,19,43,62,131,86,217,0.000333,0.430687,18,23257.09079,1292.060599,1292.060599,314.040007,14,6
0,0,3,3,10,13,23,15,15,30,0.000333,0.045236,5,678.534293,37.69635,135.706859,81.324997,1,6
0,0,12,12,13,21,34,43,37,80,0.000333,0.135666,6,2441.982164,135.665676,406.997027,140.344382,3,6
0,0,11,11,13,20,33,38,32,70,0.000333,0.117703,6,2118.64553,117.702529,353.107588,134.544278,3,6
0,0,11,11,13,19,32,40,35,75,0.000333,0.125,6,2250,125,375,128.816339,2,6
0,0,10,10,13,18,31,35,30,65,0.000333,0.107341,6,1932.136561,107.34092,322.02276,123.164366,2,6
0,0,12,12,13,19,32,43,36,79,0.000333,0.131667,6,2370,131.666667,395,128.816339,3,6
0,0,11,11,13,18,31,38,31,69,0.000333,0.113947,6,2051.037273,113.946515,341.839545,123.164366,3,6
0,0,14,14,17,23,40,57,53,110,0.000333,0.195137,16,9366.593447,520.366303,585.41209,173.528793,2,6
0,0,17,17,18,27,45,77,64,141,0.000333,0.258117,18,13938.32316,774.351287,774.351287,203.440613,2,6
0,0,11,11,18,20,38,54,43,97,0.000333,0.169683,18,9162.881438,509.048969,509.048969,161.497212,2,6
0,0,11,11,19,17,36,58,42,100,0.000333,0.172331,18,9305.865003,516.9925,516.9925,150.197491,2,6
0,0,16,16,18,24,42,75,64,139,0.000333,0.249844,18,13491.57819,749.532122,749.532122,185.09775,2,6
0,0,11,11,18,20,38,57,45,102,0.000333,0.17843,18,9635.194915,535.288606,535.288606,161.497212,2,6
0,0,13,13,15,20,35,51,41,92,0.000333,0.157298,14,6606.516526,367.028696,471.894038,145.041921,2,6
0,0,14,14,14,20,34,58,52,110,0.000333,0.18654,14,7834.692776,435.26071,559.620913,139.741531,2,6
0,0,14,14,15,20,35,59,43,102,0.000333,0.174396,14,7324.616148,406.923119,523.186868,145.041921,2,6
0,0,12,12,13,19,32,54,40,94,0.000333,0.156667,12,5640,313.333333,470,128.816339,1,6
0,0,9,9,12,19,31,31,30,61,0.000333,0.100735,6,1813.23585,100.735325,302.205975,123.730173,2,6
0,0,9,9,12,19,31,31,30,61,0.000333,0.100735,6,1813.23585,100.735325,302.205975,123.730173,2,6
0,0,9,9,12,19,31,31,30,61,0.000333,0.100735,6,1813.23585,100.735325,302.205975,123.730173,2,6
0,0,3,3,12,14,26,18,19,37,0.000333,0.057972,6,1043.497617,57.97209,173.91627,96.322519,1,6
0,0,18,18,13,22,35,66,56,122,0.000333,0.208591,12,7509.270337,417.181685,625.772528,146.213212,2,6
0,0,9,9,13,16,29,39,29,68,0.000333,0.110114,6,1982.056246,110.114236,330.342708,112.105716,2,6
0,0,16,16,17,21,38,65,47,112,0.000333,0.195923,16,9404.286104,522.460339,587.767882,161.725534,3,6
0,0,10,10,13,16,29,37,29,66,0.000333,0.106876,6,1923.760474,106.875582,320.626746,112.105716,2,6
0,0,15,15,15,20,35,59,41,100,0.000333,0.170976,14,7180.996224,398.944235,512.928302,145.041921,3,6
0,0,10,10,13,16,29,37,29,66,0.000333,0.106876,6,1923.760474,106.875582,320.626746,112.105716,2,6
0,0,15,15,17,21,38,63,46,109,0.000333,0.190675,16,9152.385583,508.465866,572.024099,161.725534,3,6
0,0,9,9,13,15,28,34,27,61,0.000333,0.09775,6,1759.491901,97.74955,293.24865,106.709075,2,6
0,0,13,13,14,19,33,54,39,93,0.000333,0.156376,14,6567.801143,364.877841,469.128653,134.013592,2,6
0,0,9,9,13,15,28,34,27,61,0.000333,0.09775,6,1759.491901,97.74955,293.24865,106.709075,2,6
0,0,15,15,15,20,35,63,45,108,0.000333,0.184654,14,7755.475922,430.859773,553.962566,145.041921,2,6
0,0,9,9,13,15,28,34,27,61,0.000333,0.09775,6,1759.491901,97.74955,293.24865,106.709075,2,6
0,0,10,10,13,14,27,36,30,66,0.000333,0.104608,12,3765.870902,209.21505,313.822575,101.408685,3,6
0,0,10,10,13,16,29,34,29,63,0.000333,0.102018,6,1836.316816,102.017601,306.052803,112.105716,2,6
0,0,12,12,13,15,28,42,32,74,0.000333,0.118581,12,4268.931171,237.162843,355.744264,106.709075,5,6
0,0,12,12,13,17,30,40,31,71,0.000333,0.11613,6,2090.335394,116.129744,348.389232,117.592585,4,6
0,0,12,12,13,15,28,42,32,74,0.000333,0.118581,12,4268.931171,237.162843,355.744264,106.709075,5,6
0,0,12,12,13,17,30,40,31,71,0.000333,0.11613,6,2090.335394,116.129744,348.389232,117.592585,4,6
0,0,16,16,15,15,30,52,38,90,0.000333,0.147207,14,6182.68215,343.482342,441.620154,117.206718,5,6
0,0,16,16,15,17,32,50,37,87,0.000333,0.145,14,6090,338.333333,435,128.090227,4,6
0,0,17,17,15,22,37,76,60,136,0.000333,0.236162,14,9918.799208,551.0444,708.485658,156.710855,2,6
0,0,10,10,14,17,31,48,35,83,0.000333,0.137066,14,5756.776113,319.820895,411.198294,122.789837,2,6
0,0,11,11,14,17,31,47,39,86,0.000333,0.14202,14,5964.852358,331.380687,426.060883,122.789837,2,6
0,0,10,10,14,16,30,44,33,77,0.000333,0.125944,14,5289.628062,293.868226,377.830576,117.302969,2,6
0,0,19,19,15,24,39,77,72,149,0.000333,0.262508,21,16538.02354,918.779086,787.524931,168.642459,2,6
0,0,10,10,14,18,32,46,38,84,0.000333,0.14,14,5880,326.666667,420,128.361619,2,6
0,0,11,11,10,17,27,49,45,94,0.000333,0.148986,10,4469.594252,248.310792,446.959425,102.706149,1,6
0,0,10,10,9,15,24,37,54,91,0.000333,0.139077,12,5006.779051,278.154392,417.231588,87.132684,1,6
0,0,15,15,10,19,29,61,69,130,0.000333,0.210513,15,9473.06294,526.281274,631.537529,113.929904,1,6
0,0,14,14,16,20,36,54,41,95,0.000333,0.163714,16,7858.286002,436.571445,491.142875,150.438562,6,6
0,0,14,14,14,22,36,52,40,92,0.000333,0.158544,7,3329.431701,184.968428,475.6331,151.410465,5,6
0,0,10,10,11,21,32,39,31,70,0.000333,0.116667,5,1750,97.222222,350,130.292414,4,6
0,0,11,11,11,21,32,40,33,73,0.000333,0.121667,5,1825,101.388889,365,130.292414,4,6
0,0,42,42,28,52,80,161,131,292,0.000333,0.615334,28,51688.0841,2871.560228,1846.003004,431.028803,11,6
0,0,42,42,26,54,80,159,130,289,0.000333,0.609012,26,47502.96771,2639.053761,1827.037219,432.975358,10,6
0,0,3,3,10,14,24,15,15,30,0.000333,0.04585,5,687.744375,38.208021,137.548875,86.52225,1,6
0,0,16,16,14,21,35,67,51,118,0.000333,0.201752,14,8473.575544,470.754197,605.255396,145.541635,2,6
0,0,10,10,13,16,29,41,33,74,0.000333,0.11983,12,4313.887124,239.660396,359.490594,112.105716,2,6
0,0,10,10,14,13,27,45,32,77,0.000333,0.122042,14,5125.768727,284.764929,366.126338,101.408685,2,6
0,0,9,9,15,19,34,49,34,83,0.000333,0.140753,7,2955.815911,164.211995,422.259416,139.313982,5,6
0,0,8,8,15,17,32,47,30,77,0.000333,0.128333,7,2695,149.722222,385,128.090227,5,6
0,0,7,7,12,11,23,32,20,52,0.000333,0.078408,6,1411.35133,78.408407,235.225222,81.073298,4,6
0,0,30,30,23,47,70,130,113,243,0.000333,0.496472,22,32767.14701,1820.397056,1489.415773,365.107601,9,6
0,0,30,30,21,49,70,128,112,240,0.000333,0.490343,20,29420.55848,1634.475471,1471.027924,367.359448,8,6
0,0,28,28,24,46,70,126,95,221,0.000333,0.451524,24,32509.71712,1806.095396,1354.571547,364.12295,9,6
0,0,28,28,22,48,70,124,94,218,0.000333,0.445395,11,14698.02068,816.556704,1336.183698,366.185696,8,6
0,0,26,26,20,47,67,115,88,203,0.000333,0.410472,10,12314.16106,684.120059,1231.416106,347.504238,8,6
0,0,25,25,20,47,67,114,86,200,0.000333,0.404406,10,12132.17838,674.00991,1213.217838,347.504238,8,6
0,0,29,29,25,46,71,129,97,226,0.000333,0.463281,24,33356.22838,1853.123799,1389.842849,370.180255,9,6
0,0,29,29,23,48,71,127,96,223,0.000333,0.457131,22,30170.65937,1676.147743,1371.393608,372.120125,8,6
0,0,7,7,14,10,24,31,23,54,0.000333,0.082529,14,3466.231651,192.568425,247.587975,86.52225,3,6
0,0,7,7,13,12,25,29,22,51,0.000333,0.078946,6,1421.019994,78.945555,236.836666,91.125266,2,6
0,0,6,6,12,14,26,30,25,55,0.000333,0.086175,6,1551.145107,86.174728,258.524184,96.322519,1,6
0,0,6,6,12,15,27,30,26,56,0.000333,0.088758,6,1597.642201,88.7579,266.2737,101.622909,1,6
0,0,6,6,10,13,23,24,25,49,0.000333,0.073885,5,1108.272679,61.570704,221.654536,81.324997,1,6
0,0,5,5,9,12,21,21,19,40,0.000333,0.058564,4,702.770788,39.042822,175.692697,71.548875,1,6
0,0,11,11,10,15,25,42,57,99,0.000333,0.153247,15,6896.126442,383.118136,459.741763,91.82264,1,6
0,0,5,5,10,12,22,24,21,45,0.000333,0.066891,5,1003.372114,55.742895,200.674423,76.238831,1,6
0,0,17,17,18,27,45,70,62,132,0.000333,0.241642,18,13048.64296,724.924609,724.924609,203.440613,3,6
0,0,16,16,17,24,41,68,62,130,0.000333,0.232161,16,11143.70817,619.094898,696.481761,179.525968,3,6
0,0,11,11,17,22,39,45,40,85,0.000333,0.149753,8,3594.073509,199.67075,449.259189,167.594364,3,6
0,0,31,31,23,51,74,139,103,242,0.000333,0.500896,22,33059.12972,1836.618318,1502.687714,393.335617,13,6
0,0,31,31,21,53,74,137,102,239,0.000333,0.494686,10,14840.59354,824.477419,1484.059354,395.81845,12,6
0,0,28,28,19,52,71,125,94,219,0.000333,0.448932,9,12121.15157,673.39731,1346.794619,377.133488,11,6
0,0,27,27,19,52,71,124,92,216,0.000333,0.442782,9,11955.1084,664.172689,1328.345378,377.133488,11,6
0,0,32,32,24,51,75,142,106,248,0.000333,0.514916,24,37073.92885,2059.662714,1544.747035,399.332792,12,6
0,0,32,32,22,53,75,140,105,245,0.000333,0.508687,11,16786.66637,932.592576,1526.060579,401.68728,11,6
0,0,29,29,20,51,71,128,98,226,0.000333,0.463281,10,13898.42849,772.134916,1389.842849,375.732254,10,6
0,0,28,28,20,51,71,127,96,223,0.000333,0.457131,10,13713.93608,761.885338,1371.393608,375.732254,10,6
0,0,13,13,15,19,34,52,40,92,0.000333,0.156016,14,6552.65214,364.03623,468.046581,139.313982,2,6
0,0,19,19,18,23,41,72,70,142,0.000333,0.253591,27,20540.85439,1141.158577,760.772385,179.100575,2,6
0,0,8,8,15,19,34,43,32,75,0.000333,0.127187,7,2670.917992,148.384333,381.559713,139.313982,2,6
0,0,3,3,5,6,11,8,8,16,0.000333,0.01845,2,110.701812,6.150101,55.350906,27.119415,1,6
0,0,12,12,13,19,32,39,33,72,0.000333,0.12,6,2160,120,360,128.816339,3,6
0,0,11,11,12,17,29,34,28,62,0.000333,0.100398,6,1807.16893,100.398274,301.194822,112.506418,3,6
0,0,12,12,13,19,32,39,34,73,0.000333,0.121667,6,2190,121.666667,365,128.816339,3,6
0,0,11,11,12,17,29,34,29,63,0.000333,0.102018,6,1836.316816,102.017601,306.052803,112.506418,3,6
0,0,12,12,13,20,33,39,34,73,0.000333,0.122747,6,2209.444624,122.746924,368.240771,134.544278,3,6
0,0,11,11,12,18,30,34,29,63,0.000333,0.103045,6,1854.804645,103.044703,309.134108,118.0782,3,6
0,0,12,12,13,19,32,39,33,72,0.000333,0.12,6,2160,120,360,128.816339,3,6
0,0,11,11,12,17,29,34,28,62,0.000333,0.100398,6,1807.16893,100.398274,301.194822,112.506418,3,6
0,0,14,14,17,24,41,62,55,117,0.000333,0.208945,16,10029.33735,557.185408,626.833585,179.525968,2,6
0,0,7,7,14,18,32,34,29,63,0.000333,0.105,7,2205,122.5,315,128.361619,2,6
0,0,11,11,14,20,34,52,39,91,0.000333,0.15432,7,3240.71383,180.039657,462.959119,139.741531,2,6
0,0,12,12,13,20,33,39,34,73,0.000333,0.122747,6,2209.444624,122.746924,368.240771,134.544278,3,6
0,0,11,11,12,18,30,34,29,63,0.000333,0.103045,6,1854.804645,103.044703,309.134108,118.0782,3,6
0,0,10,10,12,17,29,43,31,74,0.000333,0.11983,6,2156.943562,119.830198,359.490594,112.506418,2,6
0,0,5,5,9,12,21,21,19,40,0.000333,0.058564,4,702.770788,39.042822,175.692697,71.548875,1,6
0,0,11,11,11,17,28,46,36,82,0.000333,0.131401,10,3942.031036,219.001724,394.203104,107.540616,1,6
0,0,5,5,9,12,21,21,19,40,0.000333,0.058564,4,702.770788,39.042822,175.692697,71.548875,1,6
0,0,12,12,13,15,28,42,32,74,0.000333,0.118581,12,4268.931171,237.162843,355.744264,106.709075,5,6
0,0,12,12,13,17,30,40,31,71,0.000333,0.11613,6,2090.335394,116.129744,348.389232,117.592585,4,6
0,0,15,15,14,20,34,60,49,109,0.000333,0.184844,14,7763.468296,431.303794,554.53345,139.741531,2,6
0,0,9,9,13,15,28,37,29,66,0.000333,0.105762,6,1903.712549,105.761808,317.285425,106.709075,2,6
0,0,10,10,12,17,29,41,33,74,0.000333,0.11983,6,2156.943562,119.830198,359.490594,112.506418,1,6
0,0,14,14,14,19,33,54,51,105,0.000333,0.176554,14,7415.259355,411.958853,529.661383,134.013592,2,6
0,0,12,12,10,17,27,56,55,111,0.000333,0.175931,15,7916.887691,439.827094,527.792513,102.706149,1,6
0,0,11,11,11,17,28,56,46,102,0.000333,0.16345,10,4903.50202,272.416779,490.350202,107.540616,1,6
0,0,13,13,11,19,30,57,58,115,0.000333,0.188097,15,8464.386277,470.243682,564.292418,118.764371,1,6
0,0,14,14,15,22,37,57,47,104,0.000333,0.180594,14,7584.9641,421.386894,541.78315,156.710855,3,6
0,0,14,14,14,22,36,57,47,104,0.000333,0.179224,14,7527.410802,418.189489,537.6722,151.410465,3,6
0,0,18,18,18,26,44,80,67,147,0.000333,0.267512,18,14445.65606,802.536448,802.536448,197.270083,3,6
0,0,15,15,12,20,32,61,69,130,0.000333,0.216667,18,11700,650,650,129.458112,1,6
0,0,15,15,13,21,34,62,73,135,0.000333,0.228936,18,12362.5347,686.807484,686.807484,140.344382,1,6
0,0,11,11,12,18,30,49,45,94,0.000333,0.153749,12,5534.972592,307.498477,461.247716,118.0782,1,6
0,0,11,11,13,19,32,50,45,95,0.000333,0.158333,12,5700,316.666667,475,128.816339,1,6
0,0,14,14,15,18,33,58,42,100,0.000333,0.168146,14,7062.151767,392.341765,504.439412,133.662009,4,6
0,0,21,21,17,17,34,85,58,143,0.000333,0.242502,24,17460.17247,970.009582,727.507186,138.973737,8,6
0,0,19,19,16,19,35,74,50,124,0.000333,0.21201,16,10176.49751,565.360973,636.031094,144.710623,6,6
0,0,16,16,16,17,33,58,40,98,0.000333,0.164784,16,7909.609979,439.422777,494.350624,133.486868,5,6
0,0,21,21,16,19,35,80,55,135,0.000333,0.230818,16,11079.25132,615.513962,692.453207,144.710623,6,6
0,0,10,10,13,20,33,37,38,75,0.000333,0.12611,6,2269.977354,126.109853,378.329559,134.544278,2,6
0,0,9,9,11,20,31,31,33,64,0.000333,0.10569,5,1585.342819,88.074601,317.068564,124.49231,2,6
0,0,9,9,12,18,30,34,36,70,0.000333,0.114494,12,4121.7881,228.988228,343.482342,118.0782,1,6
0,0,8,8,10,18,28,28,31,59,0.000333,0.094545,5,1418.169702,78.787206,283.63394,108.277931,1,6
0,0,14,14,17,23,40,51,61,112,0.000333,0.198685,16,9536.895146,529.827508,596.055947,173.528793,2,6
0,0,12,12,14,21,35,50,37,87,0.000333,0.148749,7,3123.733357,173.540742,446.247622,145.541635,3,6
0,0,14,14,15,21,36,54,39,93,0.000333,0.160268,7,3365.621176,186.978954,480.803025,150.842025,3,6
0,0,16,16,15,24,39,76,49,125,0.000333,0.220225,14,9249.453883,513.858549,660.675277,168.642459,3,6
0,0,12,12,14,21,35,50,37,87,0.000333,0.148749,7,3123.733357,173.540742,446.247622,145.541635,3,6
0,0,14,14,12,23,35,64,68,132,0.000333,0.225688,12,8124.784299,451.376905,677.065358,147.061475,1,6
0,0,14,14,13,23,36,56,73,129,0.000333,0.222307,18,12004.56585,666.920325,666.920325,152.147641,1,6
0,0,12,12,12,19,31,48,75,123,0.000333,0.203122,18,10968.59063,609.366146,609.366146,123.730173,1,6
0,0,13,13,13,22,35,64,65,129,0.000333,0.220559,12,7940.13011,441.118339,661.677509,146.213212,1,6
0,0,17,17,16,21,37,62,52,114,0.000333,0.197959,16,9502.042939,527.891274,593.877684,156.238666,2,6
0,0,14,14,14,20,34,57,41,98,0.000333,0.16619,14,6979.999018,387.777723,498.571358,139.741531,3,6
0,0,9,9,13,15,28,34,27,61,0.000333,0.09775,6,1759.491901,97.74955,293.24865,106.709075,2,6
0,0,14,14,14,19,33,57,40,97,0.000333,0.163102,14,6850.287214,380.571512,489.30623,134.013592,3,6
0,0,9,9,13,15,28,34,27,61,0.000333,0.09775,6,1759.491901,97.74955,293.24865,106.709075,2,6
0,0,16,16,17,23,40,65,54,119,0.000333,0.211103,16,10132.95109,562.941727,633.309443,173.528793,2,6
0,0,14,14,15,18,33,58,42,100,0.000333,0.168146,14,7062.151767,392.341765,504.439412,133.662009,4,6
0,0,38,38,26,48,74,173,119,292,0.000333,0.604387,26,47142.16995,2619.009442,1813.160383,390.289633,14,6
0,0,36,36,24,50,74,162,111,273,0.000333,0.56506,24,40684.33845,2260.241025,1695.180769,392.23191,12,6
0,0,33,33,24,48,72,146,101,247,0.000333,0.50799,24,36575.31541,2031.961967,1523.971475,378.1173,11,6
0,0,38,38,24,50,74,168,116,284,0.000333,0.587828,24,42323.63414,2351.313008,1763.484756,392.23191,12,6
0,0,32,32,22,49,71,145,103,248,0.000333,0.508379,22,33553.02028,1864.056682,1525.137286,373.228278,11,6
0,0,31,31,22,49,71,144,101,245,0.000333,0.502229,22,33147.13697,1841.50761,1506.688044,373.228278,11,6
0,0,14,14,14,21,35,57,41,98,0.000333,0.167557,7,3518.68815,195.482675,502.669736,145.541635,3,6
0,0,9,9,13,15,28,34,27,61,0.000333,0.09775,6,1759.491901,97.74955,293.24865,106.709075,2,6
0,0,9,9,14,13,27,38,27,65,0.000333,0.103023,14,4326.947627,240.385979,309.067688,101.408685,2,6
0,0,13,13,18,21,39,58,48,106,0.000333,0.186751,18,10084.54743,560.252635,560.252635,167.297316,2,6
0,0,10,10,18,19,37,51,41,92,0.000333,0.159757,18,8626.854773,479.26971,479.26971,155.769273,2,6
0,0,8,8,14,19,33,36,30,66,0.000333,0.110977,7,2330.510083,129.472782,332.930012,134.013592,1,6
0,0,8,8,11,14,25,24,21,45,0.000333,0.069658,5,1044.867643,58.048202,208.973529,91.356717,2,6
0,0,8,8,11,14,25,24,21,45,0.000333,0.069658,5,1044.867643,58.048202,208.973529,91.356717,2,6
0,0,8,8,11,14,25,24,21,45,0.000333,0.069658,5,1044.867643,58.048202,208.973529,91.356717,2,6
0,0,26,26,19,49,68,115,86,201,0.000333,0.40786,9,11012.22028,611.790016,1223.580031,355.831405,9,6
0,0,25,25,19,49,68,114,84,198,0.000333,0.401773,9,10847.85878,602.658821,1205.317643,355.831405,9,6
0,0,15,15,14,23,37,61,64,125,0.000333,0.217061,14,9116.54339,506.474633,651.181671,157.344894,2,6
0,0,9,9,12,16,28,43,31,74,0.000333,0.118581,6,2134.465585,118.581421,355.744264,107.01955,2,6
0,0,14,14,13,19,32,48,37,85,0.000333,0.141667,6,2550,141.666667,425,128.816339,3,6
0,0,9,9,13,15,28,34,27,61,0.000333,0.09775,6,1759.491901,97.74955,293.24865,106.709075,2,6
0,0,11,11,12,16,28,34,27,61,0.000333,0.09775,6,1759.491901,97.74955,293.24865,107.01955,3,6
0,0,9,9,11,14,25,38,28,66,0.000333,0.102165,10,3064.945085,170.274727,306.494509,91.356717,2,6
0,0,9,9,11,15,26,38,28,66,0.000333,0.10341,5,1551.145107,86.174728,310.229021,96.657107,2,6
0,0,9,9,11,15,26,38,28,66,0.000333,0.10341,5,1551.145107,86.174728,310.229021,96.657107,2,6
0,0,11,11,13,18,31,47,32,79,0.000333,0.130461,6,2348.289051,130.460503,391.381509,123.164366,2,6
0,0,15,15,12,22,34,61,86,147,0.000333,0.249286,18,13461.42668,747.857038,747.857038,141.127046,1,6
0,0,15,15,15,21,36,74,48,122,0.000333,0.210244,14,8830.231902,490.568439,630.73085,150.842025,6,6
0,0,15,15,15,21,36,74,48,122,0.000333,0.210244,14,8830.231902,490.568439,630.73085,150.842025,6,6
0,0,15,15,15,21,36,74,48,122,0.000333,0.210244,14,8830.231902,490.568439,630.73085,150.842025,6,6
0,0,23,23,18,47,65,117,83,200,0.000333,0.401491,9,10840.26206,602.236781,1204.473563,336.124326,11,6
0,0,26,26,18,48,66,127,88,215,0.000333,0.433182,9,11695.90262,649.772368,1299.544736,343.13685,12,6
0,0,28,28,18,48,66,133,90,223,0.000333,0.4493,9,12131.099,673.949944,1347.899889,343.13685,13,6
0,0,32,32,20,51,71,152,101,253,0.000333,0.518629,10,15558.86021,864.381123,1555.886021,375.732254,14,6
0,0,14,14,13,18,31,48,37,85,0.000333,0.140369,12,5053.280237,280.737791,421.106686,123.164366,3,6
0,0,9,9,13,15,28,34,27,61,0.000333,0.09775,6,1759.491901,97.74955,293.24865,106.709075,2,6
0,0,11,11,12,16,28,34,27,61,0.000333,0.09775,6,1759.491901,97.74955,293.24865,107.01955,3,6
0,0,11,11,13,18,31,49,46,95,0.000333,0.156883,12,5647.783794,313.765766,470.648649,123.164366,1,6
0,0,4,4,12,11,23,22,20,42,0.000333,0.06333,6,1139.937613,63.329867,189.989602,81.073298,1,6
0,0,12,12,13,18,31,51,37,88,0.000333,0.145323,12,5231.631304,290.646184,435.969275,123.164366,2,6
0,0,10,10,11,17,28,46,34,80,0.000333,0.128196,10,3845.883938,213.660219,384.588394,107.540616,2,6
0,0,8,8,15,15,30,42,28,70,0.000333,0.114494,7,2404.376392,133.576466,343.482342,117.206718,2,6
0,0,15,15,17,22,39,64,48,112,0.000333,0.197322,16,9471.440776,526.191154,591.965049,167.594364,3,6
0,0,9,9,13,16,29,35,29,64,0.000333,0.103637,6,1865.464702,103.636928,310.910784,112.105716,2,6
0,0,11,11,13,18,31,49,46,95,0.000333,0.156883,12,5647.783794,313.765766,470.648649,123.164366,1,6
0,0,17,17,14,23,37,70,75,145,0.000333,0.25179,21,15862.7855,881.265861,755.370738,157.344894,2,6
0,0,14,14,15,22,37,64,54,118,0.000333,0.204905,14,8606.01696,478.112053,614.715497,156.710855,2,6
0,0,10,10,12,17,29,43,32,75,0.000333,0.12145,6,2186.091448,121.449525,364.348575,112.506418,2,6
0,0,5,5,9,12,21,21,19,40,0.000333,0.058564,4,702.770788,39.042822,175.692697,71.548875,1,6
0,0,15,15,14,21,35,67,46,113,0.000333,0.193203,14,8114.525733,450.806985,579.608981,145.541635,3,6
0,0,10,10,14,16,30,44,33,77,0.000333,0.125944,14,5289.628062,293.868226,377.830576,117.302969,2,6
0,0,8,8,12,16,28,33,31,64,0.000333,0.102557,6,1846.02429,102.556905,307.670715,107.01955,1,6
0,0,9,9,11,16,27,43,31,74,0.000333,0.117287,5,1759.308376,97.739354,351.861675,102.053748,2,6
0,0,9,9,11,16,27,43,31,74,0.000333,0.117287,5,1759.308376,97.739354,351.861675,102.053748,2,6
0,0,9,9,11,17,28,43,32,75,0.000333,0.120184,5,1802.758096,100.153228,360.551619,107.540616,2,6
0,0,12,12,13,18,31,48,35,83,0.000333,0.137066,6,2467.189763,137.066098,411.198294,123.164366,2,6
0,0,5,5,9,12,21,21,19,40,0.000333,0.058564,4,702.770788,39.042822,175.692697,71.548875,1,6
0,0,10,10,12,17,29,44,32,76,0.000333,0.123069,6,2215.239334,123.068852,369.206556,112.506418,2,6
0,0,5,5,9,12,21,21,19,40,0.000333,0.058564,4,702.770788,39.042822,175.692697,71.548875,1,6
0,0,12,12,15,20,35,43,42,85,0.000333,0.14533,14,6103.84679,339.102599,435.989056,145.041921,3,6
0,0,9,9,10,18,28,28,30,58,0.000333,0.092942,5,1394.132927,77.451829,278.826585,108.277931,2,6
0,0,15,15,12,22,34,66,56,122,0.000333,0.20689,12,7448.0456,413.780311,620.670467,141.127046,1,6
0,0,15,15,13,23,36,67,56,123,0.000333,0.211967,12,7630.809302,423.93385,635.900775,152.147641,1,6
0,0,16,16,17,22,39,73,52,125,0.000333,0.220225,16,10570.80444,587.266913,660.675277,167.594364,3,6
0,0,10,10,14,16,30,44,33,77,0.000333,0.125944,14,5289.628062,293.868226,377.830576,117.302969,2,6
0,0,8,8,12,14,26,30,30,60,0.000333,0.094009,12,3384.316597,188.017589,282.026383,96.322519,3,6
0,0,8,8,12,16,28,28,29,57,0.000333,0.09134,6,1644.115383,91.339744,274.019231,107.01955,2,6
0,0,9,9,11,16,27,43,33,76,0.000333,0.120457,10,3613.714502,200.761917,361.37145,102.053748,1,6
0,0,11,11,12,17,29,55,39,94,0.000333,0.152217,12,5479.802563,304.433476,456.650214,112.506418,1,6
0,0,15,15,14,23,37,56,49,105,0.000333,0.182331,14,7657.896447,425.438692,546.992603,157.344894,3,6
0,0,32,32,24,46,70,134,97,231,0.000333,0.471955,24,33980.74505,1887.819169,1415.864377,364.12295,11,6
0,0,32,32,22,48,70,132,96,228,0.000333,0.465826,22,30744.48361,1708.026867,1397.476528,366.185696,10,6
0,0,27,27,20,47,67,116,86,202,0.000333,0.40845,10,12253.50017,680.750009,1225.350016,347.504238,9,6
0,0,26,26,20,47,67,115,84,199,0.000333,0.402384,10,12071.51749,670.639861,1207.151749,347.504238,9,6
0,0,12,12,17,22,39,49,41,90,0.000333,0.158562,8,3805.489598,211.416089,475.6862,167.594364,3,6
0,0,17,17,18,23,41,70,61,131,0.000333,0.233946,18,12633.10763,701.839313,701.839313,179.100575,3,6
0,0,17,17,19,25,44,74,62,136,0.000333,0.247494,18,13364.6886,742.4827,742.4827,196.807027,3,6
0,0,17,17,16,24,40,66,76,142,0.000333,0.251905,24,18137.13095,1007.618386,755.713789,174.0391,3,6
0,0,13,13,14,21,35,57,50,107,0.000333,0.182944,14,7683.665959,426.870331,548.833283,145.541635,2,6
0,0,16,16,14,20,34,72,52,124,0.000333,0.210282,14,8831.835492,490.657527,630.845392,139.741531,3,6
0,0,10,10,13,15,28,41,32,73,0.000333,0.116979,12,4211.242912,233.95794,350.936909,106.709075,2,6
0,0,18,18,15,25,40,67,73,140,0.000333,0.248357,14,10430.97907,579.498837,745.069933,174.699764,2,6
0,0,18,18,14,25,39,75,68,143,0.000333,0.251938,14,10581.37524,587.85418,755.812517,169.399374,2,6
0,0,3,3,9,7,16,12,10,22,0.000333,0.029333,4,352,19.555556,88,48.180809,1,6
0,0,18,18,18,24,42,84,65,149,0.000333,0.267818,18,14462.19533,803.455296,803.455296,185.09775,4,6
0,0,14,14,17,21,38,68,54,122,0.000333,0.213416,16,10243.95451,569.108584,640.247157,161.725534,4,6
0,0,9,9,12,15,27,26,25,51,0.000333,0.080833,6,1454.995576,80.833088,242.499263,101.622909,2,6
0,0,9,9,12,15,27,26,25,51,0.000333,0.080833,6,1454.995576,80.833088,242.499263,101.622909,2,6
0,0,6,6,13,12,25,31,26,57,0.000333,0.088233,12,3176.397634,176.466535,264.699803,91.125266,1,6
0,0,7,7,13,17,30,31,31,62,0.000333,0.101409,6,1825.363302,101.409072,304.227217,117.592585,1,6
0,0,9,9,12,15,27,26,25,51,0.000333,0.080833,6,1454.995576,80.833088,242.499263,101.622909,2,6
0,0,16,16,13,21,34,55,72,127,0.000333,0.215369,18,11629.94006,646.107781,646.107781,140.344382,2,6
0,0,10,10,13,18,31,37,36,73,0.000333,0.120552,12,4339.875968,241.10422,361.656331,123.164366,2,6
0,0,7,7,14,12,26,30,27,57,0.000333,0.089308,14,3750.950895,208.386161,267.925064,96.322519,3,6
0,0,7,7,14,15,29,28,26,54,0.000333,0.087444,7,1836.316816,102.017601,262.330974,111.906328,2,6
0,0,15,15,19,24,43,58,56,114,0.000333,0.206198,18,11134.69528,618.594182,618.594182,190.749723,4,6
0,0,15,15,18,26,44,56,55,111,0.000333,0.201999,18,10907.94437,605.99691,605.99691,197.270083,3,6
0,0,7,7,14,14,28,32,27,59,0.000333,0.094545,7,1985.437583,110.302088,283.63394,106.605938,3,6
0,0,7,7,14,16,30,30,26,56,0.000333,0.091595,7,1923.501113,106.861173,274.785873,117.302969,2,6
0,0,12,12,14,22,36,55,41,96,0.000333,0.165438,7,3474.189601,193.010533,496.3128,151.410465,3,6
0,0,12,12,14,22,36,55,41,96,0.000333,0.165438,7,3474.189601,193.010533,496.3128,151.410465,3,6
0,0,3,3,12,13,25,18,19,37,0.000333,0.057274,6,1030.936074,57.274226,171.822679,91.125266,1,6
0,0,30,30,22,53,75,145,103,248,0.000333,0.514916,11,16992.21739,944.012077,1544.747035,401.68728,11,6
0,0,29,29,22,53,75,144,101,245,0.000333,0.508687,11,16786.66637,932.592576,1526.060579,401.68728,11,6
0,0,32,32,22,54,76,154,107,261,0.000333,0.54357,11,17937.79989,996.544438,1630.709081,408.871421,11,6
0,0,31,31,22,54,76,153,105,258,0.000333,0.537322,11,17731.61828,985.089905,1611.965298,408.871421,11,6
0,0,3,3,11,12,23,20,15,35,0.000333,0.052775,5,791.623342,43.979075,158.324668,81.073298,1,6
0,0,6,6,9,13,22,17,16,33,0.000333,0.049054,4,588.644974,32.702499,147.161243,76.635041,2,6
0,0,9,9,12,16,28,30,24,54,0.000333,0.086532,6,1557.582995,86.532389,259.597166,107.01955,3,6
0,0,14,14,14,26,40,61,47,108,0.000333,0.191589,7,4023.37764,223.52098,574.768234,175.514402,4,6
0,0,15,15,14,26,40,62,49,111,0.000333,0.196911,7,4135.13813,229.729896,590.734019,175.514402,4,6
0,0,14,14,15,28,43,63,48,111,0.000333,0.200772,7,4216.207714,234.233762,602.315388,193.209297,4,6
0,0,15,15,15,28,43,64,50,114,0.000333,0.206198,7,4330.159274,240.564404,618.594182,193.209297,4,6
0,0,3,3,10,14,24,16,16,32,0.000333,0.048906,5,733.594,40.755222,146.7188,86.52225,1,6
0,0,3,3,10,15,25,16,16,32,0.000333,0.049534,5,743.01699,41.278722,148.603398,91.82264,1,6
0,0,45,45,20,48,68,237,163,400,0.000333,0.811662,30,73049.5541,4058.308561,2434.985137,354.516762,19,6
0,0,49,49,20,49,69,249,170,419,0.000333,0.853157,30,76784.15242,4265.786246,2559.471747,361.559344,20,6
0,0,51,51,20,49,69,255,172,427,0.000333,0.869447,30,78250.19829,4347.233238,2608.339943,361.559344,21,6
0,0,54,54,21,52,73,272,181,453,0.000333,0.934664,30,84119.71576,4673.317542,2803.990525,388.661531,22,6
0,0,39,39,21,52,73,194,129,323,0.000333,0.666438,20,39986.26665,2221.459258,1999.313333,388.661531,16,6
0,0,25,25,20,48,68,126,87,213,0.000333,0.43221,10,12966.29585,720.34977,1296.629585,354.516762,11,6
0,0,32,32,20,49,69,148,96,244,0.000333,0.496827,10,14904.79968,828.044426,1490.479967,361.559344,14,6
0,0,34,34,20,49,69,154,98,252,0.000333,0.513116,20,30786.96326,1710.386848,1539.348163,361.559344,15,6
0,0,48,48,21,52,73,228,146,374,0.000333,0.771665,20,46299.8877,2572.215983,2314.994385,388.661531,19,6
0,0,21,21,18,43,61,96,72,168,0.000333,0.332121,9,8967.274854,498.181936,996.363873,308.388034,7,6
0,0,20,20,18,43,61,95,70,165,0.000333,0.326191,9,8807.144946,489.28583,978.571661,308.388034,7,6
0,0,21,21,18,44,62,96,72,168,0.000333,0.333435,9,9002.744821,500.15249,1000.30498,315.273641,8,6
0,0,20,20,18,44,62,95,70,165,0.000333,0.327481,9,8841.981521,491.221196,982.442391,315.273641,8,6
0,0,3,3,10,15,25,16,16,32,0.000333,0.049534,5,743.01699,41.278722,148.603398,91.82264,1,6
0,0,7,7,12,17,29,26,26,52,0.000333,0.084205,6,1515.69007,84.205004,252.615012,112.506418,2,6
0,0,10,10,10,15,25,33,31,64,0.000333,0.099069,10,2972.067961,165.114887,297.206796,91.82264,1,6
0,0,13,13,13,16,29,51,44,95,0.000333,0.153836,12,5538.098334,307.67213,461.508195,112.105716,2,6
0,0,3,3,10,14,24,15,15,30,0.000333,0.04585,5,687.744375,38.208021,137.548875,86.52225,1,6
0,0,5,5,8,13,21,16,15,31,0.000333,0.045387,4,544.64736,30.258187,136.16184,72.105716,2,6
0,0,8,8,11,16,27,29,23,52,0.000333,0.082418,5,1236.270751,68.681708,247.25415,102.053748,3,6
0,0,7,7,10,18,28,31,26,57,0.000333,0.09134,5,1370.096153,76.116453,274.019231,108.277931,5,6
0,0,9,9,13,21,34,40,33,73,0.000333,0.123795,6,2228.308724,123.794929,371.384787,140.344382,6,6
0,0,4,4,7,11,18,13,13,26,0.000333,0.036139,3,325.25415,18.069675,108.41805,57.705232,1,6
0,0,7,7,11,14,25,26,21,47,0.000333,0.072754,5,1091.306205,60.628122,218.261241,91.356717,2,6
0,0,5,5,8,12,20,16,14,30,0.000333,0.043219,4,518.631371,28.812854,129.657843,67.01955,2,6
0,0,8,8,11,15,26,29,22,51,0.000333,0.079907,5,1198.612128,66.589563,239.722426,96.657107,3,6
0,0,5,5,8,12,20,16,14,30,0.000333,0.043219,4,518.631371,28.812854,129.657843,67.01955,2,6
0,0,8,8,11,15,26,29,22,51,0.000333,0.079907,5,1198.612128,66.589563,239.722426,96.657107,3,6
0,0,14,14,17,20,37,58,48,106,0.000333,0.184067,16,8835.232908,490.846273,552.202057,155.92543,3,6
0,0,13,13,17,20,37,56,46,102,0.000333,0.177121,16,8501.827893,472.323772,531.364243,155.92543,3,6
0,0,12,12,13,17,30,36,35,71,0.000333,0.11613,12,4180.670787,232.259488,348.389232,117.592585,3,6
0,0,3,3,10,15,25,16,16,32,0.000333,0.049534,5,743.01699,41.278722,148.603398,91.82264,1,6
0,0,3,3,10,16,26,19,18,37,0.000333,0.057972,5,869.581348,48.310075,173.91627,97.219281,1,6
0,0,9,9,12,19,31,32,30,62,0.000333,0.102387,6,1842.961027,102.386724,307.160171,123.730173,2,6
0,0,13,13,13,20,33,41,46,87,0.000333,0.146287,12,5266.347461,292.574859,438.862288,134.544278,2,6
0,0,3,3,10,16,26,21,18,39,0.000333,0.061106,5,916.585745,50.92143,183.317149,97.219281,1,6
0,0,3,3,10,15,25,16,16,32,0.000333,0.049534,5,743.01699,41.278722,148.603398,91.82264,1,6
0,0,23,23,19,53,72,146,95,241,0.000333,0.495651,9,13382.56733,743.475963,1486.951925,384.290407,13,6
0,0,3,3,10,15,25,18,17,35,0.000333,0.054178,5,812.674833,45.148602,162.534967,91.82264,1,6
0,0,3,3,10,14,24,15,15,30,0.000333,0.04585,5,687.744375,38.208021,137.548875,86.52225,1,6
0,0,9,9,12,22,34,38,32,70,0.000333,0.118707,6,2136.734393,118.707466,356.122399,141.127046,4,6
0,0,10,10,14,29,43,50,42,92,0.000333,0.166405,7,3494.514502,194.139695,499.216357,194.184418,6,6
0,0,9,9,12,21,33,38,31,69,0.000333,0.116021,6,2088.379165,116.021065,348.063194,135.258216,4,6
0,0,10,10,14,28,42,50,41,91,0.000333,0.163567,7,3434.906198,190.828122,490.700885,187.908907,6,6
0,0,14,14,18,20,38,56,51,107,0.000333,0.187176,18,10107.50839,561.528244,561.528244,161.497212,2,6
0,0,13,13,18,20,38,54,49,103,0.000333,0.180179,18,9729.65761,540.536534,540.536534,161.497212,2,6
0,0,12,12,18,19,37,50,41,91,0.000333,0.15802,18,8533.084613,474.060256,474.060256,155.769273,2,6
0,0,11,11,18,19,37,48,39,87,0.000333,0.151074,18,8158.003971,453.222443,453.222443,155.769273,2,6
0,0,10,10,12,18,30,32,29,61,0.000333,0.099773,6,1795.921958,99.773442,299.320326,118.0782,2,6
0,0,12,12,13,20,33,36,31,67,0.000333,0.112658,6,2027.846436,112.658135,337.974406,134.544278,2,6
0,0,11,11,13,16,29,36,32,68,0.000333,0.110114,12,3964.112492,220.228472,330.342708,112.105716,2,6
0,0,10,10,12,16,28,34,30,64,0.000333,0.102557,6,1846.02429,102.556905,307.670715,107.01955,2,6
0,0,12,12,14,17,31,39,33,72,0.000333,0.118901,7,2496.91494,138.717497,356.702134,122.789837,3,6
0,0,11,11,13,17,30,37,31,68,0.000333,0.111223,6,2002.011363,111.222854,333.668561,117.592585,3,6
0,0,3,3,10,15,25,16,16,32,0.000333,0.049534,5,743.01699,41.278722,148.603398,91.82264,1,6
0,0,21,21,18,45,63,113,76,189,0.000333,0.376569,9,10167.35315,564.852953,1129.705906,322.192039,9,6
0,0,10,10,13,21,34,51,37,88,0.000333,0.149232,6,2686.18038,149.232243,447.69673,140.344382,5,6
0,0,19,19,15,43,58,104,69,173,0.000333,0.33781,7,7094.014985,394.111944,1013.430712,291.932743,8,6
0,0,8,8,10,19,29,42,30,72,0.000333,0.116592,5,1748.873158,97.15962,349.774632,113.929904,4,6
0,0,20,20,15,44,59,107,70,177,0.000333,0.347076,7,7288.594738,404.92193,1041.22782,298.81835,9,6
0,0,9,9,11,20,31,45,31,76,0.000333,0.125506,5,1882.594598,104.588589,376.51892,124.49231,5,6
0,0,3,3,10,16,26,17,20,37,0.000333,0.057972,5,869.581348,48.310075,173.91627,97.219281,1,6
0,0,3,3,10,15,25,18,17,35,0.000333,0.054178,5,812.674833,45.148602,162.534967,91.82264,1,6
0,0,3,3,12,16,28,20,18,38,0.000333,0.060893,6,1096.076922,60.893162,182.679487,107.01955,1,6
0,0,3,3,12,13,25,17,18,35,0.000333,0.054178,6,975.2098,54.178322,162.534967,91.125266,1,6
0,0,3,3,10,15,25,18,17,35,0.000333,0.054178,5,812.674833,45.148602,162.534967,91.82264,1,6
0,0,3,3,10,15,25,18,17,35,0.000333,0.054178,5,812.674833,45.148602,162.534967,91.82264,1,6
0,0,3,3,10,15,25,18,17,35,0.000333,0.054178,5,812.674833,45.148602,162.534967,91.82264,1,6
0,0,3,3,10,15,25,18,17,35,0.000333,0.054178,5,812.674833,45.148602,162.534967,91.82264,1,6
0,0,12,12,13,16,29,36,34,70,0.000333,0.113353,12,4080.704036,226.70578,340.05867,112.105716,3,6
0,0,22,22,16,51,67,140,89,229,0.000333,0.463045,8,11113.0754,617.393078,1389.134425,353.293692,13,6
0,0,25,25,18,47,65,111,90,201,0.000333,0.403499,9,10894.46337,605.247965,1210.49593,336.124326,9,6
0,0,24,24,18,47,65,110,88,198,0.000333,0.397476,9,10731.85944,596.214413,1192.428827,336.124326,9,6
0,0,24,24,18,47,65,109,82,191,0.000333,0.383424,9,10352.45027,575.136126,1150.272252,336.124326,9,6
0,0,23,23,18,47,65,108,80,188,0.000333,0.377402,9,10189.84634,566.102574,1132.205149,336.124326,9,6
0,0,23,23,18,48,66,117,84,201,0.000333,0.404974,9,10934.30896,607.461609,1214.923218,343.13685,11,6
0,0,26,26,18,49,67,127,89,216,0.000333,0.436758,9,11792.47739,655.137633,1310.275265,350.179432,12,6
0,0,28,28,18,49,67,133,91,224,0.000333,0.452935,9,12229.23581,679.401989,1358.803979,350.179432,13,6
0,0,32,32,20,52,72,152,102,254,0.000333,0.522387,10,15671.6095,870.644972,1567.16095,382.861427,14,6
0,0,5,5,8,12,20,14,15,29,0.000333,0.041779,4,501.343659,27.852426,125.335915,67.01955,1,6
0,0,8,8,12,15,27,27,23,50,0.000333,0.079248,6,1426.466251,79.248125,237.744375,101.622909,2,6
0,0,6,6,9,13,22,17,17,34,0.000333,0.05054,4,606.4827,33.693483,151.620675,76.635041,2,6
0,0,9,9,12,16,28,30,25,55,0.000333,0.088135,6,1586.427124,88.13484,264.404521,107.01955,3,6
0,0,3,3,12,16,28,20,18,38,0.000333,0.060893,6,1096.076922,60.893162,182.679487,107.01955,1,6
0,0,3,3,10,14,24,16,16,32,0.000333,0.048906,5,733.594,40.755222,146.7188,86.52225,1,6
0,0,3,3,10,14,24,16,16,32,0.000333,0.048906,5,733.594,40.755222,146.7188,86.52225,1,6
0,0,3,3,10,14,24,16,16,32,0.000333,0.048906,5,733.594,40.755222,146.7188,86.52225,1,6
0,0,3,3,10,14,24,18,17,35,0.000333,0.053491,5,802.368438,44.576024,160.473688,86.52225,1,6
0,0,3,3,10,16,26,17,20,37,0.000333,0.057972,5,869.581348,48.310075,173.91627,97.219281,1,6
0,0,13,13,18,20,38,52,42,94,0.000333,0.164435,18,8879.493353,493.305186,493.305186,161.497212,3,6
0,0,12,12,18,20,38,50,40,90,0.000333,0.157438,18,8501.642572,472.313476,472.313476,161.497212,3,6
0,0,3,3,10,15,25,16,16,32,0.000333,0.049534,5,743.01699,41.278722,148.603398,91.82264,1,6
0,0,3,3,10,15,25,16,16,32,0.000333,0.049534,5,743.01699,41.278722,148.603398,91.82264,1,6
0,0,3,3,10,15,25,16,16,32,0.000333,0.049534,5,743.01699,41.278722,148.603398,91.82264,1,6
0,0,32,32,20,57,77,150,109,259,0.000333,0.541033,10,16230.97714,901.720952,1623.097714,418.913293,11,6
0,0,31,31,20,57,77,149,107,256,0.000333,0.534766,10,16042.97354,891.276308,1604.297354,418.913293,11,6
0,0,45,45,20,48,68,237,163,400,0.000333,0.811662,30,73049.5541,4058.308561,2434.985137,354.516762,19,6
0,0,49,49,20,49,69,249,170,419,0.000333,0.853157,30,76784.15242,4265.786246,2559.471747,361.559344,20,6
0,0,51,51,20,49,69,255,172,427,0.000333,0.869447,30,78250.19829,4347.233238,2608.339943,361.559344,21,6
0,0,54,54,21,52,73,272,181,453,0.000333,0.934664,30,84119.71576,4673.317542,2803.990525,388.661531,22,6
0,0,39,39,21,52,73,194,129,323,0.000333,0.666438,20,39986.26665,2221.459258,1999.313333,388.661531,16,6
0,0,25,25,20,48,68,126,87,213,0.000333,0.43221,10,12966.29585,720.34977,1296.629585,354.516762,11,6
0,0,32,32,20,49,69,148,96,244,0.000333,0.496827,10,14904.79968,828.044426,1490.479967,361.559344,14,6
0,0,34,34,20,49,69,154,98,252,0.000333,0.513116,20,30786.96326,1710.386848,1539.348163,361.559344,15,6
0,0,48,48,21,52,73,228,146,374,0.000333,0.771665,20,46299.8877,2572.215983,2314.994385,388.661531,19,6
0,0,23,23,18,48,66,117,84,201,0.000333,0.404974,9,10934.30896,607.461609,1214.923218,343.13685,11,6
0,0,26,26,18,49,67,127,89,216,0.000333,0.436758,9,11792.47739,655.137633,1310.275265,350.179432,12,6
0,0,28,28,18,49,67,133,91,224,0.000333,0.452935,9,12229.23581,679.401989,1358.803979,350.179432,13,6
0,0,32,32,20,52,72,152,102,254,0.000333,0.522387,10,15671.6095,870.644972,1567.16095,382.861427,14,6
0,0,3,3,10,14,24,15,15,30,0.000333,0.04585,5,687.744375,38.208021,137.548875,86.52225,1,6
0,0,3,3,10,14,24,15,15,30,0.000333,0.04585,5,687.744375,38.208021,137.548875,86.52225,1,6
0,0,3,3,10,14,24,15,15,30,0.000333,0.04585,5,687.744375,38.208021,137.548875,86.52225,1,6
0,0,13,13,13,16,29,51,44,95,0.000333,0.153836,12,5538.098334,307.67213,461.508195,112.105716,2,6
0,0,13,13,19,20,39,53,43,96,0.000333,0.169133,18,9133.175034,507.398613,507.398613,167.149185,3,6
0,0,12,12,19,20,39,51,41,92,0.000333,0.162086,18,8752.626074,486.257004,486.257004,167.149185,3,6
0,0,12,12,14,17,31,39,33,72,0.000333,0.118901,7,2496.91494,138.717497,356.702134,122.789837,3,6
0,0,11,11,13,17,30,37,31,68,0.000333,0.111223,6,2002.011363,111.222854,333.668561,117.592585,3,6
0,0,12,12,11,16,27,40,37,77,0.000333,0.122042,10,3661.263377,203.403521,366.126338,102.053748,3,6
0,0,11,11,10,16,26,38,35,73,0.000333,0.114377,10,3431.320994,190.628944,343.132099,97.219281,3,6
0,0,3,3,10,15,25,16,16,32,0.000333,0.049534,5,743.01699,41.278722,148.603398,91.82264,1,6
0,0,3,3,10,15,25,16,16,32,0.000333,0.049534,5,743.01699,41.278722,148.603398,91.82264,1,6
0,0,3,3,10,14,24,16,16,32,0.000333,0.048906,5,733.594,40.755222,146.7188,86.52225,1,6
0,0,3,3,10,14,24,16,16,32,0.000333,0.048906,5,733.594,40.755222,146.7188,86.52225,1,6
0,0,3,3,10,14,24,16,16,32,0.000333,0.048906,5,733.594,40.755222,146.7188,86.52225,1,6
0,0,21,21,17,34,51,94,76,170,0.000333,0.321437,16,15428.99693,857.166496,964.312308,242.460605,9,6
0,0,19,19,12,33,45,70,67,137,0.000333,0.250795,12,9028.60649,501.589249,752.383874,209.484556,5,6
0,0,15,15,17,32,49,61,51,112,0.000333,0.209616,8,5030.78002,279.487779,628.847503,229.486868,7,6
0,0,12,12,16,30,46,49,46,95,0.000333,0.174913,8,4197.907087,233.21706,524.738386,211.206718,6,6
0,0,12,12,17,28,45,49,45,94,0.000333,0.172078,8,4129.873528,229.437418,516.234191,204.092806,6,6
0,0,12,12,17,29,46,49,45,94,0.000333,0.173072,8,4153.718591,230.762144,519.214824,210.368317,6,6
0,0,7,7,10,17,27,27,25,52,0.000333,0.082418,5,1236.270751,68.681708,247.25415,102.706149,5,6
0,0,3,3,10,14,24,16,16,32,0.000333,0.048906,5,733.594,40.755222,146.7188,86.52225,1,6
0,0,3,3,10,14,24,16,16,32,0.000333,0.048906,5,733.594,40.755222,146.7188,86.52225,1,6
0,0,3,3,10,14,24,16,16,32,0.000333,0.048906,5,733.594,40.755222,146.7188,86.52225,1,6
0,0,3,3,10,15,25,16,16,32,0.000333,0.049534,5,743.01699,41.278722,148.603398,91.82264,1,6
0,0,3,3,10,14,24,15,15,30,0.000333,0.04585,5,687.744375,38.208021,137.548875,86.52225,1,6
0,0,12,12,14,23,37,57,44,101,0.000333,0.175385,7,3683.083529,204.615752,526.15479,157.344894,6,6
0,0,15,15,15,21,36,74,48,122,0.000333,0.210244,14,8830.231902,490.568439,630.73085,150.842025,6,6
0,0,15,15,15,21,36,74,48,122,0.000333,0.210244,14,8830.231902,490.568439,630.73085,150.842025,6,6
0,0,3,3,12,16,28,21,19,40,0.000333,0.064098,6,1153.765181,64.098066,192.294197,107.01955,1,6
0,0,3,3,10,14,24,15,15,30,0.000333,0.04585,5,687.744375,38.208021,137.548875,86.52225,1,6
0,0,23,23,18,48,66,117,84,201,0.000333,0.404974,9,10934.30896,607.461609,1214.923218,343.13685,11,6
0,0,26,26,18,49,67,127,89,216,0.000333,0.436758,9,11792.47739,655.137633,1310.275265,350.179432,12,6
0,0,28,28,18,49,67,133,91,224,0.000333,0.452935,9,12229.23581,679.401989,1358.803979,350.179432,13,6
0,0,32,32,20,52,72,152,102,254,0.000333,0.522387,10,15671.6095,870.644972,1567.16095,382.861427,14,6
0,0,20,20,20,39,59,102,74,176,0.000333,0.345115,10,10353.45177,575.191765,1035.345177,292.569248,11,6
0,0,23,23,20,40,60,112,79,191,0.000333,0.376072,10,11282.16104,626.786724,1128.216104,299.315686,12,6
0,0,25,25,20,40,60,118,81,199,0.000333,0.391824,20,23509.42457,1306.079143,1175.471229,299.315686,13,6
0,0,29,29,22,43,65,137,92,229,0.000333,0.459707,22,30340.68904,1685.593836,1379.122229,331.43688,14,6
0,0,14,14,18,30,48,54,48,102,0.000333,0.189889,9,5126.995576,284.833088,569.666175,222.265368,6,6
0,0,12,12,14,22,36,54,44,98,0.000333,0.168884,14,7093.137102,394.063172,506.65265,151.410465,6,6
0,0,15,15,15,21,36,74,48,122,0.000333,0.210244,14,8830.231902,490.568439,630.73085,150.842025,6,6
0,0,31,31,20,56,76,147,104,251,0.000333,0.522743,10,15682.29806,871.238781,1568.229806,411.650438,12,6
0,0,30,30,20,55,75,146,102,248,0.000333,0.514916,10,15447.47035,858.192797,1544.747035,404.413346,12,6
0,0,31,31,20,56,76,147,104,251,0.000333,0.522743,10,15682.29806,871.238781,1568.229806,411.650438,12,6
0,0,30,30,20,55,75,146,102,248,0.000333,0.514916,10,15447.47035,858.192797,1544.747035,404.413346,12,6
0,0,33,33,22,55,77,152,106,258,0.000333,0.538944,11,17785.1402,988.063345,1616.830927,416.08228,12,6
0,0,32,32,22,54,76,151,104,255,0.000333,0.531074,11,17525.43668,973.635371,1593.221516,408.871421,12,6
0,0,3,3,10,14,24,18,17,35,0.000333,0.053491,5,802.368438,44.576024,160.473688,86.52225,1,6
0,0,3,3,11,10,21,16,12,28,0.000333,0.040995,5,614.924439,34.162469,122.984888,71.273029,1,6
0,0,3,3,10,14,24,16,16,32,0.000333,0.048906,5,733.594,40.755222,146.7188,86.52225,1,6
0,0,3,3,10,16,26,17,20,37,0.000333,0.057972,5,869.581348,48.310075,173.91627,97.219281,1,6
0,0,3,3,10,15,25,19,17,36,0.000333,0.055726,5,835.894114,46.438562,167.178823,91.82264,1,6
0,0,3,3,10,15,25,18,17,35,0.000333,0.054178,5,812.674833,45.148602,162.534967,91.82264,1,6
0,0,3,3,12,16,28,20,18,38,0.000333,0.060893,6,1096.076922,60.893162,182.679487,107.01955,1,6
0,0,12,12,14,16,30,41,31,72,0.000333,0.117765,7,2473.07286,137.392937,353.296123,117.302969,3,6
0,0,11,11,14,16,30,39,29,68,0.000333,0.111223,7,2335.679924,129.759996,333.668561,117.302969,3,6
0,0,14,14,15,17,32,46,34,80,0.000333,0.133333,14,5600,311.111111,400,128.090227,3,6
0,0,13,13,15,17,32,44,32,76,0.000333,0.126667,7,2660,147.777778,380,128.090227,3,6
0,0,3,3,10,14,24,15,15,30,0.000333,0.04585,5,687.744375,38.208021,137.548875,86.52225,1,6
0,0,3,3,10,14,24,16,16,32,0.000333,0.048906,5,733.594,40.755222,146.7188,86.52225,1,6
0,0,3,3,10,14,24,16,16,32,0.000333,0.048906,5,733.594,40.755222,146.7188,86.52225,1,6
0,0,3,3,10,14,24,16,16,32,0.000333,0.048906,5,733.594,40.755222,146.7188,86.52225,1,6
0,0,3,3,10,14,24,16,16,32,0.000333,0.048906,5,733.594,40.755222,146.7188,86.52225,1,6
0,0,14,14,14,21,35,64,47,111,0.000333,0.189783,14,7970.905808,442.8281,569.350415,145.541635,6,6
0,0,14,14,14,21,35,64,47,111,0.000333,0.189783,14,7970.905808,442.8281,569.350415,145.541635,6,6
0,0,3,3,10,14,24,15,15,30,0.000333,0.04585,5,687.744375,38.208021,137.548875,86.52225,1,6
0,0,19,19,15,25,40,86,58,144,0.000333,0.255453,14,10729.00704,596.055947,766.357646,174.699764,6,6
0,0,12,12,13,16,29,38,34,72,0.000333,0.116592,12,4197.29558,233.183088,349.774632,112.105716,3,6
0,0,11,11,12,16,28,36,32,68,0.000333,0.108967,12,3922.801616,217.933423,326.900135,107.01955,3,6
0,0,12,12,14,23,37,57,44,101,0.000333,0.175385,7,3683.083529,204.615752,526.15479,157.344894,6,6
0,0,12,12,14,23,37,57,44,101,0.000333,0.175385,7,3683.083529,204.615752,526.15479,157.344894,6,6
0,0,20,20,18,42,60,93,70,163,0.000333,0.320941,9,8665.408504,481.411584,962.823167,301.535982,7,6
0,0,19,19,18,42,60,92,68,160,0.000333,0.315034,9,8505.922458,472.551248,945.102495,301.535982,7,6
0,0,28,28,20,52,72,134,94,228,0.000333,0.468914,10,14067.429,781.523834,1406.7429,382.861427,10,6
0,0,27,27,20,51,71,133,92,225,0.000333,0.461231,10,13836.93102,768.71839,1383.693102,375.732254,10,6
0,0,4,4,9,10,19,13,11,24,0.000333,0.033983,4,407.801041,22.655613,101.95026,61.748606,3,6
0,0,19,19,15,25,40,86,62,148,0.000333,0.262548,14,11027.03501,612.613056,787.645358,174.699764,6,6
0,0,3,3,10,14,24,16,16,32,0.000333,0.048906,5,733.594,40.755222,146.7188,86.52225,1,6
0,0,3,3,10,16,26,19,18,37,0.000333,0.057972,5,869.581348,48.310075,173.91627,97.219281,1,6
0,0,3,3,10,15,25,16,16,32,0.000333,0.049534,5,743.01699,41.278722,148.603398,91.82264,1,6
0,0,3,3,10,16,26,19,18,37,0.000333,0.057972,5,869.581348,48.310075,173.91627,97.219281,1,6
0,0,27,27,21,49,70,132,94,226,0.000333,0.461739,10,13852.17962,769.565534,1385.217962,367.359448,9,6
0,0,26,26,21,49,70,131,92,223,0.000333,0.45561,10,13668.30113,759.350063,1366.830113,367.359448,9,6
0,0,27,27,21,49,70,132,93,225,0.000333,0.459696,10,13790.88679,766.160377,1379.088679,367.359448,9,6
0,0,26,26,21,49,70,131,91,222,0.000333,0.453567,10,13607.0083,755.944905,1360.70083,367.359448,9,6
0,0,29,29,23,49,72,137,96,233,0.000333,0.479198,11,15813.51778,878.528765,1437.592525,379.162707,9,6
0,0,28,28,23,49,72,136,94,230,0.000333,0.473028,11,15609.91025,867.217236,1419.08275,379.162707,9,6
0,0,8,8,14,22,36,43,35,78,0.000333,0.134418,7,2822.779051,156.821058,403.25415,151.410465,2,6
0,0,3,3,10,14,24,16,16,32,0.000333,0.048906,5,733.594,40.755222,146.7188,86.52225,1,6
0,0,3,3,10,15,25,16,16,32,0.000333,0.049534,5,743.01699,41.278722,148.603398,91.82264,1,6
0,0,3,3,10,14,24,16,16,32,0.000333,0.048906,5,733.594,40.755222,146.7188,86.52225,1,6
0,0,9,9,13,19,32,40,32,72,0.000333,0.12,6,2160,120,360,128.816339,4,6
0,0,3,3,10,13,23,15,15,30,0.000333,0.045236,5,678.534293,37.69635,135.706859,81.324997,1,6
0,0,3,3,10,13,23,15,15,30,0.000333,0.045236,5,678.534293,37.69635,135.706859,81.324997,1,6
0,0,16,16,18,30,48,71,63,134,0.000333,0.249462,18,13470.92955,748.384975,748.384975,222.265368,4,6
0,0,3,3,10,13,23,15,15,30,0.000333,0.045236,5,678.534293,37.69635,135.706859,81.324997,1,6
0,0,25,25,19,53,72,133,93,226,0.000333,0.464801,9,12549.62745,697.201525,1394.40305,384.290407,11,6
0,0,28,28,19,54,73,143,98,241,0.000333,0.497249,9,13425.72947,745.873859,1491.747719,391.474548,12,6
0,0,30,30,19,54,73,149,100,249,0.000333,0.513755,9,13871.39684,770.633158,1541.266315,391.474548,13,6
0,0,34,34,21,57,78,168,111,279,0.000333,0.584542,10,17536.27219,974.237344,1753.627219,424.713397,14,6
0,0,24,24,18,52,70,130,92,222,0.000333,0.453567,9,12246.30747,680.350415,1360.70083,371.481515,10,6
0,0,27,27,18,53,71,140,97,237,0.000333,0.48583,9,13117.41061,728.745034,1457.490067,378.638434,11,6
0,0,29,29,18,53,71,146,99,245,0.000333,0.502229,9,13560.1924,753.344022,1506.688044,378.638434,12,6
0,0,33,33,20,56,76,165,110,275,0.000333,0.572727,10,17181.80066,954.544481,1718.180066,411.650438,13,6
0,0,18,18,17,27,44,81,62,143,0.000333,0.260233,16,12491.17954,693.954419,780.698721,197.868831,6,6
0,0,8,8,13,18,31,39,31,70,0.000333,0.115598,6,2080.76245,115.597914,346.793742,123.164366,2,6
0,0,3,3,10,13,23,15,15,30,0.000333,0.045236,5,678.534293,37.69635,135.706859,81.324997,1,6
0,0,13,13,13,16,29,51,44,95,0.000333,0.153836,12,5538.098334,307.67213,461.508195,112.105716,2,6
0,0,12,12,15,24,39,59,42,101,0.000333,0.177942,7,3736.779369,207.598854,533.825624,168.642459,4,6
0,0,13,13,15,24,39,60,44,104,0.000333,0.183227,7,3847.772815,213.765156,549.681831,168.642459,4,6
0,0,13,13,15,23,38,65,47,112,0.000333,0.195923,14,8228.750341,457.152797,587.767882,162.645284,4,6
0,0,14,14,15,23,38,66,49,115,0.000333,0.201171,14,8449.163297,469.397961,603.511664,162.645284,4,6
0,0,12,12,16,23,39,59,41,100,0.000333,0.17618,8,4228.321775,234.906765,528.540222,168.041925,4,6
0,0,13,13,16,23,39,60,43,103,0.000333,0.181465,8,4355.171428,241.953968,544.396429,168.041925,4,6
0,0,11,11,12,17,29,37,30,67,0.000333,0.108495,6,1952.90836,108.494909,325.484727,112.506418,2,6
0,0,10,10,12,18,30,35,27,62,0.000333,0.101409,6,1825.363302,101.409072,304.227217,118.0782,3,6
0,0,11,11,12,17,29,37,30,67,0.000333,0.108495,6,1952.90836,108.494909,325.484727,112.506418,2,6
0,0,10,10,12,18,30,35,27,62,0.000333,0.101409,6,1825.363302,101.409072,304.227217,118.0782,3,6
0,0,3,3,11,10,21,16,12,28,0.000333,0.040995,5,614.924439,34.162469,122.984888,71.273029,1,6
0,0,3,3,10,14,24,18,17,35,0.000333,0.053491,5,802.368438,44.576024,160.473688,86.52225,1,6
0,0,3,3,10,14,24,18,17,35,0.000333,0.053491,5,802.368438,44.576024,160.473688,86.52225,1,6
0,0,3,3,10,13,23,15,15,30,0.000333,0.045236,5,678.534293,37.69635,135.706859,81.324997,1,6
0,0,3,3,11,13,24,20,15,35,0.000333,0.053491,5,802.368438,44.576024,160.473688,86.159464,1,6
0,0,3,3,10,15,25,16,16,32,0.000333,0.049534,5,743.01699,41.278722,148.603398,91.82264,1,6
0,0,23,23,18,48,66,117,84,201,0.000333,0.404974,9,10934.30896,607.461609,1214.923218,343.13685,11,6
0,0,26,26,18,49,67,127,89,216,0.000333,0.436758,9,11792.47739,655.137633,1310.275265,350.179432,12,6
0,0,28,28,18,49,67,133,91,224,0.000333,0.452935,9,12229.23581,679.401989,1358.803979,350.179432,13,6
0,0,32,32,20,52,72,152,102,254,0.000333,0.522387,10,15671.6095,870.644972,1567.16095,382.861427,14,6
0,0,23,23,18,48,66,117,84,201,0.000333,0.404974,9,10934.30896,607.461609,1214.923218,343.13685,11,6
0,0,26,26,18,49,67,127,89,216,0.000333,0.436758,9,11792.47739,655.137633,1310.275265,350.179432,12,6
0,0,28,28,18,49,67,133,91,224,0.000333,0.452935,9,12229.23581,679.401989,1358.803979,350.179432,13,6
0,0,32,32,20,52,72,152,102,254,0.000333,0.522387,10,15671.6095,870.644972,1567.16095,382.861427,14,6
0,0,23,23,18,47,65,117,83,200,0.000333,0.401491,9,10840.26206,602.236781,1204.473563,336.124326,11,6
0,0,26,26,18,48,66,127,88,215,0.000333,0.433182,9,11695.90262,649.772368,1299.544736,343.13685,12,6
0,0,28,28,18,48,66,133,90,223,0.000333,0.4493,9,12131.099,673.949944,1347.899889,343.13685,13,6
0,0,32,32,20,51,71,152,101,253,0.000333,0.518629,10,15558.86021,864.381123,1555.886021,375.732254,14,6
0,0,12,12,13,17,30,38,33,71,0.000333,0.11613,6,2090.335394,116.129744,348.389232,117.592585,3,6
0,0,11,11,12,17,29,36,31,67,0.000333,0.108495,6,1952.90836,108.494909,325.484727,112.506418,3,6
0,0,3,3,10,13,23,15,15,30,0.000333,0.045236,5,678.534293,37.69635,135.706859,81.324997,1,6
0,0,3,3,10,13,23,15,15,30,0.000333,0.045236,5,678.534293,37.69635,135.706859,81.324997,1,6
0,0,3,3,10,13,23,15,15,30,0.000333,0.045236,5,678.534293,37.69635,135.706859,81.324997,1,6
0,0,14,14,15,21,36,57,44,101,0.000333,0.174054,14,7310.273952,406.126331,522.162425,150.842025,4,6
0,0,3,3,10,16,26,18,21,39,0.000333,0.061106,5,916.585745,50.92143,183.317149,97.219281,1,6
0,0,3,3,10,14,24,16,16,32,0.000333,0.048906,5,733.594,40.755222,146.7188,86.52225,1,6
0,0,3,3,10,15,25,19,18,37,0.000333,0.057274,5,859.113395,47.728522,171.822679,91.82264,1,6
0,0,3,3,10,14,24,15,15,30,0.000333,0.04585,5,687.744375,38.208021,137.548875,86.52225,1,6
0,0,3,3,10,14,24,16,16,32,0.000333,0.048906,5,733.594,40.755222,146.7188,86.52225,1,6
0,0,3,3,10,14,24,15,15,30,0.000333,0.04585,5,687.744375,38.208021,137.548875,86.52225,1,6
0,0,3,3,10,15,25,19,18,37,0.000333,0.057274,5,859.113395,47.728522,171.822679,91.82264,1,6
0,0,12,12,13,17,30,38,38,76,0.000333,0.124308,12,4475.084223,248.61579,372.923685,117.592585,2,6
0,0,3,3,10,14,24,15,15,30,0.000333,0.04585,5,687.744375,38.208021,137.548875,86.52225,1,6
0,0,3,3,10,14,24,15,15,30,0.000333,0.04585,5,687.744375,38.208021,137.548875,86.52225,1,6
0,0,3,3,10,14,24,15,15,30,0.000333,0.04585,5,687.744375,38.208021,137.548875,86.52225,1,6
0,0,13,13,15,23,38,60,47,107,0.000333,0.187176,14,7861.395415,436.74419,561.528244,162.645284,6,6
0,0,3,3,10,15,25,21,18,39,0.000333,0.06037,5,905.551957,50.308442,181.110391,91.82264,1,6
0,0,3,3,10,15,25,19,18,37,0.000333,0.057274,5,859.113395,47.728522,171.822679,91.82264,1,6
0,0,3,3,10,15,25,19,18,37,0.000333,0.057274,5,859.113395,47.728522,171.822679,91.82264,1,6
0,0,12,12,14,20,34,50,44,94,0.000333,0.159407,14,6695.101099,371.950061,478.221507,139.741531,4,6
0,0,11,11,13,20,33,46,38,84,0.000333,0.141243,6,2542.374636,141.243035,423.729106,134.544278,4,6
0,0,12,12,13,18,31,38,34,72,0.000333,0.118901,6,2140.212806,118.900711,356.702134,123.164366,3,6
0,0,11,11,12,18,30,36,32,68,0.000333,0.111223,6,2002.011363,111.222854,333.668561,118.0782,3,6
0,0,3,3,11,11,22,19,14,33,0.000333,0.049054,5,735.806217,40.878123,147.161243,76.107496,1,6
0,0,3,3,10,13,23,15,15,30,0.000333,0.045236,5,678.534293,37.69635,135.706859,81.324997,1,6
0,0,8,8,10,15,25,29,28,57,0.000333,0.088233,5,1323.499014,73.527723,264.699803,91.82264,1,6
0,0,3,3,10,15,25,16,16,32,0.000333,0.049534,5,743.01699,41.278722,148.603398,91.82264,1,6
0,0,3,3,10,15,25,16,16,32,0.000333,0.049534,5,743.01699,41.278722,148.603398,91.82264,1,6
0,0,13,13,13,22,35,41,46,87,0.000333,0.148749,12,5354.97147,297.498415,446.247622,146.213212,2,6
0,0,3,3,10,13,23,15,15,30,0.000333,0.045236,5,678.534293,37.69635,135.706859,81.324997,1,6
0,0,13,13,14,24,38,60,46,106,0.000333,0.185427,7,3893.962215,216.331234,556.280316,163.342069,6,6
0,0,12,12,14,23,37,57,44,101,0.000333,0.175385,7,3683.083529,204.615752,526.15479,157.344894,6,6
0,0,31,31,20,56,76,146,104,250,0.000333,0.520661,10,15619.81878,867.76771,1561.981878,411.650438,12,6
0,0,30,30,20,55,75,145,102,247,0.000333,0.512839,10,15385.18217,854.732343,1538.518217,404.413346,12,6
0,0,17,17,15,24,39,80,52,132,0.000333,0.232558,14,9767.4233,542.634628,697.673093,168.642459,6,6
0,0,11,11,13,20,33,46,36,82,0.000333,0.13788,6,2481.841907,137.880106,413.640318,134.544278,4,6
0,0,11,11,13,20,33,46,36,82,0.000333,0.13788,6,2481.841907,137.880106,413.640318,134.544278,4,6
0,0,11,11,13,20,33,46,36,82,0.000333,0.13788,6,2481.841907,137.880106,413.640318,134.544278,4,6
0,0,14,14,18,29,47,63,62,125,0.000333,0.231441,18,12497.82492,694.323606,694.323606,215.940099,3,6
0,0,3,3,10,15,25,18,17,35,0.000333,0.054178,5,812.674833,45.148602,162.534967,91.82264,1,6
0,0,13,13,13,16,29,51,44,95,0.000333,0.153836,12,5538.098334,307.67213,461.508195,112.105716,2,6
0,0,3,3,10,14,24,15,15,30,0.000333,0.04585,5,687.744375,38.208021,137.548875,86.52225,1,6
0,0,3,3,10,15,25,18,17,35,0.000333,0.054178,5,812.674833,45.148602,162.534967,91.82264,1,6
0,0,11,11,13,20,33,46,36,82,0.000333,0.13788,6,2481.841907,137.880106,413.640318,134.544278,4,6
0,0,16,16,7,21,28,53,46,99,0.000333,0.158643,6,2855.568824,158.642712,475.928137,111.89015,1,6
0,0,19,19,13,24,37,66,54,120,0.000333,0.208378,12,7501.612847,416.756269,625.134404,158.144816,2,6
0,0,10,10,12,16,28,35,26,61,0.000333,0.09775,6,1759.491901,97.74955,293.24865,107.01955,2,6
0,0,15,15,13,22,35,56,44,100,0.000333,0.170976,12,6155.13962,341.952201,512.928302,146.213212,2,6
0,0,14,14,13,22,35,55,42,97,0.000333,0.165847,6,2985.242716,165.846818,497.540453,146.213212,2,6
0,0,15,15,6,18,24,50,41,91,0.000333,0.139077,6,2503.389525,139.077196,417.231588,90.568425,1,6
0,0,18,18,12,21,33,63,49,112,0.000333,0.188324,12,6779.665696,376.648094,564.972141,135.258216,2,6
0,0,10,10,12,16,28,35,26,61,0.000333,0.09775,6,1759.491901,97.74955,293.24865,107.01955,2,6
0,0,15,15,12,20,32,54,43,97,0.000333,0.161667,12,5820,323.333333,485,129.458112,2,6
0,0,14,14,12,20,32,53,41,94,0.000333,0.156667,12,5640,313.333333,470,129.458112,2,6
0,0,3,3,10,15,25,16,16,32,0.000333,0.049534,5,743.01699,41.278722,148.603398,91.82264,1,6
0,0,17,17,15,24,39,80,52,132,0.000333,0.232558,14,9767.4233,542.634628,697.673093,168.642459,6,6
0,0,17,17,15,24,39,80,52,132,0.000333,0.232558,14,9767.4233,542.634628,697.673093,168.642459,6,6
0,0,12,12,15,21,36,55,49,104,0.000333,0.179224,14,7527.410802,418.189489,537.6722,150.842025,6,6
0,0,15,15,17,21,38,67,54,121,0.000333,0.211666,16,10159.98767,564.443759,634.999229,161.725534,6,6
0,0,3,3,10,14,24,18,17,35,0.000333,0.053491,5,802.368438,44.576024,160.473688,86.52225,1,6
0,0,3,3,10,14,24,15,15,30,0.000333,0.04585,5,687.744375,38.208021,137.548875,86.52225,1,6
0,0,12,12,14,22,36,54,44,98,0.000333,0.168884,14,7093.137102,394.063172,506.65265,151.410465,6,6
0,0,12,12,14,18,32,37,35,72,0.000333,0.12,7,2520,140,360,128.361619,3,6
0,0,12,12,14,18,32,37,35,72,0.000333,0.12,7,2520,140,360,128.361619,3,6
0,0,14,14,15,18,33,41,37,78,0.000333,0.131154,14,5508.478378,306.026577,393.462741,133.662009,3,6
0,0,11,11,12,19,31,34,38,72,0.000333,0.118901,12,4280.425612,237.801423,356.702134,123.730173,2,6
0,0,12,12,13,20,33,37,39,76,0.000333,0.127791,6,2300.243718,127.791318,383.373953,134.544278,3,6
0,0,12,12,13,20,33,37,39,76,0.000333,0.127791,6,2300.243718,127.791318,383.373953,134.544278,3,6
0,0,7,7,9,12,21,19,20,39,0.000333,0.0571,4,685.201518,38.066751,171.300379,71.548875,1,6
0,0,15,15,12,13,25,63,50,113,0.000333,0.174919,18,9445.60349,524.755749,524.755749,91.125266,4,6
0,0,7,7,9,12,21,19,20,39,0.000333,0.0571,4,685.201518,38.066751,171.300379,71.548875,1,6
0,0,3,3,11,10,21,16,12,28,0.000333,0.040995,5,614.924439,34.162469,122.984888,71.273029,1,6
0,0,10,10,15,20,35,49,39,88,0.000333,0.150459,7,3159.638338,175.535463,451.376905,145.041921,6,6
0,0,10,10,15,20,35,49,39,88,0.000333,0.150459,7,3159.638338,175.535463,451.376905,145.041921,6,6
0,0,11,11,16,21,37,55,42,97,0.000333,0.168439,16,8085.071623,449.170646,505.316976,156.238666,6,6
0,0,3,3,10,15,25,16,16,32,0.000333,0.049534,5,743.01699,41.278722,148.603398,91.82264,1,6
0,0,3,3,10,16,26,19,18,37,0.000333,0.057972,5,869.581348,48.310075,173.91627,97.219281,1,6
0,0,3,3,10,15,25,16,16,32,0.000333,0.049534,5,743.01699,41.278722,148.603398,91.82264,1,6
0,0,3,3,11,12,23,17,13,30,0.000333,0.045236,5,678.534293,37.69635,135.706859,81.073298,1,6
0,0,31,31,20,56,76,146,104,250,0.000333,0.520661,10,15619.81878,867.76771,1561.981878,411.650438,12,6
0,0,30,30,20,55,75,145,102,247,0.000333,0.512839,10,15385.18217,854.732343,1538.518217,404.413346,12,6
0,0,3,3,10,14,24,18,17,35,0.000333,0.053491,5,802.368438,44.576024,160.473688,86.52225,1,6
0,0,3,3,10,14,24,18,17,35,0.000333,0.053491,5,802.368438,44.576024,160.473688,86.52225,1,6
0,0,3,3,10,13,23,15,15,30,0.000333,0.045236,5,678.534293,37.69635,135.706859,81.324997,1,6
0,0,38,38,22,53,75,312,182,494,0.000333,1.025679,33,101542.2023,5641.233461,3077.036433,401.68728,20,6
0,0,39,39,24,55,79,318,188,506,0.000333,1.063238,36,114829.6701,6379.426117,3189.713059,428.013884,20,6
0,0,12,12,14,15,29,41,31,72,0.000333,0.116592,14,4896.844843,272.046936,349.774632,111.906328,3,6
0,0,11,11,14,15,29,39,29,68,0.000333,0.110114,7,2312.398954,128.466609,330.342708,111.906328,3,6
0,0,3,3,10,14,24,16,16,32,0.000333,0.048906,5,733.594,40.755222,146.7188,86.52225,1,6
0,0,16,16,9,19,28,54,39,93,0.000333,0.149028,8,3576.672062,198.704003,447.084008,109.239948,2,6
0,0,19,19,14,22,36,67,47,114,0.000333,0.196457,14,8251.200302,458.400017,589.37145,151.410465,3,6
0,0,10,10,12,16,28,35,26,61,0.000333,0.09775,6,1759.491901,97.74955,293.24865,107.01955,2,6
0,0,16,16,14,21,35,58,41,99,0.000333,0.169266,7,3554.593131,197.477396,507.799019,145.541635,3,6
0,0,15,15,14,21,35,57,39,96,0.000333,0.164137,7,3446.878187,191.493233,492.41117,145.541635,3,6
0,0,14,14,7,19,26,49,37,86,0.000333,0.134746,3,1212.713447,67.372969,404.237816,100.362107,2,6
0,0,17,17,12,22,34,62,45,107,0.000333,0.181453,12,6532.302288,362.905683,544.358524,141.127046,3,6
0,0,10,10,12,16,28,35,26,61,0.000333,0.09775,6,1759.491901,97.74955,293.24865,107.01955,2,6
0,0,14,14,12,21,33,53,39,92,0.000333,0.154695,6,2784.505554,154.694753,464.084259,135.258216,3,6
0,0,13,13,12,21,33,52,37,89,0.000333,0.14965,6,2693.70646,149.650359,448.951077,135.258216,3,6
0,0,14,14,7,19,26,49,37,86,0.000333,0.134746,3,1212.713447,67.372969,404.237816,100.362107,2,6
0,0,17,17,12,22,34,62,45,107,0.000333,0.181453,12,6532.302288,362.905683,544.358524,141.127046,3,6
0,0,10,10,12,16,28,35,26,61,0.000333,0.09775,6,1759.491901,97.74955,293.24865,107.01955,2,6
0,0,14,14,12,21,33,53,39,92,0.000333,0.154695,6,2784.505554,154.694753,464.084259,135.258216,3,6
0,0,13,13,12,21,33,52,37,89,0.000333,0.14965,6,2693.70646,149.650359,448.951077,135.258216,3,6
0,0,14,14,7,18,25,49,37,86,0.000333,0.133124,6,2396.229794,133.123877,399.371632,94.710134,2,6
0,0,17,17,12,21,33,62,45,107,0.000333,0.179917,12,6477.002049,359.833447,539.750171,135.258216,3,6
0,0,10,10,12,16,28,35,26,61,0.000333,0.09775,6,1759.491901,97.74955,293.24865,107.01955,2,6
0,0,14,14,12,20,32,53,39,92,0.000333,0.153333,6,2760,153.333333,460,129.458112,3,6
0,0,13,13,12,20,32,52,37,89,0.000333,0.148333,6,2670,148.333333,445,129.458112,3,6
0,0,3,3,10,15,25,16,16,32,0.000333,0.049534,5,743.01699,41.278722,148.603398,91.82264,1,6
0,0,3,3,10,15,25,16,16,32,0.000333,0.049534,5,743.01699,41.278722,148.603398,91.82264,1,6
0,0,12,12,13,18,31,38,35,73,0.000333,0.120552,6,2169.937984,120.55211,361.656331,123.164366,3,6
0,0,11,11,12,18,30,36,33,69,0.000333,0.112858,6,2031.452707,112.858484,338.575451,118.0782,3,6
0,0,12,12,13,18,31,38,35,73,0.000333,0.120552,6,2169.937984,120.55211,361.656331,123.164366,3,6
0,0,11,11,12,18,30,36,33,69,0.000333,0.112858,6,2031.452707,112.858484,338.575451,118.0782,3,6
0,0,16,16,15,53,68,119,104,223,0.000333,0.452501,7,9502.529495,527.918305,1357.504214,362.183143,9,6
0,0,13,13,14,51,65,99,93,192,0.000333,0.385432,7,8094.062341,449.67013,1156.29462,342.596661,8,6
0,0,6,6,12,33,45,44,57,101,0.000333,0.184892,6,3328.062976,184.892388,554.677163,209.484556,3,6
0,0,16,16,15,52,67,119,103,222,0.000333,0.448891,7,9426.702602,523.7057,1346.6718,355.026224,9,6
0,0,13,13,14,50,64,99,92,191,0.000333,0.382,7,8022,445.666667,1146,335.495778,8,6
0,0,6,6,12,32,44,44,56,100,0.000333,0.181981,6,3275.658971,181.981054,545.943162,203.01955,3,6
0,0,18,18,16,53,69,123,106,229,0.000333,0.466284,16,22381.63361,1243.424089,1398.852101,367.579784,9,6
0,0,15,15,15,51,66,103,95,198,0.000333,0.39893,7,8377.530249,465.418347,1196.790036,347.897051,8,6
0,0,8,8,13,34,47,48,59,107,0.000333,0.198114,6,3566.046043,198.113669,594.341007,221.079453,3,6
0,0,16,16,15,52,67,119,103,222,0.000333,0.448891,7,9426.702602,523.7057,1346.6718,355.026224,9,6
0,0,13,13,14,50,64,99,92,191,0.000333,0.382,7,8022,445.666667,1146,335.495778,8,6
0,0,6,6,12,32,44,44,56,100,0.000333,0.181981,6,3275.658971,181.981054,545.943162,203.01955,3,6
0,0,9,9,12,13,25,31,28,59,0.000333,0.091329,12,3287.850182,182.658343,273.987515,91.125266,2,6
0,0,9,9,12,13,25,31,28,59,0.000333,0.091329,12,3287.850182,182.658343,273.987515,91.125266,2,6
0,0,9,9,12,13,25,31,28,59,0.000333,0.091329,12,3287.850182,182.658343,273.987515,91.125266,2,6
0,0,3,3,10,13,23,15,15,30,0.000333,0.045236,5,678.534293,37.69635,135.706859,81.324997,1,6
0,0,3,3,10,14,24,20,17,37,0.000333,0.056548,5,848.218063,47.123226,169.643613,86.52225,1,6
0,0,8,8,13,21,34,43,33,76,0.000333,0.128882,6,2319.883056,128.882392,386.647176,140.344382,4,6
0,0,11,11,18,29,47,66,49,115,0.000333,0.212926,9,5748.999461,319.388859,638.777718,215.940099,5,6
0,0,8,8,13,20,33,43,32,75,0.000333,0.12611,6,2269.977354,126.109853,378.329559,134.544278,4,6
0,0,11,11,18,28,46,66,48,114,0.000333,0.209895,9,5667.174567,314.843031,629.686063,209.664588,5,6
0,0,3,3,10,16,26,19,18,37,0.000333,0.057972,5,869.581348,48.310075,173.91627,97.219281,1,6
0,0,7,7,13,20,33,40,31,71,0.000333,0.119384,6,2148.911895,119.383994,358.151982,134.544278,3,6
0,0,10,10,18,28,46,63,47,110,0.000333,0.202531,9,5468.326336,303.795908,607.591815,209.664588,4,6
0,0,12,12,14,18,32,39,35,74,0.000333,0.123333,7,2590,143.888889,370,128.361619,3,6
0,0,11,11,13,18,31,37,33,70,0.000333,0.115598,6,2080.76245,115.597914,346.793742,123.164366,3,6
0,0,3,3,10,14,24,16,16,32,0.000333,0.048906,5,733.594,40.755222,146.7188,86.52225,1,6
0,0,6,6,11,15,26,23,19,42,0.000333,0.065806,5,987.092341,54.838463,197.418468,96.657107,3,6
0,0,7,7,11,16,27,24,21,45,0.000333,0.071323,5,1069.849688,59.436094,213.969938,102.053748,3,6
0,0,6,6,11,15,26,23,19,42,0.000333,0.065806,5,987.092341,54.838463,197.418468,96.657107,3,6
0,0,7,7,11,16,27,24,21,45,0.000333,0.071323,5,1069.849688,59.436094,213.969938,102.053748,3,6
0,0,6,6,11,15,26,23,20,43,0.000333,0.067373,5,1010.594539,56.144141,202.118908,96.657107,2,6
0,0,7,7,11,16,27,24,22,46,0.000333,0.072908,5,1093.624125,60.756896,218.724825,102.053748,2,6
0,0,3,3,10,15,25,16,16,32,0.000333,0.049534,5,743.01699,41.278722,148.603398,91.82264,1,6
0,0,12,12,14,22,36,54,44,98,0.000333,0.168884,14,7093.137102,394.063172,506.65265,151.410465,6,6
0,0,3,3,10,14,24,20,17,37,0.000333,0.056548,5,848.218063,47.123226,169.643613,86.52225,1,6
0,0,3,3,10,14,24,18,17,35,0.000333,0.053491,5,802.368438,44.576024,160.473688,86.52225,1,6
0,0,3,3,10,15,25,17,20,37,0.000333,0.057274,5,859.113395,47.728522,171.822679,91.82264,1,6
0,0,7,7,13,18,31,29,25,54,0.000333,0.089176,6,1605.159605,89.175534,267.526601,123.164366,3,6
0,0,8,8,13,18,31,30,27,57,0.000333,0.09413,6,1694.335138,94.12973,282.38919,123.164366,3,6
0,0,28,28,20,54,74,133,95,228,0.000333,0.471918,10,14157.55367,786.53076,1415.755367,397.202487,10,6
0,0,27,27,20,53,73,132,93,225,0.000333,0.464237,10,13927.10526,773.72807,1392.710526,390.018346,10,6
0,0,3,3,10,14,24,15,15,30,0.000333,0.04585,5,687.744375,38.208021,137.548875,86.52225,1,6
0,0,3,3,10,14,24,15,15,30,0.000333,0.04585,5,687.744375,38.208021,137.548875,86.52225,1,6
0,0,3,3,10,14,24,15,15,30,0.000333,0.04585,5,687.744375,38.208021,137.548875,86.52225,1,6
0,0,12,12,13,17,30,36,34,70,0.000333,0.114494,12,4121.7881,228.988228,343.482342,117.592585,3,6
0,0,12,12,13,17,30,36,34,70,0.000333,0.114494,12,4121.7881,228.988228,343.482342,117.592585,3,6
0,0,12,12,13,18,31,36,35,71,0.000333,0.117249,6,2110.487628,117.249313,351.747938,123.164366,3,6
0,0,8,8,13,22,35,43,33,76,0.000333,0.129942,6,2338.953056,129.941836,389.825509,146.213212,4,6
0,0,11,11,18,30,48,66,49,115,0.000333,0.21409,9,5780.436188,321.135344,642.270688,222.265368,5,6
0,0,7,7,13,20,33,40,31,71,0.000333,0.119384,6,2148.911895,119.383994,358.151982,134.544278,3,6
0,0,10,10,18,28,46,63,47,110,0.000333,0.202531,9,5468.326336,303.795908,607.591815,209.664588,4,6
0,0,31,31,21,57,78,146,104,250,0.000333,0.523784,10,15713.50555,872.97253,1571.350555,424.713397,12,6
0,0,30,30,21,56,77,145,102,247,0.000333,0.515965,10,15478.96276,859.942375,1547.896276,417.450542,12,6
0,0,3,3,10,15,25,16,16,32,0.000333,0.049534,5,743.01699,41.278722,148.603398,91.82264,1,6
0,0,3,3,10,15,25,16,16,32,0.000333,0.049534,5,743.01699,41.278722,148.603398,91.82264,1,6
0,0,12,12,14,19,33,38,40,78,0.000333,0.131154,14,5508.478378,306.026577,393.462741,134.013592,3,6
0,0,31,31,20,57,77,146,105,251,0.000333,0.524321,10,15729.63422,873.868568,1572.963422,418.913293,11,6
0,0,30,30,20,56,76,145,103,248,0.000333,0.516495,10,15494.86023,860.825569,1549.486023,411.650438,11,6
0,0,17,17,15,24,39,80,52,132,0.000333,0.232558,14,9767.4233,542.634628,697.673093,168.642459,6,6
0,0,17,17,15,24,39,80,52,132,0.000333,0.232558,14,9767.4233,542.634628,697.673093,168.642459,6,6
0,0,20,20,16,25,41,90,64,154,0.000333,0.275021,16,13201.00814,733.389341,825.063009,180.096405,6,6
0,0,16,16,19,30,49,79,68,147,0.000333,0.275121,18,14856.52225,825.362347,825.362347,227.917341,5,6
0,0,13,13,14,24,38,61,42,103,0.000333,0.180179,7,3783.755737,210.208652,540.536534,163.342069,5,6
0,0,14,14,14,25,39,62,44,106,0.000333,0.186751,7,3921.768446,217.876025,560.252635,169.399374,5,6
0,0,13,13,14,24,38,61,42,103,0.000333,0.180179,7,3783.755737,210.208652,540.536534,163.342069,5,6
0,0,14,14,14,25,39,62,44,106,0.000333,0.186751,7,3921.768446,217.876025,560.252635,169.399374,5,6
0,0,14,14,14,22,36,57,43,100,0.000333,0.172331,7,3618.947501,201.052639,516.9925,151.410465,11,6
0,0,16,16,14,22,36,69,51,120,0.000333,0.206797,14,8685.474002,482.526333,620.391,151.410465,13,6
0,0,8,8,10,18,28,30,26,56,0.000333,0.089737,5,1346.059378,74.781077,269.211876,108.277931,6,6
0,0,10,10,12,19,31,35,29,64,0.000333,0.10569,6,1902.411383,105.689521,317.068564,123.730173,6,6
0,0,3,3,10,15,25,16,16,32,0.000333,0.049534,5,743.01699,41.278722,148.603398,91.82264,1,6
0,0,8,8,10,19,29,30,27,57,0.000333,0.092302,5,1384.524584,76.918032,276.904917,113.929904,6,6
0,0,3,3,10,14,24,18,17,35,0.000333,0.053491,5,802.368438,44.576024,160.473688,86.52225,1,6
0,0,3,3,10,15,25,18,17,35,0.000333,0.054178,5,812.674833,45.148602,162.534967,91.82264,1,6
0,0,3,3,10,15,25,18,17,35,0.000333,0.054178,5,812.674833,45.148602,162.534967,91.82264,1,6
0,0,3,3,11,11,22,16,12,28,0.000333,0.041621,5,624.320427,34.684468,124.864085,76.107496,1,6
0,0,3,3,10,15,25,19,17,36,0.000333,0.055726,5,835.894114,46.438562,167.178823,91.82264,1,6
0,0,4,4,7,11,18,13,13,26,0.000333,0.036139,3,325.25415,18.069675,108.41805,57.705232,1,6
0,0,7,7,11,14,25,26,21,47,0.000333,0.072754,5,1091.306205,60.628122,218.261241,91.356717,2,6
0,0,3,3,10,15,25,16,16,32,0.000333,0.049534,5,743.01699,41.278722,148.603398,91.82264,1,6
0,0,3,3,10,15,25,16,16,32,0.000333,0.049534,5,743.01699,41.278722,148.603398,91.82264,1,6
0,0,3,3,10,15,25,16,16,32,0.000333,0.049534,5,743.01699,41.278722,148.603398,91.82264,1,6
0,0,3,3,10,14,24,15,15,30,0.000333,0.04585,5,687.744375,38.208021,137.548875,86.52225,1,6
0,0,12,12,13,16,29,40,31,71,0.000333,0.114972,6,2069.499904,114.972217,344.916651,112.105716,3,6
0,0,11,11,13,16,29,38,29,67,0.000333,0.108495,6,1952.90836,108.494909,325.484727,112.105716,3,6
0,0,3,3,11,12,23,17,13,30,0.000333,0.045236,5,678.534293,37.69635,135.706859,81.073298,1,6
0,0,14,14,17,26,43,68,48,116,0.000333,0.209816,8,5035.573692,279.754094,629.446712,191.698301,5,6
0,0,15,15,17,27,44,69,50,119,0.000333,0.216557,8,5197.378901,288.743272,649.672363,197.868831,5,6
0,0,12,12,14,18,32,39,34,73,0.000333,0.121667,7,2555,141.944444,365,128.361619,3,6
0,0,11,11,13,18,31,37,32,69,0.000333,0.113947,6,2051.037273,113.946515,341.839545,123.164366,3,6
0,0,10,10,12,19,31,32,29,61,0.000333,0.100735,6,1813.23585,100.735325,302.205975,123.730173,2,6
0,0,3,3,10,15,25,16,16,32,0.000333,0.049534,5,743.01699,41.278722,148.603398,91.82264,1,6
0,0,20,20,15,44,59,107,70,177,0.000333,0.347076,7,7288.594738,404.92193,1041.22782,298.81835,9,6
0,0,9,9,10,20,30,45,31,76,0.000333,0.124308,5,1864.618426,103.589913,372.923685,119.657843,5,6
0,0,3,3,10,15,25,18,17,35,0.000333,0.054178,5,812.674833,45.148602,162.534967,91.82264,1,6
0,0,3,3,10,16,26,19,18,37,0.000333,0.057972,5,869.581348,48.310075,173.91627,97.219281,1,6
0,0,3,3,10,17,27,18,21,39,0.000333,0.061814,5,927.203063,51.511281,185.440613,102.706149,1,6
0,0,3,3,10,15,25,19,17,36,0.000333,0.055726,5,835.894114,46.438562,167.178823,91.82264,1,6
0,0,12,12,15,19,34,58,43,101,0.000333,0.171278,14,7193.672458,399.64847,513.833747,139.313982,6,6
0,0,3,3,10,13,23,15,15,30,0.000333,0.045236,5,678.534293,37.69635,135.706859,81.324997,1,6
0,0,14,14,15,26,41,64,47,111,0.000333,0.198229,7,4162.817908,231.267662,594.688273,180.814792,4,6
0,0,15,15,15,26,41,65,49,114,0.000333,0.203587,7,4275.3265,237.518139,610.760929,180.814792,4,6
0,0,8,8,10,20,30,34,28,62,0.000333,0.101409,5,1521.136085,84.50756,304.227217,119.657843,6,6
0,0,3,3,10,15,25,16,16,32,0.000333,0.049534,5,743.01699,41.278722,148.603398,91.82264,1,6
0,0,23,23,18,48,66,117,84,201,0.000333,0.404974,9,10934.30896,607.461609,1214.923218,343.13685,11,6
0,0,26,26,18,49,67,127,89,216,0.000333,0.436758,9,11792.47739,655.137633,1310.275265,350.179432,12,6
0,0,28,28,18,49,67,133,91,224,0.000333,0.452935,9,12229.23581,679.401989,1358.803979,350.179432,13,6
0,0,32,32,20,52,72,152,102,254,0.000333,0.522387,10,15671.6095,870.644972,1567.16095,382.861427,14,6
0,0,3,3,10,14,24,16,16,32,0.000333,0.048906,5,733.594,40.755222,146.7188,86.52225,1,6
0,0,3,3,11,11,22,17,13,30,0.000333,0.044594,5,668.914743,37.16193,133.782949,76.107496,1,6
0,0,10,10,10,15,25,33,31,64,0.000333,0.099069,10,2972.067961,165.114887,297.206796,91.82264,1,6
0,0,10,10,10,15,25,33,31,64,0.000333,0.099069,10,2972.067961,165.114887,297.206796,91.82264,1,6
0,0,10,10,10,15,25,33,31,64,0.000333,0.099069,10,2972.067961,165.114887,297.206796,91.82264,1,6
0,0,15,15,12,17,29,59,38,97,0.000333,0.157075,12,5654.689878,314.149438,471.224157,112.506418,4,6
0,0,11,11,10,15,25,37,29,66,0.000333,0.102165,5,1532.472543,85.137363,306.494509,91.82264,2,6
0,0,14,14,13,18,31,50,37,87,0.000333,0.143672,12,5172.180948,287.343386,431.015079,123.164366,3,6
0,0,8,8,10,15,25,26,20,46,0.000333,0.071206,5,1068.086924,59.338162,213.617385,91.82264,2,6
0,0,16,16,13,18,31,61,41,102,0.000333,0.168443,12,6063.936284,336.885349,505.328024,123.164366,4,6
0,0,6,6,9,13,22,17,17,34,0.000333,0.05054,4,606.4827,33.693483,151.620675,76.635041,2,6
0,0,9,9,12,16,28,30,25,55,0.000333,0.088135,6,1586.427124,88.13484,264.404521,107.01955,3,6
0,0,3,3,10,16,26,19,18,37,0.000333,0.057972,5,869.581348,48.310075,173.91627,97.219281,1,6
0,0,3,3,10,14,24,16,16,32,0.000333,0.048906,5,733.594,40.755222,146.7188,86.52225,1,6
0,0,3,3,10,14,24,16,16,32,0.000333,0.048906,5,733.594,40.755222,146.7188,86.52225,1,6
0,0,3,3,10,15,25,19,18,37,0.000333,0.057274,5,859.113395,47.728522,171.822679,91.82264,1,6
0,0,41,41,20,48,68,216,148,364,0.000333,0.738612,30,66475.09423,3693.06079,2215.836474,354.516762,19,6
0,0,45,45,20,49,69,228,155,383,0.000333,0.779855,30,70186.94601,3899.274778,2339.564867,361.559344,20,6
0,0,47,47,20,49,69,234,157,391,0.000333,0.796144,30,71652.99188,3980.721771,2388.433063,361.559344,21,6
0,0,50,50,21,52,73,251,166,417,0.000333,0.860386,30,77434.70523,4301.928068,2581.156841,388.661531,22,6
0,0,35,35,20,44,64,173,114,287,0.000333,0.574,20,34440,1913.333333,1722,326.653553,16,6
0,0,21,21,19,40,59,105,72,177,0.000333,0.347076,9,9371.050378,520.61391,1041.22782,293.587747,11,6
0,0,28,28,19,41,60,127,81,208,0.000333,0.409544,9,11057.6992,614.316622,1228.633244,300.370255,14,6
0,0,30,30,19,41,60,133,83,216,0.000333,0.425296,18,22965.99064,1275.888369,1275.888369,300.370255,15,6
0,0,44,44,20,44,64,207,131,338,0.000333,0.676,20,40560,2253.333333,2028,326.653553,19,6
0,0,18,18,17,38,55,93,67,160,0.000333,0.308339,8,7400.140433,411.118913,925.017554,268.908114,10,6
0,0,21,21,17,39,56,103,72,175,0.000333,0.338762,8,8130.296891,451.683161,1016.287111,275.617555,11,6
0,0,23,23,17,39,56,109,74,183,0.000333,0.354249,8,8501.967606,472.331534,1062.745951,275.617555,12,6
0,0,27,27,19,42,61,128,85,213,0.000333,0.421082,18,22738.44695,1263.247053,1263.247053,307.187955,13,6
0,0,23,23,18,46,64,117,83,200,0.000333,0.4,9,10800,600,1200,329.1425,11,6
0,0,26,26,18,47,65,127,88,215,0.000333,0.431603,9,11653.28172,647.40454,1294.80908,336.124326,12,6
0,0,28,28,18,47,65,133,90,223,0.000333,0.447663,9,12086.8922,671.494011,1342.988022,336.124326,13,6
0,0,32,32,20,50,70,152,101,253,0.000333,0.516903,20,31014.17207,1723.009559,1550.708603,368.631371,14,6
0,0,3,3,10,13,23,15,15,30,0.000333,0.045236,5,678.534293,37.69635,135.706859,81.324997,1,6
0,0,3,3,10,13,23,15,15,30,0.000333,0.045236,5,678.534293,37.69635,135.706859,81.324997,1,6
0,0,3,3,10,14,24,15,15,30,0.000333,0.04585,5,687.744375,38.208021,137.548875,86.52225,1,6
0,0,3,3,10,14,24,15,15,30,0.000333,0.04585,5,687.744375,38.208021,137.548875,86.52225,1,6
0,0,3,3,10,14,24,15,15,30,0.000333,0.04585,5,687.744375,38.208021,137.548875,86.52225,1,6
0,0,3,3,10,15,25,16,16,32,0.000333,0.049534,5,743.01699,41.278722,148.603398,91.82264,1,6
0,0,3,3,10,15,25,16,16,32,0.000333,0.049534,5,743.01699,41.278722,148.603398,91.82264,1,6
0,0,11,11,13,15,28,37,30,67,0.000333,0.107364,12,3865.113357,214.72852,322.09278,106.709075,2,6
0,0,10,10,13,15,28,35,28,63,0.000333,0.100954,6,1817.180161,100.954453,302.86336,106.709075,2,6
0,0,3,3,10,15,25,16,16,32,0.000333,0.049534,5,743.01699,41.278722,148.603398,91.82264,1,6
0,0,3,3,10,15,25,16,16,32,0.000333,0.049534,5,743.01699,41.278722,148.603398,91.82264,1,6
0,0,11,11,13,19,32,35,38,73,0.000333,0.121667,12,4380,243.333333,365,128.816339,2,6
0,0,3,3,12,15,27,20,18,38,0.000333,0.060229,6,1084.11435,60.228575,180.685725,101.622909,1,6
0,0,23,23,16,48,64,122,81,203,0.000333,0.406,8,9744,541.333333,1218,332.0782,11,6
0,0,9,9,11,20,31,45,31,76,0.000333,0.125506,5,1882.594598,104.588589,376.51892,124.49231,5,6
0,0,3,3,10,14,24,18,17,35,0.000333,0.053491,5,802.368438,44.576024,160.473688,86.52225,1,6
0,0,7,7,12,17,29,26,26,52,0.000333,0.084205,6,1515.69007,84.205004,252.615012,112.506418,2,6
0,0,7,7,12,17,29,26,26,52,0.000333,0.084205,6,1515.69007,84.205004,252.615012,112.506418,2,6
0,0,3,3,10,15,25,18,17,35,0.000333,0.054178,5,812.674833,45.148602,162.534967,91.82264,1,6
0,0,3,3,11,12,23,19,14,33,0.000333,0.049759,5,746.387723,41.465985,149.277545,81.073298,1,6
0,0,3,3,10,14,24,15,15,30,0.000333,0.04585,5,687.744375,38.208021,137.548875,86.52225,1,6
0,0,29,29,21,52,73,142,102,244,0.000333,0.503439,10,15103.17192,839.065107,1510.317192,388.661531,10,6
0,0,28,28,21,52,73,141,100,241,0.000333,0.497249,10,14917.47719,828.748733,1491.747719,388.661531,10,6
0,0,31,31,21,55,76,148,109,257,0.000333,0.535239,10,16057.17371,892.065206,1605.717371,410.21345,10,6
0,0,30,30,21,55,76,147,107,254,0.000333,0.528991,10,15869.73588,881.651994,1586.973588,410.21345,10,6
0,0,30,30,21,53,74,145,104,249,0.000333,0.515385,10,15461.53888,858.974382,1546.153888,395.81845,10,6
0,0,29,29,21,53,74,144,102,246,0.000333,0.509175,10,15275.25528,848.625293,1527.525528,395.81845,10,6
0,0,5,5,10,14,24,20,18,38,0.000333,0.058076,5,871.142875,48.396826,174.228575,86.52225,2,6
0,0,6,6,10,15,25,21,20,41,0.000333,0.063466,5,951.990519,52.888362,190.398104,91.82264,2,6
0,0,6,6,10,15,25,23,20,43,0.000333,0.066562,5,998.429081,55.468282,199.685816,91.82264,3,6
0,0,7,7,10,16,26,24,22,46,0.000333,0.072073,5,1081.101135,60.061174,216.220227,97.219281,3,6
0,0,9,9,12,19,31,32,30,62,0.000333,0.102387,6,1842.961027,102.386724,307.160171,123.730173,2,6
0,0,10,10,13,20,33,39,32,71,0.000333,0.119384,6,2148.911895,119.383994,358.151982,134.544278,2,6
0,0,9,9,12,19,31,32,30,62,0.000333,0.102387,6,1842.961027,102.386724,307.160171,123.730173,2,6
0,0,12,12,14,20,34,38,40,78,0.000333,0.132274,14,5555.509423,308.639412,396.822102,139.741531,3,6
0,0,3,3,10,14,24,16,16,32,0.000333,0.048906,5,733.594,40.755222,146.7188,86.52225,1,6
0,0,3,3,10,14,24,16,16,32,0.000333,0.048906,5,733.594,40.755222,146.7188,86.52225,1,6
0,0,21,21,18,43,61,96,71,167,0.000333,0.330144,9,8913.898218,495.216568,990.433135,308.388034,8,6
0,0,20,20,18,43,61,95,69,164,0.000333,0.324214,9,8753.76831,486.320462,972.640923,308.388034,8,6
0,0,3,3,12,17,29,21,19,40,0.000333,0.064773,6,1165.915439,64.77308,194.31924,112.506418,1,6
0,0,9,9,12,22,34,38,32,70,0.000333,0.118707,6,2136.734393,118.707466,356.122399,141.127046,4,6
0,0,10,10,14,29,43,50,42,92,0.000333,0.166405,7,3494.514502,194.139695,499.216357,194.184418,6,6
0,0,9,9,13,21,34,38,31,69,0.000333,0.117012,6,2106.209616,117.011645,351.034936,140.344382,4,6
0,0,10,10,15,28,43,50,41,91,0.000333,0.164597,7,3456.530649,192.02948,493.790093,193.209297,6,6
0,0,9,9,13,20,33,38,31,69,0.000333,0.116021,6,2088.379165,116.021065,348.063194,134.544278,4,6
0,0,10,10,15,27,42,50,41,91,0.000333,0.163567,7,3434.906198,190.828122,490.700885,186.985321,6,6
0,0,10,10,15,22,37,44,37,81,0.000333,0.140655,7,2953.760058,164.097781,421.965723,156.710855,4,6
0,0,11,11,17,29,46,56,47,103,0.000333,0.189642,8,4551.415052,252.856392,568.926881,210.368317,6,6
0,0,3,3,10,13,23,15,15,30,0.000333,0.045236,5,678.534293,37.69635,135.706859,81.324997,1,6
0,0,3,3,10,13,23,15,15,30,0.000333,0.045236,5,678.534293,37.69635,135.706859,81.324997,1,6
0,0,3,3,10,13,23,15,15,30,0.000333,0.045236,5,678.534293,37.69635,135.706859,81.324997,1,6
0,0,3,3,10,13,23,15,15,30,0.000333,0.045236,5,678.534293,37.69635,135.706859,81.324997,1,6
0,0,3,3,10,14,24,16,16,32,0.000333,0.048906,5,733.594,40.755222,146.7188,86.52225,1,6
0,0,13,13,16,20,36,65,45,110,0.000333,0.189564,16,9099.068003,505.503778,568.69175,150.438562,6,6
0,0,12,12,15,19,34,58,43,101,0.000333,0.171278,14,7193.672458,399.64847,513.833747,139.313982,6,6
0,0,12,12,15,19,34,58,43,101,0.000333,0.171278,14,7193.672458,399.64847,513.833747,139.313982,6,6
0,0,12,12,15,25,40,52,38,90,0.000333,0.159658,7,3352.8147,186.267483,478.973529,174.699764,5,6
0,0,12,12,14,30,44,56,45,101,0.000333,0.183801,7,3859.818154,214.434342,551.402593,200.509687,7,6
0,0,30,30,21,54,75,145,104,249,0.000333,0.516992,10,15509.75854,861.653252,1550.975854,403.002591,11,6
0,0,29,29,21,54,75,144,102,246,0.000333,0.510763,10,15322.89398,851.271888,1532.289398,403.002591,11,6
0,0,3,3,10,14,24,15,15,30,0.000333,0.04585,5,687.744375,38.208021,137.548875,86.52225,1,6
0,0,3,3,10,14,24,15,15,30,0.000333,0.04585,5,687.744375,38.208021,137.548875,86.52225,1,6
0,0,3,3,10,15,25,18,17,35,0.000333,0.054178,5,812.674833,45.148602,162.534967,91.82264,1,6
0,0,3,3,10,14,24,15,15,30,0.000333,0.04585,5,687.744375,38.208021,137.548875,86.52225,1,6
0,0,3,3,10,14,24,15,15,30,0.000333,0.04585,5,687.744375,38.208021,137.548875,86.52225,1,6
0,0,30,30,21,53,74,145,103,248,0.000333,0.513315,10,15399.44435,855.524686,1539.944435,395.81845,11,6
0,0,29,29,21,53,74,144,101,245,0.000333,0.507105,10,15213.16075,845.175597,1521.316075,395.81845,11,6
0,0,13,13,14,26,40,60,43,103,0.000333,0.18272,7,3837.110156,213.172786,548.158594,175.514402,5,6
0,0,14,14,14,27,41,61,45,106,0.000333,0.1893,7,3975.303587,220.850199,567.900512,181.684931,5,6
0,0,13,13,14,26,40,60,43,103,0.000333,0.18272,7,3837.110156,213.172786,548.158594,175.514402,5,6
0,0,14,14,14,27,41,61,45,106,0.000333,0.1893,7,3975.303587,220.850199,567.900512,181.684931,5,6
0,0,23,23,17,29,46,110,72,182,0.000333,0.335096,16,16084.61242,893.589579,1005.288276,210.368317,8,6
0,0,24,24,17,30,47,111,74,185,0.000333,0.342533,16,16441.583,913.421278,1027.598938,216.693586,8,6
0,0,12,12,14,17,31,39,34,73,0.000333,0.120552,14,5063.188629,281.288257,361.656331,122.789837,3,6
0,0,11,11,13,17,30,37,32,69,0.000333,0.112858,6,2031.452707,112.858484,338.575451,117.592585,3,6
0,0,14,14,14,21,35,64,47,111,0.000333,0.189783,14,7970.905808,442.8281,569.350415,145.541635,6,6
0,0,3,3,10,16,26,19,18,37,0.000333,0.057972,5,869.581348,48.310075,173.91627,97.219281,1,6
0,0,3,3,10,16,26,19,18,37,0.000333,0.057972,5,869.581348,48.310075,173.91627,97.219281,1,6
0,0,3,3,11,13,24,20,15,35,0.000333,0.053491,5,802.368438,44.576024,160.473688,86.159464,1,6
0,0,3,3,10,15,25,16,16,32,0.000333,0.049534,5,743.01699,41.278722,148.603398,91.82264,1,6
0,0,31,31,20,55,75,147,104,251,0.000333,0.521144,10,15634.33491,868.574162,1563.433491,404.413346,11,6
0,0,30,30,20,54,74,146,102,248,0.000333,0.513315,10,15399.44435,855.524686,1539.944435,397.202487,11,6
0,0,24,24,18,54,72,149,93,242,0.000333,0.497707,9,13438.09665,746.560925,1493.12185,385.822575,13,6
0,0,22,22,16,52,68,140,89,229,0.000333,0.464676,8,11152.23193,619.56844,1394.028991,360.422865,13,6
0,0,22,22,16,52,68,140,90,230,0.000333,0.466705,8,11200.93163,622.273979,1400.116453,360.422865,13,6
0,0,22,22,16,52,68,140,89,229,0.000333,0.464676,8,11152.23193,619.56844,1394.028991,360.422865,13,6
0,0,22,22,16,52,68,140,89,229,0.000333,0.464676,8,11152.23193,619.56844,1394.028991,360.422865,13,6
0,0,12,12,14,17,31,39,34,73,0.000333,0.120552,14,5063.188629,281.288257,361.656331,122.789837,3,6
0,0,11,11,13,17,30,37,32,69,0.000333,0.112858,6,2031.452707,112.858484,338.575451,117.592585,3,6
0,0,18,18,16,20,36,73,53,126,0.000333,0.217137,16,10422.5688,579.0316,651.41055,150.438562,4,6
0,0,17,17,16,20,36,71,51,122,0.000333,0.210244,16,10091.6936,560.649645,630.73085,150.438562,4,6
0,0,14,14,15,19,34,48,37,85,0.000333,0.144145,7,3027.040391,168.168911,432.434342,139.313982,3,6
0,0,17,17,14,20,34,63,47,110,0.000333,0.18654,14,7834.692776,435.26071,559.620913,139.741531,5,6
0,0,12,12,12,20,32,48,33,81,0.000333,0.135,6,2430,135,405,129.458112,3,6
0,0,3,3,10,14,24,15,15,30,0.000333,0.04585,5,687.744375,38.208021,137.548875,86.52225,1,6
0,0,3,3,10,14,24,15,15,30,0.000333,0.04585,5,687.744375,38.208021,137.548875,86.52225,1,6
0,0,13,13,19,20,39,53,42,95,0.000333,0.167371,18,9038.037794,502.113211,502.113211,167.149185,3,6
0,0,12,12,19,20,39,51,40,91,0.000333,0.160324,18,8657.488834,480.971602,480.971602,167.149185,3,6
0,0,20,20,21,24,45,93,67,160,0.000333,0.292899,20,17573.92991,976.329439,878.696495,202.277766,4,6
0,0,19,19,21,24,45,91,65,156,0.000333,0.285576,20,17134.58166,951.921203,856.729083,202.277766,4,6
0,0,15,15,20,23,43,62,46,108,0.000333,0.195346,20,11720.73187,651.151771,586.036594,190.480487,3,6
0,0,19,19,20,24,44,83,61,144,0.000333,0.262053,20,15723.16306,873.509059,786.158153,196.477662,5,6
0,0,13,13,17,24,41,62,42,104,0.000333,0.185728,8,4457.483268,247.637959,557.185408,179.525968,3,6
0,0,3,3,10,14,24,15,15,30,0.000333,0.04585,5,687.744375,38.208021,137.548875,86.52225,1,6
0,0,3,3,10,15,25,16,16,32,0.000333,0.049534,5,743.01699,41.278722,148.603398,91.82264,1,6
0,0,3,3,10,15,25,16,16,32,0.000333,0.049534,5,743.01699,41.278722,148.603398,91.82264,1,6
0,0,3,3,10,14,24,16,16,32,0.000333,0.048906,5,733.594,40.755222,146.7188,86.52225,1,6
0,0,25,25,17,49,66,127,84,211,0.000333,0.425122,8,10202.93727,566.829849,1275.367159,344.607651,11,6
0,0,11,11,12,21,33,50,34,84,0.000333,0.141243,6,2542.374636,141.243035,423.729106,135.258216,5,6
0,0,3,3,12,13,25,18,19,37,0.000333,0.057274,6,1030.936074,57.274226,171.822679,91.125266,1,6
0,0,13,13,18,21,39,52,43,95,0.000333,0.167371,18,9038.037794,502.113211,502.113211,167.297316,3,6
0,0,12,12,18,21,39,50,41,91,0.000333,0.160324,9,4328.744417,240.485801,480.971602,167.297316,3,6
0,0,3,3,10,14,24,16,16,32,0.000333,0.048906,5,733.594,40.755222,146.7188,86.52225,1,6
0,0,3,3,10,14,24,16,16,32,0.000333,0.048906,5,733.594,40.755222,146.7188,86.52225,1,6
0,0,3,3,10,14,24,16,16,32,0.000333,0.048906,5,733.594,40.755222,146.7188,86.52225,1,6
0,0,11,11,14,15,29,38,30,68,0.000333,0.110114,14,4624.797907,256.933217,330.342708,111.906328,2,6
0,0,10,10,14,15,29,36,28,64,0.000333,0.103637,7,2176.375486,120.909749,310.910784,111.906328,2,6
0,0,12,12,15,15,30,41,31,72,0.000333,0.117765,14,4946.14572,274.785873,353.296123,117.206718,3,6
0,0,11,11,15,15,30,39,29,68,0.000333,0.111223,7,2335.679924,129.759996,333.668561,117.206718,3,6
0,0,12,12,15,16,31,41,31,72,0.000333,0.118901,7,2496.91494,138.717497,356.702134,122.603359,3,6
0,0,11,11,15,16,31,39,29,68,0.000333,0.112295,7,2358.197444,131.010969,336.885349,122.603359,3,6
0,0,13,13,15,18,33,45,37,82,0.000333,0.13788,14,5790.964449,321.720247,413.640318,133.662009,2,6
0,0,12,12,15,18,33,43,35,78,0.000333,0.131154,7,2754.239189,153.013288,393.462741,133.662009,2,6
0,0,12,12,14,16,30,41,32,73,0.000333,0.119401,14,5014.842189,278.602344,358.203013,117.302969,2,6
0,0,11,11,14,16,30,39,30,69,0.000333,0.112858,7,2370.028158,131.668231,338.575451,117.302969,2,6
0,0,3,3,12,15,27,20,18,38,0.000333,0.060229,6,1084.11435,60.228575,180.685725,101.622909,1,6
0,0,3,3,10,16,26,19,18,37,0.000333,0.057972,5,869.581348,48.310075,173.91627,97.219281,1,6
0,0,14,14,14,21,35,56,48,104,0.000333,0.177815,14,7468.236073,414.902004,533.445434,145.541635,4,6
0,0,3,3,10,14,24,18,17,35,0.000333,0.053491,5,802.368438,44.576024,160.473688,86.52225,1,6
0,0,15,15,16,20,36,68,55,123,0.000333,0.211967,16,10174.4124,565.245133,635.900775,150.438562,6,6
0,0,3,3,10,15,25,16,16,32,0.000333,0.049534,5,743.01699,41.278722,148.603398,91.82264,1,6
0,0,3,3,10,15,25,16,16,32,0.000333,0.049534,5,743.01699,41.278722,148.603398,91.82264,1,6
0,0,17,17,15,22,37,80,58,138,0.000333,0.239635,14,10064.6639,559.147995,718.904564,156.710855,6,6
0,0,9,9,15,19,34,45,36,81,0.000333,0.137361,7,2884.591431,160.255079,412.08449,139.313982,2,6
0,0,12,12,14,22,36,54,44,98,0.000333,0.168884,14,7093.137102,394.063172,506.65265,151.410465,6,6
0,0,10,10,14,18,32,43,33,76,0.000333,0.126667,7,2660,147.777778,380,128.361619,2,6
0,0,8,8,13,18,31,39,31,70,0.000333,0.115598,6,2080.76245,115.597914,346.793742,123.164366,2,6
0,0,22,22,18,46,64,114,82,196,0.000333,0.392,9,10584,588,1176,329.1425,10,6
0,0,25,25,18,47,65,124,87,211,0.000333,0.423573,9,11436.47648,635.359804,1270.719609,336.124326,11,6
0,0,27,27,18,47,65,130,89,219,0.000333,0.439633,9,11870.08696,659.449276,1318.898551,336.124326,12,6
0,0,31,31,20,50,70,149,100,249,0.000333,0.50873,20,30523.82942,1695.768301,1526.191471,368.631371,13,6
0,0,23,23,18,46,64,117,83,200,0.000333,0.4,9,10800,600,1200,329.1425,11,6
0,0,26,26,18,47,65,127,88,215,0.000333,0.431603,9,11653.28172,647.40454,1294.80908,336.124326,12,6
0,0,28,28,18,47,65,133,90,223,0.000333,0.447663,9,12086.8922,671.494011,1342.988022,336.124326,13,6
0,0,32,32,20,50,70,152,101,253,0.000333,0.516903,20,31014.17207,1723.009559,1550.708603,368.631371,14,6
0,0,19,19,17,39,56,96,68,164,0.000333,0.317469,8,7619.249658,423.291648,952.406207,275.617555,11,6
0,0,22,22,17,40,57,106,73,179,0.000333,0.348029,8,8352.6985,464.038806,1044.087313,282.363992,12,6
0,0,24,24,17,40,57,112,75,187,0.000333,0.363583,8,8726.003461,484.77797,1090.750433,282.363992,13,6
0,0,28,28,19,43,62,131,86,217,0.000333,0.430687,18,23257.09079,1292.060599,1292.060599,314.040007,14,6
0,0,3,3,10,13,23,15,15,30,0.000333,0.045236,5,678.534293,37.69635,135.706859,81.324997,1,6
0,0,3,3,10,13,23,15,15,30,0.000333,0.045236,5,678.534293,37.69635,135.706859,81.324997,1,6
0,0,3,3,10,13,23,15,15,30,0.000333,0.045236,5,678.534293,37.69635,135.706859,81.324997,1,6
0,0,17,17,16,22,38,75,55,130,0.000333,0.22741,16,10915.68923,606.427179,682.230577,162.107496,6,6
0,0,3,3,10,15,25,16,16,32,0.000333,0.049534,5,743.01699,41.278722,148.603398,91.82264,1,6
0,0,3,3,10,15,25,16,16,32,0.000333,0.049534,5,743.01699,41.278722,148.603398,91.82264,1,6
0,0,3,3,10,15,25,16,16,32,0.000333,0.049534,5,743.01699,41.278722,148.603398,91.82264,1,6
0,0,28,28,24,58,82,151,115,266,0.000333,0.563703,12,20293.306,1127.405889,1691.108833,449.801998,9,6
0,0,8,8,10,18,28,30,27,57,0.000333,0.09134,5,1370.096153,76.116453,274.019231,108.277931,6,6
0,0,10,10,12,20,32,35,29,64,0.000333,0.106667,6,1920,106.666667,320,129.458112,6,6
0,0,14,14,14,23,37,57,43,100,0.000333,0.173648,7,3646.617356,202.589853,520.945337,157.344894,11,6
0,0,16,16,14,23,37,69,51,120,0.000333,0.208378,14,8751.881654,486.215647,625.134404,157.344894,13,6
0,0,10,10,11,20,31,34,29,63,0.000333,0.104038,5,1560.571838,86.698435,312.114368,124.49231,6,6
0,0,12,12,14,22,36,54,44,98,0.000333,0.168884,14,7093.137102,394.063172,506.65265,151.410465,6,6
0,0,12,12,14,22,36,54,44,98,0.000333,0.168884,14,7093.137102,394.063172,506.65265,151.410465,6,6
0,0,16,16,18,31,49,71,63,134,0.000333,0.25079,18,13542.68014,752.371119,752.371119,228.638736,4,6
0,0,3,3,10,13,23,15,15,30,0.000333,0.045236,5,678.534293,37.69635,135.706859,81.324997,1,6
0,0,30,30,22,52,74,139,96,235,0.000333,0.486407,11,16051.43695,891.746497,1459.221541,394.530361,10,6
0,0,29,29,22,51,73,138,94,232,0.000333,0.47868,11,15796.43227,877.579571,1436.039298,387.401188,10,6
0,0,12,12,16,29,45,49,46,95,0.000333,0.173909,8,4173.808353,231.878242,521.726044,204.881449,6,6
0,0,12,12,16,30,46,49,46,95,0.000333,0.174913,8,4197.907087,233.21706,524.738386,211.206718,6,6
0,0,27,27,21,48,69,132,93,225,0.000333,0.458139,10,13744.18003,763.565557,1374.418003,360.316866,9,6
0,0,26,26,21,48,69,131,91,222,0.000333,0.452031,10,13560.92429,753.384683,1356.092429,360.316866,9,6
0,0,27,27,22,49,71,132,93,225,0.000333,0.461231,11,15220.62412,845.590229,1383.693102,373.228278,9,6
0,0,26,26,22,49,71,131,91,222,0.000333,0.455081,11,15017.68247,834.315693,1365.243861,373.228278,9,6
0,0,27,27,21,49,70,132,93,225,0.000333,0.459696,10,13790.88679,766.160377,1379.088679,367.359448,9,6
0,0,26,26,21,49,70,131,91,222,0.000333,0.453567,10,13607.0083,755.944905,1360.70083,367.359448,9,6
0,0,10,10,15,22,37,47,37,84,0.000333,0.145865,7,3063.158579,170.175477,437.594083,156.710855,2,6
0,0,10,10,15,23,38,52,38,90,0.000333,0.157438,7,3306.194333,183.677463,472.313476,162.645284,2,6
0,0,8,8,14,21,35,43,34,77,0.000333,0.131652,7,2764.683546,153.59353,394.954792,145.541635,2,6
0,0,7,7,13,21,34,40,33,73,0.000333,0.123795,6,2228.308724,123.794929,371.384787,140.344382,1,6
0,0,3,3,10,15,25,19,18,37,0.000333,0.057274,5,859.113395,47.728522,171.822679,91.82264,1,6
0,0,3,3,10,15,25,19,18,37,0.000333,0.057274,5,859.113395,47.728522,171.822679,91.82264,1,6
0,0,17,17,15,24,39,80,52,132,0.000333,0.232558,14,9767.4233,542.634628,697.673093,168.642459,6,6
0,0,3,3,10,14,24,20,17,37,0.000333,0.056548,5,848.218063,47.123226,169.643613,86.52225,1,6
0,0,3,3,12,16,28,20,18,38,0.000333,0.060893,6,1096.076922,60.893162,182.679487,107.01955,1,6
0,0,3,3,7,3,10,8,5,13,0.000333,0.014395,3,129.555196,7.197511,43.185065,24.406372,1,6
0,0,5,5,8,5,13,15,10,25,0.000333,0.030837,8,740.087944,41.115997,92.510993,35.60964,1,6
0,0,15,15,15,21,36,74,48,122,0.000333,0.210244,14,8830.231902,490.568439,630.73085,150.842025,6,6
0,0,15,15,15,21,36,74,48,122,0.000333,0.210244,14,8830.231902,490.568439,630.73085,150.842025,6,6
0,0,23,23,18,46,64,117,83,200,0.000333,0.4,9,10800,600,1200,329.1425,11,6
0,0,26,26,18,47,65,127,88,215,0.000333,0.431603,9,11653.28172,647.40454,1294.80908,336.124326,12,6
0,0,28,28,18,47,65,133,90,223,0.000333,0.447663,9,12086.8922,671.494011,1342.988022,336.124326,13,6
0,0,32,32,20,50,70,152,101,253,0.000333,0.516903,20,31014.17207,1723.009559,1550.708603,368.631371,14,6
0,0,3,3,11,12,23,20,15,35,0.000333,0.052775,5,791.623342,43.979075,158.324668,81.073298,1,6
0,0,3,3,10,14,24,16,16,32,0.000333,0.048906,5,733.594,40.755222,146.7188,86.52225,1,6
0,0,3,3,10,13,23,15,15,30,0.000333,0.045236,5,678.534293,37.69635,135.706859,81.324997,1,6
0,0,3,3,10,13,23,15,15,30,0.000333,0.045236,5,678.534293,37.69635,135.706859,81.324997,1,6
0,0,3,3,10,13,23,15,15,30,0.000333,0.045236,5,678.534293,37.69635,135.706859,81.324997,1,6
0,0,3,3,10,13,23,15,15,30,0.000333,0.045236,5,678.534293,37.69635,135.706859,81.324997,1,6
0,0,3,3,10,14,24,16,16,32,0.000333,0.048906,5,733.594,40.755222,146.7188,86.52225,1,6
0,0,3,3,10,14,24,16,16,32,0.000333,0.048906,5,733.594,40.755222,146.7188,86.52225,1,6
0,0,3,3,10,14,24,15,15,30,0.000333,0.04585,5,687.744375,38.208021,137.548875,86.52225,1,6
0,0,3,3,10,14,24,15,15,30,0.000333,0.04585,5,687.744375,38.208021,137.548875,86.52225,1,6
0,0,3,3,10,16,26,20,18,38,0.000333,0.059539,5,893.083546,49.615753,178.616709,97.219281,1,6
0,0,21,21,18,44,62,96,72,168,0.000333,0.333435,9,9002.744821,500.15249,1000.30498,315.273641,8,6
0,0,20,20,18,44,62,95,70,165,0.000333,0.327481,9,8841.981521,491.221196,982.442391,315.273641,8,6
0,0,8,8,12,18,30,29,28,57,0.000333,0.093231,6,1678.156584,93.230921,279.692764,118.0782,2,6
0,0,3,3,10,13,23,15,15,30,0.000333,0.045236,5,678.534293,37.69635,135.706859,81.324997,1,6
0,0,3,3,10,13,23,15,15,30,0.000333,0.045236,5,678.534293,37.69635,135.706859,81.324997,1,6
0,0,3,3,10,14,24,15,15,30,0.000333,0.04585,5,687.744375,38.208021,137.548875,86.52225,1,6
0,0,3,3,10,14,24,15,15,30,0.000333,0.04585,5,687.744375,38.208021,137.548875,86.52225,1,6
0,0,3,3,10,13,23,15,15,30,0.000333,0.045236,5,678.534293,37.69635,135.706859,81.324997,1,6
0,0,3,3,10,13,23,15,15,30,0.000333,0.045236,5,678.534293,37.69635,135.706859,81.324997,1,6
0,0,3,3,10,14,24,18,17,35,0.000333,0.053491,5,802.368438,44.576024,160.473688,86.52225,1,6
0,0,10,10,12,18,30,32,28,60,0.000333,0.098138,6,1766.480614,98.137812,294.413436,118.0782,2,6
0,0,12,12,14,20,34,43,36,79,0.000333,0.13397,7,2813.366951,156.298164,401.909564,139.741531,2,6
0,0,11,11,15,21,36,41,33,74,0.000333,0.127525,7,2678.021151,148.778953,382.57445,150.842025,3,6
0,0,10,10,11,16,27,34,29,63,0.000333,0.099853,5,1497.789563,83.210531,299.557913,102.053748,1,6
0,0,9,9,12,17,29,32,26,58,0.000333,0.093921,6,1690.577386,93.920966,281.762898,112.506418,2,6
0,0,13,13,13,19,32,41,33,74,0.000333,0.123333,6,2220,123.333333,370,128.816339,2,6
0,0,12,12,13,20,33,39,30,69,0.000333,0.116021,6,2088.379165,116.021065,348.063194,134.544278,3,6
0,0,14,14,12,21,33,52,37,89,0.000333,0.14965,6,2693.70646,149.650359,448.951077,135.258216,3,6
0,0,16,16,13,20,33,56,42,98,0.000333,0.164784,12,5932.207484,329.567082,494.350624,134.544278,2,6
0,0,15,15,13,21,34,54,39,93,0.000333,0.157711,6,2838.804265,157.711348,473.134044,140.344382,3,6
0,0,17,17,15,24,39,80,52,132,0.000333,0.232558,14,9767.4233,542.634628,697.673093,168.642459,6,6
0,0,12,12,13,20,33,37,40,77,0.000333,0.129473,12,4661.020166,258.945565,388.418347,134.544278,3,6
0,0,13,13,13,21,34,37,40,77,0.000333,0.130578,6,2350.407833,130.578213,391.734639,140.344382,3,6
0,0,12,12,13,20,33,37,40,77,0.000333,0.129473,12,4661.020166,258.945565,388.418347,134.544278,3,6
0,0,12,12,13,20,33,37,39,76,0.000333,0.127791,6,2300.243718,127.791318,383.373953,134.544278,3,6
0,0,13,13,12,17,29,44,41,85,0.000333,0.137643,12,4955.140615,275.28559,412.928385,112.506418,2,6
0,0,3,3,10,14,24,16,16,32,0.000333,0.048906,5,733.594,40.755222,146.7188,86.52225,1,6
0,0,13,13,13,20,33,41,51,92,0.000333,0.154695,12,5569.011108,309.389506,464.084259,134.544278,2,6
0,0,3,3,10,14,24,15,15,30,0.000333,0.04585,5,687.744375,38.208021,137.548875,86.52225,1,6
0,0,3,3,10,14,24,15,15,30,0.000333,0.04585,5,687.744375,38.208021,137.548875,86.52225,1,6
0,0,3,3,10,14,24,15,15,30,0.000333,0.04585,5,687.744375,38.208021,137.548875,86.52225,1,6
0,0,3,3,10,13,23,15,15,30,0.000333,0.045236,5,678.534293,37.69635,135.706859,81.324997,1,6
0,0,3,3,10,13,23,15,15,30,0.000333,0.045236,5,678.534293,37.69635,135.706859,81.324997,1,6
0,0,14,14,14,24,38,63,54,117,0.000333,0.204669,14,8596.105267,477.561404,614.007519,163.342069,6,6
0,0,3,3,10,14,24,18,17,35,0.000333,0.053491,5,802.368438,44.576024,160.473688,86.52225,1,6
0,0,13,13,17,28,45,55,56,111,0.000333,0.203199,16,9753.531099,541.862839,609.595694,204.092806,2,6
0,0,31,31,20,58,78,146,105,251,0.000333,0.525879,10,15776.35957,876.464421,1577.635957,426.20146,12,6
0,0,30,30,20,57,77,145,103,248,0.000333,0.518054,10,15541.63062,863.423923,1554.163062,418.913293,12,6
0,0,17,17,15,24,39,80,52,132,0.000333,0.232558,14,9767.4233,542.634628,697.673093,168.642459,6,6
0,0,17,17,15,24,39,80,52,132,0.000333,0.232558,14,9767.4233,542.634628,697.673093,168.642459,6,6
0,0,9,9,13,20,33,33,33,66,0.000333,0.110977,6,1997.580071,110.976671,332.930012,134.544278,2,6
0,0,3,3,10,14,24,15,15,30,0.000333,0.04585,5,687.744375,38.208021,137.548875,86.52225,1,6
0,0,3,3,10,15,25,19,18,37,0.000333,0.057274,5,859.113395,47.728522,171.822679,91.82264,1,6
0,0,3,3,10,15,25,19,18,37,0.000333,0.057274,5,859.113395,47.728522,171.822679,91.82264,1,6
0,0,3,3,10,14,24,16,16,32,0.000333,0.048906,5,733.594,40.755222,146.7188,86.52225,1,6
0,0,3,3,11,12,23,20,15,35,0.000333,0.052775,5,791.623342,43.979075,158.324668,81.073298,1,6
0,0,3,3,11,11,22,17,13,30,0.000333,0.044594,5,668.914743,37.16193,133.782949,76.107496,1,6
0,0,9,9,13,19,32,40,32,72,0.000333,0.12,6,2160,120,360,128.816339,4,6
0,0,9,9,13,19,32,40,32,72,0.000333,0.12,6,2160,120,360,128.816339,4,6
0,0,3,3,10,13,23,15,15,30,0.000333,0.045236,5,678.534293,37.69635,135.706859,81.324997,1,6
0,0,3,3,10,13,23,15,15,30,0.000333,0.045236,5,678.534293,37.69635,135.706859,81.324997,1,6
0,0,3,3,10,13,23,15,15,30,0.000333,0.045236,5,678.534293,37.69635,135.706859,81.324997,1,6
0,0,3,3,10,13,23,15,15,30,0.000333,0.045236,5,678.534293,37.69635,135.706859,81.324997,1,6
0,0,11,11,13,20,33,46,36,82,0.000333,0.13788,6,2481.841907,137.880106,413.640318,134.544278,4,6
0,0,3,3,12,17,29,21,19,40,0.000333,0.064773,6,1165.915439,64.77308,194.31924,112.506418,1,6
0,0,3,3,12,14,26,18,19,37,0.000333,0.057972,6,1043.497617,57.97209,173.91627,96.322519,1,6
0,0,14,14,15,26,41,64,51,115,0.000333,0.205373,7,4312.829364,239.601631,616.118481,180.814792,6,6
0,0,3,3,10,14,24,15,15,30,0.000333,0.04585,5,687.744375,38.208021,137.548875,86.52225,1,6
0,0,3,3,10,14,24,15,15,30,0.000333,0.04585,5,687.744375,38.208021,137.548875,86.52225,1,6
0,0,10,10,15,20,35,49,39,88,0.000333,0.150459,7,3159.638338,175.535463,451.376905,145.041921,6,6
0,0,3,3,10,14,24,18,17,35,0.000333,0.053491,5,802.368438,44.576024,160.473688,86.52225,1,6
0,0,11,11,15,22,37,56,40,96,0.000333,0.166703,7,3500.752662,194.486259,500.107523,156.710855,3,6
0,0,12,12,15,22,37,57,42,99,0.000333,0.171912,7,3610.151182,200.563955,515.735883,156.710855,3,6
0,0,3,3,10,14,24,19,17,36,0.000333,0.05502,5,825.29325,45.849625,165.05865,86.52225,1,6
0,0,3,3,10,16,26,19,18,37,0.000333,0.057972,5,869.581348,48.310075,173.91627,97.219281,1,6
0,0,3,3,10,13,23,15,15,30,0.000333,0.045236,5,678.534293,37.69635,135.706859,81.324997,1,6
0,0,12,12,13,17,30,36,35,71,0.000333,0.11613,12,4180.670787,232.259488,348.389232,117.592585,2,6
0,0,8,8,13,21,34,43,32,75,0.000333,0.127187,6,2289.358279,127.186571,381.559713,140.344382,4,6
0,0,11,11,18,29,47,66,48,114,0.000333,0.211074,9,5699.008162,316.611565,633.223129,215.940099,5,6
0,0,8,8,13,21,34,43,32,75,0.000333,0.127187,6,2289.358279,127.186571,381.559713,140.344382,4,6
0,0,11,11,18,29,47,66,48,114,0.000333,0.211074,9,5699.008162,316.611565,633.223129,215.940099,5,6
0,0,3,3,10,13,23,15,15,30,0.000333,0.045236,5,678.534293,37.69635,135.706859,81.324997,1,6
0,0,8,8,12,17,29,28,22,50,0.000333,0.080966,6,1457.394299,80.96635,242.89905,112.506418,3,6
0,0,9,9,12,17,29,29,24,53,0.000333,0.085824,6,1544.837956,85.824331,257.472993,112.506418,3,6
0,0,23,23,18,46,64,106,80,186,0.000333,0.372,9,10044,558,1116,329.1425,9,6
0,0,22,22,18,46,64,105,78,183,0.000333,0.366,9,9882,549,1098,329.1425,9,6
0,0,24,24,18,47,65,109,81,190,0.000333,0.381417,9,10298.24896,572.124942,1144.249884,336.124326,10,6
0,0,23,23,18,47,65,108,79,187,0.000333,0.375394,9,10135.64503,563.091391,1126.182781,336.124326,10,6
0,0,7,7,10,17,27,27,25,52,0.000333,0.082418,5,1236.270751,68.681708,247.25415,102.706149,5,6
0,0,3,3,10,15,25,16,16,32,0.000333,0.049534,5,743.01699,41.278722,148.603398,91.82264,1,6
0,0,3,3,10,15,25,16,16,32,0.000333,0.049534,5,743.01699,41.278722,148.603398,91.82264,1,6
0,0,3,3,10,15,25,16,16,32,0.000333,0.049534,5,743.01699,41.278722,148.603398,91.82264,1,6
0,0,3,3,10,15,25,16,16,32,0.000333,0.049534,5,743.01699,41.278722,148.603398,91.82264,1,6
0,0,3,3,10,15,25,16,16,32,0.000333,0.049534,5,743.01699,41.278722,148.603398,91.82264,1,6
0,0,10,10,14,18,32,41,30,71,0.000333,0.118333,7,2485,138.055556,355,128.361619,4,6
0,0,3,3,10,14,24,18,17,35,0.000333,0.053491,5,802.368438,44.576024,160.473688,86.52225,1,6
0,0,3,3,10,14,24,18,17,35,0.000333,0.053491,5,802.368438,44.576024,160.473688,86.52225,1,6
0,0,3,3,10,14,24,18,17,35,0.000333,0.053491,5,802.368438,44.576024,160.473688,86.52225,1,6
0,0,3,3,10,14,24,16,16,32,0.000333,0.048906,5,733.594,40.755222,146.7188,86.52225,1,6
0,0,3,3,10,15,25,19,18,37,0.000333,0.057274,5,859.113395,47.728522,171.822679,91.82264,1,6
0,0,3,3,12,15,27,20,18,38,0.000333,0.060229,6,1084.11435,60.228575,180.685725,101.622909,1,6
0,0,15,15,15,21,36,74,48,122,0.000333,0.210244,14,8830.231902,490.568439,630.73085,150.842025,6,6
0,0,3,3,10,14,24,16,16,32,0.000333,0.048906,5,733.594,40.755222,146.7188,86.52225,1,6
0,0,3,3,10,14,24,16,16,32,0.000333,0.048906,5,733.594,40.755222,146.7188,86.52225,1,6
0,0,28,28,21,54,75,133,94,227,0.000333,0.471314,10,14139.41843,785.523246,1413.941843,403.002591,10,6
0,0,27,27,21,53,74,132,92,224,0.000333,0.463639,10,13909.17554,772.731974,1390.917554,395.81845,10,6
0,0,30,30,21,54,75,137,97,234,0.000333,0.485848,10,14575.43574,809.74643,1457.543574,403.002591,10,6
0,0,29,29,21,53,74,136,95,231,0.000333,0.478128,10,14343.83728,796.879849,1434.383727,395.81845,10,6
0,0,30,30,22,54,76,138,97,235,0.000333,0.489421,11,16150.89262,897.271812,1468.262966,408.871421,10,6
0,0,29,29,22,53,75,137,95,232,0.000333,0.481695,11,15895.9453,883.108072,1445.085936,401.68728,10,6
0,0,28,28,20,53,73,133,94,227,0.000333,0.468363,10,14050.90175,780.605653,1405.090175,390.018346,10,6
0,0,27,27,20,52,72,132,92,224,0.000333,0.460688,10,13820.632,767.812889,1382.0632,382.861427,10,6
0,0,29,29,23,55,78,140,101,241,0.000333,0.504927,11,16662.60128,925.700071,1514.781935,422.016709,10,6
0,0,28,28,23,54,77,139,99,238,0.000333,0.497165,11,16406.44716,911.469287,1491.495197,414.80585,10,6
0,0,3,3,10,14,24,15,15,30,0.000333,0.04585,5,687.744375,38.208021,137.548875,86.52225,1,6
0,0,12,12,12,18,30,38,35,73,0.000333,0.119401,6,2149.218081,119.401004,358.203013,118.0782,2,6
0,0,11,11,12,18,30,36,33,69,0.000333,0.112858,6,2031.452707,112.858484,338.575451,118.0782,2,6
0,0,11,11,12,17,29,35,33,68,0.000333,0.110114,6,1982.056246,110.114236,330.342708,112.506418,2,6
0,0,10,10,11,17,28,33,31,64,0.000333,0.102557,5,1538.353575,85.464088,307.670715,107.540616,2,6
0,0,13,13,12,19,31,44,40,84,0.000333,0.138717,12,4993.829881,277.434993,416.15249,123.730173,3,6
0,0,12,12,11,19,30,42,38,80,0.000333,0.13085,10,3925.512476,218.084026,392.551248,118.764371,3,6
0,0,12,12,13,18,31,38,34,72,0.000333,0.118901,6,2140.212806,118.900711,356.702134,123.164366,3,6
0,0,11,11,12,18,30,36,32,68,0.000333,0.111223,6,2002.011363,111.222854,333.668561,118.0782,3,6
0,0,14,14,14,26,40,62,49,111,0.000333,0.196911,7,4135.13813,229.729896,590.734019,175.514402,6,6
0,0,9,9,12,13,25,31,28,59,0.000333,0.091329,12,3287.850182,182.658343,273.987515,91.125266,2,6
0,0,28,28,20,52,72,134,94,228,0.000333,0.468914,10,14067.429,781.523834,1406.7429,382.861427,9,6
0,0,27,27,20,51,71,133,92,225,0.000333,0.461231,10,13836.93102,768.71839,1383.693102,375.732254,9,6
0,0,29,29,21,52,73,137,98,235,0.000333,0.48487,10,14546.08771,808.115984,1454.608771,388.661531,9,6
0,0,28,28,21,52,73,136,96,232,0.000333,0.47868,10,14360.39298,797.79961,1436.039298,388.661531,9,6
0,0,13,13,15,23,38,61,50,111,0.000333,0.194173,14,8155.279356,453.071075,582.519954,162.645284,3,6
0,0,14,14,15,23,38,62,52,114,0.000333,0.199421,14,8375.692311,465.31624,598.263737,162.645284,3,6
0,0,3,3,10,15,25,16,16,32,0.000333,0.049534,5,743.01699,41.278722,148.603398,91.82264,1,6
0,0,13,13,15,23,38,60,46,106,0.000333,0.185427,14,7787.92443,432.662468,556.280316,162.645284,3,6
0,0,14,14,15,23,38,61,48,109,0.000333,0.190675,14,8008.337386,444.907633,572.024099,162.645284,3,6
0,0,3,3,12,17,29,21,19,40,0.000333,0.064773,6,1165.915439,64.77308,194.31924,112.506418,1,6
0,0,13,13,14,20,34,43,40,83,0.000333,0.140753,14,5911.631822,328.42399,422.259416,139.741531,2,6
0,0,12,12,14,20,34,41,38,79,0.000333,0.13397,7,2813.366951,156.298164,401.909564,139.741531,2,6
0,0,3,3,10,15,25,19,18,37,0.000333,0.057274,5,859.113395,47.728522,171.822679,91.82264,1,6
0,0,3,3,10,15,25,21,18,39,0.000333,0.06037,5,905.551957,50.308442,181.110391,91.82264,1,6
0,0,3,3,10,14,24,16,16,32,0.000333,0.048906,5,733.594,40.755222,146.7188,86.52225,1,6
0,0,3,3,10,13,23,15,15,30,0.000333,0.045236,5,678.534293,37.69635,135.706859,81.324997,1,6
0,0,3,3,10,13,23,15,15,30,0.000333,0.045236,5,678.534293,37.69635,135.706859,81.324997,1,6
0,0,3,3,10,15,25,16,16,32,0.000333,0.049534,5,743.01699,41.278722,148.603398,91.82264,1,6
0,0,3,3,10,15,25,16,16,32,0.000333,0.049534,5,743.01699,41.278722,148.603398,91.82264,1,6
0,0,17,17,8,20,28,64,52,116,0.000333,0.185884,8,4461.225368,247.845854,557.653171,110.438562,1,6
0,0,20,20,13,23,36,77,60,137,0.000333,0.236093,12,8499.356702,472.186483,708.279725,152.147641,2,6
0,0,10,10,12,17,29,38,28,66,0.000333,0.106876,6,1923.760474,106.875582,320.626746,112.506418,2,6
0,0,16,16,8,19,27,56,48,104,0.000333,0.164836,8,3956.066402,219.781467,494.5083,104.710623,1,6
0,0,19,19,13,22,35,69,56,125,0.000333,0.21372,12,7693.924525,427.440251,641.160377,146.213212,2,6
0,0,10,10,12,17,29,38,28,66,0.000333,0.106876,6,1923.760474,106.875582,320.626746,112.506418,2,6
0,0,15,15,6,18,24,51,45,96,0.000333,0.146719,6,2640.9384,146.7188,440.1564,90.568425,1,6
0,0,18,18,12,21,33,64,53,117,0.000333,0.196731,12,7082.329344,393.462741,590.194112,135.258216,2,6
0,0,10,10,12,16,28,37,28,65,0.000333,0.104159,6,1874.86842,104.159357,312.47807,107.01955,2,6
0,0,13,13,6,16,22,39,50,89,0.000333,0.132296,9,3572.004727,198.444707,396.889414,79.509775,1,6
0,0,16,16,12,19,31,52,58,110,0.000333,0.181654,18,9809.308695,544.961594,544.961594,123.730173,2,6
0,0,10,10,12,16,28,37,28,65,0.000333,0.104159,6,1874.86842,104.159357,312.47807,107.01955,2,6
0,0,38,38,22,53,75,312,182,494,0.000333,1.025679,33,101542.2023,5641.233461,3077.036433,401.68728,20,6
0,0,24,24,18,47,65,109,81,190,0.000333,0.381417,9,10298.24896,572.124942,1144.249884,336.124326,10,6
0,0,23,23,18,47,65,108,79,187,0.000333,0.375394,9,10135.64503,563.091391,1126.182781,336.124326,10,6
0,0,3,3,12,13,25,17,18,35,0.000333,0.054178,6,975.2098,54.178322,162.534967,91.125266,1,6
0,0,12,12,15,17,32,37,34,71,0.000333,0.118333,14,4970,276.111111,355,128.090227,3,6
0,0,13,13,17,19,36,43,40,83,0.000333,0.143035,16,6865.660402,381.425578,429.103775,150.197491,3,6
0,0,13,13,14,17,31,40,39,79,0.000333,0.130461,14,5479.341119,304.40784,391.381509,122.789837,2,6
0,0,16,16,15,53,68,119,104,223,0.000333,0.452501,7,9502.529495,527.918305,1357.504214,362.183143,9,6
0,0,13,13,14,51,65,99,93,192,0.000333,0.385432,7,8094.062341,449.67013,1156.29462,342.596661,8,6
0,0,6,6,12,33,45,44,57,101,0.000333,0.184892,6,3328.062976,184.892388,554.677163,209.484556,3,6
0,0,15,15,15,51,66,116,102,218,0.000333,0.439226,14,18447.49085,1024.860603,1317.677918,347.897051,8,6
0,0,12,12,14,49,63,96,91,187,0.000333,0.372584,7,7824.25942,434.681079,1117.751346,328.423751,7,6
0,0,5,5,12,31,43,41,55,96,0.000333,0.17364,6,3125.528499,173.640472,520.921416,196.599636,2,6
0,0,12,12,15,20,35,51,36,87,0.000333,0.148749,7,3123.733357,173.540742,446.247622,145.041921,4,6
0,0,13,13,15,21,36,52,38,90,0.000333,0.155098,7,3257.052751,180.947375,465.29325,150.842025,4,6
0,0,13,13,15,21,36,54,38,92,0.000333,0.158544,7,3329.431701,184.968428,475.6331,150.842025,4,6
0,0,14,14,15,22,37,55,40,95,0.000333,0.164966,7,3464.286488,192.46036,494.89807,156.710855,4,6
0,0,3,3,10,12,22,16,13,29,0.000333,0.043108,5,646.617585,35.923199,129.323517,76.238831,1,6
0,0,3,3,10,11,21,15,12,27,0.000333,0.039531,5,592.962852,32.942381,118.59257,71.273029,1,6
0,0,13,13,16,19,35,55,36,91,0.000333,0.155588,8,3734.118036,207.451002,466.764755,144.710623,5,6
0,0,14,14,16,20,36,56,38,94,0.000333,0.161991,8,3887.783601,215.987978,485.97295,150.438562,5,6
0,0,13,13,15,20,35,55,37,92,0.000333,0.157298,7,3303.258263,183.514348,471.894038,145.041921,5,6
0,0,14,14,15,21,36,56,39,95,0.000333,0.163714,7,3438.000126,191.000007,491.142875,150.842025,5,6
0,0,23,23,18,23,41,100,62,162,0.000333,0.289308,18,15622.62165,867.923425,867.923425,179.100575,8,6
0,0,24,24,18,24,42,101,64,165,0.000333,0.296577,18,16015.18275,889.732375,889.732375,185.09775,8,6
0,0,15,15,16,21,37,59,39,98,0.000333,0.170175,8,4084.211439,226.900635,510.52643,156.238666,5,6
0,0,16,16,16,22,38,60,41,101,0.000333,0.17668,8,4240.325431,235.573635,530.040679,162.107496,5,6
0,0,3,3,10,10,20,15,12,27,0.000333,0.038897,5,583.460293,32.414461,116.692059,66.438562,1,6
0,0,13,13,14,19,33,53,40,93,0.000333,0.156376,14,6567.801143,364.877841,469.128653,134.013592,4,6
0,0,30,30,20,58,78,169,117,286,0.000333,0.599208,20,35952.50069,1997.36115,1797.625035,426.20146,10,6
0,0,29,29,20,56,76,164,114,278,0.000333,0.578975,20,34738.47698,1929.915387,1736.923849,411.650438,10,6
0,0,17,17,17,29,46,98,63,161,0.000333,0.296431,16,14228.6956,790.483089,889.293475,210.368317,6,6
0,0,16,16,16,20,36,72,51,123,0.000333,0.211967,16,10174.4124,565.245133,635.900775,150.438562,6,6
0,0,14,14,14,19,33,64,45,109,0.000333,0.18328,14,7697.745426,427.652524,549.838959,134.013592,6,6
0,0,15,15,15,29,44,80,59,139,0.000333,0.252954,14,10624.05393,590.225218,758.860995,199.484808,4,6
0,0,14,14,15,27,42,75,56,131,0.000333,0.235465,14,9889.510153,549.417231,706.393582,186.985321,4,6
0,0,14,14,16,26,42,82,58,140,0.000333,0.251641,16,12078.79103,671.043946,754.924439,186.211433,6,6
0,0,3,3,10,11,21,15,12,27,0.000333,0.039531,5,592.962852,32.942381,118.59257,71.273029,1,6
0,0,3,3,10,11,21,16,13,29,0.000333,0.042459,5,636.886026,35.382557,127.377205,71.273029,1,6
0,0,27,27,20,55,75,156,107,263,0.000333,0.54606,10,16381.79316,910.09962,1638.179316,404.413346,8,6
0,0,26,26,20,53,73,151,104,255,0.000333,0.526135,10,15784.05263,876.891813,1578.405263,390.018346,8,6
0,0,17,17,17,29,46,98,63,161,0.000333,0.296431,16,14228.6956,790.483089,889.293475,210.368317,6,6
0,0,3,3,10,12,22,16,13,29,0.000333,0.043108,5,646.617585,35.923199,129.323517,76.238831,1,6
0,0,17,17,17,25,42,78,58,136,0.000333,0.244452,16,11733.68271,651.871262,733.355169,185.583273,6,6
0,0,11,11,14,19,33,46,37,83,0.000333,0.139562,7,2930.792983,162.821832,418.684712,134.013592,4,6
0,0,14,14,17,18,35,66,47,113,0.000333,0.193203,16,9273.743695,515.207983,579.608981,144.545518,6,6
0,0,3,3,10,11,21,16,13,29,0.000333,0.042459,5,636.886026,35.382557,127.377205,71.273029,1,6
0,0,3,3,10,10,20,15,12,27,0.000333,0.038897,5,583.460293,32.414461,116.692059,66.438562,1,6
0,0,3,3,10,10,20,15,12,27,0.000333,0.038897,5,583.460293,32.414461,116.692059,66.438562,1,6
0,0,31,31,22,54,76,140,100,240,0.000333,0.499834,11,16494.52864,916.362702,1499.502603,408.871421,12,6
0,0,30,30,22,53,75,139,98,237,0.000333,0.492077,11,16238.53033,902.140574,1476.23003,401.68728,12,6
0,0,28,28,22,50,72,127,89,216,0.000333,0.444235,11,14659.7418,814.4301,1332.7038,380.300305,10,6
0,0,27,27,22,49,71,126,87,213,0.000333,0.436632,11,14408.8575,800.492083,1309.896136,373.228278,10,6
0,0,28,28,22,51,73,127,90,217,0.000333,0.447731,11,14775.11122,820.839512,1343.191929,387.401188,10,6
0,0,27,27,22,50,72,126,88,214,0.000333,0.440121,11,14524.00345,806.889081,1320.36395,380.300305,10,6
0,0,13,13,15,21,36,54,37,91,0.000333,0.156821,7,3293.242226,182.957901,470.463175,150.842025,5,6
0,0,14,14,15,22,37,55,39,94,0.000333,0.16323,7,3427.820315,190.434462,489.688616,156.710855,5,6
0,0,3,3,10,10,20,15,12,27,0.000333,0.038897,5,583.460293,32.414461,116.692059,66.438562,1,6
0,0,9,9,13,17,30,40,30,70,0.000333,0.114494,6,2060.89405,114.494114,343.482342,117.592585,4,6
0,0,17,17,16,20,36,81,52,133,0.000333,0.2292,16,11001.6004,611.200022,687.600025,150.438562,6,6
0,0,27,27,20,51,71,130,91,221,0.000333,0.453031,10,13590.94113,755.052285,1359.094113,375.732254,9,6
0,0,26,26,20,50,70,129,89,218,0.000333,0.445395,10,13361.83698,742.324276,1336.183698,368.631371,9,6
0,0,13,13,15,19,34,55,37,92,0.000333,0.156016,7,3276.32607,182.018115,468.046581,139.313982,4,6
0,0,14,14,15,20,35,56,39,95,0.000333,0.162427,7,3410.973206,189.498511,487.281887,145.041921,4,6
0,0,31,31,22,50,72,141,98,239,0.000333,0.491537,11,16220.73283,901.151824,1474.612075,380.300305,12,6
0,0,30,30,22,49,71,140,96,236,0.000333,0.48378,11,15964.74352,886.930196,1451.34032,373.228278,12,6
0,0,32,32,23,51,74,144,103,247,0.000333,0.511245,22,33742.16959,1874.564977,1533.734981,393.335617,11,6
0,0,31,31,23,51,74,143,101,244,0.000333,0.505036,11,16666.17283,925.898491,1515.106621,393.335617,11,6
0,0,32,32,22,51,73,142,103,245,0.000333,0.505502,22,33363.15437,1853.508576,1516.507017,387.401188,11,6
0,0,31,31,22,51,73,141,101,242,0.000333,0.499313,11,16477.31298,915.406276,1497.937543,387.401188,11,6
0,0,3,3,10,12,22,16,13,29,0.000333,0.043108,5,646.617585,35.923199,129.323517,76.238831,1,6
0,0,16,16,15,21,36,68,55,123,0.000333,0.211967,14,8902.610852,494.589492,635.900775,150.842025,6,6
0,0,13,13,15,21,36,54,37,91,0.000333,0.156821,7,3293.242226,182.957901,470.463175,150.842025,5,6
0,0,14,14,15,22,37,55,39,94,0.000333,0.16323,7,3427.820315,190.434462,489.688616,156.710855,5,6
0,0,13,13,15,21,36,54,38,92,0.000333,0.158544,7,3329.431701,184.968428,475.6331,150.842025,5,6
0,0,14,14,15,22,37,55,40,95,0.000333,0.164966,7,3464.286488,192.46036,494.89807,156.710855,5,6
0,0,38,38,25,50,75,173,114,287,0.000333,0.59589,24,42904.10314,2383.561286,1787.670964,398.289214,13,6
0,0,37,37,25,49,74,172,112,284,0.000333,0.587828,24,42323.63414,2351.313008,1763.484756,391.217187,13,6
0,0,17,17,16,25,41,77,58,135,0.000333,0.24109,16,11572.31233,642.906241,723.269521,180.096405,6,6
0,0,32,32,22,55,77,143,105,248,0.000333,0.518054,11,17095.79368,949.766316,1554.163062,416.08228,11,6
0,0,31,31,22,55,77,142,103,245,0.000333,0.511788,11,16888.98973,938.277207,1535.362702,416.08228,11,6
0,0,12,12,15,18,33,52,35,87,0.000333,0.146287,7,3072.036019,170.668668,438.862288,133.662009,4,6
0,0,13,13,15,19,34,53,37,90,0.000333,0.152624,7,3205.10159,178.061199,457.871656,139.313982,4,6
0,0,17,17,17,25,42,78,58,136,0.000333,0.244452,16,11733.68271,651.871262,733.355169,185.583273,6,6
0,0,9,9,14,16,30,34,30,64,0.000333,0.10468,7,2198.286987,122.127055,314.040998,117.302969,2,6
0,0,30,30,23,50,73,131,92,223,0.000333,0.46011,11,15183.63964,843.535536,1380.330877,386.234734,10,6
0,0,29,29,23,49,72,130,90,220,0.000333,0.452461,11,14931.2185,829.512139,1357.3835,379.162707,10,6
0,0,28,28,22,51,73,127,90,217,0.000333,0.447731,11,14775.11122,820.839512,1343.191929,387.401188,10,6
0,0,27,27,22,50,72,126,88,214,0.000333,0.440121,11,14524.00345,806.889081,1320.36395,380.300305,10,6
0,0,3,3,10,10,20,15,12,27,0.000333,0.038897,5,583.460293,32.414461,116.692059,66.438562,1,6
0,0,11,11,13,19,32,38,35,73,0.000333,0.121667,6,2190,121.666667,365,128.816339,2,6
0,0,29,29,23,48,71,131,93,224,0.000333,0.459181,11,15152.9769,841.83205,1377.543355,372.120125,9,6
0,0,28,28,23,48,71,130,91,221,0.000333,0.453031,11,14950.03525,830.557514,1359.094113,372.120125,9,6
0,0,29,29,22,48,70,129,93,222,0.000333,0.453567,11,14967.70913,831.539396,1360.70083,366.185696,9,6
0,0,28,28,22,48,70,128,91,219,0.000333,0.447438,11,14765.44279,820.302377,1342.312981,366.185696,9,6
0,0,29,29,22,50,72,128,94,222,0.000333,0.456574,11,15066.95685,837.053159,1369.72335,380.300305,9,6
0,0,28,28,22,50,72,127,92,219,0.000333,0.450405,11,14863.34933,825.741629,1351.213575,380.300305,9,6
0,0,3,3,10,10,20,15,12,27,0.000333,0.038897,5,583.460293,32.414461,116.692059,66.438562,1,6
0,0,3,3,10,10,20,15,12,27,0.000333,0.038897,5,583.460293,32.414461,116.692059,66.438562,1,6
0,0,3,3,12,15,27,22,17,39,0.000333,0.061814,6,1112.643676,61.813538,185.440613,101.622909,1,6
0,0,10,10,15,25,40,55,43,98,0.000333,0.17385,7,3650.842673,202.824593,521.548953,174.699764,2,6
0,0,9,9,15,23,38,50,40,90,0.000333,0.157438,7,3306.194333,183.677463,472.313476,162.645284,2,6
0,0,28,28,22,48,70,128,88,216,0.000333,0.441308,11,14563.17645,809.065358,1323.925132,366.185696,10,6
0,0,27,27,22,47,69,127,86,213,0.000333,0.433705,11,14312.2728,795.126267,1301.115709,359.173172,10,6
0,0,33,33,24,51,75,146,101,247,0.000333,0.512839,12,18462.2186,1025.678811,1538.518217,399.332792,12,6
0,0,32,32,24,50,74,145,99,244,0.000333,0.505036,12,18181.27946,1010.071081,1515.106621,392.23191,12,6
0,0,31,31,22,51,73,141,98,239,0.000333,0.493123,11,16273.04877,904.058265,1479.36807,387.401188,12,6
0,0,30,30,22,50,72,140,96,236,0.000333,0.485367,11,16017.1253,889.840295,1456.1023,380.300305,12,6
0,0,31,31,22,51,73,141,98,239,0.000333,0.493123,11,16273.04877,904.058265,1479.36807,387.401188,12,6
0,0,30,30,22,50,72,140,96,236,0.000333,0.485367,11,16017.1253,889.840295,1456.1023,380.300305,12,6
0,0,3,3,12,14,26,21,16,37,0.000333,0.057972,6,1043.497617,57.97209,173.91627,96.322519,1,6
0,0,3,3,10,12,22,16,13,29,0.000333,0.043108,5,646.617585,35.923199,129.323517,76.238831,1,6
0,0,28,28,22,49,71,128,89,217,0.000333,0.444832,11,14679.44637,815.524799,1334.495125,373.228278,10,6
0,0,27,27,22,48,70,127,87,214,0.000333,0.437222,11,14428.33222,801.574012,1311.666566,366.185696,10,6
0,0,32,32,25,54,79,147,106,253,0.000333,0.531619,12,19138.27835,1063.237686,1594.856529,426.86033,12,6
0,0,31,31,25,53,78,146,104,250,0.000333,0.523784,12,18856.20666,1047.567036,1571.350555,419.676189,12,6
0,0,3,3,12,13,25,21,16,37,0.000333,0.057274,6,1030.936074,57.274226,171.822679,91.125266,1,6
0,0,3,3,12,13,25,21,16,37,0.000333,0.057274,6,1030.936074,57.274226,171.822679,91.125266,1,6
0,0,9,9,12,17,29,32,28,60,0.000333,0.09716,6,1748.873158,97.15962,291.47886,112.506418,2,6
0,0,15,15,16,22,38,72,53,125,0.000333,0.218664,16,10495.85503,583.103057,655.990939,162.107496,6,6
0,0,29,29,23,50,73,130,94,224,0.000333,0.462174,11,15251.72771,847.318206,1386.520701,386.234734,9,6
0,0,28,28,23,50,73,129,92,221,0.000333,0.455984,11,15047.4635,835.970195,1367.951228,386.234734,9,6
0,0,3,3,10,12,22,16,13,29,0.000333,0.043108,5,646.617585,35.923199,129.323517,76.238831,1,6
0,0,31,31,22,54,76,140,100,240,0.000333,0.499834,11,16494.52864,916.362702,1499.502603,408.871421,12,6
0,0,30,30,22,53,75,139,98,237,0.000333,0.492077,11,16238.53033,902.140574,1476.23003,401.68728,12,6
0,0,3,3,10,10,20,15,12,27,0.000333,0.038897,5,583.460293,32.414461,116.692059,66.438562,1,6
0,0,3,3,10,11,21,16,13,29,0.000333,0.042459,5,636.886026,35.382557,127.377205,71.273029,1,6
0,0,3,3,12,13,25,20,15,35,0.000333,0.054178,6,975.2098,54.178322,162.534967,91.125266,1,6
0,0,3,3,10,12,22,16,13,29,0.000333,0.043108,5,646.617585,35.923199,129.323517,76.238831,1,6
0,0,3,3,10,11,21,15,12,27,0.000333,0.039531,5,592.962852,32.942381,118.59257,71.273029,1,6
0,0,24,24,17,22,39,100,76,176,0.000333,0.310077,24,22325.53897,1240.307721,930.230791,167.594364,3,6
0,0,7,7,14,23,37,45,33,78,0.000333,0.135446,7,2844.361538,158.020085,406.337363,157.344894,2,6
0,0,10,10,18,30,48,68,50,118,0.000333,0.219675,9,5931.230176,329.512788,659.025575,222.265368,3,6
0,0,9,9,18,28,46,65,47,112,0.000333,0.206213,9,5567.750452,309.31947,618.638939,209.664588,3,6
0,0,17,17,16,19,35,76,52,128,0.000333,0.218849,16,10504.77162,583.598423,656.548226,144.710623,6,6
0,0,14,14,14,18,32,65,44,109,0.000333,0.181667,14,7630,423.888889,545,128.361619,6,6
0,0,13,13,15,16,31,47,45,92,0.000333,0.151929,14,6381.004848,354.500269,455.786061,122.603359,2,6
0,0,8,8,9,13,22,25,25,50,0.000333,0.074324,4,891.886324,49.54924,222.971581,76.635041,1,6
0,0,20,20,19,25,44,98,73,171,0.000333,0.311188,18,16804.13052,933.562807,933.562807,196.807027,2,6
0,0,13,13,16,16,32,52,39,91,0.000333,0.151667,16,7280,404.444444,455,128,2,6
0,0,11,11,13,17,30,47,34,81,0.000333,0.132486,12,4769.497659,264.972092,397.458138,117.592585,4,6
0,0,8,8,12,12,24,31,24,55,0.000333,0.084058,12,3026.07525,168.115292,252.172938,86.0391,1,6
0,0,18,18,11,17,28,66,54,120,0.000333,0.192294,15,8653.23886,480.735492,576.882591,107.540616,2,6
0,0,21,21,15,20,35,79,62,141,0.000333,0.241076,21,15187.80701,843.767056,723.228905,145.041921,3,6
0,0,13,13,12,14,26,56,38,94,0.000333,0.14728,12,5302.096002,294.560889,441.841334,96.322519,2,6
0,0,16,16,15,16,31,69,46,115,0.000333,0.189911,14,7976.25606,443.125337,569.732576,122.603359,3,6
0,0,13,13,12,15,27,56,39,95,0.000333,0.150571,12,5420.571752,301.142875,451.714313,101.622909,2,6
0,0,16,16,15,17,32,69,47,116,0.000333,0.193333,14,8120,451.111111,580,128.090227,3,6
0,0,10,10,14,14,28,46,31,77,0.000333,0.123389,14,5182.328606,287.907145,370.166329,106.605938,2,6
0,0,27,27,19,46,65,119,89,208,0.000333,0.417551,9,11273.87255,626.326253,1252.652505,334.794473,10,6
0,0,26,26,19,46,65,118,87,205,0.000333,0.411528,9,11111.26862,617.292701,1234.585402,334.794473,10,6
0,0,17,17,12,17,29,59,54,113,0.000333,0.182984,18,9881.133344,548.951852,548.951852,112.506418,2,6
0,0,19,19,15,19,34,67,59,126,0.000333,0.213673,21,13461.42668,747.857038,641.020318,139.313982,3,6
0,0,14,14,11,17,28,49,47,96,0.000333,0.153835,10,4615.060725,256.392263,461.506073,107.540616,2,6
0,0,16,16,14,19,33,57,52,109,0.000333,0.18328,14,7697.745426,427.652524,549.838959,134.013592,3,6
0,0,14,14,11,17,28,49,47,96,0.000333,0.153835,10,4615.060725,256.392263,461.506073,107.540616,2,6
0,0,16,16,14,19,33,57,52,109,0.000333,0.18328,14,7697.745426,427.652524,549.838959,134.013592,3,6
0,0,20,20,13,19,32,74,65,139,0.000333,0.231667,18,12510,695,695,128.816339,2,6
0,0,22,22,15,21,36,82,70,152,0.000333,0.261943,21,16502.40061,916.800034,785.8286,150.842025,3,6
0,0,14,14,11,16,27,49,46,95,0.000333,0.150571,10,4517.143127,250.952396,451.714313,102.053748,2,6
0,0,16,16,15,18,33,57,51,108,0.000333,0.181598,14,7627.123908,423.729106,544.794565,133.662009,3,6
0,0,16,16,12,20,32,60,47,107,0.000333,0.178333,12,6420,356.666667,535,129.458112,3,6
0,0,19,19,15,22,37,73,55,128,0.000333,0.22227,14,9335.340431,518.630024,666.810031,156.710855,4,6
0,0,10,10,13,14,27,39,28,67,0.000333,0.106192,12,3822.929552,212.384975,318.577463,101.408685,2,6
0,0,11,11,13,18,31,47,32,79,0.000333,0.130461,6,2348.289051,130.460503,391.381509,123.164366,4,6
0,0,12,12,13,18,31,48,34,82,0.000333,0.135415,6,2437.464585,135.414699,406.244097,123.164366,4,6
0,0,15,15,12,18,30,66,50,116,0.000333,0.189733,12,6830.391709,379.466206,569.199309,118.0782,1,6
0,0,11,11,15,15,30,42,34,76,0.000333,0.124308,14,5220.931594,290.051755,372.923685,117.206718,2,6
0,0,13,13,12,16,28,49,39,88,0.000333,0.141016,12,5076.566798,282.031489,423.047233,107.01955,2,6
0,0,16,16,16,19,35,62,47,109,0.000333,0.186364,16,8945.469582,496.970532,559.091849,144.710623,3,6
0,0,17,17,17,23,40,79,56,135,0.000333,0.239487,16,11495.36469,638.631371,718.460293,173.528793,6,6
0,0,10,10,12,12,24,45,32,77,0.000333,0.117681,12,4236.505351,235.361408,353.042113,86.0391,1,6
0,0,15,15,14,16,30,51,48,99,0.000333,0.161927,21,10201.42555,566.745864,485.782169,117.302969,2,6
0,0,16,16,15,17,32,58,53,111,0.000333,0.185,21,11655,647.5,555,128.090227,2,6
0,0,11,11,14,16,30,40,35,75,0.000333,0.122672,14,5152.235125,286.235285,368.016795,117.302969,2,6
0,0,9,9,11,17,28,35,29,64,0.000333,0.102557,5,1538.353575,85.464088,307.670715,107.540616,2,6
0,0,8,8,11,17,28,34,27,61,0.000333,0.09775,5,1466.243251,81.457958,293.24865,107.540616,2,6
0,0,15,15,14,26,40,64,46,110,0.000333,0.195137,7,4097.884633,227.660257,585.41209,175.514402,6,6
0,0,17,17,15,25,40,68,48,116,0.000333,0.205781,7,4321.405613,240.07809,617.343659,174.699764,6,6
0,0,18,18,16,25,41,81,60,141,0.000333,0.251805,16,12086.63732,671.479851,755.414833,180.096405,6,6
0,0,21,21,16,22,38,95,67,162,0.000333,0.283388,24,20403.94217,1133.552343,850.164257,162.107496,2,6
0,0,16,16,15,20,35,72,51,123,0.000333,0.210301,14,8832.625355,490.701409,630.901811,145.041921,6,6
0,0,7,7,12,12,24,28,24,52,0.000333,0.079473,12,2861.0166,158.945367,238.41805,86.0391,1,6
0,0,10,10,15,20,35,50,38,88,0.000333,0.150459,7,3159.638338,175.535463,451.376905,145.041921,5,6
0,0,15,15,16,21,37,67,53,120,0.000333,0.208378,16,10002.15046,555.675026,625.134404,156.238666,5,6
0,0,16,16,13,17,30,56,51,107,0.000333,0.175012,18,9450.671287,525.037294,525.037294,117.592585,2,6
0,0,19,19,16,19,35,68,60,128,0.000333,0.218849,24,15757.15743,875.397635,656.548226,144.710623,3,6
0,0,14,14,13,18,31,51,49,100,0.000333,0.16514,12,5945.035572,330.279754,495.419631,123.164366,2,6
0,0,17,17,17,20,37,63,58,121,0.000333,0.210115,16,10085.50172,560.305651,630.343857,155.92543,3,6
0,0,13,13,11,17,28,45,44,89,0.000333,0.142618,10,4278.545881,237.696993,427.854588,107.540616,2,6
0,0,16,16,14,19,33,57,53,110,0.000333,0.184961,14,7768.366944,431.575941,554.883353,134.013592,3,6
0,0,16,16,16,17,33,63,42,105,0.000333,0.176554,16,8474.582121,470.810118,529.661383,133.486868,3,6
0,0,14,14,14,19,33,56,48,104,0.000333,0.174872,14,7344.637838,408.035435,524.616988,134.013592,3,6
0,0,12,12,13,15,28,52,40,92,0.000333,0.147426,12,5307.319834,294.851102,442.276653,106.709075,3,6
0,0,18,18,17,19,36,75,46,121,0.000333,0.20852,16,10008.9748,556.054156,625.560925,150.197491,3,6
0,0,16,16,16,17,33,63,42,105,0.000333,0.176554,16,8474.582121,470.810118,529.661383,133.486868,3,6
0,0,11,11,15,13,28,47,31,78,0.000333,0.124991,14,5249.631575,291.646199,374.973684,106.709075,2,6
0,0,18,18,18,17,35,68,44,112,0.000333,0.191493,18,10340.63456,574.479698,574.479698,144.545518,3,6
0,0,11,11,15,13,28,47,31,78,0.000333,0.124991,14,5249.631575,291.646199,374.973684,106.709075,2,6
0,0,3,3,12,14,26,21,16,37,0.000333,0.057972,6,1043.497617,57.97209,173.91627,96.322519,1,6
0,0,9,9,11,15,26,31,29,60,0.000333,0.094009,5,1410.131915,78.340662,282.026383,96.657107,2,6
0,0,11,11,13,24,37,46,41,87,0.000333,0.151074,6,2719.334657,151.074148,453.222443,158.144816,2,6
0,0,12,12,15,24,39,51,43,94,0.000333,0.165609,7,3477.79466,193.210814,496.827809,168.642459,2,6
0,0,9,9,13,23,36,40,35,75,0.000333,0.129248,6,2326.466251,129.248125,387.744375,152.147641,2,6
0,0,12,12,15,25,40,63,48,111,0.000333,0.196911,7,4135.13813,229.729896,590.734019,174.699764,6,6
0,0,7,7,11,14,25,27,24,51,0.000333,0.078946,5,1184.183328,65.787963,236.836666,91.356717,1,6
0,0,11,11,16,20,36,45,37,82,0.000333,0.141311,8,3391.470801,188.415044,423.93385,150.438562,3,6
0,0,7,7,11,14,25,27,24,51,0.000333,0.078946,5,1184.183328,65.787963,236.836666,91.356717,1,6
0,0,9,9,13,17,30,36,30,66,0.000333,0.107952,6,1943.128676,107.951593,323.854779,117.592585,2,6
0,0,7,7,11,14,25,27,24,51,0.000333,0.078946,5,1184.183328,65.787963,236.836666,91.356717,1,6
0,0,10,10,14,18,32,39,31,70,0.000333,0.116667,7,2450,136.111111,350,128.361619,3,6
0,0,11,11,13,15,28,41,40,81,0.000333,0.129799,12,4672.748984,259.597166,389.395749,106.709075,1,6
0,0,8,8,10,14,24,28,27,55,0.000333,0.084058,5,1260.864688,70.048038,252.172938,86.52225,1,6
0,0,7,7,11,12,23,27,24,51,0.000333,0.076901,10,2307.016598,128.167589,230.70166,81.073298,1,6
0,0,18,18,16,20,36,85,54,139,0.000333,0.23954,16,11497.9132,638.772956,718.619575,150.438562,5,6
0,0,20,20,13,19,32,82,62,144,0.000333,0.24,18,12960,720,720,128.816339,2,6
0,0,23,23,17,21,38,95,70,165,0.000333,0.288636,24,20781.79295,1154.544053,865.90804,161.725534,3,6
0,0,10,10,13,14,27,46,31,77,0.000333,0.122042,12,4393.516052,244.084225,366.126338,101.408685,2,6
0,0,29,29,19,45,64,146,94,240,0.000333,0.48,18,25920,1440,1440,327.844012,9,6
0,0,17,17,15,20,35,81,52,133,0.000333,0.227398,14,9550.724978,530.595832,682.194641,145.041921,5,6
0,0,3,3,12,12,24,20,15,35,0.000333,0.053491,6,962.842125,53.491229,160.473688,86.0391,1,6
0,0,3,3,12,13,25,20,15,35,0.000333,0.054178,6,975.2098,54.178322,162.534967,91.125266,1,6
0,0,41,41,25,55,80,184,126,310,0.000333,0.653266,24,47035.14503,2613.063613,1959.797709,434.071189,15,6
0,0,40,40,25,54,79,183,124,307,0.000333,0.645087,24,46446.25655,2580.347586,1935.26069,426.86033,15,6
0,0,3,3,10,11,21,16,13,29,0.000333,0.042459,5,636.886026,35.382557,127.377205,71.273029,1,6
0,0,13,13,15,19,34,55,36,91,0.000333,0.15432,7,3240.71383,180.039657,462.959119,139.313982,5,6
0,0,14,14,15,20,35,56,38,94,0.000333,0.160718,7,3375.068225,187.50379,482.152604,145.041921,5,6
0,0,13,13,15,19,34,55,36,91,0.000333,0.15432,7,3240.71383,180.039657,462.959119,139.313982,5,6
0,0,14,14,15,20,35,56,38,94,0.000333,0.160718,7,3375.068225,187.50379,482.152604,145.041921,5,6
0,0,3,3,10,11,21,16,13,29,0.000333,0.042459,5,636.886026,35.382557,127.377205,71.273029,1,6
0,0,39,39,19,50,69,165,125,290,0.000333,0.590491,18,31886.49766,1771.472092,1771.472092,362.903432,10,6
0,0,42,42,21,53,74,178,133,311,0.000333,0.643713,20,38622.79993,2145.711107,1931.139997,395.81845,11,6
0,0,3,3,10,11,21,15,12,27,0.000333,0.039531,5,592.962852,32.942381,118.59257,71.273029,1,6
0,0,3,3,12,12,24,20,15,35,0.000333,0.053491,6,962.842125,53.491229,160.473688,86.0391,1,6
0,0,16,16,16,16,32,63,41,104,0.000333,0.173333,16,8320,462.222222,520,128,3,6
0,0,13,13,14,16,30,43,35,78,0.000333,0.127579,14,5358.32453,297.684696,382.737466,117.302969,2,6
0,0,10,10,12,13,25,31,24,55,0.000333,0.085137,6,1532.472543,85.137363,255.41209,91.125266,2,6
0,0,11,11,12,20,32,42,30,72,0.000333,0.12,6,2160,120,360,129.458112,4,6
0,0,12,12,12,20,32,43,32,75,0.000333,0.125,6,2250,125,375,129.458112,4,6
0,0,11,11,12,19,31,42,30,72,0.000333,0.118901,6,2140.212806,118.900711,356.702134,123.730173,4,6
0,0,12,12,12,19,31,43,32,75,0.000333,0.123855,6,2229.38834,123.854908,371.564723,123.730173,4,6
0,0,11,11,10,13,23,37,29,66,0.000333,0.099518,10,2985.550891,165.863938,298.555089,81.324997,2,6
0,0,14,14,14,16,30,50,37,87,0.000333,0.1423,14,5976.592745,332.03293,426.899482,117.302969,3,6
0,0,10,10,13,14,27,39,28,67,0.000333,0.106192,12,3822.929552,212.384975,318.577463,101.408685,2,6
0,0,17,17,18,20,38,63,47,110,0.000333,0.192424,18,10390.89648,577.272026,577.272026,161.497212,3,6
0,0,15,15,17,20,37,59,45,104,0.000333,0.180594,16,8668.5304,481.585022,541.78315,155.92543,3,6
0,0,15,15,17,20,37,59,45,104,0.000333,0.180594,16,8668.5304,481.585022,541.78315,155.92543,3,6
0,0,17,17,19,20,39,64,47,111,0.000333,0.19556,18,10560.23363,586.679646,586.679646,167.149185,3,6
0,0,11,11,15,16,31,47,36,83,0.000333,0.137066,14,5756.776113,319.820895,411.198294,122.603359,2,6
0,0,15,15,17,19,36,59,44,103,0.000333,0.177501,16,8520.036402,473.335356,532.502275,150.197491,3,6
0,0,15,15,17,19,36,59,44,103,0.000333,0.177501,16,8520.036402,473.335356,532.502275,150.197491,3,6
0,0,15,15,17,15,32,57,41,98,0.000333,0.163333,16,7840,435.555556,490,128.090227,3,6
0,0,20,20,19,18,37,78,55,133,0.000333,0.230952,27,18707.14704,1039.285946,692.857298,155.769273,3,6
0,0,11,11,14,14,28,48,32,80,0.000333,0.128196,14,5384.237513,299.124306,384.588394,106.605938,2,6
0,0,14,14,15,25,40,65,51,116,0.000333,0.205781,14,8642.811226,480.156179,617.343659,174.699764,6,6
0,0,17,17,16,25,41,76,60,136,0.000333,0.242876,16,11658.03316,647.668509,728.627073,180.096405,6,6
0,0,17,17,16,26,42,80,63,143,0.000333,0.257034,16,12337.62226,685.423459,771.101391,186.211433,6,6
0,0,13,13,15,26,41,66,50,116,0.000333,0.207159,7,4350.332228,241.685124,621.476033,180.814792,6,6
0,0,18,18,16,18,34,59,49,108,0.000333,0.183149,16,8791.13579,488.396433,549.445987,139.05865,3,6
0,0,13,13,14,23,37,61,45,106,0.000333,0.184067,7,3865.414397,214.745244,552.202057,157.344894,5,6
0,0,16,16,15,18,33,59,52,111,0.000333,0.186643,14,7838.988461,435.499359,559.927747,133.662009,3,6
0,0,19,19,16,23,39,88,56,144,0.000333,0.253699,16,12177.56671,676.531484,761.09792,168.041925,6,6
0,0,15,15,15,18,33,50,43,93,0.000333,0.156376,14,6567.801143,364.877841,469.128653,133.662009,3,6
0,0,20,20,15,19,34,74,61,135,0.000333,0.228936,21,14422.95716,801.275397,686.807484,139.313982,3,6
0,0,12,12,14,15,29,55,42,97,0.000333,0.157075,14,6597.138191,366.507677,471.224157,111.906328,3,6
0,0,20,20,16,19,35,75,66,141,0.000333,0.241076,24,17357.49373,964.305207,723.228905,144.710623,3,6
0,0,15,15,15,16,31,50,42,92,0.000333,0.151929,14,6381.004848,354.500269,455.786061,122.603359,3,6
0,0,13,13,14,23,37,56,44,100,0.000333,0.173648,7,3646.617356,202.589853,520.945337,157.344894,4,6
0,0,14,14,16,23,39,61,46,107,0.000333,0.188513,16,9048.608599,502.700478,565.538037,168.041925,4,6
0,0,13,13,14,23,37,56,44,100,0.000333,0.173648,7,3646.617356,202.589853,520.945337,157.344894,4,6
0,0,12,12,14,23,37,53,40,93,0.000333,0.161493,7,3391.354141,188.408563,484.479163,157.344894,4,6
0,0,12,12,17,22,39,47,41,88,0.000333,0.155038,8,3720.923162,206.717953,465.115395,167.594364,3,6
0,0,17,17,19,20,39,65,51,116,0.000333,0.204369,18,11035.91983,613.106657,613.106657,167.149185,3,6
0,0,13,13,17,18,35,48,39,87,0.000333,0.148749,16,7139.96196,396.664553,446.247622,144.545518,3,6
0,0,15,15,15,17,32,48,41,89,0.000333,0.148333,14,6230,346.111111,445,128.090227,3,6
0,0,16,16,15,21,36,78,49,127,0.000333,0.21886,14,9192.126653,510.673703,656.580475,150.842025,5,6
0,0,15,15,15,20,35,75,47,122,0.000333,0.208591,14,8760.815393,486.711966,625.772528,145.041921,5,6
0,0,15,15,15,17,32,50,42,92,0.000333,0.153333,14,6440,357.777778,460,128.090227,3,6
0,0,15,15,15,18,33,50,43,93,0.000333,0.156376,14,6567.801143,364.877841,469.128653,133.662009,3,6
0,0,17,17,16,27,43,88,57,145,0.000333,0.262269,16,12588.93423,699.385235,786.808389,192.381963,6,6
0,0,12,12,14,15,29,45,40,85,0.000333,0.137643,14,5780.997384,321.166521,412.928385,111.906328,1,6
0,0,34,34,19,50,69,165,107,272,0.000333,0.55384,18,29907.33574,1661.518652,1661.518652,362.903432,12,6
0,0,19,19,15,22,37,87,55,142,0.000333,0.246581,14,10356.39329,575.355183,739.742378,156.710855,6,6
0,0,28,28,19,46,65,143,90,233,0.000333,0.467737,9,12628.9053,701.60585,1403.2117,334.794473,10,6
0,0,28,28,20,45,65,143,89,232,0.000333,0.46573,10,13971.89333,776.216296,1397.189333,333.571951,10,6
0,0,15,15,15,19,34,75,46,121,0.000333,0.205194,14,8618.162053,478.786781,615.583004,139.313982,5,6
0,0,12,12,13,17,30,52,45,97,0.000333,0.158656,12,5711.620653,317.312259,475.968388,117.592585,1,6
0,0,9,9,12,14,26,34,30,64,0.000333,0.100276,12,3609.937704,200.552095,300.828142,96.322519,1,6
0,0,21,21,16,23,39,87,69,156,0.000333,0.274841,24,19788.54591,1099.363662,824.522746,168.041925,2,6
0,0,13,13,17,15,32,48,35,83,0.000333,0.138333,16,6640,368.888889,415,128.090227,3,6
0,0,13,13,17,15,32,48,36,84,0.000333,0.14,16,6720,373.333333,420,128.090227,3,6
0,0,20,20,12,21,33,85,72,157,0.000333,0.26399,18,14255.45778,791.969877,791.969877,135.258216,1,6
0,0,22,22,16,23,39,93,77,170,0.000333,0.299506,24,21564.44105,1198.024503,898.518377,168.041925,2,6
0,0,14,14,15,27,42,67,50,117,0.000333,0.2103,7,4416.307969,245.350443,630.901138,186.985321,6,6
0,0,23,23,18,43,61,103,77,180,0.000333,0.355844,9,9607.794487,533.76636,1067.532721,308.388034,7,6
0,0,22,22,18,43,61,102,75,177,0.000333,0.349914,9,9447.664579,524.870254,1049.740509,308.388034,7,6
0,0,13,13,14,17,31,54,39,93,0.000333,0.15358,14,6450.363596,358.353533,460.740257,122.789837,4,6
0,0,10,10,13,19,32,39,32,71,0.000333,0.118333,6,2130,118.333333,355,128.816339,3,6
0,0,12,12,14,19,33,43,34,77,0.000333,0.129473,7,2718.92843,151.051579,388.418347,134.013592,3,6
0,0,12,12,14,15,29,50,36,86,0.000333,0.139262,14,5849.009118,324.944951,417.786366,111.906328,3,6
0,0,12,12,14,16,30,50,37,87,0.000333,0.1423,14,5976.592745,332.03293,426.899482,117.302969,3,6
0,0,11,11,13,20,33,43,37,80,0.000333,0.134517,6,2421.309177,134.517177,403.55153,134.544278,2,6
0,0,9,9,11,17,28,34,31,65,0.000333,0.104159,5,1562.39035,86.799464,312.47807,107.540616,1,6
0,0,14,14,11,15,26,64,46,110,0.000333,0.172349,15,7755.725535,430.873641,517.048369,96.657107,1,6
0,0,17,17,15,18,33,77,54,131,0.000333,0.220272,21,13877.12822,770.951568,660.81563,133.662009,2,6
0,0,11,11,13,15,28,50,36,86,0.000333,0.137811,12,4961.19028,275.621682,413.432523,106.709075,1,6
0,0,16,16,15,16,31,56,41,97,0.000333,0.160186,14,6727.79859,373.766588,480.557042,122.603359,2,6
0,0,10,10,14,13,27,40,28,68,0.000333,0.107777,14,4526.652902,251.480717,323.33235,101.408685,2,6
0,0,10,10,15,13,28,41,28,69,0.000333,0.110569,14,4643.904855,257.994714,331.70749,106.709075,2,6
0,0,16,16,15,16,31,56,41,97,0.000333,0.160186,14,6727.79859,373.766588,480.557042,122.603359,2,6
0,0,17,17,17,16,33,61,43,104,0.000333,0.174872,16,8393.871815,466.326212,524.616988,133.486868,2,6
0,0,10,10,14,13,27,37,26,63,0.000333,0.099853,14,4193.810777,232.989488,299.557913,101.408685,2,6
0,0,20,20,15,18,33,68,53,121,0.000333,0.203457,14,8545.203638,474.733535,610.371688,133.662009,2,6
0,0,10,10,14,13,27,40,28,68,0.000333,0.107777,14,4526.652902,251.480717,323.33235,101.408685,2,6
0,0,14,14,17,18,35,52,44,96,0.000333,0.164137,16,7878.578714,437.698817,492.41117,144.545518,2,6
0,0,21,21,17,21,38,77,65,142,0.000333,0.248402,24,17884.93697,993.607609,745.205707,161.725534,2,6
0,0,11,11,14,18,32,37,36,73,0.000333,0.121667,14,5110,283.888889,365,128.361619,2,6
0,0,19,19,16,18,34,69,59,128,0.000333,0.217065,24,15628.68585,868.260325,651.195244,139.05865,3,6
0,0,16,16,19,19,38,62,48,110,0.000333,0.192424,18,10390.89648,577.272026,577.272026,161.421246,3,6
0,0,17,17,19,22,41,61,51,112,0.000333,0.200015,18,10800.82484,600.045825,600.045825,178.818118,3,6
0,0,18,18,17,17,34,67,58,125,0.000333,0.211978,24,15262.38852,847.910474,635.932855,138.973737,2,6
0,0,18,18,16,21,37,85,55,140,0.000333,0.243108,16,11669.17554,648.28753,729.323471,156.238666,5,6
0,0,12,12,14,14,28,37,33,70,0.000333,0.112172,14,4711.207824,261.733768,336.514845,106.605938,2,6
0,0,16,16,15,17,32,51,45,96,0.000333,0.16,14,6720,373.333333,480,128.090227,2,6
0,0,18,18,16,18,34,58,48,106,0.000333,0.179757,16,8628.336979,479.352054,539.271061,139.05865,3,6
0,0,14,14,11,14,25,45,37,82,0.000333,0.126932,10,3807.962076,211.553449,380.796208,91.356717,2,6
0,0,17,17,15,17,32,58,45,103,0.000333,0.171667,14,7210,400.555556,515,128.090227,3,6
0,0,17,17,16,21,37,73,57,130,0.000333,0.225743,16,10835.663,601.981278,677.228938,156.238666,6,6
0,0,21,21,16,22,38,87,63,150,0.000333,0.262396,16,12595.02603,699.723668,787.189127,162.107496,2,6
0,0,10,10,15,17,32,43,31,74,0.000333,0.123333,7,2590,143.888889,370,128.090227,2,6
0,0,13,13,15,15,30,49,43,92,0.000333,0.150478,14,6320.075087,351.115283,451.433935,117.206718,1,6
0,0,18,18,11,18,29,69,61,130,0.000333,0.210513,15,9473.06294,526.281274,631.537529,113.112398,1,6
0,0,20,20,15,20,35,77,66,143,0.000333,0.244496,21,15403.2369,855.735383,733.487471,145.041921,2,6
0,0,8,8,10,14,24,30,30,60,0.000333,0.091699,10,2750.9775,152.832083,275.09775,86.52225,1,6
0,0,10,10,14,17,31,38,35,73,0.000333,0.120552,14,5063.188629,281.288257,361.656331,122.789837,2,6
0,0,10,10,12,12,24,37,26,63,0.000333,0.096284,12,3466.231651,192.568425,288.852638,86.0391,2,6
0,0,9,9,12,13,25,34,26,60,0.000333,0.092877,12,3343.576457,185.754248,278.631371,91.125266,1,6
0,0,12,12,15,20,35,51,40,91,0.000333,0.155588,14,6534.706564,363.039254,466.764755,145.041921,3,6
0,0,14,14,11,15,26,67,46,113,0.000333,0.17705,15,7967.245322,442.62474,531.149688,96.657107,1,6
0,0,17,17,15,18,33,80,54,134,0.000333,0.225316,21,14194.92505,788.606947,675.948812,133.662009,2,6
0,0,18,18,15,16,31,72,54,126,0.000333,0.208076,21,13108.80344,728.266858,624.228735,122.603359,2,6
0,0,19,19,15,19,34,73,57,130,0.000333,0.220457,21,13888.77356,771.598531,661.370169,139.313982,2,6
0,0,10,10,13,13,26,41,30,71,0.000333,0.111244,12,4004.77464,222.48748,333.73122,96.211433,2,6
0,0,18,18,14,16,30,71,54,125,0.000333,0.204454,21,12880.58781,715.588212,613.361324,117.302969,2,6
0,0,18,18,15,16,31,74,54,128,0.000333,0.211379,21,13316.87968,739.826649,634.137128,122.603359,2,6
0,0,10,10,13,13,26,41,30,71,0.000333,0.111244,12,4004.77464,222.48748,333.73122,96.211433,2,6
0,0,19,19,16,16,32,76,56,132,0.000333,0.22,24,15840,880,660,128,2,6
0,0,10,10,13,13,26,41,30,71,0.000333,0.111244,12,4004.77464,222.48748,333.73122,96.211433,2,6
0,0,14,14,15,22,37,60,45,105,0.000333,0.182331,14,7657.896447,425.438692,546.992603,156.710855,4,6
0,0,12,12,14,22,36,58,43,101,0.000333,0.174054,7,3655.136976,203.063165,522.162425,151.410465,5,6
0,0,18,18,18,18,36,62,53,115,0.000333,0.19818,18,10701.74475,594.541375,594.541375,150.1173,3,6
0,0,19,19,19,21,40,64,56,120,0.000333,0.212877,18,11495.36469,638.631371,638.631371,172.949289,3,6
0,0,22,22,18,20,38,74,65,139,0.000333,0.243154,27,19695.47196,1094.192887,729.461924,161.497212,3,6
0,0,20,20,18,19,37,68,59,127,0.000333,0.220534,27,17863.21559,992.400866,661.600577,155.769273,3,6
0,0,14,14,19,20,39,69,52,121,0.000333,0.213178,18,11511.60603,639.533668,639.533668,167.149185,2,6
0,0,10,10,19,18,37,56,41,97,0.000333,0.168439,18,9095.705576,505.316976,505.316976,155.769273,2,6
0,0,20,20,19,24,43,89,70,159,0.000333,0.287592,18,15529.96973,862.776096,862.776096,190.749723,2,6
0,0,10,10,19,19,38,57,42,99,0.000333,0.173182,18,9351.806829,519.544824,519.544824,161.421246,2,6
0,0,21,21,18,18,36,84,62,146,0.000333,0.251603,27,20379.84436,1132.213575,754.80905,150.1173,3,6
0,0,24,24,17,20,37,92,72,164,0.000333,0.284783,24,20504.40845,1139.133803,854.350352,155.92543,3,6
0,0,10,10,13,13,26,44,31,75,0.000333,0.117511,12,4230.395746,235.021986,352.532979,96.211433,2,6
0,0,13,13,17,16,33,54,39,93,0.000333,0.156376,16,7506.05845,417.003247,469.128653,133.486868,3,6
0,0,10,10,14,13,27,42,29,71,0.000333,0.112532,14,4726.358177,262.575454,337.597013,101.408685,2,6
0,0,7,7,9,11,20,23,20,43,0.000333,0.061948,4,743.371632,41.298424,185.842908,66.583073,1,6
0,0,14,14,14,17,31,53,40,93,0.000333,0.15358,14,6450.363596,358.353533,460.740257,122.789837,2,6
0,0,14,14,15,18,33,54,43,97,0.000333,0.163102,14,6850.287214,380.571512,489.30623,133.662009,2,6
0,0,15,15,17,16,33,53,42,95,0.000333,0.159739,16,7667.479061,425.971059,479.217441,133.486868,3,6
0,0,16,16,19,18,37,59,48,107,0.000333,0.185804,18,10033.40718,557.41151,557.41151,155.769273,3,6
0,0,15,15,10,16,26,45,45,90,0.000333,0.141013,10,4230.395746,235.021986,423.039575,97.219281,1,6
0,0,22,22,16,20,36,84,70,154,0.000333,0.265389,24,19108.04281,1061.557934,796.16845,150.438562,3,6
0,0,15,15,17,19,36,59,44,103,0.000333,0.177501,16,8520.036402,473.335356,532.502275,150.197491,3,6
0,0,15,15,17,19,36,59,44,103,0.000333,0.177501,16,8520.036402,473.335356,532.502275,150.197491,3,6
0,0,11,11,15,16,31,47,36,83,0.000333,0.137066,14,5756.776113,319.820895,411.198294,122.603359,2,6
0,0,15,15,17,20,37,59,45,104,0.000333,0.180594,16,8668.5304,481.585022,541.78315,155.92543,3,6
0,0,11,11,15,16,31,47,36,83,0.000333,0.137066,14,5756.776113,319.820895,411.198294,122.603359,2,6
0,0,9,9,12,13,25,36,33,69,0.000333,0.106809,12,3845.112925,213.617385,320.426077,91.125266,2,6
0,0,11,11,16,16,32,44,38,82,0.000333,0.136667,16,6560,364.444444,410,128,3,6
0,0,19,19,14,19,33,75,64,139,0.000333,0.233724,21,14724.58643,818.03258,701.170783,134.013592,2,6
0,0,21,21,18,21,39,83,69,152,0.000333,0.267794,27,21691.29071,1205.071706,803.381137,167.297316,3,6
0,0,18,18,14,18,32,66,60,126,0.000333,0.21,21,13230,735,630,128.361619,2,6
0,0,20,20,18,20,38,74,65,139,0.000333,0.243154,27,19695.47196,1094.192887,729.461924,161.497212,3,6
0,0,20,20,13,20,33,75,67,142,0.000333,0.238768,18,12893.47137,716.303965,716.303965,134.544278,2,6
0,0,22,22,17,22,39,83,72,155,0.000333,0.273079,24,19661.69625,1092.316459,819.237344,167.594364,3,6
0,0,9,9,13,20,33,36,32,68,0.000333,0.11434,6,2058.112801,114.3396,343.0188,134.544278,2,6
0,0,8,8,12,11,23,34,23,57,0.000333,0.085948,12,3094.116378,171.895354,257.843031,81.073298,2,6
0,0,13,13,13,14,27,47,34,81,0.000333,0.128382,12,4621.750652,256.763925,385.145888,101.408685,2,6
0,0,5,5,9,9,18,21,16,37,0.000333,0.051429,4,617.1489,34.28605,154.287225,57.05865,1,6
0,0,17,17,14,15,29,68,49,117,0.000333,0.189461,21,11936.05931,663.114406,568.383776,111.906328,3,6
0,0,17,17,14,16,30,68,49,117,0.000333,0.191369,21,12056.23019,669.790566,574.1062,117.302969,3,6
0,0,17,17,14,17,31,68,50,118,0.000333,0.194865,14,8184.332305,454.685128,584.595165,122.789837,3,6
0,0,17,17,14,17,31,68,50,118,0.000333,0.194865,14,8184.332305,454.685128,584.595165,122.789837,3,6
0,0,10,10,13,13,26,41,30,71,0.000333,0.111244,12,4004.77464,222.48748,333.73122,96.211433,2,6
0,0,15,15,14,26,40,68,48,116,0.000333,0.205781,7,4321.405613,240.07809,617.343659,175.514402,6,6
0,0,16,16,15,21,36,72,51,123,0.000333,0.211967,14,8902.610852,494.589492,635.900775,150.842025,6,6
0,0,15,15,16,23,39,73,54,127,0.000333,0.223749,16,10739.93731,596.663184,671.246082,168.041925,5,6
0,0,17,17,18,18,36,59,48,107,0.000333,0.184394,18,9957.275553,553.181975,553.181975,150.1173,4,6
0,0,19,19,20,19,39,64,51,115,0.000333,0.202607,20,12156.4251,675.35695,607.821255,167.149185,4,6
0,0,21,21,19,21,40,76,58,134,0.000333,0.237713,18,12836.49057,713.138365,713.138365,172.949289,4,6
0,0,17,17,15,17,32,71,51,122,0.000333,0.203333,21,12810,711.666667,610,128.090227,2,6
0,0,19,19,18,17,35,75,53,128,0.000333,0.218849,27,17726.80211,984.822339,656.548226,144.545518,4,6
0,0,11,11,14,13,27,44,30,74,0.000333,0.117287,14,4926.063452,273.670192,351.861675,101.408685,2,6
0,0,14,14,12,15,27,51,46,97,0.000333,0.153741,18,8302.033579,461.224088,461.224088,101.622909,2,6
0,0,16,16,15,17,32,59,51,110,0.000333,0.183333,21,11550,641.666667,550,128.090227,3,6
0,0,14,14,12,15,27,51,46,97,0.000333,0.153741,18,8302.033579,461.224088,461.224088,101.622909,2,6
0,0,16,16,16,17,33,59,51,110,0.000333,0.184961,24,13317.20048,739.844471,554.883353,133.486868,3,6
0,0,11,11,14,21,35,43,38,81,0.000333,0.138491,7,2908.303471,161.572415,415.471924,145.541635,2,6
0,0,10,10,14,15,29,35,29,64,0.000333,0.103637,7,2176.375486,120.909749,310.910784,111.906328,2,6
0,0,15,15,15,18,33,61,43,104,0.000333,0.174872,14,7344.637838,408.035435,524.616988,133.662009,2,6
0,0,9,9,13,13,26,34,25,59,0.000333,0.092442,6,1663.95566,92.441981,277.325943,96.211433,2,6
0,0,16,16,12,16,28,60,54,114,0.000333,0.182679,18,9864.6923,548.038461,548.038461,107.01955,1,6
0,0,18,18,16,18,34,68,59,127,0.000333,0.215369,24,15506.58674,861.477041,646.107781,139.05865,2,6
0,0,12,12,15,23,38,57,45,102,0.000333,0.17843,7,3747.020245,208.167791,535.288606,162.645284,5,6
0,0,15,15,17,21,38,68,53,121,0.000333,0.211666,16,10159.98767,564.443759,634.999229,161.725534,5,6
0,0,10,10,11,13,24,38,30,68,0.000333,0.103926,10,3117.7745,173.209694,311.77745,86.159464,1,6
0,0,11,11,13,15,28,43,31,74,0.000333,0.118581,12,4268.931171,237.162843,355.744264,106.709075,2,6
0,0,14,14,11,15,26,48,38,86,0.000333,0.134746,10,4042.378158,224.576564,404.237816,96.657107,2,6
0,0,17,17,15,18,33,61,46,107,0.000333,0.179917,14,7556.502391,419.805688,539.750171,133.662009,3,6
0,0,14,14,16,18,34,53,42,95,0.000333,0.161103,16,7732.943519,429.607973,483.30897,139.05865,4,6
0,0,14,14,15,20,35,51,41,92,0.000333,0.157298,14,6606.516526,367.028696,471.894038,145.041921,3,6
0,0,9,9,11,18,29,36,27,63,0.000333,0.102018,5,1530.264013,85.014667,306.052803,113.112398,3,6
0,0,10,10,11,18,29,37,29,66,0.000333,0.106876,5,1603.133728,89.062985,320.626746,113.112398,3,6
0,0,11,11,10,12,22,38,29,67,0.000333,0.099594,10,2987.819184,165.989955,298.781918,76.238831,2,6
0,0,14,14,14,15,29,51,37,88,0.000333,0.142501,14,5985.032586,332.50181,427.502328,111.906328,3,6
0,0,10,10,13,14,27,39,28,67,0.000333,0.106192,12,3822.929552,212.384975,318.577463,101.408685,2,6
0,0,12,12,14,14,28,39,35,74,0.000333,0.118581,14,4980.419699,276.689983,355.744264,106.605938,2,6
0,0,10,10,15,14,29,39,33,72,0.000333,0.116592,14,4896.844843,272.046936,349.774632,111.906328,2,6
0,0,16,16,16,17,33,54,47,101,0.000333,0.169828,16,8151.740897,452.874494,509.483806,133.486868,2,6
0,0,11,11,15,15,30,39,34,73,0.000333,0.119401,14,5014.842189,278.602344,358.203013,117.206718,2,6
0,0,19,19,16,18,34,78,53,131,0.000333,0.222153,16,10663.32212,592.406784,666.457632,139.05865,2,6
0,0,11,11,14,14,28,47,33,80,0.000333,0.128196,14,5384.237513,299.124306,384.588394,106.605938,2,6
0,0,12,12,17,16,33,47,39,86,0.000333,0.144606,16,6941.086308,385.615906,433.817894,133.486868,3,6
0,0,17,17,15,20,35,95,60,155,0.000333,0.265013,21,16695.81622,927.545346,795.038868,145.041921,5,6
0,0,8,8,11,12,23,29,22,51,0.000333,0.076901,5,1153.508299,64.083794,230.70166,81.073298,2,6
0,0,11,11,13,12,25,40,29,69,0.000333,0.106809,12,3845.112925,213.617385,320.426077,91.125266,2,6
0,0,13,13,11,15,26,59,44,103,0.000333,0.161382,10,4841.45291,268.969606,484.145291,96.657107,1,6
0,0,16,16,15,18,33,72,52,124,0.000333,0.208502,14,8757.068191,486.503788,625.504871,133.662009,2,6
0,0,18,18,10,19,29,67,61,128,0.000333,0.207274,15,9327.323511,518.184639,621.821567,113.929904,1,6
0,0,20,20,14,21,35,75,66,141,0.000333,0.241076,21,15187.80701,843.767056,723.228905,145.541635,2,6
0,0,7,7,10,10,20,34,24,58,0.000333,0.083557,10,2506.718295,139.262128,250.67183,66.438562,1,6
0,0,15,15,12,15,27,56,50,106,0.000333,0.168006,18,9072.325354,504.018075,504.018075,101.622909,1,6
0,0,17,17,16,17,33,64,55,119,0.000333,0.200094,24,14406.78961,800.3772,600.2829,133.486868,2,6
0,0,15,15,13,15,28,57,53,110,0.000333,0.17627,18,9518.562746,528.809041,528.809041,106.709075,1,6
0,0,17,17,17,17,34,65,58,123,0.000333,0.208586,24,15018.19031,834.343906,625.757929,138.973737,2,6
0,0,14,14,11,15,26,52,48,100,0.000333,0.156681,15,7050.659577,391.70331,470.043972,96.657107,1,6
0,0,16,16,15,17,32,60,53,113,0.000333,0.188333,21,11865,659.166667,565,128.090227,2,6
0,0,17,17,10,17,27,58,57,115,0.000333,0.182271,15,8202.180941,455.676719,546.812063,102.706149,1,6
0,0,19,19,14,19,33,66,62,128,0.000333,0.215227,21,13559.33139,753.296188,645.682447,134.013592,2,6
0,0,15,15,16,19,35,69,50,119,0.000333,0.203462,16,9766.154864,542.564159,610.384679,144.710623,5,6
0,0,13,13,11,16,27,48,39,87,0.000333,0.137892,10,4136.752127,229.819563,413.675213,102.053748,2,6
0,0,16,16,15,19,34,61,47,108,0.000333,0.183149,14,7692.243816,427.346879,549.445987,139.313982,3,6
0,0,19,19,15,17,32,69,52,121,0.000333,0.201667,21,12705,705.833333,605,128.090227,2,6
0,0,11,11,14,13,27,47,33,80,0.000333,0.126797,14,5325.474002,295.859667,380.391,101.408685,2,6
0,0,13,13,13,15,28,51,48,99,0.000333,0.158643,18,8566.706471,475.928137,475.928137,106.709075,1,6
0,0,9,9,11,17,28,33,31,64,0.000333,0.102557,5,1538.353575,85.464088,307.670715,107.540616,1,6
0,0,14,14,12,14,26,58,41,99,0.000333,0.155115,12,5584.122385,310.229021,465.343532,96.322519,2,6
0,0,17,17,15,16,31,71,49,120,0.000333,0.198168,21,12484.5747,693.587483,594.503557,122.603359,3,6
0,0,10,10,13,15,28,31,27,58,0.000333,0.092942,6,1672.959513,92.942195,278.826585,106.709075,2,6
0,0,16,16,16,18,34,49,44,93,0.000333,0.157711,16,7570.144708,420.563595,473.134044,139.05865,2,6
0,0,9,9,14,18,32,30,28,58,0.000333,0.096667,7,2030,112.777778,290,128.361619,2,6
0,0,14,14,17,15,32,52,40,92,0.000333,0.153333,16,7360,408.888889,460,128.090227,2,6
0,0,12,12,15,20,35,51,40,91,0.000333,0.155588,14,6534.706564,363.039254,466.764755,145.041921,3,6
0,0,26,26,20,45,65,115,82,197,0.000333,0.395469,10,11864.06459,659.1147,1186.406459,333.571951,9,6
0,0,25,25,20,45,65,114,80,194,0.000333,0.389446,10,11683.39356,649.07742,1168.339356,333.571951,9,6
0,0,28,28,21,44,65,119,84,203,0.000333,0.407514,10,12225.40666,679.189259,1222.540666,332.453657,9,6
0,0,27,27,21,44,65,118,82,200,0.000333,0.401491,10,12044.73563,669.151979,1204.473563,332.453657,9,6
0,0,7,7,10,11,21,36,25,61,0.000333,0.08931,10,2679.313628,148.850757,267.931363,71.273029,1,6
0,0,10,10,12,15,27,37,32,69,0.000333,0.109362,12,3937.046852,218.724825,328.087238,101.622909,1,6
0,0,11,11,14,18,32,38,37,75,0.000333,0.125,14,5250,291.666667,375,128.361619,2,6
0,0,14,14,16,18,34,52,45,97,0.000333,0.164495,16,7895.74233,438.652352,493.483896,139.05865,2,6
0,0,11,11,13,18,31,47,37,84,0.000333,0.138717,12,4993.829881,277.434993,416.15249,123.164366,3,6
0,0,11,11,13,20,33,43,37,80,0.000333,0.134517,6,2421.309177,134.517177,403.55153,134.544278,2,6
0,0,9,9,11,17,28,34,31,65,0.000333,0.104159,5,1562.39035,86.799464,312.47807,107.540616,1,6
0,0,10,10,13,15,28,38,32,70,0.000333,0.112172,12,4038.178135,224.34323,336.514845,106.709075,1,6
0,0,14,14,17,16,33,51,40,91,0.000333,0.153013,16,7344.637838,408.035435,459.039865,133.486868,2,6
0,0,11,11,14,17,31,36,34,70,0.000333,0.115598,14,4855.112384,269.728466,346.793742,122.789837,2,6
0,0,16,16,15,18,33,59,52,111,0.000333,0.186643,14,7838.988461,435.499359,559.927747,133.662009,3,6
0,0,16,16,15,17,32,59,51,110,0.000333,0.183333,21,11550,641.666667,550,128.090227,3,6
0,0,16,16,15,17,32,59,51,110,0.000333,0.183333,21,11550,641.666667,550,128.090227,3,6
0,0,15,15,17,17,34,59,42,101,0.000333,0.171278,16,8221.339951,456.741108,513.833747,138.973737,3,6
0,0,9,9,13,20,33,41,32,73,0.000333,0.122747,6,2209.444624,122.746924,368.240771,134.544278,3,6
0,0,15,15,17,16,33,55,48,103,0.000333,0.173191,24,12469.74226,692.763459,519.572594,133.486868,2,6
0,0,15,15,18,16,34,56,51,107,0.000333,0.181453,27,14697.68015,816.537786,544.358524,139.05865,2,6
0,0,18,18,18,17,35,69,48,117,0.000333,0.200042,18,10802.27003,600.126113,600.126113,144.545518,4,6
0,0,14,14,12,13,25,58,41,99,0.000333,0.153247,18,8275.35173,459.741763,459.741763,91.125266,2,6
0,0,17,17,16,15,31,71,49,120,0.000333,0.198168,24,14268.08537,792.67141,594.503557,122.603359,3,6
0,0,14,14,12,14,26,58,41,99,0.000333,0.155115,12,5584.122385,310.229021,465.343532,96.322519,2,6
0,0,17,17,15,16,31,71,49,120,0.000333,0.198168,21,12484.5747,693.587483,594.503557,122.603359,3,6
0,0,16,16,13,15,28,62,44,106,0.000333,0.16986,12,6114.955461,339.719748,509.579622,106.709075,2,6
0,0,19,19,16,17,33,75,52,127,0.000333,0.213546,24,15375.31328,854.184071,640.638053,133.486868,3,6
0,0,28,28,20,45,65,143,89,232,0.000333,0.46573,10,13971.89333,776.216296,1397.189333,333.571951,10,6
0,0,15,15,15,19,34,75,46,121,0.000333,0.205194,14,8618.162053,478.786781,615.583004,139.313982,5,6
0,0,29,29,22,45,67,149,95,244,0.000333,0.493375,22,32562.76677,1809.042599,1480.125762,345.240885,10,6
0,0,15,15,15,19,34,75,46,121,0.000333,0.205194,14,8618.162053,478.786781,615.583004,139.313982,5,6
0,0,15,15,16,24,40,73,51,124,0.000333,0.219973,16,10558.70534,586.594741,659.919084,174.0391,6,6
0,0,14,14,15,23,38,68,49,117,0.000333,0.204669,14,8596.105267,477.561404,614.007519,162.645284,6,6
0,0,16,16,16,16,32,63,41,104,0.000333,0.173333,16,8320,462.222222,520,128,3,6
0,0,21,21,15,21,36,75,64,139,0.000333,0.23954,21,15091.01108,838.389504,718.619575,150.842025,3,6
0,0,12,12,13,17,30,54,42,96,0.000333,0.15702,12,5652.737966,314.040998,471.061497,117.592585,3,6
0,0,20,20,16,20,36,83,62,145,0.000333,0.24988,24,17991.33901,999.518834,749.639125,150.438562,3,6
0,0,12,12,14,16,30,55,42,97,0.000333,0.158656,14,6663.557429,370.197635,475.968388,117.302969,3,6
0,0,20,20,17,20,37,84,65,149,0.000333,0.258736,24,18629.00524,1034.944735,776.208551,155.92543,3,6
0,0,10,10,12,13,25,37,26,63,0.000333,0.097521,12,3510.755279,195.04196,292.56294,91.125266,2,6
0,0,17,17,16,27,43,88,57,145,0.000333,0.262269,16,12588.93423,699.385235,786.808389,192.381963,6,6
0,0,17,17,16,27,43,88,57,145,0.000333,0.262269,16,12588.93423,699.385235,786.808389,192.381963,6,6
0,0,8,8,13,18,31,37,29,66,0.000333,0.108992,6,1961.861739,108.992319,326.976956,123.164366,3,6
0,0,14,14,15,18,33,65,47,112,0.000333,0.188324,14,7909.609979,439.422777,564.972141,133.662009,5,6
0,0,14,14,16,18,34,66,47,113,0.000333,0.191628,16,9198.132817,511.007379,574.883301,139.05865,5,6
0,0,13,13,16,17,33,49,41,90,0.000333,0.151332,16,7263.927532,403.55153,453.995471,133.486868,2,6
0,0,11,11,11,13,24,45,34,79,0.000333,0.120737,10,3622.120376,201.22891,362.212038,86.159464,1,6
0,0,12,12,14,16,30,50,35,85,0.000333,0.139029,14,5839.199809,324.399989,417.085701,117.302969,2,6
0,0,10,10,12,16,28,32,28,60,0.000333,0.096147,6,1730.647772,96.147098,288.441295,107.01955,1,6
0,0,14,14,16,16,32,50,41,91,0.000333,0.151667,16,7280,404.444444,455,128,2,6
0,0,17,17,14,17,31,59,56,115,0.000333,0.189911,21,11964.38409,664.688005,569.732576,122.789837,2,6
0,0,12,12,13,18,31,47,40,87,0.000333,0.143672,12,5172.180948,287.343386,431.015079,123.164366,2,6
0,0,17,17,15,17,32,60,56,116,0.000333,0.193333,21,12180,676.666667,580,128.090227,2,6
0,0,6,6,13,10,23,25,18,43,0.000333,0.064838,6,1167.078985,64.837721,194.513164,81.324997,3,6
0,0,14,14,15,29,44,71,53,124,0.000333,0.225657,7,4738.786645,263.265925,676.969521,199.484808,6,6
0,0,32,32,20,52,72,165,106,271,0.000333,0.55735,20,33440.99351,1857.832973,1672.049675,382.861427,10,6
0,0,18,18,16,27,43,91,58,149,0.000333,0.269504,16,12936.21518,718.678621,808.513448,192.381963,6,6
0,0,18,18,17,19,36,65,58,123,0.000333,0.211967,24,15261.6186,847.8677,635.900775,150.197491,4,6
0,0,17,17,14,17,31,61,57,118,0.000333,0.194865,21,12276.49846,682.027692,584.595165,122.789837,2,6
0,0,19,19,18,19,37,69,62,131,0.000333,0.227479,27,18425.83655,1023.657586,682.438391,155.769273,3,6
0,0,16,16,14,16,30,57,52,109,0.000333,0.178284,21,11231.87257,623.992921,534.851075,117.302969,3,6
0,0,18,18,18,18,36,65,57,122,0.000333,0.210244,27,17029.73296,946.096275,630.73085,150.1173,4,6
0,0,15,15,13,16,29,54,51,105,0.000333,0.170029,18,9181.584081,510.088004,510.088004,112.105716,2,6
0,0,17,17,17,18,35,62,56,118,0.000333,0.201752,24,14526.1295,807.007195,605.255396,144.545518,3,6
0,0,12,12,15,24,39,59,45,104,0.000333,0.183227,7,3847.772815,213.765156,549.681831,168.642459,6,6
0,0,7,7,11,14,25,27,24,51,0.000333,0.078946,5,1184.183328,65.787963,236.836666,91.356717,1,6
0,0,9,9,13,17,30,36,30,66,0.000333,0.107952,6,1943.128676,107.951593,323.854779,117.592585,2,6
0,0,10,10,12,16,28,32,28,60,0.000333,0.096147,6,1730.647772,96.147098,288.441295,107.01955,1,6
0,0,13,13,15,17,32,46,41,87,0.000333,0.145,14,6090,338.333333,435,128.090227,2,6
0,0,26,26,18,47,65,116,87,203,0.000333,0.407514,9,11002.86599,611.270333,1222.540666,336.124326,9,6
0,0,25,25,18,47,65,115,85,200,0.000333,0.401491,9,10840.26206,602.236781,1204.473563,336.124326,9,6
0,0,12,12,13,19,32,42,37,79,0.000333,0.131667,6,2370,131.666667,395,128.816339,2,6
0,0,11,11,13,19,32,39,35,74,0.000333,0.123333,6,2220,123.333333,370,128.816339,2,6
0,0,7,7,9,11,20,23,20,43,0.000333,0.061948,4,743.371632,41.298424,185.842908,66.583073,1,6
0,0,14,14,14,17,31,53,40,93,0.000333,0.15358,14,6450.363596,358.353533,460.740257,122.789837,2,6
0,0,14,14,15,18,33,54,43,97,0.000333,0.163102,14,6850.287214,380.571512,489.30623,133.662009,2,6
0,0,9,9,13,17,30,41,31,72,0.000333,0.117765,6,2119.776737,117.765374,353.296123,117.592585,3,6
0,0,11,11,13,16,29,42,36,78,0.000333,0.126308,12,4547.070211,252.615012,378.922518,112.105716,1,6
0,0,14,14,17,19,36,55,44,99,0.000333,0.170608,16,8189.161202,454.9534,511.822575,150.197491,2,6
0,0,24,24,16,28,44,101,78,179,0.000333,0.325746,16,15635.81216,868.656231,977.23826,198.605938,4,6
0,0,27,27,18,30,48,114,86,200,0.000333,0.372331,18,20105.865,1116.9925,1116.9925,222.265368,5,6
0,0,20,20,17,23,40,94,62,156,0.000333,0.27674,16,13283.53253,737.974029,830.220783,173.528793,6,6
0,0,14,14,14,20,34,58,43,101,0.000333,0.171278,14,7193.672458,399.64847,513.833747,139.741531,4,6
0,0,11,11,13,17,30,47,36,83,0.000333,0.135757,12,4887.263033,271.514613,407.271919,117.592585,3,6
0,0,14,14,14,22,36,59,44,103,0.000333,0.177501,14,7455.031852,414.168436,532.502275,151.410465,4,6
0,0,11,11,13,19,32,48,37,85,0.000333,0.141667,6,2550,141.666667,425,128.816339,3,6
0,0,15,15,18,18,36,56,43,99,0.000333,0.170608,18,9212.806353,511.822575,511.822575,150.1173,4,6
0,0,14,14,16,16,32,48,38,86,0.000333,0.143333,16,6880,382.222222,430,128,2,6
0,0,16,16,18,17,35,58,49,107,0.000333,0.182944,18,9878.999091,548.833283,548.833283,144.545518,3,6
0,0,13,13,17,16,33,48,39,87,0.000333,0.146287,16,7021.796614,390.099812,438.862288,133.486868,3,6
0,0,13,13,17,16,33,48,39,87,0.000333,0.146287,16,7021.796614,390.099812,438.862288,133.486868,3,6
0,0,13,13,18,16,34,49,40,89,0.000333,0.150928,18,8150.115472,452.784193,452.784193,139.05865,3,6
0,0,13,13,18,16,34,49,40,89,0.000333,0.150928,18,8150.115472,452.784193,452.784193,139.05865,3,6
0,0,14,14,16,17,33,54,45,99,0.000333,0.166465,16,7990.320285,443.906683,499.395018,133.486868,3,6
0,0,16,16,18,19,37,62,47,109,0.000333,0.189277,18,10220.9475,567.830417,567.830417,155.769273,3,6
0,0,13,13,17,17,34,48,40,88,0.000333,0.149232,16,7163.14768,397.952649,447.69673,138.973737,3,6
0,0,10,10,10,12,22,41,34,75,0.000333,0.111486,10,3344.573714,185.809651,334.457371,76.238831,1,6
0,0,8,8,12,12,24,29,25,54,0.000333,0.082529,12,2971.0557,165.05865,247.587975,86.0391,2,6
0,0,12,12,14,15,29,42,36,78,0.000333,0.126308,14,5304.915247,294.717514,378.922518,111.906328,2,6
0,0,12,12,12,16,28,42,34,76,0.000333,0.121786,12,4384.307689,243.572649,365.358974,107.01955,1,6
0,0,5,5,9,9,18,21,16,37,0.000333,0.051429,4,617.1489,34.28605,154.287225,57.05865,1,6
0,0,11,11,12,13,25,41,31,72,0.000333,0.111453,12,4012.291748,222.905097,334.357646,91.125266,1,6
0,0,12,12,16,14,30,45,34,79,0.000333,0.129215,16,6202.309713,344.572762,387.644357,117.302969,2,6
0,0,14,14,16,15,31,54,41,95,0.000333,0.156883,16,7530.378392,418.354355,470.648649,122.603359,3,6
0,0,15,15,17,18,35,53,43,96,0.000333,0.164137,16,7878.578714,437.698817,492.41117,144.545518,2,6
0,0,14,14,16,15,31,51,40,91,0.000333,0.150277,16,7213.309828,400.739435,450.831864,122.603359,2,6
0,0,16,16,15,17,32,69,49,118,0.000333,0.196667,14,8260,458.888889,590,128.090227,2,6
0,0,17,17,14,15,29,69,49,118,0.000333,0.191081,21,12038.07691,668.78205,573.241757,111.906328,2,6
0,0,20,20,17,17,34,82,57,139,0.000333,0.235719,24,16971.77604,942.876447,707.157335,138.973737,3,6
0,0,10,10,14,13,27,44,30,74,0.000333,0.117287,14,4926.063452,273.670192,351.861675,101.408685,2,6
0,0,20,20,17,22,39,92,57,149,0.000333,0.262508,16,12600.39889,700.022161,787.524931,167.594364,6,6
0,0,30,30,19,48,67,149,93,242,0.000333,0.489331,9,13211.94226,733.996792,1467.993584,348.788823,11,6
0,0,30,30,19,46,65,149,92,241,0.000333,0.483797,18,26125.03157,1451.390643,1451.390643,334.794473,11,6
0,0,17,17,15,21,36,81,49,130,0.000333,0.22403,14,9409.263503,522.736861,672.09025,150.842025,6,6
0,0,9,9,11,19,30,34,32,66,0.000333,0.107952,5,1619.273897,89.959661,323.854779,118.764371,1,6
0,0,7,7,11,16,27,27,25,52,0.000333,0.082418,5,1236.270751,68.681708,247.25415,102.053748,1,6
0,0,10,10,13,17,30,38,33,71,0.000333,0.11613,6,2090.335394,116.129744,348.389232,117.592585,1,6
0,0,12,12,11,14,25,39,35,74,0.000333,0.114548,10,3436.45358,190.914088,343.645358,91.356717,1,6
0,0,13,13,11,16,27,48,39,87,0.000333,0.137892,10,4136.752127,229.819563,413.675213,102.053748,2,6
0,0,16,16,15,19,34,61,47,108,0.000333,0.183149,14,7692.243816,427.346879,549.445987,139.313982,3,6
0,0,13,13,12,16,28,49,39,88,0.000333,0.141016,12,5076.566798,282.031489,423.047233,107.01955,2,6
0,0,16,16,16,19,35,62,47,109,0.000333,0.186364,16,8945.469582,496.970532,559.091849,144.710623,3,6
0,0,10,10,13,16,29,37,30,67,0.000333,0.108495,6,1952.90836,108.494909,325.484727,112.105716,2,6
0,0,9,9,13,13,26,34,25,59,0.000333,0.092442,6,1663.95566,92.441981,277.325943,96.211433,2,6
0,0,15,15,13,16,29,55,45,100,0.000333,0.161933,12,5829.577194,323.8654,485.7981,112.105716,2,6
0,0,9,9,13,13,26,37,27,64,0.000333,0.100276,12,3609.937704,200.552095,300.828142,96.211433,2,6
0,0,7,7,10,11,21,27,21,48,0.000333,0.070277,5,1054.156181,58.564232,210.831236,71.273029,1,6
0,0,14,14,15,17,32,57,41,98,0.000333,0.163333,14,6860,381.111111,490,128.090227,2,6
0,0,14,14,16,18,34,58,44,102,0.000333,0.172974,16,8302.739357,461.263298,518.92121,139.05865,2,6
0,0,12,12,11,14,25,46,42,88,0.000333,0.13622,15,6129.890171,340.549454,408.659345,91.356717,1,6
0,0,14,14,15,16,31,54,47,101,0.000333,0.166791,14,7005.233583,389.179643,500.373827,122.603359,2,6
0,0,13,13,12,15,27,49,44,93,0.000333,0.147402,12,5306.454452,294.803025,442.204538,101.622909,2,6
0,0,15,15,15,17,32,57,49,106,0.000333,0.176667,14,7420,412.222222,530,128.090227,3,6
0,0,13,13,12,15,27,49,43,92,0.000333,0.145817,12,5249.395802,291.6331,437.44965,101.622909,2,6
0,0,15,15,15,17,32,57,48,105,0.000333,0.175,14,7350,408.333333,525,128.090227,3,6
0,0,18,18,16,18,34,69,55,124,0.000333,0.210282,24,15140.28942,841.12719,630.845392,139.05865,3,6
0,0,18,18,15,18,33,71,56,127,0.000333,0.213546,21,13453.39912,747.411062,640.638053,133.662009,4,6
0,0,14,14,13,16,29,61,47,108,0.000333,0.174887,12,6295.94337,349.774632,524.661947,112.105716,4,6
0,0,13,13,11,16,27,53,48,101,0.000333,0.160081,15,7203.654566,400.203031,480.243638,102.053748,1,6
0,0,16,16,15,19,34,65,57,122,0.000333,0.20689,21,13034.0798,724.115544,620.670467,139.313982,2,6
0,0,11,11,14,23,37,49,38,87,0.000333,0.151074,7,3172.5571,176.253172,453.222443,157.344894,4,6
0,0,10,10,14,22,36,46,36,82,0.000333,0.141311,7,2967.536951,164.863164,423.93385,151.410465,4,6
0,0,16,16,14,17,31,56,52,108,0.000333,0.178351,21,11236.11723,624.228735,535.053202,122.789837,3,6
0,0,11,11,10,12,22,38,29,67,0.000333,0.099594,10,2987.819184,165.989955,298.781918,76.238831,2,6
0,0,14,14,14,15,29,51,37,88,0.000333,0.142501,14,5985.032586,332.50181,427.502328,111.906328,3,6
0,0,10,10,13,14,27,39,28,67,0.000333,0.106192,12,3822.929552,212.384975,318.577463,101.408685,2,6
0,0,14,14,17,17,34,55,40,95,0.000333,0.161103,16,7732.943519,429.607973,483.30897,138.973737,2,6
0,0,10,10,16,15,31,42,29,71,0.000333,0.117249,8,2813.983504,156.332417,351.747938,122.603359,2,6
0,0,12,12,14,13,27,41,30,71,0.000333,0.112532,14,4726.358177,262.575454,337.597013,101.408685,2,6
0,0,17,17,17,25,42,83,60,143,0.000333,0.257034,16,12337.62226,685.423459,771.101391,185.583273,6,6
0,0,17,17,17,25,42,83,60,143,0.000333,0.257034,16,12337.62226,685.423459,771.101391,185.583273,6,6
0,0,14,14,16,21,37,64,51,115,0.000333,0.199696,16,9585.394193,532.5219,599.087137,156.238666,5,6
0,0,16,16,12,19,31,78,56,134,0.000333,0.221287,12,7966.347667,442.57487,663.862306,123.730173,1,6
0,0,12,12,12,18,30,45,34,79,0.000333,0.129215,6,2325.866142,129.214786,387.644357,118.0782,4,6
0,0,21,21,19,19,38,82,58,140,0.000333,0.244903,27,19837.166,1102.064778,734.709852,161.421246,4,6
0,0,10,10,13,13,26,41,29,70,0.000333,0.109677,12,3948.369363,219.353854,329.03078,96.211433,2,6
0,0,9,9,9,11,20,34,30,64,0.000333,0.092201,8,2212.827185,122.934844,276.603398,66.583073,1,6
0,0,9,9,11,12,23,37,28,65,0.000333,0.098011,10,2940.315271,163.350848,294.031527,81.073298,1,6
0,0,13,13,11,14,25,49,40,89,0.000333,0.137768,10,4133.032009,229.612889,413.303201,91.356717,1,6
0,0,13,13,13,14,27,51,41,92,0.000333,0.145817,12,5249.395802,291.6331,437.44965,101.408685,1,6
0,0,13,13,16,18,34,50,44,94,0.000333,0.159407,16,7651.544113,425.085784,478.221507,139.05865,2,6
0,0,14,14,14,24,38,63,47,110,0.000333,0.192424,7,4040.904185,224.494677,577.272026,163.342069,6,6
0,0,15,15,14,16,30,54,46,100,0.000333,0.163563,14,6869.646834,381.647046,490.68906,117.302969,2,6
0,0,17,17,17,18,35,62,51,113,0.000333,0.193203,16,9273.743695,515.207983,579.608981,144.545518,3,6
0,0,19,19,15,18,33,75,55,130,0.000333,0.21859,21,13771.19595,765.066441,655.771236,133.662009,3,6
0,0,22,22,18,20,38,88,63,151,0.000333,0.264146,27,21395.80047,1188.655582,792.437055,161.497212,4,6
0,0,12,12,16,16,32,53,37,90,0.000333,0.15,16,7200,400,450,128,3,6
0,0,17,17,14,17,31,71,52,123,0.000333,0.203122,21,12796.68907,710.927171,609.366146,122.789837,2,6
0,0,20,20,18,19,37,84,60,144,0.000333,0.250054,27,20254.35469,1125.241927,750.161285,155.769273,3,6
0,0,12,12,16,16,32,53,37,90,0.000333,0.15,16,7200,400,450,128,3,6
0,0,15,15,11,17,28,57,47,104,0.000333,0.166655,10,4999.649119,277.758284,499.964912,107.540616,1,6
0,0,10,10,13,17,30,38,33,71,0.000333,0.11613,6,2090.335394,116.129744,348.389232,117.592585,1,6
0,0,15,15,16,23,39,73,54,127,0.000333,0.223749,16,10739.93731,596.663184,671.246082,168.041925,5,6
0,0,14,14,14,25,39,65,50,115,0.000333,0.202607,14,8509.497572,472.749865,607.821255,169.399374,5,6
0,0,6,6,11,10,21,27,19,46,0.000333,0.067349,5,1010.233007,56.124056,202.046601,71.273029,1,6
0,0,10,10,15,14,29,42,29,71,0.000333,0.114972,14,4828.833109,268.268506,344.916651,111.906328,2,6
0,0,14,14,17,16,33,59,41,100,0.000333,0.168146,16,8071.030591,448.390588,504.439412,133.486868,2,6
0,0,11,11,11,14,25,54,37,91,0.000333,0.140864,10,4225.909133,234.77273,422.590913,91.356717,1,6
0,0,8,8,12,12,24,30,25,55,0.000333,0.084058,12,3026.07525,168.115292,252.172938,86.0391,2,6
0,0,6,6,8,9,17,15,15,30,0.000333,0.040875,4,490.495541,27.249752,122.623885,52.529325,1,6
0,0,13,13,15,15,30,46,35,81,0.000333,0.132486,14,5564.413935,309.134108,397.458138,117.206718,2,6
0,0,11,11,13,17,30,35,30,65,0.000333,0.106316,6,1913.687332,106.315963,318.947889,117.592585,2,6
0,0,20,20,17,27,44,98,64,162,0.000333,0.294809,16,14150.84676,786.158153,884.427922,197.868831,6,6
0,0,16,16,14,17,31,64,48,112,0.000333,0.184957,14,7768.179815,431.565545,554.869987,122.789837,3,6
0,0,19,19,17,19,36,77,56,133,0.000333,0.2292,16,11001.6004,611.200022,687.600025,150.197491,4,6
0,0,13,13,14,21,35,55,39,94,0.000333,0.160718,7,3375.068225,187.50379,482.152604,145.541635,5,6
0,0,6,6,11,9,20,19,15,34,0.000333,0.048982,5,734.727776,40.81821,146.945555,66.583073,2,6
0,0,19,19,17,19,36,76,59,135,0.000333,0.232647,24,16750.55701,930.5865,697.939875,150.197491,2,6
0,0,13,13,16,16,32,53,41,94,0.000333,0.156667,16,7520,417.777778,470,128,2,6
0,0,21,21,17,23,40,84,67,151,0.000333,0.26787,16,12857.77828,714.321015,803.611142,173.528793,3,6
0,0,15,15,16,16,32,59,44,103,0.000333,0.171667,16,8240,457.777778,515,128,2,6
0,0,13,13,16,25,41,54,44,98,0.000333,0.175013,8,4200.320772,233.351154,525.040096,180.096405,4,6
0,0,9,9,13,19,32,36,31,67,0.000333,0.111667,6,2010,111.666667,335,128.816339,2,6
0,0,12,12,13,23,36,48,38,86,0.000333,0.148205,6,2667.681301,148.204517,444.61355,152.147641,4,6
0,0,13,13,16,15,31,53,38,91,0.000333,0.150277,16,7213.309828,400.739435,450.831864,122.603359,2,6
0,0,13,13,16,17,33,56,50,106,0.000333,0.178235,16,8555.292426,475.294024,534.705777,133.486868,2,6
0,0,24,24,19,42,61,106,79,185,0.000333,0.365729,9,9874.677667,548.593204,1097.186407,307.187955,8,6
0,0,23,23,19,42,61,105,77,182,0.000333,0.359798,9,9714.547759,539.697098,1079.394195,307.187955,8,6
0,0,10,10,11,13,24,33,29,62,0.000333,0.094756,10,2842.67675,157.926486,284.267675,86.159464,1,6
0,0,13,13,15,16,31,46,37,83,0.000333,0.137066,14,5756.776113,319.820895,411.198294,122.603359,2,6
0,0,18,18,18,23,41,79,58,137,0.000333,0.244662,18,13211.72324,733.984625,733.984625,179.100575,4,6
0,0,33,33,22,48,70,148,111,259,0.000333,0.529161,22,34924.65463,1940.258591,1587.484301,366.185696,10,6
0,0,15,15,18,16,34,61,41,102,0.000333,0.172974,18,9340.581777,518.92121,518.92121,139.05865,3,6
0,0,13,13,16,15,31,53,38,91,0.000333,0.150277,16,7213.309828,400.739435,450.831864,122.603359,2,6
0,0,7,7,11,12,23,30,24,54,0.000333,0.081424,10,2442.723456,135.706859,244.272346,81.073298,1,6
0,0,15,15,15,24,39,75,53,128,0.000333,0.22551,14,9471.440776,526.191154,676.531484,168.642459,6,6
0,0,16,16,15,24,39,78,57,135,0.000333,0.237843,14,9989.410194,554.967233,713.5293,168.642459,6,6
0,0,17,17,17,17,34,58,39,97,0.000333,0.164495,16,7895.74233,438.652352,493.483896,138.973737,3,6
0,0,10,10,14,13,27,37,26,63,0.000333,0.099853,14,4193.810777,232.989488,299.557913,101.408685,2,6
0,0,13,13,14,21,35,55,39,94,0.000333,0.160718,7,3375.068225,187.50379,482.152604,145.541635,5,6
0,0,15,15,16,20,36,60,41,101,0.000333,0.174054,16,8354.598802,464.144378,522.162425,150.438562,5,6
0,0,9,9,13,16,29,41,30,71,0.000333,0.114972,6,2069.499904,114.972217,344.916651,112.105716,3,6
0,0,13,13,14,20,34,55,38,93,0.000333,0.157711,7,3311.93831,183.996573,473.134044,139.741531,5,6
0,0,13,13,14,21,35,55,39,94,0.000333,0.160718,7,3375.068225,187.50379,482.152604,145.541635,5,6
0,0,9,9,13,16,29,41,30,71,0.000333,0.114972,6,2069.499904,114.972217,344.916651,112.105716,3,6
0,0,15,15,14,16,30,64,47,111,0.000333,0.181555,14,7625.307986,423.628221,544.664856,117.302969,2,6
0,0,18,18,18,18,36,77,55,132,0.000333,0.227477,27,18425.61271,1023.64515,682.4301,150.1173,3,6
0,0,13,13,14,21,35,55,39,94,0.000333,0.160718,7,3375.068225,187.50379,482.152604,145.541635,5,6
0,0,15,15,11,14,25,61,46,107,0.000333,0.165631,15,7453.389185,414.077177,496.892612,91.356717,1,6
0,0,18,18,15,16,31,74,54,128,0.000333,0.211379,21,13316.87968,739.826649,634.137128,122.603359,2,6
0,0,10,10,13,18,31,42,33,75,0.000333,0.123855,6,2229.38834,123.854908,371.564723,123.164366,4,6
0,0,12,12,16,16,32,51,40,91,0.000333,0.151667,16,7280,404.444444,455,128,2,6
0,0,12,12,14,22,36,58,43,101,0.000333,0.174054,7,3655.136976,203.063165,522.162425,151.410465,5,6
0,0,16,16,14,16,30,64,47,111,0.000333,0.181555,14,7625.307986,423.628221,544.664856,117.302969,3,6
0,0,19,19,17,18,35,77,55,132,0.000333,0.225688,24,16249.5686,902.753811,677.065358,144.545518,4,6
0,0,19,19,16,22,38,69,58,127,0.000333,0.222162,16,10663.78871,592.432706,666.486794,162.107496,2,6
0,0,11,11,15,18,33,49,38,87,0.000333,0.146287,14,6144.072037,341.337335,438.862288,133.662009,2,6
0,0,10,10,10,12,22,33,28,61,0.000333,0.090675,10,2720.253287,151.125183,272.025329,76.238831,1,6
0,0,11,11,13,14,27,38,29,67,0.000333,0.106192,12,3822.929552,212.384975,318.577463,101.408685,2,6
0,0,6,6,8,9,17,15,15,30,0.000333,0.040875,4,490.495541,27.249752,122.623885,52.529325,1,6
0,0,13,13,15,15,30,46,35,81,0.000333,0.132486,14,5564.413935,309.134108,397.458138,117.206718,2,6
0,0,18,18,17,25,42,82,60,142,0.000333,0.255236,16,12251.34519,680.630288,765.709074,185.583273,6,6
0,0,14,14,14,24,38,63,47,110,0.000333,0.192424,7,4040.904185,224.494677,577.272026,163.342069,6,6
0,0,17,17,16,18,34,65,50,115,0.000333,0.195019,16,9360.931628,520.051757,585.058227,139.05865,4,6
0,0,16,16,15,17,32,62,49,111,0.000333,0.185,14,7770,431.666667,555,128.090227,3,6
0,0,12,12,13,15,28,52,40,92,0.000333,0.147426,12,5307.319834,294.851102,442.276653,106.709075,3,6
0,0,17,17,16,18,34,65,51,116,0.000333,0.196715,16,9442.331033,524.573946,590.14569,139.05865,4,6
0,0,14,14,12,15,27,53,48,101,0.000333,0.160081,18,8644.385479,480.243638,480.243638,101.622909,1,6
0,0,16,16,16,17,33,61,53,114,0.000333,0.191687,24,13801.46231,766.747906,575.06093,133.486868,2,6
0,0,15,15,12,18,30,54,51,105,0.000333,0.171741,12,6182.68215,343.482342,515.223513,118.0782,1,6
0,0,17,17,16,20,36,62,56,118,0.000333,0.20335,16,9760.818403,542.267689,610.05115,150.438562,2,6
0,0,10,10,14,21,35,41,34,75,0.000333,0.128232,7,2692.873584,149.604088,384.696226,145.541635,2,6
0,0,19,19,16,26,42,90,60,150,0.000333,0.269616,16,12941.56182,718.975656,808.847613,186.211433,6,6
0,0,18,18,16,26,42,87,56,143,0.000333,0.257034,16,12337.62226,685.423459,771.101391,186.211433,6,6
0,0,19,19,17,28,45,91,61,152,0.000333,0.278254,16,13356.18673,742.010374,834.761671,204.092806,6,6
0,0,20,20,18,26,44,95,62,157,0.000333,0.28571,18,15428.35375,857.130764,857.130764,197.270083,6,6
0,0,7,7,11,16,27,27,25,52,0.000333,0.082418,5,1236.270751,68.681708,247.25415,102.053748,1,6
0,0,19,19,17,18,35,70,59,129,0.000333,0.220559,24,15880.26022,882.236679,661.677509,144.545518,3,6
0,0,17,17,16,17,33,63,56,119,0.000333,0.200094,24,14406.78961,800.3772,600.2829,133.486868,2,6
0,0,17,17,15,17,32,62,56,118,0.000333,0.196667,21,12390,688.333333,590,128.090227,2,6
0,0,16,16,12,19,31,59,46,105,0.000333,0.173397,12,6242.287351,346.793742,520.190613,123.730173,3,6
0,0,19,19,15,21,36,72,54,126,0.000333,0.217137,14,9119.747703,506.65265,651.41055,150.842025,4,6
0,0,10,10,13,14,27,39,28,67,0.000333,0.106192,12,3822.929552,212.384975,318.577463,101.408685,2,6
0,0,11,11,13,17,30,45,31,76,0.000333,0.124308,6,2237.542112,124.307895,372.923685,117.592585,4,6
0,0,12,12,13,18,31,46,33,79,0.000333,0.130461,6,2348.289051,130.460503,391.381509,123.164366,4,6
0,0,18,18,17,21,38,86,55,141,0.000333,0.246653,16,11839.32447,657.740248,739.957779,161.725534,5,6
0,0,17,17,16,21,37,82,53,135,0.000333,0.234425,16,11252.41927,625.134404,703.276204,156.238666,5,6
0,0,15,15,14,15,29,58,43,101,0.000333,0.163552,14,6869.185127,381.621396,490.656081,111.906328,2,6
0,0,19,19,17,19,36,77,56,133,0.000333,0.2292,16,11001.6004,611.200022,687.600025,150.197491,4,6
0,0,17,17,16,25,41,84,54,138,0.000333,0.246447,16,11829.47483,657.193046,739.342177,180.096405,6,6
0,0,10,10,11,13,24,47,33,80,0.000333,0.122266,10,3667.970001,203.776111,366.797,86.159464,1,6
0,0,19,19,13,19,32,68,66,134,0.000333,0.223333,18,12060,670,670,128.816339,2,6
0,0,21,21,17,22,39,76,71,147,0.000333,0.258985,24,18646.89903,1035.938835,776.954126,167.594364,3,6
0,0,13,13,13,17,30,44,42,86,0.000333,0.140664,12,5063.911095,281.328394,421.992591,117.592585,2,6
0,0,15,15,13,17,30,50,46,96,0.000333,0.15702,12,5652.737966,314.040998,471.061497,117.592585,2,6
0,0,18,18,16,19,35,62,55,117,0.000333,0.200042,16,9602.017808,533.445434,600.126113,144.710623,3,6
0,0,13,13,11,16,27,45,43,88,0.000333,0.139477,10,4184.301002,232.461167,418.4301,102.053748,2,6
0,0,16,16,14,18,32,57,52,109,0.000333,0.181667,14,7630,423.888889,545,128.361619,3,6
0,0,17,17,15,19,34,75,52,127,0.000333,0.215369,14,9045.508932,502.528274,646.107781,139.313982,6,6
0,0,16,16,15,19,34,72,50,122,0.000333,0.20689,14,8689.386533,482.743696,620.670467,139.313982,6,6
0,0,13,13,14,21,35,58,44,102,0.000333,0.174396,14,7324.616148,406.923119,523.186868,145.541635,6,6
0,0,11,11,11,13,24,47,33,80,0.000333,0.122266,10,3667.970001,203.776111,366.797,86.159464,1,6
0,0,8,8,12,12,24,34,23,57,0.000333,0.087114,6,1568.057175,87.114288,261.342863,86.0391,2,6
0,0,10,10,13,15,28,43,27,70,0.000333,0.112172,6,2019.089067,112.171615,336.514845,106.709075,2,6
0,0,10,10,14,13,27,39,26,65,0.000333,0.103023,14,4326.947627,240.385979,309.067688,101.408685,2,6
0,0,8,8,12,13,25,34,24,58,0.000333,0.089781,6,1616.061954,89.78122,269.343659,91.125266,2,6
0,0,5,5,9,8,17,15,13,28,0.000333,0.03815,4,457.795838,25.433102,114.44896,52.529325,1,6
0,0,22,22,16,19,35,92,64,156,0.000333,0.266723,24,19204.03562,1066.890868,800.168151,144.710623,3,6
0,0,25,25,18,21,39,105,72,177,0.000333,0.311839,27,25258.9372,1403.274289,935.516193,167.297316,4,6
0,0,10,10,13,13,26,41,29,70,0.000333,0.109677,12,3948.369363,219.353854,329.03078,96.211433,2,6
0,0,18,18,15,17,32,68,50,118,0.000333,0.196667,14,8260,458.888889,590,128.090227,3,6
0,0,21,21,18,19,37,81,58,139,0.000333,0.241371,27,19551.07848,1086.171027,724.114018,155.769273,4,6
0,0,18,18,17,25,42,82,60,142,0.000333,0.255236,16,12251.34519,680.630288,765.709074,185.583273,6,6
0,0,11,11,16,19,35,51,39,90,0.000333,0.153878,16,7386.167544,410.342641,461.635472,144.710623,2,6
0,0,10,10,11,13,24,30,28,58,0.000333,0.088643,10,2659.27825,147.737681,265.927825,86.159464,2,6
0,0,12,12,13,15,28,35,31,66,0.000333,0.105762,12,3807.425098,211.523617,317.285425,106.709075,2,6
0,0,10,10,11,15,26,30,29,59,0.000333,0.092442,5,1386.629717,77.034984,277.325943,96.657107,2,6
0,0,16,16,16,17,33,63,42,105,0.000333,0.176554,16,8474.582121,470.810118,529.661383,133.486868,3,6
0,0,9,9,14,10,24,32,25,57,0.000333,0.087114,14,3658.800076,203.266671,261.342863,86.52225,3,6
0,0,9,9,13,12,25,30,24,54,0.000333,0.083589,12,3009.218811,167.178823,250.768234,91.125266,2,6
0,0,13,13,12,16,28,49,39,88,0.000333,0.141016,12,5076.566798,282.031489,423.047233,107.01955,2,6
0,0,16,16,16,19,35,62,47,109,0.000333,0.186364,16,8945.469582,496.970532,559.091849,144.710623,3,6
0,0,42,42,19,54,73,178,135,313,0.000333,0.645805,18,34873.47157,1937.415087,1937.415087,391.474548,12,6
0,0,45,45,21,56,77,191,143,334,0.000333,0.697702,20,41862.13409,2325.674116,2093.106705,417.450542,13,6
0,0,18,18,18,28,46,86,63,149,0.000333,0.274337,18,14814.19317,823.010731,823.010731,209.664588,6,6
0,0,17,17,13,16,29,67,52,119,0.000333,0.1927,18,10405.79529,578.099738,578.099738,112.105716,2,6
0,0,20,20,17,18,35,80,60,140,0.000333,0.239367,24,17234.39094,957.466163,718.099622,144.545518,3,6
0,0,10,10,13,13,26,44,31,75,0.000333,0.117511,12,4230.395746,235.021986,352.532979,96.211433,2,6
0,0,18,18,15,16,31,72,54,126,0.000333,0.208076,21,13108.80344,728.266858,624.228735,122.603359,2,6
0,0,21,21,19,18,37,85,62,147,0.000333,0.255263,27,20676.32041,1148.684467,765.789645,155.769273,3,6
0,0,10,10,13,13,26,41,29,70,0.000333,0.109677,12,3948.369363,219.353854,329.03078,96.211433,2,6
0,0,17,17,13,16,29,67,52,119,0.000333,0.1927,18,10405.79529,578.099738,578.099738,112.105716,2,6
0,0,20,20,17,18,35,80,60,140,0.000333,0.239367,24,17234.39094,957.466163,718.099622,144.545518,3,6
0,0,17,17,15,17,32,71,50,121,0.000333,0.201667,14,8470,470.555556,605,128.090227,3,6
0,0,11,11,15,14,29,42,29,71,0.000333,0.114972,14,4828.833109,268.268506,344.916651,111.906328,2,6
0,0,11,11,15,15,30,42,30,72,0.000333,0.117765,14,4946.14572,274.785873,353.296123,117.206718,2,6
0,0,11,11,15,14,29,42,29,71,0.000333,0.114972,14,4828.833109,268.268506,344.916651,111.906328,2,6
0,0,12,12,16,19,35,55,40,95,0.000333,0.162427,16,7796.510186,433.139455,487.281887,144.710623,2,6
0,0,18,18,16,22,38,84,60,144,0.000333,0.251901,16,12091.22499,671.734722,755.701562,162.107496,2,6
0,0,12,12,17,19,36,56,40,96,0.000333,0.165438,16,7941.004802,441.166933,496.3128,150.197491,2,6
0,0,11,11,12,17,29,45,37,82,0.000333,0.132785,12,4780.253299,265.569628,398.354442,112.506418,2,6
0,0,14,14,16,20,36,58,45,103,0.000333,0.177501,16,8520.036402,473.335356,532.502275,150.438562,3,6
0,0,12,12,16,16,32,53,37,90,0.000333,0.15,16,7200,400,450,128,3,6
0,0,22,22,14,21,35,93,71,164,0.000333,0.280401,21,17665.25071,981.402817,841.202415,145.541635,2,6
0,0,25,25,18,23,41,106,79,185,0.000333,0.330382,27,26760.97226,1486.720681,991.147121,179.100575,3,6
0,0,10,10,11,13,24,33,29,62,0.000333,0.094756,10,2842.67675,157.926486,284.267675,86.159464,1,6
0,0,13,13,15,16,31,46,37,83,0.000333,0.137066,14,5756.776113,319.820895,411.198294,122.603359,2,6
0,0,21,21,19,24,43,97,69,166,0.000333,0.300253,18,16213.67909,900.759949,900.759949,190.749723,6,6
0,0,14,14,16,26,42,64,50,114,0.000333,0.204908,8,4917.79349,273.210749,614.724186,186.211433,4,6
0,0,22,22,16,22,38,103,73,176,0.000333,0.307878,24,22167.24582,1231.513656,923.635242,162.107496,2,6
0,0,12,12,16,16,32,50,34,84,0.000333,0.14,16,6720,373.333333,420,128,3,6
0,0,14,14,18,16,34,55,36,91,0.000333,0.15432,18,8333.264134,462.959119,462.959119,139.05865,3,6
0,0,12,12,16,15,31,50,33,83,0.000333,0.137066,16,6579.1727,365.509594,411.198294,122.603359,3,6
0,0,12,12,15,18,33,59,42,101,0.000333,0.169828,14,7132.773285,396.265182,509.483806,133.662009,5,6
0,0,13,13,16,17,33,54,42,96,0.000333,0.161421,16,7748.189367,430.454965,484.261835,133.486868,2,6
0,0,16,16,18,20,38,71,51,122,0.000333,0.213416,18,11524.44882,640.247157,640.247157,161.497212,3,6
0,0,30,30,20,51,71,156,99,255,0.000333,0.522729,10,15681.85516,871.214175,1568.185515,375.732254,11,6
0,0,17,17,16,26,42,88,56,144,0.000333,0.258831,16,12423.89934,690.21663,776.493709,186.211433,6,6
0,0,29,29,20,51,71,153,98,251,0.000333,0.514529,10,15435.86527,857.548071,1543.586527,375.732254,10,6
0,0,17,17,16,26,42,88,56,144,0.000333,0.258831,16,12423.89934,690.21663,776.493709,186.211433,6,6
0,0,7,7,9,14,23,27,25,52,0.000333,0.078408,4,940.900887,52.272271,235.225222,81.832294,1,6
0,0,10,10,13,17,30,40,33,73,0.000333,0.119401,6,2149.218081,119.401004,358.203013,117.592585,2,6
0,0,9,9,13,14,27,37,28,65,0.000333,0.103023,12,3708.812252,206.045125,309.067688,101.408685,2,6
0,0,16,16,11,17,28,69,51,120,0.000333,0.192294,15,8653.23886,480.735492,576.882591,107.540616,1,6
0,0,19,19,15,19,34,82,59,141,0.000333,0.239111,21,15063.97747,836.887637,717.332261,139.313982,2,6
0,0,9,9,13,15,28,40,30,70,0.000333,0.112172,12,4038.178135,224.34323,336.514845,106.709075,2,6
0,0,18,18,14,18,32,65,59,124,0.000333,0.206667,21,13020,723.333333,620,128.361619,2,6
0,0,20,20,18,20,38,73,64,137,0.000333,0.239655,27,19412.08387,1078.449104,718.966069,161.497212,3,6
0,0,10,10,13,15,28,42,37,79,0.000333,0.126594,12,4557.372466,253.187359,379.781039,106.709075,2,6
0,0,12,12,17,18,35,50,42,92,0.000333,0.157298,16,7550.304601,419.461367,471.894038,144.545518,3,6
0,0,17,17,13,18,31,61,57,118,0.000333,0.194865,18,10522.71296,584.595165,584.595165,123.164366,2,6
0,0,19,19,17,20,37,69,62,131,0.000333,0.227479,24,16378.52138,909.917855,682.438391,155.92543,3,6
0,0,18,18,15,16,31,74,54,128,0.000333,0.211379,21,13316.87968,739.826649,634.137128,122.603359,2,6
0,0,20,20,16,17,33,81,57,138,0.000333,0.232042,24,16707.03332,928.168518,696.126388,133.486868,3,6
0,0,10,10,14,13,27,44,30,74,0.000333,0.117287,14,4926.063452,273.670192,351.861675,101.408685,2,6
0,0,16,16,15,20,35,63,51,114,0.000333,0.194913,14,8186.335695,454.796428,584.738264,145.041921,3,6
0,0,18,18,18,28,46,86,63,149,0.000333,0.274337,18,14814.19317,823.010731,823.010731,209.664588,6,6
0,0,11,11,15,14,29,42,29,71,0.000333,0.114972,14,4828.833109,268.268506,344.916651,111.906328,2,6
0,0,12,12,16,15,31,43,33,76,0.000333,0.125506,16,6024.302713,334.683484,376.51892,122.603359,3,6
0,0,15,15,16,17,33,53,41,94,0.000333,0.158058,16,7586.768756,421.487153,474.173047,133.486868,3,6
0,0,11,11,16,14,30,47,32,79,0.000333,0.129215,16,6202.309713,344.572762,387.644357,117.302969,2,6
0,0,12,12,16,14,30,50,33,83,0.000333,0.135757,16,6516.350711,362.019484,407.271919,117.302969,3,6
0,0,12,12,16,15,31,50,34,84,0.000333,0.138717,16,6658.439841,369.913325,416.15249,122.603359,3,6
0,0,12,12,16,16,32,50,34,84,0.000333,0.14,16,6720,373.333333,420,128,3,6
0,0,14,14,18,16,34,55,36,91,0.000333,0.15432,18,8333.264134,462.959119,462.959119,139.05865,3,6
0,0,13,13,15,26,41,60,48,108,0.000333,0.192872,7,4050.309315,225.017184,578.615616,180.814792,4,6
0,0,16,16,14,17,31,65,47,112,0.000333,0.184957,14,7768.179815,431.565545,554.869987,122.789837,3,6
0,0,19,19,17,19,36,78,55,133,0.000333,0.2292,16,11001.6004,611.200022,687.600025,150.197491,4,6
0,0,12,12,16,16,32,53,37,90,0.000333,0.15,16,7200,400,450,128,3,6
0,0,16,16,14,18,32,65,48,113,0.000333,0.188333,14,7910,439.444444,565,128.361619,3,6
0,0,19,19,17,20,37,78,56,134,0.000333,0.232689,16,11169.06802,620.503779,698.066751,155.92543,4,6
0,0,6,6,11,9,20,19,15,34,0.000333,0.048982,5,734.727776,40.81821,146.945555,66.583073,2,6
0,0,11,11,13,18,31,47,37,84,0.000333,0.138717,12,4993.829881,277.434993,416.15249,123.164366,3,6
0,0,18,18,14,19,33,78,60,138,0.000333,0.232042,21,14618.65416,812.147453,696.126388,134.013592,2,6
0,0,31,31,20,52,72,156,102,258,0.000333,0.530614,10,15918.4065,884.355917,1591.84065,382.861427,10,6
0,0,19,19,17,27,44,91,60,151,0.000333,0.274791,16,13189.98679,732.777044,824.374174,197.868831,6,6
0,0,12,12,14,17,31,51,38,89,0.000333,0.146974,14,6172.928603,342.940478,440.923472,122.789837,3,6
0,0,15,15,17,18,35,65,46,111,0.000333,0.189783,16,9109.606638,506.089258,569.350415,144.545518,2,6
0,0,11,11,16,16,32,52,35,87,0.000333,0.145,16,6960,386.666667,435,128,2,6
0,0,13,13,11,14,25,51,39,90,0.000333,0.139316,10,4179.470571,232.192809,417.947057,91.356717,2,6
0,0,16,16,14,16,30,64,47,111,0.000333,0.181555,14,7625.307986,423.628221,544.664856,117.302969,3,6
0,0,20,20,17,28,45,98,65,163,0.000333,0.298391,16,14322.75288,795.708493,895.172055,204.092806,6,6
0,0,8,8,11,12,23,29,22,51,0.000333,0.076901,5,1153.508299,64.083794,230.70166,81.073298,2,6
0,0,14,14,13,19,32,58,40,98,0.000333,0.163333,12,5880,326.666667,490,128.816339,5,6
0,0,11,11,13,16,29,47,33,80,0.000333,0.129546,12,4663.661755,259.09232,388.63848,112.105716,4,6
0,0,11,11,14,20,34,43,37,80,0.000333,0.135666,7,2848.979191,158.276622,406.997027,139.741531,2,6
0,0,16,16,16,21,37,67,47,114,0.000333,0.197959,16,9502.042939,527.891274,593.877684,156.238666,6,6
0,0,11,11,13,16,29,47,33,80,0.000333,0.129546,12,4663.661755,259.09232,388.63848,112.105716,4,6
0,0,14,14,15,17,32,58,41,99,0.000333,0.165,14,6930,385,495,128.090227,4,6
0,0,15,15,13,21,34,61,42,103,0.000333,0.17467,12,6288.104072,349.339115,524.008673,140.344382,6,6
0,0,14,14,17,17,34,56,41,97,0.000333,0.164495,16,7895.74233,438.652352,493.483896,138.973737,2,6
0,0,10,10,16,15,31,43,30,73,0.000333,0.120552,16,5786.501291,321.472294,361.656331,122.603359,2,6
0,0,14,14,16,17,33,55,41,96,0.000333,0.161421,16,7748.189367,430.454965,484.261835,133.486868,2,6
0,0,10,10,16,15,31,43,30,73,0.000333,0.120552,16,5786.501291,321.472294,361.656331,122.603359,2,6
0,0,9,9,13,13,26,36,28,64,0.000333,0.100276,12,3609.937704,200.552095,300.828142,96.211433,2,6
0,0,14,14,16,17,33,59,44,103,0.000333,0.173191,16,8313.161509,461.842306,519.572594,133.486868,2,6
0,0,15,15,17,17,34,59,42,101,0.000333,0.171278,16,8221.339951,456.741108,513.833747,138.973737,3,6
0,0,16,16,15,21,36,80,49,129,0.000333,0.222307,14,9336.884553,518.715808,666.920325,150.842025,5,6
0,0,15,15,15,20,35,75,47,122,0.000333,0.208591,14,8760.815393,486.711966,625.772528,145.041921,5,6
0,0,23,23,18,24,42,97,81,178,0.000333,0.319944,27,25915.47753,1439.748752,959.832501,185.09775,3,6
0,0,18,18,15,21,36,65,56,121,0.000333,0.20852,14,8757.852952,486.547386,625.560925,150.842025,2,6
0,0,10,10,14,24,38,50,39,89,0.000333,0.155689,7,3269.458841,181.636602,467.065549,163.342069,4,6
0,0,9,9,13,23,36,40,35,75,0.000333,0.129248,6,2326.466251,129.248125,387.744375,152.147641,2,6
0,0,18,18,18,20,38,73,62,135,0.000333,0.236157,27,19128.69579,1062.705321,708.470214,161.497212,3,6
0,0,18,18,15,16,31,74,54,128,0.000333,0.211379,21,13316.87968,739.826649,634.137128,122.603359,2,6
0,0,10,10,14,13,27,47,32,79,0.000333,0.125212,14,5258.905577,292.161421,375.636113,101.408685,2,6
0,0,12,12,15,14,29,44,32,76,0.000333,0.123069,14,5168.891779,287.160654,369.206556,111.906328,3,6
0,0,12,12,15,16,31,44,33,77,0.000333,0.127158,14,5340.623623,296.701312,381.473116,122.603359,3,6
0,0,12,12,15,15,30,44,32,76,0.000333,0.124308,14,5220.931594,290.051755,372.923685,117.206718,3,6
0,0,16,16,16,25,41,79,58,137,0.000333,0.244662,16,11743.75399,652.430777,733.984625,180.096405,6,6
0,0,7,7,10,10,20,26,20,46,0.000333,0.06627,10,1988.086924,110.449274,198.808692,66.438562,1,6
0,0,13,13,15,16,31,50,37,87,0.000333,0.143672,14,6034.211106,335.23395,431.015079,122.603359,2,6
0,0,14,14,15,18,33,55,42,97,0.000333,0.163102,14,6850.287214,380.571512,489.30623,133.662009,2,6
0,0,10,10,15,16,31,43,31,74,0.000333,0.122204,7,2566.273689,142.57076,366.610527,122.603359,2,6
0,0,21,21,16,22,38,88,64,152,0.000333,0.265895,16,12762.95971,709.053317,797.684982,162.107496,2,6
0,0,10,10,15,17,32,44,32,76,0.000333,0.126667,7,2660,147.777778,380,128.090227,2,6
0,0,8,8,11,11,22,24,18,42,0.000333,0.062432,5,936.48064,52.026702,187.296128,76.107496,2,6
0,0,17,17,11,18,29,67,58,125,0.000333,0.202416,15,9108.714366,506.039687,607.247624,113.112398,1,6
0,0,19,19,15,20,35,75,63,138,0.000333,0.235947,21,14864.66218,825.814566,707.841056,145.041921,2,6
0,0,19,19,13,20,33,77,67,144,0.000333,0.242131,18,13075.06956,726.392753,726.392753,134.544278,1,6
0,0,21,21,17,22,39,85,72,157,0.000333,0.276603,24,19915.39556,1106.410864,829.808148,167.594364,2,6
0,0,17,17,16,25,41,84,54,138,0.000333,0.246447,16,11829.47483,657.193046,739.342177,180.096405,6,6
0,0,23,23,18,42,60,102,77,179,0.000333,0.352444,9,9516.00075,528.666708,1057.333417,301.535982,7,6
0,0,22,22,18,42,60,101,75,176,0.000333,0.346538,9,9356.514703,519.806372,1039.612745,301.535982,7,6
0,0,17,17,15,22,37,81,50,131,0.000333,0.227479,14,9554.137473,530.785415,682.438391,156.710855,6,6
0,0,17,17,15,22,37,81,50,131,0.000333,0.227479,14,9554.137473,530.785415,682.438391,156.710855,6,6
0,0,14,14,16,17,33,61,44,105,0.000333,0.176554,16,8474.582121,470.810118,529.661383,133.486868,2,6
0,0,14,14,17,17,34,62,44,106,0.000333,0.179757,16,8628.336979,479.352054,539.271061,138.973737,2,6
0,0,17,17,17,19,36,58,54,112,0.000333,0.193011,16,9264.505603,514.694756,579.0316,150.197491,2,6
0,0,13,13,11,15,26,47,40,87,0.000333,0.136313,10,4089.382555,227.18792,408.938255,96.657107,1,6
0,0,6,6,10,11,21,29,20,49,0.000333,0.071741,5,1076.117769,59.78432,215.223554,71.273029,1,6
0,0,11,11,11,13,24,46,34,80,0.000333,0.122266,10,3667.970001,203.776111,366.797,86.159464,1,6
0,0,14,14,14,18,32,65,44,109,0.000333,0.181667,14,7630,423.888889,545,128.361619,6,6
0,0,9,9,12,17,29,33,28,61,0.000333,0.098779,6,1778.021044,98.778947,296.336841,112.506418,2,6
0,0,11,11,13,14,27,45,34,79,0.000333,0.125212,12,4507.633352,250.424075,375.636113,101.408685,1,6
0,0,9,9,13,20,33,36,32,68,0.000333,0.11434,6,2058.112801,114.3396,343.0188,134.544278,2,6
0,0,12,12,14,13,27,41,30,71,0.000333,0.112532,14,4726.358177,262.575454,337.597013,101.408685,2,6
0,0,10,10,14,13,27,37,26,63,0.000333,0.099853,14,4193.810777,232.989488,299.557913,101.408685,2,6
0,0,13,13,11,14,25,51,39,90,0.000333,0.139316,10,4179.470571,232.192809,417.947057,91.356717,2,6
0,0,16,16,15,16,31,64,47,111,0.000333,0.183305,14,7698.821066,427.712281,549.91579,122.603359,3,6
0,0,13,13,11,15,26,51,39,90,0.000333,0.141013,10,4230.395746,235.021986,423.039575,96.657107,2,6
0,0,16,16,15,17,32,64,47,111,0.000333,0.185,14,7770,431.666667,555,128.090227,3,6
0,0,9,9,13,14,27,37,28,65,0.000333,0.103023,12,3708.812252,206.045125,309.067688,101.408685,2,6
0,0,16,16,12,15,27,58,53,111,0.000333,0.175931,18,9500.265229,527.792513,527.792513,101.622909,1,6
0,0,18,18,16,17,33,66,58,124,0.000333,0.208502,24,15012.1169,834.006494,625.504871,133.486868,2,6
0,0,13,13,10,14,24,48,45,93,0.000333,0.142134,15,6396.022689,355.334594,426.401513,86.52225,1,6
0,0,15,15,14,17,31,56,50,106,0.000333,0.175048,14,7352.027325,408.445962,525.144809,122.789837,2,6
0,0,17,17,11,16,27,60,57,117,0.000333,0.185441,15,8344.827566,463.601531,556.321838,102.053748,1,6
0,0,19,19,15,18,33,68,62,130,0.000333,0.21859,21,13771.19595,765.066441,655.771236,133.662009,2,6
0,0,11,11,11,14,25,50,36,86,0.000333,0.133124,10,3993.716323,221.873129,399.371632,91.356717,1,6
0,0,12,12,11,14,25,46,42,88,0.000333,0.13622,15,6129.890171,340.549454,408.659345,91.356717,1,6
0,0,14,14,15,16,31,54,47,101,0.000333,0.166791,14,7005.233583,389.179643,500.373827,122.603359,2,6
0,0,9,9,12,12,24,41,27,68,0.000333,0.103926,12,3741.329401,207.851633,311.77745,86.0391,2,6
0,0,9,9,12,11,23,41,27,68,0.000333,0.102534,12,3691.226556,205.068142,307.602213,81.073298,2,6
0,0,11,11,13,13,26,45,30,75,0.000333,0.117511,12,4230.395746,235.021986,352.532979,96.211433,2,6
0,0,9,9,12,13,25,41,28,69,0.000333,0.106809,12,3845.112925,213.617385,320.426077,91.125266,2,6
0,0,9,9,12,13,25,41,28,69,0.000333,0.106809,12,3845.112925,213.617385,320.426077,91.125266,2,6
0,0,8,8,13,12,25,30,25,55,0.000333,0.085137,12,3064.945085,170.274727,255.41209,91.125266,2,6
0,0,8,8,14,15,29,34,27,61,0.000333,0.098779,7,2074.357885,115.242105,296.336841,111.906328,2,6
0,0,15,15,15,17,32,52,44,96,0.000333,0.16,14,6720,373.333333,480,128.090227,2,6
0,0,21,21,16,22,38,87,63,150,0.000333,0.262396,16,12595.02603,699.723668,787.189127,162.107496,2,6
0,0,10,10,15,17,32,43,31,74,0.000333,0.123333,7,2590,143.888889,370,128.090227,2,6
0,0,30,30,20,51,71,152,97,249,0.000333,0.510429,10,15312.87033,850.715018,1531.287033,375.732254,11,6
0,0,18,18,16,22,38,76,59,135,0.000333,0.236157,16,11335.52343,629.751302,708.470214,162.107496,2,6
0,0,14,14,15,27,42,67,50,117,0.000333,0.2103,7,4416.307969,245.350443,630.901138,186.985321,6,6
0,0,14,14,15,27,42,67,50,117,0.000333,0.2103,7,4416.307969,245.350443,630.901138,186.985321,6,6
0,0,14,14,15,27,42,67,50,117,0.000333,0.2103,7,4416.307969,245.350443,630.901138,186.985321,6,6
0,0,10,10,14,14,28,36,28,64,0.000333,0.102557,14,4307.39001,239.299445,307.670715,106.605938,2,6
0,0,16,16,10,17,27,54,54,108,0.000333,0.171176,15,7702.917754,427.939875,513.52785,102.706149,1,6
0,0,19,19,14,19,33,66,63,129,0.000333,0.216909,21,13665.26367,759.181315,650.726841,134.013592,2,6
0,0,18,18,14,18,32,71,59,130,0.000333,0.216667,21,13650,758.333333,650,128.361619,2,6
0,0,20,20,16,20,36,79,64,143,0.000333,0.246433,24,17743.18261,985.732367,739.299275,150.438562,3,6
0,0,13,13,12,15,27,49,43,92,0.000333,0.145817,12,5249.395802,291.6331,437.44965,101.622909,2,6
0,0,15,15,15,17,32,57,48,105,0.000333,0.175,14,7350,408.333333,525,128.090227,3,6
0,0,13,13,12,14,26,49,43,92,0.000333,0.144147,18,7783.928173,432.440454,432.440454,96.322519,2,6
0,0,15,15,16,16,32,57,48,105,0.000333,0.175,24,12600,700,525,128,3,6
0,0,15,15,16,15,31,60,40,100,0.000333,0.16514,16,7926.714097,440.373005,495.419631,122.603359,2,6
0,0,11,11,15,13,28,47,31,78,0.000333,0.124991,14,5249.631575,291.646199,374.973684,106.709075,2,6
0,0,29,29,19,46,65,146,91,237,0.000333,0.475767,9,12845.71055,713.650586,1427.301172,334.794473,10,6
0,0,17,17,15,21,36,81,49,130,0.000333,0.22403,14,9409.263503,522.736861,672.09025,150.842025,6,6
0,0,18,18,12,20,32,77,67,144,0.000333,0.24,18,12960,720,720,129.458112,1,6
0,0,21,21,16,23,39,89,76,165,0.000333,0.290697,24,20930.19279,1162.788488,872.091366,168.041925,2,6
0,0,14,14,14,18,32,55,44,99,0.000333,0.165,14,6930,385,495,128.361619,2,6
0,0,17,17,15,20,35,75,53,128,0.000333,0.218849,14,9191.675166,510.64862,656.548226,145.041921,6,6
0,0,11,11,10,12,22,38,29,67,0.000333,0.099594,10,2987.819184,165.989955,298.781918,76.238831,2,6
0,0,14,14,14,15,29,51,37,88,0.000333,0.142501,14,5985.032586,332.50181,427.502328,111.906328,3,6
0,0,10,10,13,14,27,39,28,67,0.000333,0.106192,12,3822.929552,212.384975,318.577463,101.408685,2,6
0,0,22,22,14,21,35,98,73,171,0.000333,0.292369,21,18419.25531,1023.291962,877.107396,145.541635,2,6
0,0,25,25,18,23,41,111,81,192,0.000333,0.342883,27,27773.54959,1542.974977,1028.649985,179.100575,3,6
0,0,17,17,14,16,30,64,49,113,0.000333,0.184826,21,11644.05138,646.891744,554.478637,117.302969,2,6
0,0,13,13,13,15,28,53,41,94,0.000333,0.15063,12,5422.696352,301.260908,451.891363,106.709075,2,6
0,0,19,19,15,17,32,71,52,123,0.000333,0.205,21,12915,717.5,615,128.090227,3,6
0,0,9,9,13,13,26,34,25,59,0.000333,0.092442,6,1663.95566,92.441981,277.325943,96.211433,2,6
0,0,13,13,15,15,30,42,35,77,0.000333,0.125944,14,5289.628062,293.868226,377.830576,117.206718,2,6
0,0,16,16,15,18,33,71,48,119,0.000333,0.200094,14,8403.960603,466.8867,600.2829,133.662009,2,6
0,0,19,19,17,26,43,91,60,151,0.000333,0.273122,16,13109.85565,728.325314,819.365978,191.698301,6,6
0,0,19,19,16,17,33,80,57,137,0.000333,0.230361,24,16585.96786,921.442659,691.081994,133.486868,2,6
0,0,10,10,14,14,28,48,32,80,0.000333,0.128196,14,5384.237513,299.124306,384.588394,106.605938,2,6
0,0,16,16,14,16,30,65,50,115,0.000333,0.188097,21,11850.14079,658.341155,564.292418,117.302969,2,6
0,0,10,10,14,13,27,47,32,79,0.000333,0.125212,14,5258.905577,292.161421,375.636113,101.408685,2,6
0,0,16,16,15,27,42,70,54,124,0.000333,0.222882,14,9361.063046,520.059058,668.64736,186.985321,6,6
0,0,11,11,12,16,28,46,40,86,0.000333,0.137811,12,4961.19028,275.621682,413.432523,107.01955,1,6
0,0,13,13,16,19,35,54,45,99,0.000333,0.169266,16,8124.784299,451.376905,507.799019,144.710623,2,6
0,0,12,12,15,12,27,41,33,74,0.000333,0.117287,14,4926.063452,273.670192,351.861675,101.622909,3,6
0,0,12,12,14,14,28,39,32,71,0.000333,0.113774,14,4778.510793,265.472822,341.322199,106.605938,2,6
0,0,9,9,11,12,23,37,26,63,0.000333,0.094995,10,2849.844032,158.324668,284.984403,81.073298,2,6
0,0,10,10,10,12,22,40,31,71,0.000333,0.10554,10,3166.196449,175.899803,316.619645,76.238831,1,6
0,0,15,15,17,20,37,59,45,104,0.000333,0.180594,16,8668.5304,481.585022,541.78315,155.92543,3,6
0,0,18,18,18,21,39,73,51,124,0.000333,0.218463,18,11797.01775,655.389875,655.389875,167.297316,3,6
0,0,16,16,16,19,35,65,50,115,0.000333,0.196623,16,9437.880751,524.326708,589.867547,144.710623,3,6
0,0,13,13,15,17,32,56,43,99,0.000333,0.165,14,6930,385,495,128.090227,3,6
0,0,35,35,20,50,70,166,105,271,0.000333,0.553679,20,33220.71395,1845.59522,1661.035698,368.631371,13,6
0,0,12,12,13,18,31,46,40,86,0.000333,0.14202,12,5112.730592,284.040588,426.060883,123.164366,2,6
0,0,7,7,10,14,24,26,25,51,0.000333,0.077944,5,1169.165438,64.953635,233.833088,86.52225,1,6
0,0,13,13,14,15,29,54,41,95,0.000333,0.153836,14,6461.114724,358.950818,461.508195,111.906328,2,6
0,0,16,16,16,16,32,57,41,98,0.000333,0.163333,16,7840,435.555556,490,128,2,6
0,0,16,16,16,16,32,59,41,100,0.000333,0.166667,16,8000,444.444444,500,128,2,6
0,0,10,10,14,13,27,37,26,63,0.000333,0.099853,14,4193.810777,232.989488,299.557913,101.408685,2,6
0,0,18,18,16,17,33,63,44,107,0.000333,0.179917,16,8636.002732,479.77793,539.750171,133.486868,3,6
0,0,10,10,14,13,27,37,26,63,0.000333,0.099853,14,4193.810777,232.989488,299.557913,101.408685,2,6
0,0,6,6,10,11,21,33,21,54,0.000333,0.079062,5,1185.925704,65.884761,237.185141,71.273029,1,6
0,0,18,18,16,17,33,66,58,124,0.000333,0.208502,24,15012.1169,834.006494,625.504871,133.486868,2,6
0,0,15,15,18,18,36,57,43,100,0.000333,0.172331,18,9305.865003,516.9925,516.9925,150.1173,4,6
0,0,14,14,15,18,33,65,47,112,0.000333,0.188324,14,7909.609979,439.422777,564.972141,133.662009,5,6
0,0,21,21,16,21,37,86,64,150,0.000333,0.260473,24,18754.03212,1041.890673,781.418005,156.238666,2,6
0,0,10,10,16,16,32,50,34,84,0.000333,0.14,16,6720,373.333333,420,128,2,6
0,0,11,11,13,14,27,36,34,70,0.000333,0.110947,12,3994.105502,221.89475,332.842125,101.408685,2,6
0,0,12,12,15,17,32,59,41,100,0.000333,0.166667,14,7000,388.888889,500,128.090227,5,6
0,0,15,15,15,20,35,75,47,122,0.000333,0.208591,14,8760.815393,486.711966,625.772528,145.041921,5,6
0,0,17,17,15,19,34,78,50,128,0.000333,0.217065,14,9116.733412,506.48519,651.195244,139.313982,5,6
0,0,16,16,19,18,37,61,47,108,0.000333,0.18754,18,10127.17734,562.620963,562.620963,155.769273,3,6
0,0,15,15,13,17,30,62,47,109,0.000333,0.178284,12,6418.212899,356.567383,534.851075,117.592585,2,6
0,0,18,18,17,19,36,75,55,130,0.000333,0.22403,16,10753.444,597.413556,672.09025,150.197491,3,6
0,0,24,24,18,23,41,109,79,188,0.000333,0.33574,27,27194.93398,1510.829665,1007.219777,179.100575,3,6
0,0,14,14,16,15,31,44,32,76,0.000333,0.125506,16,6024.302713,334.683484,376.51892,122.603359,3,6
0,0,12,12,15,14,29,40,29,69,0.000333,0.111734,14,4692.809641,260.711647,335.200689,111.906328,3,6
0,0,14,14,17,15,32,45,32,77,0.000333,0.128333,16,6160,342.222222,385,128.090227,3,6
0,0,4,4,8,8,16,14,12,26,0.000333,0.034667,4,416,23.111111,104,48,1,6
0,0,11,11,11,12,23,44,32,76,0.000333,0.114597,10,3437.907087,190.994838,343.790709,81.073298,1,6
0,0,14,14,14,25,39,61,48,109,0.000333,0.192036,7,4032.761893,224.042327,576.108842,169.399374,3,6
0,0,10,10,13,23,36,43,36,79,0.000333,0.136141,6,2450.544451,136.141358,408.424075,152.147641,2,6
0,0,11,11,14,23,37,47,40,87,0.000333,0.151074,7,3172.5571,176.253172,453.222443,157.344894,2,6
0,0,6,6,10,11,21,33,21,54,0.000333,0.079062,5,1185.925704,65.884761,237.185141,71.273029,1,6
0,0,16,16,16,26,42,77,61,138,0.000333,0.248047,16,11906.23687,661.457604,744.139804,186.211433,6,6
0,0,16,16,15,27,42,68,51,119,0.000333,0.213895,7,4491.800413,249.544467,641.685773,186.985321,5,6
0,0,13,13,15,24,39,57,44,101,0.000333,0.177942,7,3736.779369,207.598854,533.825624,168.642459,4,6
0,0,14,14,16,22,38,61,45,106,0.000333,0.185427,16,8900.485063,494.471392,556.280316,162.107496,4,6
0,0,13,13,16,16,32,52,39,91,0.000333,0.151667,16,7280,404.444444,455,128,2,6
0,0,16,16,12,16,28,74,50,124,0.000333,0.198704,18,10730.01619,596.11201,596.11201,107.01955,1,6
0,0,19,19,16,18,34,87,58,145,0.000333,0.245894,24,17704.37069,983.576149,737.682112,139.05865,2,6
0,0,10,10,14,15,29,49,33,82,0.000333,0.132785,14,5576.962182,309.831232,398.354442,111.906328,2,6
0,0,9,9,10,12,22,37,27,64,0.000333,0.095135,10,2854.036236,158.557569,285.403624,76.238831,1,6
0,0,12,12,14,14,28,50,35,85,0.000333,0.136208,14,5720.752357,317.819575,408.625168,106.605938,2,6
0,0,10,10,14,14,28,46,31,77,0.000333,0.123389,14,5182.328606,287.907145,370.166329,106.605938,2,6
0,0,18,18,15,21,36,71,65,136,0.000333,0.23437,21,14765.3058,820.294767,703.1098,150.842025,2,6
0,0,18,18,17,19,36,71,54,125,0.000333,0.215414,16,10339.85,574.436111,646.240625,150.197491,2,6
0,0,19,19,17,20,37,63,56,119,0.000333,0.206642,16,9918.799208,551.0444,619.924951,155.92543,2,6
0,0,21,21,18,21,39,81,66,147,0.000333,0.258985,27,20977.76141,1165.431189,776.954126,167.297316,2,6
0,0,15,15,15,20,35,75,47,122,0.000333,0.208591,14,8760.815393,486.711966,625.772528,145.041921,5,6
0,0,16,16,16,19,35,71,50,121,0.000333,0.206881,16,9930.291921,551.682884,620.643245,144.710623,6,6
0,0,15,15,16,23,39,73,54,127,0.000333,0.223749,16,10739.93731,596.663184,671.246082,168.041925,5,6
0,0,14,14,15,23,38,60,46,106,0.000333,0.185427,14,7787.92443,432.662468,556.280316,162.645284,4,6
0,0,13,13,13,18,31,53,40,93,0.000333,0.15358,12,5528.883082,307.160171,460.740257,123.164366,4,6
0,0,11,11,13,17,30,47,34,81,0.000333,0.132486,12,4769.497659,264.972092,397.458138,117.592585,4,6
0,0,22,22,17,22,39,87,75,162,0.000333,0.285412,24,20549.64383,1141.646879,856.235159,167.594364,2,6
0,0,20,20,16,20,36,69,65,134,0.000333,0.230923,24,16626.47881,923.693267,692.76995,150.438562,2,6
0,0,19,19,16,19,35,77,63,140,0.000333,0.239367,24,17234.39094,957.466163,718.099622,144.710623,2,6
0,0,8,8,13,18,31,37,29,66,0.000333,0.108992,6,1961.861739,108.992319,326.976956,123.164366,3,6
0,0,12,12,14,20,34,50,40,90,0.000333,0.152624,14,6410.20318,356.122399,457.871656,139.741531,3,6
0,0,18,18,18,20,38,78,57,135,0.000333,0.236157,18,12752.46386,708.470214,708.470214,161.497212,2,6
0,0,16,16,16,18,34,68,48,116,0.000333,0.196715,16,9442.331033,524.573946,590.14569,139.05865,2,6
0,0,15,15,15,20,35,75,47,122,0.000333,0.208591,14,8760.815393,486.711966,625.772528,145.041921,5,6
0,0,19,19,17,19,36,68,62,130,0.000333,0.22403,24,16130.16601,896.120334,672.09025,150.197491,3,6
0,0,19,19,18,19,37,69,62,131,0.000333,0.227479,27,18425.83655,1023.657586,682.438391,155.769273,3,6
0,0,15,15,14,19,33,72,45,117,0.000333,0.196731,14,8262.717568,459.039865,590.194112,134.013592,6,6
0,0,13,13,12,13,25,56,38,94,0.000333,0.145507,12,5238.269782,291.014988,436.522482,91.125266,2,6
0,0,16,16,15,15,30,69,46,115,0.000333,0.188097,21,11850.14079,658.341155,564.292418,117.206718,3,6
0,0,5,5,9,13,22,19,19,38,0.000333,0.056486,4,677.833606,37.657423,169.458402,76.635041,1,6
0,0,25,25,19,44,63,112,81,193,0.000333,0.384538,9,10382.53523,576.807513,1153.615025,320.925614,8,6
0,0,24,24,19,44,63,111,79,190,0.000333,0.378561,9,10221.14867,567.841593,1135.683185,320.925614,8,6
0,0,9,9,11,11,22,37,26,63,0.000333,0.093648,10,2809.44192,156.080107,280.944192,76.107496,2,6
0,0,16,16,13,16,29,55,49,104,0.000333,0.16841,18,9094.140423,505.230023,505.230023,112.105716,2,6
0,0,18,18,16,18,34,63,54,117,0.000333,0.198411,24,14285.59566,793.644203,595.233152,139.05865,3,6
0,0,14,14,12,15,27,51,46,97,0.000333,0.153741,18,8302.033579,461.224088,461.224088,101.622909,2,6
0,0,16,16,15,17,32,59,51,110,0.000333,0.183333,21,11550,641.666667,550,128.090227,3,6
0,0,15,15,15,20,35,75,47,122,0.000333,0.208591,14,8760.815393,486.711966,625.772528,145.041921,5,6
0,0,8,8,11,13,24,33,27,60,0.000333,0.091699,10,2750.9775,152.832083,275.09775,86.159464,1,6
0,0,12,12,14,20,34,55,42,97,0.000333,0.164495,14,6908.774538,383.820808,493.483896,139.741531,6,6
0,0,12,12,14,20,34,55,42,97,0.000333,0.164495,14,6908.774538,383.820808,493.483896,139.741531,6,6
0,0,23,23,16,22,38,105,75,180,0.000333,0.314876,24,22671.04686,1259.502603,944.626952,162.107496,2,6
0,0,10,10,11,13,24,33,29,62,0.000333,0.094756,10,2842.67675,157.926486,284.267675,86.159464,1,6
0,0,13,13,15,16,31,46,37,83,0.000333,0.137066,14,5756.776113,319.820895,411.198294,122.603359,2,6
0,0,16,16,17,22,39,65,52,117,0.000333,0.206131,16,9894.272954,549.681831,618.39206,167.594364,2,6
0,0,20,20,17,23,40,92,58,150,0.000333,0.266096,16,12772.62743,709.590413,798.289214,173.528793,6,6
0,0,20,20,16,23,39,91,58,149,0.000333,0.262508,16,12600.39889,700.022161,787.524931,168.041925,6,6
0,0,17,17,15,22,37,81,50,131,0.000333,0.227479,14,9554.137473,530.785415,682.438391,156.710855,6,6
0,0,17,17,15,22,37,81,50,131,0.000333,0.227479,14,9554.137473,530.785415,682.438391,156.710855,6,6
0,0,16,16,14,17,31,54,49,103,0.000333,0.170094,14,7143.95108,396.886171,510.28222,122.789837,3,6
0,0,11,11,15,14,29,36,29,65,0.000333,0.105256,14,4420.762706,245.597928,315.768765,111.906328,2,6
0,0,18,18,17,20,37,72,56,128,0.000333,0.22227,16,10668.96049,592.720027,666.810031,155.92543,2,6
0,0,11,11,12,18,30,39,34,73,0.000333,0.119401,6,2149.218081,119.401004,358.203013,118.0782,2,6
0,0,11,11,12,18,30,39,34,73,0.000333,0.119401,6,2149.218081,119.401004,358.203013,118.0782,2,6
0,0,9,9,12,17,29,33,28,61,0.000333,0.098779,6,1778.021044,98.778947,296.336841,112.506418,2,6
0,0,11,11,13,20,33,40,35,75,0.000333,0.12611,6,2269.977354,126.109853,378.329559,134.544278,2,6
0,0,14,14,15,22,37,68,48,116,0.000333,0.201432,14,8460.152266,470.008459,604.29659,156.710855,6,6
0,0,18,18,18,17,35,69,47,116,0.000333,0.198332,18,10709.94294,594.99683,594.99683,144.545518,4,6
0,0,8,8,10,15,25,30,25,55,0.000333,0.085137,5,1277.060452,70.947803,255.41209,91.82264,2,6
0,0,9,9,10,16,26,31,27,58,0.000333,0.090875,5,1363.127518,75.729307,272.625504,97.219281,2,6
0,0,9,9,11,12,23,37,26,63,0.000333,0.094995,10,2849.844032,158.324668,284.984403,81.073298,2,6
0,0,9,9,11,13,24,37,27,64,0.000333,0.097813,10,2934.376,163.020889,293.4376,86.159464,2,6
0,0,9,9,11,13,24,37,27,64,0.000333,0.097813,10,2934.376,163.020889,293.4376,86.159464,2,6
0,0,11,11,13,13,26,42,29,71,0.000333,0.111244,12,4004.77464,222.48748,333.73122,96.211433,2,6
0,0,9,9,11,12,23,37,26,63,0.000333,0.094995,10,2849.844032,158.324668,284.984403,81.073298,2,6
0,0,15,15,16,16,32,54,37,91,0.000333,0.151667,16,7280,404.444444,455,128,3,6
0,0,12,12,16,17,33,49,35,84,0.000333,0.141243,16,6779.665696,376.648094,423.729106,133.486868,3,6
0,0,11,11,14,22,36,50,38,88,0.000333,0.151651,7,3184.673801,176.926322,454.9534,151.410465,4,6
0,0,13,13,15,14,29,49,36,85,0.000333,0.137643,14,5780.997384,321.166521,412.928385,111.906328,1,6
0,0,15,15,16,17,33,58,45,103,0.000333,0.173191,16,8313.161509,461.842306,519.572594,133.486868,2,6
0,0,14,14,16,23,39,61,46,107,0.000333,0.188513,16,9048.608599,502.700478,565.538037,168.041925,4,6
0,0,11,11,12,16,28,46,40,86,0.000333,0.137811,12,4961.19028,275.621682,413.432523,107.01955,1,6
0,0,13,13,16,19,35,54,45,99,0.000333,0.169266,16,8124.784299,451.376905,507.799019,144.710623,2,6
0,0,12,12,13,17,30,45,39,84,0.000333,0.137393,12,4946.14572,274.785873,412.17881,117.592585,1,6
0,0,14,14,15,25,40,64,49,113,0.000333,0.200459,7,4209.645123,233.869174,601.377875,174.699764,4,6
0,0,13,13,14,25,39,60,47,107,0.000333,0.188513,7,3958.766262,219.931459,565.538037,169.399374,4,6
0,0,12,12,16,18,34,49,38,87,0.000333,0.147536,16,7081.748275,393.43046,442.609267,139.05865,2,6
0,0,14,14,11,15,26,59,51,110,0.000333,0.172349,15,7755.725535,430.873641,517.048369,96.657107,1,6
0,0,16,16,15,18,33,67,56,123,0.000333,0.20682,21,13029.67001,723.870556,620.460477,133.662009,2,6
0,0,15,15,12,18,30,75,53,128,0.000333,0.209361,12,7536.983955,418.721331,628.081996,118.0782,1,6
0,0,14,14,18,17,35,54,41,95,0.000333,0.162427,18,8771.073959,487.281887,487.281887,144.545518,3,6
0,0,16,16,18,18,36,63,48,111,0.000333,0.191287,18,10329.51015,573.861675,573.861675,150.1173,4,6
0,0,17,17,19,21,40,62,50,112,0.000333,0.198685,18,10729.00704,596.055947,596.055947,172.949289,3,6
0,0,13,13,13,16,29,54,42,96,0.000333,0.155455,12,5596.394106,310.910784,466.366176,112.105716,2,6
0,0,16,16,17,19,36,67,50,117,0.000333,0.201627,16,9678.099603,537.6722,604.881225,150.197491,3,6
0,0,21,21,16,23,39,88,75,163,0.000333,0.287174,24,20676.49348,1148.694082,861.520562,168.041925,2,6
0,0,9,9,12,16,28,33,27,60,0.000333,0.096147,6,1730.647772,96.147098,288.441295,107.01955,2,6
0,0,11,11,12,18,30,42,33,75,0.000333,0.122672,6,2208.100768,122.672265,368.016795,118.0782,3,6
0,0,9,9,12,16,28,33,27,60,0.000333,0.096147,6,1730.647772,96.147098,288.441295,107.01955,2,6
0,0,12,12,13,18,31,45,34,79,0.000333,0.130461,6,2348.289051,130.460503,391.381509,123.164366,4,6
0,0,12,12,12,20,32,45,35,80,0.000333,0.133333,6,2400,133.333333,400,129.458112,4,6
0,0,16,16,16,25,41,75,55,130,0.000333,0.232161,16,11143.70817,619.094898,696.481761,180.096405,6,6
0,0,14,14,13,19,32,54,41,95,0.000333,0.158333,12,5700,316.666667,475,128.816339,3,6
0,0,10,10,12,17,29,36,29,65,0.000333,0.105256,6,1894.612588,105.256255,315.768765,112.506418,2,6
0,0,11,11,12,17,29,39,33,72,0.000333,0.116592,6,2098.64779,116.591544,349.774632,112.506418,2,6
0,0,13,13,12,19,31,48,39,87,0.000333,0.143672,12,5172.180948,287.343386,431.015079,123.730173,3,6
0,0,12,12,14,14,28,50,36,86,0.000333,0.137811,14,5788.055326,321.558629,413.432523,106.605938,3,6
0,0,15,15,17,17,34,64,45,109,0.000333,0.184844,16,8872.535195,492.918622,554.53345,138.973737,2,6
0,0,11,11,17,15,32,52,34,86,0.000333,0.143333,16,6880,382.222222,430,128.090227,2,6
0,0,18,18,17,17,34,72,49,121,0.000333,0.205194,16,9849.328061,547.184892,615.583004,138.973737,2,6
0,0,11,11,15,14,29,51,33,84,0.000333,0.136023,14,5712.98565,317.388092,408.070404,111.906328,2,6
0,0,13,13,15,13,28,51,35,86,0.000333,0.137811,14,5788.055326,321.558629,413.432523,106.709075,2,6
0,0,9,9,15,14,29,32,24,56,0.000333,0.090682,7,1904.32855,105.796031,272.046936,111.906328,2,6
0,0,15,15,15,15,30,49,40,89,0.000333,0.145571,14,6113.985682,339.665871,436.713263,117.206718,2,6
0,0,13,13,10,14,24,53,40,93,0.000333,0.142134,10,4264.015126,236.889729,426.401513,86.52225,1,6
0,0,16,16,14,16,30,66,48,114,0.000333,0.186462,21,11747.09609,652.616449,559.385528,117.302969,2,6
0,0,10,10,13,14,27,42,30,72,0.000333,0.114117,12,4108.222802,228.2346,342.3519,101.408685,2,6
0,0,18,18,15,17,32,81,56,137,0.000333,0.228333,21,14385,799.166667,685,128.090227,2,6
0,0,12,12,14,24,38,50,43,93,0.000333,0.162686,7,3416.400811,189.800045,488.057259,163.342069,2,6
0,0,16,16,15,19,34,59,49,108,0.000333,0.183149,14,7692.243816,427.346879,549.445987,139.313982,2,6
0,0,9,9,11,11,22,33,26,59,0.000333,0.087702,10,2631.064655,146.170259,263.106465,76.107496,1,6
0,0,29,29,20,49,69,149,95,244,0.000333,0.496827,10,14904.79968,828.044426,1490.479967,361.559344,10,6
0,0,17,17,16,24,40,84,53,137,0.000333,0.243035,16,11665.66638,648.092577,729.104149,174.0391,6,6
0,0,30,30,20,51,71,152,97,249,0.000333,0.510429,10,15312.87033,850.715018,1531.287033,375.732254,11,6
0,0,17,17,16,24,40,84,53,137,0.000333,0.243035,16,11665.66638,648.092577,729.104149,174.0391,6,6
0,0,11,11,16,18,34,47,37,84,0.000333,0.142449,16,6837.550059,379.863892,427.346879,139.05865,2,6
0,0,18,18,16,22,38,82,60,142,0.000333,0.248402,16,11923.29131,662.405073,745.205707,162.107496,2,6
0,0,12,12,13,25,38,52,42,94,0.000333,0.164435,6,2959.831118,164.435062,493.305186,164.202121,4,6
0,0,9,9,12,18,30,32,29,61,0.000333,0.099773,6,1795.921958,99.773442,299.320326,118.0782,2,6
0,0,13,13,11,16,27,48,39,87,0.000333,0.137892,10,4136.752127,229.819563,413.675213,102.053748,2,6
0,0,16,16,15,19,34,61,47,108,0.000333,0.183149,14,7692.243816,427.346879,549.445987,139.313982,3,6
0,0,17,17,16,19,35,59,45,104,0.000333,0.177815,16,8535.12694,474.173719,533.445434,144.710623,2,6
0,0,10,10,14,13,27,38,27,65,0.000333,0.103023,14,4326.947627,240.385979,309.067688,101.408685,2,6
0,0,16,16,15,16,31,57,42,99,0.000333,0.163488,14,6866.516086,381.473116,490.465435,122.603359,2,6
0,0,18,18,17,17,34,65,45,110,0.000333,0.18654,16,8953.934601,497.440811,559.620913,138.973737,3,6
0,0,10,10,14,13,27,38,27,65,0.000333,0.103023,14,4326.947627,240.385979,309.067688,101.408685,2,6
0,0,20,20,16,23,39,91,58,149,0.000333,0.262508,16,12600.39889,700.022161,787.524931,168.041925,6,6
0,0,10,10,15,13,28,42,29,71,0.000333,0.113774,14,4778.510793,265.472822,341.322199,106.709075,2,6
0,0,16,16,17,19,36,59,48,107,0.000333,0.184394,16,8850.911602,491.717311,553.181975,150.197491,2,6
0,0,15,15,15,19,34,61,49,110,0.000333,0.18654,14,7834.692776,435.26071,559.620913,139.313982,2,6
0,0,9,9,15,19,34,40,32,72,0.000333,0.122099,7,2564.081272,142.44896,366.297325,139.313982,2,6
0,0,16,16,14,19,33,74,55,129,0.000333,0.216909,14,9110.17578,506.120877,650.726841,134.013592,1,6
0,0,31,31,19,48,67,156,99,255,0.000333,0.515618,18,27843.34938,1546.852744,1546.852744,348.788823,12,6
0,0,12,12,15,14,29,48,34,82,0.000333,0.132785,14,5576.962182,309.831232,398.354442,111.906328,1,6
0,0,12,12,14,14,28,45,34,79,0.000333,0.126594,14,5316.934544,295.385252,379.781039,106.605938,1,6
0,0,9,9,12,15,27,34,30,64,0.000333,0.101438,12,3651.753602,202.8752,304.3128,101.622909,1,6
0,0,8,8,14,12,26,34,24,58,0.000333,0.090875,14,3816.757051,212.042058,272.625504,96.322519,1,6
0,0,16,16,14,19,33,58,53,111,0.000333,0.186643,14,7838.988461,435.499359,559.927747,134.013592,3,6
0,0,18,18,17,21,38,66,58,124,0.000333,0.216914,16,10411.88819,578.438233,650.743012,161.725534,4,6
0,0,18,18,16,19,35,63,55,118,0.000333,0.201752,16,9684.086336,538.004796,605.255396,144.710623,3,6
0,0,20,20,19,21,40,71,60,131,0.000333,0.232391,18,12549.10645,697.17258,697.17258,172.949289,4,6
0,0,16,16,14,19,33,58,53,111,0.000333,0.186643,14,7838.988461,435.499359,559.927747,134.013592,3,6
0,0,18,18,17,21,38,66,58,124,0.000333,0.216914,16,10411.88819,578.438233,650.743012,161.725534,4,6
0,0,16,16,12,15,27,58,53,111,0.000333,0.175931,18,9500.265229,527.792513,527.792513,101.622909,1,6
0,0,18,18,16,17,33,66,58,124,0.000333,0.208502,24,15012.1169,834.006494,625.504871,133.486868,2,6
0,0,15,15,11,15,26,54,51,105,0.000333,0.164515,15,7403.192556,411.288475,493.54617,96.657107,1,6
0,0,17,17,15,17,32,62,56,118,0.000333,0.196667,21,12390,688.333333,590,128.090227,2,6
0,0,12,12,11,13,24,53,37,90,0.000333,0.137549,10,4126.466251,229.248125,412.646625,86.159464,1,6
0,0,15,15,15,15,30,66,45,111,0.000333,0.181555,21,11437.96198,635.442332,544.664856,117.206718,2,6
0,0,10,10,14,14,28,46,31,77,0.000333,0.123389,14,5182.328606,287.907145,370.166329,106.605938,2,6
0,0,10,10,15,14,29,41,33,74,0.000333,0.11983,14,5032.868311,279.603795,359.490594,111.906328,2,6
0,0,12,12,14,20,34,50,40,90,0.000333,0.152624,14,6410.20318,356.122399,457.871656,139.741531,3,6
0,0,15,15,16,16,32,49,41,90,0.000333,0.15,16,7200,400,450,128,3,6
0,0,15,15,15,18,33,49,42,91,0.000333,0.153013,14,6426.558108,357.031006,459.039865,133.662009,3,6
0,0,19,19,16,20,36,66,51,117,0.000333,0.201627,16,9678.099603,537.6722,604.881225,150.438562,3,6
0,0,17,17,16,18,34,53,44,97,0.000333,0.164495,16,7895.74233,438.652352,493.483896,139.05865,3,6
0,0,15,15,15,17,32,49,41,90,0.000333,0.15,14,6300,350,450,128.090227,3,6
0,0,19,19,14,18,32,63,60,123,0.000333,0.205,21,12915,717.5,615,128.361619,2,6
0,0,35,35,19,46,65,154,115,269,0.000333,0.540006,18,29160.30495,1620.016942,1620.016942,334.794473,8,6
0,0,38,38,21,49,70,167,123,290,0.000333,0.592497,20,35549.8415,1974.991194,1777.492075,367.359448,9,6
0,0,12,12,16,17,33,49,35,84,0.000333,0.141243,16,6779.665696,376.648094,423.729106,133.486868,3,6
0,0,11,11,15,14,29,43,35,78,0.000333,0.126308,14,5304.915247,294.717514,378.922518,111.906328,3,6
0,0,11,11,15,16,31,41,34,75,0.000333,0.123855,14,5201.906126,288.994785,371.564723,122.603359,2,6
0,0,15,15,15,18,33,49,42,91,0.000333,0.153013,14,6426.558108,357.031006,459.039865,133.662009,3,6
0,0,17,17,17,20,37,68,52,120,0.000333,0.208378,16,10002.15046,555.675026,625.134404,155.92543,2,6
0,0,11,11,15,17,32,51,38,89,0.000333,0.148333,14,6230,346.111111,445,128.090227,2,6
0,0,20,20,16,19,35,81,56,137,0.000333,0.234237,16,11243.38837,624.632687,702.711773,144.710623,2,6
0,0,11,11,15,14,29,52,33,85,0.000333,0.137643,14,5780.997384,321.166521,412.928385,111.906328,2,6
0,0,10,10,11,12,23,41,31,72,0.000333,0.108565,10,3256.964608,180.942478,325.696461,81.073298,1,6
0,0,10,10,10,12,22,40,31,71,0.000333,0.10554,10,3166.196449,175.899803,316.619645,76.238831,1,6
0,0,12,12,14,22,36,58,43,101,0.000333,0.174054,7,3655.136976,203.063165,522.162425,151.410465,5,6
0,0,15,15,16,23,39,73,54,127,0.000333,0.223749,16,10739.93731,596.663184,671.246082,168.041925,5,6
0,0,10,10,14,24,38,50,39,89,0.000333,0.155689,7,3269.458841,181.636602,467.065549,163.342069,4,6
0,0,19,19,17,30,47,95,64,159,0.000333,0.294393,16,14130.87404,785.048558,883.179627,216.693586,6,6
0,0,20,20,18,28,46,99,65,164,0.000333,0.301955,18,16305.55489,905.864161,905.864161,209.664588,6,6
0,0,12,12,13,25,38,52,41,93,0.000333,0.162686,6,2928.343553,162.685753,488.057259,164.202121,4,6
0,0,9,9,13,22,35,40,34,74,0.000333,0.126522,6,2277.40166,126.522314,379.566943,146.213212,2,6
0,0,15,15,15,19,34,61,49,110,0.000333,0.18654,14,7834.692776,435.26071,559.620913,139.313982,2,6
0,0,14,14,16,16,32,52,44,96,0.000333,0.16,16,7680,426.666667,480,128,2,6
0,0,10,10,11,12,23,44,32,76,0.000333,0.114597,10,3437.907087,190.994838,343.790709,81.073298,1,6
0,0,4,4,10,9,19,23,16,39,0.000333,0.055223,5,828.345865,46.019215,165.669173,61.748606,1,6
0,0,31,31,19,50,69,156,100,256,0.000333,0.521261,18,28148.0807,1563.782261,1563.782261,362.903432,12,6
0,0,12,12,13,14,27,41,31,72,0.000333,0.114117,12,4108.222802,228.2346,342.3519,101.408685,2,6
0,0,10,10,13,14,27,37,27,64,0.000333,0.101438,6,1825.876801,101.4376,304.3128,101.408685,2,6
0,0,17,17,15,21,36,72,57,129,0.000333,0.222307,14,9336.884553,518.715808,666.920325,150.842025,6,6
0,0,11,11,15,16,31,42,35,77,0.000333,0.127158,14,5340.623623,296.701312,381.473116,122.603359,2,6
0,0,9,9,12,12,24,41,27,68,0.000333,0.103926,12,3741.329401,207.851633,311.77745,86.0391,2,6
0,0,9,9,12,13,25,41,28,69,0.000333,0.106809,12,3845.112925,213.617385,320.426077,91.125266,2,6
0,0,11,11,15,15,30,42,34,76,0.000333,0.124308,14,5220.931594,290.051755,372.923685,117.206718,2,6
0,0,17,17,16,20,36,70,61,131,0.000333,0.225753,24,16254.24421,903.013567,677.260175,150.438562,1,6
0,0,7,7,14,22,36,44,32,76,0.000333,0.130971,7,2750.400101,152.800006,392.9143,151.410465,2,6
0,0,10,10,18,29,47,67,49,116,0.000333,0.214777,9,5798.990761,322.166153,644.332307,215.940099,3,6
0,0,9,9,18,27,45,64,46,110,0.000333,0.201368,9,5436.934565,302.05192,604.103841,203.440613,3,6
0,0,7,7,14,22,36,44,32,76,0.000333,0.130971,7,2750.400101,152.800006,392.9143,151.410465,2,6
0,0,10,10,18,29,47,67,49,116,0.000333,0.214777,9,5798.990761,322.166153,644.332307,215.940099,3,6
0,0,9,9,18,27,45,64,46,110,0.000333,0.201368,9,5436.934565,302.05192,604.103841,203.440613,3,6
0,0,11,11,14,18,32,48,37,85,0.000333,0.141667,14,5950,330.555556,425,128.361619,3,6
0,0,16,16,15,18,33,71,48,119,0.000333,0.200094,14,8403.960603,466.8867,600.2829,133.662009,2,6
0,0,12,12,14,17,31,52,40,92,0.000333,0.151929,14,6381.004848,354.500269,455.786061,122.789837,3,6
0,0,12,12,14,17,31,58,42,100,0.000333,0.16514,14,6935.874835,385.32638,495.419631,122.789837,5,6
0,0,18,18,17,25,42,82,60,142,0.000333,0.255236,16,12251.34519,680.630288,765.709074,185.583273,6,6
0,0,10,10,11,13,24,30,28,58,0.000333,0.088643,10,2659.27825,147.737681,265.927825,86.159464,2,6
0,0,7,7,12,21,33,38,30,68,0.000333,0.11434,6,2058.112801,114.3396,343.0188,135.258216,2,6
0,0,10,10,17,29,46,61,47,108,0.000333,0.198848,8,4772.35753,265.130974,596.544691,210.368317,3,6
0,0,14,14,11,15,26,48,38,86,0.000333,0.134746,10,4042.378158,224.576564,404.237816,96.657107,2,6
0,0,17,17,15,18,33,61,46,107,0.000333,0.179917,14,7556.502391,419.805688,539.750171,133.662009,3,6
0,0,12,12,15,17,32,59,41,100,0.000333,0.166667,14,7000,388.888889,500,128.090227,5,6
0,0,13,13,16,18,34,65,43,108,0.000333,0.183149,16,8791.13579,488.396433,549.445987,139.05865,5,6
0,0,10,10,13,14,27,37,30,67,0.000333,0.106192,12,3822.929552,212.384975,318.577463,101.408685,4,6
0,0,14,14,11,16,27,49,46,95,0.000333,0.150571,10,4517.143127,250.952396,451.714313,102.053748,2,6
0,0,16,16,14,18,32,57,51,108,0.000333,0.18,14,7560,420,540,128.361619,3,6
0,0,15,15,15,20,35,75,47,122,0.000333,0.208591,14,8760.815393,486.711966,625.772528,145.041921,5,6
0,0,23,23,17,21,38,99,73,172,0.000333,0.300881,24,21663.44478,1203.52471,902.643532,161.725534,2,6
0,0,5,5,9,9,18,21,15,36,0.000333,0.050039,4,600.4692,33.3594,150.1173,57.05865,1,6
0,0,16,16,11,16,27,65,49,114,0.000333,0.180686,15,8130.857629,451.714313,542.057175,102.053748,1,6
0,0,19,19,15,18,33,78,57,135,0.000333,0.226998,21,14300.85733,794.492074,680.993206,133.662009,2,6
0,0,10,10,13,15,28,46,32,78,0.000333,0.124991,12,4499.684207,249.982456,374.973684,106.709075,2,6
0,0,18,18,11,18,29,66,55,121,0.000333,0.195939,15,8817.235506,489.846417,587.8157,113.112398,1,6
0,0,21,21,15,20,35,79,63,142,0.000333,0.242786,21,15295.52196,849.75122,728.358188,145.041921,2,6
0,0,10,10,13,16,29,44,32,76,0.000333,0.123069,12,4430.478668,246.137704,369.206556,112.105716,2,6
0,0,14,14,14,18,32,65,44,109,0.000333,0.181667,14,7630,423.888889,545,128.361619,6,6
0,0,17,17,14,16,30,70,52,122,0.000333,0.199547,21,12571.45371,698.414095,598.640653,117.302969,2,6
0,0,20,20,18,18,36,83,60,143,0.000333,0.246433,27,19961.08043,1108.948913,739.299275,150.1173,3,6
0,0,10,10,13,13,26,41,29,70,0.000333,0.109677,12,3948.369363,219.353854,329.03078,96.211433,2,6
0,0,11,11,12,20,32,42,30,72,0.000333,0.12,6,2160,120,360,129.458112,4,6
0,0,12,12,12,20,32,43,32,75,0.000333,0.125,6,2250,125,375,129.458112,4,6
0,0,11,11,13,19,32,42,30,72,0.000333,0.12,6,2160,120,360,128.816339,3,6
0,0,12,12,13,19,32,43,32,75,0.000333,0.125,6,2250,125,375,128.816339,3,6
0,0,15,15,16,23,39,73,54,127,0.000333,0.223749,16,10739.93731,596.663184,671.246082,168.041925,5,6
0,0,11,11,13,17,30,40,33,73,0.000333,0.119401,6,2149.218081,119.401004,358.203013,117.592585,2,6
0,0,18,18,15,18,33,68,55,123,0.000333,0.20682,21,13029.67001,723.870556,620.460477,133.662009,3,6
0,0,12,12,14,15,29,55,42,97,0.000333,0.157075,14,6597.138191,366.507677,471.224157,111.906328,3,6
0,0,18,18,16,18,34,69,58,127,0.000333,0.215369,24,15506.58674,861.477041,646.107781,139.05865,3,6
0,0,18,18,17,19,36,68,49,117,0.000333,0.201627,16,9678.099603,537.6722,604.881225,150.197491,2,6
0,0,11,11,15,13,28,47,31,78,0.000333,0.124991,14,5249.631575,291.646199,374.973684,106.709075,2,6
0,0,19,19,17,18,35,73,57,130,0.000333,0.222269,24,16003.36301,889.075723,666.806792,144.545518,3,6
0,0,12,12,13,15,28,52,40,92,0.000333,0.147426,12,5307.319834,294.851102,442.276653,106.709075,3,6
0,0,15,15,14,16,30,57,46,103,0.000333,0.16847,14,7075.736239,393.096458,505.409731,117.302969,3,6
0,0,12,12,13,15,28,52,40,92,0.000333,0.147426,12,5307.319834,294.851102,442.276653,106.709075,3,6
0,0,10,10,14,16,30,44,40,84,0.000333,0.137393,14,5770.50334,320.583519,412.17881,117.302969,1,6
0,0,16,16,15,18,33,68,48,116,0.000333,0.19505,14,8192.09605,455.116447,585.149718,133.662009,2,6
0,0,10,10,13,13,26,41,30,71,0.000333,0.111244,12,4004.77464,222.48748,333.73122,96.211433,2,6
0,0,16,16,18,17,35,56,47,103,0.000333,0.176105,18,9509.690713,528.316151,528.316151,144.545518,3,6
0,0,15,15,14,15,29,61,41,102,0.000333,0.165171,14,6937.196861,385.399826,495.514062,111.906328,2,6
0,0,18,18,17,17,34,74,49,123,0.000333,0.208586,16,10012.12687,556.229271,625.757929,138.973737,3,6
0,0,10,10,14,14,28,46,31,77,0.000333,0.123389,14,5182.328606,287.907145,370.166329,106.605938,2,6
0,0,12,12,14,24,38,50,43,93,0.000333,0.162686,7,3416.400811,189.800045,488.057259,163.342069,2,6
0,0,9,9,12,15,27,34,30,64,0.000333,0.101438,12,3651.753602,202.8752,304.3128,101.622909,1,6
0,0,25,25,20,43,63,112,80,192,0.000333,0.382546,10,11476.37745,637.576525,1147.637745,319.767946,8,6
0,0,24,24,20,43,63,111,78,189,0.000333,0.376569,10,11297.05906,627.614392,1129.705906,319.767946,8,6
0,0,26,26,20,44,64,115,82,197,0.000333,0.394,10,11820,656.666667,1182,326.653553,8,6
0,0,25,25,20,44,64,114,80,194,0.000333,0.388,10,11640,646.666667,1164,326.653553,8,6
0,0,27,27,20,44,64,116,86,202,0.000333,0.404,10,12120,673.333333,1212,326.653553,8,6
0,0,26,26,20,44,64,115,84,199,0.000333,0.398,10,11940,663.333333,1194,326.653553,8,6
0,0,11,11,15,16,31,42,35,77,0.000333,0.127158,14,5340.623623,296.701312,381.473116,122.603359,2,6
0,0,14,14,16,18,34,56,43,99,0.000333,0.167886,16,8058.541141,447.69673,503.658821,139.05865,2,6
0,0,11,11,15,16,31,47,36,83,0.000333,0.137066,14,5756.776113,319.820895,411.198294,122.603359,2,6
0,0,14,14,18,16,34,57,40,97,0.000333,0.164495,18,8882.710121,493.483896,493.483896,139.05865,3,6
0,0,11,11,15,13,28,45,30,75,0.000333,0.120184,14,5047.722668,280.429037,360.551619,106.709075,2,6
0,0,17,17,16,22,38,64,52,116,0.000333,0.20292,16,9740.153465,541.119637,608.759592,162.107496,2,6
0,0,11,11,15,16,31,47,36,83,0.000333,0.137066,14,5756.776113,319.820895,411.198294,122.603359,2,6
0,0,16,16,16,19,35,62,49,111,0.000333,0.189783,16,9109.606638,506.089258,569.350415,144.710623,2,6
0,0,19,19,16,22,38,86,55,141,0.000333,0.246653,16,11839.32447,657.740248,739.957779,162.107496,6,6
0,0,12,12,15,21,36,47,40,87,0.000333,0.149928,7,3148.484326,174.915796,449.783475,150.842025,2,6
0,0,18,18,17,17,34,64,44,108,0.000333,0.183149,16,8791.13579,488.396433,549.445987,138.973737,3,6
0,0,10,10,14,13,27,37,26,63,0.000333,0.099853,14,4193.810777,232.989488,299.557913,101.408685,2,6
0,0,16,16,16,16,32,59,41,100,0.000333,0.166667,16,8000,444.444444,500,128,2,6
0,0,10,10,14,13,27,37,26,63,0.000333,0.099853,14,4193.810777,232.989488,299.557913,101.408685,2,6
0,0,9,9,12,14,26,33,31,64,0.000333,0.100276,12,3609.937704,200.552095,300.828142,96.322519,1,6
0,0,14,14,14,18,32,65,44,109,0.000333,0.181667,14,7630,423.888889,545,128.361619,6,6
0,0,17,17,19,19,38,66,50,116,0.000333,0.20292,18,10957.67265,608.759592,608.759592,161.421246,3,6
0,0,17,17,16,18,34,58,49,107,0.000333,0.181453,16,8709.736384,483.874244,544.358524,139.05865,2,6
0,0,11,11,15,15,30,38,33,71,0.000333,0.11613,14,4877.449252,270.969403,348.389232,117.206718,2,6
0,0,18,18,15,18,33,58,52,110,0.000333,0.184961,14,7768.366944,431.575941,554.883353,133.662009,2,6
0,0,15,15,18,21,39,62,48,110,0.000333,0.193798,18,10465.09639,581.394244,581.394244,167.297316,3,6
0,0,13,13,16,16,32,52,39,91,0.000333,0.151667,16,7280,404.444444,455,128,2,6
0,0,13,13,19,18,37,55,40,95,0.000333,0.164966,18,8908.165255,494.89807,494.89807,155.769273,3,6
0,0,16,16,16,17,33,59,51,110,0.000333,0.184961,24,13317.20048,739.844471,554.883353,133.486868,3,6
0,0,17,17,16,21,37,82,53,135,0.000333,0.234425,16,11252.41927,625.134404,703.276204,156.238666,5,6
0,0,16,16,18,18,36,54,46,100,0.000333,0.172331,18,9305.865003,516.9925,516.9925,150.1173,3,6
0,0,17,17,16,18,34,52,43,95,0.000333,0.161103,16,7732.943519,429.607973,483.30897,139.05865,3,6
0,0,14,14,16,18,34,58,50,108,0.000333,0.183149,16,8791.13579,488.396433,549.445987,139.05865,2,6
0,0,20,20,19,18,37,73,50,123,0.000333,0.213588,18,11533.72975,640.762764,640.762764,155.769273,4,6
0,0,19,19,15,23,38,87,56,143,0.000333,0.250151,14,10506.35088,583.68616,750.453634,162.645284,6,6
0,0,18,18,15,23,38,84,52,136,0.000333,0.237906,14,9992.053986,555.11411,713.718142,162.645284,6,6
0,0,19,19,16,25,41,88,57,145,0.000333,0.258948,16,12429.52065,690.528925,776.845041,180.096405,6,6
0,0,19,19,15,23,38,87,56,143,0.000333,0.250151,14,10506.35088,583.68616,750.453634,162.645284,6,6
0,0,20,20,17,23,40,92,58,150,0.000333,0.266096,16,12772.62743,709.590413,798.289214,173.528793,6,6
0,0,10,10,15,20,35,50,38,88,0.000333,0.150459,7,3159.638338,175.535463,451.376905,145.041921,5,6
0,0,12,12,17,17,34,48,40,88,0.000333,0.149232,16,7163.14768,397.952649,447.69673,138.973737,2,6
0,0,11,11,15,15,30,42,34,76,0.000333,0.124308,14,5220.931594,290.051755,372.923685,117.206718,2,6
0,0,13,13,15,18,33,47,43,90,0.000333,0.151332,14,6355.93659,353.107588,453.995471,133.662009,1,6
0,0,16,16,13,17,30,54,49,103,0.000333,0.16847,12,6064.916776,336.939821,505.409731,117.592585,2,6
0,0,18,18,16,19,35,62,54,116,0.000333,0.198332,16,9519.949279,528.886071,594.99683,144.710623,3,6
0,0,14,14,11,16,27,49,46,95,0.000333,0.150571,10,4517.143127,250.952396,451.714313,102.053748,2,6
0,0,16,16,14,18,32,57,51,108,0.000333,0.18,14,7560,420,540,128.361619,3,6
0,0,13,13,14,16,30,60,43,103,0.000333,0.16847,14,7075.736239,393.096458,505.409731,117.302969,2,6
0,0,7,7,12,12,24,28,24,52,0.000333,0.079473,12,2861.0166,158.945367,238.41805,86.0391,1,6
0,0,10,10,14,24,38,50,39,89,0.000333,0.155689,7,3269.458841,181.636602,467.065549,163.342069,4,6
0,0,10,10,14,24,38,50,39,89,0.000333,0.155689,7,3269.458841,181.636602,467.065549,163.342069,4,6
0,0,14,14,15,23,38,72,51,123,0.000333,0.215165,14,9036.931178,502.051732,645.495084,162.645284,6,6
0,0,7,7,11,16,27,27,25,52,0.000333,0.082418,5,1236.270751,68.681708,247.25415,102.053748,1,6
0,0,8,8,11,11,22,38,26,64,0.000333,0.095135,10,2854.036236,158.557569,285.403624,76.107496,1,6
0,0,11,11,14,15,29,50,31,81,0.000333,0.131165,14,5508.950448,306.052803,393.496461,111.906328,2,6
0,0,23,23,15,19,34,96,66,162,0.000333,0.274723,21,17307.54859,961.530477,824.16898,139.313982,3,6
0,0,10,10,13,13,26,41,30,71,0.000333,0.111244,12,4004.77464,222.48748,333.73122,96.211433,2,6
0,0,16,16,14,15,29,65,48,113,0.000333,0.182984,21,11527.9889,640.443828,548.951852,111.906328,2,6
0,0,10,10,13,13,26,41,30,71,0.000333,0.111244,12,4004.77464,222.48748,333.73122,96.211433,2,6
0,0,6,6,9,10,19,24,18,42,0.000333,0.059471,4,713.651822,39.647323,178.412956,61.748606,1,6
0,0,15,15,14,25,39,64,45,109,0.000333,0.192036,7,4032.761893,224.042327,576.108842,169.399374,6,6
0,0,15,15,14,25,39,64,45,109,0.000333,0.192036,7,4032.761893,224.042327,576.108842,169.399374,6,6
0,0,11,11,14,21,35,50,37,87,0.000333,0.148749,7,3123.733357,173.540742,446.247622,145.541635,4,6
0,0,14,14,14,24,38,61,44,105,0.000333,0.183677,7,3857.226722,214.290373,551.032389,163.342069,5,6
0,0,11,11,14,21,35,50,37,87,0.000333,0.148749,7,3123.733357,173.540742,446.247622,145.541635,4,6
0,0,7,7,12,20,32,39,29,68,0.000333,0.113333,6,2040,113.333333,340,129.458112,2,6
0,0,10,10,17,27,44,62,46,108,0.000333,0.19654,8,4716.948919,262.052718,589.618615,197.868831,3,6
0,0,9,9,17,25,42,59,43,102,0.000333,0.183339,8,4400.131017,244.451723,550.016377,185.583273,3,6
0,0,11,11,10,13,23,37,29,66,0.000333,0.099518,10,2985.550891,165.863938,298.555089,81.324997,2,6
0,0,14,14,14,16,30,50,37,87,0.000333,0.1423,14,5976.592745,332.03293,426.899482,117.302969,3,6
0,0,10,10,13,14,27,39,28,67,0.000333,0.106192,12,3822.929552,212.384975,318.577463,101.408685,2,6
0,0,13,13,11,16,27,48,39,87,0.000333,0.137892,10,4136.752127,229.819563,413.675213,102.053748,2,6
0,0,16,16,15,19,34,61,47,108,0.000333,0.183149,14,7692.243816,427.346879,549.445987,139.313982,3,6
0,0,11,11,17,17,34,48,36,84,0.000333,0.142449,16,6837.550059,379.863892,427.346879,138.973737,3,6
0,0,16,16,16,23,39,75,54,129,0.000333,0.227272,16,10909.07018,606.059454,681.816886,168.041925,6,6
0,0,15,15,19,18,37,56,43,99,0.000333,0.171912,18,9283.245898,515.735883,515.735883,155.769273,4,6
0,0,17,17,16,27,43,88,57,145,0.000333,0.262269,16,12588.93423,699.385235,786.808389,192.381963,6,6
0,0,7,7,11,15,26,27,25,52,0.000333,0.081474,5,1222.114327,67.89524,244.422865,96.657107,1,6
0,0,7,7,11,15,26,27,25,52,0.000333,0.081474,5,1222.114327,67.89524,244.422865,96.657107,1,6
0,0,8,8,11,16,27,32,27,59,0.000333,0.093513,5,1402.691813,77.927323,280.538363,102.053748,1,6
0,0,19,19,13,18,31,70,62,132,0.000333,0.217985,18,11771.17043,653.953913,653.953913,123.164366,2,6
0,0,22,22,15,20,35,82,71,153,0.000333,0.261593,21,16480.38633,915.577019,784.780302,145.041921,3,6
0,0,18,18,19,20,39,75,54,129,0.000333,0.227272,18,12272.70395,681.816886,681.816886,167.149185,3,6
0,0,16,16,17,19,36,59,48,107,0.000333,0.184394,16,8850.911602,491.717311,553.181975,150.197491,2,6
0,0,12,12,14,14,28,45,34,79,0.000333,0.126594,14,5316.934544,295.385252,379.781039,106.605938,1,6
0,0,16,16,16,16,32,63,42,105,0.000333,0.175,16,8400,466.666667,525,128,3,6
0,0,11,11,15,13,28,47,31,78,0.000333,0.124991,14,5249.631575,291.646199,374.973684,106.709075,2,6
0,0,15,15,17,19,36,59,44,103,0.000333,0.177501,16,8520.036402,473.335356,532.502275,150.197491,3,6
0,0,17,17,18,20,38,67,55,122,0.000333,0.213416,18,11524.44882,640.247157,640.247157,161.497212,3,6
0,0,24,24,19,21,40,97,71,168,0.000333,0.298028,27,24140.26584,1341.12588,894.08392,172.949289,3,6
0,0,11,11,16,16,32,50,34,84,0.000333,0.14,16,6720,373.333333,420,128,2,6
0,0,13,13,14,22,36,56,43,99,0.000333,0.170608,7,3582.758026,199.042113,511.822575,151.410465,4,6
0,0,16,16,14,25,39,67,50,117,0.000333,0.206131,14,8657.488834,480.971602,618.39206,169.399374,5,6
0,0,16,16,15,27,42,70,54,124,0.000333,0.222882,14,9361.063046,520.059058,668.64736,186.985321,6,6
0,0,19,19,12,19,31,82,62,144,0.000333,0.237801,18,12841.27684,713.404269,713.404269,123.730173,1,6
0,0,22,22,16,22,38,95,70,165,0.000333,0.288636,24,20781.79295,1154.544053,865.90804,162.107496,2,6
0,0,14,14,15,27,42,67,50,117,0.000333,0.2103,7,4416.307969,245.350443,630.901138,186.985321,6,6
0,0,16,16,16,30,46,74,57,131,0.000333,0.241196,8,5788.69293,321.594052,723.586616,211.206718,6,6
0,0,26,26,18,47,65,116,88,204,0.000333,0.409521,9,11057.06731,614.281517,1228.563034,336.124326,9,6
0,0,25,25,18,47,65,115,86,201,0.000333,0.403499,9,10894.46337,605.247965,1210.49593,336.124326,9,6
0,0,15,15,14,18,32,47,44,91,0.000333,0.151667,14,6370,353.888889,455,128.361619,2,6
0,0,9,9,12,13,25,26,23,49,0.000333,0.07585,6,1365.29372,75.849651,227.548953,91.125266,2,6
0,0,12,12,15,25,40,63,48,111,0.000333,0.196911,7,4135.13813,229.729896,590.734019,174.699764,6,6
0,0,12,12,15,25,40,63,48,111,0.000333,0.196911,7,4135.13813,229.729896,590.734019,174.699764,6,6
0,0,8,8,13,18,31,37,29,66,0.000333,0.108992,6,1961.861739,108.992319,326.976956,123.164366,3,6
0,0,15,15,16,15,31,53,36,89,0.000333,0.146974,16,7054.775546,391.931975,440.923472,122.603359,3,6
0,0,10,10,14,13,27,37,26,63,0.000333,0.099853,14,4193.810777,232.989488,299.557913,101.408685,2,6
0,0,11,11,13,17,30,47,34,81,0.000333,0.132486,12,4769.497659,264.972092,397.458138,117.592585,4,6
0,0,11,11,13,17,30,47,34,81,0.000333,0.132486,12,4769.497659,264.972092,397.458138,117.592585,4,6
0,0,15,15,17,17,34,64,50,114,0.000333,0.193324,16,9279.532222,515.529568,579.970764,138.973737,3,6
0,0,12,12,17,16,33,59,44,103,0.000333,0.173191,16,8313.161509,461.842306,519.572594,133.486868,3,6
0,0,14,14,13,18,31,68,49,117,0.000333,0.193214,12,6955.69162,386.427312,579.640968,123.164366,1,6
0,0,12,12,11,13,24,53,37,90,0.000333,0.137549,10,4126.466251,229.248125,412.646625,86.159464,1,6
0,0,15,15,15,15,30,66,45,111,0.000333,0.181555,21,11437.96198,635.442332,544.664856,117.206718,2,6
0,0,10,10,14,14,28,46,31,77,0.000333,0.123389,14,5182.328606,287.907145,370.166329,106.605938,2,6
0,0,13,13,12,14,26,56,38,94,0.000333,0.14728,12,5302.096002,294.560889,441.841334,96.322519,2,6
0,0,16,16,16,16,32,69,46,115,0.000333,0.191667,16,9200,511.111111,575,128,3,6
0,0,10,10,14,14,28,46,31,77,0.000333,0.123389,14,5182.328606,287.907145,370.166329,106.605938,2,6
0,0,15,15,10,16,26,52,51,103,0.000333,0.161382,15,7262.179365,403.454409,484.145291,97.219281,1,6
0,0,17,17,14,18,32,60,56,116,0.000333,0.193333,21,12180,676.666667,580,128.361619,2,6
0,0,8,8,10,13,23,29,28,57,0.000333,0.085948,10,2578.430315,143.246129,257.843031,81.324997,1,6
0,0,10,10,14,16,30,37,33,70,0.000333,0.114494,14,4808.752784,267.152932,343.482342,117.302969,2,6
0,0,17,17,16,24,40,78,57,135,0.000333,0.239487,16,11495.36469,638.631371,718.460293,174.0391,6,6
0,0,16,16,11,19,30,54,54,108,0.000333,0.176648,10,5299.441843,294.413436,529.944184,118.764371,1,6
0,0,18,18,15,21,36,62,59,121,0.000333,0.20852,14,8757.852952,486.547386,625.560925,150.842025,2,6
0,0,16,16,12,16,28,57,53,110,0.000333,0.17627,18,9518.562746,528.809041,528.809041,107.01955,1,6
0,0,18,18,16,18,34,65,58,123,0.000333,0.208586,24,15018.19031,834.343906,625.757929,139.05865,2,6
0,0,15,15,10,16,26,52,51,103,0.000333,0.161382,15,7262.179365,403.454409,484.145291,97.219281,1,6
0,0,17,17,14,18,32,60,56,116,0.000333,0.193333,21,12180,676.666667,580,128.361619,2,6
0,0,7,7,10,12,22,29,27,56,0.000333,0.083243,10,2497.281706,138.737873,249.728171,76.238831,1,6
0,0,9,9,14,15,29,37,32,69,0.000333,0.111734,14,4692.809641,260.711647,335.200689,111.906328,2,6
0,0,11,11,13,17,30,38,33,71,0.000333,0.11613,6,2090.335394,116.129744,348.389232,117.592585,2,6
0,0,11,11,14,16,30,47,35,82,0.000333,0.134122,14,5633.110404,312.950578,402.365029,117.302969,2,6
0,0,10,10,14,13,27,44,30,74,0.000333,0.117287,14,4926.063452,273.670192,351.861675,101.408685,2,6
0,0,19,19,12,20,32,91,65,156,0.000333,0.26,18,14040,780,780,129.458112,1,6
0,0,22,22,16,23,39,104,73,177,0.000333,0.311839,24,22452.38863,1247.354924,935.516193,168.041925,2,6
0,0,11,11,13,15,28,51,37,88,0.000333,0.141016,12,5076.566798,282.031489,423.047233,106.709075,1,6
0,0,14,14,17,18,35,64,45,109,0.000333,0.186364,16,8945.469582,496.970532,559.091849,144.545518,2,6
0,0,12,12,13,16,29,52,37,89,0.000333,0.14412,12,5188.323703,288.240206,432.360309,112.105716,1,6
0,0,21,21,15,19,34,89,64,153,0.000333,0.259461,21,16346.01811,908.112117,778.381815,139.313982,2,6
0,0,10,10,14,14,28,49,32,81,0.000333,0.129799,14,5451.540482,302.86336,389.395749,106.605938,2,6
0,0,13,13,15,23,38,57,44,101,0.000333,0.17668,7,3710.284752,206.126931,530.040679,162.645284,4,6
0,0,17,17,20,19,39,62,45,107,0.000333,0.188513,20,11310.76075,628.375597,565.538037,167.149185,4,6
0,0,16,16,16,19,35,65,50,115,0.000333,0.196623,16,9437.880751,524.326708,589.867547,144.710623,3,6
0,0,13,13,15,17,32,56,43,99,0.000333,0.165,14,6930,385,495,128.090227,3,6
0,0,19,19,15,16,31,75,56,131,0.000333,0.216333,21,13628.99405,757.166336,648.999717,122.603359,2,6
0,0,20,20,14,17,31,77,60,137,0.000333,0.226242,21,14253.22279,791.84571,678.724895,122.789837,2,6
0,0,10,10,13,13,26,44,32,76,0.000333,0.119078,12,4286.801023,238.155612,357.233419,96.211433,2,6
0,0,15,15,18,20,38,56,44,100,0.000333,0.174931,18,9446.269524,524.792751,524.792751,161.497212,4,6
0,0,15,15,17,15,32,57,41,98,0.000333,0.163333,16,7840,435.555556,490,128.090227,3,6
0,0,11,11,14,13,27,44,30,74,0.000333,0.117287,14,4926.063452,273.670192,351.861675,101.408685,2,6
0,0,17,17,15,17,32,62,56,118,0.000333,0.196667,21,12390,688.333333,590,128.090227,2,6
0,0,20,20,19,20,39,74,55,129,0.000333,0.227272,18,12272.70395,681.816886,681.816886,167.149185,3,6
0,0,11,11,14,13,27,44,30,74,0.000333,0.117287,14,4926.063452,273.670192,351.861675,101.408685,2,6
0,0,19,19,19,17,36,73,52,125,0.000333,0.215414,27,17448.49688,969.360938,646.240625,150.197491,3,6
0,0,11,11,14,13,27,44,30,74,0.000333,0.117287,14,4926.063452,273.670192,351.861675,101.408685,2,6
0,0,30,30,20,45,65,147,92,239,0.000333,0.479782,20,28786.91815,1599.27323,1439.345907,333.571951,10,6
0,0,14,14,10,17,27,48,43,91,0.000333,0.144232,10,4326.947627,240.385979,432.694763,102.706149,1,6
0,0,13,13,11,16,27,48,40,88,0.000333,0.139477,10,4184.301002,232.461167,418.4301,102.053748,1,6
0,0,11,11,14,17,31,48,36,84,0.000333,0.138717,14,5826.134861,323.674159,416.15249,122.789837,3,6
0,0,13,13,10,15,25,44,45,89,0.000333,0.137768,15,6199.548013,344.419334,413.303201,91.82264,1,6
0,0,16,16,14,18,32,56,54,110,0.000333,0.183333,21,11550,641.666667,550,128.361619,2,6
0,0,11,11,13,16,29,35,33,68,0.000333,0.110114,12,3964.112492,220.228472,330.342708,112.105716,2,6
0,0,15,15,17,17,34,64,45,109,0.000333,0.184844,16,8872.535195,492.918622,554.53345,138.973737,2,6
0,0,11,11,17,15,32,52,34,86,0.000333,0.143333,16,6880,382.222222,430,128.090227,2,6
0,0,9,9,12,16,28,34,31,65,0.000333,0.104159,6,1874.86842,104.159357,312.47807,107.01955,1,6
0,0,15,15,12,16,28,54,51,105,0.000333,0.168257,18,9085.900803,504.772267,504.772267,107.01955,2,6
0,0,17,17,16,19,35,62,56,118,0.000333,0.201752,16,9684.086336,538.004796,605.255396,144.710623,3,6
0,0,11,11,12,14,26,37,35,72,0.000333,0.112811,12,4061.179916,225.621106,338.43166,96.322519,2,6
0,0,13,13,16,16,32,45,40,85,0.000333,0.141667,16,6800,377.777778,425,128,3,6
0,0,31,31,19,49,68,156,99,255,0.000333,0.517434,18,27941.45444,1552.303025,1552.303025,355.831405,12,6
0,0,33,33,20,49,69,160,102,262,0.000333,0.533478,20,32008.66815,1778.259342,1600.433408,361.559344,12,6
0,0,21,21,13,19,32,72,69,141,0.000333,0.235,18,12690,705,705,128.816339,2,6
0,0,23,23,17,21,38,80,74,154,0.000333,0.269394,24,19396.34009,1077.574449,808.180837,161.725534,3,6
0,0,10,10,15,20,35,50,38,88,0.000333,0.150459,7,3159.638338,175.535463,451.376905,145.041921,5,6
0,0,15,15,15,17,32,52,43,95,0.000333,0.158333,14,6650,369.444444,475,128.090227,1,6
0,0,10,10,13,19,32,39,32,71,0.000333,0.118333,6,2130,118.333333,355,128.816339,3,6
0,0,10,10,13,18,31,39,31,70,0.000333,0.115598,6,2080.76245,115.597914,346.793742,123.164366,3,6
0,0,7,7,11,14,25,27,24,51,0.000333,0.078946,5,1184.183328,65.787963,236.836666,91.356717,1,6
0,0,10,10,14,17,31,39,31,70,0.000333,0.115598,7,2427.556192,134.864233,346.793742,122.789837,3,6
0,0,20,20,16,19,35,81,56,137,0.000333,0.234237,16,11243.38837,624.632687,702.711773,144.710623,2,6
0,0,11,11,15,14,29,52,33,85,0.000333,0.137643,14,5780.997384,321.166521,412.928385,111.906328,2,6
0,0,10,10,14,14,28,36,31,67,0.000333,0.107364,14,4509.298917,250.516606,322.09278,106.605938,2,6
0,0,17,17,16,17,33,55,47,102,0.000333,0.171509,16,8232.451203,457.3584,514.5282,133.486868,2,6
0,0,17,17,17,17,34,56,50,106,0.000333,0.179757,16,8628.336979,479.352054,539.271061,138.973737,2,6
0,0,16,16,14,17,31,54,49,103,0.000333,0.170094,14,7143.95108,396.886171,510.28222,122.789837,2,6
0,0,15,15,15,18,33,61,43,104,0.000333,0.174872,14,7344.637838,408.035435,524.616988,133.662009,2,6
0,0,9,9,13,13,26,34,25,59,0.000333,0.092442,6,1663.95566,92.441981,277.325943,96.211433,2,6
0,0,19,19,11,18,29,68,56,124,0.000333,0.200797,15,9035.844651,501.991369,602.389643,113.112398,2,6
0,0,22,22,15,21,36,81,64,145,0.000333,0.24988,21,15742.42163,874.578979,749.639125,150.842025,3,6
0,0,19,19,16,22,38,77,59,136,0.000333,0.237906,16,11419.49027,634.416126,713.718142,162.107496,2,6
0,0,11,11,15,17,32,52,38,90,0.000333,0.15,14,6300,350,450,128.090227,2,6
0,0,19,19,18,19,37,79,55,134,0.000333,0.232689,18,12565.20152,698.066751,698.066751,155.769273,3,6
0,0,11,11,13,14,27,44,31,75,0.000333,0.118872,12,4279.398752,237.744375,356.616563,101.408685,2,6
0,0,14,14,12,15,27,58,42,100,0.000333,0.158496,12,5705.865003,316.9925,475.48875,101.622909,2,6
0,0,17,17,15,17,32,71,50,121,0.000333,0.201667,14,8470,470.555556,605,128.090227,3,6
0,0,10,10,14,13,27,44,30,74,0.000333,0.117287,14,4926.063452,273.670192,351.861675,101.408685,2,6
0,0,22,22,14,22,36,100,74,174,0.000333,0.299856,21,18890.90596,1049.494775,899.56695,151.410465,2,6
0,0,25,25,18,25,43,113,82,195,0.000333,0.352707,27,28569.28393,1587.182441,1058.121627,191.155055,3,6
0,0,15,15,11,16,27,61,53,114,0.000333,0.180686,15,8130.857629,451.714313,542.057175,102.053748,1,6
0,0,17,17,15,18,33,69,58,127,0.000333,0.213546,21,13453.39912,747.411062,640.638053,133.662009,2,6
0,0,14,14,16,21,37,64,51,115,0.000333,0.199696,16,9585.394193,532.5219,599.087137,156.238666,5,6
0,0,33,33,19,49,68,162,102,264,0.000333,0.535697,18,28927.62342,1607.09019,1607.09019,355.831405,13,6
0,0,17,17,15,21,36,81,49,130,0.000333,0.22403,14,9409.263503,522.736861,672.09025,150.842025,6,6
0,0,12,12,15,18,33,59,42,101,0.000333,0.169828,14,7132.773285,396.265182,509.483806,133.662009,5,6
0,0,7,7,13,12,25,33,27,60,0.000333,0.092877,12,3343.576457,185.754248,278.631371,91.125266,1,6
0,0,11,11,16,16,32,48,41,89,0.000333,0.148333,16,7120,395.555556,445,128,1,6
0,0,17,17,16,20,36,70,61,131,0.000333,0.225753,24,16254.24421,903.013567,677.260175,150.438562,1,6
0,0,7,7,11,12,23,27,24,51,0.000333,0.076901,10,2307.016598,128.167589,230.70166,81.073298,1,6
0,0,7,7,11,16,27,27,25,52,0.000333,0.082418,5,1236.270751,68.681708,247.25415,102.053748,1,6
0,0,14,14,16,24,40,65,48,113,0.000333,0.200459,16,9622.045996,534.558111,601.377875,174.0391,4,6
0,0,17,17,15,27,42,72,51,123,0.000333,0.221085,7,4642.785301,257.932517,663.255043,186.985321,6,6
0,0,12,12,16,24,40,60,42,102,0.000333,0.180946,8,4342.693325,241.26074,542.836666,174.0391,4,6
0,0,12,12,14,22,36,58,43,101,0.000333,0.174054,7,3655.136976,203.063165,522.162425,151.410465,5,6
0,0,12,12,14,22,36,58,43,101,0.000333,0.174054,7,3655.136976,203.063165,522.162425,151.410465,5,6
0,0,19,19,16,23,39,88,56,144,0.000333,0.253699,16,12177.56671,676.531484,761.09792,168.041925,6,6
0,0,32,32,19,49,68,159,101,260,0.000333,0.52758,18,28489.3261,1582.740339,1582.740339,355.831405,12,6
0,0,17,17,15,21,36,81,49,130,0.000333,0.22403,14,9409.263503,522.736861,672.09025,150.842025,6,6
0,0,15,15,16,18,34,53,43,96,0.000333,0.162799,16,7814.342924,434.130162,488.396433,139.05865,3,6
0,0,15,15,16,18,34,53,43,96,0.000333,0.162799,16,7814.342924,434.130162,488.396433,139.05865,3,6
0,0,15,15,16,18,34,53,43,96,0.000333,0.162799,16,7814.342924,434.130162,488.396433,139.05865,3,6
0,0,19,19,17,20,37,70,52,122,0.000333,0.211851,16,10168.85297,564.936276,635.553311,155.92543,3,6
0,0,17,17,15,18,33,64,56,120,0.000333,0.201776,21,12711.87318,706.215177,605.327294,133.662009,2,6
0,0,11,11,13,14,27,34,32,66,0.000333,0.104608,12,3765.870902,209.21505,313.822575,101.408685,2,6
0,0,11,11,10,12,22,38,29,67,0.000333,0.099594,10,2987.819184,165.989955,298.781918,76.238831,2,6
0,0,14,14,14,15,29,51,37,88,0.000333,0.142501,14,5985.032586,332.50181,427.502328,111.906328,3,6
0,0,10,10,13,14,27,39,28,67,0.000333,0.106192,12,3822.929552,212.384975,318.577463,101.408685,2,6
0,0,11,11,15,16,31,48,36,84,0.000333,0.138717,14,5826.134861,323.674159,416.15249,122.603359,1,6
0,0,11,11,10,14,24,33,33,66,0.000333,0.100869,10,3026.07525,168.115292,302.607525,86.52225,1,6
0,0,12,12,12,14,26,38,35,73,0.000333,0.114377,12,4117.585193,228.754733,343.132099,96.322519,1,6
0,0,13,13,13,15,28,41,36,77,0.000333,0.123389,12,4441.995948,246.777553,370.166329,106.709075,2,6
0,0,11,11,11,14,25,34,33,67,0.000333,0.103713,10,3111.383647,172.854647,311.138365,91.356717,1,6
0,0,11,11,10,14,24,33,33,66,0.000333,0.100869,10,3026.07525,168.115292,302.607525,86.52225,1,6
0,0,15,15,15,16,31,53,37,90,0.000333,0.148626,14,6242.287351,346.793742,445.877668,122.603359,3,6
0,0,17,17,15,22,37,81,50,131,0.000333,0.227479,14,9554.137473,530.785415,682.438391,156.710855,6,6
0,0,11,11,11,16,27,42,39,81,0.000333,0.128382,10,3851.458877,213.969938,385.145888,102.053748,1,6
0,0,13,13,15,19,34,50,44,94,0.000333,0.159407,14,6695.101099,371.950061,478.221507,139.313982,2,6
0,0,10,10,13,18,31,38,30,68,0.000333,0.112295,6,2021.312095,112.295116,336.885349,123.164366,2,6
0,0,9,9,12,17,29,33,28,61,0.000333,0.098779,6,1778.021044,98.778947,296.336841,112.506418,2,6
0,0,16,16,15,18,33,59,52,111,0.000333,0.186643,14,7838.988461,435.499359,559.927747,133.662009,3,6
0,0,16,16,16,32,48,78,60,138,0.000333,0.256908,8,6165.798601,342.544367,770.724825,224,6,6
0,0,13,13,15,17,32,53,42,95,0.000333,0.158333,14,6650,369.444444,475,128.090227,2,6
0,0,13,13,15,16,31,51,44,95,0.000333,0.156883,14,6589.081093,366.060061,470.648649,122.603359,1,6
0,0,15,15,17,23,40,61,50,111,0.000333,0.196911,16,9451.744297,525.096905,590.734019,173.528793,3,6
0,0,14,14,12,15,27,51,46,97,0.000333,0.153741,18,8302.033579,461.224088,461.224088,101.622909,2,6
0,0,16,16,15,17,32,59,51,110,0.000333,0.183333,21,11550,641.666667,550,128.090227,3,6
0,0,13,13,12,16,28,49,44,93,0.000333,0.149028,12,5365.008093,298.056005,447.084008,107.01955,2,6
0,0,15,15,15,18,33,57,49,106,0.000333,0.178235,14,7485.880873,415.882271,534.705777,133.662009,3,6
0,0,13,13,12,16,28,49,44,93,0.000333,0.149028,12,5365.008093,298.056005,447.084008,107.01955,2,6
0,0,15,15,15,18,33,57,49,106,0.000333,0.178235,14,7485.880873,415.882271,534.705777,133.662009,3,6
0,0,12,12,15,24,39,59,45,104,0.000333,0.183227,7,3847.772815,213.765156,549.681831,168.642459,6,6
0,0,14,14,14,24,38,63,47,110,0.000333,0.192424,7,4040.904185,224.494677,577.272026,163.342069,6,6
0,0,17,17,16,17,33,57,49,106,0.000333,0.178235,16,8555.292426,475.294024,534.705777,133.486868,2,6
0,0,17,17,17,17,34,58,52,110,0.000333,0.18654,24,13430.9019,746.161217,559.620913,138.973737,2,6
0,0,16,16,14,17,31,56,51,107,0.000333,0.1767,21,11132.07911,618.448839,530.099005,122.789837,2,6
0,0,18,18,16,19,35,68,54,122,0.000333,0.208591,16,10012.36045,556.242247,625.772528,144.710623,2,6
0,0,12,12,16,17,33,49,35,84,0.000333,0.141243,16,6779.665696,376.648094,423.729106,133.486868,3,6
0,0,10,10,12,19,31,35,31,66,0.000333,0.108992,6,1961.861739,108.992319,326.976956,123.730173,2,6
0,0,19,19,14,21,35,87,65,152,0.000333,0.259884,21,16372.67139,909.592855,779.651019,145.541635,2,6
0,0,11,11,14,22,36,50,38,88,0.000333,0.151651,7,3184.673801,176.926322,454.9534,151.410465,4,6
0,0,11,11,10,13,23,41,33,74,0.000333,0.111581,10,3347.435847,185.968658,334.743585,81.324997,1,6
0,0,12,12,13,16,29,46,34,80,0.000333,0.129546,12,4663.661755,259.09232,388.63848,112.105716,2,6
0,0,17,17,17,25,42,88,58,146,0.000333,0.262426,16,12596.4535,699.802972,787.278344,185.583273,7,6
0,0,16,16,18,19,37,59,48,107,0.000333,0.185804,18,10033.40718,557.41151,557.41151,155.769273,3,6
0,0,13,13,14,23,37,61,45,106,0.000333,0.184067,7,3865.414397,214.745244,552.202057,157.344894,5,6
0,0,13,13,14,17,31,51,45,96,0.000333,0.158534,14,6658.439841,369.913325,475.602846,122.789837,2,6
0,0,15,15,18,20,38,59,50,109,0.000333,0.190675,18,10296.43378,572.024099,572.024099,161.497212,3,6
0,0,12,12,16,17,33,49,35,84,0.000333,0.141243,16,6779.665696,376.648094,423.729106,133.486868,3,6
0,0,16,16,16,23,39,76,56,132,0.000333,0.232558,16,11162.76949,620.15386,697.673093,168.041925,5,6
0,0,12,12,14,15,29,45,41,86,0.000333,0.139262,14,5849.009118,324.944951,417.786366,111.906328,1,6
0,0,11,11,15,16,31,42,35,77,0.000333,0.127158,14,5340.623623,296.701312,381.473116,122.603359,2,6
0,0,11,11,15,15,30,42,34,76,0.000333,0.124308,14,5220.931594,290.051755,372.923685,117.206718,2,6
0,0,29,29,22,45,67,149,95,244,0.000333,0.493375,22,32562.76677,1809.042599,1480.125762,345.240885,10,6
0,0,15,15,15,19,34,75,46,121,0.000333,0.205194,14,8618.162053,478.786781,615.583004,139.313982,5,6
0,0,15,15,12,18,30,66,50,116,0.000333,0.189733,12,6830.391709,379.466206,569.199309,118.0782,1,6
0,0,19,19,11,16,27,73,58,131,0.000333,0.20763,15,9343.353942,519.075219,622.890263,102.053748,1,6
0,0,22,22,15,18,33,86,66,152,0.000333,0.255583,21,16101.70603,894.539224,766.747906,133.662009,2,6
0,0,10,10,14,13,27,47,32,79,0.000333,0.125212,14,5258.905577,292.161421,375.636113,101.408685,2,6
0,0,13,13,10,13,23,52,42,94,0.000333,0.141738,15,6378.222358,354.345687,425.214824,81.324997,1,6
0,0,16,16,14,16,30,65,50,115,0.000333,0.188097,21,11850.14079,658.341155,564.292418,117.302969,2,6
0,0,10,10,14,13,27,47,32,79,0.000333,0.125212,14,5258.905577,292.161421,375.636113,101.408685,2,6
0,0,15,15,11,14,25,61,46,107,0.000333,0.165631,15,7453.389185,414.077177,496.892612,91.356717,1,6
0,0,18,18,15,16,31,74,54,128,0.000333,0.211379,21,13316.87968,739.826649,634.137128,122.603359,2,6
0,0,10,10,14,13,27,47,32,79,0.000333,0.125212,14,5258.905577,292.161421,375.636113,101.408685,2,6
0,0,16,16,14,16,30,60,51,111,0.000333,0.181555,21,11437.96198,635.442332,544.664856,117.302969,2,6
0,0,18,18,17,18,35,68,56,124,0.000333,0.21201,24,15264.74626,848.041459,636.031094,144.545518,3,6
0,0,7,7,10,12,22,36,24,60,0.000333,0.089189,10,2675.658971,148.647721,267.565897,76.238831,1,6
0,0,11,11,10,14,24,32,33,65,0.000333,0.099341,10,2980.225625,165.56809,298.022563,86.52225,1,6
0,0,9,9,12,13,25,26,23,49,0.000333,0.07585,6,1365.29372,75.849651,227.548953,91.125266,2,6
0,0,9,9,13,17,30,41,31,72,0.000333,0.117765,6,2119.776737,117.765374,353.296123,117.592585,3,6
0,0,9,9,12,14,26,31,28,59,0.000333,0.092442,12,3327.91132,184.883962,277.325943,96.322519,1,6
0,0,11,11,12,14,26,48,36,84,0.000333,0.131612,12,4738.043236,263.224624,394.836936,96.322519,1,6
0,0,14,14,16,17,33,61,44,105,0.000333,0.176554,16,8474.582121,470.810118,529.661383,133.486868,2,6
0,0,20,20,12,20,32,92,67,159,0.000333,0.265,18,14310,795,795,129.458112,1,6
0,0,23,23,16,22,38,105,75,180,0.000333,0.314876,24,22671.04686,1259.502603,944.626952,162.107496,2,6
0,0,9,9,13,17,30,41,31,72,0.000333,0.117765,6,2119.776737,117.765374,353.296123,117.592585,3,6
0,0,9,9,13,17,30,41,31,72,0.000333,0.117765,6,2119.776737,117.765374,353.296123,117.592585,3,6
0,0,15,15,16,19,35,69,50,119,0.000333,0.203462,16,9766.154864,542.564159,610.384679,144.710623,5,6
0,0,9,9,13,20,33,36,32,68,0.000333,0.11434,6,2058.112801,114.3396,343.0188,134.544278,2,6
0,0,11,11,12,15,27,44,39,83,0.000333,0.131552,12,4735.867952,263.103775,394.655663,101.622909,1,6
0,0,13,13,16,18,34,52,44,96,0.000333,0.162799,16,7814.342924,434.130162,488.396433,139.05865,2,6
0,0,11,11,10,13,23,41,33,74,0.000333,0.111581,10,3347.435847,185.968658,334.743585,81.324997,1,6
0,0,12,12,13,16,29,46,34,80,0.000333,0.129546,12,4663.661755,259.09232,388.63848,112.105716,2,6
0,0,13,13,15,17,32,51,40,91,0.000333,0.151667,14,6370,353.888889,455,128.090227,2,6
0,0,11,11,15,16,31,47,36,83,0.000333,0.137066,14,5756.776113,319.820895,411.198294,122.603359,2,6
0,0,17,17,17,21,38,78,57,135,0.000333,0.236157,16,11335.52343,629.751302,708.470214,161.725534,6,6
0,0,6,6,10,11,21,29,20,49,0.000333,0.071741,5,1076.117769,59.78432,215.223554,71.273029,1,6
0,0,18,18,17,20,37,86,54,140,0.000333,0.243108,16,11669.17554,648.28753,729.323471,155.92543,5,6
0,0,20,20,16,21,37,74,61,135,0.000333,0.234425,16,11252.41927,625.134404,703.276204,156.238666,2,6
0,0,11,11,15,16,31,50,38,88,0.000333,0.145323,14,6103.569854,339.087214,435.969275,122.603359,2,6
0,0,12,12,15,18,33,52,39,91,0.000333,0.153013,14,6426.558108,357.031006,459.039865,133.662009,3,6
0,0,11,11,12,13,25,41,32,73,0.000333,0.113001,12,4068.018022,226.001001,339.001502,91.125266,2,6
0,0,14,14,16,15,31,54,40,94,0.000333,0.155231,16,7451.111251,413.950625,465.694453,122.603359,3,6
0,0,10,10,13,13,26,41,29,70,0.000333,0.109677,12,3948.369363,219.353854,329.03078,96.211433,2,6
0,0,12,12,16,20,36,49,40,89,0.000333,0.153374,16,7361.973202,408.998511,460.123325,150.438562,2,6
0,0,18,18,16,23,39,77,60,137,0.000333,0.241367,16,11585.60166,643.644537,724.100104,168.041925,2,6
0,0,13,13,13,16,29,54,42,96,0.000333,0.155455,12,5596.394106,310.910784,466.366176,112.105716,2,6
0,0,16,16,17,19,36,67,50,117,0.000333,0.201627,16,9678.099603,537.6722,604.881225,150.197491,3,6
0,0,10,10,15,15,30,46,32,78,0.000333,0.127579,14,5358.32453,297.684696,382.737466,117.206718,2,6
0,0,22,22,14,20,34,92,71,163,0.000333,0.276419,21,17414.38531,967.46585,829.256443,139.741531,2,6
0,0,25,25,18,22,40,105,79,184,0.000333,0.326412,27,26439.33878,1468.852154,979.234769,173.166146,3,6
0,0,9,9,13,17,30,41,31,72,0.000333,0.117765,6,2119.776737,117.765374,353.296123,117.592585,3,6
0,0,14,14,14,23,37,64,49,113,0.000333,0.196223,14,8241.355224,457.853068,588.66823,157.344894,5,6
0,0,33,33,19,51,70,162,103,265,0.000333,0.54142,18,29236.67999,1624.259999,1624.259999,370.004315,13,6
0,0,16,16,17,23,40,77,56,133,0.000333,0.235939,16,11325.06299,629.170166,707.816437,173.528793,5,6
0,0,19,19,18,18,36,77,55,132,0.000333,0.227477,27,18425.61271,1023.64515,682.4301,150.1173,4,6
0,0,10,10,13,13,26,41,29,70,0.000333,0.109677,12,3948.369363,219.353854,329.03078,96.211433,2,6
0,0,22,22,19,19,38,88,63,151,0.000333,0.264146,27,21395.80047,1188.655582,792.437055,161.421246,4,6
0,0,10,10,13,13,26,41,29,70,0.000333,0.109677,12,3948.369363,219.353854,329.03078,96.211433,2,6
0,0,13,13,17,15,32,48,35,83,0.000333,0.138333,16,6640,368.888889,415,128.090227,3,6
0,0,7,7,11,12,23,33,28,61,0.000333,0.091979,10,2759.372793,153.298489,275.937279,81.073298,1,6
0,0,9,9,15,15,30,41,33,74,0.000333,0.121037,14,5083.538657,282.418814,363.109904,117.206718,2,6
0,0,11,11,15,15,30,47,35,82,0.000333,0.134122,14,5633.110404,312.950578,402.365029,117.206718,1,6
0,0,13,13,16,18,34,48,42,90,0.000333,0.152624,16,7325.946491,406.997027,457.871656,139.05865,2,6
0,0,21,21,16,23,39,87,69,156,0.000333,0.274841,24,19788.54591,1099.363662,824.522746,168.041925,2,6
0,0,14,14,16,19,35,55,46,101,0.000333,0.172686,16,8288.921355,460.495631,518.057585,144.710623,2,6
0,0,15,15,16,17,33,61,45,106,0.000333,0.178235,16,8555.292426,475.294024,534.705777,133.486868,2,6
0,0,11,11,16,15,31,49,34,83,0.000333,0.137066,16,6579.1727,365.509594,411.198294,122.603359,2,6
0,0,19,19,11,18,29,68,56,124,0.000333,0.200797,15,9035.844651,501.991369,602.389643,113.112398,2,6
0,0,22,22,15,21,36,81,64,145,0.000333,0.24988,21,15742.42163,874.578979,749.639125,150.842025,3,6
0,0,10,10,12,15,27,40,33,73,0.000333,0.115702,12,4165.281452,231.404525,347.106788,101.622909,2,6
0,0,13,13,16,18,34,53,41,94,0.000333,0.159407,16,7651.544113,425.085784,478.221507,139.05865,3,6
0,0,10,10,13,13,26,41,29,70,0.000333,0.109677,12,3948.369363,219.353854,329.03078,96.211433,2,6
0,0,20,20,18,28,46,99,65,164,0.000333,0.301955,18,16305.55489,905.864161,905.864161,209.664588,6,6
0,0,20,20,18,28,46,99,65,164,0.000333,0.301955,18,16305.55489,905.864161,905.864161,209.664588,6,6
0,0,19,19,17,30,47,95,64,159,0.000333,0.294393,16,14130.87404,785.048558,883.179627,216.693586,6,6
0,0,12,12,13,15,28,37,34,71,0.000333,0.113774,12,4095.866394,227.548133,341.322199,106.709075,2,6
0,0,8,8,13,18,31,37,29,66,0.000333,0.108992,6,1961.861739,108.992319,326.976956,123.164366,3,6
0,0,12,12,13,15,28,37,34,71,0.000333,0.113774,12,4095.866394,227.548133,341.322199,106.709075,2,6
0,0,7,7,11,15,26,27,25,52,0.000333,0.081474,5,1222.114327,67.89524,244.422865,96.657107,1,6
0,0,39,39,19,50,69,165,125,290,0.000333,0.590491,18,31886.49766,1771.472092,1771.472092,362.903432,10,6
0,0,42,42,21,53,74,178,133,311,0.000333,0.643713,20,38622.79993,2145.711107,1931.139997,395.81845,11,6
0,0,10,10,15,18,33,44,32,76,0.000333,0.127791,7,2683.617671,149.089871,383.373953,133.662009,2,6
0,0,18,18,18,20,38,69,56,125,0.000333,0.218664,18,11807.83691,655.990939,655.990939,161.497212,3,6
0,0,21,21,14,18,32,76,61,137,0.000333,0.228333,21,14385,799.166667,685,128.361619,2,6
0,0,9,9,13,13,26,37,27,64,0.000333,0.100276,12,3609.937704,200.552095,300.828142,96.211433,2,6
0,0,9,9,14,13,27,38,27,65,0.000333,0.103023,14,4326.947627,240.385979,309.067688,101.408685,2,6
0,0,17,17,14,16,30,64,49,113,0.000333,0.184826,21,11644.05138,646.891744,554.478637,117.302969,2,6
0,0,9,9,13,13,26,37,27,64,0.000333,0.100276,12,3609.937704,200.552095,300.828142,96.211433,2,6
0,0,17,17,15,16,31,65,49,114,0.000333,0.188259,21,11860.34597,658.908109,564.778379,122.603359,2,6
0,0,17,17,17,19,36,58,52,110,0.000333,0.189564,16,9099.068003,505.503778,568.69175,150.197491,3,6
0,0,9,9,12,13,25,28,24,52,0.000333,0.080494,6,1448.883131,80.493507,241.480522,91.125266,2,6
0,0,21,21,12,22,34,92,79,171,0.000333,0.289985,18,15659.21063,869.956146,869.956146,141.127046,1,6
0,0,23,23,16,25,41,100,84,184,0.000333,0.328597,24,23658.94965,1314.386092,985.789569,180.096405,2,6
0,0,11,11,12,16,28,46,40,86,0.000333,0.137811,12,4961.19028,275.621682,413.432523,107.01955,1,6
0,0,13,13,16,19,35,54,45,99,0.000333,0.169266,16,8124.784299,451.376905,507.799019,144.710623,2,6
0,0,9,9,12,12,24,40,30,70,0.000333,0.106982,12,3851.368501,213.964917,320.947375,86.0391,2,6
0,0,12,12,16,15,31,53,38,91,0.000333,0.150277,16,7213.309828,400.739435,450.831864,122.603359,3,6
0,0,10,10,13,13,26,44,31,75,0.000333,0.117511,12,4230.395746,235.021986,352.532979,96.211433,2,6
0,0,16,16,18,21,39,66,51,117,0.000333,0.206131,18,11131.05707,618.39206,618.39206,167.297316,3,6
0,0,17,17,14,20,34,76,56,132,0.000333,0.223848,14,9401.631331,522.312852,671.545095,139.741531,1,6
0,0,28,28,22,44,66,120,84,204,0.000333,0.411019,11,13563.6204,753.534467,1233.0564,338.322487,9,6
0,0,27,27,22,44,66,119,82,201,0.000333,0.404974,11,13364.1554,742.453078,1214.923218,338.322487,9,6
0,0,16,16,18,20,38,61,51,112,0.000333,0.195923,18,10579.82187,587.767882,587.767882,161.497212,3,6
0,0,15,15,19,21,40,72,54,126,0.000333,0.223521,18,12070.13292,670.56294,670.56294,172.949289,2,6
0,0,11,11,19,19,38,59,43,102,0.000333,0.17843,18,9635.194915,535.288606,535.288606,161.421246,2,6
0,0,12,12,13,18,31,46,40,86,0.000333,0.14202,12,5112.730592,284.040588,426.060883,123.164366,2,6
0,0,16,16,15,16,31,56,51,107,0.000333,0.1767,21,11132.07911,618.448839,530.099005,122.603359,3,6
0,0,18,18,18,30,48,90,66,156,0.000333,0.290418,18,15682.5747,871.25415,871.25415,222.265368,6,6
0,0,17,17,17,30,47,86,64,150,0.000333,0.277729,16,13331.01324,740.611847,833.188328,216.693586,6,6
0,0,11,11,13,15,28,45,39,84,0.000333,0.134606,12,4845.813761,269.211876,403.817813,106.709075,1,6
0,0,13,13,17,18,35,53,44,97,0.000333,0.165847,16,7960.647242,442.25818,497.540453,144.545518,2,6
0,0,11,11,12,15,27,44,39,83,0.000333,0.131552,12,4735.867952,263.103775,394.655663,101.622909,1,6
0,0,13,13,16,18,34,52,44,96,0.000333,0.162799,16,7814.342924,434.130162,488.396433,139.05865,2,6
0,0,18,18,16,16,32,77,54,131,0.000333,0.218333,24,15720,873.333333,655,128,2,6
0,0,10,10,14,13,27,44,30,74,0.000333,0.117287,14,4926.063452,273.670192,351.861675,101.408685,2,6
0,0,31,31,19,49,68,156,99,255,0.000333,0.517434,18,27941.45444,1552.303025,1552.303025,355.831405,12,6
0,0,15,15,15,19,34,75,46,121,0.000333,0.205194,14,8618.162053,478.786781,615.583004,139.313982,5,6
0,0,31,31,19,50,69,156,100,256,0.000333,0.521261,18,28148.0807,1563.782261,1563.782261,362.903432,12,6
0,0,15,15,15,19,34,75,46,121,0.000333,0.205194,14,8618.162053,478.786781,615.583004,139.313982,5,6
0,0,10,10,12,15,27,39,31,70,0.000333,0.110947,12,3994.105502,221.89475,332.842125,101.622909,1,6
0,0,7,7,11,11,22,31,22,53,0.000333,0.078783,10,2363.498758,131.305487,236.349876,76.107496,1,6
0,0,15,15,15,20,35,75,47,122,0.000333,0.208591,14,8760.815393,486.711966,625.772528,145.041921,5,6
0,0,11,11,13,17,30,35,29,64,0.000333,0.10468,6,1884.245989,104.680333,314.040998,117.592585,2,6
0,0,18,18,16,18,34,62,53,115,0.000333,0.195019,16,9360.931628,520.051757,585.058227,139.05865,2,6
0,0,20,20,16,19,35,68,59,127,0.000333,0.21714,24,15634.05464,868.558591,651.418943,144.710623,2,6
0,0,17,17,18,17,35,61,49,110,0.000333,0.188074,18,10155.98037,564.221132,564.221132,144.545518,2,6
0,0,15,15,15,25,40,67,50,117,0.000333,0.207555,14,8717.318219,484.295457,622.665587,174.699764,6,6
0,0,19,19,16,17,33,75,55,130,0.000333,0.21859,24,15738.50965,874.361647,655.771236,133.486868,3,6
0,0,22,22,19,19,38,88,63,151,0.000333,0.264146,27,21395.80047,1188.655582,792.437055,161.421246,4,6
0,0,10,10,13,13,26,41,29,70,0.000333,0.109677,12,3948.369363,219.353854,329.03078,96.211433,2,6
0,0,14,14,17,15,32,54,40,94,0.000333,0.156667,16,7520,417.777778,470,128.090227,2,6
0,0,7,7,11,12,23,27,24,51,0.000333,0.076901,10,2307.016598,128.167589,230.70166,81.073298,1,6
0,0,10,10,11,15,26,30,29,59,0.000333,0.092442,5,1386.629717,77.034984,277.325943,96.657107,2,6
0,0,13,13,14,23,37,61,45,106,0.000333,0.184067,7,3865.414397,214.745244,552.202057,157.344894,5,6
0,0,17,17,14,19,33,72,55,127,0.000333,0.213546,14,8968.932744,498.274041,640.638053,134.013592,1,6
0,0,9,9,14,10,24,32,25,57,0.000333,0.087114,14,3658.800076,203.266671,261.342863,86.52225,3,6
0,0,9,9,13,12,25,30,24,54,0.000333,0.083589,12,3009.218811,167.178823,250.768234,91.125266,2,6
0,0,10,10,14,13,27,39,28,67,0.000333,0.106192,14,4460.084477,247.782471,318.577463,101.408685,1,6
0,0,17,17,13,16,29,67,52,119,0.000333,0.1927,18,10405.79529,578.099738,578.099738,112.105716,2,6
0,0,20,20,17,18,35,80,60,140,0.000333,0.239367,24,17234.39094,957.466163,718.099622,144.545518,3,6
0,0,11,11,15,14,29,42,30,72,0.000333,0.116592,14,4896.844843,272.046936,349.774632,111.906328,2,6
0,0,11,11,15,14,29,42,29,71,0.000333,0.114972,14,4828.833109,268.268506,344.916651,111.906328,2,6
0,0,11,11,16,19,35,46,38,84,0.000333,0.14362,16,6893.756375,382.986465,430.859773,144.710623,2,6
0,0,13,13,11,16,27,48,39,87,0.000333,0.137892,10,4136.752127,229.819563,413.675213,102.053748,2,6
0,0,16,16,15,19,34,61,47,108,0.000333,0.183149,14,7692.243816,427.346879,549.445987,139.313982,3,6
0,0,13,13,12,16,28,49,39,88,0.000333,0.141016,12,5076.566798,282.031489,423.047233,107.01955,2,6
0,0,16,16,16,19,35,62,47,109,0.000333,0.186364,16,8945.469582,496.970532,559.091849,144.710623,3,6
0,0,13,13,14,17,31,51,45,96,0.000333,0.158534,14,6658.439841,369.913325,475.602846,122.789837,2,6
0,0,15,15,18,20,38,59,50,109,0.000333,0.190675,18,10296.43378,572.024099,572.024099,161.497212,3,6
0,0,22,22,14,22,36,91,78,169,0.000333,0.291239,21,18348.06383,1019.336879,873.717325,151.410465,2,6
0,0,24,24,18,24,42,99,83,182,0.000333,0.327134,27,26497.84782,1472.102656,981.401771,185.09775,3,6
0,0,20,20,16,22,38,91,57,148,0.000333,0.258898,16,12427.09235,690.39402,776.693272,162.107496,6,6
0,0,12,12,13,23,36,48,38,86,0.000333,0.148205,6,2667.681301,148.204517,444.61355,152.147641,4,6
0,0,9,9,13,19,32,36,31,67,0.000333,0.111667,6,2010,111.666667,335,128.816339,2,6
0,0,11,11,15,19,34,45,38,83,0.000333,0.140753,14,5911.631822,328.42399,422.259416,139.313982,2,6
0,0,21,21,18,29,47,106,73,179,0.000333,0.331424,18,17896.88528,994.271404,994.271404,215.940099,7,6
0,0,13,13,12,13,25,56,38,94,0.000333,0.145507,12,5238.269782,291.014988,436.522482,91.125266,2,6
0,0,16,16,15,15,30,69,46,115,0.000333,0.188097,21,11850.14079,658.341155,564.292418,117.206718,3,6
0,0,11,11,10,13,23,37,29,66,0.000333,0.099518,10,2985.550891,165.863938,298.555089,81.324997,2,6
0,0,14,14,14,16,30,50,37,87,0.000333,0.1423,14,5976.592745,332.03293,426.899482,117.302969,3,6
0,0,10,10,13,14,27,39,28,67,0.000333,0.106192,12,3822.929552,212.384975,318.577463,101.408685,2,6
0,0,13,13,12,15,27,49,43,92,0.000333,0.145817,12,5249.395802,291.6331,437.44965,101.622909,2,6
0,0,15,15,15,17,32,57,48,105,0.000333,0.175,14,7350,408.333333,525,128.090227,3,6
0,0,14,14,15,17,32,58,44,102,0.000333,0.17,14,7140,396.666667,510,128.090227,2,6
0,0,10,10,15,15,30,46,33,79,0.000333,0.129215,14,5427.020999,301.501167,387.644357,117.206718,2,6
0,0,21,21,15,21,36,83,64,147,0.000333,0.253326,21,15959.55848,886.642138,759.978975,150.842025,2,6
0,0,10,10,15,16,31,47,34,81,0.000333,0.133763,14,5618.058616,312.114368,401.289901,122.603359,2,6
0,0,28,28,19,45,64,143,89,232,0.000333,0.464,9,12528,696,1392,327.844012,10,6
0,0,15,15,15,19,34,75,46,121,0.000333,0.205194,14,8618.162053,478.786781,615.583004,139.313982,5,6
0,0,28,28,19,45,64,143,89,232,0.000333,0.464,9,12528,696,1392,327.844012,10,6
0,0,11,11,13,22,35,45,37,82,0.000333,0.1402,6,2523.607244,140.200402,420.601207,146.213212,3,6
0,0,9,9,13,19,32,36,31,67,0.000333,0.111667,6,2010,111.666667,335,128.816339,2,6
0,0,14,14,12,14,26,58,41,99,0.000333,0.155115,12,5584.122385,310.229021,465.343532,96.322519,2,6
0,0,17,17,15,16,31,71,49,120,0.000333,0.198168,21,12484.5747,693.587483,594.503557,122.603359,3,6
0,0,16,16,14,15,29,63,44,107,0.000333,0.173268,14,7277.255531,404.291974,519.803966,111.906328,2,6
0,0,19,19,17,17,34,76,52,128,0.000333,0.217065,24,15628.68585,868.260325,651.195244,138.973737,3,6
0,0,10,10,14,13,27,44,30,74,0.000333,0.117287,14,4926.063452,273.670192,351.861675,101.408685,2,6
0,0,10,10,14,13,27,37,30,67,0.000333,0.106192,14,4460.084477,247.782471,318.577463,101.408685,2,6
0,0,14,14,15,19,34,56,44,100,0.000333,0.169582,14,7122.447978,395.691554,508.746284,139.313982,4,6
0,0,18,18,18,20,38,69,52,121,0.000333,0.211666,18,11429.98612,634.999229,634.999229,161.497212,3,6
0,0,11,11,15,16,31,47,36,83,0.000333,0.137066,14,5756.776113,319.820895,411.198294,122.603359,2,6
0,0,18,18,19,20,39,70,59,129,0.000333,0.227272,18,12272.70395,681.816886,681.816886,167.149185,3,6
0,0,16,16,16,19,35,62,49,111,0.000333,0.189783,16,9109.606638,506.089258,569.350415,144.710623,2,6
0,0,11,11,15,16,31,47,36,83,0.000333,0.137066,14,5756.776113,319.820895,411.198294,122.603359,2,6
0,0,13,13,12,14,26,56,38,94,0.000333,0.14728,12,5302.096002,294.560889,441.841334,96.322519,2,6
0,0,16,16,15,16,31,69,46,115,0.000333,0.189911,14,7976.25606,443.125337,569.732576,122.603359,3,6
0,0,10,10,14,14,28,46,31,77,0.000333,0.123389,14,5182.328606,287.907145,370.166329,106.605938,2,6
0,0,15,15,18,19,37,56,44,100,0.000333,0.173648,18,9377.016058,520.945337,520.945337,155.769273,4,6
0,0,13,13,17,17,34,48,40,88,0.000333,0.149232,16,7163.14768,397.952649,447.69673,138.973737,3,6
0,0,13,13,17,16,33,48,40,88,0.000333,0.147969,16,7102.50692,394.583718,443.906683,133.486868,3,6
0,0,12,12,16,15,31,45,38,83,0.000333,0.137066,16,6579.1727,365.509594,411.198294,122.603359,2,6
0,0,15,15,15,20,35,75,47,122,0.000333,0.208591,14,8760.815393,486.711966,625.772528,145.041921,5,6
0,0,9,9,12,12,24,41,27,68,0.000333,0.103926,12,3741.329401,207.851633,311.77745,86.0391,2,6
0,0,13,13,12,14,26,56,39,95,0.000333,0.148847,12,5358.501279,297.694515,446.541773,96.322519,2,6
0,0,16,16,15,16,31,69,47,116,0.000333,0.191562,14,8045.614808,446.9786,574.686772,122.603359,3,6
0,0,9,9,13,13,26,39,30,69,0.000333,0.10811,12,3891.964087,216.220227,324.330341,96.211433,1,6
0,0,14,14,14,24,38,63,47,110,0.000333,0.192424,7,4040.904185,224.494677,577.272026,163.342069,6,6
0,0,14,14,14,24,38,63,47,110,0.000333,0.192424,7,4040.904185,224.494677,577.272026,163.342069,6,6
0,0,11,11,12,13,25,43,31,74,0.000333,0.114548,12,4123.744297,229.096905,343.645358,91.125266,1,6
0,0,5,5,9,9,18,21,16,37,0.000333,0.051429,4,617.1489,34.28605,154.287225,57.05865,1,6
0,0,10,10,12,14,26,37,27,64,0.000333,0.100276,6,1804.968852,100.276047,300.828142,96.322519,2,6
0,0,32,32,20,47,67,153,95,248,0.000333,0.501463,20,30087.80239,1671.544577,1504.390119,347.504238,11,6
0,0,18,18,17,22,39,87,51,138,0.000333,0.243129,16,11670.1681,648.342672,729.385506,167.594364,6,6
0,0,30,30,19,47,66,149,92,241,0.000333,0.485566,9,13110.29085,728.349491,1456.698983,341.776299,11,6
0,0,10,10,15,20,35,50,38,88,0.000333,0.150459,7,3159.638338,175.535463,451.376905,145.041921,5,6
0,0,11,11,11,15,26,40,35,75,0.000333,0.117511,10,3525.329789,195.851655,352.532979,96.657107,1,6
0,0,7,7,11,16,27,27,25,52,0.000333,0.082418,5,1236.270751,68.681708,247.25415,102.053748,1,6
0,0,7,7,11,16,27,27,25,52,0.000333,0.082418,5,1236.270751,68.681708,247.25415,102.053748,1,6
0,0,7,7,11,16,27,27,25,52,0.000333,0.082418,5,1236.270751,68.681708,247.25415,102.053748,1,6
0,0,13,13,10,13,23,44,38,82,0.000333,0.123644,10,3709.320804,206.073378,370.93208,81.324997,1,6
0,0,10,10,11,14,25,34,29,63,0.000333,0.097521,10,2925.6294,162.534967,292.56294,91.356717,1,6
0,0,10,10,12,11,23,37,28,65,0.000333,0.098011,12,3528.378326,196.021018,294.031527,81.073298,1,6
0,0,3,3,9,7,16,12,10,22,0.000333,0.029333,4,352,19.555556,88,48.180809,1,6
0,0,5,5,9,8,17,15,13,28,0.000333,0.03815,4,457.795838,25.433102,114.44896,52.529325,1,6
0,0,9,9,10,11,21,32,26,58,0.000333,0.084918,10,2547.544105,141.530228,254.754411,71.273029,1,6
0,0,19,19,17,18,35,77,55,132,0.000333,0.225688,24,16249.5686,902.753811,677.065358,144.545518,4,6
0,0,10,10,13,13,26,41,29,70,0.000333,0.109677,12,3948.369363,219.353854,329.03078,96.211433,2,6
0,0,22,22,16,21,37,89,68,157,0.000333,0.272628,24,19629.22028,1090.512238,817.884178,156.238666,2,6
0,0,19,19,17,17,34,77,55,132,0.000333,0.223848,24,16117.08228,895.39346,671.545095,138.973737,4,6
0,0,18,18,17,17,34,74,54,128,0.000333,0.217065,24,15628.68585,868.260325,651.195244,138.973737,3,6
0,0,13,13,17,17,34,54,46,100,0.000333,0.169582,16,8139.940546,452.218919,508.746284,138.973737,2,6
0,0,13,13,16,17,33,53,46,99,0.000333,0.166465,16,7990.320285,443.906683,499.395018,133.486868,2,6
0,0,16,16,16,16,32,63,41,104,0.000333,0.173333,16,8320,462.222222,520,128,3,6
0,0,17,17,15,16,31,71,50,121,0.000333,0.199819,21,12588.61283,699.367379,599.457754,122.603359,3,6
0,0,10,10,14,13,27,44,30,74,0.000333,0.117287,14,4926.063452,273.670192,351.861675,101.408685,2,6
0,0,15,15,11,16,27,52,50,102,0.000333,0.161666,15,7274.977878,404.165438,484.998525,102.053748,1,6
0,0,18,18,15,18,33,64,59,123,0.000333,0.20682,21,13029.67001,723.870556,620.460477,133.662009,2,6
0,0,7,7,9,15,24,24,27,51,0.000333,0.077944,4,935.33235,51.962908,233.833088,87.132684,1,6
0,0,10,10,13,18,31,36,36,72,0.000333,0.118901,12,4280.425612,237.801423,356.702134,123.164366,2,6
0,0,19,19,18,20,38,75,64,139,0.000333,0.243154,27,19695.47196,1094.192887,729.461924,161.497212,3,6
0,0,17,17,16,19,35,65,51,116,0.000333,0.198332,16,9519.949279,528.886071,594.99683,144.710623,4,6
0,0,20,20,17,20,37,79,57,136,0.000333,0.236162,16,11335.77052,629.765029,708.485658,155.92543,4,6
0,0,12,12,13,15,28,52,40,92,0.000333,0.147426,12,5307.319834,294.851102,442.276653,106.709075,3,6
0,0,17,17,16,18,34,65,50,115,0.000333,0.195019,16,9360.931628,520.051757,585.058227,139.05865,4,6
0,0,19,19,18,19,37,70,53,123,0.000333,0.213588,18,11533.72975,640.762764,640.762764,155.769273,4,6
0,0,12,12,13,15,28,52,40,92,0.000333,0.147426,12,5307.319834,294.851102,442.276653,106.709075,3,6
0,0,17,17,16,18,34,65,50,115,0.000333,0.195019,16,9360.931628,520.051757,585.058227,139.05865,4,6
0,0,12,12,13,15,28,52,40,92,0.000333,0.147426,12,5307.319834,294.851102,442.276653,106.709075,3,6
0,0,15,15,18,20,38,74,54,128,0.000333,0.223912,18,12091.22499,671.734722,671.734722,161.497212,2,6
0,0,10,10,18,16,34,51,38,89,0.000333,0.150928,18,8150.115472,452.784193,452.784193,139.05865,2,6
0,0,17,17,16,27,43,88,57,145,0.000333,0.262269,16,12588.93423,699.385235,786.808389,192.381963,6,6
0,0,17,17,16,27,43,88,57,145,0.000333,0.262269,16,12588.93423,699.385235,786.808389,192.381963,6,6
0,0,17,17,16,27,43,88,57,145,0.000333,0.262269,16,12588.93423,699.385235,786.808389,192.381963,6,6
0,0,13,13,15,24,39,56,45,101,0.000333,0.177942,7,3736.779369,207.598854,533.825624,168.642459,4,6
0,0,14,14,15,24,39,59,47,106,0.000333,0.186751,7,3921.768446,217.876025,560.252635,168.642459,4,6
0,0,19,19,17,28,45,95,63,158,0.000333,0.289238,16,13883.40463,771.300257,867.712789,204.092806,6,6
0,0,8,8,12,12,24,29,25,54,0.000333,0.082529,12,2971.0557,165.05865,247.587975,86.0391,2,6
0,0,13,13,17,18,35,53,44,97,0.000333,0.165847,16,7960.647242,442.25818,497.540453,144.545518,2,6
0,0,10,10,11,19,30,39,29,68,0.000333,0.111223,5,1668.342803,92.685711,333.668561,118.764371,3,6
0,0,11,11,11,19,30,40,31,71,0.000333,0.11613,5,1741.946161,96.774787,348.389232,118.764371,3,6
0,0,9,9,13,20,33,36,32,68,0.000333,0.11434,6,2058.112801,114.3396,343.0188,134.544278,2,6
0,0,16,16,14,16,30,58,46,104,0.000333,0.170106,14,7144.432707,396.912928,510.316622,117.302969,2,6
0,0,10,10,14,13,27,40,28,68,0.000333,0.107777,14,4526.652902,251.480717,323.33235,101.408685,2,6
0,0,18,18,15,17,32,62,47,109,0.000333,0.181667,14,7630,423.888889,545,128.090227,2,6
0,0,10,10,14,13,27,40,28,68,0.000333,0.107777,14,4526.652902,251.480717,323.33235,101.408685,2,6
0,0,7,7,17,14,31,52,28,80,0.000333,0.132112,16,6341.371277,352.298404,396.335705,122.789837,3,6
0,0,17,17,14,22,36,76,65,141,0.000333,0.242986,14,10205.43195,566.968442,728.959425,151.410465,1,6
0,0,11,11,15,17,32,48,42,90,0.000333,0.15,14,6300,350,450,128.090227,1,6
0,0,16,16,17,16,33,63,41,104,0.000333,0.174872,16,8393.871815,466.326212,524.616988,133.486868,3,6
0,0,16,16,16,17,33,63,42,105,0.000333,0.176554,16,8474.582121,470.810118,529.661383,133.486868,3,6
0,0,11,11,15,13,28,47,31,78,0.000333,0.124991,14,5249.631575,291.646199,374.973684,106.709075,2,6
0,0,19,19,16,22,38,88,55,143,0.000333,0.250151,16,12007.25815,667.069897,750.453634,162.107496,6,6
0,0,12,12,15,23,38,57,45,102,0.000333,0.17843,7,3747.020245,208.167791,535.288606,162.645284,5,6
0,0,11,11,15,21,36,53,40,93,0.000333,0.160268,7,3365.621176,186.978954,480.803025,150.842025,5,6
0,0,12,12,15,21,36,56,44,100,0.000333,0.172331,14,7237.895002,402.105278,516.9925,150.842025,5,6
0,0,10,10,14,13,27,39,28,67,0.000333,0.106192,14,4460.084477,247.782471,318.577463,101.408685,1,6
0,0,11,11,15,14,29,42,29,71,0.000333,0.114972,14,4828.833109,268.268506,344.916651,111.906328,2,6
0,0,16,16,14,17,31,57,52,109,0.000333,0.180002,21,11340.15535,630.008631,540.007398,122.789837,3,6
0,0,18,18,17,19,36,65,57,122,0.000333,0.210244,24,15137.5404,840.974467,630.73085,150.197491,4,6
0,0,16,16,14,18,32,57,53,110,0.000333,0.183333,14,7700,427.777778,550,128.361619,3,6
0,0,18,18,17,20,37,65,58,123,0.000333,0.213588,16,10252.20422,569.566901,640.762764,155.92543,4,6
0,0,16,16,14,18,32,57,53,110,0.000333,0.183333,14,7700,427.777778,550,128.361619,3,6
0,0,18,18,17,20,37,65,58,123,0.000333,0.213588,16,10252.20422,569.566901,640.762764,155.92543,4,6
0,0,15,15,16,23,39,73,54,127,0.000333,0.223749,16,10739.93731,596.663184,671.246082,168.041925,5,6
0,0,12,12,12,15,27,46,36,82,0.000333,0.129967,12,4678.809302,259.93385,389.900775,101.622909,2,6
0,0,15,15,16,17,33,59,44,103,0.000333,0.173191,16,8313.161509,461.842306,519.572594,133.486868,3,6
0,0,16,16,12,17,29,63,52,115,0.000333,0.186223,18,10056.02066,558.667814,558.667814,112.506418,2,6
0,0,19,19,16,20,36,76,60,136,0.000333,0.23437,24,16874.63521,937.479734,703.1098,150.438562,3,6
0,0,12,12,16,16,32,56,39,95,0.000333,0.158333,16,7600,422.222222,475,128,3,6
0,0,18,18,14,17,31,72,54,126,0.000333,0.208076,21,13108.80344,728.266858,624.228735,122.789837,2,6
0,0,21,21,18,19,37,85,62,147,0.000333,0.255263,27,20676.32041,1148.684467,765.789645,155.769273,3,6
0,0,12,12,16,16,32,53,37,90,0.000333,0.15,16,7200,400,450,128,3,6
0,0,18,18,15,17,32,73,57,130,0.000333,0.216667,21,13650,758.333333,650,128.090227,2,6
0,0,21,21,19,19,38,86,65,151,0.000333,0.264146,27,21395.80047,1188.655582,792.437055,161.421246,3,6
0,0,10,10,14,22,36,46,36,82,0.000333,0.141311,7,2967.536951,164.863164,423.93385,151.410465,4,6
0,0,17,17,15,19,34,68,56,124,0.000333,0.210282,14,8831.835492,490.657527,630.845392,139.313982,2,6
0,0,11,11,15,16,31,50,38,88,0.000333,0.145323,14,6103.569854,339.087214,435.969275,122.603359,2,6
0,0,13,13,12,16,28,49,39,88,0.000333,0.141016,12,5076.566798,282.031489,423.047233,107.01955,2,6
0,0,16,16,16,19,35,62,47,109,0.000333,0.186364,16,8945.469582,496.970532,559.091849,144.710623,3,6
0,0,14,14,14,23,37,64,49,113,0.000333,0.196223,14,8241.355224,457.853068,588.66823,157.344894,5,6
0,0,11,11,12,14,26,48,36,84,0.000333,0.131612,12,4738.043236,263.224624,394.836936,96.322519,1,6
0,0,14,14,16,17,33,61,44,105,0.000333,0.176554,16,8474.582121,470.810118,529.661383,133.486868,2,6
0,0,10,10,16,15,31,49,33,82,0.000333,0.135415,16,6499.905559,361.105864,406.244097,122.603359,2,6
0,0,10,10,14,22,36,46,36,82,0.000333,0.141311,7,2967.536951,164.863164,423.93385,151.410465,4,6
0,0,31,31,20,52,72,159,104,263,0.000333,0.540897,20,32453.80551,1802.989195,1622.690275,382.861427,10,6
0,0,19,19,16,27,43,94,62,156,0.000333,0.282166,16,13543.95683,752.442046,846.497302,192.381963,6,6
0,0,13,13,16,15,31,48,37,85,0.000333,0.140369,16,6737.706982,374.317055,421.106686,122.603359,2,6
0,0,13,13,14,21,35,55,39,94,0.000333,0.160718,7,3375.068225,187.50379,482.152604,145.541635,5,6
0,0,14,14,14,16,30,51,47,98,0.000333,0.160292,14,6732.253897,374.014105,480.875278,117.302969,1,6
0,0,9,9,12,12,24,41,28,69,0.000333,0.105454,12,3796.348951,210.908275,316.362413,86.0391,2,6
0,0,8,8,14,13,27,34,28,62,0.000333,0.098268,14,4127.242352,229.291242,294.803025,101.408685,1,6
0,0,18,18,16,16,32,67,48,115,0.000333,0.191667,24,13800,766.666667,575,128,2,6
0,0,11,11,14,13,27,44,31,75,0.000333,0.118872,14,4992.631877,277.368438,356.616563,101.408685,2,6
0,0,18,18,17,16,33,68,51,119,0.000333,0.200094,24,14406.78961,800.3772,600.2829,133.486868,2,6
0,0,12,12,13,13,26,51,35,86,0.000333,0.134746,12,4850.853789,269.491877,404.237816,96.211433,2,6
0,0,9,9,12,11,23,41,27,68,0.000333,0.102534,12,3691.226556,205.068142,307.602213,81.073298,2,6
0,0,10,10,11,13,24,33,29,62,0.000333,0.094756,10,2842.67675,157.926486,284.267675,86.159464,1,6
0,0,13,13,15,16,31,46,37,83,0.000333,0.137066,14,5756.776113,319.820895,411.198294,122.603359,2,6
0,0,18,18,18,23,41,78,58,136,0.000333,0.242876,18,13115.28731,728.627073,728.627073,179.100575,4,6
0,0,12,12,14,19,33,52,37,89,0.000333,0.14965,7,3142.657536,174.592085,448.951077,134.013592,4,6
0,0,9,9,13,16,29,41,30,71,0.000333,0.114972,6,2069.499904,114.972217,344.916651,112.105716,3,6
0,0,15,15,15,17,32,54,38,92,0.000333,0.153333,14,6440,357.777778,460,128.090227,3,6
0,0,10,10,14,13,27,38,27,65,0.000333,0.103023,14,4326.947627,240.385979,309.067688,101.408685,2,6
0,0,17,17,17,17,34,59,40,99,0.000333,0.167886,16,8058.541141,447.69673,503.658821,138.973737,3,6
0,0,10,10,14,13,27,38,27,65,0.000333,0.103023,14,4326.947627,240.385979,309.067688,101.408685,2,6
0,0,14,14,11,14,25,45,37,82,0.000333,0.126932,10,3807.962076,211.553449,380.796208,91.356717,2,6
0,0,17,17,15,17,32,58,45,103,0.000333,0.171667,14,7210,400.555556,515,128.090227,3,6
0,0,12,12,9,15,24,42,42,84,0.000333,0.128379,8,3081.0948,171.171933,385.13685,87.132684,1,6
0,0,15,15,13,18,31,54,51,105,0.000333,0.173397,12,6242.287351,346.793742,520.190613,123.164366,2,6
0,0,10,10,11,15,26,38,36,74,0.000333,0.115944,10,3478.325391,193.2403,347.832539,96.657107,1,6
0,0,13,13,15,18,33,50,45,95,0.000333,0.159739,14,6709.044179,372.724677,479.217441,133.662009,2,6
0,0,17,17,15,16,31,71,49,120,0.000333,0.198168,21,12484.5747,693.587483,594.503557,122.603359,3,6
0,0,10,10,14,13,27,44,30,74,0.000333,0.117287,14,4926.063452,273.670192,351.861675,101.408685,2,6
0,0,17,17,17,20,37,70,52,122,0.000333,0.211851,16,10168.85297,564.936276,635.553311,155.92543,3,6
0,0,11,11,15,16,31,49,34,83,0.000333,0.137066,14,5756.776113,319.820895,411.198294,122.603359,2,6
0,0,16,16,16,16,32,63,41,104,0.000333,0.173333,16,8320,462.222222,520,128,3,6
0,0,18,18,17,21,38,77,56,133,0.000333,0.232658,16,11167.58975,620.421653,697.974359,161.725534,2,6
0,0,11,11,15,17,32,50,38,88,0.000333,0.146667,14,6160,342.222222,440,128.090227,2,6
0,0,7,7,10,10,20,25,20,45,0.000333,0.064829,10,1944.867643,108.048202,194.486764,66.438562,1,6
0,0,5,5,9,9,18,21,16,37,0.000333,0.051429,4,617.1489,34.28605,154.287225,57.05865,1,6
0,0,14,14,14,19,33,56,49,105,0.000333,0.176554,14,7415.259355,411.958853,529.661383,134.013592,2,6
0,0,16,16,18,22,40,64,54,118,0.000333,0.209329,18,11303.77527,627.987515,627.987515,173.166146,3,6
0,0,20,20,13,21,34,76,67,143,0.000333,0.242502,18,13095.12935,727.507186,727.507186,140.344382,2,6
0,0,22,22,17,23,40,84,72,156,0.000333,0.27674,24,19925.29879,1106.961044,830.220783,173.528793,3,6
0,0,17,17,16,18,34,65,50,115,0.000333,0.195019,16,9360.931628,520.051757,585.058227,139.05865,4,6
0,0,12,12,13,15,28,52,40,92,0.000333,0.147426,12,5307.319834,294.851102,442.276653,106.709075,3,6
0,0,18,18,14,18,32,74,55,129,0.000333,0.215,21,13545,752.5,645,128.361619,2,6
0,0,21,21,18,20,38,87,63,150,0.000333,0.262396,27,21254.10643,1180.783691,787.189127,161.497212,3,6
0,0,12,12,16,17,33,57,39,96,0.000333,0.161421,16,7748.189367,430.454965,484.261835,133.486868,3,6
0,0,6,6,9,9,18,18,17,35,0.000333,0.048649,4,583.7895,32.43275,145.947375,57.05865,1,6
0,0,17,17,16,20,36,82,53,135,0.000333,0.232647,16,11167.038,620.391,697.939875,150.438562,5,6
0,0,11,11,13,14,27,42,35,77,0.000333,0.122042,12,4393.516052,244.084225,366.126338,101.408685,3,6
0,0,11,11,13,16,29,40,34,74,0.000333,0.11983,12,4313.887124,239.660396,359.490594,112.105716,2,6
0,0,7,7,11,16,27,27,25,52,0.000333,0.082418,5,1236.270751,68.681708,247.25415,102.053748,1,6
0,0,10,10,16,14,30,40,33,73,0.000333,0.119401,16,5731.248216,318.402679,358.203013,117.302969,2,6
0,0,14,14,16,16,32,53,40,93,0.000333,0.155,16,7440,413.333333,465,128,2,6
0,0,14,14,16,15,31,51,39,90,0.000333,0.148626,16,7134.042687,396.335705,445.877668,122.603359,2,6
0,0,14,14,17,16,33,53,43,96,0.000333,0.161421,16,7748.189367,430.454965,484.261835,133.486868,2,6
0,0,8,8,11,11,22,29,21,50,0.000333,0.074324,5,1114.857905,61.93655,222.971581,76.107496,2,6
0,0,8,8,11,12,23,29,22,51,0.000333,0.076901,5,1153.508299,64.083794,230.70166,81.073298,2,6
0,0,8,8,11,11,22,29,21,50,0.000333,0.074324,5,1114.857905,61.93655,222.971581,76.107496,2,6
0,0,10,10,13,14,27,38,25,63,0.000333,0.099853,6,1797.347476,99.852638,299.557913,101.408685,2,6
0,0,18,18,16,23,39,83,61,144,0.000333,0.253699,16,12177.56671,676.531484,761.09792,168.041925,2,6
0,0,9,9,10,13,23,33,30,63,0.000333,0.094995,10,2849.844032,158.324668,284.984403,81.324997,1,6
0,0,11,11,14,15,29,41,35,76,0.000333,0.123069,14,5168.891779,287.160654,369.206556,111.906328,2,6
0,0,14,14,11,15,26,52,48,100,0.000333,0.156681,15,7050.659577,391.70331,470.043972,96.657107,1,6
0,0,16,16,15,17,32,60,53,113,0.000333,0.188333,21,11865,659.166667,565,128.090227,2,6
0,0,35,35,19,46,65,154,115,269,0.000333,0.540006,18,29160.30495,1620.016942,1620.016942,334.794473,8,6
0,0,38,38,21,49,70,167,123,290,0.000333,0.592497,20,35549.8415,1974.991194,1777.492075,367.359448,9,6
0,0,14,14,14,19,33,65,45,110,0.000333,0.184961,14,7768.366944,431.575941,554.883353,134.013592,6,6
0,0,14,14,14,19,33,65,45,110,0.000333,0.184961,14,7768.366944,431.575941,554.883353,134.013592,6,6
0,0,17,17,15,17,32,79,54,133,0.000333,0.221667,21,13965,775.833333,665,128.090227,2,6
0,0,10,10,14,13,27,44,30,74,0.000333,0.117287,14,4926.063452,273.670192,351.861675,101.408685,2,6
0,0,11,11,13,14,27,42,35,77,0.000333,0.122042,12,4393.516052,244.084225,366.126338,101.408685,3,6
0,0,11,11,13,16,29,40,34,74,0.000333,0.11983,12,4313.887124,239.660396,359.490594,112.105716,2,6
0,0,14,14,15,23,38,68,49,117,0.000333,0.204669,14,8596.105267,477.561404,614.007519,162.645284,6,6
0,0,11,11,12,12,24,45,33,78,0.000333,0.119209,12,4291.524901,238.41805,357.627075,86.0391,1,6
0,0,10,10,10,12,22,40,31,71,0.000333,0.10554,10,3166.196449,175.899803,316.619645,76.238831,1,6
0,0,6,6,10,10,20,23,18,41,0.000333,0.059066,5,885.995259,49.221959,177.199052,66.438562,1,6
0,0,13,13,16,18,34,54,47,101,0.000333,0.171278,16,8221.339951,456.741108,513.833747,139.05865,2,6
0,0,14,14,15,23,38,68,49,117,0.000333,0.204669,14,8596.105267,477.561404,614.007519,162.645284,6,6
0,0,17,17,15,17,32,71,50,121,0.000333,0.201667,14,8470,470.555556,605,128.090227,3,6
0,0,34,34,19,50,69,165,107,272,0.000333,0.55384,18,29907.33574,1661.518652,1661.518652,362.903432,12,6
0,0,19,19,15,22,37,87,55,142,0.000333,0.246581,14,10356.39329,575.355183,739.742378,156.710855,6,6
0,0,16,16,15,15,30,68,48,116,0.000333,0.189733,21,11953.18549,664.065861,569.199309,117.206718,2,6
0,0,10,10,14,13,27,44,30,74,0.000333,0.117287,14,4926.063452,273.670192,351.861675,101.408685,2,6
0,0,15,15,15,17,32,53,37,90,0.000333,0.15,14,6300,350,450,128.090227,3,6
0,0,15,15,15,17,32,53,37,90,0.000333,0.15,14,6300,350,450,128.090227,3,6
0,0,15,15,15,16,31,53,36,89,0.000333,0.146974,14,6172.928603,342.940478,440.923472,122.603359,3,6
0,0,17,17,16,19,35,65,41,106,0.000333,0.181235,16,8699.263997,483.292444,543.704,144.710623,3,6
0,0,10,10,14,13,27,37,26,63,0.000333,0.099853,14,4193.810777,232.989488,299.557913,101.408685,2,6
0,0,8,8,9,12,21,28,24,52,0.000333,0.076134,8,1827.204048,101.511336,228.400506,71.548875,1,6
0,0,11,11,13,14,27,41,32,73,0.000333,0.115702,12,4165.281452,231.404525,347.106788,101.408685,2,6
0,0,9,9,13,14,27,37,28,65,0.000333,0.103023,12,3708.812252,206.045125,309.067688,101.408685,2,6
0,0,14,14,10,15,25,54,44,98,0.000333,0.151699,10,4550.979066,252.83217,455.097907,91.82264,1,6
0,0,17,17,14,17,31,67,52,119,0.000333,0.196516,21,12380.53658,687.807588,589.549361,122.789837,2,6
0,0,9,9,13,14,27,40,30,70,0.000333,0.110947,12,3994.105502,221.89475,332.842125,101.408685,2,6
0,0,15,15,11,18,29,56,47,103,0.000333,0.166791,10,5003.720425,277.984468,500.372042,113.112398,1,6
0,0,18,18,15,20,35,69,55,124,0.000333,0.21201,14,8904.435317,494.690851,636.031094,145.041921,2,6
0,0,9,9,13,14,27,37,28,65,0.000333,0.103023,12,3708.812252,206.045125,309.067688,101.408685,2,6
0,0,14,14,10,15,25,54,44,98,0.000333,0.151699,10,4550.979066,252.83217,455.097907,91.82264,1,6
0,0,17,17,14,17,31,67,52,119,0.000333,0.196516,21,12380.53658,687.807588,589.549361,122.789837,2,6
0,0,9,9,13,14,27,40,30,70,0.000333,0.110947,12,3994.105502,221.89475,332.842125,101.408685,2,6
0,0,16,16,10,16,26,60,50,110,0.000333,0.172349,15,7755.725535,430.873641,517.048369,97.219281,1,6
0,0,19,19,14,18,32,73,58,131,0.000333,0.218333,21,13755,764.166667,655,128.361619,2,6
0,0,9,9,13,14,27,40,30,70,0.000333,0.110947,12,3994.105502,221.89475,332.842125,101.408685,2,6
0,0,17,17,13,18,31,61,57,118,0.000333,0.194865,18,10522.71296,584.595165,584.595165,123.164366,2,6
0,0,19,19,17,20,37,69,62,131,0.000333,0.227479,24,16378.52138,909.917855,682.438391,155.92543,3,6
0,0,19,19,16,19,35,69,60,129,0.000333,0.220559,24,15880.26022,882.236679,661.677509,144.710623,3,6
0,0,21,21,19,21,40,77,65,142,0.000333,0.251905,27,20404.27232,1133.570684,755.713789,172.949289,4,6
0,0,19,19,15,19,34,68,60,128,0.000333,0.217065,21,13675.10012,759.727784,651.195244,139.313982,3,6
0,0,21,21,18,21,39,76,65,141,0.000333,0.248414,27,20121.52625,1117.862569,745.241713,167.297316,4,6
0,0,18,18,16,22,38,78,59,137,0.000333,0.239655,16,11503.45711,639.080951,718.966069,162.107496,2,6
0,0,19,19,12,21,33,79,69,148,0.000333,0.248857,18,13438.26593,746.57033,746.57033,135.258216,1,6
0,0,22,22,16,23,39,91,78,169,0.000333,0.297744,24,21437.5914,1190.9773,893.232975,168.041925,2,6
0,0,16,16,15,17,32,60,42,102,0.000333,0.17,14,7140,396.666667,510,128.090227,3,6
0,0,16,16,15,16,31,60,41,101,0.000333,0.166791,14,7005.233583,389.179643,500.373827,122.603359,3,6
0,0,22,22,15,19,34,89,61,150,0.000333,0.254373,21,16025.50795,890.305997,763.119426,139.313982,3,6
0,0,9,9,13,13,26,34,25,59,0.000333,0.092442,6,1663.95566,92.441981,277.325943,96.211433,2,6
0,0,16,16,14,16,30,61,44,105,0.000333,0.171741,14,7213.129176,400.729399,515.223513,117.302969,3,6
0,0,16,16,14,17,31,61,45,106,0.000333,0.175048,14,7352.027325,408.445962,525.144809,122.789837,3,6
0,0,16,16,14,16,30,61,45,106,0.000333,0.173377,14,7281.825644,404.545869,520.130403,117.302969,3,6
0,0,9,9,13,13,26,34,25,59,0.000333,0.092442,6,1663.95566,92.441981,277.325943,96.211433,2,6
0,0,8,8,12,13,25,34,27,61,0.000333,0.094425,12,3399.302731,188.850152,283.275228,91.125266,1,6
0,0,21,21,16,19,35,81,63,144,0.000333,0.246206,24,17726.80211,984.822339,738.616754,144.710623,2,6
0,0,10,10,14,15,29,46,32,78,0.000333,0.126308,14,5304.915247,294.717514,378.922518,111.906328,2,6
0,0,21,21,15,19,34,89,64,153,0.000333,0.259461,21,16346.01811,908.112117,778.381815,139.313982,2,6
0,0,10,10,14,14,28,49,32,81,0.000333,0.129799,14,5451.540482,302.86336,389.395749,106.605938,2,6
0,0,15,15,14,18,32,49,46,95,0.000333,0.158333,14,6650,369.444444,475,128.361619,2,6
0,0,9,9,13,15,28,28,25,53,0.000333,0.08493,6,1528.738865,84.929937,254.789811,106.709075,2,6
0,0,18,18,17,19,36,64,59,123,0.000333,0.211967,24,15261.6186,847.8677,635.900775,150.197491,3,6
0,0,11,11,13,16,29,37,34,71,0.000333,0.114972,12,4138.999808,229.944434,344.916651,112.105716,2,6
0,0,19,19,14,18,32,65,62,127,0.000333,0.211667,21,13335,740.833333,635,128.361619,2,6
0,0,21,21,14,19,33,71,68,139,0.000333,0.233724,21,14724.58643,818.03258,701.170783,134.013592,2,6
0,0,18,18,15,17,32,63,58,121,0.000333,0.201667,21,12705,705.833333,605,128.090227,2,6
0,0,17,17,16,16,32,60,43,103,0.000333,0.171667,16,8240,457.777778,515,128,2,6
0,0,10,10,14,13,27,37,26,63,0.000333,0.099853,14,4193.810777,232.989488,299.557913,101.408685,2,6
0,0,17,17,17,16,33,61,46,107,0.000333,0.179917,16,8636.002732,479.77793,539.750171,133.486868,2,6
0,0,11,11,14,16,30,40,31,71,0.000333,0.11613,7,2438.724626,135.484701,348.389232,117.302969,2,6
0,0,10,10,14,13,27,37,26,63,0.000333,0.099853,14,4193.810777,232.989488,299.557913,101.408685,2,6
0,0,23,23,18,23,41,101,73,174,0.000333,0.310738,27,25169.77932,1398.321073,932.214049,179.100575,3,6
0,0,10,10,15,16,31,47,33,80,0.000333,0.132112,14,5548.699868,308.261104,396.335705,122.603359,2,6
0,0,15,15,13,15,28,61,46,107,0.000333,0.171462,18,9258.96558,514.386977,514.386977,106.709075,2,6
0,0,18,18,17,17,34,74,54,128,0.000333,0.217065,24,15628.68585,868.260325,651.195244,138.973737,3,6
0,0,15,15,17,18,35,65,46,111,0.000333,0.189783,16,9109.606638,506.089258,569.350415,144.545518,2,6
0,0,11,11,16,16,32,52,35,87,0.000333,0.145,16,6960,386.666667,435,128,2,6
0,0,9,9,12,15,27,34,30,64,0.000333,0.101438,12,3651.753602,202.8752,304.3128,101.622909,1,6
0,0,13,13,16,14,30,50,36,86,0.000333,0.140664,16,6751.88146,375.104526,421.992591,117.302969,1,6
0,0,12,12,15,16,31,43,34,77,0.000333,0.127158,14,5340.623623,296.701312,381.473116,122.603359,3,6
0,0,19,19,12,19,31,90,65,155,0.000333,0.255967,18,13822.20771,767.900428,767.900428,123.730173,1,6
0,0,22,22,16,22,38,103,73,176,0.000333,0.307878,24,22167.24582,1231.513656,923.635242,162.107496,2,6
0,0,13,13,15,17,32,47,37,84,0.000333,0.14,14,5880,326.666667,420,128.090227,1,6
0,0,12,12,14,20,34,50,40,90,0.000333,0.152624,14,6410.20318,356.122399,457.871656,139.741531,3,6
0,0,12,12,14,14,28,45,34,79,0.000333,0.126594,14,5316.934544,295.385252,379.781039,106.605938,1,6
0,0,17,17,16,24,40,82,59,141,0.000333,0.250131,16,12006.26978,667.014988,750.391861,174.0391,6,6
0,0,14,14,17,21,38,61,44,105,0.000333,0.183677,16,8816.518223,489.806568,551.032389,161.725534,5,6
0,0,9,9,13,16,29,41,30,71,0.000333,0.114972,6,2069.499904,114.972217,344.916651,112.105716,3,6
0,0,13,13,15,20,35,55,38,93,0.000333,0.159008,7,3339.163244,185.509069,477.023321,145.041921,5,6
0,0,9,9,13,16,29,41,30,71,0.000333,0.114972,6,2069.499904,114.972217,344.916651,112.105716,3,6
0,0,13,13,14,19,33,52,42,94,0.000333,0.158058,14,6638.422661,368.801259,474.173047,134.013592,4,6
0,0,12,12,12,13,25,47,34,81,0.000333,0.125384,12,4513.828216,250.768234,376.152351,91.125266,2,6
0,0,12,12,14,20,34,46,39,85,0.000333,0.144145,7,3027.040391,168.168911,432.434342,139.741531,2,6
0,0,15,15,17,17,34,68,45,113,0.000333,0.191628,16,9198.132817,511.007379,574.883301,138.973737,2,6
0,0,12,12,15,20,35,47,39,86,0.000333,0.147039,7,3087.828376,171.546021,441.118339,145.041921,2,6
0,0,13,13,13,15,28,53,41,94,0.000333,0.15063,12,5422.696352,301.260908,451.891363,106.709075,2,6
0,0,17,17,13,17,30,65,53,118,0.000333,0.193004,18,10422.23563,579.01309,579.01309,117.592585,2,6
0,0,9,9,12,11,23,28,23,51,0.000333,0.076901,12,2768.419917,153.801107,230.70166,81.073298,2,6
0,0,15,15,15,20,35,75,47,122,0.000333,0.208591,14,8760.815393,486.711966,625.772528,145.041921,5,6
0,0,30,30,21,50,71,152,96,248,0.000333,0.508379,10,15251.37286,847.298492,1525.137286,374.431475,11,6
0,0,17,17,16,24,40,84,53,137,0.000333,0.243035,16,11665.66638,648.092577,729.104149,174.0391,6,6
0,0,30,30,20,49,69,152,96,248,0.000333,0.504971,10,15149.14065,841.618925,1514.914065,361.559344,11,6
0,0,17,17,16,24,40,84,53,137,0.000333,0.243035,16,11665.66638,648.092577,729.104149,174.0391,6,6
0,0,13,13,14,17,31,47,38,85,0.000333,0.140369,14,5895.493609,327.527423,421.106686,122.789837,2,6
0,0,10,10,13,15,28,35,27,62,0.000333,0.099352,6,1788.336031,99.352002,298.056005,106.709075,2,6
0,0,15,15,17,19,36,53,48,101,0.000333,0.174054,16,8354.598802,464.144378,522.162425,150.197491,2,6
0,0,17,17,12,18,30,59,57,116,0.000333,0.189733,18,10245.58756,569.199309,569.199309,118.0782,1,6
0,0,19,19,16,20,36,67,62,129,0.000333,0.222307,24,16006.0878,889.2271,666.920325,150.438562,2,6
0,0,11,11,12,16,28,46,40,86,0.000333,0.137811,12,4961.19028,275.621682,413.432523,107.01955,1,6
0,0,13,13,16,19,35,54,45,99,0.000333,0.169266,16,8124.784299,451.376905,507.799019,144.710623,2,6
0,0,18,18,15,17,32,81,56,137,0.000333,0.228333,21,14385,799.166667,685,128.090227,2,6
0,0,10,10,14,13,27,44,30,74,0.000333,0.117287,14,4926.063452,273.670192,351.861675,101.408685,2,6
0,0,9,9,11,12,23,37,26,63,0.000333,0.094995,10,2849.844032,158.324668,284.984403,81.073298,2,6
0,0,11,11,13,13,26,42,29,71,0.000333,0.111244,12,4004.77464,222.48748,333.73122,96.211433,2,6
0,0,9,9,11,13,24,37,27,64,0.000333,0.097813,10,2934.376,163.020889,293.4376,86.159464,2,6
0,0,9,9,11,12,23,37,26,63,0.000333,0.094995,10,2849.844032,158.324668,284.984403,81.073298,2,6
0,0,11,11,15,15,30,42,30,72,0.000333,0.117765,14,4946.14572,274.785873,353.296123,117.206718,2,6
0,0,14,14,15,19,34,59,45,104,0.000333,0.176365,14,7407.345897,411.519216,529.096135,139.313982,3,6
0,0,11,11,17,18,35,53,38,91,0.000333,0.155588,16,7468.236073,414.902004,466.764755,144.545518,2,6
0,0,7,7,14,24,38,44,34,78,0.000333,0.136446,7,2865.368422,159.187135,409.338346,163.342069,2,6
0,0,10,10,18,32,50,67,51,118,0.000333,0.221992,9,5993.775274,332.987515,665.97503,235.05865,3,6
0,0,11,11,13,16,29,42,36,78,0.000333,0.126308,12,4547.070211,252.615012,378.922518,112.105716,1,6
0,0,14,14,17,19,36,55,44,99,0.000333,0.170608,16,8189.161202,454.9534,511.822575,150.197491,2,6
0,0,12,12,15,17,32,59,41,100,0.000333,0.166667,14,7000,388.888889,500,128.090227,5,6
0,0,14,14,17,16,33,54,46,100,0.000333,0.168146,16,8071.030591,448.390588,504.439412,133.486868,2,6
0,0,17,17,15,22,37,81,50,131,0.000333,0.227479,14,9554.137473,530.785415,682.438391,156.710855,6,6
0,0,14,14,17,16,33,52,46,98,0.000333,0.164784,16,7909.609979,439.422777,494.350624,133.486868,2,6
0,0,17,17,15,22,37,81,50,131,0.000333,0.227479,14,9554.137473,530.785415,682.438391,156.710855,6,6
0,0,17,17,15,22,37,81,50,131,0.000333,0.227479,14,9554.137473,530.785415,682.438391,156.710855,6,6
0,0,15,15,18,16,34,56,48,104,0.000333,0.176365,27,14285.59566,793.644203,529.096135,139.05865,2,6
0,0,14,14,17,15,32,47,37,84,0.000333,0.14,16,6720,373.333333,420,128.090227,2,6
0,0,9,9,15,15,30,31,25,56,0.000333,0.091595,7,1923.501113,106.861173,274.785873,117.206718,2,6
0,0,17,17,15,17,32,54,47,101,0.000333,0.168333,14,7070,392.777778,505,128.090227,2,6
0,0,10,10,14,13,27,47,32,79,0.000333,0.125212,14,5258.905577,292.161421,375.636113,101.408685,2,6
0,0,12,12,13,18,31,43,36,79,0.000333,0.130461,12,4696.578102,260.921006,391.381509,123.164366,2,6
0,0,13,13,11,15,26,51,39,90,0.000333,0.141013,10,4230.395746,235.021986,423.039575,96.657107,2,6
0,0,16,16,14,17,31,64,47,111,0.000333,0.183305,14,7698.821066,427.712281,549.91579,122.789837,3,6
0,0,19,19,17,25,42,91,59,150,0.000333,0.269616,16,12941.56182,718.975656,808.847613,185.583273,6,6
0,0,16,16,17,19,36,63,49,112,0.000333,0.193011,16,9264.505603,514.694756,579.0316,150.197491,2,6
0,0,16,16,17,19,36,65,49,114,0.000333,0.196457,16,9429.943203,523.885733,589.37145,150.197491,2,6
0,0,11,11,15,16,31,47,36,83,0.000333,0.137066,14,5756.776113,319.820895,411.198294,122.603359,2,6
0,0,11,11,16,16,32,51,38,89,0.000333,0.148333,16,7120,395.555556,445,128,2,6
0,0,9,9,11,17,28,33,31,64,0.000333,0.102557,5,1538.353575,85.464088,307.670715,107.540616,1,6
0,0,13,13,13,14,27,48,36,84,0.000333,0.133137,12,4792.926602,266.2737,399.41055,101.408685,2,6
0,0,11,11,13,14,27,44,32,76,0.000333,0.120457,12,4336.457402,240.9143,361.37145,101.408685,2,6
0,0,20,20,12,20,32,92,67,159,0.000333,0.265,18,14310,795,795,129.458112,1,6
0,0,23,23,16,22,38,105,75,180,0.000333,0.314876,24,22671.04686,1259.502603,944.626952,162.107496,2,6
0,0,10,10,16,16,32,50,34,84,0.000333,0.14,16,6720,373.333333,420,128,2,6
0,0,17,17,17,30,47,86,64,150,0.000333,0.277729,16,13331.01324,740.611847,833.188328,216.693586,6,6
0,0,8,8,14,13,27,31,23,54,0.000333,0.085588,7,1797.347476,99.852638,256.763925,101.408685,2,6
0,0,14,14,16,15,31,49,37,86,0.000333,0.14202,16,6816.974123,378.720785,426.060883,122.603359,2,6
0,0,14,14,14,16,30,49,41,90,0.000333,0.147207,14,6182.68215,343.482342,441.620154,117.302969,2,6
0,0,12,12,16,17,33,45,35,80,0.000333,0.134517,16,6456.824473,358.712471,403.55153,133.486868,2,6
0,0,14,14,14,18,32,60,46,106,0.000333,0.176667,14,7420,412.222222,530,128.361619,2,6
0,0,17,17,18,21,39,73,54,127,0.000333,0.223749,18,12082.42947,671.246082,671.246082,167.297316,3,6
0,0,12,12,17,18,35,58,40,98,0.000333,0.167557,16,8042.715771,446.817543,502.669736,144.545518,3,6
0,0,15,15,13,20,33,61,41,102,0.000333,0.171509,12,6174.338402,343.0188,514.5282,134.544278,6,6
0,0,17,17,15,20,35,66,44,110,0.000333,0.188074,14,7899.095846,438.838658,564.221132,145.041921,6,6
0,0,11,11,13,16,29,47,33,80,0.000333,0.129546,12,4663.661755,259.09232,388.63848,112.105716,4,6
0,0,15,15,13,21,34,61,42,103,0.000333,0.17467,12,6288.104072,349.339115,524.008673,140.344382,6,6
0,0,11,11,13,16,29,47,33,80,0.000333,0.129546,12,4663.661755,259.09232,388.63848,112.105716,4,6
0,0,15,15,13,20,33,61,42,103,0.000333,0.173191,12,6234.871132,346.38173,519.572594,134.544278,6,6
0,0,11,11,13,16,29,47,33,80,0.000333,0.129546,12,4663.661755,259.09232,388.63848,112.105716,4,6
0,0,15,15,13,20,33,61,41,102,0.000333,0.171509,12,6174.338402,343.0188,514.5282,134.544278,6,6
0,0,11,11,13,16,29,47,33,80,0.000333,0.129546,12,4663.661755,259.09232,388.63848,112.105716,4,6
0,0,13,13,15,18,33,47,42,89,0.000333,0.14965,14,6285.315073,349.184171,448.951077,133.662009,2,6
0,0,20,20,16,23,39,85,68,153,0.000333,0.269556,16,12938.66463,718.814702,808.666539,168.041925,2,6
0,0,17,17,16,24,40,82,59,141,0.000333,0.250131,16,12006.26978,667.014988,750.391861,174.0391,6,6
0,0,13,13,11,14,25,42,35,77,0.000333,0.119192,10,3575.769266,198.653848,357.576927,91.356717,2,6
0,0,16,16,15,17,32,55,43,98,0.000333,0.163333,14,6860,381.111111,490,128.090227,3,6
0,0,10,10,13,14,27,39,28,67,0.000333,0.106192,12,3822.929552,212.384975,318.577463,101.408685,2,6
0,0,17,17,17,28,45,82,61,143,0.000333,0.261778,16,12565.35988,698.075549,785.334993,204.092806,6,6
0,0,13,13,16,16,32,47,38,85,0.000333,0.141667,16,6800,377.777778,425,128,2,6
0,0,8,8,15,15,30,35,27,62,0.000333,0.101409,7,2129.590518,118.310584,304.227217,117.206718,2,6
0,0,10,10,14,17,31,39,29,68,0.000333,0.112295,7,2358.197444,131.010969,336.885349,122.789837,2,6
0,0,9,9,15,16,31,35,28,63,0.000333,0.104038,7,2184.800573,121.37781,312.114368,122.603359,2,6
0,0,12,12,16,17,33,51,45,96,0.000333,0.161421,16,7748.189367,430.454965,484.261835,133.486868,2,6
0,0,16,16,14,17,31,65,47,112,0.000333,0.184957,14,7768.179815,431.565545,554.869987,122.789837,3,6
0,0,19,19,17,19,36,78,55,133,0.000333,0.2292,16,11001.6004,611.200022,687.600025,150.197491,4,6
0,0,16,16,14,17,31,65,47,112,0.000333,0.184957,14,7768.179815,431.565545,554.869987,122.789837,3,6
0,0,19,19,18,19,37,78,55,133,0.000333,0.230952,18,12471.43136,692.857298,692.857298,155.769273,4,6
0,0,12,12,16,16,32,53,37,90,0.000333,0.15,16,7200,400,450,128,3,6
0,0,11,11,13,18,31,47,37,84,0.000333,0.138717,12,4993.829881,277.434993,416.15249,123.164366,3,6
0,0,18,18,15,17,32,63,48,111,0.000333,0.185,14,7770,431.666667,555,128.090227,2,6
0,0,10,10,14,13,27,41,29,70,0.000333,0.110947,14,4659.789752,258.877208,332.842125,101.408685,2,6
0,0,8,8,13,18,31,37,29,66,0.000333,0.108992,6,1961.861739,108.992319,326.976956,123.164366,3,6
0,0,7,7,11,15,26,27,25,52,0.000333,0.081474,5,1222.114327,67.89524,244.422865,96.657107,1,6
0,0,12,12,16,16,32,49,35,84,0.000333,0.14,16,6720,373.333333,420,128,3,6
0,0,21,21,18,25,43,90,70,160,0.000333,0.289401,18,15627.64249,868.202361,868.202361,191.155055,3,6
0,0,12,12,13,13,26,45,34,79,0.000333,0.123778,12,4456.016853,247.556492,371.334738,96.211433,2,6
0,0,10,10,13,13,26,41,30,71,0.000333,0.111244,12,4004.77464,222.48748,333.73122,96.211433,2,6
0,0,12,12,17,16,33,49,34,83,0.000333,0.139562,16,6698.955391,372.164188,418.684712,133.486868,3,6
0,0,14,14,17,16,33,56,41,97,0.000333,0.163102,16,7828.899673,434.938871,489.30623,133.486868,2,6
0,0,14,14,18,17,35,58,45,103,0.000333,0.176105,18,9509.690713,528.316151,528.316151,144.545518,2,6
0,0,14,14,15,16,31,60,41,101,0.000333,0.166791,14,7005.233583,389.179643,500.373827,122.603359,1,6
0,0,15,15,17,18,35,67,46,113,0.000333,0.193203,16,9273.743695,515.207983,579.608981,144.545518,2,6
0,0,8,8,11,12,23,37,26,63,0.000333,0.094995,10,2849.844032,158.324668,284.984403,81.073298,1,6
0,0,11,11,15,15,30,50,34,84,0.000333,0.137393,14,5770.50334,320.583519,412.17881,117.206718,2,6
0,0,10,10,15,14,29,47,31,78,0.000333,0.126308,14,5304.915247,294.717514,378.922518,111.906328,2,6
0,0,7,7,11,11,22,37,25,62,0.000333,0.092162,10,2764.847604,153.602645,276.48476,76.107496,1,6
0,0,10,10,15,14,29,50,33,83,0.000333,0.134404,14,5644.973916,313.609662,403.212423,111.906328,2,6
0,0,14,14,12,14,26,60,43,103,0.000333,0.161382,18,8714.615237,484.145291,484.145291,96.322519,1,6
0,0,17,17,16,16,32,73,51,124,0.000333,0.206667,24,14880,826.666667,620,128,2,6
0,0,10,10,14,14,28,46,31,77,0.000333,0.123389,14,5182.328606,287.907145,370.166329,106.605938,2,6
0,0,15,15,12,17,29,61,46,107,0.000333,0.173268,12,6237.647598,346.535978,519.803966,112.506418,1,6
0,0,18,18,16,19,35,74,54,128,0.000333,0.218849,16,10504.77162,583.598423,656.548226,144.710623,2,6
0,0,10,10,14,14,28,46,31,77,0.000333,0.123389,14,5182.328606,287.907145,370.166329,106.605938,2,6
0,0,15,15,15,20,35,75,47,122,0.000333,0.208591,14,8760.815393,486.711966,625.772528,145.041921,5,6
0,0,13,13,14,17,31,41,37,78,0.000333,0.128809,14,5409.982371,300.554576,386.427312,122.789837,2,6
0,0,9,9,12,13,25,26,23,49,0.000333,0.07585,6,1365.29372,75.849651,227.548953,91.125266,2,6
0,0,15,15,15,20,35,75,47,122,0.000333,0.208591,14,8760.815393,486.711966,625.772528,145.041921,5,6
0,0,15,15,15,20,35,75,47,122,0.000333,0.208591,14,8760.815393,486.711966,625.772528,145.041921,5,6
0,0,11,11,15,15,30,40,32,72,0.000333,0.117765,14,4946.14572,274.785873,353.296123,117.206718,2,6
0,0,12,12,14,16,30,50,37,87,0.000333,0.1423,14,5976.592745,332.03293,426.899482,117.302969,3,6
0,0,11,11,15,14,29,42,29,71,0.000333,0.114972,14,4828.833109,268.268506,344.916651,111.906328,2,6
0,0,8,8,13,18,31,37,29,66,0.000333,0.108992,6,1961.861739,108.992319,326.976956,123.164366,3,6
0,0,20,20,16,22,38,85,62,147,0.000333,0.257148,16,12343.12551,685.729195,771.445344,162.107496,2,6
0,0,15,15,17,16,33,55,40,95,0.000333,0.159739,16,7667.479061,425.971059,479.217441,133.486868,3,6
0,0,23,23,17,21,38,80,74,154,0.000333,0.269394,24,19396.34009,1077.574449,808.180837,161.725534,3,6
0,0,11,11,10,12,22,38,29,67,0.000333,0.099594,10,2987.819184,165.989955,298.781918,76.238831,2,6
0,0,14,14,14,15,29,51,37,88,0.000333,0.142501,14,5985.032586,332.50181,427.502328,111.906328,3,6
0,0,10,10,13,14,27,39,28,67,0.000333,0.106192,12,3822.929552,212.384975,318.577463,101.408685,2,6
0,0,11,11,17,16,33,45,38,83,0.000333,0.139562,16,6698.955391,372.164188,418.684712,133.486868,3,6
0,0,10,10,13,14,27,32,26,58,0.000333,0.091928,6,1654.700851,91.927825,275.783475,101.408685,2,6
0,0,10,10,12,12,24,31,24,55,0.000333,0.084058,12,3026.07525,168.115292,252.172938,86.0391,2,6
0,0,14,14,10,14,24,52,43,95,0.000333,0.14519,15,6533.571564,362.976198,435.571438,86.52225,1,6
0,0,10,10,9,12,21,37,33,70,0.000333,0.102487,8,2459.697757,136.649875,307.46222,71.548875,1,6
0,0,16,16,15,24,39,74,55,129,0.000333,0.227272,14,9545.436407,530.302023,681.816886,168.642459,6,6
0,0,18,18,17,26,43,89,56,145,0.000333,0.262269,16,12588.93423,699.385235,786.808389,191.698301,6,6
0,0,22,22,18,42,60,100,74,174,0.000333,0.3426,9,9250.190673,513.899482,1027.798964,301.535982,7,6
0,0,21,21,18,42,60,99,72,171,0.000333,0.336693,9,9090.704627,505.039146,1010.078292,301.535982,7,6
0,0,13,13,16,18,34,50,44,94,0.000333,0.159407,16,7651.544113,425.085784,478.221507,139.05865,2,6
0,0,14,14,13,14,27,51,42,93,0.000333,0.147402,18,7959.681679,442.204538,442.204538,101.408685,2,6
0,0,13,13,15,14,29,43,34,77,0.000333,0.124688,14,5236.903513,290.939084,374.064537,111.906328,2,6
0,0,12,12,14,17,31,44,35,79,0.000333,0.130461,14,5479.341119,304.40784,391.381509,122.789837,2,6
0,0,15,15,14,20,34,68,47,115,0.000333,0.195019,14,8190.815174,455.045287,585.058227,139.741531,6,6
0,0,16,16,12,19,31,59,46,105,0.000333,0.173397,12,6242.287351,346.793742,520.190613,123.730173,3,6
0,0,19,19,15,21,36,72,54,126,0.000333,0.217137,14,9119.747703,506.65265,651.41055,150.842025,4,6
0,0,10,10,13,14,27,39,28,67,0.000333,0.106192,12,3822.929552,212.384975,318.577463,101.408685,2,6
0,0,11,11,13,17,30,45,31,76,0.000333,0.124308,6,2237.542112,124.307895,372.923685,117.592585,4,6
0,0,12,12,13,18,31,46,33,79,0.000333,0.130461,6,2348.289051,130.460503,391.381509,123.164366,4,6
0,0,16,16,15,22,37,61,52,113,0.000333,0.196223,14,8241.355224,457.853068,588.66823,156.710855,2,6
0,0,19,19,17,24,41,74,60,134,0.000333,0.239304,16,11486.5915,638.143972,717.911969,179.525968,3,6
0,0,14,14,16,21,37,57,46,103,0.000333,0.178858,16,8585.179147,476.954397,536.573697,156.238666,2,6
0,0,19,19,16,25,41,88,57,145,0.000333,0.258948,16,12429.52065,690.528925,776.845041,180.096405,6,6
0,0,19,19,16,23,39,88,56,144,0.000333,0.253699,16,12177.56671,676.531484,761.09792,168.041925,6,6
0,0,15,15,16,30,46,75,56,131,0.000333,0.241196,8,5788.69293,321.594052,723.586616,211.206718,6,6
0,0,14,14,15,29,44,71,53,124,0.000333,0.225657,7,4738.786645,263.265925,676.969521,199.484808,6,6
0,0,20,20,16,22,38,85,62,147,0.000333,0.257148,16,12343.12551,685.729195,771.445344,162.107496,2,6
0,0,9,9,15,16,31,40,29,69,0.000333,0.113947,7,2392.876818,132.937601,341.839545,122.603359,2,6
0,0,12,12,15,15,30,39,30,69,0.000333,0.112858,14,4740.056315,263.336462,338.575451,117.206718,3,6
0,0,12,12,14,22,36,58,43,101,0.000333,0.174054,7,3655.136976,203.063165,522.162425,151.410465,5,6
0,0,17,17,16,27,43,88,57,145,0.000333,0.262269,16,12588.93423,699.385235,786.808389,192.381963,6,6
0,0,17,17,15,22,37,81,50,131,0.000333,0.227479,14,9554.137473,530.785415,682.438391,156.710855,6,6
0,0,18,18,16,23,39,86,52,138,0.000333,0.243129,16,11670.1681,648.342672,729.385506,168.041925,6,6
0,0,9,9,13,14,27,33,26,59,0.000333,0.093513,6,1683.230176,93.512788,280.538363,101.408685,2,6
0,0,11,11,15,14,29,43,35,78,0.000333,0.126308,14,5304.915247,294.717514,378.922518,111.906328,3,6
0,0,11,11,15,16,31,41,34,75,0.000333,0.123855,14,5201.906126,288.994785,371.564723,122.603359,2,6
0,0,11,11,14,14,28,42,35,77,0.000333,0.123389,14,5182.328606,287.907145,370.166329,106.605938,3,6
0,0,11,11,14,16,30,40,34,74,0.000333,0.121037,14,5083.538657,282.418814,363.109904,117.302969,2,6
0,0,7,7,11,11,22,31,22,53,0.000333,0.078783,10,2363.498758,131.305487,236.349876,76.107496,1,6
0,0,14,14,15,17,32,58,41,99,0.000333,0.165,14,6930,385,495,128.090227,4,6
0,0,13,13,14,17,31,54,39,93,0.000333,0.15358,14,6450.363596,358.353533,460.740257,122.789837,4,6
0,0,17,17,16,25,41,84,54,138,0.000333,0.246447,16,11829.47483,657.193046,739.342177,180.096405,6,6
0,0,7,7,11,15,26,27,25,52,0.000333,0.081474,5,1222.114327,67.89524,244.422865,96.657107,1,6
0,0,5,5,10,13,23,23,20,43,0.000333,0.064838,5,972.565821,54.031434,194.513164,81.324997,1,6
0,0,17,17,16,25,41,84,54,138,0.000333,0.246447,16,11829.47483,657.193046,739.342177,180.096405,6,6
0,0,15,15,16,18,34,62,46,108,0.000333,0.183149,16,8791.13579,488.396433,549.445987,139.05865,2,6
0,0,11,11,15,16,31,49,35,84,0.000333,0.138717,14,5826.134861,323.674159,416.15249,122.603359,2,6
0,0,14,14,11,16,27,56,42,98,0.000333,0.155326,10,4659.789752,258.877208,465.978975,102.053748,2,6
0,0,17,17,14,18,32,69,50,119,0.000333,0.198333,14,8330,462.777778,595,128.361619,3,6
0,0,14,14,11,15,26,56,41,97,0.000333,0.151981,10,4559.426527,253.301474,455.942653,96.657107,2,6
0,0,17,17,14,17,31,69,49,118,0.000333,0.194865,14,8184.332305,454.685128,584.595165,122.789837,3,6
0,0,10,10,13,14,27,42,30,72,0.000333,0.114117,12,4108.222802,228.2346,342.3519,101.408685,2,6
0,0,14,14,11,15,26,56,42,98,0.000333,0.153548,10,4606.430924,255.912829,460.643092,96.657107,2,6
0,0,17,17,14,17,31,69,50,119,0.000333,0.196516,14,8253.691053,458.538392,589.549361,122.789837,3,6
0,0,7,7,10,11,21,30,27,57,0.000333,0.083454,10,2503.620931,139.090052,250.362093,71.273029,1,6
0,0,9,9,14,14,28,38,32,70,0.000333,0.112172,14,4711.207824,261.733768,336.514845,106.605938,2,6
0,0,13,13,15,19,34,56,43,99,0.000333,0.167886,14,7051.223498,391.734639,503.658821,139.313982,2,6
0,0,14,14,15,27,42,67,50,117,0.000333,0.2103,7,4416.307969,245.350443,630.901138,186.985321,6,6
0,0,17,17,16,25,41,84,54,138,0.000333,0.246447,16,11829.47483,657.193046,739.342177,180.096405,6,6
0,0,14,14,15,27,42,67,50,117,0.000333,0.2103,7,4416.307969,245.350443,630.901138,186.985321,6,6
0,0,12,12,14,13,27,48,34,82,0.000333,0.129967,14,5458.610852,303.256158,389.900775,101.408685,2,6
0,0,10,10,14,13,27,44,30,74,0.000333,0.117287,14,4926.063452,273.670192,351.861675,101.408685,2,6
0,0,12,12,14,22,36,58,43,101,0.000333,0.174054,7,3655.136976,203.063165,522.162425,151.410465,5,6
0,0,15,15,16,15,31,54,37,91,0.000333,0.150277,16,7213.309828,400.739435,450.831864,122.603359,3,6
0,0,10,10,14,13,27,38,27,65,0.000333,0.103023,14,4326.947627,240.385979,309.067688,101.408685,2,6
0,0,17,17,19,19,38,61,45,106,0.000333,0.185427,18,10013.0457,556.280316,556.280316,161.421246,4,6
0,0,15,15,18,19,37,57,43,100,0.000333,0.173648,18,9377.016058,520.945337,520.945337,155.769273,4,6
0,0,25,25,18,23,41,111,81,192,0.000333,0.342883,27,27773.54959,1542.974977,1028.649985,179.100575,3,6
0,0,10,10,15,16,31,47,33,80,0.000333,0.132112,14,5548.699868,308.261104,396.335705,122.603359,2,6
0,0,12,12,15,18,33,59,42,101,0.000333,0.169828,14,7132.773285,396.265182,509.483806,133.662009,5,6
0,0,12,12,15,18,33,59,42,101,0.000333,0.169828,14,7132.773285,396.265182,509.483806,133.662009,5,6
0,0,12,12,15,17,32,59,41,100,0.000333,0.166667,14,7000,388.888889,500,128.090227,5,6
0,0,11,11,14,16,30,47,36,83,0.000333,0.135757,14,5701.806872,316.767048,407.271919,117.302969,1,6
0,0,11,11,14,23,37,47,40,87,0.000333,0.151074,7,3172.5571,176.253172,453.222443,157.344894,2,6
0,0,9,9,12,13,25,44,30,74,0.000333,0.114548,12,4123.744297,229.096905,343.645358,91.125266,1,6
0,0,9,9,12,16,28,33,27,60,0.000333,0.096147,6,1730.647772,96.147098,288.441295,107.01955,2,6
0,0,12,12,12,20,32,45,35,80,0.000333,0.133333,6,2400,133.333333,400,129.458112,4,6
0,0,9,9,12,16,28,33,27,60,0.000333,0.096147,6,1730.647772,96.147098,288.441295,107.01955,2,6
0,0,14,14,14,20,34,50,37,87,0.000333,0.147536,7,3098.26487,172.125826,442.609267,139.741531,4,6
0,0,12,12,12,19,31,45,34,79,0.000333,0.130461,6,2348.289051,130.460503,391.381509,123.730173,4,6
0,0,9,9,12,16,28,33,27,60,0.000333,0.096147,6,1730.647772,96.147098,288.441295,107.01955,2,6
0,0,14,14,13,20,33,49,37,86,0.000333,0.144606,6,2602.907366,144.605965,433.817894,134.544278,4,6
0,0,16,16,18,19,37,75,58,133,0.000333,0.230952,27,18707.14704,1039.285946,692.857298,155.769273,3,6
0,0,11,11,18,17,35,61,45,106,0.000333,0.181235,18,9786.671996,543.704,543.704,144.545518,3,6
0,0,18,18,16,18,34,72,49,121,0.000333,0.205194,16,9849.328061,547.184892,615.583004,139.05865,2,6
0,0,10,10,14,14,28,41,29,70,0.000333,0.112172,14,4711.207824,261.733768,336.514845,106.605938,2,6
0,0,20,20,16,23,39,85,68,153,0.000333,0.269556,16,12938.66463,718.814702,808.666539,168.041925,2,6
0,0,13,13,17,18,35,53,44,97,0.000333,0.165847,16,7960.647242,442.25818,497.540453,144.545518,2,6
0,0,11,11,15,14,29,42,30,72,0.000333,0.116592,14,4896.844843,272.046936,349.774632,111.906328,2,6
0,0,10,10,15,13,28,39,27,66,0.000333,0.105762,14,4441.995948,246.777553,317.285425,106.709075,2,6
0,0,11,11,12,15,27,44,39,83,0.000333,0.131552,12,4735.867952,263.103775,394.655663,101.622909,1,6
0,0,13,13,16,18,34,52,44,96,0.000333,0.162799,16,7814.342924,434.130162,488.396433,139.05865,2,6
0,0,33,33,19,51,70,162,103,265,0.000333,0.54142,18,29236.67999,1624.259999,1624.259999,370.004315,13,6
0,0,17,17,15,21,36,81,49,130,0.000333,0.22403,14,9409.263503,522.736861,672.09025,150.842025,6,6
0,0,12,12,16,16,32,49,34,83,0.000333,0.138333,16,6640,368.888889,415,128,3,6
0,0,12,12,17,15,32,49,34,83,0.000333,0.138333,16,6640,368.888889,415,128.090227,3,6
0,0,12,12,14,22,36,58,43,101,0.000333,0.174054,7,3655.136976,203.063165,522.162425,151.410465,5,6
0,0,8,8,15,14,29,41,27,68,0.000333,0.110114,7,2312.398954,128.466609,330.342708,111.906328,2,6
0,0,29,29,19,46,65,146,91,237,0.000333,0.475767,9,12845.71055,713.650586,1427.301172,334.794473,10,6
0,0,17,17,15,21,36,81,49,130,0.000333,0.22403,14,9409.263503,522.736861,672.09025,150.842025,6,6
0,0,21,21,14,20,34,96,71,167,0.000333,0.283202,21,17841.73218,991.207344,849.606294,139.741531,2,6
0,0,24,24,18,23,41,109,79,188,0.000333,0.33574,27,27194.93398,1510.829665,1007.219777,179.100575,3,6
0,0,10,10,15,16,31,47,33,80,0.000333,0.132112,14,5548.699868,308.261104,396.335705,122.603359,2,6
0,0,10,10,15,14,29,42,29,71,0.000333,0.114972,14,4828.833109,268.268506,344.916651,111.906328,2,6
0,0,14,14,15,17,32,59,45,104,0.000333,0.173333,14,7280,404.444444,520,128.090227,2,6
0,0,18,18,16,21,37,85,55,140,0.000333,0.243108,16,11669.17554,648.28753,729.323471,156.238666,5,6
0,0,11,11,14,24,38,47,41,88,0.000333,0.153939,7,3232.723348,179.595742,461.817621,163.342069,2,6
0,0,13,13,15,26,41,60,48,108,0.000333,0.192872,7,4050.309315,225.017184,578.615616,180.814792,4,6
0,0,11,11,14,25,39,53,41,94,0.000333,0.165609,7,3477.79466,193.210814,496.827809,169.399374,4,6
0,0,14,14,16,26,42,64,50,114,0.000333,0.204908,8,4917.79349,273.210749,614.724186,186.211433,4,6
0,0,12,12,15,27,42,57,46,103,0.000333,0.185136,7,3887.860862,215.99227,555.408695,186.985321,4,6
0,0,9,9,13,17,30,41,31,72,0.000333,0.117765,6,2119.776737,117.765374,353.296123,117.592585,3,6
0,0,11,11,14,20,34,47,38,85,0.000333,0.144145,7,3027.040391,168.168911,432.434342,139.741531,3,6
0,0,18,18,17,19,36,65,57,122,0.000333,0.210244,24,15137.5404,840.974467,630.73085,150.197491,4,6
0,0,18,18,17,19,36,65,57,122,0.000333,0.210244,24,15137.5404,840.974467,630.73085,150.197491,4,6
0,0,20,20,19,20,39,70,60,130,0.000333,0.229034,27,18551.76179,1030.653433,687.102288,167.149185,4,6
0,0,18,18,17,20,37,65,58,123,0.000333,0.213588,16,10252.20422,569.566901,640.762764,155.92543,4,6
0,0,18,18,17,20,37,65,58,123,0.000333,0.213588,16,10252.20422,569.566901,640.762764,155.92543,4,6
0,0,18,18,17,20,37,65,58,123,0.000333,0.213588,16,10252.20422,569.566901,640.762764,155.92543,4,6
0,0,19,19,13,19,32,84,62,146,0.000333,0.243333,18,13140,730,730,128.816339,1,6
0,0,22,22,17,21,38,97,70,167,0.000333,0.292135,24,21033.69347,1168.538526,876.403895,161.725534,2,6
0,0,10,10,16,17,33,52,35,87,0.000333,0.146287,16,7021.796614,390.099812,438.862288,133.486868,2,6
0,0,16,16,14,18,32,58,53,111,0.000333,0.185,14,7770,431.666667,555,128.361619,3,6
0,0,18,18,17,20,37,66,58,124,0.000333,0.215324,16,10335.55548,574.197527,645.972217,155.92543,4,6
0,0,16,16,12,15,27,64,48,112,0.000333,0.177516,18,9585.853204,532.5474,532.5474,101.622909,1,6
0,0,19,19,16,17,33,77,56,133,0.000333,0.223635,24,16101.70603,894.539224,670.904418,133.486868,2,6
0,0,10,10,13,14,27,42,30,72,0.000333,0.114117,12,4108.222802,228.2346,342.3519,101.408685,2,6
0,0,15,15,12,17,29,61,46,107,0.000333,0.173268,12,6237.647598,346.535978,519.803966,112.506418,1,6
0,0,18,18,16,19,35,74,54,128,0.000333,0.218849,16,10504.77162,583.598423,656.548226,144.710623,2,6
0,0,10,10,14,14,28,46,31,77,0.000333,0.123389,14,5182.328606,287.907145,370.166329,106.605938,2,6
0,0,14,14,11,14,25,59,43,102,0.000333,0.157891,15,7105.09997,394.727776,473.673331,91.356717,1,6
0,0,17,17,15,16,31,72,51,123,0.000333,0.203122,21,12796.68907,710.927171,609.366146,122.603359,2,6
0,0,10,10,14,14,28,46,31,77,0.000333,0.123389,14,5182.328606,287.907145,370.166329,106.605938,2,6
0,0,14,14,12,14,26,62,43,105,0.000333,0.164515,18,8883.831067,493.54617,493.54617,96.322519,1,6
0,0,17,17,16,16,32,75,51,126,0.000333,0.21,24,15120,840,630,128,2,6
0,0,10,10,14,14,28,46,31,77,0.000333,0.123389,14,5182.328606,287.907145,370.166329,106.605938,2,6
0,0,9,9,10,12,22,37,27,64,0.000333,0.095135,10,2854.036236,158.557569,285.403624,76.238831,1,6
0,0,12,12,14,14,28,50,35,85,0.000333,0.136208,14,5720.752357,317.819575,408.625168,106.605938,2,6
0,0,10,10,14,14,28,46,31,77,0.000333,0.123389,14,5182.328606,287.907145,370.166329,106.605938,2,6
0,0,13,13,11,16,27,48,39,87,0.000333,0.137892,10,4136.752127,229.819563,413.675213,102.053748,2,6
0,0,16,16,15,19,34,61,47,108,0.000333,0.183149,14,7692.243816,427.346879,549.445987,139.313982,3,6
0,0,10,10,15,17,32,43,31,74,0.000333,0.123333,7,2590,143.888889,370,128.090227,2,6
0,0,9,9,13,14,27,33,30,63,0.000333,0.099853,12,3594.694952,199.705275,299.557913,101.408685,2,6
0,0,10,10,13,17,30,33,33,66,0.000333,0.107952,6,1943.128676,107.951593,323.854779,117.592585,2,6
0,0,14,14,16,18,34,66,47,113,0.000333,0.191628,16,9198.132817,511.007379,574.883301,139.05865,5,6
0,0,17,17,17,18,35,62,50,112,0.000333,0.191493,16,9191.675166,510.64862,574.479698,144.545518,2,6
0,0,13,13,15,13,28,51,35,86,0.000333,0.137811,14,5788.055326,321.558629,413.432523,106.709075,2,6
0,0,11,11,15,13,28,47,31,78,0.000333,0.124991,14,5249.631575,291.646199,374.973684,106.709075,2,6
0,0,12,12,12,13,25,47,34,81,0.000333,0.125384,12,4513.828216,250.768234,376.152351,91.125266,2,6
0,0,9,9,11,13,24,37,27,64,0.000333,0.097813,10,2934.376,163.020889,293.4376,86.159464,2,6
0,0,10,10,13,14,27,43,32,75,0.000333,0.118872,12,4279.398752,237.744375,356.616563,101.408685,2,6
0,0,9,9,11,11,22,37,26,63,0.000333,0.093648,10,2809.44192,156.080107,280.944192,76.107496,2,6
0,0,12,12,15,25,40,59,43,102,0.000333,0.180946,7,3799.85666,211.103148,542.836666,174.699764,4,6
0,0,11,11,14,24,38,54,41,95,0.000333,0.166184,7,3489.871796,193.881766,498.553114,163.342069,4,6
0,0,9,9,13,23,36,40,35,75,0.000333,0.129248,6,2326.466251,129.248125,387.744375,152.147641,2,6
0,0,9,9,13,23,36,40,35,75,0.000333,0.129248,6,2326.466251,129.248125,387.744375,152.147641,2,6
0,0,9,9,12,13,25,38,30,68,0.000333,0.105261,12,3789.386651,210.521481,315.782221,91.125266,1,6
0,0,5,5,12,11,23,26,19,45,0.000333,0.067853,6,1221.361728,67.853429,203.560288,81.073298,1,6
0,0,16,16,18,21,39,69,53,122,0.000333,0.21494,18,11606.74327,644.819071,644.819071,167.297316,3,6
0,0,19,19,11,19,30,71,57,128,0.000333,0.209361,15,9421.229944,523.401664,628.081996,118.764371,2,6
0,0,22,22,15,22,37,84,65,149,0.000333,0.258736,14,10866.91972,603.717762,776.208551,156.710855,3,6
0,0,10,10,15,18,33,44,32,76,0.000333,0.127791,7,2683.617671,149.089871,383.373953,133.662009,2,6
0,0,12,12,15,15,30,44,32,76,0.000333,0.124308,14,5220.931594,290.051755,372.923685,117.206718,3,6
0,0,17,17,16,27,43,88,57,145,0.000333,0.262269,16,12588.93423,699.385235,786.808389,192.381963,6,6
0,0,17,17,16,25,41,82,60,142,0.000333,0.253591,16,12172.35815,676.24212,760.772385,180.096405,6,6
0,0,12,12,16,19,35,55,40,95,0.000333,0.162427,16,7796.510186,433.139455,487.281887,144.710623,2,6
0,0,11,11,15,14,29,43,35,78,0.000333,0.126308,14,5304.915247,294.717514,378.922518,111.906328,3,6
0,0,11,11,15,16,31,41,34,75,0.000333,0.123855,14,5201.906126,288.994785,371.564723,122.603359,2,6
0,0,12,12,17,19,36,56,40,96,0.000333,0.165438,16,7941.004802,441.166933,496.3128,150.197491,2,6
0,0,7,7,10,15,25,27,22,49,0.000333,0.07585,5,1137.744766,63.208043,227.548953,91.82264,2,6
0,0,8,8,10,15,25,28,24,52,0.000333,0.080494,5,1207.402609,67.077923,241.480522,91.82264,2,6
0,0,15,15,10,15,25,59,46,105,0.000333,0.162535,15,7314.073499,406.337417,487.6049,91.82264,1,6
0,0,18,18,14,17,31,72,54,126,0.000333,0.208076,21,13108.80344,728.266858,624.228735,122.789837,2,6
0,0,10,10,13,14,27,45,32,77,0.000333,0.122042,12,4393.516052,244.084225,366.126338,101.408685,2,6
0,0,5,5,12,13,25,26,19,45,0.000333,0.069658,6,1253.841171,69.657843,208.973529,91.125266,3,6
0,0,6,6,12,14,26,27,21,48,0.000333,0.075207,6,1353.726639,75.207035,225.621106,96.322519,3,6
0,0,7,7,11,16,27,27,25,52,0.000333,0.082418,5,1236.270751,68.681708,247.25415,102.053748,1,6
0,0,11,11,14,24,38,54,41,95,0.000333,0.166184,7,3489.871796,193.881766,498.553114,163.342069,4,6
0,0,8,8,12,13,25,37,28,65,0.000333,0.100617,12,3622.207828,201.233768,301.850652,91.125266,1,6
0,0,15,15,13,17,30,69,51,120,0.000333,0.196276,18,10598.88369,588.826871,588.826871,117.592585,1,6
0,0,13,13,16,26,42,58,47,105,0.000333,0.188731,8,4529.546635,251.64148,566.193329,186.211433,4,6
0,0,9,9,13,22,35,40,34,74,0.000333,0.126522,6,2277.40166,126.522314,379.566943,146.213212,2,6
0,0,11,11,13,24,37,49,40,89,0.000333,0.154547,6,2781.848097,154.547117,463.64135,158.144816,3,6
0,0,9,9,13,22,35,40,34,74,0.000333,0.126522,6,2277.40166,126.522314,379.566943,146.213212,2,6
0,0,14,14,14,24,38,63,47,110,0.000333,0.192424,7,4040.904185,224.494677,577.272026,163.342069,6,6
0,0,21,21,16,22,38,82,72,154,0.000333,0.269394,24,19396.34009,1077.574449,808.180837,162.107496,2,6
0,0,11,11,10,12,22,38,29,67,0.000333,0.099594,10,2987.819184,165.989955,298.781918,76.238831,2,6
0,0,14,14,14,15,29,51,37,88,0.000333,0.142501,14,5985.032586,332.50181,427.502328,111.906328,3,6
0,0,10,10,13,14,27,39,28,67,0.000333,0.106192,12,3822.929552,212.384975,318.577463,101.408685,2,6
0,0,15,15,15,16,31,49,41,90,0.000333,0.148626,14,6242.287351,346.793742,445.877668,122.603359,3,6
0,0,15,15,15,17,32,49,42,91,0.000333,0.151667,14,6370,353.888889,455,128.090227,3,6
0,0,15,15,15,17,32,49,41,90,0.000333,0.15,14,6300,350,450,128.090227,3,6
0,0,11,11,10,12,22,38,29,67,0.000333,0.099594,10,2987.819184,165.989955,298.781918,76.238831,2,6
0,0,14,14,14,15,29,51,37,88,0.000333,0.142501,14,5985.032586,332.50181,427.502328,111.906328,3,6
0,0,10,10,13,14,27,39,28,67,0.000333,0.106192,12,3822.929552,212.384975,318.577463,101.408685,2,6
0,0,18,18,11,17,28,66,54,120,0.000333,0.192294,15,8653.23886,480.735492,576.882591,107.540616,2,6
0,0,21,21,15,20,35,79,62,141,0.000333,0.241076,21,15187.80701,843.767056,723.228905,145.041921,3,6
0,0,10,10,15,17,32,44,32,76,0.000333,0.126667,7,2660,147.777778,380,128.090227,2,6
0,0,31,31,23,50,73,148,102,250,0.000333,0.515819,22,34044.03507,1891.335282,1547.45614,386.234734,11,6
0,0,30,30,23,50,73,147,100,247,0.000333,0.509629,22,33635.50665,1868.639258,1528.886666,386.234734,11,6
0,0,31,31,23,50,73,148,102,250,0.000333,0.515819,22,34044.03507,1891.335282,1547.45614,386.234734,11,6
0,0,30,30,23,50,73,147,100,247,0.000333,0.509629,22,33635.50665,1868.639258,1528.886666,386.234734,11,6
0,0,31,31,23,49,72,148,102,250,0.000333,0.51416,22,33934.58751,1885.254862,1542.48125,379.162707,11,6
0,0,30,30,23,49,72,147,100,247,0.000333,0.50799,22,33527.37246,1862.631803,1523.971475,379.162707,11,6
0,0,31,31,23,51,74,148,103,251,0.000333,0.519524,22,34288.60149,1904.922305,1558.572795,393.335617,11,6
0,0,30,30,23,51,74,147,101,248,0.000333,0.513315,11,16939.38878,941.077155,1539.944435,393.335617,11,6
0,0,20,20,18,19,37,72,64,136,0.000333,0.236162,27,19129.11276,1062.728487,708.485658,155.769273,3,6
0,0,19,19,17,19,36,68,62,130,0.000333,0.22403,24,16130.16601,896.120334,672.09025,150.197491,3,6
0,0,17,17,17,16,33,69,46,115,0.000333,0.193368,16,9281.68518,515.649177,580.105324,133.486868,2,6
0,0,11,11,15,13,28,47,31,78,0.000333,0.124991,14,5249.631575,291.646199,374.973684,106.709075,2,6
0,0,19,19,17,17,34,73,49,122,0.000333,0.20689,16,9930.727466,551.707081,620.670467,138.973737,3,6
0,0,11,11,15,13,28,47,31,78,0.000333,0.124991,14,5249.631575,291.646199,374.973684,106.709075,2,6
0,0,13,13,11,14,25,42,35,77,0.000333,0.119192,10,3575.769266,198.653848,357.576927,91.356717,2,6
0,0,16,16,15,17,32,55,43,98,0.000333,0.163333,14,6860,381.111111,490,128.090227,3,6
0,0,18,18,11,16,27,71,55,126,0.000333,0.199705,15,8986.737379,499.263188,599.115825,102.053748,1,6
0,0,21,21,15,18,33,84,63,147,0.000333,0.247175,21,15572.04465,865.113591,741.525936,133.662009,2,6
0,0,10,10,14,14,28,49,33,82,0.000333,0.131401,14,5518.843451,306.602414,394.203104,106.605938,2,6
0,0,7,7,10,11,21,36,25,61,0.000333,0.08931,10,2679.313628,148.850757,267.931363,71.273029,1,6
0,0,10,10,14,14,28,49,33,82,0.000333,0.131401,14,5518.843451,306.602414,394.203104,106.605938,2,6
0,0,9,9,10,12,22,37,27,64,0.000333,0.095135,10,2854.036236,158.557569,285.403624,76.238831,1,6
0,0,12,12,14,14,28,50,35,85,0.000333,0.136208,14,5720.752357,317.819575,408.625168,106.605938,2,6
0,0,10,10,14,14,28,46,31,77,0.000333,0.123389,14,5182.328606,287.907145,370.166329,106.605938,2,6
0,0,17,17,11,17,28,74,53,127,0.000333,0.203511,15,9158.011127,508.778396,610.534075,107.540616,1,6
0,0,20,20,15,19,34,87,61,148,0.000333,0.250982,21,15811.83451,878.435251,752.944501,139.313982,2,6
0,0,10,10,14,15,29,51,33,84,0.000333,0.136023,14,5712.98565,317.388092,408.070404,111.906328,2,6
0,0,17,17,12,17,29,66,52,118,0.000333,0.191081,18,10318.35163,573.241757,573.241757,112.506418,1,6
0,0,20,20,16,19,35,79,60,139,0.000333,0.237657,24,17111.28815,950.627119,712.970339,144.710623,2,6
0,0,10,10,14,16,30,48,33,81,0.000333,0.132486,14,5564.413935,309.134108,397.458138,117.302969,2,6
0,0,13,13,11,14,25,48,45,93,0.000333,0.14396,15,6478.179385,359.898855,431.878626,91.356717,1,6
0,0,15,15,15,16,31,56,50,106,0.000333,0.175048,21,11028.04099,612.668944,525.144809,122.603359,2,6
0,0,11,11,14,14,28,39,34,73,0.000333,0.116979,14,4913.11673,272.950929,350.936909,106.605938,2,6
0,0,17,17,14,17,31,57,54,111,0.000333,0.183305,21,11548.2316,641.568422,549.91579,122.789837,2,6
0,0,17,17,15,17,32,60,54,114,0.000333,0.19,21,11970,665,570,128.090227,2,6
0,0,8,8,9,12,21,28,24,52,0.000333,0.076134,8,1827.204048,101.511336,228.400506,71.548875,1,6
0,0,11,11,13,14,27,41,32,73,0.000333,0.115702,12,4165.281452,231.404525,347.106788,101.408685,2,6
0,0,9,9,13,14,27,37,28,65,0.000333,0.103023,12,3708.812252,206.045125,309.067688,101.408685,2,6
0,0,10,10,11,14,25,41,34,75,0.000333,0.116096,10,3482.892142,193.494008,348.289214,91.356717,1,6
0,0,13,13,15,17,32,54,42,96,0.000333,0.16,14,6720,373.333333,480,128.090227,2,6
0,0,9,9,15,16,31,42,31,73,0.000333,0.120552,7,2531.594315,140.644129,361.656331,122.603359,2,6
0,0,8,8,13,12,25,30,25,55,0.000333,0.085137,12,3064.945085,170.274727,255.41209,91.125266,2,6
0,0,12,12,15,14,29,42,35,77,0.000333,0.124688,14,5236.903513,290.939084,374.064537,111.906328,2,6
0,0,14,14,15,25,40,64,49,113,0.000333,0.200459,7,4209.645123,233.869174,601.377875,174.699764,4,6
0,0,14,14,14,19,33,56,49,105,0.000333,0.176554,14,7415.259355,411.958853,529.661383,134.013592,2,6
0,0,16,16,18,22,40,64,54,118,0.000333,0.209329,18,11303.77527,627.987515,627.987515,173.166146,3,6
0,0,30,30,20,52,72,156,99,255,0.000333,0.524444,10,15733.30875,874.072709,1573.330875,382.861427,11,6
0,0,17,17,16,26,42,88,56,144,0.000333,0.258831,16,12423.89934,690.21663,776.493709,186.211433,6,6
0,0,17,17,16,16,32,66,46,112,0.000333,0.186667,16,8960,497.777778,560,128,2,6
0,0,11,11,15,13,28,50,33,83,0.000333,0.133003,14,5586.146419,310.341468,399.010459,106.709075,2,6
0,0,21,21,16,18,34,78,58,136,0.000333,0.230632,24,16605.47871,922.526595,691.894946,139.05865,2,6
0,0,11,11,15,13,28,50,33,83,0.000333,0.133003,14,5586.146419,310.341468,399.010459,106.709075,2,6
0,0,16,16,15,21,36,78,49,127,0.000333,0.21886,14,9192.126653,510.673703,656.580475,150.842025,5,6
0,0,17,17,15,21,36,81,53,134,0.000333,0.230923,14,9698.779303,538.821072,692.76995,150.842025,5,6
0,0,13,13,16,18,34,49,39,88,0.000333,0.149232,16,7163.14768,397.952649,447.69673,139.05865,3,6
0,0,16,16,16,24,40,75,55,130,0.000333,0.230617,16,11069.61044,614.978358,691.850652,174.0391,6,6
0,0,9,9,12,13,25,34,26,60,0.000333,0.092877,12,3343.576457,185.754248,278.631371,91.125266,1,6
0,0,21,21,16,18,34,78,58,136,0.000333,0.230632,24,16605.47871,922.526595,691.894946,139.05865,2,6
0,0,11,11,15,13,28,50,33,83,0.000333,0.133003,14,5586.146419,310.341468,399.010459,106.709075,2,6
0,0,17,17,15,16,31,68,51,119,0.000333,0.196516,21,12380.53658,687.807588,589.549361,122.603359,2,6
0,0,11,11,15,13,28,50,33,83,0.000333,0.133003,14,5586.146419,310.341468,399.010459,106.709075,2,6
0,0,18,18,17,16,33,70,48,118,0.000333,0.198413,24,14285.72415,793.651341,595.238506,133.486868,2,6
0,0,11,11,15,13,28,47,31,78,0.000333,0.124991,14,5249.631575,291.646199,374.973684,106.709075,2,6
0,0,18,18,18,16,34,71,51,122,0.000333,0.20689,27,16758.1026,931.0057,620.670467,139.05865,2,6
0,0,12,12,15,15,30,40,30,70,0.000333,0.114494,14,4808.752784,267.152932,343.482342,117.206718,3,6
0,0,12,12,16,13,29,40,29,69,0.000333,0.111734,16,5363.211019,297.956168,335.200689,112.105716,3,6
0,0,12,12,15,14,29,42,35,77,0.000333,0.124688,14,5236.903513,290.939084,374.064537,111.906328,2,6
0,0,10,10,16,14,30,42,33,75,0.000333,0.122672,16,5888.268715,327.12604,368.016795,117.302969,2,6
0,0,14,14,13,19,32,55,49,104,0.000333,0.173333,12,6240,346.666667,520,128.816339,2,6
0,0,16,16,17,22,39,63,54,117,0.000333,0.206131,16,9894.272954,549.681831,618.39206,167.594364,3,6
0,0,12,12,11,14,25,39,35,74,0.000333,0.114548,10,3436.45358,190.914088,343.645358,91.356717,1,6
0,0,11,11,11,13,24,47,33,80,0.000333,0.122266,10,3667.970001,203.776111,366.797,86.159464,1,6
0,0,3,3,8,7,15,11,10,21,0.000333,0.027348,4,328.17881,18.232156,82.044703,43.651484,1,6
0,0,12,12,14,19,33,43,37,80,0.000333,0.134517,7,2824.860707,156.936706,403.55153,134.013592,2,6
0,0,9,9,12,18,30,32,29,61,0.000333,0.099773,6,1795.921958,99.773442,299.320326,118.0782,2,6
0,0,10,10,13,19,32,36,32,68,0.000333,0.113333,6,2040,113.333333,340,128.816339,2,6
0,0,13,13,18,16,34,43,37,80,0.000333,0.135666,18,7325.946491,406.997027,406.997027,139.05865,3,6
0,0,31,31,19,50,69,156,100,256,0.000333,0.521261,18,28148.0807,1563.782261,1563.782261,362.903432,12,6
0,0,31,31,19,50,69,156,100,256,0.000333,0.521261,18,28148.0807,1563.782261,1563.782261,362.903432,12,6
0,0,15,15,15,19,34,75,46,121,0.000333,0.205194,14,8618.162053,478.786781,615.583004,139.313982,5,6
0,0,12,12,14,15,29,38,32,70,0.000333,0.113353,14,4760.821375,264.490076,340.05867,111.906328,3,6
0,0,11,11,13,15,28,36,30,66,0.000333,0.105762,12,3807.425098,211.523617,317.285425,106.709075,3,6
0,0,12,12,14,15,29,38,31,69,0.000333,0.111734,14,4692.809641,260.711647,335.200689,111.906328,3,6
0,0,11,11,13,15,28,36,29,65,0.000333,0.104159,6,1874.86842,104.159357,312.47807,106.709075,3,6
0,0,12,12,14,15,29,38,31,69,0.000333,0.111734,14,4692.809641,260.711647,335.200689,111.906328,3,6
0,0,11,11,13,15,28,36,29,65,0.000333,0.104159,6,1874.86842,104.159357,312.47807,106.709075,3,6
0,0,34,34,23,55,78,175,115,290,0.000333,0.607589,22,40100.86616,2227.825898,1822.766643,422.016709,13,6
0,0,17,17,16,26,42,88,56,144,0.000333,0.258831,16,12423.89934,690.21663,776.493709,186.211433,6,6
0,0,18,18,16,20,36,85,54,139,0.000333,0.23954,16,11497.9132,638.772956,718.619575,150.438562,5,6
0,0,17,17,16,20,36,82,52,134,0.000333,0.230923,16,11084.3192,615.795511,692.76995,150.438562,5,6
0,0,19,19,17,25,42,91,59,150,0.000333,0.269616,16,12941.56182,718.975656,808.847613,185.583273,6,6
0,0,34,34,20,54,74,168,111,279,0.000333,0.577479,20,34648.74978,1924.930543,1732.437489,397.202487,12,6
0,0,19,19,16,25,41,90,59,149,0.000333,0.266092,16,12772.40398,709.577999,798.275249,180.096405,6,6
0,0,20,20,18,25,43,95,61,156,0.000333,0.282166,18,15236.95143,846.497302,846.497302,191.155055,6,6
0,0,12,12,15,15,30,39,32,71,0.000333,0.11613,14,4877.449252,270.969403,348.389232,117.206718,3,6
0,0,11,11,14,15,29,37,30,67,0.000333,0.108495,14,4556.786173,253.154787,325.484727,111.906328,3,6
0,0,11,11,13,14,27,34,29,63,0.000333,0.099853,12,3594.694952,199.705275,299.557913,101.408685,3,6
0,0,10,10,12,14,26,32,27,59,0.000333,0.092442,6,1663.95566,92.441981,277.325943,96.322519,3,6
0,0,7,7,9,9,18,20,17,37,0.000333,0.051429,4,617.1489,34.28605,154.287225,57.05865,1,6
0,0,12,12,15,15,30,37,32,69,0.000333,0.112858,14,4740.056315,263.336462,338.575451,117.206718,3,6
0,0,12,12,15,14,29,39,30,69,0.000333,0.111734,14,4692.809641,260.711647,335.200689,111.906328,3,6
0,0,11,11,14,14,28,37,28,65,0.000333,0.104159,14,4374.692979,243.038499,312.47807,106.605938,3,6
0,0,12,12,15,14,29,39,30,69,0.000333,0.111734,14,4692.809641,260.711647,335.200689,111.906328,3,6
0,0,11,11,14,14,28,37,28,65,0.000333,0.104159,14,4374.692979,243.038499,312.47807,106.605938,3,6
0,0,33,33,20,54,74,165,107,272,0.000333,0.56299,10,16889.71316,938.317397,1688.971315,397.202487,13,6
0,0,17,17,16,24,40,84,53,137,0.000333,0.243035,16,11665.66638,648.092577,729.104149,174.0391,6,6
0,0,33,33,20,54,74,165,106,271,0.000333,0.560921,10,16827.61862,934.867701,1682.761862,397.202487,13,6
0,0,33,33,20,54,74,165,106,271,0.000333,0.560921,10,16827.61862,934.867701,1682.761862,397.202487,13,6
0,0,17,17,16,24,40,84,53,137,0.000333,0.243035,16,11665.66638,648.092577,729.104149,174.0391,6,6
0,0,35,35,22,54,76,170,109,279,0.000333,0.581057,22,38349.77908,2130.543282,1743.171776,408.871421,13,6
0,0,17,17,16,24,40,84,53,137,0.000333,0.243035,16,11665.66638,648.092577,729.104149,174.0391,6,6
0,0,13,13,16,17,33,46,37,83,0.000333,0.139562,16,6698.955391,372.164188,418.684712,133.486868,3,6
0,0,12,12,15,17,32,44,35,79,0.000333,0.131667,14,5530,307.222222,395,128.090227,3,6
0,0,12,12,14,15,29,36,32,68,0.000333,0.110114,14,4624.797907,256.933217,330.342708,111.906328,3,6
0,0,14,14,16,17,33,48,36,84,0.000333,0.141243,16,6779.665696,376.648094,423.729106,133.486868,3,6
0,0,14,14,15,17,32,45,35,80,0.000333,0.133333,14,5600,311.111111,400,128.090227,3,6
0,0,11,11,15,15,30,38,25,63,0.000333,0.103045,7,2163.938753,120.21882,309.134108,117.206718,3,6
0,0,12,12,14,14,28,36,31,67,0.000333,0.107364,14,4509.298917,250.516606,322.09278,106.605938,3,6
0,0,12,12,14,15,29,36,32,68,0.000333,0.110114,14,4624.797907,256.933217,330.342708,111.906328,3,6
0,0,12,12,14,15,29,36,32,68,0.000333,0.110114,14,4624.797907,256.933217,330.342708,111.906328,3,6
0,0,12,12,14,14,28,38,30,68,0.000333,0.108967,14,4576.601886,254.25566,326.900135,106.605938,3,6
0,0,11,11,13,14,27,36,28,64,0.000333,0.101438,12,3651.753602,202.8752,304.3128,101.408685,3,6
0,0,11,11,13,13,26,35,29,64,0.000333,0.100276,12,3609.937704,200.552095,300.828142,96.211433,2,6
0,0,10,10,12,13,25,33,27,60,0.000333,0.092877,12,3343.576457,185.754248,278.631371,91.125266,2,6
0,0,14,14,14,17,31,48,41,89,0.000333,0.146974,14,6172.928603,342.940478,440.923472,122.789837,2,6
0,0,13,13,14,17,31,46,39,85,0.000333,0.140369,14,5895.493609,327.527423,421.106686,122.789837,2,6
0,0,13,13,15,16,31,45,36,81,0.000333,0.133763,14,5618.058616,312.114368,401.289901,122.603359,3,6
0,0,12,12,14,16,30,43,34,77,0.000333,0.125944,14,5289.628062,293.868226,377.830576,117.302969,3,6
0,0,20,20,9,19,28,74,58,132,0.000333,0.211524,12,7614.850197,423.047233,634.57085,109.239948,1,6
0,0,23,23,14,22,36,87,66,153,0.000333,0.263666,21,16610.96903,922.831613,790.998525,151.410465,2,6
0,0,10,10,14,17,31,40,28,68,0.000333,0.112295,7,2358.197444,131.010969,336.885349,122.789837,2,6
0,0,14,14,15,16,31,52,42,94,0.000333,0.155231,14,6519.722344,362.206797,465.694453,122.603359,3,6
0,0,13,13,14,16,30,50,40,90,0.000333,0.147207,14,6182.68215,343.482342,441.620154,117.302969,3,6
0,0,12,12,15,16,31,43,35,78,0.000333,0.128809,14,5409.982371,300.554576,386.427312,122.603359,2,6
0,0,11,11,14,16,30,41,33,74,0.000333,0.121037,14,5083.538657,282.418814,363.109904,117.302969,2,6
0,0,13,13,15,17,32,46,37,83,0.000333,0.138333,14,5810,322.777778,415,128.090227,2,6
0,0,12,12,15,17,32,44,35,79,0.000333,0.131667,14,5530,307.222222,395,128.090227,2,6
0,0,13,13,14,18,32,41,42,83,0.000333,0.138333,14,5810,322.777778,415,128.361619,2,6
0,0,13,13,14,17,31,44,41,85,0.000333,0.140369,14,5895.493609,327.527423,421.106686,122.789837,3,6
0,0,31,31,23,50,73,148,102,250,0.000333,0.515819,22,34044.03507,1891.335282,1547.45614,386.234734,11,6
0,0,30,30,23,50,73,147,100,247,0.000333,0.509629,22,33635.50665,1868.639258,1528.886666,386.234734,11,6
0,0,31,31,23,50,73,148,102,250,0.000333,0.515819,22,34044.03507,1891.335282,1547.45614,386.234734,11,6
0,0,30,30,23,50,73,147,100,247,0.000333,0.509629,22,33635.50665,1868.639258,1528.886666,386.234734,11,6
0,0,12,12,14,15,29,37,36,73,0.000333,0.118211,14,4964.856577,275.825365,354.632613,111.906328,3,6
0,0,10,10,10,13,23,33,29,62,0.000333,0.093487,10,2804.608413,155.811578,280.460841,81.324997,1,6
0,0,10,10,10,13,23,33,29,62,0.000333,0.093487,10,2804.608413,155.811578,280.460841,81.324997,1,6
0,0,14,14,15,14,29,44,31,75,0.000333,0.12145,14,5100.880045,283.382225,364.348575,111.906328,3,6
0,0,13,13,15,14,29,42,29,71,0.000333,0.114972,14,4828.833109,268.268506,344.916651,111.906328,3,6
0,0,12,12,14,13,27,40,28,68,0.000333,0.107777,14,4526.652902,251.480717,323.33235,101.408685,3,6
0,0,11,11,14,13,27,38,26,64,0.000333,0.101438,14,4260.379202,236.687733,304.3128,101.408685,3,6
0,0,13,13,14,16,30,41,41,82,0.000333,0.134122,14,5633.110404,312.950578,402.365029,117.302969,2,6
0,0,9,9,11,11,22,26,17,43,0.000333,0.063919,5,958.777798,53.265433,191.75556,76.107496,2,6
0,0,6,6,9,7,16,14,11,25,0.000333,0.033333,4,400,22.222222,100,48.180809,2,6
0,0,9,9,6,11,17,25,19,44,0.000333,0.059949,3,539.545095,29.974728,179.848365,53.563523,1,6
0,0,12,12,12,14,26,38,27,65,0.000333,0.101843,6,1833.17149,101.842861,305.528582,96.322519,2,6
0,0,10,10,12,14,26,35,24,59,0.000333,0.092442,6,1663.95566,92.441981,277.325943,96.322519,2,6
0,0,13,13,13,14,27,51,43,94,0.000333,0.148986,18,8045.269654,446.959425,446.959425,101.408685,2,6
0,0,12,12,14,14,28,40,29,69,0.000333,0.110569,14,4643.904855,257.994714,331.70749,106.605938,3,6
0,0,11,11,14,14,28,38,27,65,0.000333,0.104159,7,2187.34649,121.519249,312.47807,106.605938,3,6
0,0,13,13,15,13,28,44,33,77,0.000333,0.123389,14,5182.328606,287.907145,370.166329,106.709075,2,6
0,0,12,12,15,13,28,42,31,73,0.000333,0.116979,14,4913.11673,272.950929,350.936909,106.709075,2,6
0,0,13,13,16,15,31,45,34,79,0.000333,0.130461,16,6262.104136,347.894674,391.381509,122.603359,2,6
0,0,12,12,16,15,31,43,32,75,0.000333,0.123855,16,5945.035572,330.279754,371.564723,122.603359,2,6
0,0,13,13,18,20,38,62,40,102,0.000333,0.17843,18,9635.194915,535.288606,535.288606,161.497212,4,6
0,0,14,14,18,20,38,63,42,105,0.000333,0.183677,18,9918.583,551.032389,551.032389,161.497212,4,6
0,0,34,34,20,57,77,173,115,288,0.000333,0.601612,20,36096.69047,2005.371693,1804.834524,418.913293,12,6
0,0,19,19,17,29,46,95,63,158,0.000333,0.290908,16,13963.56463,775.75359,872.722789,210.368317,6,6
0,0,34,34,20,55,75,172,114,286,0.000333,0.593814,20,35628.84291,1979.380162,1781.442145,404.413346,12,6
0,0,19,19,16,27,43,94,62,156,0.000333,0.282166,16,13543.95683,752.442046,846.497302,192.381963,6,6
0,0,12,12,16,13,29,41,28,69,0.000333,0.111734,16,5363.211019,297.956168,335.200689,112.105716,3,6
0,0,11,11,16,13,29,39,26,65,0.000333,0.105256,16,5052.300235,280.683346,315.768765,112.105716,3,6
0,0,13,13,18,15,33,47,34,81,0.000333,0.136199,18,7354.726626,408.595924,408.595924,133.662009,3,6
0,0,12,12,18,15,33,45,32,77,0.000333,0.129473,18,6991.530249,388.418347,388.418347,133.662009,3,6
0,0,11,11,15,12,27,38,27,65,0.000333,0.103023,14,4326.947627,240.385979,309.067688,101.622909,2,6
0,0,10,10,15,12,27,36,25,61,0.000333,0.096683,14,4060.673927,225.592996,290.048138,101.622909,2,6
0,0,13,13,20,17,37,53,39,92,0.000333,0.159757,20,9585.394193,532.5219,479.26971,155.92543,3,6
0,0,12,12,20,17,37,51,37,88,0.000333,0.152811,20,9168.637924,509.368774,458.431896,155.92543,3,6
0,0,13,13,20,18,38,53,40,93,0.000333,0.162686,20,9761.145175,542.285843,488.057259,161.497212,3,6
0,0,12,12,20,18,38,51,38,89,0.000333,0.155689,20,9341.310974,518.961721,467.065549,161.497212,3,6
0,0,13,13,20,18,38,53,40,93,0.000333,0.162686,20,9761.145175,542.285843,488.057259,161.497212,3,6
0,0,12,12,20,18,38,51,38,89,0.000333,0.155689,20,9341.310974,518.961721,467.065549,161.497212,3,6
0,0,14,14,18,17,35,55,44,99,0.000333,0.169266,18,9140.382336,507.799019,507.799019,144.545518,2,6
0,0,13,13,18,17,35,53,42,95,0.000333,0.162427,18,8771.073959,487.281887,487.281887,144.545518,2,6
0,0,13,13,17,21,38,62,41,103,0.000333,0.180179,8,4324.292271,240.23846,540.536534,161.725534,4,6
0,0,14,14,17,21,38,63,43,106,0.000333,0.185427,16,8900.485063,494.471392,556.280316,161.725534,4,6
0,0,13,13,17,21,38,62,41,103,0.000333,0.180179,8,4324.292271,240.23846,540.536534,161.725534,4,6
0,0,14,14,17,21,38,63,43,106,0.000333,0.185427,16,8900.485063,494.471392,556.280316,161.725534,4,6
0,0,12,12,17,19,36,59,39,98,0.000333,0.168884,16,8106.442402,450.357911,506.65265,150.197491,3,6
0,0,13,13,17,19,36,60,41,101,0.000333,0.174054,16,8354.598802,464.144378,522.162425,150.197491,3,6
0,0,14,14,19,19,38,57,45,102,0.000333,0.17843,18,9635.194915,535.288606,535.288606,161.421246,2,6
0,0,13,13,19,19,38,55,43,98,0.000333,0.171432,18,9257.344134,514.296896,514.296896,161.421246,2,6
0,0,9,9,10,11,21,26,24,50,0.000333,0.073205,10,2196.158711,122.008817,219.615871,71.273029,7,6
0,0,12,12,15,14,29,39,31,70,0.000333,0.113353,14,4760.821375,264.490076,340.05867,111.906328,3,6
0,0,11,11,14,14,28,37,29,66,0.000333,0.105762,14,4441.995948,246.777553,317.285425,106.605938,3,6
0,0,14,14,16,15,31,44,33,77,0.000333,0.127158,16,6103.569854,339.087214,381.473116,122.603359,3,6
0,0,13,13,15,15,30,42,31,73,0.000333,0.119401,14,5014.842189,278.602344,358.203013,117.206718,3,6
0,0,12,12,15,14,29,39,31,70,0.000333,0.113353,14,4760.821375,264.490076,340.05867,111.906328,3,6
0,0,11,11,14,14,28,37,29,66,0.000333,0.105762,14,4441.995948,246.777553,317.285425,106.605938,3,6
0,0,28,28,23,45,68,135,92,227,0.000333,0.460618,22,30400.78943,1688.932746,1381.854065,351.175314,9,6
0,0,27,27,23,45,68,134,90,224,0.000333,0.454531,22,29999.01688,1666.612049,1363.591676,351.175314,9,6
0,0,28,28,23,47,70,135,93,228,0.000333,0.465826,11,15372.24181,854.013434,1397.476528,365.107601,9,6
0,0,27,27,23,47,70,134,91,225,0.000333,0.459696,11,15169.97547,842.776415,1379.088679,365.107601,9,6
0,0,28,28,23,47,70,135,93,228,0.000333,0.465826,11,15372.24181,854.013434,1397.476528,365.107601,9,6
0,0,27,27,23,47,70,134,91,225,0.000333,0.459696,11,15169.97547,842.776415,1379.088679,365.107601,9,6
0,0,20,20,18,40,58,93,68,161,0.000333,0.314378,9,8488.214462,471.56747,943.13494,287.935774,7,6
0,0,19,19,18,40,58,92,66,158,0.000333,0.30852,9,8330.048975,462.780499,925.560997,287.935774,7,6
0,0,17,17,15,19,34,79,50,129,0.000333,0.218761,14,9187.957891,510.442105,656.282707,139.313982,5,6
0,0,28,28,23,46,69,135,92,227,0.000333,0.462212,22,30505.97114,1694.776174,1386.635052,358.125775,9,6
0,0,27,27,23,46,69,134,90,224,0.000333,0.456103,11,15051.40426,836.189126,1368.309478,358.125775,9,6
0,0,29,29,23,46,69,137,97,234,0.000333,0.476465,22,31446.6839,1747.037995,1429.394723,358.125775,8,6
0,0,28,28,23,46,69,136,95,231,0.000333,0.470356,22,31043.52129,1724.640072,1411.06915,358.125775,8,6
0,0,12,12,14,15,29,39,32,71,0.000333,0.114972,14,4828.833109,268.268506,344.916651,111.906328,2,6
0,0,11,11,14,15,29,37,30,67,0.000333,0.108495,14,4556.786173,253.154787,325.484727,111.906328,2,6
0,0,33,33,20,53,73,165,106,271,0.000333,0.559147,20,33548.84911,1863.824951,1677.442455,390.018346,13,6
0,0,17,17,16,24,40,84,53,137,0.000333,0.243035,16,11665.66638,648.092577,729.104149,174.0391,6,6
0,0,33,33,21,54,75,165,106,271,0.000333,0.56267,10,16880.09865,937.783258,1688.009865,403.002591,13,6
0,0,17,17,16,24,40,84,53,137,0.000333,0.243035,16,11665.66638,648.092577,729.104149,174.0391,6,6
0,0,33,33,20,55,75,165,107,272,0.000333,0.564746,10,16942.38684,941.243713,1694.238684,404.413346,13,6
0,0,33,33,20,55,75,165,107,272,0.000333,0.564746,10,16942.38684,941.243713,1694.238684,404.413346,13,6
0,0,32,32,21,48,69,158,99,257,0.000333,0.523297,20,31397.81571,1744.323095,1569.890785,360.316866,12,6
0,0,18,18,18,25,43,90,55,145,0.000333,0.262269,18,14162.55101,786.808389,786.808389,191.155055,6,6
0,0,34,34,23,54,77,171,112,283,0.000333,0.591167,22,39017.013,2167.611833,1773.500591,414.80585,13,6
0,0,17,17,16,24,40,84,53,137,0.000333,0.243035,16,11665.66638,648.092577,729.104149,174.0391,6,6
0,0,30,30,19,48,67,153,98,251,0.000333,0.507529,18,27406.59096,1522.588387,1522.588387,348.788823,11,6
0,0,15,15,15,19,34,75,46,121,0.000333,0.205194,14,8618.162053,478.786781,615.583004,139.313982,5,6
0,0,6,6,9,7,16,16,11,27,0.000333,0.036,4,432,24,108,48.180809,2,6
0,0,7,7,8,7,15,19,16,35,0.000333,0.04558,8,1093.929367,60.773854,136.741171,43.651484,1,6
0,0,5,5,8,6,14,13,10,23,0.000333,0.02919,4,350.276653,19.459814,87.569163,39.509775,1,6
0,0,7,7,9,7,16,20,16,36,0.000333,0.048,8,1152,64,144,48.180809,1,6
0,0,11,11,13,14,27,34,29,63,0.000333,0.099853,12,3594.694952,199.705275,299.557913,101.408685,3,6
0,0,10,10,12,14,26,32,27,59,0.000333,0.092442,6,1663.95566,92.441981,277.325943,96.322519,3,6
0,0,15,15,21,18,39,58,42,100,0.000333,0.17618,20,10570.80444,587.266913,528.540222,167.297316,3,6
0,0,14,14,21,18,39,56,40,96,0.000333,0.169133,20,10147.97226,563.776237,507.398613,167.297316,3,6
0,0,12,12,18,16,34,49,38,87,0.000333,0.147536,18,7966.966809,442.609267,442.609267,139.05865,2,6
0,0,11,11,18,16,34,47,36,83,0.000333,0.140753,18,7600.669485,422.259416,422.259416,139.05865,2,6
0,0,30,30,20,52,72,144,100,244,0.000333,0.501821,10,15054.617,836.367611,1505.4617,382.861427,11,6
0,0,29,29,20,51,71,143,98,241,0.000333,0.49403,10,14820.89056,823.382809,1482.089056,375.732254,11,6
0,0,18,18,17,20,37,86,54,140,0.000333,0.243108,16,11669.17554,648.28753,729.323471,155.92543,5,6
0,0,32,32,19,51,70,160,105,265,0.000333,0.54142,18,29236.67999,1624.259999,1624.259999,370.004315,11,6
0,0,17,17,15,22,37,82,53,135,0.000333,0.234425,14,9845.866861,546.992603,703.276204,156.710855,5,6
0,0,30,30,19,48,67,153,98,251,0.000333,0.507529,18,27406.59096,1522.588387,1522.588387,348.788823,11,6
0,0,15,15,15,19,34,75,46,121,0.000333,0.205194,14,8618.162053,478.786781,615.583004,139.313982,5,6
0,0,33,33,19,49,68,165,106,271,0.000333,0.549901,18,29694.64374,1649.70243,1649.70243,355.831405,11,6
0,0,16,16,15,20,35,78,48,126,0.000333,0.21543,14,9048.055242,502.669736,646.28966,145.041921,5,6
0,0,12,12,16,13,29,37,31,68,0.000333,0.110114,16,5285.483323,293.637962,330.342708,112.105716,3,6
0,0,12,12,16,14,30,37,31,68,0.000333,0.111223,16,5338.696968,296.594276,333.668561,117.302969,3,6
0,0,13,13,20,16,36,53,39,92,0.000333,0.158544,20,9512.662003,528.481222,475.6331,150.438562,3,6
0,0,12,12,20,16,36,51,37,88,0.000333,0.151651,20,9099.068003,505.503778,454.9534,150.438562,3,6
0,0,6,6,9,7,16,16,11,27,0.000333,0.036,4,432,24,108,48.180809,2,6
0,0,5,5,8,6,14,13,10,23,0.000333,0.02919,4,350.276653,19.459814,87.569163,39.509775,1,6
0,0,12,12,14,14,28,38,31,69,0.000333,0.110569,14,4643.904855,257.994714,331.70749,106.605938,3,6
0,0,11,11,13,14,27,36,29,65,0.000333,0.103023,12,3708.812252,206.045125,309.067688,101.408685,3,6
0,0,12,12,14,16,30,37,35,72,0.000333,0.117765,14,4946.14572,274.785873,353.296123,117.302969,3,6
0,0,13,13,15,18,33,45,37,82,0.000333,0.13788,14,5790.964449,321.720247,413.640318,133.662009,3,6
0,0,12,12,14,18,32,43,35,78,0.000333,0.13,7,2730,151.666667,390,128.361619,3,6
0,0,13,13,15,17,32,45,36,81,0.000333,0.135,14,5670,315,405,128.090227,3,6
0,0,12,12,14,17,31,43,34,77,0.000333,0.127158,14,5340.623623,296.701312,381.473116,122.789837,3,6
0,0,15,15,16,17,33,49,39,88,0.000333,0.147969,16,7102.50692,394.583718,443.906683,133.486868,3,6
0,0,14,14,15,17,32,47,37,84,0.000333,0.14,14,5880,326.666667,420,128.090227,3,6
0,0,33,33,20,55,75,169,109,278,0.000333,0.577204,10,17316.11596,962.006442,1731.611596,404.413346,13,6
0,0,13,13,15,14,29,40,36,76,0.000333,0.123069,14,5168.891779,287.160654,369.206556,111.906328,2,6
0,0,13,13,16,16,32,41,37,78,0.000333,0.13,16,6240,346.666667,390,128,2,6
0,0,23,23,17,43,60,105,77,182,0.000333,0.358351,8,8600.432707,477.801817,1075.054088,302.816253,9,6
0,0,22,22,17,43,60,104,75,179,0.000333,0.352444,8,8458.667333,469.925963,1057.333417,302.816253,9,6
0,0,31,31,19,48,67,156,99,255,0.000333,0.515618,18,27843.34938,1546.852744,1546.852744,348.788823,12,6
0,0,12,12,15,13,28,36,31,67,0.000333,0.107364,14,4509.298917,250.516606,322.09278,106.709075,3,6
0,0,12,12,15,13,28,37,31,68,0.000333,0.108967,14,4576.601886,254.25566,326.900135,106.709075,3,6
0,0,14,14,16,18,34,42,38,80,0.000333,0.135666,16,6511.952437,361.775135,406.997027,139.05865,3,6
0,0,11,11,14,13,27,33,30,63,0.000333,0.099853,14,4193.810777,232.989488,299.557913,101.408685,2,6
0,0,13,13,14,14,28,39,36,75,0.000333,0.120184,14,5047.722668,280.429037,360.551619,106.605938,2,6
0,0,30,30,23,49,72,145,101,246,0.000333,0.505934,22,33391.63411,1855.090784,1517.80155,379.162707,10,6
0,0,29,29,23,49,72,144,99,243,0.000333,0.499764,22,32984.41906,1832.467725,1499.291775,379.162707,10,6
0,0,11,11,14,13,27,33,30,63,0.000333,0.099853,14,4193.810777,232.989488,299.557913,101.408685,2,6
0,0,12,12,14,14,28,36,32,68,0.000333,0.108967,14,4576.601886,254.25566,326.900135,106.605938,3,6
0,0,18,18,17,19,36,65,57,122,0.000333,0.210244,24,15137.5404,840.974467,630.73085,150.197491,4,6
0,0,14,14,16,19,35,47,39,86,0.000333,0.147039,16,7057.893431,392.105191,441.118339,144.710623,3,6
0,0,10,10,13,15,28,35,26,61,0.000333,0.09775,6,1759.491901,97.74955,293.24865,106.709075,2,6
0,0,19,19,17,27,44,95,62,157,0.000333,0.28571,16,13714.09223,761.894013,857.130764,197.868831,6,6
0,0,18,18,18,27,45,94,58,152,0.000333,0.278254,18,15025.71007,834.761671,834.761671,203.440613,6,6
0,0,33,33,20,56,76,169,110,279,0.000333,0.581057,10,17431.71776,968.428765,1743.171776,411.650438,13,6
0,0,20,20,18,27,45,99,64,163,0.000333,0.298391,18,16113.09699,895.172055,895.172055,203.440613,6,6
0,0,11,11,12,15,27,35,31,66,0.000333,0.104608,12,3765.870902,209.21505,313.822575,101.622909,2,6
0,0,10,10,11,15,26,33,29,62,0.000333,0.097142,5,1457.136313,80.952017,291.427263,96.657107,2,6
0,0,13,13,20,16,36,53,39,92,0.000333,0.158544,20,9512.662003,528.481222,475.6331,150.438562,3,6
0,0,12,12,20,16,36,51,37,88,0.000333,0.151651,20,9099.068003,505.503778,454.9534,150.438562,3,6
0,0,13,13,19,18,37,52,40,92,0.000333,0.159757,18,8626.854773,479.26971,479.26971,155.769273,3,6
0,0,12,12,19,18,37,50,38,88,0.000333,0.152811,18,8251.774131,458.431896,458.431896,155.769273,3,6
0,0,15,15,18,22,40,71,44,115,0.000333,0.204007,18,11016.39116,612.021731,612.021731,173.166146,4,6
0,0,16,16,18,22,40,72,46,118,0.000333,0.209329,18,11303.77527,627.987515,627.987515,173.166146,4,6
0,0,13,13,17,20,37,62,40,102,0.000333,0.177121,16,8501.827893,472.323772,531.364243,155.92543,4,6
0,0,14,14,17,20,37,63,42,105,0.000333,0.182331,16,8751.881654,486.215647,546.992603,155.92543,4,6
0,0,13,13,17,21,38,62,41,103,0.000333,0.180179,8,4324.292271,240.23846,540.536534,161.725534,4,6
0,0,14,14,17,21,38,63,43,106,0.000333,0.185427,16,8900.485063,494.471392,556.280316,161.725534,4,6
0,0,10,10,11,11,22,31,27,58,0.000333,0.086216,10,2586.470339,143.692797,258.647034,76.107496,1,6
0,0,27,27,20,49,69,131,90,221,0.000333,0.449995,10,13499.83905,749.991058,1349.983905,361.559344,9,6
0,0,26,26,20,48,68,130,88,218,0.000333,0.442356,10,13270.66899,737.259389,1327.066899,354.516762,9,6
0,0,12,12,15,16,31,38,35,73,0.000333,0.120552,14,5063.188629,281.288257,361.656331,122.603359,3,6
0,0,14,14,16,18,34,42,38,80,0.000333,0.135666,16,6511.952437,361.775135,406.997027,139.05865,3,6
0,0,6,6,9,8,17,14,12,26,0.000333,0.035425,4,425.096135,23.616452,106.274034,52.529325,2,6
0,0,5,5,8,6,14,11,10,21,0.000333,0.026651,4,319.817813,17.767656,79.954453,39.509775,1,6
0,0,9,9,6,11,17,25,19,44,0.000333,0.059949,3,539.545095,29.974728,179.848365,53.563523,1,6
0,0,12,12,12,14,26,38,27,65,0.000333,0.101843,6,1833.17149,101.842861,305.528582,96.322519,2,6
0,0,10,10,12,14,26,35,24,59,0.000333,0.092442,6,1663.95566,92.441981,277.325943,96.322519,2,6
0,0,12,12,14,14,28,38,30,68,0.000333,0.108967,14,4576.601886,254.25566,326.900135,106.605938,3,6
0,0,11,11,13,14,27,36,28,64,0.000333,0.101438,12,3651.753602,202.8752,304.3128,101.408685,3,6
0,0,11,11,14,12,26,37,27,64,0.000333,0.100276,14,4211.593987,233.977444,300.828142,96.322519,2,6
0,0,10,10,14,12,26,35,25,60,0.000333,0.094009,14,3948.369363,219.353854,282.026383,96.322519,2,6
0,0,14,14,16,14,30,46,31,77,0.000333,0.125944,16,6045.289214,335.849401,377.830576,117.302969,3,6
0,0,13,13,16,14,30,44,29,73,0.000333,0.119401,16,5731.248216,318.402679,358.203013,117.302969,3,6
0,0,14,14,16,14,30,45,31,76,0.000333,0.124308,16,5966.778964,331.48772,372.923685,117.302969,3,6
0,0,13,13,16,14,30,43,29,72,0.000333,0.117765,16,5652.737966,314.040998,353.296123,117.302969,3,6
0,0,17,17,17,17,34,60,48,108,0.000333,0.183149,16,8791.13579,488.396433,549.445987,138.973737,3,6
0,0,14,14,16,17,33,46,35,81,0.000333,0.136199,16,6537.534779,363.196377,408.595924,133.486868,3,6
0,0,13,13,20,17,37,53,39,92,0.000333,0.159757,20,9585.394193,532.5219,479.26971,155.92543,3,6
0,0,12,12,20,17,37,51,37,88,0.000333,0.152811,20,9168.637924,509.368774,458.431896,155.92543,3,6
0,0,13,13,14,14,28,42,35,77,0.000333,0.123389,14,5182.328606,287.907145,370.166329,106.605938,2,6
0,0,12,12,14,14,28,40,33,73,0.000333,0.116979,14,4913.11673,272.950929,350.936909,106.605938,2,6
0,0,12,12,15,14,29,39,30,69,0.000333,0.111734,14,4692.809641,260.711647,335.200689,111.906328,3,6
0,0,11,11,14,14,28,37,28,65,0.000333,0.104159,14,4374.692979,243.038499,312.47807,106.605938,3,6
0,0,8,8,12,11,23,26,21,47,0.000333,0.070869,6,1275.644472,70.869137,212.607412,81.073298,2,6
0,0,29,29,23,45,68,141,98,239,0.000333,0.484968,22,32007.87962,1778.215534,1454.903619,351.175314,9,6
0,0,28,28,23,45,68,140,96,236,0.000333,0.47888,22,31606.10707,1755.894837,1436.641231,351.175314,9,6
0,0,18,18,16,20,36,71,70,141,0.000333,0.242986,24,17495.02621,971.9459,728.959425,150.438562,3,6
0,0,10,10,13,15,28,44,33,77,0.000333,0.123389,12,4441.995948,246.777553,370.166329,106.709075,2,6
0,0,12,12,16,17,33,53,40,93,0.000333,0.156376,16,7506.05845,417.003247,469.128653,133.486868,3,6
0,0,10,10,13,15,28,44,33,77,0.000333,0.123389,12,4441.995948,246.777553,370.166329,106.709075,2,6
0,0,5,5,7,12,19,10,17,27,0.000333,0.038231,3,344.082129,19.115674,114.694043,62.671034,1,6
0,0,14,14,17,19,36,48,40,88,0.000333,0.151651,16,7279.254402,404.403022,454.9534,150.197491,3,6
0,0,11,11,12,17,29,33,29,62,0.000333,0.100398,6,1807.16893,100.398274,301.194822,112.506418,2,6
0,0,13,13,13,19,32,46,61,107,0.000333,0.178333,18,9630,535,535,128.816339,2,6
0,0,7,7,13,16,29,28,25,53,0.000333,0.085824,6,1544.837956,85.824331,257.472993,112.105716,2,6
0,0,8,8,14,17,31,29,26,55,0.000333,0.090827,7,1907.365579,105.964754,272.480797,122.789837,2,6
0,0,17,17,14,22,36,65,71,136,0.000333,0.23437,21,14765.3058,820.294767,703.1098,151.410465,2,6
0,0,9,9,15,18,33,37,36,73,0.000333,0.122747,14,5155.37079,286.409488,368.240771,133.662009,2,6
0,0,5,5,5,12,17,9,21,30,0.000333,0.040875,2,245.24777,13.624876,122.623885,54.62919,1,6
0,0,9,9,15,20,35,37,38,75,0.000333,0.128232,7,2692.873584,149.604088,384.696226,145.041921,2,6
0,0,13,13,14,20,34,46,56,102,0.000333,0.172974,14,7264.896937,403.605385,518.92121,139.741531,2,6
0,0,17,17,14,22,36,58,86,144,0.000333,0.248156,21,15633.8532,868.5474,744.4692,151.410465,2,6
0,0,13,13,14,21,35,47,43,90,0.000333,0.153878,14,6462.896601,359.049811,461.635472,145.541635,2,6
0,0,10,10,13,19,32,33,31,64,0.000333,0.106667,6,1920,106.666667,320,128.816339,2,6
0,0,30,30,20,52,72,131,100,231,0.000333,0.475084,10,14252.52675,791.807042,1425.252675,382.861427,10,6
0,0,29,29,20,52,72,130,98,228,0.000333,0.468914,10,14067.429,781.523834,1406.7429,382.861427,10,6
0,0,15,15,14,20,34,66,46,112,0.000333,0.189932,14,7977.141735,443.174541,569.795838,139.741531,2,6
0,0,11,11,14,17,31,47,35,82,0.000333,0.135415,14,5687.417364,315.967631,406.244097,122.789837,2,6
0,0,18,18,15,24,39,74,58,132,0.000333,0.232558,14,9767.4233,542.634628,697.673093,168.642459,2,6
0,0,11,11,14,17,31,47,35,82,0.000333,0.135415,14,5687.417364,315.967631,406.244097,122.789837,2,6
0,0,9,9,15,14,29,40,33,73,0.000333,0.118211,14,4964.856577,275.825365,354.632613,111.906328,2,6
0,0,14,14,15,22,37,57,61,118,0.000333,0.204905,14,8606.01696,478.112053,614.715497,156.710855,2,6
0,0,11,11,13,20,33,48,36,84,0.000333,0.141243,6,2542.374636,141.243035,423.729106,134.544278,2,6
0,0,11,11,13,20,33,45,36,81,0.000333,0.136199,6,2451.575542,136.198641,408.595924,134.544278,4,6
0,0,4,4,8,10,18,11,15,26,0.000333,0.036139,4,433.6722,24.0929,108.41805,57.219281,1,6
0,0,19,19,18,24,42,67,74,141,0.000333,0.253439,27,20528.55243,1140.475135,760.316757,185.09775,2,6
0,0,13,13,12,18,30,50,64,114,0.000333,0.186462,18,10068.9395,559.385528,559.385528,118.0782,2,6
0,0,12,12,11,17,28,50,46,96,0.000333,0.153835,10,4615.060725,256.392263,461.506073,107.540616,1,6
0,0,14,14,15,22,37,57,47,104,0.000333,0.180594,14,7584.9641,421.386894,541.78315,156.710855,3,6
0,0,14,14,15,21,36,57,47,104,0.000333,0.179224,14,7527.410802,418.189489,537.6722,150.842025,3,6
0,0,13,13,14,21,35,54,46,100,0.000333,0.170976,14,7180.996224,398.944235,512.928302,145.541635,2,6
0,0,15,15,16,20,36,54,43,97,0.000333,0.167161,16,8023.723602,445.762422,501.482725,150.438562,3,6
0,0,9,9,13,15,28,34,27,61,0.000333,0.09775,6,1759.491901,97.74955,293.24865,106.709075,2,6
0,0,12,12,15,18,33,40,33,73,0.000333,0.122747,7,2577.685395,143.204744,368.240771,133.662009,3,6
0,0,13,13,13,18,31,45,36,81,0.000333,0.133763,12,4815.478814,267.526601,401.289901,123.164366,2,6
0,0,9,9,13,15,28,34,27,61,0.000333,0.09775,6,1759.491901,97.74955,293.24865,106.709075,2,6
0,0,10,10,12,15,27,31,26,57,0.000333,0.090343,6,1626.171526,90.342863,271.028588,101.622909,2,6
0,0,6,6,7,10,17,14,15,29,0.000333,0.039512,3,355.609267,19.75607,118.536422,52.870765,1,6
0,0,12,12,11,17,28,45,47,92,0.000333,0.147426,10,4422.766528,245.709252,442.276653,107.540616,1,6
0,0,19,19,15,24,39,77,72,149,0.000333,0.262508,21,16538.02354,918.779086,787.524931,168.642459,2,6
0,0,10,10,14,18,32,46,38,84,0.000333,0.14,14,5880,326.666667,420,128.361619,2,6
0,0,17,17,15,22,37,73,60,133,0.000333,0.230952,14,9700.002167,538.889009,692.857298,156.710855,2,6
0,0,10,10,13,17,30,45,35,80,0.000333,0.13085,12,4710.614972,261.700832,392.551248,117.592585,2,6
0,0,16,16,13,19,32,62,71,133,0.000333,0.221667,18,11970,665,665,128.816339,2,6
0,0,10,10,13,16,29,44,35,79,0.000333,0.127927,12,4605.365983,255.853666,383.780499,112.105716,2,6
0,0,17,17,15,21,36,63,44,107,0.000333,0.184394,14,7744.547652,430.252647,553.181975,150.842025,3,6
0,0,10,10,13,16,29,37,29,66,0.000333,0.106876,6,1923.760474,106.875582,320.626746,112.105716,2,6
0,0,12,12,14,19,33,56,39,95,0.000333,0.159739,14,6709.044179,372.724677,479.217441,134.013592,3,6
0,0,19,19,21,25,46,75,75,150,0.000333,0.276178,30,24856.0288,1380.890489,828.534293,208.335071,3,6
0,0,12,12,14,21,35,56,40,96,0.000333,0.164137,7,3446.878187,191.493233,492.41117,145.541635,3,6
0,0,9,9,14,18,32,37,36,73,0.000333,0.121667,14,5110,283.888889,365,128.361619,2,6
0,0,15,15,16,23,39,56,47,103,0.000333,0.181465,16,8710.342857,483.907936,544.396429,168.041925,4,6
0,0,11,11,12,18,30,36,30,66,0.000333,0.107952,6,1943.128676,107.951593,323.854779,118.0782,3,6
0,0,14,14,16,21,37,53,45,98,0.000333,0.170175,16,8168.422877,453.801271,510.52643,156.238666,3,6
0,0,10,10,12,16,28,33,28,61,0.000333,0.09775,6,1759.491901,97.74955,293.24865,107.01955,2,6
0,0,14,14,15,18,33,45,42,87,0.000333,0.146287,14,6144.072037,341.337335,438.862288,133.662009,2,6
0,0,10,10,12,16,28,29,27,56,0.000333,0.089737,6,1615.271254,89.737292,269.211876,107.01955,2,6
0,0,15,15,14,22,36,56,48,104,0.000333,0.179224,14,7527.410802,418.189489,537.6722,151.410465,3,6
0,0,9,9,13,16,29,33,32,65,0.000333,0.105256,12,3789.225176,210.51251,315.768765,112.105716,2,6
0,0,18,18,14,23,37,53,63,116,0.000333,0.201432,14,8460.152266,470.008459,604.29659,157.344894,2,6
0,0,18,18,13,23,36,61,60,121,0.000333,0.20852,12,7506.731102,417.040617,625.560925,152.147641,2,6
0,0,19,19,13,22,35,58,70,128,0.000333,0.218849,18,11817.86807,656.548226,656.548226,146.213212,2,6
0,0,15,15,13,19,32,51,62,113,0.000333,0.188333,18,10170,565,565,128.816339,2,6
0,0,17,17,15,24,39,79,52,131,0.000333,0.230796,14,9693.427669,538.523759,692.387691,168.642459,6,6
0,0,5,5,10,13,23,20,19,39,0.000333,0.058806,5,882.094581,49.005255,176.418916,81.324997,1,6
0,0,10,10,10,16,26,46,42,88,0.000333,0.13788,10,4136.386952,229.799275,413.638695,97.219281,1,6
0,0,14,14,10,18,28,58,66,124,0.000333,0.198704,15,8941.680155,496.760009,596.11201,108.277931,1,6
0,0,17,17,15,24,39,79,52,131,0.000333,0.230796,14,9693.427669,538.523759,692.387691,168.642459,6,6
0,0,17,17,15,24,39,79,52,131,0.000333,0.230796,14,9693.427669,538.523759,692.387691,168.642459,6,6
0,0,17,17,15,24,39,79,52,131,0.000333,0.230796,14,9693.427669,538.523759,692.387691,168.642459,6,6
0,0,17,17,15,24,39,79,52,131,0.000333,0.230796,14,9693.427669,538.523759,692.387691,168.642459,6,6
0,0,15,15,14,17,31,63,47,110,0.000333,0.181654,14,7629.462318,423.859018,544.961594,122.789837,2,6
0,0,10,10,14,15,29,44,32,76,0.000333,0.123069,14,5168.891779,287.160654,369.206556,111.906328,2,6
0,0,12,12,14,17,31,49,37,86,0.000333,0.14202,14,5964.852358,331.380687,426.060883,122.789837,2,6
0,0,11,11,14,17,31,47,35,82,0.000333,0.135415,14,5687.417364,315.967631,406.244097,122.789837,2,6
0,0,18,18,15,20,35,76,54,130,0.000333,0.222269,14,9335.295091,518.627505,666.806792,145.041921,3,6
0,0,10,10,13,15,28,41,32,73,0.000333,0.116979,12,4211.242912,233.95794,350.936909,106.709075,2,6
0,0,15,15,14,18,32,69,50,119,0.000333,0.198333,14,8330,462.777778,595,128.361619,2,6
0,0,10,10,13,15,28,41,32,73,0.000333,0.116979,12,4211.242912,233.95794,350.936909,106.709075,2,6
0,0,12,12,13,21,34,51,45,96,0.000333,0.162799,12,5860.757193,325.597622,488.396433,140.344382,1,6
0,0,11,11,12,18,30,49,45,94,0.000333,0.153749,12,5534.972592,307.498477,461.247716,118.0782,1,6
0,0,11,11,13,19,32,50,45,95,0.000333,0.158333,12,5700,316.666667,475,128.816339,1,6
0,0,11,11,12,18,30,49,45,94,0.000333,0.153749,12,5534.972592,307.498477,461.247716,118.0782,1,6
0,0,11,11,13,19,32,50,45,95,0.000333,0.158333,12,5700,316.666667,475,128.816339,1,6
0,0,13,13,14,20,34,59,44,103,0.000333,0.17467,14,7336.121417,407.562301,524.008673,139.741531,3,6
0,0,13,13,14,19,33,59,44,103,0.000333,0.173191,14,7274.01632,404.112018,519.572594,134.013592,3,6
0,0,12,12,13,19,32,56,43,99,0.000333,0.165,12,5940,330,495,128.816339,2,6
0,0,10,10,16,17,33,36,36,72,0.000333,0.121065,16,5811.142026,322.841224,363.196377,133.486868,2,6
0,0,19,19,17,22,39,61,71,132,0.000333,0.232558,24,16744.15423,930.230791,697.673093,167.594364,2,6
0,0,16,16,18,22,40,67,56,123,0.000333,0.218199,18,11782.7488,654.597156,654.597156,173.166146,4,6
0,0,11,11,17,18,35,56,45,101,0.000333,0.172686,16,8288.921355,460.495631,518.057585,144.545518,3,6
0,0,9,9,14,20,34,36,31,67,0.000333,0.11362,7,2386.020073,132.556671,340.86001,139.741531,2,6
0,0,16,16,18,22,40,67,56,123,0.000333,0.218199,18,11782.7488,654.597156,654.597156,173.166146,4,6
0,0,11,11,17,18,35,56,45,101,0.000333,0.172686,16,8288.921355,460.495631,518.057585,144.545518,3,6
0,0,9,9,14,20,34,36,31,67,0.000333,0.11362,7,2386.020073,132.556671,340.86001,139.741531,2,6
0,0,18,18,19,23,42,71,58,129,0.000333,0.23187,18,12520.96106,695.608948,695.608948,184.752548,4,6
0,0,11,11,17,18,35,56,45,101,0.000333,0.172686,16,8288.921355,460.495631,518.057585,144.545518,3,6
0,0,11,11,15,21,36,40,33,73,0.000333,0.125802,7,2641.831676,146.768426,377.404525,150.842025,2,6
0,0,14,14,14,20,34,48,52,100,0.000333,0.169582,14,7122.447978,395.691554,508.746284,139.741531,2,6
0,0,11,11,18,20,38,54,47,101,0.000333,0.17668,18,9540.732219,530.040679,530.040679,161.497212,2,6
0,0,10,10,18,19,37,51,41,92,0.000333,0.159757,18,8626.854773,479.26971,479.26971,155.769273,2,6
0,0,29,29,19,52,71,128,95,223,0.000333,0.457131,9,12342.54247,685.696804,1371.393608,377.133488,11,6
0,0,28,28,19,52,71,127,93,220,0.000333,0.450981,9,12176.4993,676.472183,1352.944366,377.133488,11,6
0,0,14,14,15,20,35,49,46,95,0.000333,0.162427,14,6821.946413,378.997023,487.281887,145.041921,2,6
0,0,13,13,16,22,38,54,47,101,0.000333,0.17668,16,8480.650862,471.14727,530.040679,162.107496,3,6
0,0,16,16,18,22,40,72,79,151,0.000333,0.26787,27,21697.50084,1205.416713,803.611142,173.166146,2,6
0,0,10,10,18,19,37,54,43,97,0.000333,0.168439,18,9095.705576,505.316976,505.316976,155.769273,2,6
0,0,13,13,16,22,38,54,47,101,0.000333,0.17668,16,8480.650862,471.14727,530.040679,162.107496,3,6
0,0,10,10,11,17,28,36,33,69,0.000333,0.110569,5,1658.537448,92.140969,331.70749,107.540616,2,6
0,0,10,10,11,16,27,36,32,68,0.000333,0.107777,10,3233.323501,179.629083,323.33235,102.053748,2,6
0,0,10,10,14,17,31,42,32,74,0.000333,0.122204,7,2566.273689,142.57076,366.610527,122.789837,2,6
0,0,9,9,10,14,24,29,25,54,0.000333,0.082529,5,1237.939875,68.774438,247.587975,86.52225,2,6
0,0,11,11,13,16,29,38,31,69,0.000333,0.111734,6,2011.204132,111.733563,335.200689,112.105716,2,6
0,0,9,9,10,14,24,29,25,54,0.000333,0.082529,5,1237.939875,68.774438,247.587975,86.52225,2,6
0,0,11,11,13,16,29,38,31,69,0.000333,0.111734,6,2011.204132,111.733563,335.200689,112.105716,2,6
0,0,19,19,15,25,40,78,59,137,0.000333,0.243035,14,10207.45809,567.081005,729.104149,174.699764,3,6
0,0,13,13,13,19,32,55,48,103,0.000333,0.171667,12,6180,343.333333,515,128.816339,1,6
0,0,16,16,12,21,33,63,70,133,0.000333,0.223635,18,12076.27952,670.904418,670.904418,135.258216,1,6
0,0,16,16,13,22,35,64,74,138,0.000333,0.235947,18,12741.13901,707.841056,707.841056,146.213212,1,6
0,0,14,14,12,20,32,57,58,115,0.000333,0.191667,12,6900,383.333333,575,129.458112,1,6
0,0,14,14,13,21,34,58,60,118,0.000333,0.200107,12,7203.847383,400.213744,600.320615,140.344382,1,6
0,0,7,7,13,14,27,31,29,60,0.000333,0.095098,12,3423.519002,190.1955,285.29325,101.408685,2,6
0,0,9,9,11,16,27,47,32,79,0.000333,0.125212,10,3756.361127,208.686729,375.636113,102.053748,2,6
0,0,11,11,13,17,30,52,35,87,0.000333,0.1423,12,5122.793782,284.599655,426.899482,117.592585,2,6
0,0,9,9,11,17,28,47,33,80,0.000333,0.128196,5,1922.941969,106.830109,384.588394,107.540616,2,6
0,0,9,9,12,17,29,29,28,57,0.000333,0.092302,6,1661.4295,92.301639,276.904917,112.506418,2,6
0,0,20,20,18,26,44,73,79,152,0.000333,0.276611,27,22405.50736,1244.750409,829.833606,197.270083,3,6
0,0,17,17,16,22,38,62,77,139,0.000333,0.243154,24,17507.08619,972.615899,729.461924,162.107496,3,6
0,0,15,15,17,23,40,60,53,113,0.000333,0.200459,16,9622.045996,534.558111,601.377875,173.528793,3,6
0,0,14,14,14,23,37,54,48,102,0.000333,0.177121,14,7439.099406,413.2833,531.364243,157.344894,3,6
0,0,7,7,10,13,23,32,24,56,0.000333,0.08444,5,1266.597348,70.366519,253.31947,81.324997,1,6
0,0,10,10,12,15,27,39,28,67,0.000333,0.106192,6,1911.464776,106.192488,318.577463,101.622909,2,6
0,0,8,8,15,19,34,36,31,67,0.000333,0.11362,7,2386.020073,132.556671,340.86001,139.313982,2,6
0,0,11,11,13,18,31,44,34,78,0.000333,0.128809,6,2318.563873,128.809104,386.427312,123.164366,2,6
0,0,13,13,12,18,30,50,55,105,0.000333,0.171741,18,9274.023226,515.223513,515.223513,118.0782,1,6
0,0,13,13,13,20,33,55,58,113,0.000333,0.190006,12,6840.198426,380.011024,570.016535,134.544278,1,6
0,0,14,14,14,22,36,44,44,88,0.000333,0.151651,14,6369.347602,353.852645,454.9534,151.410465,2,6
0,0,12,12,13,19,32,38,34,72,0.000333,0.12,6,2160,120,360,128.816339,2,6
0,0,13,13,14,19,33,45,38,83,0.000333,0.139562,14,5861.585967,325.643665,418.684712,134.013592,2,6
0,0,11,11,12,17,29,34,29,63,0.000333,0.102018,6,1836.316816,102.017601,306.052803,112.506418,2,6
0,0,11,11,14,21,35,55,41,96,0.000333,0.164137,7,3446.878187,191.493233,492.41117,145.541635,2,6
0,0,12,12,14,22,36,49,40,89,0.000333,0.153374,7,3220.863276,178.936849,460.123325,151.410465,3,6
0,0,11,11,14,20,34,46,38,84,0.000333,0.142449,7,2991.428151,166.190453,427.346879,139.741531,2,6
0,0,15,15,15,22,37,59,56,115,0.000333,0.199696,14,8387.219919,465.956662,599.087137,156.710855,3,6
0,0,12,12,14,15,29,41,42,83,0.000333,0.134404,14,5644.973916,313.609662,403.212423,111.906328,3,6
0,0,12,12,13,17,30,39,41,80,0.000333,0.13085,12,4710.614972,261.700832,392.551248,117.592585,2,6
0,0,14,14,14,21,35,56,47,103,0.000333,0.176105,14,7396.42611,410.912562,528.316151,145.541635,2,6
0,0,15,15,14,22,36,59,48,107,0.000333,0.184394,14,7744.547652,430.252647,553.181975,151.410465,3,6
0,0,15,15,14,22,36,55,47,102,0.000333,0.175777,14,7382.652902,410.147383,527.33235,151.410465,3,6
0,0,14,14,14,19,33,43,41,84,0.000333,0.141243,14,5932.207484,329.567082,423.729106,134.013592,3,6
0,0,10,10,13,16,29,29,26,55,0.000333,0.089063,6,1603.133728,89.062985,267.188955,112.105716,3,6
0,0,14,14,14,20,34,43,41,84,0.000333,0.142449,14,5982.856301,332.380906,427.346879,139.741531,3,6
0,0,10,10,13,16,29,29,26,55,0.000333,0.089063,6,1603.133728,89.062985,267.188955,112.105716,3,6
0,0,14,14,13,21,34,43,42,85,0.000333,0.144145,12,5189.212098,288.289561,432.434342,140.344382,3,6
0,0,10,10,12,17,29,29,27,56,0.000333,0.090682,6,1632.281614,90.682312,272.046936,112.506418,3,6
0,0,19,19,14,24,38,60,53,113,0.000333,0.197672,14,8302.221326,461.234518,593.015809,163.342069,3,6
0,0,12,12,13,19,32,38,30,68,0.000333,0.113333,6,2040,113.333333,340,128.816339,3,6
0,0,12,12,13,19,32,38,30,68,0.000333,0.113333,6,2040,113.333333,340,128.816339,3,6
0,0,9,9,11,16,27,34,28,62,0.000333,0.098268,5,1474.015126,81.889729,294.803025,102.053748,2,6
0,0,11,11,13,18,31,43,34,77,0.000333,0.127158,6,2288.838695,127.157705,381.473116,123.164366,2,6
0,0,9,9,11,15,26,34,28,62,0.000333,0.097142,5,1457.136313,80.952017,291.427263,96.657107,2,6
0,0,11,11,13,18,31,43,34,77,0.000333,0.127158,6,2288.838695,127.157705,381.473116,123.164366,2,6
0,0,9,9,11,16,27,34,28,62,0.000333,0.098268,5,1474.015126,81.889729,294.803025,102.053748,2,6
0,0,11,11,13,18,31,43,34,77,0.000333,0.127158,6,2288.838695,127.157705,381.473116,123.164366,2,6
0,0,9,9,11,16,27,34,29,63,0.000333,0.099853,5,1497.789563,83.210531,299.557913,102.053748,2,6
0,0,11,11,13,18,31,43,34,77,0.000333,0.127158,6,2288.838695,127.157705,381.473116,123.164366,2,6
0,0,9,9,11,16,27,34,28,62,0.000333,0.098268,5,1474.015126,81.889729,294.803025,102.053748,2,6
0,0,11,11,13,18,31,43,34,77,0.000333,0.127158,6,2288.838695,127.157705,381.473116,123.164366,2,6
0,0,14,14,15,21,36,54,41,95,0.000333,0.163714,7,3438.000126,191.000007,491.142875,150.842025,6,6
0,0,14,14,14,23,37,52,40,92,0.000333,0.159757,7,3354.887967,186.382665,479.26971,157.344894,5,6
0,0,10,10,11,22,33,39,31,70,0.000333,0.117703,5,1765.537942,98.085441,353.107588,136.161243,4,6
0,0,11,11,11,22,33,40,33,73,0.000333,0.122747,5,1841.203854,102.289103,368.240771,136.161243,4,6
0,0,14,14,15,22,37,54,43,97,0.000333,0.168439,7,3537.218835,196.512158,505.316976,156.710855,6,6
0,0,14,14,14,24,38,52,42,94,0.000333,0.164435,7,3453.136304,191.840906,493.305186,163.342069,5,6
0,0,10,10,11,23,34,39,32,71,0.000333,0.120403,5,1806.049309,100.336073,361.209862,142.095673,4,6
0,0,11,11,11,23,34,40,34,74,0.000333,0.125491,5,1882.361251,104.575625,376.47225,142.095673,4,6
0,0,14,14,15,21,36,54,41,95,0.000333,0.163714,7,3438.000126,191.000007,491.142875,150.842025,6,6
0,0,14,14,14,23,37,52,40,92,0.000333,0.159757,7,3354.887967,186.382665,479.26971,157.344894,5,6
0,0,10,10,11,22,33,39,31,70,0.000333,0.117703,5,1765.537942,98.085441,353.107588,136.161243,4,6
0,0,11,11,11,22,33,40,33,73,0.000333,0.122747,5,1841.203854,102.289103,368.240771,136.161243,4,6
0,0,20,20,14,21,35,84,67,151,0.000333,0.258174,21,16264.95645,903.608691,774.521736,145.541635,2,6
0,0,10,10,14,16,30,49,34,83,0.000333,0.135757,14,5701.806872,316.767048,407.271919,117.302969,2,6
0,0,10,10,13,15,28,44,34,78,0.000333,0.124991,12,4499.684207,249.982456,374.973684,106.709075,2,6
0,0,10,10,13,19,32,46,35,81,0.000333,0.135,6,2430,135,405,128.816339,2,6
0,0,6,6,14,15,29,32,26,58,0.000333,0.093921,7,1972.340284,109.57446,281.762898,111.906328,1,6
0,0,7,7,12,15,27,32,28,60,0.000333,0.095098,6,1711.759501,95.09775,285.29325,101.622909,2,6
0,0,16,16,13,21,34,68,67,135,0.000333,0.228936,18,12362.5347,686.807484,686.807484,140.344382,2,6
0,0,13,13,12,18,30,50,64,114,0.000333,0.186462,18,10068.9395,559.385528,559.385528,118.0782,2,6
0,0,18,18,17,21,38,78,85,163,0.000333,0.285137,32,27373.18991,1520.732773,855.412185,161.725534,3,6
0,0,11,11,17,18,35,59,47,106,0.000333,0.181235,16,8699.263997,483.292444,543.704,144.545518,3,6
0,0,18,18,17,22,39,78,92,170,0.000333,0.299506,32,28752.58807,1597.366004,898.518377,167.594364,3,6
0,0,11,11,11,15,26,45,39,84,0.000333,0.131612,10,3948.369363,219.353854,394.836936,96.657107,1,6
0,0,9,9,8,12,20,29,42,71,0.000333,0.102286,12,3682.282737,204.571263,306.856895,67.01955,1,6
0,0,12,12,10,16,26,47,47,94,0.000333,0.14728,10,4418.413335,245.467408,441.841334,97.219281,1,6
0,0,14,14,14,22,36,58,64,122,0.000333,0.210244,14,8830.231902,490.568439,630.73085,151.410465,2,6
0,0,19,19,18,24,42,71,75,146,0.000333,0.262426,27,21256.51528,1180.917516,787.278344,185.09775,2,6
0,0,17,17,16,22,38,57,61,118,0.000333,0.206418,16,9908.087145,550.449286,619.255447,162.107496,3,6
0,0,12,12,17,20,37,45,42,87,0.000333,0.151074,16,7251.559085,402.864394,453.222443,155.92543,3,6
0,0,5,5,5,10,15,9,17,26,0.000333,0.03386,2,203.158311,11.286573,101.579155,44.828921,1,6
0,0,17,17,19,24,43,78,60,138,0.000333,0.249608,18,13478.84165,748.824536,748.824536,190.749723,4,6
0,0,12,12,17,19,36,59,47,106,0.000333,0.182671,16,8768.192802,487.121822,548.01205,150.197491,3,6
0,0,17,17,19,24,43,78,60,138,0.000333,0.249608,18,13478.84165,748.824536,748.824536,190.749723,4,6
0,0,12,12,17,19,36,59,47,106,0.000333,0.182671,16,8768.192802,487.121822,548.01205,150.197491,3,6
0,0,9,9,11,17,28,47,33,80,0.000333,0.128196,5,1922.941969,106.830109,384.588394,107.540616,2,6
0,0,12,12,14,16,30,47,47,94,0.000333,0.153749,14,6457.468024,358.748224,461.247716,117.302969,1,6
0,0,4,4,8,10,18,11,15,26,0.000333,0.036139,4,433.6722,24.0929,108.41805,57.219281,1,6
0,0,12,12,10,17,27,53,44,97,0.000333,0.153741,10,4612.240877,256.235604,461.224088,102.706149,1,6
0,0,11,11,13,18,31,44,34,78,0.000333,0.128809,6,2318.563873,128.809104,386.427312,123.164366,2,6
0,0,16,16,17,23,40,63,53,116,0.000333,0.205781,16,9877.498544,548.749919,617.343659,173.528793,4,6
0,0,18,18,18,24,42,67,56,123,0.000333,0.221085,18,11938.59077,663.255043,663.255043,185.09775,4,6
0,0,21,21,18,27,45,89,68,157,0.000333,0.287407,18,15519.97685,862.220936,862.220936,203.440613,4,6
0,0,15,15,17,22,39,60,52,112,0.000333,0.197322,16,9471.440776,526.191154,591.965049,167.594364,3,6
0,0,16,16,19,22,41,76,58,134,0.000333,0.239304,18,12922.41544,717.911969,717.911969,178.818118,4,6
0,0,11,11,17,18,35,56,45,101,0.000333,0.172686,16,8288.921355,460.495631,518.057585,144.545518,3,6
0,0,16,16,19,22,41,76,58,134,0.000333,0.239304,18,12922.41544,717.911969,717.911969,178.818118,4,6
0,0,11,11,17,18,35,56,45,101,0.000333,0.172686,16,8288.921355,460.495631,518.057585,144.545518,3,6
0,0,18,18,21,24,45,81,61,142,0.000333,0.259948,20,15596.86279,866.492377,779.84314,202.277766,4,6
0,0,11,11,17,18,35,56,45,101,0.000333,0.172686,16,8288.921355,460.495631,518.057585,144.545518,3,6
0,0,16,16,19,23,42,76,59,135,0.000333,0.242654,18,13103.33134,727.962852,727.962852,184.752548,4,6
0,0,11,11,17,18,35,56,45,101,0.000333,0.172686,16,8288.921355,460.495631,518.057585,144.545518,3,6
0,0,10,10,10,15,25,37,31,68,0.000333,0.105261,10,3157.822209,175.434567,315.782221,91.82264,2,6
0,0,12,12,13,19,32,46,37,83,0.000333,0.138333,6,2490,138.333333,415,128.816339,2,6
0,0,17,17,18,25,43,74,65,139,0.000333,0.251417,18,13576.51442,754.250801,754.250801,191.155055,3,6
0,0,11,11,16,22,38,44,43,87,0.000333,0.15219,8,3652.557549,202.919864,456.569694,162.107496,3,6
0,0,19,19,17,27,44,83,72,155,0.000333,0.282071,16,13539.39041,752.188356,846.211901,197.868831,3,6
0,0,16,16,14,21,35,66,47,113,0.000333,0.193203,14,8114.525733,450.806985,579.608981,145.541635,3,6
0,0,11,11,13,17,30,44,35,79,0.000333,0.129215,12,4651.732285,258.429571,387.644357,117.592585,2,6
0,0,11,11,12,15,27,46,35,81,0.000333,0.128382,12,4621.750652,256.763925,385.145888,101.622909,1,6
0,0,33,33,23,52,75,151,118,269,0.000333,0.558517,22,36862.14901,2047.897167,1675.552228,400.46479,11,6
0,0,33,33,21,54,75,149,117,266,0.000333,0.552289,20,33137.31543,1840.961969,1656.865772,403.002591,10,6
0,0,18,18,16,23,39,65,79,144,0.000333,0.253699,24,18266.35007,1014.797226,761.09792,168.041925,3,6
0,0,16,16,14,21,35,66,47,113,0.000333,0.193203,14,8114.525733,450.806985,579.608981,145.541635,3,6
0,0,11,11,13,17,30,44,35,79,0.000333,0.129215,12,4651.732285,258.429571,387.644357,117.592585,2,6
0,0,13,13,13,21,34,51,48,99,0.000333,0.167886,12,6043.905855,335.772548,503.658821,140.344382,4,6
0,0,14,14,15,21,36,56,44,100,0.000333,0.172331,14,7237.895002,402.105278,516.9925,150.842025,4,6
0,0,15,15,19,24,43,72,53,125,0.000333,0.226094,18,12209.0957,678.283094,678.283094,190.749723,3,6
0,0,11,11,18,20,38,54,43,97,0.000333,0.169683,18,9162.881438,509.048969,509.048969,161.497212,2,6
0,0,11,11,13,20,33,45,36,81,0.000333,0.136199,6,2451.575542,136.198641,408.595924,134.544278,4,6
0,0,15,15,14,20,34,60,45,105,0.000333,0.178061,14,7478.570377,415.476132,534.183598,139.741531,2,6
0,0,9,9,13,15,28,34,27,61,0.000333,0.09775,6,1759.491901,97.74955,293.24865,106.709075,2,6
0,0,10,10,14,16,30,38,30,68,0.000333,0.111223,7,2335.679924,129.759996,333.668561,117.302969,2,6
0,0,10,10,10,16,26,46,42,88,0.000333,0.13788,10,4136.386952,229.799275,413.638695,97.219281,1,6
0,0,11,11,12,16,28,51,38,89,0.000333,0.142618,12,5134.255057,285.236392,427.854588,107.01955,1,6
0,0,11,11,12,16,28,42,35,77,0.000333,0.123389,12,4441.995948,246.777553,370.166329,107.01955,1,6
0,0,14,14,15,19,34,54,42,96,0.000333,0.162799,14,6837.550059,379.863892,488.396433,139.313982,2,6
0,0,11,11,10,17,27,40,42,82,0.000333,0.129967,10,3899.007752,216.611542,389.900775,102.706149,1,6
0,0,9,9,13,17,30,33,29,62,0.000333,0.101409,6,1825.363302,101.409072,304.227217,117.592585,2,6
0,0,14,14,16,21,37,54,45,99,0.000333,0.171912,16,8251.774131,458.431896,515.735883,156.238666,4,6
0,0,14,14,15,23,38,52,44,96,0.000333,0.167934,7,3526.607289,195.922627,503.801041,162.645284,3,6
0,0,11,11,12,22,34,42,36,78,0.000333,0.132274,6,2380.93261,132.274034,396.822102,141.127046,3,6
0,0,12,12,12,22,34,43,38,81,0.000333,0.137361,6,2472.506941,137.361497,412.08449,141.127046,3,6
0,0,15,15,16,24,40,55,51,106,0.000333,0.188041,16,9025.990049,501.443892,564.124378,174.0391,4,6
0,0,15,15,15,26,41,53,50,103,0.000333,0.183943,7,3862.794995,214.599722,551.827856,180.814792,3,6
0,0,11,11,12,24,36,42,37,79,0.000333,0.136141,6,2450.544451,136.141358,408.424075,153.05865,3,6
0,0,12,12,12,24,36,43,39,82,0.000333,0.141311,6,2543.603101,141.311283,423.93385,153.05865,3,6
0,0,32,32,24,46,70,136,97,233,0.000333,0.476041,24,34274.95063,1904.163924,1428.122943,364.12295,11,6
0,0,32,32,23,48,71,134,96,230,0.000333,0.471481,22,31117.72043,1728.762246,1414.441837,372.120125,10,6
0,0,27,27,21,48,69,117,86,203,0.000333,0.413343,10,12400.30465,688.905814,1240.030465,360.316866,9,6
0,0,26,26,21,48,69,116,84,200,0.000333,0.407235,10,12217.04891,678.72494,1221.704891,360.316866,9,6
0,0,10,10,12,17,29,41,33,74,0.000333,0.11983,6,2156.943562,119.830198,359.490594,112.506418,1,6
0,0,13,13,13,17,30,49,56,105,0.000333,0.171741,18,9274.023226,515.223513,515.223513,117.592585,1,6
0,0,15,15,17,22,39,58,56,114,0.000333,0.200845,16,9640.573647,535.587425,602.535853,167.594364,2,6
0,0,11,11,13,20,33,35,35,70,0.000333,0.117703,6,2118.64553,117.702529,353.107588,134.544278,2,6
0,0,5,5,5,10,15,9,17,26,0.000333,0.03386,2,203.158311,11.286573,101.579155,44.828921,1,6
0,0,10,10,11,18,29,50,36,86,0.000333,0.139262,10,4177.863656,232.103536,417.786366,113.112398,2,6
0,0,10,10,11,16,27,50,35,85,0.000333,0.134722,10,4041.654377,224.536354,404.165438,102.053748,2,6
0,0,10,10,11,17,28,50,35,85,0.000333,0.136208,10,4086.251684,227.013982,408.625168,107.540616,2,6
0,0,15,15,18,23,41,67,55,122,0.000333,0.217874,18,11765.1842,653.621345,653.621345,179.100575,3,6
0,0,12,12,18,21,39,60,48,108,0.000333,0.190274,18,10274.82191,570.82344,570.82344,167.297316,3,6
0,0,10,10,17,22,39,45,37,82,0.000333,0.144468,8,3467.223856,192.623548,433.402982,167.594364,2,6
0,0,15,15,13,20,33,52,50,102,0.000333,0.171509,12,6174.338402,343.0188,514.5282,134.544278,2,6
0,0,9,9,13,16,29,38,31,69,0.000333,0.111734,6,2011.204132,111.733563,335.200689,112.105716,2,6
0,0,12,12,12,18,30,38,40,78,0.000333,0.127579,12,4592.849597,255.158311,382.737466,118.0782,2,6
0,0,15,15,13,20,33,52,44,96,0.000333,0.161421,12,5811.142026,322.841224,484.261835,134.544278,2,6
0,0,9,9,13,16,29,35,29,64,0.000333,0.103637,6,1865.464702,103.636928,310.910784,112.105716,2,6
0,0,12,12,12,18,30,38,34,72,0.000333,0.117765,6,2119.776737,117.765374,353.296123,118.0782,2,6
0,0,11,11,13,20,33,45,36,81,0.000333,0.136199,6,2451.575542,136.198641,408.595924,134.544278,4,6
0,0,18,18,18,26,44,86,58,144,0.000333,0.262053,18,14150.84676,786.158153,786.158153,197.270083,4,6
0,0,13,13,15,23,38,53,45,98,0.000333,0.171432,7,3600.078274,200.004349,514.296896,162.645284,2,6
0,0,18,18,17,22,39,75,53,128,0.000333,0.22551,16,10824.50374,601.361319,676.531484,167.594364,4,6
0,0,11,11,13,17,30,44,34,78,0.000333,0.127579,12,4592.849597,255.158311,382.737466,117.592585,2,6
0,0,18,18,15,23,38,69,65,134,0.000333,0.234407,14,9845.112015,546.950668,703.222287,162.645284,3,6
0,0,17,17,16,22,38,67,55,122,0.000333,0.213416,16,10243.95451,569.108584,640.247157,162.107496,2,6
0,0,11,11,10,15,25,44,44,88,0.000333,0.13622,10,4086.593447,227.032969,408.659345,91.82264,1,6
0,0,16,16,16,22,38,76,52,128,0.000333,0.223912,16,10747.75555,597.09753,671.734722,162.107496,3,6
0,0,12,12,14,20,34,56,42,98,0.000333,0.16619,14,6979.999018,387.777723,498.571358,139.741531,3,6
0,0,15,15,14,21,35,54,45,99,0.000333,0.169266,14,7109.186261,394.954792,507.799019,145.541635,3,6
0,0,11,11,13,15,28,46,33,79,0.000333,0.126594,12,4557.372466,253.187359,379.781039,106.709075,2,6
0,0,9,9,10,14,24,38,30,68,0.000333,0.103926,10,3117.7745,173.209694,311.77745,86.52225,1,6
0,0,10,10,11,17,28,40,35,75,0.000333,0.120184,10,3605.516192,200.306455,360.551619,107.540616,1,6
0,0,10,10,12,14,26,43,32,75,0.000333,0.117511,12,4230.395746,235.021986,352.532979,96.322519,1,6
0,0,16,16,18,22,40,72,79,151,0.000333,0.26787,27,21697.50084,1205.416713,803.611142,173.166146,2,6
0,0,10,10,18,19,37,54,43,97,0.000333,0.168439,18,9095.705576,505.316976,505.316976,155.769273,2,6
0,0,11,11,18,20,38,54,47,101,0.000333,0.17668,18,9540.732219,530.040679,530.040679,161.497212,2,6
0,0,10,10,18,19,37,51,41,92,0.000333,0.159757,18,8626.854773,479.26971,479.26971,155.769273,2,6
0,0,18,18,18,25,43,79,70,149,0.000333,0.269504,18,14553.24207,808.513448,808.513448,191.155055,2,6
0,0,10,10,18,20,38,56,43,99,0.000333,0.173182,18,9351.806829,519.544824,519.544824,161.497212,2,6
0,0,7,7,13,15,28,31,26,57,0.000333,0.09134,6,1644.115383,91.339744,274.019231,106.709075,1,6
0,0,5,5,5,10,15,9,17,26,0.000333,0.03386,2,203.158311,11.286573,101.579155,44.828921,1,6
0,0,10,10,13,20,33,37,38,75,0.000333,0.12611,6,2269.977354,126.109853,378.329559,134.544278,2,6
0,0,9,9,11,20,31,31,33,64,0.000333,0.10569,5,1585.342819,88.074601,317.068564,124.49231,2,6
0,0,9,9,12,18,30,34,36,70,0.000333,0.114494,12,4121.7881,228.988228,343.482342,118.0782,1,6
0,0,8,8,10,18,28,28,31,59,0.000333,0.094545,5,1418.169702,78.787206,283.63394,108.277931,1,6
0,0,10,10,13,19,32,37,37,74,0.000333,0.123333,6,2220,123.333333,370,128.816339,2,6
0,0,9,9,11,19,30,31,32,63,0.000333,0.103045,5,1545.670538,85.870585,309.134108,118.764371,2,6
0,0,16,16,14,24,38,65,60,125,0.000333,0.218664,14,9183.873149,510.215175,655.990939,163.342069,2,6
0,0,13,13,14,21,35,55,66,121,0.000333,0.206881,21,13033.50815,724.083786,620.643245,145.541635,2,6
0,0,11,11,14,21,35,55,41,96,0.000333,0.164137,7,3446.878187,191.493233,492.41117,145.541635,2,6
0,0,18,18,16,23,39,65,69,134,0.000333,0.236081,24,16997.85354,944.325196,708.243897,168.041925,3,6
0,0,12,12,14,22,36,58,42,100,0.000333,0.172331,7,3618.947501,201.052639,516.9925,151.410465,3,6
0,0,11,11,17,21,38,46,39,85,0.000333,0.148691,8,3568.590709,198.255039,446.073839,161.725534,3,6
0,0,19,19,18,24,42,69,57,126,0.000333,0.226477,18,12229.77592,679.431995,679.431995,185.09775,4,6
0,0,17,17,17,23,40,65,54,119,0.000333,0.211103,16,10132.95109,562.941727,633.309443,173.528793,4,6
0,0,17,17,17,24,41,65,55,120,0.000333,0.214302,16,10286.49985,571.472214,642.906241,179.525968,4,6
0,0,17,17,17,24,41,65,55,120,0.000333,0.214302,16,10286.49985,571.472214,642.906241,179.525968,4,6
0,0,11,11,17,19,36,49,42,91,0.000333,0.156821,16,7527.410802,418.189489,470.463175,150.197491,2,6
0,0,14,14,15,21,36,60,42,102,0.000333,0.175777,14,7382.652902,410.147383,527.33235,150.842025,3,6
0,0,12,12,15,19,34,56,39,95,0.000333,0.161103,14,6766.325579,375.906977,483.30897,139.313982,3,6
0,0,12,12,15,20,35,56,39,95,0.000333,0.162427,7,3410.973206,189.498511,487.281887,145.041921,3,6
0,0,13,13,17,22,39,62,45,107,0.000333,0.188513,16,9048.608599,502.700478,565.538037,167.594364,3,6
0,0,6,6,10,13,23,19,22,41,0.000333,0.061822,5,927.330201,51.518344,185.46604,81.324997,1,6
0,0,16,16,17,24,41,65,60,125,0.000333,0.223231,16,10715.10401,595.283556,669.694001,179.525968,3,6
0,0,14,14,14,20,34,57,40,97,0.000333,0.164495,14,6908.774538,383.820808,493.483896,139.741531,3,6
0,0,9,9,13,15,28,34,27,61,0.000333,0.09775,6,1759.491901,97.74955,293.24865,106.709075,2,6
0,0,14,14,14,20,34,57,41,98,0.000333,0.16619,14,6979.999018,387.777723,498.571358,139.741531,3,6
0,0,9,9,13,15,28,34,27,61,0.000333,0.09775,6,1759.491901,97.74955,293.24865,106.709075,2,6
0,0,9,9,9,15,24,34,30,64,0.000333,0.097813,8,2347.5008,130.416711,293.4376,87.132684,1,6
0,0,12,12,13,19,32,46,37,83,0.000333,0.138333,6,2490,138.333333,415,128.816339,2,6
0,0,15,15,13,18,31,55,59,114,0.000333,0.188259,18,10166.01083,564.778379,564.778379,123.164366,2,6
0,0,9,9,13,15,28,37,29,66,0.000333,0.105762,6,1903.712549,105.761808,317.285425,106.709075,2,6
0,0,11,11,10,17,27,53,46,99,0.000333,0.156911,10,4707.338627,261.518813,470.733863,102.706149,1,6
0,0,13,13,11,18,29,65,46,111,0.000333,0.179745,10,5392.358905,299.575495,539.23589,113.112398,1,6
0,0,12,12,11,20,31,55,46,101,0.000333,0.166791,10,5003.738273,277.98546,500.373827,124.49231,1,6
0,0,18,18,18,25,43,79,70,149,0.000333,0.269504,18,14553.24207,808.513448,808.513448,191.155055,2,6
0,0,10,10,18,20,38,56,43,99,0.000333,0.173182,18,9351.806829,519.544824,519.544824,161.497212,2,6
0,0,10,10,18,19,37,54,43,97,0.000333,0.168439,18,9095.705576,505.316976,505.316976,155.769273,2,6
0,0,16,16,18,23,41,70,63,133,0.000333,0.237518,18,12825.9795,712.554417,712.554417,179.100575,2,6
0,0,10,10,18,20,38,55,43,98,0.000333,0.171432,18,9257.344134,514.296896,514.296896,161.497212,2,6
0,0,19,19,14,23,37,76,64,140,0.000333,0.243108,14,10210.5286,567.251589,729.323471,157.344894,2,6
0,0,10,10,14,17,31,49,35,84,0.000333,0.138717,14,5826.134861,323.674159,416.15249,122.789837,2,6
0,0,10,10,14,16,30,47,35,82,0.000333,0.134122,14,5633.110404,312.950578,402.365029,117.302969,2,6
0,0,3,3,9,8,17,10,12,22,0.000333,0.029975,4,359.69673,19.983152,89.924183,52.529325,1,6
0,0,12,12,15,18,33,47,38,85,0.000333,0.142925,14,6002.829002,333.4905,428.7735,133.662009,3,6
0,0,9,9,14,17,31,40,32,72,0.000333,0.118901,7,2496.91494,138.717497,356.702134,122.789837,2,6
0,0,16,16,16,23,39,57,55,112,0.000333,0.197322,16,9471.440776,526.191154,591.965049,168.041925,2,6
0,0,13,13,14,21,35,63,51,114,0.000333,0.194913,14,8186.335695,454.796428,584.738264,145.541635,2,6
0,0,15,15,14,22,36,69,63,132,0.000333,0.227477,14,9554.021403,530.778967,682.4301,151.410465,2,6
0,0,15,15,19,24,43,72,53,125,0.000333,0.226094,18,12209.0957,678.283094,678.283094,190.749723,3,6
0,0,11,11,18,20,38,54,43,97,0.000333,0.169683,18,9162.881438,509.048969,509.048969,161.497212,2,6
0,0,14,14,14,21,35,56,47,103,0.000333,0.176105,14,7396.42611,410.912562,528.316151,145.541635,2,6
0,0,15,15,14,23,37,59,49,108,0.000333,0.18754,14,7876.693489,437.594083,562.620963,157.344894,3,6
0,0,9,9,14,16,30,39,30,69,0.000333,0.112858,7,2370.028158,131.668231,338.575451,117.302969,2,6
0,0,18,18,17,21,38,81,58,139,0.000333,0.243154,16,11671.39079,648.410599,729.461924,161.725534,4,6
0,0,10,10,13,15,28,41,31,72,0.000333,0.115377,12,4153.554653,230.753036,346.129554,106.709075,2,6
0,0,18,18,17,22,39,81,58,139,0.000333,0.24489,16,11754.73454,653.040807,734.670908,167.594364,4,6
0,0,10,10,13,15,28,41,31,72,0.000333,0.115377,12,4153.554653,230.753036,346.129554,106.709075,2,6
0,0,11,11,13,18,31,39,41,80,0.000333,0.132112,12,4756.028458,264.223803,396.335705,123.164366,2,6
0,0,14,14,19,22,41,61,49,110,0.000333,0.196444,18,10607.95297,589.330721,589.330721,178.818118,3,6
0,0,10,10,18,19,37,51,41,92,0.000333,0.159757,18,8626.854773,479.26971,479.26971,155.769273,2,6
0,0,9,9,15,20,35,39,31,70,0.000333,0.119683,7,2513.348678,139.630482,359.049811,145.041921,2,6
0,0,10,10,13,18,31,37,32,69,0.000333,0.113947,6,2051.037273,113.946515,341.839545,123.164366,2,6
0,0,9,9,11,18,29,31,28,59,0.000333,0.09554,5,1433.104394,79.616911,286.620879,113.112398,2,6
0,0,10,10,13,17,30,37,31,68,0.000333,0.111223,6,2002.011363,111.222854,333.668561,117.592585,2,6
0,0,9,9,11,17,28,31,27,58,0.000333,0.092942,5,1394.132927,77.451829,278.826585,107.540616,2,6
0,0,10,10,13,18,31,37,32,69,0.000333,0.113947,6,2051.037273,113.946515,341.839545,123.164366,2,6
0,0,9,9,11,18,29,31,28,59,0.000333,0.09554,5,1433.104394,79.616911,286.620879,113.112398,2,6
0,0,10,10,13,17,30,37,31,68,0.000333,0.111223,6,2002.011363,111.222854,333.668561,117.592585,2,6
0,0,9,9,11,17,28,31,27,58,0.000333,0.092942,5,1394.132927,77.451829,278.826585,107.540616,2,6
0,0,9,9,10,15,25,38,31,69,0.000333,0.106809,10,3204.260771,178.014487,320.426077,91.82264,1,6
0,0,12,12,14,19,33,50,38,88,0.000333,0.147969,14,6214.693555,345.260753,443.906683,134.013592,2,6
0,0,10,10,11,16,27,41,32,73,0.000333,0.115702,10,3471.067877,192.837104,347.106788,102.053748,2,6
0,0,12,12,14,19,33,50,38,88,0.000333,0.147969,14,6214.693555,345.260753,443.906683,134.013592,2,6
0,0,10,10,11,15,26,41,32,73,0.000333,0.114377,10,3431.320994,190.628944,343.132099,96.657107,2,6
0,0,12,12,14,19,33,50,38,88,0.000333,0.147969,14,6214.693555,345.260753,443.906683,134.013592,2,6
0,0,13,13,13,17,30,52,40,92,0.000333,0.150478,12,5417.207218,300.955957,451.433935,117.592585,2,6
0,0,15,15,16,20,36,61,46,107,0.000333,0.184394,16,8850.911602,491.717311,553.181975,150.438562,2,6
0,0,13,13,12,17,29,51,49,100,0.000333,0.161933,12,5829.577194,323.8654,485.7981,112.506418,2,6
0,0,15,15,15,20,35,60,52,112,0.000333,0.191493,14,8042.715771,446.817543,574.479698,145.041921,2,6
0,0,15,15,16,25,41,59,60,119,0.000333,0.212516,16,10200.77902,566.709945,637.548689,180.096405,2,6
0,0,14,14,15,22,37,51,42,93,0.000333,0.161493,7,3391.354141,188.408563,484.479163,156.710855,3,6
0,0,12,12,15,20,35,43,34,77,0.000333,0.131652,7,2764.683546,153.59353,394.954792,145.041921,3,6
0,0,12,12,14,21,35,47,39,86,0.000333,0.147039,7,3087.828376,171.546021,441.118339,145.541635,3,6
0,0,10,10,14,19,33,39,31,70,0.000333,0.117703,7,2471.753118,137.319618,353.107588,134.013592,3,6
0,0,12,12,14,22,36,47,40,87,0.000333,0.149928,7,3148.484326,174.915796,449.783475,151.410465,3,6
0,0,10,10,14,20,34,39,32,71,0.000333,0.120403,7,2528.469032,140.470502,361.209862,139.741531,3,6
0,0,17,17,15,24,39,79,52,131,0.000333,0.230796,14,9693.427669,538.523759,692.387691,168.642459,6,6
0,0,17,17,15,24,39,79,52,131,0.000333,0.230796,14,9693.427669,538.523759,692.387691,168.642459,6,6
0,0,17,17,15,24,39,79,52,131,0.000333,0.230796,14,9693.427669,538.523759,692.387691,168.642459,6,6
0,0,7,7,13,17,30,31,31,62,0.000333,0.101409,6,1825.363302,101.409072,304.227217,117.592585,1,6
0,0,5,5,5,12,17,9,21,30,0.000333,0.040875,2,245.24777,13.624876,122.623885,54.62919,1,6
0,0,11,11,12,19,31,40,44,84,0.000333,0.138717,12,4993.829881,277.434993,416.15249,123.730173,1,6
0,0,10,10,10,19,29,34,39,73,0.000333,0.118211,10,3546.326126,197.018118,354.632613,113.929904,1,6
0,0,15,15,12,21,33,52,81,133,0.000333,0.223635,18,12076.27952,670.904418,670.904418,135.258216,1,6
0,0,13,13,12,20,32,46,66,112,0.000333,0.186667,18,10080,560,560,129.458112,1,6
0,0,14,14,15,23,38,67,56,123,0.000333,0.215165,14,9036.931178,502.051732,645.495084,162.645284,2,6
0,0,13,13,14,21,35,55,66,121,0.000333,0.206881,21,13033.50815,724.083786,620.643245,145.541635,2,6
0,0,9,9,16,17,33,41,34,75,0.000333,0.12611,16,6053.272943,336.292941,378.329559,133.486868,2,6
0,0,11,11,13,19,32,48,35,83,0.000333,0.138333,6,2490,138.333333,415,128.816339,2,6
0,0,12,12,14,20,34,45,36,81,0.000333,0.137361,7,2884.591431,160.255079,412.08449,139.741531,3,6
0,0,8,8,14,20,34,36,32,68,0.000333,0.115316,7,2421.632312,134.535128,345.947473,139.741531,2,6
0,0,14,14,17,24,41,57,55,112,0.000333,0.200015,16,9600.733192,533.374066,600.045825,179.525968,2,6
0,0,14,14,16,22,38,60,43,103,0.000333,0.180179,8,4324.292271,240.23846,540.536534,162.107496,3,6
0,0,11,11,15,14,29,38,34,72,0.000333,0.116592,14,4896.844843,272.046936,349.774632,111.906328,3,6
0,0,11,11,14,16,30,36,33,69,0.000333,0.112858,14,4740.056315,263.336462,338.575451,117.302969,2,6
0,0,11,11,15,19,34,40,35,75,0.000333,0.127187,7,2670.917992,148.384333,381.559713,139.313982,3,6
0,0,16,16,17,22,39,58,58,116,0.000333,0.204369,16,9809.706518,544.983695,613.106657,167.594364,3,6
0,0,10,10,13,16,29,37,32,69,0.000333,0.111734,12,4022.408264,223.467126,335.200689,112.105716,2,6
0,0,9,9,13,15,28,34,27,61,0.000333,0.09775,6,1759.491901,97.74955,293.24865,106.709075,2,6
0,0,16,16,14,21,35,57,54,111,0.000333,0.189783,14,7970.905808,442.8281,569.350415,145.541635,2,6
0,0,21,21,17,23,40,83,60,143,0.000333,0.253679,16,12176.57148,676.476193,761.035718,173.528793,4,6
0,0,10,10,13,15,28,41,31,72,0.000333,0.115377,12,4153.554653,230.753036,346.129554,106.709075,2,6
0,0,15,15,14,20,34,57,40,97,0.000333,0.164495,14,6908.774538,383.820808,493.483896,139.741531,3,6
0,0,15,15,14,21,35,58,41,99,0.000333,0.169266,7,3554.593131,197.477396,507.799019,145.541635,3,6
0,0,12,12,13,17,30,46,36,82,0.000333,0.134122,12,4828.380346,268.243353,402.365029,117.592585,2,6
0,0,20,20,17,21,38,76,57,133,0.000333,0.232658,16,11167.58975,620.421653,697.974359,161.725534,4,6
0,0,10,10,13,15,28,41,31,72,0.000333,0.115377,12,4153.554653,230.753036,346.129554,106.709075,2,6
0,0,15,15,14,19,33,53,40,93,0.000333,0.156376,14,6567.801143,364.877841,469.128653,134.013592,3,6
0,0,11,11,13,17,30,44,34,78,0.000333,0.127579,12,4592.849597,255.158311,382.737466,117.592585,2,6
0,0,10,10,9,15,24,37,54,91,0.000333,0.139077,12,5006.779051,278.154392,417.231588,87.132684,1,6
0,0,11,11,9,16,25,40,42,82,0.000333,0.126932,8,3046.36966,169.242759,380.796208,92.529325,1,6
0,0,10,10,11,17,28,50,35,85,0.000333,0.136208,10,4086.251684,227.013982,408.625168,107.540616,2,6
0,0,17,17,16,22,38,57,55,112,0.000333,0.195923,16,9404.286104,522.460339,587.767882,162.107496,3,6
0,0,11,11,12,17,29,34,33,67,0.000333,0.108495,6,1952.90836,108.494909,325.484727,112.506418,2,6
0,0,13,13,15,15,30,44,38,82,0.000333,0.134122,14,5633.110404,312.950578,402.365029,117.206718,3,6
0,0,13,13,15,17,32,42,37,79,0.000333,0.131667,14,5530,307.222222,395,128.090227,2,6
0,0,12,12,14,15,29,41,36,77,0.000333,0.124688,14,5236.903513,290.939084,374.064537,111.906328,3,6
0,0,12,12,14,17,31,39,35,74,0.000333,0.122204,14,5132.547378,285.141521,366.610527,122.789837,2,6
0,0,12,12,13,15,28,39,36,75,0.000333,0.120184,12,4326.61943,240.367746,360.551619,106.709075,3,6
0,0,12,12,13,17,30,37,35,72,0.000333,0.117765,12,4239.553475,235.530749,353.296123,117.592585,2,6
0,0,7,7,15,19,34,39,31,70,0.000333,0.118707,7,2492.856792,138.492044,356.122399,139.313982,2,6
0,0,14,14,16,18,34,55,45,100,0.000333,0.169582,16,8139.940546,452.218919,508.746284,139.05865,2,6
0,0,12,12,14,22,36,58,43,101,0.000333,0.174054,7,3655.136976,203.063165,522.162425,151.410465,3,6
0,0,13,13,14,18,32,53,44,97,0.000333,0.161667,14,6790,377.222222,485,128.361619,3,6
0,0,14,14,15,21,36,52,49,101,0.000333,0.174054,14,7310.273952,406.126331,522.162425,150.842025,2,6
0,0,20,20,13,22,35,70,78,148,0.000333,0.253045,18,13664.40996,759.133887,759.133887,146.213212,2,6
0,0,10,10,13,16,29,44,35,79,0.000333,0.127927,12,4605.365983,255.853666,383.780499,112.105716,2,6
0,0,16,16,13,20,33,58,54,112,0.000333,0.188324,12,6779.665696,376.648094,564.972141,134.544278,2,6
0,0,10,10,13,16,29,44,35,79,0.000333,0.127927,12,4605.365983,255.853666,383.780499,112.105716,2,6
0,0,13,13,13,19,32,44,44,88,0.000333,0.146667,12,5280,293.333333,440,128.816339,2,6
0,0,11,11,19,17,36,58,42,100,0.000333,0.172331,18,9305.865003,516.9925,516.9925,150.197491,2,6
0,0,22,22,21,24,45,87,80,167,0.000333,0.305713,30,27514.18401,1528.565778,917.139467,202.277766,3,6
0,0,20,20,18,23,41,78,73,151,0.000333,0.269663,27,21842.73952,1213.485529,808.990353,179.100575,2,6
0,0,16,16,14,21,35,69,48,117,0.000333,0.200042,14,8401.765582,466.764755,600.126113,145.541635,3,6
0,0,11,11,14,17,31,47,35,82,0.000333,0.135415,14,5687.417364,315.967631,406.244097,122.789837,2,6
0,0,12,12,14,21,35,60,40,100,0.000333,0.170976,7,3590.498112,199.472117,512.928302,145.541635,3,6
0,0,16,16,14,22,36,62,59,121,0.000333,0.20852,14,8757.852952,486.547386,625.560925,151.410465,2,6
0,0,11,11,15,19,34,42,38,80,0.000333,0.135666,14,5697.958382,316.553243,406.997027,139.313982,2,6
0,0,31,31,22,50,72,139,101,240,0.000333,0.493594,22,32577.20401,1809.844667,1480.782,380.300305,13,6
0,0,31,31,21,52,73,137,100,237,0.000333,0.488996,10,14669.88421,814.993567,1466.98842,388.661531,12,6
0,0,28,28,19,52,71,125,93,218,0.000333,0.446882,9,12065.80385,670.322436,1340.644872,377.133488,11,6
0,0,27,27,19,52,71,124,91,215,0.000333,0.440732,9,11899.76068,661.097815,1322.195631,377.133488,11,6
0,0,21,21,17,26,43,71,62,133,0.000333,0.240564,16,11547.0914,641.505078,721.693212,191.698301,4,6
0,0,12,12,13,20,33,40,32,72,0.000333,0.121065,6,2179.17826,121.065459,363.196377,134.544278,3,6
0,0,12,12,13,20,33,40,32,72,0.000333,0.121065,6,2179.17826,121.065459,363.196377,134.544278,3,6
0,0,16,16,17,21,38,54,50,104,0.000333,0.181928,16,8732.551382,485.141743,545.784461,161.725534,4,6
0,0,10,10,13,17,30,31,28,59,0.000333,0.096502,6,1737.039271,96.502182,289.506545,117.592585,3,6
0,0,16,16,16,23,39,54,51,105,0.000333,0.184989,16,8879.475728,493.304207,554.967233,168.041925,4,6
0,0,10,10,12,18,30,31,29,60,0.000333,0.098138,6,1766.480614,98.137812,294.413436,118.0782,3,6
0,0,16,16,15,21,36,66,47,113,0.000333,0.194734,14,8178.821352,454.378964,584.201525,150.842025,3,6
0,0,11,11,13,17,30,44,35,79,0.000333,0.129215,12,4651.732285,258.429571,387.644357,117.592585,2,6
0,0,17,17,13,23,36,56,73,129,0.000333,0.222307,18,12004.56585,666.920325,666.920325,152.147641,2,6
0,0,7,7,10,13,23,32,24,56,0.000333,0.08444,5,1266.597348,70.366519,253.31947,81.324997,1,6
0,0,13,13,11,19,30,54,48,102,0.000333,0.166834,10,5005.028408,278.057134,500.502841,118.764371,1,6
0,0,12,12,13,20,33,58,51,109,0.000333,0.18328,12,6598.067508,366.559306,549.838959,134.544278,1,6
0,0,4,4,12,13,25,25,20,45,0.000333,0.069658,6,1253.841171,69.657843,208.973529,91.125266,1,6
0,0,4,4,12,11,23,22,20,42,0.000333,0.06333,6,1139.937613,63.329867,189.989602,81.073298,1,6
0,0,17,17,14,18,32,69,53,122,0.000333,0.203333,14,8540,474.444444,610,128.361619,2,6
0,0,10,10,13,15,28,41,32,73,0.000333,0.116979,12,4211.242912,233.95794,350.936909,106.709075,2,6
0,0,13,13,13,18,31,49,39,88,0.000333,0.145323,12,5231.631304,290.646184,435.969275,123.164366,2,6
0,0,12,12,13,18,31,47,37,84,0.000333,0.138717,12,4993.829881,277.434993,416.15249,123.164366,2,6
0,0,17,17,13,18,31,66,53,119,0.000333,0.196516,12,7074.592331,393.032907,589.549361,123.164366,2,6
0,0,10,10,13,15,28,41,32,73,0.000333,0.116979,12,4211.242912,233.95794,350.936909,106.709075,2,6
0,0,14,14,13,18,31,52,43,95,0.000333,0.156883,12,5647.783794,313.765766,470.648649,123.164366,2,6
0,0,13,13,13,18,31,50,41,91,0.000333,0.150277,12,5409.982371,300.554576,450.831864,123.164366,2,6
0,0,17,17,13,18,31,66,57,123,0.000333,0.203122,18,10968.59063,609.366146,609.366146,123.164366,2,6
0,0,10,10,13,15,28,44,34,78,0.000333,0.124991,12,4499.684207,249.982456,374.973684,106.709075,2,6
0,0,14,14,13,18,31,52,47,99,0.000333,0.163488,12,5885.585217,326.976956,490.465435,123.164366,2,6
0,0,13,13,13,18,31,50,45,95,0.000333,0.156883,12,5647.783794,313.765766,470.648649,123.164366,2,6
0,0,11,11,10,16,26,38,40,78,0.000333,0.122211,10,3666.34298,203.685721,366.634298,97.219281,1,6
0,0,5,5,10,12,22,24,21,45,0.000333,0.066891,5,1003.372114,55.742895,200.674423,76.238831,1,6
0,0,12,12,12,18,30,40,40,80,0.000333,0.13085,12,4710.614972,261.700832,392.551248,118.0782,2,6
0,0,12,12,14,21,35,60,41,101,0.000333,0.172686,7,3626.403093,201.466838,518.057585,145.541635,3,6
0,0,12,12,14,21,35,60,40,100,0.000333,0.170976,7,3590.498112,199.472117,512.928302,145.541635,3,6
0,0,12,12,14,22,36,60,41,101,0.000333,0.174054,7,3655.136976,203.063165,522.162425,151.410465,3,6
2,0,9,11,14,16,30,38,28,66,0.000333,0.107952,7,2266.983455,125.943525,323.854779,117.302969,2,6
2,0,10,12,14,16,30,44,30,74,0.000333,0.121037,7,2541.769329,141.209407,363.109904,117.302969,3,6
0,0,9,9,10,15,25,29,26,55,0.000333,0.085137,5,1277.060452,70.947803,255.41209,91.82264,2,6
0,0,11,11,13,16,29,38,31,69,0.000333,0.111734,6,2011.204132,111.733563,335.200689,112.105716,2,6
0,0,9,9,10,15,25,29,26,55,0.000333,0.085137,5,1277.060452,70.947803,255.41209,91.82264,2,6
0,0,11,11,13,16,29,38,31,69,0.000333,0.111734,6,2011.204132,111.733563,335.200689,112.105716,2,6
0,0,9,9,10,14,24,29,26,55,0.000333,0.084058,5,1260.864688,70.048038,252.172938,86.52225,2,6
0,0,11,11,13,16,29,38,31,69,0.000333,0.111734,6,2011.204132,111.733563,335.200689,112.105716,2,6
0,0,11,11,11,15,26,33,28,61,0.000333,0.095576,5,1433.634114,79.64634,286.726823,96.657107,2,6
0,0,11,11,13,16,29,38,31,69,0.000333,0.111734,6,2011.204132,111.733563,335.200689,112.105716,2,6
0,0,8,8,13,14,27,31,27,58,0.000333,0.091928,6,1654.700851,91.927825,275.783475,101.408685,3,6
0,0,8,8,13,16,29,29,26,55,0.000333,0.089063,6,1603.133728,89.062985,267.188955,112.105716,2,6
0,0,19,19,15,21,36,93,67,160,0.000333,0.275729,21,17370.94801,965.052667,827.188,150.842025,2,6
0,0,10,10,14,16,30,47,34,81,0.000333,0.132486,14,5564.413935,309.134108,397.458138,117.302969,2,6
0,0,32,32,23,50,73,141,113,254,0.000333,0.524072,22,34588.73964,1921.596646,1572.215438,386.234734,11,6
0,0,32,32,22,52,74,139,112,251,0.000333,0.519524,22,34288.60149,1904.922305,1558.572795,394.530361,10,6
0,0,11,11,13,19,32,51,47,98,0.000333,0.163333,12,5880,326.666667,490,128.816339,1,6
0,0,9,9,11,16,27,43,32,75,0.000333,0.118872,10,3566.165627,198.120313,356.616563,102.053748,2,6
0,0,18,18,20,27,47,93,64,157,0.000333,0.29069,20,17441.40899,968.967166,872.07045,214.820524,3,6
0,0,10,10,18,19,37,51,41,92,0.000333,0.159757,18,8626.854773,479.26971,479.26971,155.769273,2,6
0,0,14,14,19,23,42,70,52,122,0.000333,0.219288,18,11841.52906,657.862726,657.862726,184.752548,3,6
0,0,10,10,18,19,37,51,41,92,0.000333,0.159757,18,8626.854773,479.26971,479.26971,155.769273,2,6
0,0,14,14,19,24,43,70,53,123,0.000333,0.222477,18,12013.75017,667.430565,667.430565,190.749723,3,6
0,0,10,10,18,19,37,51,41,92,0.000333,0.159757,18,8626.854773,479.26971,479.26971,155.769273,2,6
0,0,15,15,13,20,33,53,71,124,0.000333,0.208502,18,11259.08767,625.504871,625.504871,134.544278,2,6
0,0,18,18,13,24,37,63,65,128,0.000333,0.22227,12,8001.72037,444.540021,666.810031,158.144816,2,6
0,0,9,9,12,17,29,43,33,76,0.000333,0.123069,6,2215.239334,123.068852,369.206556,112.506418,1,6
0,0,9,9,13,14,27,44,31,75,0.000333,0.118872,12,4279.398752,237.744375,356.616563,101.408685,1,6
0,0,10,10,13,18,31,46,34,80,0.000333,0.132112,6,2378.014229,132.111902,396.335705,123.164366,2,6
0,0,10,10,13,19,32,46,35,81,0.000333,0.135,6,2430,135,405,128.816339,2,6
0,0,13,13,15,21,36,55,61,116,0.000333,0.199904,14,8395.958202,466.442122,599.7113,150.842025,2,6
0,0,15,15,14,20,34,67,46,113,0.000333,0.191628,14,8048.366215,447.131456,574.883301,139.741531,3,6
0,0,10,10,14,16,30,44,33,77,0.000333,0.125944,14,5289.628062,293.868226,377.830576,117.302969,2,6
0,0,12,12,17,19,36,55,42,97,0.000333,0.167161,16,8023.723602,445.762422,501.482725,150.197491,3,6
0,0,10,10,14,17,31,46,35,81,0.000333,0.133763,14,5618.058616,312.114368,401.289901,122.789837,2,6
0,0,14,14,17,20,37,63,55,118,0.000333,0.204905,16,9835.447954,546.413775,614.715497,155.92543,3,6
0,0,12,12,17,19,36,59,47,106,0.000333,0.182671,16,8768.192802,487.121822,548.01205,150.197491,3,6
0,0,11,11,14,18,32,43,34,77,0.000333,0.128333,7,2695,149.722222,385,128.361619,2,6
0,0,12,12,14,18,32,46,35,81,0.000333,0.135,7,2835,157.5,405,128.361619,3,6
0,0,13,13,13,22,35,57,60,117,0.000333,0.200042,12,7201.513356,400.084075,600.126113,146.213212,1,6
0,0,13,13,15,20,35,62,44,106,0.000333,0.181235,14,7611.855997,422.880889,543.704,145.041921,2,6
0,0,14,14,16,20,36,64,46,110,0.000333,0.189564,16,9099.068003,505.503778,568.69175,150.438562,2,6
0,0,11,11,15,19,34,40,35,75,0.000333,0.127187,7,2670.917992,148.384333,381.559713,139.313982,3,6
0,0,4,4,9,12,21,16,19,35,0.000333,0.051244,4,614.924439,34.162469,153.73111,71.548875,1,6
0,0,11,11,13,19,32,42,44,86,0.000333,0.143333,12,5160,286.666667,430,128.816339,1,6
0,0,3,3,10,10,20,15,16,31,0.000333,0.04466,5,669.898855,37.216603,133.979771,66.438562,1,6
0,0,15,15,14,21,35,55,53,108,0.000333,0.184654,14,7755.475922,430.859773,553.962566,145.541635,2,6
0,0,8,8,11,14,25,35,25,60,0.000333,0.092877,5,1393.156857,77.397603,278.631371,91.356717,2,6
0,0,10,10,13,15,28,40,28,68,0.000333,0.108967,6,1961.400808,108.966712,326.900135,106.709075,2,6
0,0,16,16,14,18,32,66,48,114,0.000333,0.19,14,7980,443.333333,570,128.361619,3,6
0,0,10,10,14,15,29,44,32,76,0.000333,0.123069,14,5168.891779,287.160654,369.206556,111.906328,2,6
0,0,13,13,14,18,32,52,38,90,0.000333,0.15,14,6300,350,450,128.361619,3,6
0,0,11,11,14,17,31,47,35,82,0.000333,0.135415,14,5687.417364,315.967631,406.244097,122.789837,2,6
0,0,16,16,14,20,34,72,52,124,0.000333,0.210282,14,8831.835492,490.657527,630.845392,139.741531,3,6
0,0,10,10,13,15,28,41,32,73,0.000333,0.116979,12,4211.242912,233.95794,350.936909,106.709075,2,6
0,0,10,10,11,16,27,41,33,74,0.000333,0.117287,10,3518.616752,195.478708,351.861675,102.053748,2,6
0,0,12,12,14,19,33,50,38,88,0.000333,0.147969,14,6214.693555,345.260753,443.906683,134.013592,2,6
0,0,10,10,11,16,27,41,32,73,0.000333,0.115702,10,3471.067877,192.837104,347.106788,102.053748,2,6
0,0,12,12,14,19,33,50,38,88,0.000333,0.147969,14,6214.693555,345.260753,443.906683,134.013592,2,6
0,0,16,16,14,19,33,72,51,123,0.000333,0.20682,14,8686.446674,482.580371,620.460477,134.013592,3,6
0,0,10,10,13,15,28,41,32,73,0.000333,0.116979,12,4211.242912,233.95794,350.936909,106.709075,2,6
0,0,10,10,11,17,28,41,33,74,0.000333,0.118581,5,1778.721321,98.817851,355.744264,107.540616,2,6
0,0,12,12,14,19,33,50,38,88,0.000333,0.147969,14,6214.693555,345.260753,443.906683,134.013592,2,6
0,0,11,11,10,17,27,49,39,88,0.000333,0.139477,10,4184.301002,232.461167,418.4301,102.706149,1,6
0,0,13,13,13,18,31,57,42,99,0.000333,0.163488,12,5885.585217,326.976956,490.465435,123.164366,2,6
0,0,9,9,10,16,26,43,33,76,0.000333,0.119078,10,3572.334186,198.46301,357.233419,97.219281,1,6
0,0,11,11,13,19,32,52,40,92,0.000333,0.153333,12,5520,306.666667,460,128.816339,2,6
0,0,21,21,17,24,41,74,75,149,0.000333,0.266092,24,19158.60597,1064.366998,798.275249,179.525968,3,6
0,0,10,10,13,18,31,43,37,80,0.000333,0.132112,12,4756.028458,264.223803,396.335705,123.164366,2,6
0,0,20,20,17,23,40,82,67,149,0.000333,0.264322,16,12687.47658,704.85981,792.967286,173.528793,3,6
0,0,10,10,13,17,30,44,34,78,0.000333,0.127579,12,4592.849597,255.158311,382.737466,117.592585,2,6
0,0,19,19,17,22,39,73,63,136,0.000333,0.239605,16,11501.03523,638.946402,718.814702,167.594364,3,6
0,0,10,10,13,17,30,45,34,79,0.000333,0.129215,12,4651.732285,258.429571,387.644357,117.592585,2,6
0,0,15,15,13,17,30,60,47,107,0.000333,0.175012,12,6300.447525,350.024862,525.037294,117.592585,2,6
0,0,10,10,13,15,28,41,32,73,0.000333,0.116979,12,4211.242912,233.95794,350.936909,106.709075,2,6
0,0,12,12,13,17,30,46,37,83,0.000333,0.135757,12,4887.263033,271.514613,407.271919,117.592585,2,6
0,0,11,11,13,17,30,44,35,79,0.000333,0.129215,12,4651.732285,258.429571,387.644357,117.592585,2,6
0,0,18,18,15,19,34,68,51,119,0.000333,0.201803,14,8475.713094,470.87295,605.408078,139.313982,3,6
0,0,10,10,13,15,28,41,32,73,0.000333,0.116979,12,4211.242912,233.95794,350.936909,106.709075,2,6
0,0,15,15,15,19,34,54,41,95,0.000333,0.161103,14,6766.325579,375.906977,483.30897,139.313982,3,6
0,0,11,11,13,17,30,44,35,79,0.000333,0.129215,12,4651.732285,258.429571,387.644357,117.592585,2,6
0,0,17,17,17,24,41,58,51,109,0.000333,0.194658,16,9343.570696,519.087261,583.973169,179.525968,4,6
0,0,12,12,13,19,32,35,31,66,0.000333,0.11,6,1980,110,330,128.816339,3,6
0,0,20,20,17,27,44,72,61,133,0.000333,0.242035,16,11617.67048,645.426138,726.104405,197.868831,4,6
0,0,12,12,14,21,35,41,33,74,0.000333,0.126522,7,2656.968603,147.609367,379.566943,145.541635,3,6
0,0,12,12,13,20,33,40,32,72,0.000333,0.121065,6,2179.17826,121.065459,363.196377,134.544278,3,6
0,0,15,15,16,24,40,54,49,103,0.000333,0.18272,16,8770.5375,487.252083,548.158594,174.0391,4,6
0,0,10,10,12,18,30,31,29,60,0.000333,0.098138,6,1766.480614,98.137812,294.413436,118.0782,3,6
0,0,15,15,17,23,40,54,48,102,0.000333,0.180946,16,8685.386651,482.521481,542.836666,173.528793,4,6
0,0,10,10,13,17,30,31,28,59,0.000333,0.096502,6,1737.039271,96.502182,289.506545,117.592585,3,6
0,0,15,15,17,22,39,54,48,102,0.000333,0.179704,16,8625.776421,479.209801,539.111026,167.594364,4,6
0,0,10,10,13,17,30,31,28,59,0.000333,0.096502,6,1737.039271,96.502182,289.506545,117.592585,3,6
0,0,10,10,12,16,28,44,32,76,0.000333,0.121786,12,4384.307689,243.572649,365.358974,107.01955,2,6
0,0,5,5,9,12,21,21,19,40,0.000333,0.058564,4,702.770788,39.042822,175.692697,71.548875,1,6
0,0,13,13,13,20,33,45,62,107,0.000333,0.179917,18,9715.503074,539.750171,539.750171,134.544278,2,6
0,0,15,15,15,23,38,66,56,122,0.000333,0.213416,14,8963.460193,497.970011,640.247157,162.645284,2,6
0,0,7,7,13,17,30,27,26,53,0.000333,0.086688,6,1560.391209,86.688401,260.065202,117.592585,2,6
0,0,29,29,19,51,70,128,95,223,0.000333,0.45561,9,12301.47102,683.415056,1366.830113,370.004315,11,6
0,0,28,28,19,51,70,127,93,220,0.000333,0.449481,9,12135.98037,674.221132,1348.442264,370.004315,11,6
0,0,19,19,18,26,44,73,74,147,0.000333,0.267512,18,14445.65606,802.536448,802.536448,197.270083,3,6
0,0,12,12,14,22,36,49,40,89,0.000333,0.153374,7,3220.863276,178.936849,460.123325,151.410465,3,6
0,0,12,12,14,21,35,49,39,88,0.000333,0.150459,7,3159.638338,175.535463,451.376905,145.541635,3,6
0,0,12,12,14,22,36,49,40,89,0.000333,0.153374,7,3220.863276,178.936849,460.123325,151.410465,3,6
0,0,18,18,16,23,39,66,55,121,0.000333,0.213178,16,10232.5387,568.474372,639.533668,168.041925,3,6
0,0,31,31,22,49,71,139,101,240,0.000333,0.49198,22,32470.66479,1803.925822,1475.939309,373.228278,13,6
0,0,31,31,21,51,72,137,100,237,0.000333,0.487424,10,14622.72225,812.373459,1462.272225,381.532358,12,6
0,0,28,28,19,51,70,125,93,218,0.000333,0.445395,9,12025.65328,668.091849,1336.183698,370.004315,11,6
0,0,27,27,19,51,70,124,91,215,0.000333,0.439265,9,11860.16264,658.897924,1317.795849,370.004315,11,6
0,0,17,17,17,21,38,81,57,138,0.000333,0.241405,16,11587.42395,643.745775,724.213997,161.725534,3,6
0,0,10,10,14,15,29,44,32,76,0.000333,0.123069,14,5168.891779,287.160654,369.206556,111.906328,2,6
0,0,35,35,24,50,74,149,107,256,0.000333,0.529873,24,38150.88148,2119.493415,1589.620062,392.23191,13,6
0,0,35,35,23,52,75,147,106,253,0.000333,0.525297,22,34669.60483,1926.089157,1575.891129,400.46479,12,6
0,0,30,30,21,52,73,130,96,226,0.000333,0.4663,10,13989.0035,777.166861,1398.90035,388.661531,11,6
0,0,29,29,21,52,73,129,94,223,0.000333,0.46011,10,13803.30877,766.850487,1380.330877,388.661531,11,6
0,0,31,31,22,50,72,139,101,240,0.000333,0.493594,22,32577.20401,1809.844667,1480.782,380.300305,13,6
0,0,31,31,21,52,73,137,100,237,0.000333,0.488996,10,14669.88421,814.993567,1466.98842,388.661531,12,6
0,0,28,28,19,52,71,125,93,218,0.000333,0.446882,9,12065.80385,670.322436,1340.644872,377.133488,11,6
0,0,27,27,19,52,71,124,91,215,0.000333,0.440732,9,11899.76068,661.097815,1322.195631,377.133488,11,6
0,0,31,31,22,51,73,139,103,242,0.000333,0.499313,22,32954.62595,1830.812553,1497.937543,387.401188,13,6
0,0,31,31,21,53,74,137,102,239,0.000333,0.494686,10,14840.59354,824.477419,1484.059354,395.81845,12,6
0,0,28,28,19,53,72,125,94,219,0.000333,0.450405,9,12160.92218,675.606788,1351.213575,384.290407,11,6
0,0,27,27,19,53,72,124,92,216,0.000333,0.444235,9,11994.3342,666.3519,1332.7038,384.290407,11,6
0,0,4,4,10,11,21,18,19,37,0.000333,0.054172,5,812.578723,45.143262,162.515745,71.273029,1,6
0,0,8,8,12,17,29,40,29,69,0.000333,0.111734,6,2011.204132,111.733563,335.200689,112.506418,2,6
0,0,8,8,12,17,29,40,29,69,0.000333,0.111734,6,2011.204132,111.733563,335.200689,112.506418,2,6
0,0,16,16,16,23,39,59,50,109,0.000333,0.192036,16,9217.74147,512.096748,576.108842,168.041925,3,6
0,0,9,9,14,18,32,36,35,71,0.000333,0.118333,7,2485,138.055556,355,128.361619,2,6
0,0,16,16,17,25,42,61,62,123,0.000333,0.221085,16,10612.08069,589.560038,663.255043,185.583273,2,6
0,0,14,14,14,22,36,54,47,101,0.000333,0.174054,14,7310.273952,406.126331,522.162425,151.410465,3,6
0,0,16,16,14,19,33,72,52,124,0.000333,0.208502,14,8757.068191,486.503788,625.504871,134.013592,3,6
0,0,10,10,13,15,28,41,32,73,0.000333,0.116979,12,4211.242912,233.95794,350.936909,106.709075,2,6
0,0,15,15,14,18,32,69,50,119,0.000333,0.198333,14,8330,462.777778,595,128.361619,2,6
0,0,10,10,13,15,28,41,32,73,0.000333,0.116979,12,4211.242912,233.95794,350.936909,106.709075,2,6
0,0,10,10,15,18,33,39,36,75,0.000333,0.12611,14,5296.613825,294.256324,378.329559,133.662009,2,6
0,0,5,5,5,10,15,9,17,26,0.000333,0.03386,2,203.158311,11.286573,101.579155,44.828921,1,6
0,0,15,15,14,21,35,51,55,106,0.000333,0.181235,14,7611.855997,422.880889,543.704,145.541635,2,6
0,0,12,12,14,19,33,41,44,85,0.000333,0.142925,14,6002.829002,333.4905,428.7735,134.013592,2,6
0,0,11,11,10,17,27,49,45,94,0.000333,0.148986,10,4469.594252,248.310792,446.959425,102.706149,1,6
0,0,12,12,12,17,29,54,41,95,0.000333,0.153836,12,5538.098334,307.67213,461.508195,112.506418,1,6
0,0,12,12,16,22,38,52,48,100,0.000333,0.174931,16,8396.684022,466.482446,524.792751,162.107496,3,6
0,0,16,16,14,21,35,70,57,127,0.000333,0.21714,14,9119.865204,506.659178,651.418943,145.541635,2,6
0,0,10,10,14,16,30,47,35,82,0.000333,0.134122,14,5633.110404,312.950578,402.365029,117.302969,2,6
0,0,11,11,15,17,32,48,36,84,0.000333,0.14,14,5880,326.666667,420,128.090227,2,6
0,0,17,17,15,24,39,72,57,129,0.000333,0.227272,14,9545.436407,530.302023,681.816886,168.642459,2,6
0,0,10,10,14,16,30,44,33,77,0.000333,0.125944,14,5289.628062,293.868226,377.830576,117.302969,2,6
0,0,16,16,17,23,40,70,60,130,0.000333,0.230617,16,11069.61044,614.978358,691.850652,173.528793,3,6
0,0,21,21,14,23,37,84,82,166,0.000333,0.288256,21,18160.15443,1008.897468,864.769259,157.344894,2,6
0,0,11,11,14,17,31,50,37,87,0.000333,0.143672,14,6034.211106,335.23395,431.015079,122.789837,2,6
0,0,12,12,14,20,34,49,37,86,0.000333,0.145841,7,3062.65263,170.147368,437.521804,139.741531,3,6
0,0,11,11,14,19,33,44,32,76,0.000333,0.127791,7,2683.617671,149.089871,383.373953,134.013592,3,6
0,0,13,13,17,21,38,55,43,98,0.000333,0.171432,16,8228.750341,457.152797,514.296896,161.725534,3,6
0,0,12,12,17,20,37,50,38,88,0.000333,0.152811,8,3667.455169,203.747509,458.431896,155.92543,3,6
0,0,7,7,15,17,32,35,32,67,0.000333,0.111667,7,2345,130.277778,335,128.090227,1,6
0,0,9,9,12,15,27,26,25,51,0.000333,0.080833,6,1454.995576,80.833088,242.499263,101.622909,2,6
0,0,9,9,12,15,27,26,25,51,0.000333,0.080833,6,1454.995576,80.833088,242.499263,101.622909,2,6
0,0,9,9,12,15,27,26,25,51,0.000333,0.080833,6,1454.995576,80.833088,242.499263,101.622909,2,6
0,0,15,15,13,20,33,59,55,114,0.000333,0.191687,12,6900.731155,383.373953,575.06093,134.544278,2,6
0,0,16,16,14,23,37,47,61,108,0.000333,0.18754,14,7876.693489,437.594083,562.620963,157.344894,2,6
0,0,12,12,13,20,33,43,36,79,0.000333,0.132836,6,2391.042813,132.835712,398.507135,134.544278,3,6
0,0,11,11,13,19,32,38,31,69,0.000333,0.115,6,2070,115,345,128.816339,3,6
0,0,12,12,13,21,34,43,37,80,0.000333,0.135666,6,2441.982164,135.665676,406.997027,140.344382,3,6
0,0,11,11,13,20,33,38,32,70,0.000333,0.117703,6,2118.64553,117.702529,353.107588,134.544278,3,6
0,0,10,10,12,16,28,37,37,74,0.000333,0.118581,12,4268.931171,237.162843,355.744264,107.01955,1,6
0,0,14,14,14,22,36,58,68,126,0.000333,0.217137,21,13679.62155,759.978975,651.41055,151.410465,2,6
0,0,17,17,14,23,37,70,75,145,0.000333,0.25179,21,15862.7855,881.265861,755.370738,157.344894,2,6
0,0,8,8,14,19,33,40,32,72,0.000333,0.121065,7,2542.374636,141.243035,363.196377,134.013592,2,6
0,0,5,5,8,11,19,26,19,45,0.000333,0.063719,4,764.626952,42.479275,191.156738,62.053748,1,6
0,0,12,12,14,15,29,42,32,74,0.000333,0.11983,14,5032.868311,279.603795,359.490594,111.906328,5,6
0,0,12,12,13,17,30,40,31,71,0.000333,0.11613,6,2090.335394,116.129744,348.389232,117.592585,4,6
0,0,19,19,15,24,39,64,67,131,0.000333,0.230796,14,9693.427669,538.523759,692.387691,168.642459,2,6
0,0,20,20,14,22,36,93,70,163,0.000333,0.280899,21,17696.65328,983.147404,842.697775,151.410465,2,6
0,0,10,10,14,16,30,49,34,83,0.000333,0.135757,14,5701.806872,316.767048,407.271919,117.302969,2,6
0,0,18,18,15,20,35,84,63,147,0.000333,0.251335,21,15834.09667,879.672037,754.004603,145.041921,2,6
0,0,10,10,14,16,30,48,34,82,0.000333,0.134122,14,5633.110404,312.950578,402.365029,117.302969,2,6
0,0,19,19,15,21,36,93,67,160,0.000333,0.275729,21,17370.94801,965.052667,827.188,150.842025,2,6
0,0,10,10,14,16,30,47,34,81,0.000333,0.132486,14,5564.413935,309.134108,397.458138,117.302969,2,6
0,0,9,9,11,16,27,47,32,79,0.000333,0.125212,10,3756.361127,208.686729,375.636113,102.053748,2,6
0,0,9,9,11,16,27,47,32,79,0.000333,0.125212,10,3756.361127,208.686729,375.636113,102.053748,2,6
0,0,13,13,12,16,28,45,62,107,0.000333,0.171462,18,9258.96558,514.386977,514.386977,107.01955,3,6
0,0,13,13,12,18,30,43,61,104,0.000333,0.170106,18,9185.699195,510.316622,510.316622,118.0782,2,6
0,0,31,31,22,48,70,138,111,249,0.000333,0.50873,22,33576.21237,1865.345131,1526.191471,366.185696,9,6
0,0,31,31,21,50,71,136,110,246,0.000333,0.504279,20,30256.75583,1680.930879,1512.837791,374.431475,8,6
0,0,31,31,22,49,71,132,116,248,0.000333,0.508379,22,33553.02028,1864.056682,1525.137286,373.228278,9,6
0,0,31,31,21,51,72,130,115,245,0.000333,0.503877,20,30232.63251,1679.590695,1511.631625,381.532358,8,6
0,0,9,9,13,17,30,33,29,62,0.000333,0.101409,6,1825.363302,101.409072,304.227217,117.592585,2,6
0,0,9,9,13,17,30,33,29,62,0.000333,0.101409,6,1825.363302,101.409072,304.227217,117.592585,2,6
0,0,9,9,13,17,30,33,29,62,0.000333,0.101409,6,1825.363302,101.409072,304.227217,117.592585,2,6
0,0,9,9,13,17,30,33,29,62,0.000333,0.101409,6,1825.363302,101.409072,304.227217,117.592585,2,6
0,0,11,11,13,18,31,44,34,78,0.000333,0.128809,6,2318.563873,128.809104,386.427312,123.164366,2,6
0,0,16,16,19,22,41,76,58,134,0.000333,0.239304,18,12922.41544,717.911969,717.911969,178.818118,4,6
0,0,11,11,17,18,35,56,45,101,0.000333,0.172686,16,8288.921355,460.495631,518.057585,144.545518,3,6
0,0,16,16,19,22,41,76,58,134,0.000333,0.239304,18,12922.41544,717.911969,717.911969,178.818118,4,6
0,0,11,11,17,18,35,56,45,101,0.000333,0.172686,16,8288.921355,460.495631,518.057585,144.545518,3,6
0,0,16,16,19,23,42,76,59,135,0.000333,0.242654,18,13103.33134,727.962852,727.962852,184.752548,4,6
0,0,11,11,17,18,35,56,45,101,0.000333,0.172686,16,8288.921355,460.495631,518.057585,144.545518,3,6
0,0,18,18,20,24,44,80,61,141,0.000333,0.256593,20,15395.59717,855.310954,769.779858,196.477662,4,6
0,0,11,11,17,18,35,56,45,101,0.000333,0.172686,16,8288.921355,460.495631,518.057585,144.545518,3,6
0,0,16,16,19,22,41,76,58,134,0.000333,0.239304,18,12922.41544,717.911969,717.911969,178.818118,4,6
0,0,11,11,17,18,35,56,45,101,0.000333,0.172686,16,8288.921355,460.495631,518.057585,144.545518,3,6
0,0,14,14,14,21,35,48,44,92,0.000333,0.157298,14,6606.516526,367.028696,471.894038,145.541635,3,6
0,0,10,10,13,18,31,34,29,63,0.000333,0.104038,6,1872.686205,104.038123,312.114368,123.164366,3,6
0,0,14,14,14,22,36,48,45,93,0.000333,0.160268,14,6731.242352,373.957908,480.803025,151.410465,3,6
0,0,10,10,13,19,32,34,30,64,0.000333,0.106667,6,1920,106.666667,320,128.816339,3,6
0,0,13,13,14,20,34,45,43,88,0.000333,0.149232,14,6267.75422,348.208568,447.69673,139.741531,2,6
0,0,9,9,13,17,30,31,28,59,0.000333,0.096502,6,1737.039271,96.502182,289.506545,117.592585,2,6
0,0,13,13,15,20,35,50,41,91,0.000333,0.155588,14,6534.706564,363.039254,466.764755,145.041921,3,6
0,0,13,13,15,20,35,50,41,91,0.000333,0.155588,14,6534.706564,363.039254,466.764755,145.041921,3,6
0,0,13,13,15,20,35,50,41,91,0.000333,0.155588,14,6534.706564,363.039254,466.764755,145.041921,3,6
0,0,13,13,15,20,35,50,41,91,0.000333,0.155588,14,6534.706564,363.039254,466.764755,145.041921,3,6
0,0,13,13,15,19,34,50,40,90,0.000333,0.152624,14,6410.20318,356.122399,457.871656,139.313982,3,6
0,0,14,14,17,20,37,57,44,101,0.000333,0.175385,16,8418.476639,467.693147,526.15479,155.92543,3,6
0,0,11,11,14,14,28,45,31,76,0.000333,0.121786,14,5115.025637,284.168091,365.358974,106.605938,2,6
0,0,19,19,17,22,39,78,64,142,0.000333,0.250176,16,12008.43384,667.135213,750.527115,167.594364,3,6
0,0,11,11,13,17,30,47,36,83,0.000333,0.135757,12,4887.263033,271.514613,407.271919,117.592585,2,6
0,0,11,11,12,17,29,44,43,87,0.000333,0.140881,12,5071.732159,281.762898,422.644347,112.506418,1,6
0,0,11,11,13,19,32,49,44,93,0.000333,0.155,12,5580,310,465,128.816339,1,6
0,0,11,11,13,17,30,47,37,84,0.000333,0.137393,12,4946.14572,274.785873,412.17881,117.592585,1,6
0,0,11,11,13,20,33,52,49,101,0.000333,0.169828,12,6113.805673,339.655871,509.483806,134.544278,1,6
0,0,6,6,13,12,25,31,26,57,0.000333,0.088233,12,3176.397634,176.466535,264.699803,91.125266,1,6
0,0,15,15,14,20,34,60,43,103,0.000333,0.17467,14,7336.121417,407.562301,524.008673,139.741531,3,6
0,0,10,10,13,17,30,38,31,69,0.000333,0.112858,6,2031.452707,112.858484,338.575451,117.592585,2,6
0,0,14,14,15,24,39,60,51,111,0.000333,0.19556,14,8213.515048,456.306392,586.679646,168.642459,2,6
0,0,14,14,15,21,36,58,51,109,0.000333,0.187841,14,7889.305552,438.294753,563.521825,150.842025,2,6
0,0,13,13,14,20,34,56,65,121,0.000333,0.205194,21,12927.24308,718.180171,615.583004,139.741531,2,6
0,0,7,7,14,17,31,38,29,67,0.000333,0.110644,7,2323.51807,129.084337,331.931153,122.789837,2,6
0,0,8,8,14,18,32,38,33,71,0.000333,0.118333,7,2485,138.055556,355,128.361619,2,6
0,0,13,13,16,15,31,44,45,89,0.000333,0.146974,24,10582.16332,587.897962,440.923472,122.603359,3,6
0,0,13,13,15,17,32,42,44,86,0.000333,0.143333,14,6020,334.444444,430,128.090227,2,6
0,0,14,14,16,16,32,52,49,101,0.000333,0.168333,24,12120,673.333333,505,128,3,6
0,0,14,14,15,18,33,50,48,98,0.000333,0.164784,14,6920.908732,384.49493,494.350624,133.662009,2,6
0,0,35,35,22,52,74,148,135,283,0.000333,0.585758,22,38660.05665,2147.780925,1757.275302,394.530361,11,6
0,0,35,35,21,54,75,146,134,280,0.000333,0.581356,20,34881.38467,1937.854704,1744.069233,403.002591,10,6
0,0,15,15,14,18,32,56,43,99,0.000333,0.165,14,6930,385,495,128.361619,3,6
0,0,9,9,13,15,28,34,27,61,0.000333,0.09775,6,1759.491901,97.74955,293.24865,106.709075,2,6
0,0,12,12,14,18,32,42,33,75,0.000333,0.125,7,2625,145.833333,375,128.361619,3,6
0,0,10,10,13,17,30,37,30,67,0.000333,0.109587,6,1972.570019,109.587223,328.76167,117.592585,2,6
0,0,8,8,14,14,28,31,27,58,0.000333,0.092942,7,1951.786098,108.432561,278.826585,106.605938,3,6
0,0,8,8,13,16,29,29,26,55,0.000333,0.089063,6,1603.133728,89.062985,267.188955,112.105716,2,6
0,0,13,13,14,20,34,53,49,102,0.000333,0.172974,14,7264.896937,403.605385,518.92121,139.741531,2,6
0,0,8,8,14,15,29,36,27,63,0.000333,0.102018,7,2142.369619,119.020534,306.052803,111.906328,2,6
0,0,16,16,15,20,35,66,47,113,0.000333,0.193203,14,8114.525733,450.806985,579.608981,145.041921,3,6
0,0,11,11,13,17,30,44,35,79,0.000333,0.129215,12,4651.732285,258.429571,387.644357,117.592585,2,6
0,0,16,16,14,22,36,66,48,114,0.000333,0.196457,14,8251.200302,458.400017,589.37145,151.410465,3,6
0,0,11,11,13,17,30,44,35,79,0.000333,0.129215,12,4651.732285,258.429571,387.644357,117.592585,2,6
0,0,19,19,15,22,37,76,64,140,0.000333,0.243108,14,10210.5286,567.251589,729.323471,156.710855,3,6
0,0,11,11,13,17,30,44,35,79,0.000333,0.129215,12,4651.732285,258.429571,387.644357,117.592585,2,6
0,0,19,19,16,22,38,77,55,132,0.000333,0.230909,16,11083.62291,615.756828,692.726432,162.107496,3,6
0,0,11,11,13,17,30,44,35,79,0.000333,0.129215,12,4651.732285,258.429571,387.644357,117.592585,2,6
0,0,15,15,14,20,34,63,46,109,0.000333,0.184844,14,7763.468296,431.303794,554.53345,139.741531,2,6
0,0,11,11,13,17,30,44,35,79,0.000333,0.129215,12,4651.732285,258.429571,387.644357,117.592585,2,6
0,0,11,11,10,17,27,34,35,69,0.000333,0.109362,10,3280.872376,182.270688,328.087238,102.706149,1,6
0,0,13,13,14,19,33,45,38,83,0.000333,0.139562,14,5861.585967,325.643665,418.684712,134.013592,2,6
0,0,12,12,11,18,29,46,45,91,0.000333,0.147359,10,4420.762706,245.597928,442.076271,113.112398,1,6
0,0,14,14,15,20,35,51,52,103,0.000333,0.176105,14,7396.42611,410.912562,528.316151,145.041921,2,6
0,0,17,17,15,19,34,61,46,107,0.000333,0.181453,14,7621.019336,423.389963,544.358524,139.313982,3,6
0,0,9,9,13,15,28,34,27,61,0.000333,0.09775,6,1759.491901,97.74955,293.24865,106.709075,2,6
0,0,14,14,15,19,34,47,36,83,0.000333,0.140753,7,2955.815911,164.211995,422.259416,139.313982,3,6
0,0,10,10,13,17,30,37,30,67,0.000333,0.109587,6,1972.570019,109.587223,328.76167,117.592585,2,6
0,0,7,7,14,19,33,33,30,63,0.000333,0.105932,7,2224.577807,123.587656,317.79683,134.013592,2,6
0,0,11,11,13,19,32,34,34,68,0.000333,0.113333,6,2040,113.333333,340,128.816339,2,6
0,0,9,9,12,16,28,26,26,52,0.000333,0.083327,6,1499.894736,83.327485,249.982456,107.01955,2,6
0,0,10,10,13,21,34,46,43,89,0.000333,0.150928,12,5433.410314,301.856129,452.784193,140.344382,2,6
0,0,10,10,13,20,33,46,42,88,0.000333,0.147969,12,5326.88019,295.937788,443.906683,134.544278,2,6
0,0,7,7,12,17,29,30,35,65,0.000333,0.105256,12,3789.225176,210.51251,315.768765,112.506418,1,6
0,0,16,16,16,22,38,59,57,116,0.000333,0.20292,16,9740.153465,541.119637,608.759592,162.107496,3,6
0,0,12,12,12,17,29,39,40,79,0.000333,0.127927,12,4605.365983,255.853666,383.780499,112.506418,2,6
0,0,9,9,9,15,24,25,29,54,0.000333,0.082529,4,990.3519,55.01955,247.587975,87.132684,1,6
0,0,9,9,12,15,27,26,25,51,0.000333,0.080833,6,1454.995576,80.833088,242.499263,101.622909,2,6
0,0,16,16,18,24,42,75,64,139,0.000333,0.249844,18,13491.57819,749.532122,749.532122,185.09775,2,6
0,0,11,11,18,20,38,57,45,102,0.000333,0.17843,18,9635.194915,535.288606,535.288606,161.497212,2,6
0,0,13,13,16,20,36,50,48,98,0.000333,0.168884,16,8106.442402,450.357911,506.65265,150.438562,1,6
0,0,10,10,15,15,30,42,34,76,0.000333,0.124308,14,5220.931594,290.051755,372.923685,117.206718,2,6
0,0,16,16,15,19,34,71,51,122,0.000333,0.20689,14,8689.386533,482.743696,620.670467,139.313982,2,6
0,0,9,9,13,15,28,34,27,61,0.000333,0.09775,6,1759.491901,97.74955,293.24865,106.709075,2,6
0,0,10,10,11,18,29,36,33,69,0.000333,0.111734,5,1676.003443,93.111302,335.200689,113.112398,2,6
0,0,10,10,11,18,29,36,33,69,0.000333,0.111734,5,1676.003443,93.111302,335.200689,113.112398,2,6
0,0,12,12,13,18,31,41,35,76,0.000333,0.125506,6,2259.113518,125.506307,376.51892,123.164366,2,6
0,0,10,10,11,17,28,36,32,68,0.000333,0.108967,5,1634.500673,90.805593,326.900135,107.540616,2,6
0,0,14,14,13,20,33,59,44,103,0.000333,0.173191,12,6234.871132,346.38173,519.572594,134.544278,2,6
0,0,16,16,16,22,38,54,50,104,0.000333,0.181928,16,8732.551382,485.141743,545.784461,162.107496,4,6
0,0,10,10,12,17,29,31,28,59,0.000333,0.09554,6,1719.725272,95.540293,286.620879,112.506418,3,6
0,0,16,16,16,23,39,54,51,105,0.000333,0.184989,16,8879.475728,493.304207,554.967233,168.041925,4,6
0,0,10,10,12,18,30,31,29,60,0.000333,0.098138,6,1766.480614,98.137812,294.413436,118.0782,3,6
0,0,17,17,16,22,38,60,56,116,0.000333,0.20292,16,9740.153465,541.119637,608.759592,162.107496,4,6
0,0,11,11,15,19,34,37,34,71,0.000333,0.120403,7,2528.469032,140.470502,361.209862,139.313982,3,6
0,0,11,11,12,17,29,40,36,76,0.000333,0.123069,12,4430.478668,246.137704,369.206556,112.506418,1,6
0,0,10,10,10,17,27,34,32,66,0.000333,0.104608,5,1569.112876,87.172938,313.822575,102.706149,1,6
0,0,11,11,13,14,27,41,34,75,0.000333,0.118872,12,4279.398752,237.744375,356.616563,101.408685,1,6
0,0,10,10,11,14,25,35,30,65,0.000333,0.100617,10,3018.506523,167.694807,301.850652,91.356717,1,6
0,0,14,14,19,23,42,70,52,122,0.000333,0.219288,18,11841.52906,657.862726,657.862726,184.752548,3,6
0,0,10,10,18,19,37,51,41,92,0.000333,0.159757,18,8626.854773,479.26971,479.26971,155.769273,2,6
0,0,13,13,12,18,30,46,54,100,0.000333,0.163563,18,8832.403072,490.68906,490.68906,118.0782,1,6
0,0,13,13,13,19,32,47,56,103,0.000333,0.171667,12,6180,343.333333,515,128.816339,1,6
0,0,16,16,16,24,40,62,75,137,0.000333,0.243035,24,17498.49958,972.138865,729.104149,174.0391,3,6
0,0,19,19,17,26,43,64,74,138,0.000333,0.249608,16,11981.19258,665.62181,748.824536,191.698301,3,6
0,0,17,17,14,23,37,62,61,123,0.000333,0.213588,14,8970.678696,498.371039,640.762764,157.344894,2,6
0,0,12,12,13,15,28,40,42,82,0.000333,0.131401,12,4730.437243,262.802069,394.203104,106.709075,3,6
0,0,12,12,13,17,30,38,41,79,0.000333,0.129215,12,4651.732285,258.429571,387.644357,117.592585,2,6
0,0,7,7,12,13,25,30,26,56,0.000333,0.086685,12,3120.67136,173.370631,260.055947,91.125266,3,6
0,0,7,7,12,15,27,28,25,53,0.000333,0.084003,6,1512.054226,84.003013,252.009038,101.622909,2,6
0,0,16,16,16,20,36,61,48,109,0.000333,0.187841,16,9016.349203,500.908289,563.521825,150.438562,3,6
0,0,10,10,13,16,29,41,32,73,0.000333,0.118211,12,4255.591352,236.421742,354.632613,112.105716,2,6
0,0,11,11,13,18,31,38,31,69,0.000333,0.113947,6,2051.037273,113.946515,341.839545,123.164366,2,6
0,0,18,18,16,21,37,70,55,125,0.000333,0.217061,16,10418.90673,578.828152,651.181671,156.238666,4,6
0,0,10,10,13,16,29,41,32,73,0.000333,0.118211,12,4255.591352,236.421742,354.632613,112.105716,2,6
0,0,13,13,16,19,35,47,38,85,0.000333,0.14533,16,6975.824903,387.545828,435.989056,144.710623,3,6
0,0,17,17,17,21,38,64,49,113,0.000333,0.197672,16,9488.252944,527.125164,593.015809,161.725534,4,6
0,0,10,10,13,16,29,41,32,73,0.000333,0.118211,12,4255.591352,236.421742,354.632613,112.105716,2,6
0,0,12,12,14,19,33,41,32,73,0.000333,0.122747,7,2577.685395,143.204744,368.240771,134.013592,3,6
0,0,21,21,17,25,42,78,58,136,0.000333,0.244452,16,11733.68271,651.871262,733.355169,185.583273,4,6
0,0,10,10,13,16,29,41,32,73,0.000333,0.118211,12,4255.591352,236.421742,354.632613,112.105716,2,6
0,0,14,14,14,21,35,50,36,86,0.000333,0.147039,7,3087.828376,171.546021,441.118339,145.541635,3,6
0,0,14,14,14,22,36,50,36,86,0.000333,0.148205,7,3112.294851,172.905269,444.61355,151.410465,3,6
0,0,17,17,16,21,37,64,49,113,0.000333,0.196223,16,9418.691685,523.260649,588.66823,156.238666,4,6
0,0,10,10,13,16,29,41,32,73,0.000333,0.118211,12,4255.591352,236.421742,354.632613,112.105716,2,6
0,0,12,12,13,19,32,41,32,73,0.000333,0.121667,6,2190,121.666667,365,128.816339,3,6
0,0,17,17,17,21,38,73,52,125,0.000333,0.218664,16,10495.85503,583.103057,655.990939,161.725534,4,6
0,0,10,10,13,16,29,41,32,73,0.000333,0.118211,12,4255.591352,236.421742,354.632613,112.105716,2,6
0,0,19,19,19,23,42,78,55,133,0.000333,0.239059,18,12909.20791,717.178217,717.178217,184.752548,4,6
0,0,10,10,13,16,29,41,32,73,0.000333,0.118211,12,4255.591352,236.421742,354.632613,112.105716,2,6
0,0,11,11,11,24,35,42,34,76,0.000333,0.129942,5,1949.127546,108.284864,389.825509,148.092848,4,6
0,0,12,12,11,24,35,43,36,79,0.000333,0.135071,5,2026.066792,112.559266,405.213358,148.092848,4,6
0,0,6,6,13,11,24,31,22,53,0.000333,0.081001,12,2916.03615,162.002008,243.003013,86.159464,1,6
0,0,5,5,7,10,17,10,14,24,0.000333,0.0327,3,294.297325,16.349851,98.099108,52.870765,1,6
0,0,6,6,13,12,25,31,23,54,0.000333,0.083589,6,1504.609405,83.589411,250.768234,91.125266,1,6
0,0,13,13,13,23,36,47,36,83,0.000333,0.143035,6,2574.622651,143.034592,429.103775,152.147641,4,6
0,0,14,14,13,23,36,48,38,86,0.000333,0.148205,6,2667.681301,148.204517,444.61355,152.147641,4,6
0,0,11,11,11,24,35,42,34,76,0.000333,0.129942,5,1949.127546,108.284864,389.825509,148.092848,4,6
0,0,12,12,11,24,35,43,36,79,0.000333,0.135071,5,2026.066792,112.559266,405.213358,148.092848,4,6
0,0,11,11,12,17,29,40,42,82,0.000333,0.132785,12,4780.253299,265.569628,398.354442,112.506418,1,6
0,0,11,11,13,18,31,41,42,83,0.000333,0.137066,12,4934.379525,274.132196,411.198294,123.164366,1,6
0,0,18,18,15,22,37,69,76,145,0.000333,0.25179,21,15862.7855,881.265861,755.370738,156.710855,2,6
0,0,14,14,15,20,35,57,52,109,0.000333,0.186364,14,7827.285884,434.849216,559.091849,145.041921,2,6
0,0,7,7,13,15,28,31,26,57,0.000333,0.09134,6,1644.115383,91.339744,274.019231,106.709075,1,6
0,0,5,5,5,10,15,9,17,26,0.000333,0.03386,2,203.158311,11.286573,101.579155,44.828921,1,6
0,0,13,13,13,19,32,52,50,102,0.000333,0.17,12,6120,340,510,128.816339,2,6
0,0,11,11,12,16,28,51,38,89,0.000333,0.142618,12,5134.255057,285.236392,427.854588,107.01955,1,6
0,0,15,15,15,22,37,63,54,117,0.000333,0.203169,14,8533.084613,474.060256,609.506044,156.710855,2,6
0,0,14,14,15,21,36,54,50,104,0.000333,0.179224,14,7527.410802,418.189489,537.6722,150.842025,2,6
0,0,10,10,14,14,28,35,30,65,0.000333,0.104159,14,4374.692979,243.038499,312.47807,106.605938,4,6
0,0,10,10,13,16,29,33,29,62,0.000333,0.100398,6,1807.16893,100.398274,301.194822,112.105716,3,6
0,0,10,10,14,14,28,35,29,64,0.000333,0.102557,14,4307.39001,239.299445,307.670715,106.605938,4,6
0,0,10,10,13,16,29,33,28,61,0.000333,0.098779,6,1778.021044,98.778947,296.336841,112.105716,3,6
0,0,10,10,14,13,27,35,29,64,0.000333,0.101438,14,4260.379202,236.687733,304.3128,101.408685,4,6
0,0,10,10,13,15,28,33,28,61,0.000333,0.09775,6,1759.491901,97.74955,293.24865,106.709075,3,6
0,0,18,18,13,24,37,62,64,126,0.000333,0.218797,12,7876.693489,437.594083,656.391124,158.144816,2,6
0,0,10,10,11,17,28,37,33,70,0.000333,0.112172,5,1682.574223,93.476346,336.514845,107.540616,2,6
0,0,9,9,12,17,29,30,29,59,0.000333,0.09554,6,1719.725272,95.540293,286.620879,112.506418,2,6
0,0,13,13,10,18,28,59,58,117,0.000333,0.187487,15,8436.907888,468.717105,562.460526,108.277931,1,6
0,0,11,11,10,17,27,53,46,99,0.000333,0.156911,10,4707.338627,261.518813,470.733863,102.706149,1,6
0,0,10,10,13,17,30,37,31,68,0.000333,0.111223,6,2002.011363,111.222854,333.668561,117.592585,2,6
0,0,9,9,11,17,28,31,27,58,0.000333,0.092942,5,1394.132927,77.451829,278.826585,107.540616,2,6
0,0,10,10,13,17,30,37,31,68,0.000333,0.111223,6,2002.011363,111.222854,333.668561,117.592585,2,6
0,0,9,9,11,17,28,31,27,58,0.000333,0.092942,5,1394.132927,77.451829,278.826585,107.540616,2,6
0,0,20,20,16,25,41,89,66,155,0.000333,0.276807,16,13286.72897,738.15161,830.420561,180.096405,6,6
0,0,12,12,13,15,28,41,34,75,0.000333,0.120184,12,4326.61943,240.367746,360.551619,106.709075,5,6
0,0,12,12,13,17,30,39,33,72,0.000333,0.117765,6,2119.776737,117.765374,353.296123,117.592585,4,6
0,0,12,12,13,15,28,41,34,75,0.000333,0.120184,12,4326.61943,240.367746,360.551619,106.709075,5,6
0,0,12,12,13,17,30,39,33,72,0.000333,0.117765,6,2119.776737,117.765374,353.296123,117.592585,4,6
0,0,9,9,10,15,25,32,28,60,0.000333,0.092877,5,1393.156857,77.397603,278.631371,91.82264,1,6
0,0,5,5,9,12,21,21,19,40,0.000333,0.058564,4,702.770788,39.042822,175.692697,71.548875,1,6
0,0,10,10,12,17,29,34,28,62,0.000333,0.100398,6,1807.16893,100.398274,301.194822,112.506418,2,6
0,0,12,12,13,17,30,40,32,72,0.000333,0.117765,6,2119.776737,117.765374,353.296123,117.592585,2,6
0,0,5,5,9,12,21,21,19,40,0.000333,0.058564,4,702.770788,39.042822,175.692697,71.548875,1,6
0,0,13,13,14,20,34,42,32,74,0.000333,0.125491,7,2635.305752,146.405875,376.47225,139.741531,3,6
0,0,13,13,16,20,36,54,41,95,0.000333,0.163714,16,7858.286002,436.571445,491.142875,150.438562,3,6
0,0,14,14,15,24,39,65,51,116,0.000333,0.204369,14,8583.493203,476.860734,613.106657,168.642459,2,6
0,0,16,16,15,21,36,57,64,121,0.000333,0.20852,21,13136.77943,729.821079,625.560925,150.842025,2,6
0,0,8,8,16,16,32,38,32,70,0.000333,0.116667,16,5600,311.111111,350,128,2,6
2,0,10,12,15,16,31,44,34,78,0.000333,0.128809,14,5409.982371,300.554576,386.427312,122.603359,2,6
0,0,12,12,13,17,30,58,40,98,0.000333,0.160292,12,5770.50334,320.583519,480.875278,117.592585,2,6
0,0,11,11,12,16,28,55,39,94,0.000333,0.15063,12,5422.696352,301.260908,451.891363,107.01955,1,6
0,0,50,50,27,56,83,187,148,335,0.000333,0.711879,26,55526.59345,3084.810747,2135.63821,453.593838,14,6
0,0,50,50,26,58,84,185,147,332,0.000333,0.707416,26,55178.48399,3065.471333,2122.249384,461.97433,13,6
0,0,14,14,14,18,32,62,45,107,0.000333,0.178333,14,7490,416.111111,535,128.361619,2,6
0,0,9,9,13,15,28,34,27,61,0.000333,0.09775,6,1759.491901,97.74955,293.24865,106.709075,2,6
0,0,17,17,16,20,36,70,49,119,0.000333,0.205074,16,9843.537203,546.863178,615.221075,150.438562,3,6
0,0,9,9,13,15,28,34,27,61,0.000333,0.09775,6,1759.491901,97.74955,293.24865,106.709075,2,6
0,0,10,10,11,16,27,41,32,73,0.000333,0.115702,10,3471.067877,192.837104,347.106788,102.053748,2,6
0,0,12,12,14,19,33,50,38,88,0.000333,0.147969,14,6214.693555,345.260753,443.906683,134.013592,2,6
0,0,8,8,13,12,25,35,28,63,0.000333,0.097521,12,3510.755279,195.04196,292.56294,91.125266,2,6
0,0,12,12,11,20,31,51,45,96,0.000333,0.158534,10,4756.028458,264.223803,475.602846,124.49231,1,6
0,0,16,16,18,25,43,78,59,137,0.000333,0.247799,18,13381.16889,743.398271,743.398271,191.155055,3,6
0,0,13,13,18,22,40,63,50,113,0.000333,0.200459,18,10824.80175,601.377875,601.377875,173.166146,3,6
0,0,12,12,12,17,29,53,48,101,0.000333,0.163552,12,5887.872966,327.104054,490.656081,112.506418,2,6
0,0,9,9,11,15,26,43,31,74,0.000333,0.115944,10,3478.325391,193.2403,347.832539,96.657107,2,6
0,0,9,9,11,16,27,43,31,74,0.000333,0.117287,5,1759.308376,97.739354,351.861675,102.053748,2,6
0,0,12,12,15,18,33,42,34,76,0.000333,0.127791,7,2683.617671,149.089871,383.373953,133.662009,2,6
0,0,11,11,13,18,31,36,30,66,0.000333,0.108992,6,1961.861739,108.992319,326.976956,123.164366,2,6
0,0,10,10,13,17,30,37,31,68,0.000333,0.111223,6,2002.011363,111.222854,333.668561,117.592585,2,6
0,0,9,9,11,17,28,31,27,58,0.000333,0.092942,5,1394.132927,77.451829,278.826585,107.540616,2,6
0,0,10,10,13,17,30,37,31,68,0.000333,0.111223,6,2002.011363,111.222854,333.668561,117.592585,2,6
0,0,9,9,11,17,28,31,27,58,0.000333,0.092942,5,1394.132927,77.451829,278.826585,107.540616,2,6
0,0,17,17,18,25,43,88,70,158,0.000333,0.285783,18,15432.29696,857.349831,857.349831,191.155055,2,6
0,0,10,10,18,20,38,54,43,97,0.000333,0.169683,18,9162.881438,509.048969,509.048969,161.497212,2,6
0,0,12,12,14,22,36,47,40,87,0.000333,0.149928,7,3148.484326,174.915796,449.783475,151.410465,3,6
0,0,10,10,14,20,34,39,32,71,0.000333,0.120403,7,2528.469032,140.470502,361.209862,139.741531,3,6
0,0,14,14,15,22,37,51,42,93,0.000333,0.161493,7,3391.354141,188.408563,484.479163,156.710855,3,6
0,0,12,12,15,20,35,43,34,77,0.000333,0.131652,7,2764.683546,153.59353,394.954792,145.041921,3,6
0,0,12,12,14,21,35,47,39,86,0.000333,0.147039,7,3087.828376,171.546021,441.118339,145.541635,3,6
0,0,10,10,14,19,33,39,31,70,0.000333,0.117703,7,2471.753118,137.319618,353.107588,134.013592,3,6
0,0,14,14,13,22,35,44,44,88,0.000333,0.150459,12,5416.522866,300.917937,451.376905,146.213212,3,6
0,0,10,10,12,19,31,30,29,59,0.000333,0.097433,6,1753.785494,97.432527,292.297582,123.730173,3,6
0,0,14,14,13,21,34,44,43,87,0.000333,0.147536,12,5311.311206,295.072845,442.609267,140.344382,3,6
0,0,10,10,12,18,30,30,28,58,0.000333,0.094867,6,1707.597927,94.866552,284.599655,118.0782,3,6
0,0,16,16,13,18,31,63,49,112,0.000333,0.184957,12,6658.439841,369.913325,554.869987,123.164366,3,6
0,0,10,10,13,15,28,41,32,73,0.000333,0.116979,12,4211.242912,233.95794,350.936909,106.709075,2,6
0,0,13,13,13,18,31,49,39,88,0.000333,0.145323,12,5231.631304,290.646184,435.969275,123.164366,3,6
0,0,11,11,13,17,30,44,35,79,0.000333,0.129215,12,4651.732285,258.429571,387.644357,117.592585,2,6
0,0,20,20,17,23,40,82,75,157,0.000333,0.278514,24,20053.02506,1114.056948,835.542711,173.528793,3,6
0,0,10,10,13,16,29,44,34,78,0.000333,0.126308,12,4547.070211,252.615012,378.922518,112.105716,2,6
0,0,18,18,17,22,39,76,57,133,0.000333,0.234319,16,11247.33592,624.851996,702.958495,167.594364,3,6
0,0,10,10,13,16,29,41,32,73,0.000333,0.118211,12,4255.591352,236.421742,354.632613,112.105716,2,6
0,0,11,11,14,18,32,42,34,76,0.000333,0.126667,7,2660,147.777778,380,128.361619,2,6
0,0,10,10,14,14,28,39,28,67,0.000333,0.107364,14,4509.298917,250.516606,322.09278,106.605938,2,6
0,0,17,17,15,24,39,65,54,119,0.000333,0.209654,14,8805.480097,489.193339,628.962864,168.642459,2,6
0,0,10,10,13,17,30,38,31,69,0.000333,0.112858,6,2031.452707,112.858484,338.575451,117.592585,2,6
0,0,17,17,16,21,37,68,50,118,0.000333,0.204905,16,9835.447954,546.413775,614.715497,156.238666,2,6
0,0,10,10,13,17,30,38,31,69,0.000333,0.112858,6,2031.452707,112.858484,338.575451,117.592585,2,6
0,0,12,12,12,18,30,47,45,92,0.000333,0.150478,12,5417.207218,300.955957,451.433935,118.0782,1,6
0,0,12,12,13,20,33,52,46,98,0.000333,0.164784,12,5932.207484,329.567082,494.350624,134.544278,1,6
0,0,16,16,12,20,32,59,69,128,0.000333,0.213333,18,11520,640,640,129.458112,1,6
0,0,16,16,13,22,35,64,74,138,0.000333,0.235947,18,12741.13901,707.841056,707.841056,146.213212,1,6
0,0,14,14,12,19,31,53,57,110,0.000333,0.181654,18,9809.308695,544.961594,544.961594,123.730173,1,6
0,0,14,14,13,21,34,58,60,118,0.000333,0.200107,12,7203.847383,400.213744,600.320615,140.344382,1,6
0,0,8,8,11,14,25,24,21,45,0.000333,0.069658,5,1044.867643,58.048202,208.973529,91.356717,2,6
0,0,8,8,11,14,25,24,21,45,0.000333,0.069658,5,1044.867643,58.048202,208.973529,91.356717,2,6
0,0,8,8,11,14,25,24,21,45,0.000333,0.069658,5,1044.867643,58.048202,208.973529,91.356717,2,6
0,0,13,13,14,15,29,42,46,88,0.000333,0.142501,21,8977.548879,498.752715,427.502328,111.906328,4,6
0,0,13,13,13,17,30,40,45,85,0.000333,0.139029,12,5005.028408,278.057134,417.085701,117.592585,3,6
0,0,12,12,14,15,29,40,34,74,0.000333,0.11983,14,5032.868311,279.603795,359.490594,111.906328,5,6
0,0,12,12,13,17,30,38,33,71,0.000333,0.11613,6,2090.335394,116.129744,348.389232,117.592585,4,6
0,0,16,16,15,14,29,48,38,86,0.000333,0.139262,14,5849.009118,324.944951,417.786366,111.906328,5,6
0,0,16,16,14,16,30,46,37,83,0.000333,0.135757,14,5701.806872,316.767048,407.271919,117.302969,4,6
0,0,12,12,15,13,28,40,32,72,0.000333,0.115377,14,4845.813761,269.211876,346.129554,106.709075,5,6
0,0,12,12,14,15,29,38,31,69,0.000333,0.111734,14,4692.809641,260.711647,335.200689,111.906328,4,6
0,0,13,13,16,21,37,54,42,96,0.000333,0.166703,16,8001.72037,444.540021,500.107523,156.238666,3,6
0,0,8,8,16,18,34,40,32,72,0.000333,0.122099,8,2930.378597,162.798811,366.297325,139.05865,2,6
0,0,15,15,17,24,41,62,49,111,0.000333,0.198229,16,9515.01236,528.611798,594.688273,179.525968,4,6
0,0,17,17,18,25,43,66,52,118,0.000333,0.213433,18,11525.38634,640.299241,640.299241,191.155055,4,6
0,0,9,9,14,20,34,35,32,67,0.000333,0.11362,7,2386.020073,132.556671,340.86001,139.741531,2,6
0,0,35,35,25,56,81,201,130,331,0.000333,0.699497,24,50363.76842,2797.987135,2098.490351,441.30828,20,6
0,0,36,36,25,59,84,209,134,343,0.000333,0.730855,24,52621.55702,2923.419835,2192.564876,463.172345,20,6
0,0,3,3,10,15,25,16,16,32,0.000333,0.049534,5,743.01699,41.278722,148.603398,91.82264,1,6
0,0,24,24,20,36,56,129,78,207,0.000333,0.400707,20,24042.44938,1335.691632,1202.122469,272.555862,9,6
0,0,21,21,19,34,53,123,72,195,0.000333,0.372315,18,20105.0008,1116.944489,1116.944489,253.684359,9,6
0,0,23,23,20,33,53,109,72,181,0.000333,0.345585,20,20735.07205,1151.948447,1036.753602,252.903568,8,6
0,0,23,23,20,35,55,115,74,189,0.000333,0.364226,20,21853.53972,1214.08554,1092.676986,265.963467,8,6
0,0,20,20,19,27,46,95,62,157,0.000333,0.289066,18,15609.58609,867.199227,867.199227,209.092585,5,6
0,0,23,23,20,32,52,109,73,182,0.000333,0.345827,20,20749.60057,1152.755587,1037.480029,246.438562,8,6
0,0,44,44,25,50,75,206,134,340,0.000333,0.705933,24,50827.16051,2823.73114,2117.798355,398.289214,26,6
0,0,29,29,20,42,62,137,95,232,0.000333,0.460458,20,27627.47088,1534.859493,1381.373544,312.915894,12,6
0,0,33,33,20,42,62,151,107,258,0.000333,0.512061,20,30723.65296,1706.869609,1536.182648,312.915894,13,6
0,0,29,29,18,26,44,128,91,219,0.000333,0.398539,27,32281.61916,1793.423287,1195.615524,197.270083,9,6
0,0,44,44,25,52,77,212,136,348,0.000333,0.726947,24,52340.20119,2907.788955,2180.841716,412.51927,26,6
0,0,29,29,20,44,64,143,97,240,0.000333,0.48,20,28800,1600,1440,326.653553,12,6
0,0,33,33,20,44,64,157,109,266,0.000333,0.532,20,31920,1773.333333,1596,326.653553,13,6
0,0,29,29,18,28,46,134,93,227,0.000333,0.41795,27,33853.91123,1880.772846,1253.848564,209.664588,9,6
0,0,41,41,24,44,68,192,124,316,0.000333,0.641213,24,46167.31819,2564.85101,1923.638258,350.254091,23,6
0,0,44,44,25,49,74,206,135,341,0.000333,0.705808,24,50818.16634,2823.231464,2117.423598,391.217187,26,6
0,0,29,29,20,41,61,137,96,233,0.000333,0.460621,20,27637.23599,1535.402,1381.8618,306.098194,12,6
0,0,33,33,20,41,61,151,108,259,0.000333,0.51202,20,30721.21941,1706.734412,1536.06097,306.098194,13,6
0,0,29,29,18,25,43,128,92,220,0.000333,0.397926,27,32232.01264,1790.667369,1193.778246,191.155055,9,6
0,0,3,3,10,14,24,18,17,35,0.000333,0.053491,5,802.368438,44.576024,160.473688,86.52225,1,6
0,0,3,3,10,13,23,15,15,30,0.000333,0.045236,5,678.534293,37.69635,135.706859,81.324997,1,6
0,0,3,3,10,13,23,15,15,30,0.000333,0.045236,5,678.534293,37.69635,135.706859,81.324997,1,6
0,0,3,3,10,13,23,15,15,30,0.000333,0.045236,5,678.534293,37.69635,135.706859,81.324997,1,6
0,0,40,40,30,49,79,184,123,307,0.000333,0.645087,30,58057.82069,3225.434483,1935.26069,422.3275,15,6
0,0,43,43,31,54,85,202,135,337,0.000333,0.719988,30,64798.94236,3599.941242,2159.964745,464.344011,18,6
0,0,24,24,20,26,46,112,81,193,0.000333,0.355349,30,31981.42373,1776.745763,1066.047458,208.649995,5,6
0,0,29,29,22,32,54,129,92,221,0.000333,0.423943,22,27980.26304,1554.459058,1271.830138,258.107496,6,6
0,0,34,34,25,43,68,158,105,263,0.000333,0.533668,24,38424.06545,2134.670303,1601.002727,349.425789,13,6
0,0,22,22,19,24,43,99,74,173,0.000333,0.312915,27,25346.08267,1408.115704,938.743803,190.749723,5,6
0,0,27,27,21,30,51,116,85,201,0.000333,0.380052,20,22803.14988,1266.84166,1140.157494,239.445384,6,6
0,0,33,33,23,44,67,169,107,276,0.000333,0.55808,22,36833.29356,2046.294087,1674.240617,344.256916,12,6
0,0,21,21,17,25,42,110,76,186,0.000333,0.334324,24,24071.30498,1337.294721,1002.971041,185.583273,4,6
0,0,26,26,18,31,49,127,87,214,0.000333,0.400516,18,21627.86232,1201.547907,1201.547907,228.638736,5,6
0,0,43,43,31,57,88,222,141,363,0.000333,0.781591,30,70343.21033,3907.956129,2344.773678,486.054816,18,6
0,0,24,24,21,29,50,132,87,219,0.000333,0.412002,30,37080.13517,2060.007509,1236.004506,233.120115,5,6
0,0,29,29,22,35,57,149,98,247,0.000333,0.480241,22,31695.92434,1760.884685,1440.723833,277.632401,6,6
0,0,38,38,29,54,83,194,125,319,0.000333,0.677879,28,56941.8522,3163.436233,2033.637579,451.645374,17,6
0,0,19,19,18,24,42,104,71,175,0.000333,0.314552,18,16985.79988,943.655549,943.655549,185.09775,4,6
0,0,24,24,20,31,51,121,82,203,0.000333,0.383834,20,23030.04689,1279.447049,1151.502344,240.018648,5,6
0,0,34,34,24,36,60,182,112,294,0.000333,0.578875,36,62518.53006,3473.25167,1736.625835,296.1564,25,6
0,0,31,31,23,30,53,168,102,270,0.000333,0.515513,33,51035.77125,2835.320625,1546.538523,251.248643,22,6
0,0,34,34,24,35,59,182,113,295,0.000333,0.57846,36,62473.66918,3470.759399,1735.3797,289.564006,25,6
0,0,22,22,18,45,63,124,79,203,0.000333,0.404463,9,10920.49042,606.693912,1213.387824,322.192039,10,6
0,0,22,22,18,47,65,130,81,211,0.000333,0.423573,9,11436.47648,635.359804,1270.719609,336.124326,10,6
0,0,19,19,17,39,56,110,69,179,0.000333,0.346506,8,8316.132248,462.007347,1039.516531,275.617555,7,6
0,0,22,22,18,44,62,124,80,204,0.000333,0.404885,9,10931.90443,607.328024,1214.656047,315.273641,10,6
0,0,55,55,24,63,87,301,198,499,0.000333,1.071676,36,115741.037,6430.057609,3215.028804,486.607735,27,6
0,0,52,52,24,62,86,295,192,487,0.000333,1.043197,36,112665.2737,6259.181871,3129.590936,479.199271,27,6
0,0,53,53,26,71,97,285,197,482,0.000333,1.060386,26,82710.10774,4595.005985,3181.15799,558.843478,31,6
0,0,36,36,19,46,65,200,141,341,0.000333,0.684542,27,55447.94046,3080.441136,2053.627424,334.794473,21,6
0,0,47,47,25,69,94,251,174,425,0.000333,0.928567,24,66856.80629,3714.267016,2785.700262,537.584592,24,6
0,0,44,44,25,71,96,242,169,411,0.000333,0.90214,24,64954.07011,3608.55945,2706.419588,552.72845,24,6
0,0,33,33,18,46,64,185,135,320,0.000333,0.64,18,34560,1920,1920,329.1425,20,6
0,0,44,44,24,69,93,236,168,404,0.000333,0.880607,24,63403.68383,3522.42688,2641.82016,531.527288,23,6
0,0,42,42,25,66,91,223,151,374,0.000333,0.811305,24,58413.96469,3245.220261,2433.915195,515.026417,24,6
0,0,31,31,18,41,59,166,117,283,0.000333,0.554929,18,29966.18369,1664.787983,1664.787983,294.718282,20,6
0,0,42,42,24,64,88,217,150,367,0.000333,0.790204,24,56894.6737,3160.815205,2370.611404,494.0391,23,6
0,0,3,3,12,17,29,21,19,40,0.000333,0.064773,6,1165.915439,64.77308,194.31924,112.506418,1,6
0,0,39,39,22,63,85,179,135,314,0.000333,0.67085,22,44276.07259,2459.78181,2012.548754,474.676131,20,6
0,0,41,41,22,64,86,186,141,327,0.000333,0.700463,22,46230.54865,2568.363814,2101.388575,482.107496,20,6
0,0,39,39,20,64,84,175,134,309,0.000333,0.658409,20,39504.52167,2194.695648,1975.226084,470.438562,20,6
0,0,45,45,20,56,76,233,155,388,0.000333,0.808065,20,48483.9175,2693.550972,2424.195875,411.650438,23,6
0,0,42,42,20,54,74,227,149,376,0.000333,0.778251,20,46695.08931,2594.171628,2334.754465,397.202487,23,6
0,0,33,33,19,50,69,174,115,289,0.000333,0.588455,18,31776.54422,1765.363568,1765.363568,362.903432,15,6
0,0,33,33,19,50,69,175,116,291,0.000333,0.592527,18,31996.45111,1777.580617,1777.580617,362.903432,15,6
0,0,33,33,19,50,69,174,115,289,0.000333,0.588455,18,31776.54422,1765.363568,1765.363568,362.903432,15,6
0,0,33,33,19,50,69,175,116,291,0.000333,0.592527,18,31996.45111,1777.580617,1777.580617,362.903432,15,6
0,0,33,33,19,50,69,174,115,289,0.000333,0.588455,18,31776.54422,1765.363568,1765.363568,362.903432,15,6
0,0,33,33,19,50,69,175,116,291,0.000333,0.592527,18,31996.45111,1777.580617,1777.580617,362.903432,15,6
0,0,45,45,19,54,73,228,157,385,0.000333,0.794361,18,42895.48419,2383.082455,2383.082455,391.474548,23,6
0,0,44,44,19,54,73,222,154,376,0.000333,0.775791,18,41892.73261,2327.374034,2327.374034,391.474548,22,6
0,0,43,43,19,54,73,216,151,367,0.000333,0.757222,18,40889.98104,2271.665613,2271.665613,391.474548,21,6
0,0,45,45,20,56,76,231,158,389,0.000333,0.810148,20,48608.87606,2700.493114,2430.443803,411.650438,22,6
0,0,33,33,21,50,71,186,111,297,0.000333,0.608825,20,36529.49789,2029.416549,1826.474894,374.431475,16,6
0,0,35,35,21,51,72,193,117,310,0.000333,0.637559,20,38253.53501,2125.196389,1912.67675,381.532358,16,6
0,0,29,29,19,46,65,149,92,241,0.000333,0.483797,18,26125.03157,1451.390643,1451.390643,334.794473,16,6
0,0,30,30,20,42,62,159,100,259,0.000333,0.514046,20,30842.73689,1713.485383,1542.136844,312.915894,12,6
0,0,33,33,21,47,68,177,112,289,0.000333,0.586426,20,35185.53522,1954.751957,1759.276761,353.304342,15,6
0,0,22,22,18,34,52,106,71,177,0.000333,0.336326,18,18161.60094,1008.97783,1008.97783,248.032387,13,6
0,0,44,44,28,50,78,256,171,427,0.000333,0.894622,42,112722.4034,6262.355744,2683.866747,416.798747,12,6
0,0,31,31,25,45,70,192,116,308,0.000333,0.629273,24,45307.66006,2517.092226,1887.819169,363.229794,14,6
0,0,67,67,29,74,103,348,226,574,0.000333,1.27935,42,161198.1547,8955.453039,3838.051303,600.380998,25,6
0,0,72,72,29,78,107,365,238,603,0.000333,1.355035,42,170734.3929,9485.24405,4065.104593,631.142822,25,6
0,0,24,24,19,32,51,111,79,190,0.000333,0.359254,18,19399.69467,1077.760815,1077.760815,240.710623,5,6
0,0,24,24,20,30,50,108,77,185,0.000333,0.348038,20,20882.2679,1160.125995,1044.113395,233.64528,5,6
0,0,29,29,23,40,63,144,98,242,0.000333,0.482167,22,31823.03831,1767.946573,1446.501741,316.919049,8,6
0,0,17,17,13,26,39,81,57,138,0.000333,0.243129,12,8752.626074,486.257004,729.385506,170.317149,2,6
0,0,28,28,21,40,61,143,96,239,0.000333,0.472482,20,28348.92447,1574.940249,1417.446224,305.11579,7,6
0,0,18,18,19,30,49,100,65,165,0.000333,0.308809,18,16675.68824,926.427124,926.427124,227.917341,6,6
0,0,34,34,19,42,61,176,114,290,0.000333,0.573305,18,30958.4489,1719.913828,1719.913828,307.187955,10,6
0,0,36,36,19,43,62,183,120,303,0.000333,0.601374,18,32474.18668,1804.121482,1804.121482,314.040007,10,6
0,0,33,33,17,42,59,171,111,282,0.000333,0.552968,16,26542.48544,1474.582524,1658.90534,295.9642,10,6
0,0,27,27,19,40,59,120,85,205,0.000333,0.401981,18,21706.95285,1205.941825,1205.941825,293.587747,9,6
0,0,30,30,20,45,65,134,96,230,0.000333,0.461715,20,27702.89194,1539.049552,1385.144597,333.571951,12,6
0,0,21,21,14,25,39,84,68,152,0.000333,0.267794,14,11247.33592,624.851996,803.381137,169.399374,8,6
0,0,20,20,14,21,35,82,67,149,0.000333,0.254754,21,16049.52656,891.640364,764.26317,145.541635,8,6
0,0,31,31,20,48,68,144,101,245,0.000333,0.497143,20,29828.56792,1657.142662,1491.428396,354.516762,12,6
0,0,22,22,15,28,43,94,73,167,0.000333,0.302062,14,12686.607,704.8115,906.186214,193.209297,8,6
0,0,21,21,15,24,39,92,72,164,0.000333,0.288935,21,18202.92524,1011.273625,866.805964,168.642459,8,6
0,0,29,29,20,48,68,130,96,226,0.000333,0.458589,20,27515.33204,1528.629558,1375.766602,354.516762,11,6
0,0,21,21,14,28,42,83,69,152,0.000333,0.273211,14,11474.85148,637.491749,819.632248,187.908907,7,6
0,0,20,20,14,24,38,81,68,149,0.000333,0.260647,14,10947.17679,608.176489,781.9412,163.342069,7,6
0,0,25,25,22,40,62,134,85,219,0.000333,0.434656,22,28687.31782,1593.739879,1303.968992,310.984619,10,6
0,0,25,25,23,38,61,131,83,214,0.000333,0.423059,22,27921.91139,1551.217299,1269.17779,303.463171,10,6
0,0,30,30,24,48,72,163,103,266,0.000333,0.547067,24,39388.80121,2188.266734,1641.20005,378.1173,13,6
0,0,18,18,17,34,51,104,63,167,0.000333,0.315765,8,7578.360257,421.020014,947.295032,242.460605,7,6
0,0,29,29,22,48,70,162,101,263,0.000333,0.537334,22,35464.03154,1970.223974,1612.001433,366.185696,12,6
0,0,23,23,19,43,62,127,83,210,0.000333,0.416794,9,11253.43103,625.190613,1250.381225,314.040007,11,6
0,0,40,40,26,42,68,192,124,316,0.000333,0.641213,26,50014.5947,2778.588595,1923.638258,348.688764,16,6
0,0,37,37,25,41,66,186,118,304,0.000333,0.612499,24,44099.8995,2449.994416,1837.495812,335.756037,16,6
0,0,48,48,19,63,82,241,166,407,0.000333,0.862508,18,46575.42599,2587.523666,2587.523666,457.279258,19,6
0,0,47,47,20,67,87,228,165,393,0.000333,0.844026,20,50641.53588,2813.41866,2532.076794,492.866538,23,6
0,0,44,44,19,65,84,206,153,359,0.000333,0.764947,18,41307.15519,2294.841955,2294.841955,472.164531,17,6
0,0,32,32,14,43,57,157,119,276,0.000333,0.536626,14,22538.28702,1252.127056,1609.877644,286.632353,14,6
0,0,39,39,20,72,92,199,144,343,0.000333,0.745861,20,44751.63502,2486.201945,2237.581751,530.673162,18,6
0,0,42,42,19,70,89,205,154,359,0.000333,0.774929,18,41846.18943,2324.788302,2324.788302,509.760434,18,6
0,0,30,30,15,48,63,156,120,276,0.000333,0.54991,14,23096.20962,1283.122757,1649.729259,326.681559,15,6
0,0,37,37,21,68,89,180,126,306,0.000333,0.660525,10,19815.7443,1100.874683,1981.57443,506.186139,18,6
0,0,40,40,20,66,86,186,136,322,0.000333,0.689752,20,41385.14502,2299.174723,2069.257251,485.368574,18,6
0,0,28,28,16,44,60,137,102,239,0.000333,0.470582,16,22587.94964,1254.886091,1411.746852,304.214991,15,6
0,0,56,56,27,73,100,293,197,490,0.000333,1.085163,26,84642.72786,4702.37377,3255.489533,580.239155,31,6
0,0,40,40,19,56,75,197,141,338,0.000333,0.70178,18,37896.13291,2105.340717,2105.340717,405.922498,19,6
0,0,32,32,16,43,59,165,119,284,0.000333,0.55689,16,26730.73002,1485.040556,1670.670626,297.329384,18,6
0,0,48,48,26,77,103,263,176,439,0.000333,0.978458,26,76319.71702,4239.984279,2935.373731,604.753996,28,6
0,0,38,38,19,61,80,203,144,347,0.000333,0.731236,18,39486.76288,2193.709049,2193.709049,442.4856,22,6
0,0,30,30,18,50,68,171,122,293,0.000333,0.594542,18,32105.27903,1783.626612,1783.626612,357.25146,21,6
0,0,46,46,26,73,99,244,158,402,0.000333,0.888334,26,69290.03539,3849.446411,2665.001361,574.068625,28,6
0,0,36,36,19,57,76,184,126,310,0.000333,0.645619,18,34863.43553,1936.857529,1936.857529,413.185354,22,6
0,0,28,28,18,46,64,152,104,256,0.000333,0.512,18,27648,1536,1536,329.1425,21,6
0,0,33,33,24,56,80,203,127,330,0.000333,0.695412,24,50069.67051,2781.648362,2086.236271,435.250976,20,6
0,0,34,34,24,59,83,211,131,342,0.000333,0.726754,24,52326.32365,2907.017981,2180.263486,457.11504,20,6
0,0,15,15,21,32,53,110,69,179,0.000333,0.341766,20,20505.95523,1139.219735,1025.297761,252.238666,12,6
0,0,3,3,10,15,25,19,18,37,0.000333,0.057274,5,859.113395,47.728522,171.822679,91.82264,1,6
0,0,24,24,21,37,58,121,78,199,0.000333,0.388579,20,23314.76436,1295.264687,1165.738218,284.98844,6,6
0,0,27,27,22,42,64,135,89,224,0.000333,0.448,22,29568,1642.666667,1344,324.584827,9,6
0,0,28,28,22,45,67,145,94,239,0.000333,0.483265,22,31895.49696,1771.972054,1449.795317,345.240885,9,6
0,0,20,20,19,36,55,100,69,169,0.000333,0.325683,9,8793.448124,488.524896,977.049792,266.827923,9,6
0,0,16,16,22,31,53,107,58,165,0.000333,0.315036,11,10396.17563,577.565313,945.106875,251.687581,8,6
0,0,9,9,21,19,40,73,34,107,0.000333,0.189815,10,5694.463062,316.359059,569.446306,172.949289,5,6
0,0,30,30,22,51,73,162,101,263,0.000333,0.542641,11,17907.16245,994.842358,1627.923859,387.401188,14,6
0,0,21,21,18,40,58,105,70,175,0.000333,0.341716,9,9226.320067,512.573337,1025.146674,287.935774,11,6
0,0,44,44,25,48,73,230,143,373,0.000333,0.769602,24,55411.30945,3078.406081,2308.80456,384.174605,24,6
0,0,46,46,25,49,74,237,149,386,0.000333,0.79895,36,86286.56397,4793.697998,2396.848999,391.217187,24,6
0,0,42,42,23,48,71,216,136,352,0.000333,0.72157,22,47623.64169,2645.757872,2164.710986,372.120125,23,6
0,0,31,31,24,42,66,148,98,246,0.000333,0.49564,24,35686.10288,1982.561271,1486.920953,336.516432,13,6
0,0,35,35,24,42,66,162,110,272,0.000333,0.548025,24,39457.80481,2192.100267,1644.0752,336.516432,14,6
0,0,26,26,18,26,44,110,81,191,0.000333,0.347584,27,28154.28886,1564.127159,1042.751439,197.270083,7,6
0,0,19,19,16,14,30,75,58,133,0.000333,0.217539,32,20883.72638,1160.207021,652.616449,117.302969,6,6
0,0,31,31,23,44,67,151,100,251,0.000333,0.507529,22,33496.94451,1860.941362,1522.588387,344.256916,13,6
0,0,35,35,23,44,67,165,112,277,0.000333,0.560102,22,36966.74753,2053.708196,1680.306706,344.256916,14,6
0,0,26,26,18,28,46,113,83,196,0.000333,0.360873,18,19487.12658,1082.618143,1082.618143,209.664588,7,6
0,0,19,19,16,16,32,78,60,138,0.000333,0.23,24,16560,920,690,128,6,6
0,0,35,35,25,50,75,174,114,288,0.000333,0.597967,24,43053.59479,2391.866377,1793.899783,398.289214,16,6
0,0,36,36,24,45,69,170,114,284,0.000333,0.578274,24,41635.7027,2313.094594,1734.820946,357.172489,14,6
0,0,27,27,19,29,48,118,85,203,0.000333,0.377916,18,20407.45298,1133.747388,1133.747388,221.592072,7,6
0,0,20,20,17,17,34,83,62,145,0.000333,0.245894,24,17704.37069,983.576149,737.682112,138.973737,6,6
0,0,20,20,22,31,53,100,70,170,0.000333,0.324582,22,21422.4225,1190.134583,973.746477,251.687581,9,6
0,0,12,12,17,22,39,54,39,93,0.000333,0.163847,8,3932.339251,218.463292,491.542406,167.594364,5,6
0,0,13,13,19,23,42,65,45,110,0.000333,0.197718,9,5338.394249,296.577458,593.154917,184.752548,5,6
0,0,17,17,21,27,48,88,62,150,0.000333,0.279248,20,16754.8875,930.827083,837.744375,220.620628,7,6
0,0,3,3,10,14,24,16,16,32,0.000333,0.048906,5,733.594,40.755222,146.7188,86.52225,1,6
0,0,36,36,21,60,81,219,110,329,0.000333,0.69527,10,20858.10651,1158.783695,2085.810651,446.652102,13,6
0,0,37,37,21,58,79,211,109,320,0.000333,0.672403,10,20172.09839,1120.672133,2017.209839,432.001564,13,6
0,0,37,37,21,60,81,217,111,328,0.000333,0.693157,10,20794.70801,1155.261556,2079.470801,446.652102,13,6
0,0,34,34,20,52,72,197,99,296,0.000333,0.608766,10,18262.978,1014.609889,1826.2978,382.861427,10,6
0,0,37,37,21,57,78,211,110,321,0.000333,0.672538,10,20176.14112,1120.896729,2017.614112,424.713397,13,6
0,0,14,14,17,32,49,84,56,140,0.000333,0.26202,8,6288.475025,349.359724,786.059378,229.486868,6,6
0,0,21,21,23,34,57,117,76,193,0.000333,0.375249,22,24766.451,1375.913944,1125.747773,277.015662,11,6
0,0,22,22,23,37,60,125,80,205,0.000333,0.403638,22,26640.07659,1480.004255,1210.912572,296.7917,11,6
0,0,18,18,21,27,48,99,65,164,0.000333,0.305311,20,18318.677,1017.704278,915.93385,220.620628,8,6
0,0,21,21,23,33,56,117,77,194,0.000333,0.375542,22,24785.79081,1376.988378,1126.626855,270.506931,11,6
0,0,24,24,20,42,62,137,93,230,0.000333,0.456488,20,27389.30303,1521.627946,1369.465151,312.915894,6,6
0,0,27,27,21,47,68,151,104,255,0.000333,0.517434,20,31046.06049,1724.781138,1552.303025,353.304342,9,6
0,0,28,28,21,50,71,161,109,270,0.000333,0.553477,20,33208.63445,1844.924136,1660.431722,374.431475,9,6
0,0,16,16,17,27,44,79,56,135,0.000333,0.245674,16,11792.3723,655.131794,737.023269,197.868831,6,6
0,0,14,14,15,31,46,76,57,133,0.000333,0.244878,7,5142.436181,285.690899,734.63374,212.183445,5,6
0,0,13,13,15,29,44,71,54,125,0.000333,0.227476,7,4777.002666,265.389037,682.428952,199.484808,5,6
0,0,14,14,16,29,45,82,61,143,0.000333,0.261778,16,12565.35988,698.075549,785.334993,204.881449,6,6
0,0,13,13,15,31,46,73,56,129,0.000333,0.237513,7,4987.776446,277.098691,712.539492,212.183445,4,6
0,0,12,12,15,29,44,68,53,121,0.000333,0.220197,7,4624.138581,256.896588,660.591226,199.484808,4,6
0,0,14,14,16,29,45,82,61,143,0.000333,0.261778,16,12565.35988,698.075549,785.334993,204.881449,6,6
0,0,6,6,14,23,37,40,35,75,0.000333,0.130236,7,2734.963017,151.94239,390.709002,157.344894,2,6
0,0,5,5,14,21,35,35,32,67,0.000333,0.114554,7,2405.633735,133.646319,343.661962,145.541635,2,6
0,0,3,3,10,14,24,18,17,35,0.000333,0.053491,5,802.368438,44.576024,160.473688,86.52225,1,6
0,0,3,3,10,13,23,15,15,30,0.000333,0.045236,5,678.534293,37.69635,135.706859,81.324997,1,6
0,0,14,14,15,32,47,81,55,136,0.000333,0.251808,7,5287.968587,293.776033,755.424084,218.603359,7,6
0,0,33,33,26,51,77,170,116,286,0.000333,0.597434,26,46599.82472,2588.879151,1792.300951,411.505125,17,6
0,0,34,34,26,54,80,178,120,298,0.000333,0.627978,26,48982.29888,2721.238827,1883.934572,432.975358,17,6
0,0,30,30,26,45,71,156,106,262,0.000333,0.537078,26,41892.07738,2327.337632,1611.233745,369.344822,14,6
0,0,33,33,26,50,76,170,117,287,0.000333,0.597718,26,46622.03511,2590.113061,1793.155196,404.404242,17,6
0,0,14,14,17,29,46,81,53,134,0.000333,0.246719,8,5921.258417,328.958801,740.157302,210.368317,4,6
0,0,27,27,19,46,65,166,109,275,0.000333,0.55205,18,29810.72067,1656.151149,1656.151149,334.794473,11,6
0,0,28,28,20,49,69,174,113,287,0.000333,0.584382,20,35062.93038,1947.940577,1753.146519,361.559344,11,6
0,0,25,25,24,40,64,129,86,215,0.000333,0.43,24,30960,1720,1290,322.916224,12,6
0,0,17,17,19,31,50,83,55,138,0.000333,0.259617,9,7009.669388,389.426077,778.852154,234.290708,8,6
0,0,18,18,21,32,53,94,61,155,0.000333,0.295943,10,8878.276705,493.237595,887.82767,252.238666,8,6
0,0,22,22,23,36,59,117,78,195,0.000333,0.382372,22,25236.53868,1402.029927,1147.115395,290.159225,10,6
0,0,32,32,23,43,66,157,101,258,0.000333,0.519818,22,34307.98102,1905.998946,1559.453683,337.371309,15,6
0,0,43,43,27,55,82,204,140,344,0.000333,0.728999,26,56861.94513,3158.996952,2186.99789,446.356747,18,6
0,0,35,35,24,46,70,158,109,267,0.000333,0.545506,24,39276.44557,2182.024754,1636.518566,364.12295,14,6
0,0,36,36,25,47,72,169,115,284,0.000333,0.584086,24,42054.20881,2336.344934,1752.2587,377.162081,14,6
0,0,40,40,26,51,77,192,132,324,0.000333,0.676813,26,52791.40982,2932.856101,2030.438839,411.505125,16,6
0,0,5,5,13,13,26,33,23,56,0.000333,0.087742,6,1579.347745,87.741541,263.224624,96.211433,1,6
0,0,23,23,19,44,63,102,79,181,0.000333,0.360629,9,9736.988995,540.943833,1081.887666,320.925614,7,6
0,0,22,22,19,44,63,101,77,178,0.000333,0.354652,9,9575.602437,531.977913,1063.955826,320.925614,7,6
0,0,9,9,11,19,30,33,32,65,0.000333,0.106316,5,1594.739444,88.596636,318.947889,118.764371,3,6
0,0,12,12,15,22,37,45,41,86,0.000333,0.149338,7,3136.090926,174.227274,448.012989,156.710855,4,6
0,0,9,9,11,20,31,33,32,65,0.000333,0.107341,5,1610.113801,89.450767,322.02276,124.49231,3,6
0,0,12,12,15,23,38,45,41,86,0.000333,0.150441,7,3159.252363,175.51402,451.321766,162.645284,4,6
0,0,16,16,14,20,34,67,49,116,0.000333,0.196715,14,8262.039654,459.002203,590.14569,139.741531,3,6
0,0,9,9,13,15,28,34,27,61,0.000333,0.09775,6,1759.491901,97.74955,293.24865,106.709075,2,6
0,0,29,29,20,49,69,125,97,222,0.000333,0.452031,10,13560.92429,753.384683,1356.092429,361.559344,10,6
0,0,28,28,20,49,69,124,95,219,0.000333,0.445922,10,13377.66856,743.203809,1337.766856,361.559344,10,6
0,0,9,9,12,18,30,32,28,60,0.000333,0.098138,6,1766.480614,98.137812,294.413436,118.0782,3,6
0,0,10,10,12,18,30,33,30,63,0.000333,0.103045,6,1854.804645,103.044703,309.134108,118.0782,3,6
0,0,27,27,18,49,67,118,91,209,0.000333,0.422604,9,11410.31377,633.90632,1267.812641,350.179432,10,6
0,0,26,26,18,49,67,117,89,206,0.000333,0.416538,9,11246.52936,624.807187,1249.614373,350.179432,10,6
0,0,36,36,22,51,73,155,113,268,0.000333,0.552958,22,36495.2056,2027.511422,1658.872982,387.401188,13,6
0,0,35,35,22,51,73,154,111,265,0.000333,0.546768,22,36086.67718,2004.815399,1640.303508,387.401188,13,6
0,0,15,15,10,19,29,58,58,116,0.000333,0.187842,15,8452.886932,469.60483,563.525795,113.929904,1,6
0,0,18,18,14,22,36,70,67,137,0.000333,0.236093,21,14873.87423,826.326346,708.279725,151.410465,2,6
0,0,15,15,9,18,27,49,61,110,0.000333,0.174346,12,6276.451503,348.69175,523.037625,103.587975,1,6
0,0,18,18,13,21,34,61,70,131,0.000333,0.222153,18,11996.23738,666.457632,666.457632,140.344382,2,6
0,0,29,29,20,49,69,125,97,222,0.000333,0.452031,10,13560.92429,753.384683,1356.092429,361.559344,10,6
0,0,28,28,20,49,69,124,95,219,0.000333,0.445922,10,13377.66856,743.203809,1337.766856,361.559344,10,6
0,0,12,12,14,19,33,56,42,98,0.000333,0.164784,14,6920.908732,384.49493,494.350624,134.013592,6,6
0,0,14,14,15,20,35,66,47,113,0.000333,0.193203,14,8114.525733,450.806985,579.608981,145.041921,7,6
0,0,12,12,14,19,33,56,42,98,0.000333,0.164784,14,6920.908732,384.49493,494.350624,134.013592,6,6
0,0,13,13,10,16,26,48,59,107,0.000333,0.167649,15,7544.205748,419.122542,502.94705,97.219281,1,6
0,0,15,15,14,19,33,56,64,120,0.000333,0.201776,21,12711.87318,706.215177,605.327294,134.013592,2,6
0,0,33,33,19,51,70,140,104,244,0.000333,0.498515,18,26919.81101,1495.545056,1495.545056,370.004315,11,6
0,0,36,36,21,54,75,153,112,265,0.000333,0.550212,20,33012.73906,1834.041059,1650.636953,403.002591,12,6
0,0,10,10,13,16,29,39,30,69,0.000333,0.111734,6,2011.204132,111.733563,335.200689,112.105716,2,6
0,0,29,29,21,53,74,129,93,222,0.000333,0.4595,10,13784.98647,765.832582,1378.498647,395.81845,12,6
0,0,28,28,21,53,74,128,91,219,0.000333,0.45329,10,13598.70287,755.483493,1359.870287,395.81845,12,6
0,0,10,10,12,20,32,36,30,66,0.000333,0.11,6,1980,110,330,129.458112,4,6
0,0,11,11,12,20,32,37,32,69,0.000333,0.115,6,2070,115,345,129.458112,4,6
0,0,10,10,12,20,32,36,30,66,0.000333,0.11,6,1980,110,330,129.458112,4,6
0,0,11,11,12,20,32,37,32,69,0.000333,0.115,6,2070,115,345,129.458112,4,6
0,0,18,18,15,22,37,69,51,120,0.000333,0.208378,14,8751.881654,486.215647,625.134404,156.710855,6,6
0,0,19,19,15,22,37,70,53,123,0.000333,0.213588,14,8970.678696,498.371039,640.762764,156.710855,6,6
0,0,10,10,12,21,33,36,31,67,0.000333,0.112658,6,2027.846436,112.658135,337.974406,135.258216,4,6
0,0,11,11,12,21,33,37,33,70,0.000333,0.117703,6,2118.64553,117.702529,353.107588,135.258216,4,6
0,0,11,11,12,19,31,40,32,72,0.000333,0.118901,6,2140.212806,118.900711,356.702134,123.730173,3,6
0,0,14,14,16,22,38,53,40,93,0.000333,0.162686,8,3904.45807,216.914337,488.057259,162.107496,4,6
0,0,12,12,13,20,33,44,33,77,0.000333,0.129473,6,2330.510083,129.472782,388.418347,134.544278,3,6
0,0,9,9,11,18,29,36,29,65,0.000333,0.105256,5,1578.843823,87.713546,315.768765,113.112398,3,6
0,0,12,12,15,21,36,49,37,86,0.000333,0.148205,7,3112.294851,172.905269,444.61355,150.842025,4,6
0,0,10,10,12,18,30,40,30,70,0.000333,0.114494,6,2060.89405,114.494114,343.482342,118.0782,3,6
0,0,7,7,11,14,25,34,27,61,0.000333,0.094425,5,1416.376138,78.687563,283.275228,91.356717,1,6
0,0,10,10,14,17,31,47,35,82,0.000333,0.135415,14,5687.417364,315.967631,406.244097,122.789837,2,6
0,0,15,15,16,22,38,71,53,124,0.000333,0.216914,16,10411.88819,578.438233,650.743012,162.107496,6,6
0,0,7,7,10,14,24,32,30,62,0.000333,0.094756,10,2842.67675,157.926486,284.267675,86.52225,1,6
0,0,9,9,14,17,31,40,35,75,0.000333,0.123855,14,5201.906126,288.994785,371.564723,122.789837,2,6
0,0,19,19,10,22,32,82,76,158,0.000333,0.263333,15,11850,658.333333,790,131.326777,1,6
0,0,21,21,14,25,39,90,81,171,0.000333,0.301268,21,18979.87937,1054.437743,903.803779,169.399374,2,6
0,0,7,7,12,15,27,34,31,65,0.000333,0.103023,12,3708.812252,206.045125,309.067688,101.622909,1,6
0,0,9,9,15,18,33,42,36,78,0.000333,0.131154,14,5508.478378,306.026577,393.462741,133.662009,2,6
0,0,17,17,13,22,35,72,71,143,0.000333,0.244496,18,13202.77449,733.487471,733.487471,146.213212,1,6
0,0,19,19,17,25,42,80,76,156,0.000333,0.280401,24,20188.83643,1121.602024,841.201518,185.583273,2,6
0,0,12,12,10,22,32,48,53,101,0.000333,0.168333,10,5050,280.555556,505,131.326777,1,6
0,0,10,10,10,19,29,43,48,91,0.000333,0.147359,10,4420.762706,245.597928,442.076271,113.929904,1,6
0,0,11,11,10,22,32,45,45,90,0.000333,0.15,10,4500,250,450,131.326777,1,6
0,0,9,9,10,19,29,40,40,80,0.000333,0.129546,10,3886.384796,215.910266,388.63848,113.929904,1,6
0,0,28,28,22,58,80,157,108,265,0.000333,0.558437,11,18428.4204,1023.801133,1675.310945,437.870393,9,6
0,0,27,27,22,56,78,152,105,257,0.000333,0.538449,11,17768.83207,987.157337,1615.34837,423.319371,9,6
0,0,17,17,17,32,49,98,66,164,0.000333,0.306937,16,14732.99863,818.499924,920.812414,229.486868,6,6
0,0,24,24,19,45,64,105,81,186,0.000333,0.372,9,10044,558,1116,327.844012,7,6
0,0,23,23,19,45,64,104,79,183,0.000333,0.366,9,9882,549,1098,327.844012,7,6
0,0,17,17,16,19,35,73,52,125,0.000333,0.21372,16,10258.56603,569.920335,641.160377,144.710623,3,6
0,0,20,20,19,22,41,86,60,146,0.000333,0.260734,18,14079.64667,782.202593,782.202593,178.818118,4,6
0,0,10,10,13,15,28,41,31,72,0.000333,0.115377,12,4153.554653,230.753036,346.129554,106.709075,2,6
0,0,15,15,14,19,33,68,50,118,0.000333,0.198413,14,8333.339085,462.963283,595.238506,134.013592,3,6
0,0,18,18,17,22,39,81,58,139,0.000333,0.24489,16,11754.73454,653.040807,734.670908,167.594364,4,6
0,0,10,10,13,15,28,41,31,72,0.000333,0.115377,12,4153.554653,230.753036,346.129554,106.709075,2,6
0,0,15,15,14,19,33,68,50,118,0.000333,0.198413,14,8333.339085,462.963283,595.238506,134.013592,3,6
0,0,18,18,17,22,39,81,58,139,0.000333,0.24489,16,11754.73454,653.040807,734.670908,167.594364,4,6
0,0,10,10,13,15,28,41,31,72,0.000333,0.115377,12,4153.554653,230.753036,346.129554,106.709075,2,6
0,0,18,18,16,23,39,86,57,143,0.000333,0.251938,16,12093.00028,671.833349,755.812517,168.041925,5,6
0,0,18,18,16,23,39,86,57,143,0.000333,0.251938,16,12093.00028,671.833349,755.812517,168.041925,5,6
0,0,15,15,11,18,29,55,54,109,0.000333,0.176507,15,7942.798927,441.266607,529.519928,113.112398,2,6
0,0,17,17,15,21,36,63,59,122,0.000333,0.210244,14,8830.231902,490.568439,630.73085,150.842025,3,6
0,0,14,14,15,21,36,52,47,99,0.000333,0.170608,14,7165.516052,398.084225,511.822575,150.842025,3,6
0,0,14,14,13,20,33,63,49,112,0.000333,0.188324,12,6779.665696,376.648094,564.972141,134.544278,2,6
0,0,17,17,17,22,39,76,57,133,0.000333,0.234319,16,11247.33592,624.851996,702.958495,167.594364,3,6
0,0,9,9,13,16,29,37,30,67,0.000333,0.108495,6,1952.90836,108.494909,325.484727,112.105716,2,6
0,0,16,16,11,18,29,61,59,120,0.000333,0.194319,15,8744.365791,485.7981,582.957719,113.112398,1,6
0,0,18,18,15,21,36,69,64,133,0.000333,0.2292,21,14439.60053,802.200029,687.600025,150.842025,2,6
0,0,14,14,14,21,35,52,48,100,0.000333,0.170976,14,7180.996224,398.944235,512.928302,145.541635,2,6
0,0,17,17,19,30,49,132,78,210,0.000333,0.39303,18,21223.60321,1179.089067,1179.089067,227.917341,16,6
0,0,16,16,18,26,44,95,61,156,0.000333,0.28389,18,15330.08399,851.671333,851.671333,197.270083,10,6
0,0,12,12,16,24,40,73,47,120,0.000333,0.212877,8,5109.050971,283.836165,638.631371,174.0391,9,6
0,0,16,16,14,20,34,60,53,113,0.000333,0.191628,14,8048.366215,447.131456,574.883301,139.741531,3,6
0,0,18,18,16,21,37,65,56,121,0.000333,0.210115,16,10085.50172,560.305651,630.343857,156.238666,3,6
0,0,18,18,15,21,36,64,56,120,0.000333,0.206797,14,8685.474002,482.526333,620.391,150.842025,3,6
0,0,9,9,11,19,30,36,30,66,0.000333,0.107952,5,1619.273897,89.959661,323.854779,118.764371,3,6
0,0,12,12,15,22,37,49,38,87,0.000333,0.151074,7,3172.5571,176.253172,453.222443,156.710855,4,6
0,0,10,10,12,19,31,40,31,71,0.000333,0.117249,6,2110.487628,117.249313,351.747938,123.730173,3,6
0,0,7,7,12,13,25,30,26,56,0.000333,0.086685,12,3120.67136,173.370631,260.055947,91.125266,3,6
0,0,7,7,12,15,27,28,25,53,0.000333,0.084003,6,1512.054226,84.003013,252.009038,101.622909,2,6
0,0,13,13,15,16,31,46,45,91,0.000333,0.150277,14,6311.646099,350.647006,450.831864,122.603359,3,6
0,0,13,13,15,18,33,44,44,88,0.000333,0.147969,14,6214.693555,345.260753,443.906683,133.662009,2,6
0,0,13,13,14,15,29,44,44,88,0.000333,0.142501,14,5985.032586,332.50181,427.502328,111.906328,3,6
0,0,13,13,14,17,31,42,43,85,0.000333,0.140369,14,5895.493609,327.527423,421.106686,122.789837,2,6
0,0,13,13,15,17,32,43,44,87,0.000333,0.145,14,6090,338.333333,435,128.090227,3,6
0,0,13,13,15,19,34,41,43,84,0.000333,0.142449,14,5982.856301,332.380906,427.346879,139.313982,2,6
0,0,12,12,14,21,35,53,42,95,0.000333,0.162427,14,6821.946413,378.997023,487.281887,145.541635,4,6
0,0,18,18,10,19,29,70,77,147,0.000333,0.238041,20,14282.46413,793.470229,714.123206,113.929904,1,6
0,0,20,20,14,22,36,78,82,160,0.000333,0.275729,21,17370.94801,965.052667,827.188,151.410465,2,6
0,0,7,7,10,13,23,36,27,63,0.000333,0.094995,10,2849.844032,158.324668,284.984403,81.324997,1,6
0,0,10,10,14,16,30,49,35,84,0.000333,0.137393,14,5770.50334,320.583519,412.17881,117.302969,2,6
0,0,27,27,20,50,70,140,96,236,0.000333,0.48217,10,14465.10792,803.617107,1446.510792,368.631371,11,6
0,0,15,15,14,21,35,74,49,123,0.000333,0.210301,14,8832.625355,490.701409,630.901811,145.541635,5,6
0,0,27,27,19,48,67,140,96,236,0.000333,0.477199,18,25768.74688,1431.597049,1431.597049,348.788823,11,6
0,0,15,15,14,21,35,74,49,123,0.000333,0.210301,14,8832.625355,490.701409,630.901811,145.541635,5,6
0,0,28,28,19,50,69,143,107,250,0.000333,0.509044,18,27488.36006,1527.131114,1527.131114,362.903432,10,6
0,0,29,29,19,50,69,152,106,258,0.000333,0.525333,18,28367.98758,1575.99931,1575.99931,362.903432,9,6
0,0,16,16,14,22,36,77,51,128,0.000333,0.220583,14,9264.505603,514.694756,661.7504,151.410465,5,6
0,0,47,47,23,58,81,227,151,378,0.000333,0.798821,22,52722.19262,2929.010701,2396.463301,443.804823,17,6
0,0,43,43,22,54,76,209,136,345,0.000333,0.718512,22,47421.76983,2634.542768,2155.534992,408.871421,16,6
0,0,49,49,26,62,88,240,159,399,0.000333,0.859104,26,67010.14361,3722.785756,2577.313216,491.371604,17,6
0,0,51,51,26,63,89,255,171,426,0.000333,0.919554,26,71725.22348,3984.734638,2758.662442,498.780068,18,6
0,0,47,47,20,55,75,236,171,407,0.000333,0.845043,30,76053.87621,4225.215345,2535.129207,404.413346,28,6
0,0,26,26,23,46,69,134,94,228,0.000333,0.464248,22,30640.35868,1702.242149,1392.743576,358.125775,12,6
0,0,18,18,18,37,55,88,63,151,0.000333,0.290995,9,7856.867851,436.492658,872.985317,267.808425,8,6
0,0,19,19,20,38,58,99,69,168,0.000333,0.328047,10,9841.408072,546.744893,984.140807,285.859807,8,6
0,0,23,23,22,42,64,122,86,208,0.000333,0.416,22,27456,1525.333333,1248,324.584827,10,6
0,0,28,28,26,52,78,192,113,305,0.000333,0.639016,26,49843.2396,2769.068866,1917.047677,418.634298,19,6
0,0,30,30,26,52,78,199,119,318,0.000333,0.666253,26,51967.70555,2887.094753,1998.757906,418.634298,19,6
0,0,27,27,24,51,75,181,109,290,0.000333,0.602119,24,43352.57809,2408.47656,1806.35742,399.332792,18,6
0,0,9,9,11,20,31,32,29,61,0.000333,0.100735,5,1511.029875,83.946104,302.205975,124.49231,3,6
0,0,10,10,11,20,31,33,31,64,0.000333,0.10569,5,1585.342819,88.074601,317.068564,124.49231,3,6
0,0,15,15,11,17,28,63,52,115,0.000333,0.184282,15,8292.687241,460.704847,552.845816,107.540616,1,6
0,0,18,18,15,20,35,76,60,136,0.000333,0.232527,21,14649.2323,813.846239,697.58249,145.041921,2,6
0,0,10,10,14,17,31,50,35,85,0.000333,0.140369,14,5895.493609,327.527423,421.106686,122.789837,2,6
0,0,15,15,13,18,31,61,54,115,0.000333,0.189911,18,10255.18636,569.732576,569.732576,123.164366,1,6
0,0,18,18,17,21,38,74,62,136,0.000333,0.237906,16,11419.49027,634.416126,713.718142,161.725534,2,6
0,0,12,12,10,14,24,50,39,89,0.000333,0.136021,10,4080.616626,226.700924,408.061663,86.52225,1,6
0,0,15,15,14,17,31,63,47,110,0.000333,0.181654,14,7629.462318,423.859018,544.961594,122.789837,2,6
0,0,10,10,14,15,29,44,32,76,0.000333,0.123069,14,5168.891779,287.160654,369.206556,111.906328,2,6
0,0,12,12,14,17,31,49,37,86,0.000333,0.14202,14,5964.852358,331.380687,426.060883,122.789837,2,6
0,0,11,11,14,17,31,47,35,82,0.000333,0.135415,14,5687.417364,315.967631,406.244097,122.789837,2,6
0,0,13,13,11,14,25,53,40,93,0.000333,0.14396,10,4318.786256,239.93257,431.878626,91.356717,2,6
0,0,16,16,14,17,31,66,48,114,0.000333,0.188259,14,7906.897311,439.272073,564.778379,122.789837,3,6
0,0,10,10,14,15,29,44,32,76,0.000333,0.123069,14,5168.891779,287.160654,369.206556,111.906328,2,6
0,0,13,13,14,17,31,52,38,90,0.000333,0.148626,14,6242.287351,346.793742,445.877668,122.789837,3,6
0,0,11,11,14,17,31,47,35,82,0.000333,0.135415,14,5687.417364,315.967631,406.244097,122.789837,2,6
0,0,13,13,11,15,26,53,41,94,0.000333,0.14728,10,4418.413335,245.467408,441.841334,96.657107,2,6
0,0,16,16,14,18,32,66,49,115,0.000333,0.191667,14,8050,447.222222,575,128.361619,3,6
0,0,10,10,14,15,29,44,32,76,0.000333,0.123069,14,5168.891779,287.160654,369.206556,111.906328,2,6
0,0,13,13,14,18,32,52,39,91,0.000333,0.151667,14,6370,353.888889,455,128.361619,3,6
0,0,11,11,14,17,31,47,35,82,0.000333,0.135415,14,5687.417364,315.967631,406.244097,122.789837,2,6
0,0,13,13,11,15,26,53,40,93,0.000333,0.145714,10,4371.408938,242.856052,437.140894,96.657107,2,6
0,0,16,16,14,18,32,66,48,114,0.000333,0.19,14,7980,443.333333,570,128.361619,3,6
0,0,10,10,14,15,29,44,32,76,0.000333,0.123069,14,5168.891779,287.160654,369.206556,111.906328,2,6
0,0,13,13,14,18,32,52,38,90,0.000333,0.15,14,6300,350,450,128.361619,3,6
0,0,11,11,14,17,31,47,35,82,0.000333,0.135415,14,5687.417364,315.967631,406.244097,122.789837,2,6
0,0,9,9,15,24,39,65,38,103,0.000333,0.181465,7,3810.775,211.709722,544.396429,168.642459,5,6
0,0,23,23,18,44,62,158,98,256,0.000333,0.508091,18,27436.9366,1524.274255,1524.274255,315.273641,13,6
0,0,24,24,19,47,66,166,102,268,0.000333,0.539966,18,29158.15723,1619.897624,1619.897624,341.776299,13,6
0,0,19,19,17,42,59,110,74,184,0.000333,0.360802,8,8659.250569,481.069476,1082.406321,295.9642,9,6
0,0,29,29,24,47,71,154,102,256,0.000333,0.524778,24,37784.0463,2099.113683,1574.335263,371.104776,14,6
0,0,30,30,24,50,74,162,106,268,0.000333,0.554711,24,39939.20405,2218.844669,1664.133502,392.23191,14,6
0,0,26,26,23,41,64,140,92,232,0.000333,0.464,22,30624,1701.333333,1392,323.701557,11,6
0,0,29,29,24,46,70,154,103,257,0.000333,0.525075,24,37805.41765,2100.30098,1575.225735,364.12295,14,6
0,0,16,16,15,33,48,91,61,152,0.000333,0.282971,7,5942.400101,330.133339,848.9143,225.068365,7,6
0,0,25,25,23,38,61,133,87,220,0.000333,0.434921,22,28704.76871,1594.709373,1304.762214,303.463171,14,6
0,0,26,26,23,41,64,141,91,232,0.000333,0.464,22,30624,1701.333333,1392,323.701557,14,6
0,0,22,22,22,32,54,119,77,196,0.000333,0.375986,22,24815.07491,1378.615273,1127.95795,258.107496,11,6
0,0,25,25,23,37,60,133,88,221,0.000333,0.435141,22,28719.30208,1595.516782,1305.422822,296.7917,14,6
0,0,20,20,17,21,38,86,68,154,0.000333,0.269394,24,19396.34009,1077.574449,808.180837,161.725534,3,6
0,0,10,10,13,15,28,44,33,77,0.000333,0.123389,12,4441.995948,246.777553,370.166329,106.709075,2,6
0,0,7,7,14,11,25,40,28,68,0.000333,0.105261,14,4420.951093,245.608394,315.782221,91.356717,3,6
0,0,23,23,21,35,56,118,77,195,0.000333,0.377478,20,22648.6842,1258.260233,1132.43421,271.763571,8,6
0,0,23,23,22,33,55,115,75,190,0.000333,0.366153,22,24166.0836,1342.5602,1098.458346,264.572502,8,6
0,0,28,28,23,42,65,147,95,242,0.000333,0.485804,22,32063.08624,1781.282569,1457.413011,330.519257,11,6
0,0,16,16,16,29,45,88,55,143,0.000333,0.261778,8,6282.679942,349.037775,785.334993,204.881449,5,6
0,0,27,27,21,42,63,146,93,239,0.000333,0.47619,20,28571.39803,1587.299891,1428.569902,318.715998,10,6
0,0,23,23,19,40,59,123,81,204,0.000333,0.40002,18,21601.06528,1200.059182,1200.059182,293.587747,9,6
0,0,35,35,17,52,69,191,132,323,0.000333,0.657684,16,31568.85439,1753.825244,1973.0534,365.909734,20,6
0,0,32,32,17,65,82,201,131,332,0.000333,0.703569,16,33771.31625,1876.184236,2110.707266,460.940776,15,6
0,0,30,30,18,61,79,182,113,295,0.000333,0.619872,9,16736.53789,929.80766,1859.615321,436.833628,15,6
0,0,33,33,19,51,70,140,104,244,0.000333,0.498515,18,26919.81101,1495.545056,1495.545056,370.004315,11,6
0,0,36,36,21,54,75,153,112,265,0.000333,0.550212,20,33012.73906,1834.041059,1650.636953,403.002591,12,6
0,0,10,10,13,16,29,39,30,69,0.000333,0.111734,6,2011.204132,111.733563,335.200689,112.105716,2,6
0,0,29,29,21,53,74,129,93,222,0.000333,0.4595,10,13784.98647,765.832582,1378.498647,395.81845,12,6
0,0,28,28,21,53,74,128,91,219,0.000333,0.45329,10,13598.70287,755.483493,1359.870287,395.81845,12,6
0,0,13,13,11,19,30,53,49,102,0.000333,0.166834,10,5005.028408,278.057134,500.502841,118.764371,2,6
0,0,15,15,14,22,36,61,54,115,0.000333,0.19818,14,8323.579252,462.42107,594.541375,151.410465,3,6
0,0,4,4,13,13,26,28,24,52,0.000333,0.081474,6,1466.537192,81.474288,244.422865,96.211433,2,6
0,0,5,5,8,13,21,18,19,37,0.000333,0.054172,4,650.062979,36.11461,162.515745,72.105716,1,6
0,0,17,17,12,25,37,62,54,116,0.000333,0.201432,12,7251.559085,402.864394,604.29659,159.115955,3,6
0,0,20,20,15,27,42,75,62,137,0.000333,0.246249,14,10342.46482,574.581379,738.747487,186.985321,4,6
0,0,10,10,13,16,29,39,30,69,0.000333,0.111734,6,2011.204132,111.733563,335.200689,112.105716,2,6
0,0,13,13,14,23,37,53,41,94,0.000333,0.16323,7,3427.820315,190.434462,489.688616,157.344894,4,6
0,0,14,14,14,23,37,54,43,97,0.000333,0.168439,7,3537.218835,196.512158,505.316976,157.344894,4,6
0,0,15,15,11,20,31,65,53,118,0.000333,0.194865,10,5845.951646,324.775091,584.595165,124.49231,1,6
0,0,18,18,15,23,38,78,61,139,0.000333,0.243154,14,10212.46694,567.359275,729.461924,162.645284,2,6
0,0,10,10,13,16,29,42,32,74,0.000333,0.11983,12,4313.887124,239.660396,359.490594,112.105716,2,6
0,0,51,51,29,55,84,284,172,456,0.000333,0.971632,42,122425.6633,6801.425738,2914.896745,458.856233,32,6
0,0,48,48,28,49,77,266,161,427,0.000333,0.891973,42,112388.5498,6243.808323,2675.917853,409.72672,29,6
0,0,51,51,29,54,83,284,173,457,0.000333,0.971131,42,122362.5068,6797.917047,2913.39302,451.645374,32,6
0,0,28,28,19,49,68,122,92,214,0.000333,0.434239,9,11724.45343,651.358524,1302.717048,355.831405,11,6
0,0,27,27,19,49,68,121,90,211,0.000333,0.428152,9,11560.09194,642.22733,1284.45466,355.831405,11,6
0,0,18,18,15,35,50,89,75,164,0.000333,0.308531,14,12958.29381,719.905212,925.592415,238.128265,5,6
0,0,17,17,15,33,48,84,72,156,0.000333,0.290418,14,12197.5581,677.642117,871.25415,225.068365,5,6
0,0,13,13,15,30,45,70,62,132,0.000333,0.241642,14,10148.94452,563.830251,724.924609,205.810077,4,6
0,0,58,58,28,68,96,293,193,486,0.000333,1.066764,28,89608.16971,4978.231651,3200.291775,548.553411,27,6
0,0,50,50,22,53,75,234,154,388,0.000333,0.805594,22,53169.19634,2953.844241,2416.781652,401.68728,18,6
0,0,49,49,20,37,57,221,149,370,0.000333,0.71939,40,86326.77221,4795.931789,2158.169305,279.188336,15,6
0,0,54,54,22,53,75,248,166,414,0.000333,0.859577,33,85098.12095,4727.673386,2578.730938,401.68728,19,6
0,0,29,29,24,40,64,154,101,255,0.000333,0.51,24,36720,2040,1530,322.916224,14,6
0,0,30,30,24,41,65,162,105,267,0.000333,0.535991,24,38591.33295,2143.962941,1607.972206,329.698732,14,6
0,0,32,32,24,42,66,169,111,280,0.000333,0.564143,24,40618.32848,2256.573805,1692.430353,336.516432,14,6
0,0,28,28,22,40,62,146,97,243,0.000333,0.48229,22,31831.13348,1768.396304,1446.869703,310.984619,14,6
0,0,28,28,19,49,68,122,93,215,0.000333,0.436268,9,11779.2406,654.402255,1308.804511,355.831405,11,6
0,0,27,27,19,49,68,121,91,212,0.000333,0.430181,9,11614.8791,645.271061,1290.542122,355.831405,11,6
0,0,8,8,11,13,24,35,27,62,0.000333,0.094756,10,2842.67675,157.926486,284.267675,86.159464,1,6
0,0,11,11,15,16,31,48,35,83,0.000333,0.137066,14,5756.776113,319.820895,411.198294,122.603359,2,6
0,0,14,14,11,17,28,57,50,107,0.000333,0.171462,10,5143.869767,285.770543,514.386977,107.540616,2,6
0,0,16,16,15,19,34,65,55,120,0.000333,0.203499,14,8546.937573,474.829865,610.495541,139.313982,3,6
0,0,14,14,11,19,30,57,51,108,0.000333,0.176648,10,5299.441843,294.413436,529.944184,118.764371,2,6
0,0,16,16,14,21,35,65,56,121,0.000333,0.206881,14,8689.005431,482.722524,620.643245,145.541635,3,6
0,0,16,16,12,19,31,61,53,114,0.000333,0.188259,12,6777.340553,376.51892,564.778379,123.730173,2,6
0,0,18,18,15,21,36,69,58,127,0.000333,0.21886,14,9192.126653,510.673703,656.580475,150.842025,3,6
0,0,14,14,11,18,29,57,50,107,0.000333,0.173268,10,5198.039665,288.779981,519.803966,113.112398,2,6
0,0,16,16,14,20,34,65,55,120,0.000333,0.203499,14,8546.937573,474.829865,610.495541,139.741531,3,6
0,0,7,7,12,12,24,29,29,58,0.000333,0.088643,12,3191.133901,177.285217,265.927825,86.0391,1,6
0,0,9,9,16,16,32,37,34,71,0.000333,0.118333,16,5680,315.555556,355,128,2,6
0,0,17,17,15,35,50,86,65,151,0.000333,0.284074,7,5965.555993,331.419777,852.222285,238.128265,6,6
0,0,16,16,15,33,48,81,62,143,0.000333,0.266217,7,5590.547463,310.58597,798.649638,225.068365,6,6
0,0,11,11,15,29,44,64,50,114,0.000333,0.207458,7,4356.626432,242.034802,622.375205,199.484808,4,6
0,0,17,17,15,36,51,86,65,151,0.000333,0.285512,7,5995.753586,333.097421,856.536227,244.720659,6,6
0,0,16,16,15,34,49,81,62,143,0.000333,0.267635,7,5620.324554,312.240253,802.903508,231.577096,6,6
0,0,11,11,15,29,44,64,50,114,0.000333,0.207458,7,4356.626432,242.034802,622.375205,199.484808,4,6
0,0,17,17,10,19,29,72,59,131,0.000333,0.212132,15,9545.932655,530.329592,636.39551,113.929904,1,6
0,0,20,20,14,22,36,85,67,152,0.000333,0.261943,21,16502.40061,916.800034,785.8286,151.410465,2,6
0,0,10,10,14,17,31,51,35,86,0.000333,0.14202,14,5964.852358,331.380687,426.060883,122.789837,2,6
0,0,27,27,22,41,63,225,95,320,0.000333,0.637577,22,42080.05066,2337.780592,1912.729576,317.767128,7,6
0,0,34,34,25,51,76,182,113,295,0.000333,0.61438,24,44235.3268,2457.518155,1843.138616,405.390097,16,6
0,0,20,20,17,39,56,122,72,194,0.000333,0.375542,8,9013.014839,500.723047,1126.626855,275.617555,10,6
0,0,33,33,25,53,78,184,113,297,0.000333,0.622255,24,44802.34702,2489.019279,1866.764459,419.676189,16,6
0,0,27,27,25,45,70,147,93,240,0.000333,0.490343,24,35304.67018,1961.370565,1471.027924,363.229794,12,6
0,0,20,20,19,31,50,103,64,167,0.000333,0.314175,18,16965.43171,942.523984,942.523984,234.290708,14,6
0,0,22,22,19,32,51,119,71,190,0.000333,0.359254,18,19399.69467,1077.760815,1077.760815,240.710623,15,6
0,0,3,3,10,16,26,19,18,37,0.000333,0.057972,5,869.581348,48.310075,173.91627,97.219281,1,6
0,0,3,3,10,16,26,19,18,37,0.000333,0.057972,5,869.581348,48.310075,173.91627,97.219281,1,6
0,0,3,3,10,15,25,16,16,32,0.000333,0.049534,5,743.01699,41.278722,148.603398,91.82264,1,6
0,0,18,18,16,23,39,86,57,143,0.000333,0.251938,16,12093.00028,671.833349,755.812517,168.041925,5,6
0,0,3,3,10,16,26,19,18,37,0.000333,0.057972,5,869.581348,48.310075,173.91627,97.219281,1,6
0,0,3,3,11,12,23,17,13,30,0.000333,0.045236,5,678.534293,37.69635,135.706859,81.073298,1,6
0,0,21,21,15,22,37,84,75,159,0.000333,0.276101,21,17394.36479,966.353599,828.303085,156.710855,2,6
0,0,10,10,13,17,30,43,36,79,0.000333,0.129215,12,4651.732285,258.429571,387.644357,117.592585,2,6
0,0,14,14,14,18,32,51,49,100,0.000333,0.166667,14,7000,388.888889,500,128.361619,2,6
0,0,11,11,14,18,32,40,37,77,0.000333,0.128333,14,5390,299.444444,385,128.361619,2,6
0,0,17,17,17,22,39,62,64,126,0.000333,0.221987,16,10655.37087,591.965049,665.96068,167.594364,2,6
0,0,9,9,15,17,32,40,35,75,0.000333,0.125,14,5250,291.666667,375,128.090227,2,6
0,0,10,10,14,17,31,38,37,75,0.000333,0.123855,14,5201.906126,288.994785,371.564723,122.789837,2,6
0,0,18,18,11,20,31,73,70,143,0.000333,0.23615,15,10626.75109,590.37506,708.450072,124.49231,1,6
0,0,20,20,15,23,38,81,75,156,0.000333,0.272892,21,17192.21053,955.122807,818.676692,162.645284,2,6
0,0,18,18,10,18,28,69,69,138,0.000333,0.221138,15,9951.224689,552.845816,663.414979,108.277931,1,6
0,0,21,21,14,21,35,82,77,159,0.000333,0.271852,21,17126.67599,951.482,815.556,145.541635,2,6
0,0,10,10,14,16,30,49,35,84,0.000333,0.137393,14,5770.50334,320.583519,412.17881,117.302969,2,6
0,0,3,3,10,15,25,16,16,32,0.000333,0.049534,5,743.01699,41.278722,148.603398,91.82264,1,6
0,0,16,16,15,19,34,60,55,115,0.000333,0.195019,14,8190.815174,455.045287,585.058227,139.313982,2,6
0,0,12,12,14,19,33,43,39,82,0.000333,0.13788,14,5790.964449,321.720247,413.640318,134.013592,2,6
0,0,3,3,9,10,19,13,14,27,0.000333,0.038231,4,458.776171,25.487565,114.694043,61.748606,1,6
0,0,18,18,17,26,43,113,66,179,0.000333,0.323767,16,15540.82226,863.379014,971.301391,191.698301,6,6
0,0,18,18,17,26,43,114,67,181,0.000333,0.327385,16,15714.46273,873.025707,982.153921,191.698301,6,6
0,0,18,18,17,26,43,113,66,179,0.000333,0.323767,16,15540.82226,863.379014,971.301391,191.698301,6,6
0,0,18,18,17,26,43,114,67,181,0.000333,0.327385,16,15714.46273,873.025707,982.153921,191.698301,6,6
0,0,18,18,17,26,43,113,66,179,0.000333,0.323767,16,15540.82226,863.379014,971.301391,191.698301,6,6
0,0,18,18,17,26,43,114,67,181,0.000333,0.327385,16,15714.46273,873.025707,982.153921,191.698301,6,6
0,0,30,30,16,28,44,179,111,290,0.000333,0.527745,24,37997.64407,2110.980226,1583.235169,198.605938,14,6
0,0,29,29,16,28,44,173,108,281,0.000333,0.511367,24,36818.40684,2045.467046,1534.100285,198.605938,13,6
0,0,28,28,16,28,44,167,105,272,0.000333,0.494988,24,35639.16961,1979.953867,1484.9654,198.605938,12,6
0,0,30,30,17,30,47,182,112,294,0.000333,0.54435,24,39193.17894,2177.39883,1633.049122,216.693586,13,6
0,0,12,12,14,20,34,52,41,93,0.000333,0.157711,14,6623.876619,367.993146,473.134044,139.741531,3,6
0,0,12,12,14,20,34,52,41,93,0.000333,0.157711,14,6623.876619,367.993146,473.134044,139.741531,3,6
0,0,12,12,14,20,34,52,41,93,0.000333,0.157711,14,6623.876619,367.993146,473.134044,139.741531,3,6
0,0,16,16,14,22,36,70,53,123,0.000333,0.211967,14,8902.610852,494.589492,635.900775,151.410465,3,6
0,0,17,17,13,23,36,65,56,121,0.000333,0.20852,12,7506.731102,417.040617,625.560925,152.147641,3,6
0,0,20,20,15,25,40,78,64,142,0.000333,0.251905,14,10579.99305,587.777392,755.713789,174.699764,4,6
0,0,10,10,13,18,31,42,32,74,0.000333,0.122204,6,2199.663162,122.203509,366.610527,123.164366,2,6
0,0,4,4,9,11,20,13,17,30,0.000333,0.043219,4,518.631371,28.812854,129.657843,66.583073,1,6
0,0,29,29,19,51,70,155,111,266,0.000333,0.543463,18,29347.00709,1630.389283,1630.389283,370.004315,9,6
0,0,10,10,14,21,35,39,35,74,0.000333,0.126522,7,2656.968603,147.609367,379.566943,145.541635,3,6
0,0,11,11,14,21,35,40,37,77,0.000333,0.131652,7,2764.683546,153.59353,394.954792,145.541635,3,6
0,0,18,18,15,21,36,72,63,135,0.000333,0.232647,21,14656.73738,814.263188,697.939875,150.842025,2,6
0,0,21,21,19,23,42,85,71,156,0.000333,0.280401,27,22712.44099,1261.802277,841.201518,184.752548,3,6
0,0,19,19,16,21,37,76,64,140,0.000333,0.243108,24,17503.76331,972.431295,729.323471,156.238666,2,6
0,0,7,7,10,14,24,32,30,62,0.000333,0.094756,10,2842.67675,157.926486,284.267675,86.52225,1,6
0,0,9,9,14,17,31,40,35,75,0.000333,0.123855,14,5201.906126,288.994785,371.564723,122.789837,2,6
0,0,18,18,15,22,37,69,51,120,0.000333,0.208378,14,8751.881654,486.215647,625.134404,156.710855,6,6
0,0,19,19,15,22,37,70,53,123,0.000333,0.213588,14,8970.678696,498.371039,640.762764,156.710855,6,6
0,0,18,18,17,23,40,71,62,133,0.000333,0.235939,16,11325.06299,629.170166,707.816437,173.528793,4,6
0,0,10,10,12,20,32,36,30,66,0.000333,0.11,6,1980,110,330,129.458112,4,6
0,0,11,11,12,20,32,37,32,69,0.000333,0.115,6,2070,115,345,129.458112,4,6
0,0,24,24,18,44,62,105,80,185,0.000333,0.367175,9,9913.736857,550.763159,1101.526317,315.273641,8,6
0,0,23,23,18,44,62,104,78,182,0.000333,0.361221,9,9752.973556,541.831864,1083.663728,315.273641,8,6
0,0,12,12,14,21,35,41,33,74,0.000333,0.126522,7,2656.968603,147.609367,379.566943,145.541635,4,6
0,0,13,13,14,21,35,42,35,77,0.000333,0.131652,7,2764.683546,153.59353,394.954792,145.541635,4,6
0,0,13,13,11,18,29,63,44,107,0.000333,0.173268,10,5198.039665,288.779981,519.803966,113.112398,2,6
0,0,16,16,14,21,35,76,52,128,0.000333,0.218849,14,9191.675166,510.64862,656.548226,145.541635,3,6
0,0,10,10,14,16,30,46,33,79,0.000333,0.129215,14,5427.020999,301.501167,387.644357,117.302969,2,6
0,0,30,30,20,50,70,130,113,243,0.000333,0.496472,20,29788.31546,1654.906415,1489.415773,368.631371,10,6
0,0,19,19,14,20,34,76,67,143,0.000333,0.242502,21,15277.65091,848.758384,727.507186,139.741531,2,6
0,0,9,9,13,15,28,37,29,66,0.000333,0.105762,6,1903.712549,105.761808,317.285425,106.709075,2,6
0,0,28,28,19,49,68,122,92,214,0.000333,0.434239,9,11724.45343,651.358524,1302.717048,355.831405,11,6
0,0,27,27,19,49,68,121,90,211,0.000333,0.428152,9,11560.09194,642.22733,1284.45466,355.831405,11,6
0,0,28,28,20,49,69,126,91,217,0.000333,0.44185,10,13255.49807,736.41656,1325.549807,361.559344,12,6
0,0,27,27,19,50,69,121,90,211,0.000333,0.429633,9,11600.08794,644.44933,1288.89866,362.903432,11,6
0,0,26,26,19,50,69,120,88,208,0.000333,0.423524,9,11435.15778,635.286544,1270.573087,362.903432,11,6
0,0,28,28,20,50,70,126,93,219,0.000333,0.447438,10,13423.12981,745.729434,1342.312981,368.631371,12,6
0,0,27,27,19,51,70,121,91,212,0.000333,0.433136,9,11694.672,649.704,1299.408,370.004315,11,6
0,0,26,26,19,51,70,120,89,209,0.000333,0.427007,9,11529.18136,640.510075,1281.020151,370.004315,11,6
0,0,28,28,20,49,69,126,91,217,0.000333,0.44185,10,13255.49807,736.41656,1325.549807,361.559344,12,6
0,0,27,27,19,50,69,121,90,211,0.000333,0.429633,9,11600.08794,644.44933,1288.89866,362.903432,11,6
0,0,26,26,19,50,69,120,88,208,0.000333,0.423524,9,11435.15778,635.286544,1270.573087,362.903432,11,6
0,0,33,33,20,50,70,140,103,243,0.000333,0.496472,20,29788.31546,1654.906415,1489.415773,368.631371,11,6
0,0,36,36,22,53,75,153,111,264,0.000333,0.548136,22,36176.97895,2009.832164,1644.408134,401.68728,12,6
0,0,10,10,13,16,29,39,30,69,0.000333,0.111734,6,2011.204132,111.733563,335.200689,112.105716,2,6
0,0,29,29,22,52,74,129,92,221,0.000333,0.45743,11,15095.18113,838.621174,1372.289194,394.530361,12,6
0,0,28,28,22,52,74,128,90,218,0.000333,0.45122,11,14890.26917,827.237176,1353.660834,394.530361,12,6
0,0,7,7,11,14,25,22,20,42,0.000333,0.065014,5,975.2098,54.178322,195.04196,91.356717,3,6
0,0,16,16,13,19,32,66,55,121,0.000333,0.201667,12,7260,403.333333,605,128.816339,2,6
0,0,18,18,16,21,37,74,60,134,0.000333,0.232689,16,11169.06802,620.503779,698.066751,156.238666,3,6
0,0,18,18,14,24,38,69,66,135,0.000333,0.236157,14,9918.583,551.032389,708.470214,163.342069,2,6
0,0,20,20,18,26,44,77,71,148,0.000333,0.269332,18,14543.92583,807.99588,807.99588,197.270083,3,6
0,0,17,17,13,21,34,67,65,132,0.000333,0.223848,18,12087.81171,671.545095,671.545095,140.344382,2,6
0,0,19,19,17,23,40,75,70,145,0.000333,0.257227,24,18520.30977,1028.906098,771.679574,173.528793,3,6
0,0,15,15,16,22,38,71,53,124,0.000333,0.216914,16,10411.88819,578.438233,650.743012,162.107496,6,6
0,0,15,15,16,22,38,71,53,124,0.000333,0.216914,16,10411.88819,578.438233,650.743012,162.107496,6,6
0,0,16,16,12,18,30,55,60,115,0.000333,0.188097,18,10157.26353,564.292418,564.292418,118.0782,2,6
0,0,18,18,16,21,37,63,65,128,0.000333,0.22227,24,16003.44074,889.080041,666.810031,156.238666,3,6
0,0,9,9,12,15,27,36,35,71,0.000333,0.112532,12,4051.164152,225.064675,337.597013,101.622909,2,6
0,0,11,11,16,18,34,44,40,84,0.000333,0.142449,16,6837.550059,379.863892,427.346879,139.05865,3,6
0,0,18,18,13,20,33,70,67,137,0.000333,0.230361,18,12439.4759,691.081994,691.081994,134.544278,2,6
0,0,20,20,17,23,40,78,72,150,0.000333,0.266096,24,19158.94114,1064.385619,798.289214,173.528793,3,6
0,0,12,12,10,17,27,54,42,96,0.000333,0.152156,10,4564.692002,253.594,456.4692,102.706149,1,6
0,0,15,15,14,19,33,67,50,117,0.000333,0.196731,14,8262.717568,459.039865,590.194112,134.013592,2,6
0,0,9,9,13,16,29,37,30,67,0.000333,0.108495,6,1952.90836,108.494909,325.484727,112.105716,2,6
0,0,13,13,11,18,29,57,43,100,0.000333,0.161933,10,4857.980995,269.887833,485.7981,113.112398,2,6
0,0,16,16,15,20,35,70,51,121,0.000333,0.206881,14,8689.005431,482.722524,620.643245,145.041921,3,6
0,0,9,9,13,16,29,37,30,67,0.000333,0.108495,6,1952.90836,108.494909,325.484727,112.105716,2,6
0,0,15,15,11,19,30,55,55,110,0.000333,0.179919,10,5397.579655,299.865536,539.757966,118.764371,2,6
0,0,17,17,14,22,36,63,60,123,0.000333,0.211967,14,8902.610852,494.589492,635.900775,151.410465,3,6
0,0,14,14,14,22,36,52,48,100,0.000333,0.172331,14,7237.895002,402.105278,516.9925,151.410465,3,6
0,0,11,11,9,15,24,43,37,80,0.000333,0.122266,8,2934.376,163.020889,366.797,87.132684,1,6
0,0,14,14,13,18,31,56,45,101,0.000333,0.166791,12,6004.485928,333.582552,500.373827,123.164366,2,6
0,0,9,9,13,16,29,37,30,67,0.000333,0.108495,6,1952.90836,108.494909,325.484727,112.105716,2,6
0,0,11,11,13,17,30,39,32,71,0.000333,0.11613,6,2090.335394,116.129744,348.389232,117.592585,2,6
0,0,10,10,13,17,30,37,30,67,0.000333,0.109587,6,1972.570019,109.587223,328.76167,117.592585,2,6
0,0,12,12,10,17,27,46,39,85,0.000333,0.134722,10,4041.654377,224.536354,404.165438,102.706149,2,6
0,0,15,15,13,20,33,59,47,106,0.000333,0.178235,12,6416.46932,356.470518,534.705777,134.544278,3,6
0,0,9,9,13,16,29,37,30,67,0.000333,0.108495,6,1952.90836,108.494909,325.484727,112.105716,2,6
0,0,12,12,13,19,32,42,34,76,0.000333,0.126667,6,2280,126.666667,380,128.816339,3,6
0,0,10,10,13,17,30,37,30,67,0.000333,0.109587,6,1972.570019,109.587223,328.76167,117.592585,2,6
0,0,15,15,14,20,34,63,53,116,0.000333,0.196715,14,8262.039654,459.002203,590.14569,139.741531,3,6
0,0,15,15,14,20,34,63,53,116,0.000333,0.196715,14,8262.039654,459.002203,590.14569,139.741531,3,6
0,0,18,18,10,21,31,75,69,144,0.000333,0.237801,15,10701.06403,594.503557,713.404269,125.457947,1,6
0,0,20,20,14,23,37,83,74,157,0.000333,0.272628,21,17175.56775,954.198208,817.884178,157.344894,2,6
0,0,7,7,8,18,26,23,25,48,0.000333,0.075207,4,902.484426,50.138024,225.621106,99.05865,2,6
0,0,10,10,12,21,33,35,34,69,0.000333,0.116021,6,2088.379165,116.021065,348.063194,135.258216,3,6
0,0,7,7,8,17,25,23,24,47,0.000333,0.072754,4,873.044964,48.502498,218.261241,93.486868,2,6
0,0,10,10,12,20,32,35,33,68,0.000333,0.113333,6,2040,113.333333,340,129.458112,3,6
0,0,3,3,11,11,22,15,15,30,0.000333,0.044594,5,668.914743,37.16193,133.782949,76.107496,1,6
0,0,16,16,13,17,30,51,66,117,0.000333,0.191369,18,10333.91159,574.1062,574.1062,117.592585,3,6
0,0,16,16,13,19,32,49,65,114,0.000333,0.19,18,10260,570,570,128.816339,2,6
0,0,9,9,11,20,31,32,29,61,0.000333,0.100735,5,1511.029875,83.946104,302.205975,124.49231,3,6
0,0,10,10,11,20,31,33,31,64,0.000333,0.10569,5,1585.342819,88.074601,317.068564,124.49231,3,6
0,0,14,14,13,18,31,60,44,104,0.000333,0.171745,12,6182.836995,343.490944,515.236416,123.164366,2,6
0,0,17,17,16,21,37,73,52,125,0.000333,0.217061,16,10418.90673,578.828152,651.181671,156.238666,3,6
0,0,9,9,13,16,29,37,30,67,0.000333,0.108495,6,1952.90836,108.494909,325.484727,112.105716,2,6
0,0,47,47,25,55,80,174,138,312,0.000333,0.657481,24,47338.59758,2629.922087,1972.441566,434.071189,13,6
0,0,18,18,16,24,40,87,58,145,0.000333,0.257227,16,12346.87318,685.937399,771.679574,174.0391,6,6
0,0,18,18,16,24,40,87,58,145,0.000333,0.257227,16,12346.87318,685.937399,771.679574,174.0391,6,6
0,0,12,12,17,23,40,45,46,91,0.000333,0.161432,16,7748.727306,430.48485,484.295457,173.528793,3,6
0,0,22,22,16,22,38,104,70,174,0.000333,0.30438,24,21915.3453,1217.519183,913.139387,162.107496,3,6
0,0,25,25,18,24,42,117,78,195,0.000333,0.350501,27,28390.55123,1577.252846,1051.501897,185.09775,4,6
0,0,10,10,13,15,28,41,31,72,0.000333,0.115377,12,4153.554653,230.753036,346.129554,106.709075,2,6
0,0,18,18,15,20,35,74,54,128,0.000333,0.218849,14,9191.675166,510.64862,656.548226,145.041921,3,6
0,0,21,21,18,22,40,87,62,149,0.000333,0.264322,18,14273.41115,792.967286,792.967286,173.166146,4,6
0,0,10,10,13,15,28,41,31,72,0.000333,0.115377,12,4153.554653,230.753036,346.129554,106.709075,2,6
0,0,13,13,11,18,29,63,44,107,0.000333,0.173268,10,5198.039665,288.779981,519.803966,113.112398,2,6
0,0,16,16,14,21,35,76,52,128,0.000333,0.218849,14,9191.675166,510.64862,656.548226,145.541635,3,6
0,0,10,10,14,16,30,46,33,79,0.000333,0.129215,14,5427.020999,301.501167,387.644357,117.302969,2,6
0,0,18,18,9,19,28,59,74,133,0.000333,0.213126,12,7672.538456,426.252136,639.378205,109.239948,1,6
0,0,20,20,13,22,35,67,79,146,0.000333,0.249625,18,13479.75577,748.87532,748.87532,146.213212,2,6
0,0,15,15,11,22,33,58,44,102,0.000333,0.171509,10,5145.282002,285.849,514.5282,136.161243,4,6
0,0,18,18,14,24,38,71,52,123,0.000333,0.215165,14,9036.931178,502.051732,645.495084,163.342069,5,6
0,0,10,10,13,16,29,39,30,69,0.000333,0.111734,6,2011.204132,111.733563,335.200689,112.105716,2,6
0,0,12,12,13,21,34,50,35,85,0.000333,0.144145,6,2594.606049,144.144781,432.434342,140.344382,5,6
0,0,13,13,13,21,34,51,37,88,0.000333,0.149232,6,2686.18038,149.232243,447.69673,140.344382,5,6
0,0,18,18,13,25,38,70,51,121,0.000333,0.211666,12,7619.99075,423.332819,634.999229,164.202121,4,6
0,0,21,21,15,27,42,83,59,142,0.000333,0.255236,14,10719.92704,595.551502,765.709074,186.985321,5,6
0,0,10,10,13,16,29,39,30,69,0.000333,0.111734,6,2011.204132,111.733563,335.200689,112.105716,2,6
0,0,14,14,14,24,38,59,39,98,0.000333,0.171432,7,3600.078274,200.004349,514.296896,163.342069,5,6
0,0,15,15,14,24,38,60,41,101,0.000333,0.17668,7,3710.284752,206.126931,530.040679,163.342069,5,6
0,0,24,24,19,44,63,106,81,187,0.000333,0.372584,9,10059.76211,558.875673,1117.751346,320.925614,8,6
0,0,23,23,19,44,63,105,79,184,0.000333,0.366607,9,9898.375553,549.909753,1099.819506,320.925614,8,6
0,0,15,15,11,22,33,58,44,102,0.000333,0.171509,10,5145.282002,285.849,514.5282,136.161243,4,6
0,0,18,18,14,24,38,71,52,123,0.000333,0.215165,14,9036.931178,502.051732,645.495084,163.342069,5,6
0,0,10,10,13,16,29,39,30,69,0.000333,0.111734,6,2011.204132,111.733563,335.200689,112.105716,2,6
0,0,12,12,13,21,34,50,35,85,0.000333,0.144145,6,2594.606049,144.144781,432.434342,140.344382,5,6
0,0,13,13,13,21,34,51,37,88,0.000333,0.149232,6,2686.18038,149.232243,447.69673,140.344382,5,6
0,0,15,15,11,23,34,58,45,103,0.000333,0.17467,5,2620.043363,145.557965,524.008673,142.095673,4,6
0,0,18,18,14,25,39,71,53,124,0.000333,0.218463,14,9175.458252,509.747681,655.389875,169.399374,5,6
0,0,10,10,13,16,29,39,30,69,0.000333,0.111734,6,2011.204132,111.733563,335.200689,112.105716,2,6
0,0,12,12,13,22,35,50,36,86,0.000333,0.147039,6,2646.710037,147.039446,441.118339,146.213212,5,6
0,0,13,13,13,22,35,51,38,89,0.000333,0.152169,6,2739.037131,152.16873,456.506189,146.213212,5,6
0,0,15,15,11,23,34,58,45,103,0.000333,0.17467,5,2620.043363,145.557965,524.008673,142.095673,4,6
0,0,18,18,14,25,39,71,53,124,0.000333,0.218463,14,9175.458252,509.747681,655.389875,169.399374,5,6
0,0,10,10,13,16,29,39,30,69,0.000333,0.111734,6,2011.204132,111.733563,335.200689,112.105716,2,6
0,0,12,12,13,22,35,50,36,86,0.000333,0.147039,6,2646.710037,147.039446,441.118339,146.213212,5,6
0,0,13,13,13,22,35,51,38,89,0.000333,0.152169,6,2739.037131,152.16873,456.506189,146.213212,5,6
0,0,17,17,14,19,33,70,57,127,0.000333,0.213546,21,13453.39912,747.411062,640.638053,134.013592,2,6
0,0,9,9,13,15,28,37,29,66,0.000333,0.105762,6,1903.712549,105.761808,317.285425,106.709075,2,6
0,0,11,11,13,17,30,46,37,83,0.000333,0.135757,12,4887.263033,271.514613,407.271919,117.592585,2,6
0,0,14,14,17,20,37,59,45,104,0.000333,0.180594,16,8668.5304,481.585022,541.78315,155.92543,3,6
0,0,28,28,20,49,69,126,91,217,0.000333,0.44185,10,13255.49807,736.41656,1325.549807,361.559344,12,6
0,0,27,27,19,51,70,121,90,211,0.000333,0.431093,9,11639.50845,646.639358,1293.278717,370.004315,11,6
0,0,26,26,19,51,70,120,88,208,0.000333,0.424964,9,11474.01781,637.445434,1274.890868,370.004315,11,6
0,0,28,28,20,50,70,126,93,219,0.000333,0.447438,10,13423.12981,745.729434,1342.312981,368.631371,12,6
0,0,27,27,19,52,71,121,91,212,0.000333,0.434582,9,11733.7175,651.873195,1303.746389,377.133488,11,6
0,0,26,26,19,52,71,120,89,209,0.000333,0.428432,9,11567.67433,642.648574,1285.297148,377.133488,11,6
0,0,19,19,13,21,34,80,70,150,0.000333,0.254373,18,13736.14967,763.119426,763.119426,140.344382,2,6
0,0,22,22,17,23,40,93,78,171,0.000333,0.30335,24,21841.1929,1213.399606,910.049704,173.528793,3,6
0,0,12,12,16,18,34,56,41,97,0.000333,0.164495,16,7895.74233,438.652352,493.483896,139.05865,3,6
0,0,21,21,13,22,35,86,80,166,0.000333,0.28382,18,15326.29766,851.460981,851.460981,146.213212,2,6
0,0,24,24,17,24,41,99,88,187,0.000333,0.333954,24,24044.6934,1335.8163,1001.862225,179.525968,3,6
0,0,12,12,16,18,34,56,41,97,0.000333,0.164495,16,7895.74233,438.652352,493.483896,139.05865,3,6
0,0,36,36,19,51,70,147,122,269,0.000333,0.549592,18,29677.98837,1648.777132,1648.777132,370.004315,10,6
0,0,39,39,21,54,75,160,130,290,0.000333,0.602119,20,36127.14841,2007.0638,1806.35742,403.002591,11,6
0,0,10,10,13,17,30,41,32,73,0.000333,0.119401,6,2149.218081,119.401004,358.203013,117.592585,2,6
0,0,35,35,20,50,70,145,114,259,0.000333,0.529161,20,31749.68603,1763.871446,1587.484301,368.631371,10,6
0,0,38,38,22,53,75,158,122,280,0.000333,0.581356,22,38369.52313,2131.640174,1744.069233,401.68728,11,6
0,0,10,10,13,16,29,39,30,69,0.000333,0.111734,6,2011.204132,111.733563,335.200689,112.105716,2,6
0,0,35,35,19,51,70,147,115,262,0.000333,0.535291,18,28905.69871,1605.87215,1605.87215,370.004315,10,6
0,0,38,38,21,54,75,160,123,283,0.000333,0.587585,20,35255.11379,1958.617433,1762.755689,403.002591,11,6
0,0,10,10,13,18,31,42,32,74,0.000333,0.122204,6,2199.663162,122.203509,366.610527,123.164366,2,6
0,0,9,9,10,14,24,36,29,65,0.000333,0.099341,10,2980.225625,165.56809,298.022563,86.52225,2,6
0,0,12,12,14,17,31,49,37,86,0.000333,0.14202,14,5964.852358,331.380687,426.060883,122.789837,3,6
0,0,10,10,13,17,30,41,32,73,0.000333,0.119401,6,2149.218081,119.401004,358.203013,117.592585,2,6
0,0,37,37,19,53,72,149,125,274,0.000333,0.56352,18,30430.07011,1690.55945,1690.55945,384.290407,10,6
0,0,40,40,21,56,77,162,133,295,0.000333,0.616234,20,36974.04059,2054.113366,1848.70203,417.450542,11,6
0,0,10,10,13,18,31,41,34,75,0.000333,0.123855,6,2229.38834,123.854908,371.564723,123.164366,2,6
0,0,8,8,11,15,26,33,31,64,0.000333,0.100276,10,3008.28142,167.126746,300.828142,96.657107,1,6
0,0,10,10,15,18,33,41,36,77,0.000333,0.129473,14,5437.856861,302.103159,388.418347,133.662009,2,6
0,0,13,13,10,17,27,50,60,110,0.000333,0.174346,15,7845.564379,435.864688,523.037625,102.706149,1,6
0,0,15,15,14,20,34,58,65,123,0.000333,0.208586,21,13140.91652,730.050918,625.757929,139.741531,2,6
0,0,17,17,11,20,31,73,69,142,0.000333,0.234499,15,10552.43814,586.246563,703.495876,124.49231,1,6
0,0,19,19,15,23,38,81,74,155,0.000333,0.271143,21,17082.00406,949.000225,813.428765,162.645284,2,6
0,0,19,19,15,22,37,78,69,147,0.000333,0.255263,21,16081.58254,893.421252,765.789645,156.710855,2,6
0,0,9,9,13,16,29,33,32,65,0.000333,0.105256,12,3789.225176,210.51251,315.768765,112.105716,2,6
0,0,18,18,15,21,36,69,65,134,0.000333,0.230923,21,14548.16895,808.231609,692.76995,150.842025,2,6
0,0,9,9,10,16,26,29,30,59,0.000333,0.092442,5,1386.629717,77.034984,277.325943,97.219281,1,6
0,0,16,16,14,25,39,61,55,116,0.000333,0.204369,14,8583.493203,476.860734,613.106657,169.399374,2,6
0,0,19,19,16,27,43,74,63,137,0.000333,0.247799,16,11894.37234,660.798463,743.398271,192.381963,3,6
0,0,16,16,16,25,41,64,55,119,0.000333,0.212516,16,10200.77902,566.709945,637.548689,180.096405,2,6
0,0,17,17,14,24,38,76,60,136,0.000333,0.237906,14,9992.053986,555.11411,713.718142,163.342069,4,6
0,0,3,3,9,10,19,13,14,27,0.000333,0.038231,4,458.776171,25.487565,114.694043,61.748606,1,6
0,0,16,16,14,23,37,67,56,123,0.000333,0.213588,14,8970.678696,498.371039,640.762764,157.344894,4,6
0,0,16,16,14,22,36,65,55,120,0.000333,0.206797,14,8685.474002,482.526333,620.391,151.410465,4,6
0,0,12,12,13,19,32,50,45,95,0.000333,0.158333,12,5700,316.666667,475,128.816339,3,6
0,0,28,28,19,50,69,122,93,215,0.000333,0.437778,9,11819.99482,656.666379,1313.332758,362.903432,11,6
0,0,27,27,19,50,69,121,91,212,0.000333,0.431669,9,11655.06466,647.503592,1295.007185,362.903432,11,6
0,0,13,13,13,20,33,50,44,94,0.000333,0.158058,12,5690.076567,316.115365,474.173047,134.544278,2,6
0,0,15,15,12,19,31,51,48,99,0.000333,0.163488,12,5885.585217,326.976956,490.465435,123.730173,2,6
0,0,18,18,14,22,36,63,57,120,0.000333,0.206797,14,8685.474002,482.526333,620.391,151.410465,3,6
0,0,14,14,14,21,35,46,39,85,0.000333,0.14533,7,3051.923395,169.5513,435.989056,145.541635,3,6
0,0,14,14,14,22,36,47,40,87,0.000333,0.149928,7,3148.484326,174.915796,449.783475,151.410465,3,6
0,0,12,12,10,17,27,40,42,82,0.000333,0.129967,10,3899.007752,216.611542,389.900775,102.706149,2,6
0,0,15,15,13,20,33,52,51,103,0.000333,0.173191,12,6234.871132,346.38173,519.572594,134.544278,3,6
0,0,12,12,13,19,32,38,36,74,0.000333,0.123333,6,2220,123.333333,370,128.816339,3,6
0,0,12,12,10,17,27,40,42,82,0.000333,0.129967,10,3899.007752,216.611542,389.900775,102.706149,2,6
0,0,15,15,13,20,33,52,51,103,0.000333,0.173191,12,6234.871132,346.38173,519.572594,134.544278,3,6
0,0,12,12,13,19,32,38,36,74,0.000333,0.123333,6,2220,123.333333,370,128.816339,3,6
0,0,12,12,10,18,28,40,43,83,0.000333,0.133003,10,3990.104585,221.672477,399.010459,108.277931,2,6
0,0,15,15,13,21,34,52,52,104,0.000333,0.176365,12,6349.153626,352.730757,529.096135,140.344382,3,6
0,0,12,12,13,20,33,38,37,75,0.000333,0.12611,6,2269.977354,126.109853,378.329559,134.544278,3,6
0,0,16,16,13,20,33,60,53,113,0.000333,0.190006,12,6840.198426,380.011024,570.016535,134.544278,2,6
0,0,18,18,16,22,38,68,58,126,0.000333,0.220413,16,10579.82187,587.767882,661.238867,162.107496,3,6
0,0,20,20,14,20,34,86,72,158,0.000333,0.26794,21,16880.20171,937.788984,803.819129,139.741531,2,6
0,0,10,10,14,15,29,47,34,81,0.000333,0.131165,14,5508.950448,306.052803,393.496461,111.906328,2,6
0,0,16,16,9,18,27,64,57,121,0.000333,0.19178,12,6904.096653,383.560925,575.341388,103.587975,1,6
0,0,19,19,13,21,34,77,65,142,0.000333,0.240807,18,13003.55502,722.419723,722.419723,140.344382,2,6
0,0,9,9,13,17,30,42,32,74,0.000333,0.121037,6,2178.659424,121.036635,363.109904,117.592585,2,6
0,0,14,14,10,17,27,55,50,105,0.000333,0.166421,10,4992.631877,277.368438,499.263188,102.706149,1,6
0,0,17,17,14,20,34,68,58,126,0.000333,0.213673,14,8974.284452,498.571358,641.020318,139.741531,2,6
0,0,9,9,13,17,30,41,32,73,0.000333,0.119401,6,2149.218081,119.401004,358.203013,117.592585,2,6
0,0,18,18,15,22,37,81,69,150,0.000333,0.260473,21,16409.7781,911.654339,781.418005,156.710855,2,6
0,0,15,15,14,19,33,56,64,120,0.000333,0.201776,21,12711.87318,706.215177,605.327294,134.013592,2,6
0,0,17,17,15,21,36,72,65,137,0.000333,0.236093,21,14873.87423,826.326346,708.279725,150.842025,2,6
0,0,20,20,14,22,36,78,82,160,0.000333,0.275729,21,17370.94801,965.052667,827.188,151.410465,2,6
0,0,10,10,15,17,32,39,35,74,0.000333,0.123333,14,5180,287.777778,370,128.090227,2,6
0,0,28,28,20,45,65,135,92,227,0.000333,0.455692,20,27341.54987,1518.974993,1367.077494,333.571951,9,6
0,0,15,15,14,21,35,74,49,123,0.000333,0.210301,14,8832.625355,490.701409,630.901811,145.541635,5,6
0,0,32,32,22,54,76,160,115,275,0.000333,0.572727,22,37799.96146,2099.997859,1718.180066,408.871421,9,6
0,0,35,35,24,56,80,173,123,296,0.000333,0.623764,24,44910.97719,2495.054288,1871.290716,435.250976,10,6
0,0,25,25,20,30,50,116,79,195,0.000333,0.366851,20,22011.03914,1222.835508,1100.551957,233.64528,6,6
0,0,27,27,19,50,69,118,91,209,0.000333,0.425561,9,11490.1345,638.340806,1276.681611,362.903432,10,6
0,0,26,26,19,50,69,117,89,206,0.000333,0.419452,9,11325.20434,629.178019,1258.356038,362.903432,10,6
0,0,19,19,16,24,40,89,59,148,0.000333,0.262548,16,12602.32573,700.129207,787.645358,174.0391,5,6
0,0,21,21,17,24,41,97,65,162,0.000333,0.289308,16,13886.7748,771.487489,867.923425,179.525968,5,6
0,0,7,7,12,13,25,36,27,63,0.000333,0.097521,12,3510.755279,195.04196,292.56294,91.125266,1,6
0,0,10,10,15,16,31,49,35,84,0.000333,0.138717,14,5826.134861,323.674159,416.15249,122.603359,2,6
0,0,7,7,9,14,23,28,29,57,0.000333,0.085948,8,2062.744252,114.596903,257.843031,81.832294,1,6
0,0,9,9,13,17,30,36,34,70,0.000333,0.114494,12,4121.7881,228.988228,343.482342,117.592585,2,6
0,0,15,15,14,19,33,56,64,120,0.000333,0.201776,21,12711.87318,706.215177,605.327294,134.013592,2,6
0,0,17,17,15,21,36,72,65,137,0.000333,0.236093,21,14873.87423,826.326346,708.279725,150.842025,2,6
0,0,14,14,9,17,26,47,54,101,0.000333,0.158248,12,5696.932938,316.496274,474.744412,98.016193,1,6
0,0,16,16,13,20,33,55,59,114,0.000333,0.191687,12,6900.731155,383.373953,575.06093,134.544278,2,6
0,0,13,13,9,17,26,46,59,105,0.000333,0.164515,12,5922.554045,329.03078,493.54617,98.016193,1,6
0,0,15,15,13,20,33,54,64,118,0.000333,0.198413,18,10714.29311,595.238506,595.238506,134.544278,2,6
0,0,16,16,11,18,29,64,61,125,0.000333,0.202416,15,9108.714366,506.039687,607.247624,113.112398,1,6
0,0,18,18,15,20,35,72,66,138,0.000333,0.235947,21,14864.66218,825.814566,707.841056,145.041921,2,6
0,0,14,14,11,18,29,55,50,105,0.000333,0.170029,10,5100.880045,283.382225,510.088004,113.112398,2,6
0,0,16,16,14,20,34,63,55,118,0.000333,0.200107,14,8404.488614,466.916034,600.320615,139.741531,3,6
0,0,9,9,10,14,24,36,29,65,0.000333,0.099341,10,2980.225625,165.56809,298.022563,86.52225,2,6
0,0,12,12,14,17,31,49,37,86,0.000333,0.14202,14,5964.852358,331.380687,426.060883,122.789837,3,6
0,0,10,10,13,17,30,41,32,73,0.000333,0.119401,6,2149.218081,119.401004,358.203013,117.592585,2,6
0,0,22,22,16,30,46,83,83,166,0.000333,0.305637,16,14670.58056,815.032253,916.911285,211.206718,4,6
0,0,25,25,18,32,50,96,91,187,0.000333,0.3518,18,18997.21994,1055.401107,1055.401107,235.05865,5,6
0,0,12,12,16,17,33,53,40,93,0.000333,0.156376,16,7506.05845,417.003247,469.128653,133.486868,3,6
0,0,10,10,13,15,28,44,33,77,0.000333,0.123389,12,4441.995948,246.777553,370.166329,106.709075,2,6
0,0,17,17,10,19,29,70,70,140,0.000333,0.226706,15,10201.76009,566.764449,680.117339,113.929904,1,6
0,0,20,20,14,22,36,83,78,161,0.000333,0.277453,21,17479.51643,971.084246,832.357925,151.410465,2,6
0,0,9,9,13,16,29,40,32,72,0.000333,0.116592,12,4197.29558,233.183088,349.774632,112.105716,2,6
0,0,13,13,10,17,27,58,46,104,0.000333,0.164836,10,4945.083002,274.726833,494.5083,102.706149,1,6
0,0,16,16,14,20,34,71,54,125,0.000333,0.211978,14,8903.059972,494.614443,635.932855,139.741531,2,6
0,0,9,9,13,16,29,37,30,67,0.000333,0.108495,6,1952.90836,108.494909,325.484727,112.105716,2,6
0,0,9,9,11,14,25,27,34,61,0.000333,0.094425,10,2832.752276,157.375126,283.275228,91.356717,3,6
0,0,8,8,11,13,24,23,24,47,0.000333,0.071831,5,1077.466188,59.859233,215.493238,86.159464,2,6
0,0,16,16,13,19,32,52,57,109,0.000333,0.181667,18,9810,545,545,128.816339,2,6
0,0,13,13,13,19,32,41,45,86,0.000333,0.143333,12,5160,286.666667,430,128.816339,2,6
0,0,18,18,14,19,33,80,58,138,0.000333,0.232042,21,14618.65416,812.147453,696.126388,134.013592,2,6
0,0,10,10,14,15,29,44,32,76,0.000333,0.123069,14,5168.891779,287.160654,369.206556,111.906328,2,6
0,0,23,23,16,27,43,86,64,150,0.000333,0.271313,16,13023.03541,723.501967,813.939713,192.381963,6,6
0,0,26,26,18,29,47,99,72,171,0.000333,0.316612,18,17097.02449,949.834694,949.834694,215.940099,7,6
0,0,16,16,17,25,42,71,55,126,0.000333,0.226477,16,10870.91192,603.939551,679.431995,185.583273,4,6
0,0,19,19,15,28,43,76,60,136,0.000333,0.245991,14,10331.60809,573.978227,737.972007,193.209297,6,6
0,0,22,22,17,30,47,89,68,157,0.000333,0.29069,16,13953.1272,775.173733,872.07045,216.693586,7,6
0,0,16,16,17,25,42,71,55,126,0.000333,0.226477,16,10870.91192,603.939551,679.431995,185.583273,4,6
0,0,19,19,15,26,41,76,58,134,0.000333,0.239304,14,10050.76756,558.375976,717.911969,180.814792,6,6
0,0,22,22,17,28,45,89,66,155,0.000333,0.283746,16,13619.79568,756.655315,851.23723,204.092806,7,6
0,0,16,16,17,25,42,71,55,126,0.000333,0.226477,16,10870.91192,603.939551,679.431995,185.583273,4,6
0,0,17,17,15,26,41,70,56,126,0.000333,0.225017,14,9450.721736,525.040096,675.051553,180.814792,4,6
0,0,20,20,17,28,45,83,64,147,0.000333,0.269101,16,12916.83848,717.602138,807.302405,204.092806,5,6
0,0,16,16,17,25,42,71,55,126,0.000333,0.226477,16,10870.91192,603.939551,679.431995,185.583273,4,6
0,0,15,15,13,18,31,68,46,114,0.000333,0.188259,12,6777.340553,376.51892,564.778379,123.164366,2,6
0,0,18,18,16,21,37,81,54,135,0.000333,0.234425,16,11252.41927,625.134404,703.276204,156.238666,3,6
0,0,10,10,14,16,30,46,33,79,0.000333,0.129215,14,5427.020999,301.501167,387.644357,117.302969,2,6
0,0,13,13,11,17,28,63,43,106,0.000333,0.16986,10,5095.796217,283.09979,509.579622,107.540616,2,6
0,0,16,16,14,20,34,76,51,127,0.000333,0.215369,14,9045.508932,502.528274,646.107781,139.741531,3,6
0,0,10,10,14,16,30,46,33,79,0.000333,0.129215,14,5427.020999,301.501167,387.644357,117.302969,2,6
0,0,14,14,10,16,26,49,54,103,0.000333,0.161382,15,7262.179365,403.454409,484.145291,97.219281,1,6
0,0,16,16,14,19,33,57,59,116,0.000333,0.19505,21,12288.14408,682.674671,585.149718,134.013592,2,6
0,0,16,16,13,18,31,69,48,117,0.000333,0.193214,12,6955.69162,386.427312,579.640968,123.164366,2,6
0,0,19,19,16,20,36,82,56,138,0.000333,0.237817,16,11415.1944,634.177467,713.44965,150.438562,3,6
0,0,10,10,14,15,29,44,32,76,0.000333,0.123069,14,5168.891779,287.160654,369.206556,111.906328,2,6
0,0,15,15,14,20,34,58,51,109,0.000333,0.184844,14,7763.468296,431.303794,554.53345,139.741531,3,6
0,0,28,28,20,47,67,125,101,226,0.000333,0.456979,20,27418.72314,1523.262397,1370.936157,347.504238,8,6
0,0,10,10,10,14,24,32,52,84,0.000333,0.128379,15,5777.052751,320.947375,385.13685,86.52225,2,6
0,0,4,4,10,11,21,17,16,33,0.000333,0.048315,5,724.732375,40.26291,144.946475,71.273029,2,6
0,0,17,17,13,23,36,65,56,121,0.000333,0.20852,12,7506.731102,417.040617,625.560925,152.147641,3,6
0,0,20,20,15,25,40,78,64,142,0.000333,0.251905,14,10579.99305,587.777392,755.713789,174.699764,4,6
0,0,10,10,13,18,31,42,32,74,0.000333,0.122204,6,2199.663162,122.203509,366.610527,123.164366,2,6
0,0,8,8,12,16,28,30,23,53,0.000333,0.08493,6,1528.738865,84.929937,254.789811,107.01955,2,6
0,0,33,33,22,51,73,146,101,247,0.000333,0.509629,11,16817.75333,934.319629,1528.886666,387.401188,12,6
0,0,33,33,22,52,74,150,107,257,0.000333,0.531943,22,35108.24933,1950.458296,1595.829515,394.530361,13,6
0,0,32,32,22,52,74,149,105,254,0.000333,0.525734,22,34698.42541,1927.6903,1577.201155,394.530361,13,6
0,0,15,15,15,20,35,60,53,113,0.000333,0.193203,14,8114.525733,450.806985,579.608981,145.041921,3,6
0,0,15,15,11,19,30,62,60,122,0.000333,0.199547,15,8979.60979,498.867211,598.640653,118.764371,1,6
0,0,17,17,15,22,37,70,65,135,0.000333,0.234425,14,9845.866861,546.992603,703.276204,156.710855,2,6
0,0,9,9,15,15,30,36,29,65,0.000333,0.106316,7,2232.635221,124.03529,318.947889,117.206718,2,6
0,0,20,20,18,21,39,79,70,149,0.000333,0.262508,27,21263.17313,1181.287396,787.524931,167.297316,2,6
0,0,19,19,17,20,37,83,59,142,0.000333,0.246581,16,11835.87805,657.54878,739.742378,155.92543,4,6
0,0,10,10,13,15,28,41,31,72,0.000333,0.115377,12,4153.554653,230.753036,346.129554,106.709075,2,6
0,0,26,26,20,48,68,120,89,209,0.000333,0.424093,10,12722.79734,706.822074,1272.279734,354.516762,10,6
0,0,26,26,19,49,68,118,89,207,0.000333,0.420035,9,11340.94327,630.052404,1260.104808,355.831405,10,6
0,0,25,25,19,49,68,117,87,204,0.000333,0.413947,9,11176.58178,620.92121,1241.84242,355.831405,10,6
0,0,28,28,20,50,70,126,93,219,0.000333,0.447438,10,13423.12981,745.729434,1342.312981,368.631371,12,6
0,0,27,27,19,51,70,121,91,212,0.000333,0.433136,9,11694.672,649.704,1299.408,370.004315,11,6
0,0,26,26,19,51,70,120,89,209,0.000333,0.427007,9,11529.18136,640.510075,1281.020151,370.004315,11,6
0,0,16,16,14,21,35,65,56,121,0.000333,0.206881,14,8689.005431,482.722524,620.643245,145.541635,3,6
0,0,20,20,20,25,45,79,75,154,0.000333,0.281915,30,25372.36131,1409.575628,845.745377,202.534967,3,6
0,0,20,20,16,22,38,70,76,146,0.000333,0.255399,24,18388.73801,1021.596556,766.197417,162.107496,2,6
0,0,22,22,20,24,44,78,81,159,0.000333,0.28935,30,26041.48882,1446.749379,868.049627,196.477662,3,6
0,0,16,16,14,20,34,65,56,121,0.000333,0.205194,14,8618.162053,478.786781,615.583004,139.741531,3,6
0,0,6,6,11,15,26,26,27,53,0.000333,0.083041,5,1245.616525,69.200918,249.123305,96.657107,1,6
0,0,9,9,14,18,32,38,36,74,0.000333,0.123333,14,5180,287.777778,370,128.361619,2,6
0,0,12,12,11,17,28,49,45,94,0.000333,0.15063,10,4518.913627,251.050757,451.891363,107.540616,2,6
0,0,15,15,15,20,35,61,54,115,0.000333,0.196623,14,8258.145657,458.78587,589.867547,145.041921,3,6
0,0,10,10,12,20,32,36,30,66,0.000333,0.11,6,1980,110,330,129.458112,4,6
0,0,11,11,12,20,32,37,32,69,0.000333,0.115,6,2070,115,345,129.458112,4,6
0,0,10,10,12,20,32,36,31,67,0.000333,0.111667,6,2010,111.666667,335,129.458112,4,6
0,0,11,11,12,20,32,37,33,70,0.000333,0.116667,6,2100,116.666667,350,129.458112,4,6
0,0,25,25,20,45,65,112,91,203,0.000333,0.407514,20,24450.81332,1358.378518,1222.540666,333.571951,8,6
0,0,10,10,12,18,30,38,35,73,0.000333,0.119401,6,2149.218081,119.401004,358.203013,118.0782,1,6
0,0,18,18,17,23,40,70,69,139,0.000333,0.246583,24,17753.95213,986.330674,739.748005,173.528793,2,6
0,0,18,18,16,24,40,87,58,145,0.000333,0.257227,16,12346.87318,685.937399,771.679574,174.0391,6,6
0,0,14,14,10,17,27,52,53,105,0.000333,0.166421,15,7488.947816,416.052656,499.263188,102.706149,1,6
0,0,16,16,14,20,34,60,58,118,0.000333,0.200107,14,8404.488614,466.916034,600.320615,139.741531,2,6
0,0,13,13,14,20,34,49,46,95,0.000333,0.161103,14,6766.325579,375.906977,483.30897,139.741531,2,6
0,0,15,15,11,18,29,55,55,110,0.000333,0.178126,15,8015.668642,445.314925,534.377909,113.112398,2,6
0,0,17,17,14,21,35,63,60,123,0.000333,0.210301,14,8832.625355,490.701409,630.901811,145.541635,3,6
0,0,14,14,14,21,35,52,48,100,0.000333,0.170976,14,7180.996224,398.944235,512.928302,145.541635,3,6
0,0,15,15,11,19,30,55,55,110,0.000333,0.179919,10,5397.579655,299.865536,539.757966,118.764371,2,6
0,0,17,17,14,22,36,63,60,123,0.000333,0.211967,14,8902.610852,494.589492,635.900775,151.410465,3,6
0,0,14,14,14,22,36,52,48,100,0.000333,0.172331,14,7237.895002,402.105278,516.9925,151.410465,3,6
0,0,35,35,21,50,71,146,110,256,0.000333,0.524778,20,31486.70525,1749.261403,1574.335263,374.431475,10,6
0,0,38,38,23,53,76,159,118,277,0.000333,0.576892,22,38074.87027,2115.27057,1730.675921,407.621709,11,6
0,0,10,10,13,16,29,39,30,69,0.000333,0.111734,6,2011.204132,111.733563,335.200689,112.105716,2,6
0,0,15,15,11,18,29,55,54,109,0.000333,0.176507,15,7942.798927,441.266607,529.519928,113.112398,2,6
0,0,17,17,14,21,35,63,59,122,0.000333,0.208591,14,8760.815393,486.711966,625.772528,145.541635,3,6
0,0,14,14,14,21,35,52,47,99,0.000333,0.169266,14,7109.186261,394.954792,507.799019,145.541635,3,6
0,0,34,34,19,50,69,144,108,252,0.000333,0.513116,18,27708.26694,1539.348163,1539.348163,362.903432,10,6
0,0,37,37,21,53,74,157,116,273,0.000333,0.56506,20,33903.61538,1883.534188,1695.180769,395.81845,11,6
0,0,10,10,13,16,29,39,30,69,0.000333,0.111734,6,2011.204132,111.733563,335.200689,112.105716,2,6
0,0,29,29,21,52,73,129,93,222,0.000333,0.458047,10,13741.41052,763.411696,1374.141052,388.661531,11,6
0,0,28,28,21,52,73,128,91,219,0.000333,0.451857,10,13555.71578,753.095321,1355.571578,388.661531,11,6
0,0,34,34,21,50,71,146,109,255,0.000333,0.522729,20,31363.71031,1742.428351,1568.185515,374.431475,11,6
0,0,37,37,23,53,76,159,117,276,0.000333,0.574809,22,37937.41586,2107.634215,1724.427994,407.621709,12,6
0,0,10,10,13,16,29,39,30,69,0.000333,0.111734,6,2011.204132,111.733563,335.200689,112.105716,2,6
0,0,30,30,23,52,75,135,98,233,0.000333,0.483772,11,15964.4623,886.914572,1451.314755,400.46479,12,6
0,0,29,29,23,52,75,134,96,230,0.000333,0.477543,11,15758.91129,875.495071,1432.628299,400.46479,12,6
0,0,15,15,10,17,27,51,59,110,0.000333,0.174346,15,7845.564379,435.864688,523.037625,102.706149,2,6
0,0,18,18,14,20,34,64,67,131,0.000333,0.222153,21,13995.61028,777.533904,666.457632,139.741531,3,6
0,0,10,10,13,17,30,41,32,73,0.000333,0.119401,6,2149.218081,119.401004,358.203013,117.592585,2,6
0,0,18,18,13,20,33,72,61,133,0.000333,0.223635,18,12076.27952,670.904418,670.904418,134.544278,2,6
0,0,21,21,17,23,40,85,69,154,0.000333,0.273192,24,19669.84624,1092.769235,819.576927,173.528793,3,6
0,0,12,12,16,19,35,57,41,98,0.000333,0.167557,16,8042.715771,446.817543,502.669736,144.710623,3,6
0,0,15,15,13,19,32,69,51,120,0.000333,0.2,12,7200,400,600,128.816339,2,6
0,0,18,18,17,22,39,82,59,141,0.000333,0.248414,16,11923.86741,662.437078,745.241713,167.594364,3,6
0,0,12,12,16,18,34,53,39,92,0.000333,0.156016,16,7488.745302,416.041406,468.046581,139.05865,3,6
0,0,16,16,14,19,33,72,52,124,0.000333,0.208502,14,8757.068191,486.503788,625.504871,134.013592,3,6
0,0,19,19,18,22,40,85,60,145,0.000333,0.257227,18,13890.23233,771.679574,771.679574,173.166146,4,6
0,0,12,12,16,18,34,53,39,92,0.000333,0.156016,16,7488.745302,416.041406,468.046581,139.05865,3,6
0,0,16,16,14,20,34,72,52,124,0.000333,0.210282,14,8831.835492,490.657527,630.845392,139.741531,3,6
0,0,19,19,18,23,41,85,60,145,0.000333,0.258948,18,13983.21073,776.845041,776.845041,179.100575,4,6
0,0,12,12,16,18,34,53,39,92,0.000333,0.156016,16,7488.745302,416.041406,468.046581,139.05865,3,6
0,0,20,20,17,24,41,71,62,133,0.000333,0.237518,16,11400.87067,633.381704,712.554417,179.525968,4,6
0,0,14,14,14,21,35,48,40,88,0.000333,0.150459,7,3159.638338,175.535463,451.376905,145.541635,3,6
0,0,14,14,14,22,36,49,41,90,0.000333,0.155098,7,3257.052751,180.947375,465.29325,151.410465,3,6
0,0,17,17,14,20,34,78,57,135,0.000333,0.228936,14,9615.30477,534.183598,686.807484,139.741531,2,6
0,0,20,20,18,23,41,91,65,156,0.000333,0.278593,18,15044.00603,835.778113,835.778113,179.100575,3,6
0,0,12,12,16,18,34,53,39,92,0.000333,0.156016,16,7488.745302,416.041406,468.046581,139.05865,3,6
0,0,17,17,16,21,37,60,56,116,0.000333,0.201432,16,9668.745447,537.152525,604.29659,156.238666,4,6
0,0,12,12,13,19,32,40,37,77,0.000333,0.128333,6,2310,128.333333,385,128.816339,3,6
0,0,15,15,10,19,29,56,50,106,0.000333,0.171649,10,5149.459855,286.081103,514.945985,113.929904,1,6
0,0,18,18,14,22,36,69,58,127,0.000333,0.21886,14,9192.126653,510.673703,656.580475,151.410465,2,6
0,0,10,10,13,16,29,42,32,74,0.000333,0.11983,12,4313.887124,239.660396,359.490594,112.105716,2,6
0,0,14,14,14,21,35,54,44,98,0.000333,0.167557,14,7037.376299,390.96535,502.669736,145.541635,2,6
0,0,13,13,14,21,35,52,42,94,0.000333,0.160718,14,6750.13645,375.007581,482.152604,145.541635,2,6
0,0,14,14,9,16,25,54,49,103,0.000333,0.159439,12,5739.806251,318.878125,478.317188,92.529325,1,6
0,0,17,17,13,19,32,67,57,124,0.000333,0.206667,18,11160,620,620,128.816339,2,6
0,0,10,10,13,16,29,45,34,79,0.000333,0.127927,12,4605.365983,255.853666,383.780499,112.105716,2,6
0,0,8,8,10,14,24,33,27,60,0.000333,0.091699,5,1375.48875,76.416042,275.09775,86.52225,1,6
0,0,11,11,14,17,31,46,35,81,0.000333,0.133763,14,5618.058616,312.114368,401.289901,122.789837,2,6
0,0,21,21,13,22,35,78,85,163,0.000333,0.278691,18,15049.31637,836.073132,836.073132,146.213212,2,6
0,0,23,23,17,24,41,86,90,176,0.000333,0.31431,24,22630.29967,1257.23887,942.929153,179.525968,3,6
0,0,19,19,13,21,34,72,75,147,0.000333,0.249286,18,13461.42668,747.857038,747.857038,140.344382,2,6
0,0,21,21,17,23,40,80,80,160,0.000333,0.283836,24,20436.20388,1135.34466,851.508495,173.528793,3,6
0,0,17,17,13,20,33,66,65,131,0.000333,0.220272,18,11894.68133,660.81563,660.81563,134.544278,2,6
0,0,19,19,17,22,39,74,70,144,0.000333,0.253699,24,18266.35007,1014.797226,761.09792,167.594364,3,6
0,0,13,13,11,16,27,63,43,106,0.000333,0.168006,10,5040.180752,280.010042,504.018075,102.053748,2,6
0,0,16,16,14,19,33,76,51,127,0.000333,0.213546,14,8968.932744,498.274041,640.638053,134.013592,3,6
0,0,10,10,14,16,30,46,33,79,0.000333,0.129215,14,5427.020999,301.501167,387.644357,117.302969,2,6
0,0,7,7,10,16,26,24,25,49,0.000333,0.076774,5,1151.607731,63.978207,230.321546,97.219281,2,6
0,0,7,7,10,16,26,24,25,49,0.000333,0.076774,5,1151.607731,63.978207,230.321546,97.219281,2,6
0,0,7,7,13,16,29,30,28,58,0.000333,0.093921,6,1690.577386,93.920966,281.762898,112.105716,1,6
0,0,10,10,16,19,35,43,36,79,0.000333,0.135071,8,3241.706867,180.094826,405.213358,144.710623,2,6
0,0,31,31,20,52,72,132,116,248,0.000333,0.510047,20,30602.82801,1700.157112,1530.1414,382.861427,10,6
0,0,5,5,10,12,22,17,20,37,0.000333,0.055,5,824.994849,45.833047,164.99897,76.238831,2,6
0,0,11,11,14,19,33,41,31,72,0.000333,0.121065,7,2542.374636,141.243035,363.196377,134.013592,5,6
0,0,9,9,12,20,32,35,28,63,0.000333,0.105,6,1890,105,315,129.458112,4,6
0,0,10,10,12,20,32,36,30,66,0.000333,0.11,6,1980,110,330,129.458112,4,6
0,0,12,12,14,21,35,44,36,80,0.000333,0.136781,7,2872.398489,159.577694,410.342641,145.541635,4,6
0,0,10,10,12,20,32,38,33,71,0.000333,0.118333,6,2130,118.333333,355,129.458112,3,6
0,0,11,11,12,20,32,39,35,74,0.000333,0.123333,6,2220,123.333333,370,129.458112,3,6
0,0,17,17,15,20,35,58,53,111,0.000333,0.189783,14,7970.905808,442.8281,569.350415,145.041921,3,6
0,0,14,14,15,20,35,47,41,88,0.000333,0.150459,14,6319.276677,351.070926,451.376905,145.041921,3,6
0,0,15,15,12,18,30,64,46,110,0.000333,0.179919,12,6477.095586,359.838644,539.757966,118.0782,2,6
0,0,18,18,15,21,36,77,54,131,0.000333,0.225753,14,9481.642453,526.757914,677.260175,150.842025,3,6
0,0,10,10,13,16,29,42,32,74,0.000333,0.11983,12,4313.887124,239.660396,359.490594,112.105716,2,6
0,0,13,13,11,18,29,60,44,104,0.000333,0.16841,10,5052.300235,280.683346,505.230023,113.112398,2,6
0,0,16,16,14,21,35,73,52,125,0.000333,0.21372,14,8976.24528,498.680293,641.160377,145.541635,3,6
0,0,10,10,13,16,29,42,32,74,0.000333,0.11983,12,4313.887124,239.660396,359.490594,112.105716,2,6
0,0,15,15,14,20,34,60,53,113,0.000333,0.191628,14,8048.366215,447.131456,574.883301,139.741531,3,6
0,0,15,15,14,20,34,60,53,113,0.000333,0.191628,14,8048.366215,447.131456,574.883301,139.741531,3,6
0,0,28,28,20,49,69,127,95,222,0.000333,0.452031,10,13560.92429,753.384683,1356.092429,361.559344,10,6
0,0,27,27,19,50,69,121,91,212,0.000333,0.431669,9,11655.06466,647.503592,1295.007185,362.903432,10,6
0,0,26,26,19,50,69,120,89,209,0.000333,0.425561,9,11490.1345,638.340806,1276.681611,362.903432,10,6
0,0,15,15,11,19,30,64,59,123,0.000333,0.201183,15,9053.213149,502.956286,603.547543,118.764371,1,6
0,0,17,17,15,21,36,72,64,136,0.000333,0.23437,21,14765.3058,820.294767,703.1098,150.842025,2,6
0,0,16,16,15,25,40,66,53,119,0.000333,0.211103,14,8866.332206,492.574011,633.309443,174.699764,5,6
0,0,19,19,17,27,44,79,61,140,0.000333,0.254773,16,12229.12683,679.395935,764.320427,197.868831,6,6
0,0,19,19,18,26,44,89,66,155,0.000333,0.282071,18,15231.81422,846.211901,846.211901,197.270083,6,6
0,0,18,18,10,20,30,70,76,146,0.000333,0.238802,15,10746.0904,597.005022,716.406027,119.657843,1,6
0,0,20,20,14,22,36,78,81,159,0.000333,0.274006,21,17262.37958,959.021088,822.018075,151.410465,2,6
0,0,18,18,15,27,42,73,57,130,0.000333,0.233667,14,9814.017709,545.223206,701.001265,186.985321,5,6
0,0,21,21,17,29,46,86,65,151,0.000333,0.278019,16,13344.92569,741.38476,834.057855,210.368317,6,6
0,0,16,16,17,25,42,71,55,126,0.000333,0.226477,16,10870.91192,603.939551,679.431995,185.583273,4,6
0,0,20,20,16,27,43,81,64,145,0.000333,0.262269,16,12588.93423,699.385235,786.808389,192.381963,4,6
0,0,23,23,18,29,47,94,72,166,0.000333,0.307354,18,16597.11149,922.061749,922.061749,215.940099,5,6
0,0,19,19,18,26,44,82,63,145,0.000333,0.263873,18,14249.11653,791.617585,791.617585,197.270083,4,6
0,0,19,19,15,27,42,77,62,139,0.000333,0.249844,14,10493.44971,582.969428,749.532122,186.985321,4,6
0,0,22,22,17,29,46,90,70,160,0.000333,0.29459,16,14140.31861,785.573256,883.769913,210.368317,5,6
0,0,18,18,17,26,43,78,61,139,0.000333,0.251417,16,12068.01281,670.445156,754.250801,191.698301,4,6
0,0,13,13,11,16,27,62,43,105,0.000333,0.166421,10,4992.631877,277.368438,499.263188,102.053748,2,6
0,0,16,16,14,19,33,75,51,126,0.000333,0.211865,14,8898.311227,494.350624,635.593659,134.013592,3,6
0,0,10,10,14,15,29,44,32,76,0.000333,0.123069,14,5168.891779,287.160654,369.206556,111.906328,2,6
0,0,7,7,11,13,24,23,20,43,0.000333,0.065718,5,985.766938,54.76483,197.153388,86.159464,2,6
0,0,9,9,11,13,24,29,22,51,0.000333,0.077944,5,1169.165438,64.953635,233.833088,86.159464,4,6
0,0,45,45,24,53,77,187,133,320,0.000333,0.668457,24,48128.92063,2673.828924,2005.371693,413.618884,11,6
0,0,15,15,14,20,34,49,37,86,0.000333,0.145841,7,3062.65263,170.147368,437.521804,139.741531,5,6
0,0,11,11,12,21,33,39,31,70,0.000333,0.117703,6,2118.64553,117.702529,353.107588,135.258216,4,6
0,0,12,12,12,21,33,40,33,73,0.000333,0.122747,6,2209.444624,122.746924,368.240771,135.258216,4,6
0,0,8,8,12,16,28,30,23,53,0.000333,0.08493,6,1528.738865,84.929937,254.789811,107.01955,2,6
0,0,16,16,15,23,38,61,41,102,0.000333,0.17843,7,3747.020245,208.167791,535.288606,162.645284,5,6
0,0,15,15,14,23,37,64,45,109,0.000333,0.189277,7,3974.812918,220.82294,567.830417,157.344894,6,6
0,0,16,16,14,23,37,65,47,112,0.000333,0.194486,14,8168.422877,453.801271,583.458777,157.344894,6,6
0,0,11,11,13,20,33,41,31,72,0.000333,0.121065,6,2179.17826,121.065459,363.196377,134.544278,5,6
0,0,9,9,11,20,31,35,28,63,0.000333,0.104038,5,1560.571838,86.698435,312.114368,124.49231,4,6
0,0,10,10,11,20,31,36,30,66,0.000333,0.108992,5,1634.884782,90.826932,326.976956,124.49231,4,6
0,0,18,18,15,21,36,81,58,139,0.000333,0.23954,14,10060.67405,558.926336,718.619575,150.842025,5,6
0,0,8,8,10,15,25,29,30,59,0.000333,0.091329,10,2739.875152,152.215286,273.987515,91.82264,1,6
0,0,10,10,14,18,32,37,35,72,0.000333,0.12,7,2520,140,360,128.361619,2,6
0,0,15,15,12,22,34,58,44,102,0.000333,0.172974,12,6227.054518,345.947473,518.92121,141.127046,4,6
0,0,18,18,15,24,39,71,52,123,0.000333,0.216701,14,9101.462621,505.636812,650.104473,168.642459,5,6
0,0,10,10,13,16,29,39,30,69,0.000333,0.111734,6,2011.204132,111.733563,335.200689,112.105716,2,6
0,0,12,12,14,21,35,50,35,85,0.000333,0.14533,7,3051.923395,169.5513,435.989056,145.541635,5,6
0,0,13,13,14,21,35,51,37,88,0.000333,0.150459,7,3159.638338,175.535463,451.376905,145.541635,5,6
0,0,13,13,11,19,30,57,44,101,0.000333,0.165199,10,4955.959502,275.331083,495.59595,118.764371,2,6
0,0,16,16,14,21,35,70,52,122,0.000333,0.208591,14,8760.815393,486.711966,625.772528,145.541635,3,6
0,0,9,9,13,16,29,37,30,67,0.000333,0.108495,6,1952.90836,108.494909,325.484727,112.105716,2,6
0,0,24,24,18,45,63,105,80,185,0.000333,0.368599,9,9952.171073,552.898393,1105.796786,322.192039,8,6
0,0,23,23,18,45,63,104,78,182,0.000333,0.362622,9,9790.784515,543.932473,1087.864946,322.192039,8,6
0,0,23,23,18,44,62,102,79,181,0.000333,0.359237,9,9699.38579,538.854766,1077.709532,315.273641,7,6
0,0,22,22,18,44,62,101,77,178,0.000333,0.353282,9,9538.622489,529.923472,1059.846943,315.273641,7,6
0,0,19,19,16,19,35,82,60,142,0.000333,0.242786,24,17480.59652,971.144251,728.358188,144.710623,2,6
0,0,10,10,13,15,28,41,32,73,0.000333,0.116979,12,4211.242912,233.95794,350.936909,106.709075,2,6
0,0,18,18,14,19,33,77,62,139,0.000333,0.233724,21,14724.58643,818.03258,701.170783,134.013592,2,6
0,0,10,10,13,15,28,44,34,78,0.000333,0.124991,12,4499.684207,249.982456,374.973684,106.709075,2,6
0,0,18,18,14,19,33,77,58,135,0.000333,0.226998,21,14300.85733,794.492074,680.993206,134.013592,2,6
0,0,10,10,13,15,28,41,32,73,0.000333,0.116979,12,4211.242912,233.95794,350.936909,106.709075,2,6
0,0,18,18,14,19,33,77,62,139,0.000333,0.233724,21,14724.58643,818.03258,701.170783,134.013592,2,6
0,0,10,10,13,15,28,44,34,78,0.000333,0.124991,12,4499.684207,249.982456,374.973684,106.709075,2,6
0,0,11,11,14,16,30,45,35,80,0.000333,0.13085,14,5495.717467,305.317637,392.551248,117.302969,2,6
0,0,7,7,11,13,24,23,20,43,0.000333,0.065718,5,985.766938,54.76483,197.153388,86.159464,2,6
0,0,15,15,12,18,30,49,48,97,0.000333,0.158656,12,5711.620653,317.312259,475.968388,118.0782,2,6
0,0,17,17,15,21,36,57,53,110,0.000333,0.189564,14,7961.684502,442.315806,568.69175,150.842025,3,6
0,0,14,14,15,21,36,46,41,87,0.000333,0.149928,7,3148.484326,174.915796,449.783475,150.842025,3,6
0,0,18,18,16,24,40,87,58,145,0.000333,0.257227,16,12346.87318,685.937399,771.679574,174.0391,6,6
0,0,9,9,10,14,24,36,29,65,0.000333,0.099341,10,2980.225625,165.56809,298.022563,86.52225,2,6
0,0,12,12,14,17,31,49,37,86,0.000333,0.14202,14,5964.852358,331.380687,426.060883,122.789837,3,6
0,0,10,10,13,17,30,41,32,73,0.000333,0.119401,6,2149.218081,119.401004,358.203013,117.592585,2,6
0,0,37,37,19,53,72,149,125,274,0.000333,0.56352,18,30430.07011,1690.55945,1690.55945,384.290407,10,6
0,0,40,40,21,56,77,162,133,295,0.000333,0.616234,20,36974.04059,2054.113366,1848.70203,417.450542,11,6
0,0,10,10,13,18,31,41,34,75,0.000333,0.123855,6,2229.38834,123.854908,371.564723,123.164366,2,6
0,0,20,20,13,24,37,69,73,142,0.000333,0.246581,18,13315.3628,739.742378,739.742378,158.144816,2,6
0,0,22,22,17,27,44,77,78,155,0.000333,0.282071,16,13539.39041,752.188356,846.211901,197.868831,3,6
0,0,15,15,14,22,36,51,51,102,0.000333,0.175777,14,7382.652902,410.147383,527.33235,151.410465,2,6
0,0,12,12,17,19,36,45,41,86,0.000333,0.148205,16,7113.816802,395.212045,444.61355,150.197491,3,6
0,0,21,21,17,23,40,80,80,160,0.000333,0.283836,24,20436.20388,1135.34466,851.508495,173.528793,3,6
0,0,33,33,19,50,69,140,103,243,0.000333,0.49479,18,26718.68597,1484.371443,1484.371443,362.903432,11,6
0,0,36,36,21,53,74,153,111,264,0.000333,0.546432,20,32785.91377,1821.439654,1639.295689,395.81845,12,6
0,0,10,10,13,16,29,39,30,69,0.000333,0.111734,6,2011.204132,111.733563,335.200689,112.105716,2,6
0,0,29,29,21,52,73,129,92,221,0.000333,0.455984,10,13679.51228,759.972904,1367.951228,388.661531,12,6
0,0,28,28,21,52,73,128,90,218,0.000333,0.449794,10,13493.81754,749.65653,1349.381754,388.661531,12,6
0,0,33,33,19,51,70,140,104,244,0.000333,0.498515,18,26919.81101,1495.545056,1495.545056,370.004315,11,6
0,0,36,36,21,54,75,153,112,265,0.000333,0.550212,20,33012.73906,1834.041059,1650.636953,403.002591,12,6
0,0,10,10,13,16,29,39,30,69,0.000333,0.111734,6,2011.204132,111.733563,335.200689,112.105716,2,6
0,0,29,29,21,53,74,129,93,222,0.000333,0.4595,10,13784.98647,765.832582,1378.498647,395.81845,12,6
0,0,28,28,21,53,74,128,91,219,0.000333,0.45329,10,13598.70287,755.483493,1359.870287,395.81845,12,6
0,0,25,25,20,45,65,113,81,194,0.000333,0.389446,10,11683.39356,649.07742,1168.339356,333.571951,10,6
0,0,24,24,19,46,65,108,80,188,0.000333,0.377402,9,10189.84634,566.102574,1132.205149,334.794473,9,6
0,0,23,23,19,46,65,107,78,185,0.000333,0.371379,9,10027.24241,557.069023,1114.138045,334.794473,9,6
0,0,25,25,20,45,65,113,81,194,0.000333,0.389446,10,11683.39356,649.07742,1168.339356,333.571951,10,6
0,0,24,24,19,46,65,108,80,188,0.000333,0.377402,9,10189.84634,566.102574,1132.205149,334.794473,9,6
0,0,23,23,19,46,65,107,78,185,0.000333,0.371379,9,10027.24241,557.069023,1114.138045,334.794473,9,6
0,0,14,14,12,21,33,51,56,107,0.000333,0.179917,12,6477.002049,359.833447,539.750171,135.258216,2,6
0,0,13,13,13,21,34,51,49,100,0.000333,0.169582,12,6104.95541,339.164189,508.746284,140.344382,2,6
0,0,3,3,9,10,19,13,14,27,0.000333,0.038231,4,458.776171,25.487565,114.694043,61.748606,1,6
0,0,13,13,10,16,26,54,57,111,0.000333,0.173916,15,7826.232131,434.790674,521.748809,97.219281,1,6
0,0,16,16,14,19,33,67,65,132,0.000333,0.221953,21,13983.0605,776.836694,665.860024,134.013592,2,6
0,0,10,10,14,16,30,49,35,84,0.000333,0.137393,14,5770.50334,320.583519,412.17881,117.302969,2,6
0,0,18,18,10,18,28,77,72,149,0.000333,0.238765,20,14325.91767,795.884315,716.295883,108.277931,1,6
0,0,21,21,14,21,35,90,80,170,0.000333,0.290659,21,18311.54037,1017.307798,871.978113,145.541635,2,6
0,0,10,10,14,15,29,47,34,81,0.000333,0.131165,14,5508.950448,306.052803,393.496461,111.906328,2,6
0,0,9,9,11,15,26,29,24,53,0.000333,0.083041,5,1245.616525,69.200918,249.123305,96.657107,4,6
0,0,18,18,13,22,35,64,64,128,0.000333,0.218849,12,7878.578714,437.698817,656.548226,146.213212,3,6
0,0,20,20,16,25,41,72,69,141,0.000333,0.251805,16,12086.63732,671.479851,755.414833,180.096405,4,6
0,0,14,14,13,21,34,47,46,93,0.000333,0.157711,12,5677.608531,315.422696,473.134044,140.344382,3,6
0,0,16,16,14,21,35,64,56,120,0.000333,0.205171,14,8617.195468,478.733082,615.513962,145.541635,3,6
0,0,18,18,17,23,40,72,61,133,0.000333,0.235939,16,11325.06299,629.170166,707.816437,173.528793,4,6
0,0,16,16,14,21,35,64,56,120,0.000333,0.205171,14,8617.195468,478.733082,615.513962,145.541635,3,6
0,0,18,18,17,23,40,72,61,133,0.000333,0.235939,16,11325.06299,629.170166,707.816437,173.528793,4,6
0,0,16,16,14,22,36,64,57,121,0.000333,0.20852,14,8757.852952,486.547386,625.560925,151.410465,3,6
0,0,18,18,17,24,41,72,62,134,0.000333,0.239304,16,11486.5915,638.143972,717.911969,179.525968,4,6
0,0,16,16,14,21,35,64,57,121,0.000333,0.206881,14,8689.005431,482.722524,620.643245,145.541635,3,6
0,0,18,18,17,23,40,72,62,134,0.000333,0.237713,16,11410.21384,633.900769,713.138365,173.528793,4,6
0,0,14,14,11,18,29,57,51,108,0.000333,0.174887,10,5246.619475,291.47886,524.661947,113.112398,2,6
0,0,16,16,14,20,34,65,56,121,0.000333,0.205194,14,8618.162053,478.786781,615.583004,139.741531,3,6
0,0,13,13,10,17,27,54,49,103,0.000333,0.163251,10,4897.534127,272.085229,489.753413,102.706149,1,6
0,0,15,15,14,19,33,62,54,116,0.000333,0.19505,14,8192.09605,455.116447,585.149718,134.013592,2,6
0,0,17,17,16,24,40,70,63,133,0.000333,0.235939,16,11325.06299,629.170166,707.816437,174.0391,3,6
0,0,20,20,18,26,44,83,71,154,0.000333,0.280251,18,15133.54445,840.752469,840.752469,197.270083,4,6
0,0,22,22,19,27,46,99,80,179,0.000333,0.329573,18,17796.91662,988.71759,988.71759,209.092585,6,6
0,0,18,18,15,25,40,72,73,145,0.000333,0.257227,14,10803.51403,600.195224,771.679574,174.699764,3,6
0,0,21,21,17,27,44,85,81,166,0.000333,0.302089,24,21750.37557,1208.354198,906.265649,197.868831,4,6
0,0,16,16,15,24,39,67,55,122,0.000333,0.21494,14,9027.46699,501.525944,644.819071,168.642459,3,6
0,0,19,19,17,26,43,80,63,143,0.000333,0.258652,16,12415.29376,689.738542,775.95586,191.698301,4,6
0,0,21,21,18,27,45,96,72,168,0.000333,0.307544,18,16607.36376,922.63132,922.63132,203.440613,6,6
0,0,20,20,14,22,36,80,73,153,0.000333,0.263666,21,16610.96903,922.831613,790.998525,151.410465,2,6
0,0,23,23,18,24,42,93,81,174,0.000333,0.312754,27,25333.10725,1407.394847,938.263232,185.09775,3,6
0,0,10,10,13,17,30,43,35,78,0.000333,0.127579,12,4592.849597,255.158311,382.737466,117.592585,2,6
0,0,21,21,13,23,36,82,85,167,0.000333,0.287792,18,15540.79455,863.377475,863.377475,152.147641,2,6
0,0,23,23,17,26,43,90,90,180,0.000333,0.325576,24,23441.46374,1302.303541,976.727656,191.698301,3,6
0,0,12,12,16,16,32,36,48,84,0.000333,0.14,24,10080,560,420,128,2,6
0,0,4,4,12,10,22,17,17,34,0.000333,0.05054,6,909.72405,50.540225,151.620675,76.238831,2,6
0,0,20,20,13,22,35,88,70,158,0.000333,0.270142,18,14587.6809,810.426717,810.426717,146.213212,2,6
0,0,23,23,17,24,41,101,78,179,0.000333,0.319667,24,23016.04341,1278.669078,959.001809,179.525968,3,6
0,0,10,10,13,16,29,46,33,79,0.000333,0.127927,12,4605.365983,255.853666,383.780499,112.105716,2,6
0,0,12,12,11,16,27,40,42,82,0.000333,0.129967,10,3899.007752,216.611542,389.900775,102.053748,2,6
0,0,5,5,10,12,22,17,20,37,0.000333,0.055,5,824.994849,45.833047,164.99897,76.238831,2,6
0,0,16,16,14,20,34,63,56,119,0.000333,0.201803,14,8475.713094,470.87295,605.408078,139.741531,3,6
0,0,18,18,17,22,39,71,61,132,0.000333,0.232558,16,11162.76949,620.15386,697.673093,167.594364,4,6
0,0,16,16,14,21,35,63,57,120,0.000333,0.205171,14,8617.195468,478.733082,615.513962,145.541635,3,6
0,0,18,18,17,23,40,71,62,133,0.000333,0.235939,16,11325.06299,629.170166,707.816437,173.528793,4,6
0,0,9,9,12,16,28,26,30,56,0.000333,0.089737,6,1615.271254,89.737292,269.211876,107.01955,2,6
0,0,10,10,12,18,30,38,35,73,0.000333,0.119401,6,2149.218081,119.401004,358.203013,118.0782,1,6
0,0,10,10,12,18,30,38,35,73,0.000333,0.119401,6,2149.218081,119.401004,358.203013,118.0782,1,6
0,0,12,12,15,21,36,45,44,89,0.000333,0.153374,14,6441.726552,357.873697,460.123325,150.842025,3,6
0,0,25,25,19,45,64,109,82,191,0.000333,0.382,9,10314,573,1146,327.844012,9,6
0,0,24,24,19,45,64,108,80,188,0.000333,0.376,9,10152,564,1128,327.844012,9,6
0,0,25,25,19,45,64,109,82,191,0.000333,0.382,9,10314,573,1146,327.844012,9,6
0,0,24,24,19,45,64,108,80,188,0.000333,0.376,9,10152,564,1128,327.844012,9,6
0,0,14,14,10,16,26,65,48,113,0.000333,0.17705,15,7967.245322,442.62474,531.149688,97.219281,1,6
0,0,17,17,14,19,33,78,56,134,0.000333,0.225316,14,9463.283368,525.737965,675.948812,134.013592,2,6
0,0,10,10,14,15,29,44,32,76,0.000333,0.123069,14,5168.891779,287.160654,369.206556,111.906328,2,6
0,0,17,17,14,20,34,77,54,131,0.000333,0.222153,14,9330.406851,518.355936,666.457632,139.741531,3,6
0,0,10,10,14,15,29,44,32,76,0.000333,0.123069,14,5168.891779,287.160654,369.206556,111.906328,2,6
0,0,17,17,14,19,33,77,53,130,0.000333,0.21859,14,9180.797297,510.044294,655.771236,134.013592,3,6
0,0,10,10,14,15,29,44,32,76,0.000333,0.123069,14,5168.891779,287.160654,369.206556,111.906328,2,6
0,0,28,28,21,50,71,142,99,241,0.000333,0.49403,10,14820.89056,823.382809,1482.089056,374.431475,9,6
0,0,31,31,23,53,76,155,107,262,0.000333,0.545652,22,36013.05419,2000.725233,1636.957009,407.621709,10,6
0,0,22,22,19,29,48,105,71,176,0.000333,0.327651,18,17693.1612,982.9534,982.9534,221.592072,6,6
0,0,28,28,21,50,71,142,101,243,0.000333,0.49813,20,29887.771,1660.431722,1494.38855,374.431475,9,6
0,0,31,31,23,53,76,155,109,264,0.000333,0.549818,22,36287.963,2015.997944,1649.452864,407.621709,10,6
0,0,22,22,19,29,48,105,71,176,0.000333,0.327651,18,17693.1612,982.9534,982.9534,221.592072,6,6
0,0,32,32,22,50,72,150,105,255,0.000333,0.524444,22,34613.27926,1922.959959,1573.330875,380.300305,9,6
0,0,35,35,24,53,77,163,113,276,0.000333,0.576544,24,41511.19405,2306.177447,1729.633085,413.618884,10,6
0,0,22,22,19,29,48,105,71,176,0.000333,0.327651,18,17693.1612,982.9534,982.9534,221.592072,6,6
0,0,12,12,15,20,35,44,37,81,0.000333,0.138491,7,2908.303471,161.572415,415.471924,145.041921,3,6
0,0,5,5,11,12,23,18,17,35,0.000333,0.052775,5,791.623342,43.979075,158.324668,81.073298,2,6
0,0,7,7,8,16,24,26,22,48,0.000333,0.073359,4,880.3128,48.906267,220.0782,88,2,6
0,0,10,10,13,19,32,39,30,69,0.000333,0.115,6,2070,115,345,128.816339,3,6
0,0,17,17,15,20,35,68,60,128,0.000333,0.218849,21,13787.51275,765.972931,656.548226,145.041921,2,6
0,0,32,32,21,53,74,144,109,253,0.000333,0.523664,20,31419.83403,1745.546335,1570.991702,395.81845,11,6
0,0,31,31,21,53,74,143,107,250,0.000333,0.517454,20,31047.26683,1724.848157,1552.363341,395.81845,11,6
0,0,20,20,14,23,37,82,78,160,0.000333,0.277838,21,17503.76331,972.431295,833.512539,157.344894,2,6
0,0,22,22,18,26,44,90,83,173,0.000333,0.314827,27,25501.00509,1416.722505,944.48167,197.270083,3,6
0,0,10,10,14,16,30,46,35,81,0.000333,0.132486,14,5564.413935,309.134108,397.458138,117.302969,2,6
0,0,10,10,10,14,24,32,52,84,0.000333,0.128379,15,5777.052751,320.947375,385.13685,86.52225,2,6
0,0,10,10,13,15,28,33,35,68,0.000333,0.108967,12,3922.801616,217.933423,326.900135,106.709075,2,6
0,0,13,13,11,17,28,55,47,102,0.000333,0.16345,10,4903.50202,272.416779,490.350202,107.540616,2,6
0,0,15,15,14,19,33,63,52,115,0.000333,0.193368,14,8121.474532,451.19303,580.105324,134.013592,3,6
0,0,18,18,16,21,37,63,65,128,0.000333,0.22227,24,16003.44074,889.080041,666.810031,156.238666,3,6
0,0,14,14,13,19,32,47,50,97,0.000333,0.161667,12,5820,323.333333,485,128.816339,2,6
0,0,19,19,18,25,43,74,69,143,0.000333,0.258652,18,13967.20548,775.95586,775.95586,191.155055,3,6
0,0,18,18,17,22,39,75,65,140,0.000333,0.246652,16,11839.30097,657.738943,739.956311,167.594364,4,6
0,0,18,18,18,22,40,75,64,139,0.000333,0.246583,18,13315.46409,739.748005,739.748005,173.166146,3,6
0,0,10,10,12,14,26,31,34,65,0.000333,0.101843,12,3666.34298,203.685721,305.528582,96.322519,2,6
0,0,4,4,10,11,21,17,16,33,0.000333,0.048315,5,724.732375,40.26291,144.946475,71.273029,2,6
0,0,12,12,11,17,28,41,42,83,0.000333,0.133003,10,3990.104585,221.672477,399.010459,107.540616,2,6
0,0,19,19,13,22,35,67,67,134,0.000333,0.229108,18,12371.83064,687.323924,687.323924,146.213212,2,6
0,0,17,17,14,22,36,66,64,130,0.000333,0.22403,14,9409.263503,522.736861,672.09025,151.410465,2,6
0,0,19,19,18,25,43,74,69,143,0.000333,0.258652,18,13967.20548,775.95586,775.95586,191.155055,3,6
0,0,15,15,14,19,33,61,54,115,0.000333,0.193368,14,8121.474532,451.19303,580.105324,134.013592,3,6
0,0,17,17,18,22,40,69,59,128,0.000333,0.227069,18,12261.72233,681.206796,681.206796,173.166146,4,6
0,0,25,25,18,45,63,106,85,191,0.000333,0.380553,9,10274.94419,570.830233,1141.660465,322.192039,7,6
0,0,24,24,18,45,63,105,83,188,0.000333,0.374576,9,10113.55763,561.864313,1123.728626,322.192039,7,6
0,0,16,16,14,19,33,70,51,121,0.000333,0.203457,14,8545.203638,474.733535,610.371688,134.013592,3,6
0,0,19,19,18,21,39,83,59,142,0.000333,0.250176,18,13509.48807,750.527115,750.527115,167.297316,4,6
0,0,10,10,13,15,28,41,31,72,0.000333,0.115377,12,4153.554653,230.753036,346.129554,106.709075,2,6
0,0,17,17,14,19,33,76,56,132,0.000333,0.221953,14,9322.040333,517.89113,665.860024,134.013592,2,6
0,0,20,20,18,21,39,89,64,153,0.000333,0.269556,27,21833.99657,1212.999809,808.666539,167.297316,3,6
0,0,10,10,13,15,28,41,31,72,0.000333,0.115377,12,4153.554653,230.753036,346.129554,106.709075,2,6
0,0,12,12,14,19,33,56,42,98,0.000333,0.164784,14,6920.908732,384.49493,494.350624,134.013592,6,6
0,0,28,28,20,49,69,124,95,219,0.000333,0.445922,10,13377.66856,743.203809,1337.766856,361.559344,10,6
0,0,28,28,19,50,69,122,95,217,0.000333,0.44185,9,11929.94826,662.774904,1325.549807,362.903432,10,6
0,0,27,27,19,50,69,121,93,214,0.000333,0.435741,9,11765.0181,653.612117,1307.224234,362.903432,10,6
0,0,9,9,13,14,27,29,26,55,0.000333,0.087173,6,1569.112876,87.172938,261.518813,101.408685,2,6
0,0,21,21,18,20,38,83,73,156,0.000333,0.272892,27,22104.27069,1228.015038,818.676692,161.497212,2,6
0,0,9,9,11,14,25,28,24,52,0.000333,0.080494,5,1207.402609,67.077923,241.480522,91.356717,4,6
0,0,10,10,10,14,24,32,52,84,0.000333,0.128379,15,5777.052751,320.947375,385.13685,86.52225,2,6
0,0,11,11,12,18,30,43,36,79,0.000333,0.129215,12,4651.732285,258.429571,387.644357,118.0782,3,6
0,0,10,10,12,18,30,40,32,72,0.000333,0.117765,6,2119.776737,117.765374,353.296123,118.0782,3,6
0,0,21,21,18,21,39,90,70,160,0.000333,0.281888,27,22832.93759,1268.496533,845.664355,167.297316,3,6
0,0,10,10,13,15,28,41,31,72,0.000333,0.115377,12,4153.554653,230.753036,346.129554,106.709075,2,6
0,0,11,11,11,17,28,40,51,91,0.000333,0.145823,15,6562.039469,364.557748,437.469298,107.540616,1,6
0,0,14,14,15,20,35,53,59,112,0.000333,0.191493,14,8042.715771,446.817543,574.479698,145.041921,2,6
0,0,11,11,11,17,28,40,51,91,0.000333,0.145823,15,6562.039469,364.557748,437.469298,107.540616,1,6
0,0,14,14,15,20,35,53,59,112,0.000333,0.191493,14,8042.715771,446.817543,574.479698,145.041921,2,6
0,0,17,17,17,22,39,71,61,132,0.000333,0.232558,16,11162.76949,620.15386,697.673093,167.594364,3,6
0,0,15,15,10,19,29,58,59,117,0.000333,0.189461,15,8525.756646,473.653147,568.383776,113.929904,1,6
0,0,17,17,14,21,35,66,64,130,0.000333,0.222269,21,14002.94264,777.941258,666.806792,145.541635,2,6
0,0,18,18,13,23,36,67,52,119,0.000333,0.205074,12,7382.652902,410.147383,615.221075,152.147641,4,6
0,0,21,21,16,25,41,80,60,140,0.000333,0.250019,16,12000.91649,666.717583,750.057281,180.096405,5,6
0,0,10,10,13,16,29,39,30,69,0.000333,0.111734,6,2011.204132,111.733563,335.200689,112.105716,2,6
0,0,16,16,13,23,36,64,50,114,0.000333,0.196457,12,7072.457402,392.9143,589.37145,152.147641,4,6
0,0,19,19,16,25,41,77,58,135,0.000333,0.24109,16,11572.31233,642.906241,723.269521,180.096405,5,6
0,0,10,10,13,16,29,39,30,69,0.000333,0.111734,6,2011.204132,111.733563,335.200689,112.105716,2,6
0,0,13,13,15,24,39,56,41,97,0.000333,0.170895,7,3588.788107,199.377117,512.684015,168.642459,5,6
0,0,14,14,15,24,39,57,43,100,0.000333,0.17618,7,3699.781553,205.54342,528.540222,168.642459,5,6
0,0,14,14,11,21,32,55,43,98,0.000333,0.163333,10,4900,272.222222,490,130.292414,3,6
0,0,17,17,14,23,37,68,51,119,0.000333,0.206642,14,8678.949307,482.16385,619.924951,157.344894,4,6
0,0,10,10,13,16,29,39,30,69,0.000333,0.111734,6,2011.204132,111.733563,335.200689,112.105716,2,6
0,0,11,11,13,20,33,47,34,81,0.000333,0.136199,6,2451.575542,136.198641,408.595924,134.544278,4,6
0,0,12,12,13,20,33,48,36,84,0.000333,0.141243,6,2542.374636,141.243035,423.729106,134.544278,4,6
0,0,33,33,19,51,70,140,104,244,0.000333,0.498515,18,26919.81101,1495.545056,1495.545056,370.004315,11,6
0,0,36,36,21,54,75,153,112,265,0.000333,0.550212,20,33012.73906,1834.041059,1650.636953,403.002591,12,6
0,0,10,10,13,16,29,39,30,69,0.000333,0.111734,6,2011.204132,111.733563,335.200689,112.105716,2,6
0,0,29,29,21,53,74,129,93,222,0.000333,0.4595,10,13784.98647,765.832582,1378.498647,395.81845,12,6
0,0,28,28,21,53,74,128,91,219,0.000333,0.45329,10,13598.70287,755.483493,1359.870287,395.81845,12,6
0,0,33,33,19,50,69,140,103,243,0.000333,0.49479,18,26718.68597,1484.371443,1484.371443,362.903432,11,6
0,0,36,36,21,53,74,153,111,264,0.000333,0.546432,20,32785.91377,1821.439654,1639.295689,395.81845,12,6
0,0,10,10,13,16,29,39,30,69,0.000333,0.111734,6,2011.204132,111.733563,335.200689,112.105716,2,6
0,0,29,29,21,52,73,129,92,221,0.000333,0.455984,10,13679.51228,759.972904,1367.951228,388.661531,12,6
0,0,28,28,21,52,73,128,90,218,0.000333,0.449794,10,13493.81754,749.65653,1349.381754,388.661531,12,6
0,0,13,13,11,16,27,46,46,92,0.000333,0.145817,10,4374.496502,243.027583,437.44965,102.053748,2,6
0,0,15,15,14,19,33,54,51,105,0.000333,0.176554,14,7415.259355,411.958853,529.661383,134.013592,3,6
0,0,12,12,14,19,33,43,39,82,0.000333,0.13788,14,5790.964449,321.720247,413.640318,134.013592,3,6
0,0,13,13,10,16,26,54,57,111,0.000333,0.173916,15,7826.232131,434.790674,521.748809,97.219281,1,6
0,0,16,16,14,19,33,67,65,132,0.000333,0.221953,21,13983.0605,776.836694,665.860024,134.013592,2,6
0,0,10,10,14,16,30,49,35,84,0.000333,0.137393,14,5770.50334,320.583519,412.17881,117.302969,2,6
0,0,15,15,11,18,29,72,55,127,0.000333,0.205655,15,9254.453796,514.136322,616.963586,113.112398,1,6
0,0,18,18,15,21,36,85,63,148,0.000333,0.25505,21,16068.1269,892.673717,765.1489,150.842025,2,6
0,0,10,10,14,17,31,50,35,85,0.000333,0.140369,14,5895.493609,327.527423,421.106686,122.789837,2,6
0,0,9,9,14,15,29,42,33,75,0.000333,0.12145,14,5100.880045,283.382225,364.348575,111.906328,2,6
0,0,12,12,17,18,35,55,41,96,0.000333,0.164137,16,7878.578714,437.698817,492.41117,144.545518,3,6
0,0,10,10,14,16,30,46,34,80,0.000333,0.13085,14,5495.717467,305.317637,392.551248,117.302969,2,6
0,0,15,15,13,17,30,67,46,113,0.000333,0.184826,12,6653.743648,369.652425,554.478637,117.592585,2,6
0,0,18,18,16,20,36,80,54,134,0.000333,0.230923,16,11084.3192,615.795511,692.76995,150.438562,3,6
0,0,10,10,14,15,29,44,32,76,0.000333,0.123069,14,5168.891779,287.160654,369.206556,111.906328,2,6
0,0,8,8,11,16,27,29,28,57,0.000333,0.090343,5,1355.142938,75.285719,271.028588,102.053748,1,6
0,0,11,11,15,19,34,42,36,78,0.000333,0.132274,7,2777.754711,154.319706,396.822102,139.313982,2,6
0,0,28,28,21,50,71,142,109,251,0.000333,0.514529,20,30871.73054,1715.096141,1543.586527,374.431475,7,6
0,0,31,31,23,53,76,155,117,272,0.000333,0.566479,22,37387.59824,2077.088791,1699.436284,407.621709,8,6
0,0,28,28,21,50,71,142,103,245,0.000333,0.502229,20,30133.76089,1674.097827,1506.688044,374.431475,7,6
0,0,31,31,23,53,76,155,111,266,0.000333,0.553983,22,36562.87181,2031.270656,1661.948719,407.621709,8,6
0,0,24,24,19,30,49,111,77,188,0.000333,0.351855,18,19000.17811,1055.565451,1055.565451,227.917341,6,6
0,0,29,29,22,50,72,147,105,252,0.000333,0.518274,22,34206.06421,1900.3369,1554.8211,380.300305,7,6
0,0,32,32,24,53,77,160,113,273,0.000333,0.570278,24,41059.98542,2281.110301,1710.832726,413.618884,8,6
0,0,25,25,20,30,50,116,79,195,0.000333,0.366851,20,22011.03914,1222.835508,1100.551957,233.64528,6,6
0,0,17,17,14,18,32,63,49,112,0.000333,0.186667,14,7840,435.555556,560,128.361619,3,6
0,0,20,20,17,21,38,76,57,133,0.000333,0.232658,16,11167.58975,620.421653,697.974359,161.725534,4,6
0,0,10,10,13,15,28,41,31,72,0.000333,0.115377,12,4153.554653,230.753036,346.129554,106.709075,2,6
0,0,15,15,14,19,33,53,40,93,0.000333,0.156376,14,6567.801143,364.877841,469.128653,134.013592,3,6
0,0,11,11,13,17,30,44,34,78,0.000333,0.127579,12,4592.849597,255.158311,382.737466,117.592585,2,6
0,0,18,18,15,20,35,70,52,122,0.000333,0.208591,14,8760.815393,486.711966,625.772528,145.041921,3,6
0,0,21,21,17,23,40,83,60,143,0.000333,0.253679,16,12176.57148,676.476193,761.035718,173.528793,4,6
0,0,10,10,13,15,28,41,31,72,0.000333,0.115377,12,4153.554653,230.753036,346.129554,106.709075,2,6
0,0,15,15,14,20,34,57,40,97,0.000333,0.164495,14,6908.774538,383.820808,493.483896,139.741531,3,6
0,0,15,15,14,21,35,58,41,99,0.000333,0.169266,7,3554.593131,197.477396,507.799019,145.541635,3,6
0,0,12,12,13,17,30,46,36,82,0.000333,0.134122,12,4828.380346,268.243353,402.365029,117.592585,2,6
0,0,15,15,13,18,31,59,47,106,0.000333,0.175048,12,6301.737707,350.096539,525.144809,123.164366,3,6
0,0,18,18,16,21,37,72,55,127,0.000333,0.220534,16,10585.60924,588.089402,661.600577,156.238666,4,6
0,0,10,10,13,15,28,41,31,72,0.000333,0.115377,12,4153.554653,230.753036,346.129554,106.709075,2,6
0,0,13,13,13,19,32,49,38,87,0.000333,0.145,12,5220,290,435,128.816339,3,6
0,0,11,11,13,17,30,44,34,78,0.000333,0.127579,12,4592.849597,255.158311,382.737466,117.592585,2,6
0,0,15,15,13,17,30,59,46,105,0.000333,0.171741,12,6182.68215,343.482342,515.223513,117.592585,3,6
0,0,18,18,17,20,37,72,54,126,0.000333,0.218797,16,10502.25799,583.458777,656.391124,155.92543,4,6
0,0,10,10,13,15,28,41,31,72,0.000333,0.115377,12,4153.554653,230.753036,346.129554,106.709075,2,6
0,0,13,13,14,18,32,49,37,86,0.000333,0.143333,14,6020,334.444444,430,128.361619,3,6
0,0,11,11,13,17,30,44,34,78,0.000333,0.127579,12,4592.849597,255.158311,382.737466,117.592585,2,6
0,0,11,11,17,19,36,46,41,87,0.000333,0.149928,16,7196.535602,399.807533,449.783475,150.197491,3,6
0,0,18,18,14,22,36,73,66,139,0.000333,0.23954,21,15091.01108,838.389504,718.619575,151.410465,3,6
0,0,20,20,17,25,42,81,71,152,0.000333,0.273211,16,13114.11597,728.561998,819.632248,185.583273,4,6
0,0,26,26,23,48,71,117,96,213,0.000333,0.436632,22,28817.715,1600.984167,1309.896136,372.120125,8,6
0,0,19,19,15,20,35,86,65,151,0.000333,0.258174,21,16264.95645,903.608691,774.521736,145.041921,2,6
0,0,10,10,14,16,30,48,34,82,0.000333,0.134122,14,5633.110404,312.950578,402.365029,117.302969,2,6
0,0,15,15,12,17,29,50,48,98,0.000333,0.158694,12,5712.98565,317.388092,476.082138,112.506418,2,6
0,0,17,17,15,20,35,58,53,111,0.000333,0.189783,14,7970.905808,442.8281,569.350415,145.041921,3,6
0,0,14,14,15,20,35,47,41,88,0.000333,0.150459,14,6319.276677,351.070926,451.376905,145.041921,3,6
0,0,14,14,13,18,31,58,53,111,0.000333,0.183305,12,6598.989485,366.610527,549.91579,123.164366,2,6
0,0,16,16,17,21,38,66,58,124,0.000333,0.216914,16,10411.88819,578.438233,650.743012,161.725534,3,6
0,0,14,14,13,21,34,57,59,116,0.000333,0.196715,12,7081.748275,393.43046,590.14569,140.344382,1,6
0,0,17,17,17,24,41,69,68,137,0.000333,0.244662,16,11743.75399,652.430777,733.984625,179.525968,2,6
0,0,7,7,10,15,25,23,24,47,0.000333,0.072754,5,1091.306205,60.628122,218.261241,91.82264,1,6
0,0,7,7,10,15,25,23,24,47,0.000333,0.072754,5,1091.306205,60.628122,218.261241,91.82264,1,6
0,0,7,7,10,15,25,23,24,47,0.000333,0.072754,5,1091.306205,60.628122,218.261241,91.82264,1,6
0,0,16,16,13,21,34,63,66,129,0.000333,0.218761,18,11813.08872,656.282707,656.282707,140.344382,3,6
0,0,12,12,13,19,32,51,46,97,0.000333,0.161667,12,5820,323.333333,485,128.816339,3,6
0,0,9,9,9,13,22,31,44,75,0.000333,0.111486,12,4013.488457,222.971581,334.457371,76.635041,1,6
0,0,15,15,11,19,30,59,50,109,0.000333,0.178284,10,5348.510749,297.139486,534.851075,118.764371,1,6
0,0,18,18,15,22,37,72,58,130,0.000333,0.225743,14,9481.205125,526.733618,677.228938,156.710855,2,6
0,0,10,10,14,16,30,46,33,79,0.000333,0.129215,14,5427.020999,301.501167,387.644357,117.302969,2,6
0,0,14,14,15,21,36,57,44,101,0.000333,0.174054,14,7310.273952,406.126331,522.162425,150.842025,2,6
0,0,13,13,15,21,36,55,42,97,0.000333,0.167161,14,7020.758152,390.04212,501.482725,150.842025,2,6
0,0,15,15,13,19,32,49,48,97,0.000333,0.161667,12,5820,323.333333,485,128.816339,3,6
0,0,12,12,13,19,32,38,36,74,0.000333,0.123333,6,2220,123.333333,370,128.816339,3,6
0,0,13,13,11,16,27,54,40,94,0.000333,0.148986,10,4469.594252,248.310792,446.959425,102.053748,2,6
0,0,16,16,15,19,34,67,48,115,0.000333,0.195019,14,8190.815174,455.045287,585.058227,139.313982,3,6
0,0,10,10,14,16,30,46,33,79,0.000333,0.129215,14,5427.020999,301.501167,387.644357,117.302969,2,6
0,0,13,13,15,19,34,53,38,91,0.000333,0.15432,14,6481.42766,360.079314,462.959119,139.313982,3,6
0,0,11,11,14,18,32,48,35,83,0.000333,0.138333,7,2905,161.388889,415,128.361619,2,6
0,0,14,14,10,16,26,57,49,106,0.000333,0.166082,15,7473.699152,415.205508,498.24661,97.219281,1,6
0,0,17,17,14,19,33,70,57,127,0.000333,0.213546,21,13453.39912,747.411062,640.638053,134.013592,2,6
0,0,10,10,14,16,30,49,35,84,0.000333,0.137393,14,5770.50334,320.583519,412.17881,117.302969,2,6
0,0,14,14,14,19,33,56,47,103,0.000333,0.173191,14,7274.01632,404.112018,519.572594,134.013592,2,6
0,0,13,13,14,19,33,54,45,99,0.000333,0.166465,14,6991.530249,388.418347,499.395018,134.013592,2,6
0,0,17,17,17,21,38,69,59,128,0.000333,0.223912,16,10747.75555,597.09753,671.734722,161.725534,4,6
0,0,7,7,13,15,28,27,28,55,0.000333,0.088135,6,1586.427124,88.13484,264.404521,106.709075,1,6
0,0,10,10,17,18,35,40,36,76,0.000333,0.129942,16,6237.208149,346.511564,389.825509,144.545518,2,6
0,0,19,19,14,23,37,76,70,146,0.000333,0.253527,21,15972.18402,887.343557,760.580191,157.344894,2,6
0,0,18,18,14,23,37,73,67,140,0.000333,0.243108,14,10210.5286,567.251589,729.323471,157.344894,3,6
0,0,20,20,17,26,43,81,72,153,0.000333,0.27674,16,13283.49612,737.972007,830.218507,191.698301,4,6
0,0,31,31,21,52,73,142,100,242,0.000333,0.499313,10,14979.37543,832.187524,1497.937543,388.661531,12,6
0,0,30,30,21,52,73,141,98,239,0.000333,0.493123,10,14793.6807,821.87115,1479.36807,388.661531,12,6
0,0,7,7,12,14,26,32,30,62,0.000333,0.097142,12,3497.12715,194.284842,291.427263,96.322519,1,6
0,0,9,9,15,17,32,40,35,75,0.000333,0.125,14,5250,291.666667,375,128.090227,2,6
0,0,31,31,21,52,73,142,100,242,0.000333,0.499313,10,14979.37543,832.187524,1497.937543,388.661531,12,6
0,0,30,30,21,52,73,141,98,239,0.000333,0.493123,10,14793.6807,821.87115,1479.36807,388.661531,12,6
0,0,20,20,10,20,30,70,83,153,0.000333,0.250251,20,15015.08522,834.171401,750.754261,119.657843,1,6
0,0,22,22,14,23,37,78,88,166,0.000333,0.288256,21,18160.15443,1008.897468,864.769259,157.344894,2,6
0,0,7,7,10,15,25,23,24,47,0.000333,0.072754,5,1091.306205,60.628122,218.261241,91.82264,1,6
0,0,4,4,10,11,21,14,15,29,0.000333,0.042459,5,636.886026,35.382557,127.377205,71.273029,1,6
0,0,10,10,12,15,27,40,35,75,0.000333,0.118872,12,4279.398752,237.744375,356.616563,101.622909,2,6
0,0,13,13,16,18,34,53,43,96,0.000333,0.162799,16,7814.342924,434.130162,488.396433,139.05865,3,6
0,0,10,10,13,15,28,41,31,72,0.000333,0.115377,12,4153.554653,230.753036,346.129554,106.709075,2,6
0,0,18,18,16,21,37,63,65,128,0.000333,0.22227,24,16003.44074,889.080041,666.810031,156.238666,3,6
0,0,20,20,16,22,38,69,75,144,0.000333,0.251901,24,18136.83749,1007.602083,755.701562,162.107496,3,6
0,0,32,32,19,49,68,137,102,239,0.000333,0.484968,18,26188.26514,1454.903619,1454.903619,355.831405,10,6
0,0,35,35,21,52,73,150,110,260,0.000333,0.536451,20,32187.08771,1788.171539,1609.354385,388.661531,11,6
0,0,10,10,13,16,29,39,30,69,0.000333,0.111734,6,2011.204132,111.733563,335.200689,112.105716,2,6
0,0,28,28,21,51,72,126,91,217,0.000333,0.446291,10,13388.73725,743.818736,1338.873725,381.532358,11,6
0,0,27,27,21,51,72,125,89,214,0.000333,0.440121,10,13203.6395,733.535528,1320.36395,381.532358,11,6
0,0,18,18,16,20,36,73,62,135,0.000333,0.232647,24,16750.55701,930.5865,697.939875,150.438562,2,6
0,0,3,3,10,8,18,14,12,26,0.000333,0.036139,5,542.09025,30.116125,108.41805,57.219281,1,6
0,0,12,12,12,20,32,45,42,87,0.000333,0.145,12,5220,290,435,129.458112,2,6
0,0,9,9,10,17,27,32,33,65,0.000333,0.103023,5,1545.338438,85.852135,309.067688,102.706149,1,6
0,0,13,13,13,23,36,47,47,94,0.000333,0.161991,12,5831.675402,323.981967,485.97295,152.147641,2,6
0,0,9,9,11,19,30,33,34,67,0.000333,0.109587,5,1643.80835,91.322686,328.76167,118.764371,1,6
0,0,12,12,12,20,32,45,46,91,0.000333,0.151667,12,5460,303.333333,455,129.458112,2,6
0,0,8,8,11,13,24,35,27,62,0.000333,0.094756,10,2842.67675,157.926486,284.267675,86.159464,1,6
0,0,11,11,15,16,31,48,35,83,0.000333,0.137066,14,5756.776113,319.820895,411.198294,122.603359,2,6
0,0,10,10,15,13,28,45,30,75,0.000333,0.120184,14,5047.722668,280.429037,360.551619,106.709075,2,6
0,0,19,19,10,19,29,79,74,153,0.000333,0.247757,15,11149.06638,619.392577,743.271092,113.929904,1,6
0,0,22,22,14,21,35,92,82,174,0.000333,0.297498,21,18742.40014,1041.244452,892.495245,145.541635,2,6
0,0,10,10,14,15,29,47,34,81,0.000333,0.131165,14,5508.950448,306.052803,393.496461,111.906328,2,6
0,0,16,16,11,18,29,73,57,130,0.000333,0.210513,15,9473.06294,526.281274,631.537529,113.112398,1,6
0,0,19,19,15,20,35,86,65,151,0.000333,0.258174,21,16264.95645,903.608691,774.521736,145.041921,2,6
0,0,10,10,14,16,30,48,34,82,0.000333,0.134122,14,5633.110404,312.950578,402.365029,117.302969,2,6
0,0,9,9,11,13,24,28,22,50,0.000333,0.076416,5,1146.240625,63.680035,229.248125,86.159464,4,6
0,0,25,25,19,46,65,109,83,192,0.000333,0.385432,9,10406.65158,578.14731,1156.29462,334.794473,9,6
0,0,24,24,19,46,65,108,81,189,0.000333,0.379409,9,10244.04765,569.113758,1138.227517,334.794473,9,6
0,0,27,27,21,45,66,114,85,199,0.000333,0.400945,10,12028.3443,668.24135,1202.83443,339.372055,9,6
0,0,26,26,21,45,66,113,83,196,0.000333,0.3949,10,11847.01247,658.16736,1184.701247,339.372055,9,6
0,0,12,12,10,16,26,52,47,99,0.000333,0.155115,10,4653.435321,258.524184,465.343532,97.219281,1,6
0,0,14,14,14,19,33,60,52,112,0.000333,0.188324,14,7909.609979,439.422777,564.972141,134.013592,2,6
0,0,13,13,11,19,30,53,49,102,0.000333,0.166834,10,5005.028408,278.057134,500.502841,118.764371,2,6
0,0,15,15,14,22,36,61,54,115,0.000333,0.19818,14,8323.579252,462.42107,594.541375,151.410465,3,6
0,0,13,13,11,17,28,55,48,103,0.000333,0.165053,10,4951.57557,275.087532,495.157557,107.540616,2,6
0,0,15,15,14,20,34,63,53,116,0.000333,0.196715,14,8262.039654,459.002203,590.14569,139.741531,3,6
0,0,9,9,12,17,29,37,30,67,0.000333,0.108495,6,1952.90836,108.494909,325.484727,112.506418,3,6
0,0,34,34,19,50,69,142,112,254,0.000333,0.517188,18,27928.17382,1551.565212,1551.565212,362.903432,10,6
0,0,37,37,21,53,74,155,120,275,0.000333,0.5692,20,34151.99351,1897.332973,1707.599676,395.81845,11,6
0,0,10,10,13,17,30,41,32,73,0.000333,0.119401,6,2149.218081,119.401004,358.203013,117.592585,2,6
0,0,30,30,21,53,74,131,101,232,0.000333,0.480198,10,14405.93181,800.329545,1440.593181,395.81845,11,6
0,0,29,29,21,53,74,130,99,229,0.000333,0.473988,10,14219.64821,789.980456,1421.964821,395.81845,11,6
0,0,7,7,12,11,23,33,26,59,0.000333,0.088963,12,3202.681865,177.92677,266.890155,81.073298,1,6
0,0,10,10,16,15,31,46,34,80,0.000333,0.132112,16,6341.371277,352.298404,396.335705,122.603359,2,6
0,0,15,15,11,21,32,60,57,117,0.000333,0.195,10,5850,325,585,130.292414,1,6
0,0,17,17,15,23,38,68,62,130,0.000333,0.22741,14,9551.228074,530.623782,682.230577,162.645284,2,6
0,0,17,17,12,19,31,66,58,124,0.000333,0.204773,18,11057.76617,614.320342,614.320342,123.730173,2,6
0,0,20,20,16,22,38,79,66,145,0.000333,0.25365,24,18262.78775,1014.599319,760.949489,162.107496,3,6
0,0,12,12,16,18,34,56,41,97,0.000333,0.164495,16,7895.74233,438.652352,493.483896,139.05865,3,6
0,0,14,14,13,18,31,51,45,96,0.000333,0.158534,12,5707.23415,317.068564,475.602846,123.164366,2,6
0,0,13,13,13,18,31,49,43,92,0.000333,0.151929,12,5469.432727,303.857374,455.786061,123.164366,2,6
0,0,14,14,10,18,28,58,52,110,0.000333,0.17627,10,5288.090414,293.782801,528.809041,108.277931,1,6
0,0,16,16,14,20,34,66,57,123,0.000333,0.208586,14,8760.611013,486.700612,625.757929,139.741531,2,6
0,0,15,15,14,23,37,64,48,112,0.000333,0.194486,14,8168.422877,453.801271,583.458777,157.344894,4,6
0,0,16,16,14,23,37,65,50,115,0.000333,0.199696,14,8387.219919,465.956662,599.087137,157.344894,4,6
0,0,12,12,14,19,33,52,42,94,0.000333,0.158058,14,6638.422661,368.801259,474.173047,134.013592,3,6
0,0,14,14,15,20,35,65,50,115,0.000333,0.196623,14,8258.145657,458.78587,589.867547,145.041921,5,6
0,0,13,13,13,21,34,55,43,98,0.000333,0.16619,12,5982.856301,332.380906,498.571358,140.344382,4,6
0,0,9,9,12,18,30,40,33,73,0.000333,0.119401,6,2149.218081,119.401004,358.203013,118.0782,3,6
0,0,12,12,17,18,35,55,41,96,0.000333,0.164137,16,7878.578714,437.698817,492.41117,144.545518,3,6
0,0,10,10,14,16,30,46,34,80,0.000333,0.13085,14,5495.717467,305.317637,392.551248,117.302969,2,6
0,0,28,28,19,49,68,121,95,216,0.000333,0.438297,9,11834.02776,657.445987,1314.891974,355.831405,9,6
0,0,27,27,19,49,68,120,93,213,0.000333,0.43221,9,11669.66627,648.314793,1296.629585,355.831405,9,6
0,0,21,21,17,25,42,98,66,164,0.000333,0.29478,16,14149.44092,786.080051,884.340057,185.583273,6,6
0,0,13,13,11,16,27,53,41,94,0.000333,0.148986,10,4469.594252,248.310792,446.959425,102.053748,2,6
0,0,16,16,14,19,33,66,49,115,0.000333,0.193368,14,8121.474532,451.19303,580.105324,134.013592,3,6
0,0,10,10,14,15,29,44,32,76,0.000333,0.123069,14,5168.891779,287.160654,369.206556,111.906328,2,6
0,0,13,13,14,19,33,52,39,91,0.000333,0.153013,14,6426.558108,357.031006,459.039865,134.013592,3,6
0,0,11,11,14,17,31,47,35,82,0.000333,0.135415,14,5687.417364,315.967631,406.244097,122.789837,2,6
0,0,7,7,10,13,23,27,29,56,0.000333,0.08444,10,2533.194695,140.733039,253.31947,81.324997,1,6
0,0,9,9,15,17,32,35,34,69,0.000333,0.115,14,4830,268.333333,345,128.090227,2,6
0,0,16,16,12,18,30,65,57,122,0.000333,0.199547,18,10775.53175,598.640653,598.640653,118.0782,1,6
0,0,18,18,16,20,36,73,62,135,0.000333,0.232647,24,16750.55701,930.5865,697.939875,150.438562,2,6
0,0,7,7,10,17,27,27,25,52,0.000333,0.082418,5,1236.270751,68.681708,247.25415,102.706149,2,6
0,0,10,10,14,20,34,39,34,73,0.000333,0.123795,7,2599.693512,144.427417,371.384787,139.741531,3,6
0,0,15,15,13,19,32,69,51,120,0.000333,0.2,12,7200,400,600,128.816339,2,6
0,0,18,18,17,22,39,82,59,141,0.000333,0.248414,16,11923.86741,662.437078,745.241713,167.594364,3,6
0,0,12,12,16,18,34,53,39,92,0.000333,0.156016,16,7488.745302,416.041406,468.046581,139.05865,3,6
0,0,10,10,13,15,28,41,33,74,0.000333,0.118581,12,4268.931171,237.162843,355.744264,106.709075,2,6
0,0,13,13,17,18,35,54,41,95,0.000333,0.162427,16,7796.510186,433.139455,487.281887,144.545518,3,6
0,0,21,21,14,22,36,95,72,167,0.000333,0.287792,21,18130.92698,1007.273721,863.377475,151.410465,2,6
0,0,10,10,14,16,30,49,34,83,0.000333,0.135757,14,5701.806872,316.767048,407.271919,117.302969,2,6
0,0,20,20,15,22,37,77,70,147,0.000333,0.255263,21,16081.58254,893.421252,765.789645,156.710855,2,6
0,0,9,9,13,17,30,36,31,67,0.000333,0.109587,6,1972.570019,109.587223,328.76167,117.592585,2,6
0,0,22,22,16,25,41,104,69,173,0.000333,0.308952,16,14829.70395,823.872442,926.856497,180.096405,5,6
0,0,9,9,14,17,31,37,35,72,0.000333,0.118901,14,4993.829881,277.434993,356.702134,122.789837,2,6
0,0,10,10,13,17,30,35,37,72,0.000333,0.117765,12,4239.553475,235.530749,353.296123,117.592585,2,6
0,0,14,14,13,18,31,46,47,93,0.000333,0.15358,12,5528.883082,307.160171,460.740257,123.164366,2,6
0,0,11,11,13,18,31,35,35,70,0.000333,0.115598,6,2080.76245,115.597914,346.793742,123.164366,2,6
0,0,17,17,15,23,38,78,53,131,0.000333,0.22916,14,9624.69906,534.705503,687.478504,162.645284,5,6
0,0,9,9,14,16,30,38,34,72,0.000333,0.117765,14,4946.14572,274.785873,353.296123,117.302969,2,6
0,0,19,19,15,22,37,83,71,154,0.000333,0.267419,21,16847.37218,935.965121,802.255818,156.710855,2,6
0,0,19,19,14,21,35,74,74,148,0.000333,0.253045,21,15941.81162,885.656201,759.133887,145.541635,2,6
0,0,17,17,14,20,34,68,64,132,0.000333,0.223848,21,14102.447,783.469278,671.545095,139.741531,2,6
0,0,17,17,15,21,36,78,52,130,0.000333,0.22403,14,9409.263503,522.736861,672.09025,150.842025,5,6
0,0,15,15,14,19,33,56,64,120,0.000333,0.201776,21,12711.87318,706.215177,605.327294,134.013592,2,6
0,0,17,17,11,20,31,73,69,142,0.000333,0.234499,15,10552.43814,586.246563,703.495876,124.49231,1,6
0,0,19,19,15,23,38,81,74,155,0.000333,0.271143,21,17082.00406,949.000225,813.428765,162.645284,2,6
0,0,9,9,11,14,25,27,24,51,0.000333,0.078946,5,1184.183328,65.787963,236.836666,91.356717,4,6
0,0,17,17,11,22,33,69,67,136,0.000333,0.228679,15,10290.564,571.698,686.0376,136.161243,1,6
0,0,19,19,15,25,40,77,72,149,0.000333,0.264322,14,11101.54201,616.752334,792.967286,174.699764,2,6
0,0,9,9,11,13,24,27,22,49,0.000333,0.074888,5,1123.315813,62.406434,224.663163,86.159464,4,6
0,0,17,17,14,20,34,74,54,128,0.000333,0.217065,14,9116.733412,506.48519,651.195244,139.741531,3,6
0,0,10,10,13,15,28,41,32,73,0.000333,0.116979,12,4211.242912,233.95794,350.936909,106.709075,2,6
0,0,17,17,14,19,33,74,53,127,0.000333,0.213546,14,8968.932744,498.274041,640.638053,134.013592,3,6
0,0,10,10,13,15,28,41,32,73,0.000333,0.116979,12,4211.242912,233.95794,350.936909,106.709075,2,6
0,0,17,17,14,19,33,74,53,127,0.000333,0.213546,14,8968.932744,498.274041,640.638053,134.013592,3,6
0,0,10,10,13,15,28,41,32,73,0.000333,0.116979,12,4211.242912,233.95794,350.936909,106.709075,2,6
0,0,17,17,14,19,33,74,54,128,0.000333,0.215227,14,9039.554262,502.197459,645.682447,134.013592,3,6
0,0,10,10,13,15,28,41,32,73,0.000333,0.116979,12,4211.242912,233.95794,350.936909,106.709075,2,6
0,0,16,16,15,20,35,64,56,120,0.000333,0.205171,14,8617.195468,478.733082,615.513962,145.041921,2,6
0,0,10,10,12,21,33,36,31,67,0.000333,0.112658,6,2027.846436,112.658135,337.974406,135.258216,4,6
0,0,11,11,12,21,33,37,33,70,0.000333,0.117703,6,2118.64553,117.702529,353.107588,135.258216,4,6
0,0,18,18,16,20,36,68,60,128,0.000333,0.220583,24,15882.0096,882.333867,661.7504,150.438562,2,6
0,0,10,10,12,17,29,35,33,68,0.000333,0.110114,6,1982.056246,110.114236,330.342708,112.506418,2,6
0,0,7,7,10,16,26,24,25,49,0.000333,0.076774,5,1151.607731,63.978207,230.321546,97.219281,2,6
0,0,9,9,10,17,27,30,31,61,0.000333,0.096683,5,1450.240688,80.568927,290.048138,102.706149,2,6
0,0,8,8,10,17,27,27,27,54,0.000333,0.085588,5,1283.819626,71.323313,256.763925,102.706149,2,6
0,0,23,23,15,22,37,111,72,183,0.000333,0.317777,21,20019.92928,1112.218294,953.329966,156.710855,3,6
0,0,10,10,14,15,29,44,32,76,0.000333,0.123069,14,5168.891779,287.160654,369.206556,111.906328,2,6
0,0,15,15,14,21,35,58,52,110,0.000333,0.188074,14,7899.095846,438.838658,564.221132,145.541635,3,6
0,0,15,15,15,20,35,58,51,109,0.000333,0.186364,14,7827.285884,434.849216,559.091849,145.041921,3,6
0,0,16,16,17,22,39,64,57,121,0.000333,0.213178,16,10232.5387,568.474372,639.533668,167.594364,3,6
0,0,14,14,14,19,33,55,50,105,0.000333,0.176554,14,7415.259355,411.958853,529.661383,134.013592,2,6
0,0,17,17,15,26,41,66,64,130,0.000333,0.232161,14,9750.744648,541.708036,696.481761,180.814792,2,6
0,0,20,20,17,28,45,79,72,151,0.000333,0.276423,16,13268.31708,737.128727,829.269818,204.092806,3,6
0,0,29,29,19,51,70,125,98,223,0.000333,0.45561,9,12301.47102,683.415056,1366.830113,370.004315,10,6
0,0,28,28,19,51,70,124,96,220,0.000333,0.449481,9,12135.98037,674.221132,1348.442264,370.004315,10,6
0,0,11,11,11,17,28,40,51,91,0.000333,0.145823,15,6562.039469,364.557748,437.469298,107.540616,1,6
0,0,14,14,15,20,35,53,59,112,0.000333,0.191493,14,8042.715771,446.817543,574.479698,145.041921,2,6
0,0,28,28,19,48,67,122,92,214,0.000333,0.432714,9,11683.28778,649.071543,1298.143087,348.788823,11,6
0,0,27,27,19,48,67,121,90,211,0.000333,0.426648,9,11519.50337,639.97241,1279.944819,348.788823,11,6
0,0,17,17,14,20,34,77,54,131,0.000333,0.222153,14,9330.406851,518.355936,666.457632,139.741531,3,6
0,0,10,10,14,15,29,44,32,76,0.000333,0.123069,14,5168.891779,287.160654,369.206556,111.906328,2,6
0,0,9,9,14,16,30,38,34,72,0.000333,0.117765,14,4946.14572,274.785873,353.296123,117.302969,2,6
0,0,14,14,10,25,35,51,66,117,0.000333,0.200042,10,6001.26113,333.403396,600.126113,149.315686,1,6
0,0,6,6,9,18,27,31,35,66,0.000333,0.104608,4,1255.290301,69.73835,313.822575,103.587975,1,6
0,0,26,26,18,48,66,115,89,204,0.000333,0.411019,9,11097.5076,616.5282,1233.0564,343.13685,9,6
0,0,25,25,18,48,66,114,87,201,0.000333,0.404974,9,10934.30896,607.461609,1214.923218,343.13685,9,6
0,0,17,17,15,21,36,78,52,130,0.000333,0.22403,14,9409.263503,522.736861,672.09025,150.842025,5,6
0,0,15,15,14,20,34,71,46,117,0.000333,0.198411,14,8333.264134,462.959119,595.233152,139.741531,5,6
0,0,17,17,14,20,34,55,53,108,0.000333,0.183149,14,7692.243816,427.346879,549.445987,139.741531,3,6
0,0,14,14,14,20,34,44,41,85,0.000333,0.144145,14,6054.080781,336.337821,432.434342,139.741531,3,6
0,0,15,15,11,22,33,52,47,99,0.000333,0.166465,10,4993.950178,277.441677,499.395018,136.161243,3,6
0,0,7,7,9,18,27,33,34,67,0.000333,0.106192,4,1274.309851,70.794992,318.577463,103.587975,1,6
0,0,15,15,14,20,34,71,46,117,0.000333,0.198411,14,8333.264134,462.959119,595.233152,139.741531,5,6
0,0,15,15,14,20,34,71,46,117,0.000333,0.198411,14,8333.264134,462.959119,595.233152,139.741531,5,6
0,0,8,8,12,13,25,25,24,49,0.000333,0.07585,6,1365.29372,75.849651,227.548953,91.125266,2,6
0,0,8,8,10,15,25,32,33,65,0.000333,0.100617,10,3018.506523,167.694807,301.850652,91.82264,1,6
0,0,10,10,14,18,32,40,38,78,0.000333,0.13,14,5460,303.333333,390,128.361619,2,6
0,0,17,17,10,21,31,73,66,139,0.000333,0.229544,15,10329.49931,573.861073,688.633287,125.457947,1,6
0,0,19,19,14,23,37,81,71,152,0.000333,0.263946,21,16628.57514,923.80973,791.836912,157.344894,2,6
0,0,7,7,10,14,24,32,30,62,0.000333,0.094756,10,2842.67675,157.926486,284.267675,86.52225,1,6
0,0,9,9,14,17,31,40,35,75,0.000333,0.123855,14,5201.906126,288.994785,371.564723,122.789837,2,6
0,0,7,7,11,13,24,22,19,41,0.000333,0.062661,5,939.917313,52.217628,187.983463,86.159464,3,6
0,0,7,7,11,14,25,22,20,42,0.000333,0.065014,5,975.2098,54.178322,195.04196,91.356717,3,6
0,0,9,9,12,13,25,26,22,48,0.000333,0.074302,6,1337.430583,74.301699,222.905097,91.125266,3,6
0,0,8,8,12,16,28,30,23,53,0.000333,0.08493,6,1528.738865,84.929937,254.789811,107.01955,2,6
0,0,13,13,13,16,29,45,30,75,0.000333,0.12145,6,2186.091448,121.449525,364.348575,112.105716,4,6
0,0,15,15,11,20,31,60,58,118,0.000333,0.194865,10,5845.951646,324.775091,584.595165,124.49231,1,6
0,0,17,17,15,23,38,68,63,131,0.000333,0.22916,14,9624.69906,534.705503,687.478504,162.645284,2,6
0,0,13,13,11,18,29,55,49,104,0.000333,0.16841,10,5052.300235,280.683346,505.230023,113.112398,2,6
0,0,15,15,14,21,35,63,54,117,0.000333,0.200042,14,8401.765582,466.764755,600.126113,145.541635,3,6
0,0,12,12,14,18,32,55,41,96,0.000333,0.16,14,6720,373.333333,480,128.361619,5,6
0,0,12,12,14,18,32,55,41,96,0.000333,0.16,14,6720,373.333333,480,128.361619,5,6
0,0,12,12,14,18,32,55,41,96,0.000333,0.16,14,6720,373.333333,480,128.361619,5,6
0,0,10,10,12,15,27,40,35,75,0.000333,0.118872,12,4279.398752,237.744375,356.616563,101.622909,2,6
0,0,13,13,16,18,34,53,43,96,0.000333,0.162799,16,7814.342924,434.130162,488.396433,139.05865,3,6
0,0,10,10,13,15,28,41,31,72,0.000333,0.115377,12,4153.554653,230.753036,346.129554,106.709075,2,6
0,0,18,18,13,19,32,77,62,139,0.000333,0.231667,18,12510,695,695,128.816339,2,6
0,0,21,21,17,22,39,90,70,160,0.000333,0.281888,24,20295.94452,1127.552473,845.664355,167.594364,3,6
0,0,10,10,13,16,29,44,33,77,0.000333,0.124688,12,4488.774439,249.376358,374.064537,112.105716,2,6
0,0,27,27,19,50,69,140,98,238,0.000333,0.48461,9,13084.45939,726.91441,1453.828821,362.903432,11,6
0,0,15,15,14,21,35,74,49,123,0.000333,0.210301,14,8832.625355,490.701409,630.901811,145.541635,5,6
0,0,33,33,19,49,68,140,103,243,0.000333,0.493084,18,26626.56247,1479.25347,1479.25347,355.831405,11,6
0,0,36,36,21,52,73,153,111,264,0.000333,0.544705,20,32682.27367,1815.681871,1634.113684,388.661531,12,6
0,0,10,10,13,16,29,39,30,69,0.000333,0.111734,6,2011.204132,111.733563,335.200689,112.105716,2,6
0,0,29,29,21,51,72,129,92,221,0.000333,0.454518,10,13635.53425,757.529681,1363.553425,381.532358,12,6
0,0,28,28,21,51,72,128,90,218,0.000333,0.448348,10,13450.4365,747.246472,1345.04365,381.532358,12,6
0,0,7,7,10,16,26,30,23,53,0.000333,0.083041,5,1245.616525,69.200918,249.123305,97.219281,2,6
0,0,10,10,13,19,32,43,31,74,0.000333,0.123333,6,2220,123.333333,370,128.816339,3,6
0,0,31,31,20,49,69,148,102,250,0.000333,0.509044,20,30542.62228,1696.812349,1527.131114,361.559344,11,6
0,0,15,15,14,21,35,74,49,123,0.000333,0.210301,14,8832.625355,490.701409,630.901811,145.541635,5,6
0,0,7,7,10,16,26,30,23,53,0.000333,0.083041,5,1245.616525,69.200918,249.123305,97.219281,2,6
0,0,10,10,14,19,33,43,31,74,0.000333,0.124428,7,2612.996154,145.166453,373.285165,134.013592,3,6
0,0,9,9,12,18,30,35,26,61,0.000333,0.099773,6,1795.921958,99.773442,299.320326,118.0782,2,6
0,0,12,12,15,21,36,48,34,82,0.000333,0.141311,7,2967.536951,164.863164,423.93385,150.842025,3,6
0,0,16,16,14,18,32,74,52,126,0.000333,0.21,14,8820,490,630,128.361619,2,6
0,0,10,10,14,15,29,44,32,76,0.000333,0.123069,14,5168.891779,287.160654,369.206556,111.906328,2,6
0,0,17,17,12,19,31,67,64,131,0.000333,0.216333,18,11681.9949,648.999717,648.999717,123.730173,2,6
0,0,19,19,15,21,36,75,69,144,0.000333,0.248156,21,15633.8532,868.5474,744.4692,150.842025,3,6
0,0,15,15,10,18,28,60,55,115,0.000333,0.184282,15,8292.687241,460.704847,552.845816,108.277931,1,6
0,0,17,17,14,20,34,68,60,128,0.000333,0.217065,21,13675.10012,759.727784,651.195244,139.741531,2,6
0,0,20,20,17,21,38,66,73,139,0.000333,0.243154,24,17507.08619,972.615899,729.461924,161.725534,2,6
0,0,9,9,15,16,31,32,32,64,0.000333,0.10569,14,4438.959894,246.608883,317.068564,122.603359,2,6
0,0,13,13,11,19,30,51,48,99,0.000333,0.161927,10,4857.82169,269.878983,485.782169,118.764371,2,6
0,0,16,16,14,21,35,63,57,120,0.000333,0.205171,14,8617.195468,478.733082,615.513962,145.541635,3,6
0,0,13,13,11,20,31,51,48,99,0.000333,0.163488,10,4904.654347,272.480797,490.465435,124.49231,2,6
0,0,16,16,14,22,36,63,57,120,0.000333,0.206797,14,8685.474002,482.526333,620.391,151.410465,3,6
0,0,20,20,13,20,33,98,64,162,0.000333,0.272397,18,14709.45325,817.191847,817.191847,134.544278,2,6
0,0,23,23,15,22,37,111,72,183,0.000333,0.317777,21,20019.92928,1112.218294,953.329966,156.710855,3,6
0,0,10,10,14,15,29,44,32,76,0.000333,0.123069,14,5168.891779,287.160654,369.206556,111.906328,2,6
0,0,13,13,11,15,26,53,40,93,0.000333,0.145714,10,4371.408938,242.856052,437.140894,96.657107,2,6
0,0,16,16,14,18,32,66,48,114,0.000333,0.19,14,7980,443.333333,570,128.361619,3,6
0,0,10,10,14,15,29,44,32,76,0.000333,0.123069,14,5168.891779,287.160654,369.206556,111.906328,2,6
0,0,13,13,14,18,32,52,38,90,0.000333,0.15,14,6300,350,450,128.361619,3,6
0,0,11,11,14,17,31,47,35,82,0.000333,0.135415,14,5687.417364,315.967631,406.244097,122.789837,2,6
0,0,16,16,14,21,35,65,56,121,0.000333,0.206881,14,8689.005431,482.722524,620.643245,145.541635,3,6
0,0,16,16,14,21,35,65,56,121,0.000333,0.206881,14,8689.005431,482.722524,620.643245,145.541635,3,6
0,0,16,16,15,19,34,65,55,120,0.000333,0.203499,14,8546.937573,474.829865,610.495541,139.313982,3,6
0,0,16,16,15,20,35,65,55,120,0.000333,0.205171,14,8617.195468,478.733082,615.513962,145.041921,3,6
0,0,17,17,17,22,39,71,61,132,0.000333,0.232558,16,11162.76949,620.15386,697.673093,167.594364,3,6
0,0,15,15,11,20,31,64,58,122,0.000333,0.201471,10,6044.119499,335.784417,604.41195,124.49231,2,6
0,0,17,17,14,23,37,72,63,135,0.000333,0.234425,14,9845.866861,546.992603,703.276204,157.344894,3,6
0,0,10,10,12,17,29,36,39,75,0.000333,0.12145,12,4372.182896,242.89905,364.348575,112.506418,4,6
0,0,9,9,13,14,27,29,33,62,0.000333,0.098268,12,3537.636302,196.53535,294.803025,101.408685,2,6
0,0,11,11,11,16,27,37,40,77,0.000333,0.122042,10,3661.263377,203.403521,366.126338,102.053748,2,6
0,0,9,9,12,12,24,36,29,65,0.000333,0.099341,12,3576.270751,198.681708,298.022563,86.0391,2,6
0,0,12,12,16,16,32,49,37,86,0.000333,0.143333,16,6880,382.222222,430,128,3,6
0,0,10,10,15,16,31,41,32,73,0.000333,0.120552,14,5063.188629,281.288257,361.656331,122.603359,2,6
0,0,18,18,13,20,33,60,69,129,0.000333,0.216909,18,11713.08315,650.726841,650.726841,134.544278,2,6
0,0,15,15,13,19,32,53,64,117,0.000333,0.195,18,10530,585,585,128.816339,2,6
0,0,19,19,17,21,38,83,59,142,0.000333,0.248402,16,11923.29131,662.405073,745.205707,161.725534,4,6
0,0,10,10,13,15,28,41,31,72,0.000333,0.115377,12,4153.554653,230.753036,346.129554,106.709075,2,6
0,0,4,4,10,11,21,17,16,33,0.000333,0.048315,5,724.732375,40.26291,144.946475,71.273029,2,6
0,0,10,10,11,14,25,29,36,65,0.000333,0.100617,10,3018.506523,167.694807,301.850652,91.356717,3,6
0,0,16,16,14,26,40,60,53,113,0.000333,0.200459,14,8419.290246,467.738347,601.377875,175.514402,4,6
0,0,19,19,16,28,44,73,61,134,0.000333,0.243855,16,11705.02139,650.278966,731.563837,198.605938,5,6
0,0,14,14,16,24,40,57,49,106,0.000333,0.188041,16,9025.990049,501.443892,564.124378,174.0391,2,6
0,0,20,20,15,26,41,70,57,127,0.000333,0.226803,14,9525.727464,529.207081,680.409105,180.814792,4,6
0,0,23,23,17,28,45,83,65,148,0.000333,0.270931,16,13004.70813,722.483785,812.794258,204.092806,5,6
0,0,14,14,16,24,40,57,49,106,0.000333,0.188041,16,9025.990049,501.443892,564.124378,174.0391,2,6
0,0,15,15,14,19,33,56,64,120,0.000333,0.201776,21,12711.87318,706.215177,605.327294,134.013592,2,6
0,0,10,10,15,17,32,39,35,74,0.000333,0.123333,14,5180,287.777778,370,128.090227,2,6
0,0,18,18,15,21,36,72,66,138,0.000333,0.237817,21,14982.44265,832.357925,713.44965,150.842025,2,6
0,0,15,15,11,21,32,62,53,115,0.000333,0.191667,10,5750,319.444444,575,130.292414,1,6
0,0,18,18,15,23,38,75,61,136,0.000333,0.237906,14,9992.053986,555.11411,713.718142,162.645284,2,6
0,0,9,9,13,16,29,37,30,67,0.000333,0.108495,6,1952.90836,108.494909,325.484727,112.105716,2,6
0,0,13,13,17,18,35,46,47,93,0.000333,0.159008,16,7632.373129,424.020729,477.023321,144.545518,3,6
0,0,13,13,17,20,37,44,46,90,0.000333,0.156284,16,7501.612847,416.756269,468.850803,155.92543,2,6
0,0,8,8,12,14,26,30,30,60,0.000333,0.094009,12,3384.316597,188.017589,282.026383,96.322519,3,6
0,0,8,8,12,16,28,28,29,57,0.000333,0.09134,6,1644.115383,91.339744,274.019231,107.01955,2,6
0,0,16,16,14,23,37,71,54,125,0.000333,0.217061,14,9116.54339,506.474633,651.181671,157.344894,4,6
0,0,12,12,14,21,35,53,42,95,0.000333,0.162427,14,6821.946413,378.997023,487.281887,145.541635,4,6
0,0,9,9,9,13,22,31,44,75,0.000333,0.111486,12,4013.488457,222.971581,334.457371,76.635041,1,6
0,0,9,9,11,20,31,32,29,61,0.000333,0.100735,5,1511.029875,83.946104,302.205975,124.49231,3,6
0,0,10,10,11,20,31,33,31,64,0.000333,0.10569,5,1585.342819,88.074601,317.068564,124.49231,3,6
0,0,15,15,11,19,30,59,50,109,0.000333,0.178284,10,5348.510749,297.139486,534.851075,118.764371,1,6
0,0,18,18,15,22,37,72,58,130,0.000333,0.225743,14,9481.205125,526.733618,677.228938,156.710855,2,6
0,0,10,10,14,16,30,46,33,79,0.000333,0.129215,14,5427.020999,301.501167,387.644357,117.302969,2,6
0,0,14,14,15,21,36,57,44,101,0.000333,0.174054,14,7310.273952,406.126331,522.162425,150.842025,2,6
0,0,13,13,15,21,36,55,42,97,0.000333,0.167161,14,7020.758152,390.04212,501.482725,150.842025,2,6
0,0,14,14,10,16,26,57,49,106,0.000333,0.166082,15,7473.699152,415.205508,498.24661,97.219281,1,6
0,0,17,17,14,19,33,70,57,127,0.000333,0.213546,21,13453.39912,747.411062,640.638053,134.013592,2,6
0,0,10,10,14,16,30,49,35,84,0.000333,0.137393,14,5770.50334,320.583519,412.17881,117.302969,2,6
0,0,14,14,14,19,33,56,47,103,0.000333,0.173191,14,7274.01632,404.112018,519.572594,134.013592,2,6
0,0,13,13,14,19,33,54,45,99,0.000333,0.166465,14,6991.530249,388.418347,499.395018,134.013592,2,6
0,0,12,12,10,14,24,50,39,89,0.000333,0.136021,10,4080.616626,226.700924,408.061663,86.52225,1,6
0,0,15,15,14,17,31,63,47,110,0.000333,0.181654,14,7629.462318,423.859018,544.961594,122.789837,2,6
0,0,10,10,14,15,29,44,32,76,0.000333,0.123069,14,5168.891779,287.160654,369.206556,111.906328,2,6
0,0,12,12,14,17,31,49,37,86,0.000333,0.14202,14,5964.852358,331.380687,426.060883,122.789837,2,6
0,0,11,11,14,17,31,47,35,82,0.000333,0.135415,14,5687.417364,315.967631,406.244097,122.789837,2,6
0,0,13,13,11,15,26,53,40,93,0.000333,0.145714,10,4371.408938,242.856052,437.140894,96.657107,2,6
0,0,16,16,15,18,33,66,48,114,0.000333,0.191687,14,8050.853014,447.269612,575.06093,133.662009,3,6
0,0,10,10,14,15,29,44,32,76,0.000333,0.123069,14,5168.891779,287.160654,369.206556,111.906328,2,6
0,0,13,13,15,18,33,52,38,90,0.000333,0.151332,14,6355.93659,353.107588,453.995471,133.662009,3,6
0,0,11,11,14,17,31,47,35,82,0.000333,0.135415,14,5687.417364,315.967631,406.244097,122.789837,2,6
0,0,16,16,13,18,31,64,46,110,0.000333,0.181654,12,6539.53913,363.307729,544.961594,123.164366,2,6
0,0,19,19,15,21,36,77,54,131,0.000333,0.225753,14,9481.642453,526.757914,677.260175,150.842025,3,6
0,0,10,10,14,15,29,44,32,76,0.000333,0.123069,14,5168.891779,287.160654,369.206556,111.906328,2,6
0,0,15,15,15,20,35,60,41,101,0.000333,0.172686,14,7252.806186,402.933677,518.057585,145.041921,3,6
0,0,15,15,15,21,36,61,42,103,0.000333,0.177501,14,7455.031852,414.168436,532.502275,150.842025,3,6
0,0,12,12,14,17,31,49,37,86,0.000333,0.14202,14,5964.852358,331.380687,426.060883,122.789837,2,6
0,0,15,15,12,16,28,57,43,100,0.000333,0.160245,12,5768.825906,320.490328,480.735492,107.01955,2,6
0,0,18,18,15,19,34,70,51,121,0.000333,0.205194,14,8618.162053,478.786781,615.583004,139.313982,3,6
0,0,10,10,14,15,29,44,32,76,0.000333,0.123069,14,5168.891779,287.160654,369.206556,111.906328,2,6
0,0,15,15,15,19,34,56,41,97,0.000333,0.164495,14,6908.774538,383.820808,493.483896,139.313982,3,6
0,0,11,11,14,17,31,47,35,82,0.000333,0.135415,14,5687.417364,315.967631,406.244097,122.789837,2,6
0,0,13,13,11,15,26,53,40,93,0.000333,0.145714,10,4371.408938,242.856052,437.140894,96.657107,2,6
0,0,16,16,14,18,32,66,48,114,0.000333,0.19,14,7980,443.333333,570,128.361619,3,6
0,0,10,10,14,15,29,44,32,76,0.000333,0.123069,14,5168.891779,287.160654,369.206556,111.906328,2,6
0,0,13,13,14,18,32,52,38,90,0.000333,0.15,14,6300,350,450,128.361619,3,6
0,0,11,11,14,17,31,47,35,82,0.000333,0.135415,14,5687.417364,315.967631,406.244097,122.789837,2,6
0,0,16,16,15,19,34,61,44,105,0.000333,0.178061,14,7478.570377,415.476132,534.183598,139.313982,5,6
0,0,12,12,14,19,33,58,44,102,0.000333,0.171509,14,7203.394802,400.1886,514.5282,134.013592,5,6
0,0,7,7,8,18,26,23,25,48,0.000333,0.075207,4,902.484426,50.138024,225.621106,99.05865,2,6
0,0,10,10,12,21,33,35,34,69,0.000333,0.116021,6,2088.379165,116.021065,348.063194,135.258216,3,6
0,0,18,18,16,22,38,64,67,131,0.000333,0.22916,24,16499.4841,916.638006,687.478504,162.107496,2,6
0,0,9,9,11,19,30,32,29,61,0.000333,0.099773,5,1496.601632,83.144535,299.320326,118.764371,3,6
0,0,10,10,11,19,30,33,31,64,0.000333,0.10468,5,1570.204991,87.233611,314.040998,118.764371,3,6
0,0,9,9,11,19,30,32,28,60,0.000333,0.098138,5,1472.067179,81.78151,294.413436,118.764371,3,6
0,0,10,10,11,19,30,33,30,63,0.000333,0.103045,5,1545.670538,85.870585,309.134108,118.764371,3,6
0,0,8,8,11,18,29,29,27,56,0.000333,0.090682,5,1360.234679,75.568593,272.046936,113.112398,2,6
0,0,9,9,11,18,29,30,29,59,0.000333,0.09554,5,1433.104394,79.616911,286.620879,113.112398,2,6
0,0,8,8,12,16,28,30,27,57,0.000333,0.09134,6,1644.115383,91.339744,274.019231,107.01955,4,6
0,0,8,8,12,16,28,30,27,57,0.000333,0.09134,6,1644.115383,91.339744,274.019231,107.01955,4,6
0,0,8,8,12,16,28,30,27,57,0.000333,0.09134,6,1644.115383,91.339744,274.019231,107.01955,4,6
0,0,8,8,12,16,28,30,27,57,0.000333,0.09134,6,1644.115383,91.339744,274.019231,107.01955,4,6
0,0,13,13,11,17,28,60,43,103,0.000333,0.165053,10,4951.57557,275.087532,495.157557,107.540616,2,6
0,0,16,16,14,20,34,73,51,124,0.000333,0.210282,14,8831.835492,490.657527,630.845392,139.741531,3,6
0,0,10,10,13,16,29,42,32,74,0.000333,0.11983,12,4313.887124,239.660396,359.490594,112.105716,2,6
0,0,12,12,14,21,35,53,42,95,0.000333,0.162427,14,6821.946413,378.997023,487.281887,145.541635,4,6
0,0,26,26,19,47,66,112,88,200,0.000333,0.40296,9,10879.90942,604.439412,1208.878824,341.776299,8,6
0,0,25,25,19,47,66,111,86,197,0.000333,0.396915,9,10716.71077,595.372821,1190.745642,341.776299,8,6
0,0,13,13,11,18,29,55,48,103,0.000333,0.166791,10,5003.720425,277.984468,500.372042,113.112398,2,6
0,0,15,15,14,20,34,63,53,116,0.000333,0.196715,14,8262.039654,459.002203,590.14569,139.741531,3,6
0,0,18,18,16,24,40,72,70,142,0.000333,0.251905,16,12091.42063,671.745591,755.713789,174.0391,2,6
0,0,20,20,20,26,46,80,75,155,0.000333,0.285384,20,17123.04206,951.280115,856.152103,208.649995,3,6
0,0,12,12,10,17,27,52,46,98,0.000333,0.155326,10,4659.789752,258.877208,465.978975,102.706149,1,6
0,0,14,14,14,19,33,60,51,111,0.000333,0.186643,14,7838.988461,435.499359,559.927747,134.013592,2,6
0,0,7,7,10,12,22,34,26,60,0.000333,0.089189,10,2675.658971,148.647721,267.565897,76.238831,1,6
0,0,10,10,14,15,29,47,34,81,0.000333,0.131165,14,5508.950448,306.052803,393.496461,111.906328,2,6
0,0,12,12,13,20,33,51,40,91,0.000333,0.153013,12,5508.478378,306.026577,459.039865,134.544278,5,6
0,0,12,12,14,19,33,58,44,102,0.000333,0.171509,14,7203.394802,400.1886,514.5282,134.013592,5,6
0,0,12,12,13,18,31,51,38,89,0.000333,0.146974,12,5291.081659,293.948981,440.923472,123.164366,5,6
0,0,12,12,14,19,33,58,44,102,0.000333,0.171509,14,7203.394802,400.1886,514.5282,134.013592,5,6
0,0,14,14,11,16,27,52,50,102,0.000333,0.161666,15,7274.977878,404.165438,484.998525,102.053748,1,6
0,0,16,16,15,19,34,60,55,115,0.000333,0.195019,14,8190.815174,455.045287,585.058227,139.313982,2,6
0,0,12,12,14,19,33,43,39,82,0.000333,0.13788,14,5790.964449,321.720247,413.640318,134.013592,2,6
0,0,10,10,10,20,30,39,37,76,0.000333,0.124308,5,1864.618426,103.589913,372.923685,119.657843,3,6
0,0,13,13,15,23,38,51,46,97,0.000333,0.169683,14,7126.685563,395.926976,509.048969,162.645284,4,6
0,0,9,9,11,20,31,33,32,65,0.000333,0.107341,5,1610.113801,89.450767,322.02276,124.49231,3,6
0,0,12,12,15,23,38,45,41,86,0.000333,0.150441,7,3159.252363,175.51402,451.321766,162.645284,4,6
0,0,19,19,15,20,35,81,56,137,0.000333,0.234237,14,9837.964827,546.553601,702.711773,145.041921,3,6
0,0,10,10,14,15,29,44,32,76,0.000333,0.123069,14,5168.891779,287.160654,369.206556,111.906328,2,6
0,0,27,27,18,49,67,118,90,208,0.000333,0.420582,9,11355.71897,630.873276,1261.746552,350.179432,10,6
0,0,26,26,18,49,67,117,88,205,0.000333,0.414516,9,11191.93456,621.774142,1243.548284,350.179432,10,6
0,0,27,27,19,49,68,118,90,208,0.000333,0.422064,9,11395.73044,633.096135,1266.192271,355.831405,10,6
0,0,26,26,19,49,68,117,88,205,0.000333,0.415977,9,11231.36894,623.964941,1247.929882,355.831405,10,6
0,0,15,15,14,21,35,72,47,119,0.000333,0.203462,14,8545.385506,474.743639,610.384679,145.541635,6,6
0,0,15,15,14,21,35,72,47,119,0.000333,0.203462,14,8545.385506,474.743639,610.384679,145.541635,6,6
0,0,18,18,15,22,37,73,63,136,0.000333,0.236162,14,9918.799208,551.0444,708.485658,156.710855,2,6
0,0,21,21,19,24,43,86,71,157,0.000333,0.283975,18,15334.6242,851.923566,851.923566,190.749723,3,6
0,0,20,20,19,23,42,84,68,152,0.000333,0.273211,18,14753.38047,819.632248,819.632248,184.752548,3,6
0,0,10,10,13,15,28,44,36,80,0.000333,0.128196,12,4615.060725,256.392263,384.588394,106.709075,2,6
0,0,13,13,18,19,37,57,44,101,0.000333,0.175385,18,9470.786219,526.15479,526.15479,155.769273,3,6
0,0,12,12,18,18,36,55,41,96,0.000333,0.165438,18,8933.630402,496.3128,496.3128,150.1173,3,6
0,0,16,16,13,19,32,63,50,113,0.000333,0.188333,12,6780,376.666667,565,128.816339,3,6
0,0,19,19,16,22,38,76,58,134,0.000333,0.234407,16,11251.55659,625.086477,703.222287,162.107496,4,6
0,0,12,12,16,18,34,53,39,92,0.000333,0.156016,16,7488.745302,416.041406,468.046581,139.05865,3,6
0,0,13,13,13,18,31,48,37,85,0.000333,0.140369,12,5053.280237,280.737791,421.106686,123.164366,3,6
0,0,11,11,13,17,30,43,33,76,0.000333,0.124308,6,2237.542112,124.307895,372.923685,117.592585,2,6
0,0,18,18,16,24,40,87,58,145,0.000333,0.257227,16,12346.87318,685.937399,771.679574,174.0391,6,6
0,0,15,15,11,19,30,64,57,121,0.000333,0.197911,15,8906.006431,494.778135,593.733762,118.764371,2,6
0,0,17,17,14,22,36,72,62,134,0.000333,0.230923,14,9698.779303,538.821072,692.76995,151.410465,3,6
0,0,17,17,13,20,33,69,60,129,0.000333,0.216909,18,11713.08315,650.726841,650.726841,134.544278,2,6
0,0,19,19,16,23,39,77,65,142,0.000333,0.250176,16,12008.43384,667.135213,750.527115,168.041925,3,6
0,0,15,15,11,19,30,64,57,121,0.000333,0.197911,15,8906.006431,494.778135,593.733762,118.764371,2,6
0,0,17,17,14,22,36,72,62,134,0.000333,0.230923,14,9698.779303,538.821072,692.76995,151.410465,3,6
0,0,12,12,10,18,28,40,43,83,0.000333,0.133003,10,3990.104585,221.672477,399.010459,108.277931,2,6
0,0,15,15,13,21,34,52,52,104,0.000333,0.176365,12,6349.153626,352.730757,529.096135,140.344382,3,6
0,0,12,12,13,20,33,38,37,75,0.000333,0.12611,6,2269.977354,126.109853,378.329559,134.544278,3,6
0,0,12,12,10,16,26,40,42,82,0.000333,0.128479,10,3854.360569,214.131143,385.436057,97.219281,2,6
0,0,15,15,14,19,33,52,51,103,0.000333,0.173191,14,7274.01632,404.112018,519.572594,134.013592,3,6
0,0,12,12,14,18,32,38,36,74,0.000333,0.123333,14,5180,287.777778,370,128.361619,3,6
0,0,12,12,13,15,28,41,42,83,0.000333,0.133003,12,4788.125502,266.006972,399.010459,106.709075,3,6
0,0,12,12,13,17,30,39,41,80,0.000333,0.13085,12,4710.614972,261.700832,392.551248,117.592585,2,6
0,0,16,16,14,20,34,66,58,124,0.000333,0.210282,14,8831.835492,490.657527,630.845392,139.741531,2,6
0,0,14,14,14,19,33,60,52,112,0.000333,0.188324,14,7909.609979,439.422777,564.972141,134.013592,2,6
0,0,8,8,11,14,25,31,30,61,0.000333,0.094425,10,2832.752276,157.375126,283.275228,91.356717,1,6
0,0,10,10,15,17,32,39,35,74,0.000333,0.123333,14,5180,287.777778,370,128.090227,2,6
0,0,19,19,10,20,30,72,79,151,0.000333,0.24698,15,11114.1072,617.4504,740.94048,119.657843,1,6
0,0,21,21,14,22,36,80,84,164,0.000333,0.282623,21,17805.22171,989.178984,847.8677,151.410465,2,6
0,0,8,8,13,14,27,31,27,58,0.000333,0.091928,6,1654.700851,91.927825,275.783475,101.408685,3,6
0,0,8,8,13,16,29,29,26,55,0.000333,0.089063,6,1603.133728,89.062985,267.188955,112.105716,2,6
0,0,6,6,7,16,23,20,23,43,0.000333,0.064838,3,583.539492,32.418861,194.513164,83.651484,1,6
0,0,9,9,12,19,31,32,32,64,0.000333,0.10569,6,1902.411383,105.689521,317.068564,123.730173,2,6
0,0,8,8,10,20,30,29,30,59,0.000333,0.096502,5,1447.532726,80.418485,289.506545,119.657843,2,6
0,0,11,11,15,23,38,41,39,80,0.000333,0.139945,7,2938.839408,163.268856,419.834201,162.645284,3,6
0,0,7,7,8,17,25,23,24,47,0.000333,0.072754,4,873.044964,48.502498,218.261241,93.486868,2,6
0,0,10,10,13,20,33,35,33,68,0.000333,0.11434,6,2058.112801,114.3396,343.0188,134.544278,3,6
0,0,16,16,14,19,33,71,51,122,0.000333,0.205139,14,8615.825156,478.656953,615.416083,134.013592,3,6
0,0,19,19,17,21,38,84,59,143,0.000333,0.250151,16,12007.25815,667.069897,750.453634,161.725534,4,6
0,0,12,12,16,18,34,53,39,92,0.000333,0.156016,16,7488.745302,416.041406,468.046581,139.05865,3,6
0,0,15,15,13,19,32,68,50,118,0.000333,0.196667,12,7080,393.333333,590,128.816339,2,6
0,0,18,18,17,21,38,81,58,139,0.000333,0.243154,16,11671.39079,648.410599,729.461924,161.725534,3,6
0,0,12,12,16,18,34,53,39,92,0.000333,0.156016,16,7488.745302,416.041406,468.046581,139.05865,3,6
0,0,13,13,14,22,36,53,47,100,0.000333,0.172331,14,7237.895002,402.105278,516.9925,151.410465,3,6
0,0,14,14,15,22,37,65,51,116,0.000333,0.201432,14,8460.152266,470.008459,604.29659,156.710855,5,6
0,0,13,13,13,20,33,54,49,103,0.000333,0.173191,12,6234.871132,346.38173,519.572594,134.544278,4,6
0,0,14,14,14,20,34,63,48,111,0.000333,0.188236,14,7905.917255,439.217625,564.708375,139.741531,3,6
0,0,13,13,14,20,34,61,46,107,0.000333,0.181453,14,7621.019336,423.389963,544.358524,139.741531,5,6
0,0,17,17,10,19,29,71,64,135,0.000333,0.218609,15,9837.411515,546.522862,655.827434,113.929904,1,6
0,0,20,20,14,21,35,84,72,156,0.000333,0.266723,21,16803.53116,933.529509,800.168151,145.541635,2,6
0,0,10,10,13,16,29,45,34,79,0.000333,0.127927,12,4605.365983,255.853666,383.780499,112.105716,2,6
0,0,19,19,10,20,30,77,74,151,0.000333,0.24698,15,11114.1072,617.4504,740.94048,119.657843,1,6
0,0,22,22,14,22,36,90,82,172,0.000333,0.296409,21,18673.76911,1037.431617,889.2271,151.410465,2,6
0,0,10,10,13,16,29,45,34,79,0.000333,0.127927,12,4605.365983,255.853666,383.780499,112.105716,2,6
0,0,17,17,15,25,40,65,58,123,0.000333,0.218199,14,9164.360179,509.131121,654.597156,174.699764,3,6
0,0,20,20,17,27,44,78,66,144,0.000333,0.262053,16,12578.53045,698.807247,786.158153,197.868831,4,6
0,0,18,18,16,27,43,70,61,131,0.000333,0.236947,16,11373.45093,631.858385,710.840683,192.381963,3,6
0,0,9,9,12,15,27,38,30,68,0.000333,0.107777,12,3879.988202,215.5549,323.33235,101.622909,2,6
0,0,12,12,15,18,33,51,38,89,0.000333,0.14965,14,6285.315073,349.184171,448.951077,133.662009,3,6
0,0,10,10,14,18,32,43,33,76,0.000333,0.126667,7,2660,147.777778,380,128.361619,2,6
0,0,15,15,14,20,34,71,46,117,0.000333,0.198411,14,8333.264134,462.959119,595.233152,139.741531,5,6
0,0,10,10,15,16,31,49,35,84,0.000333,0.138717,14,5826.134861,323.674159,416.15249,122.603359,2,6
0,0,10,10,15,17,32,39,35,74,0.000333,0.123333,14,5180,287.777778,370,128.090227,2,6
0,0,18,18,14,20,34,63,69,132,0.000333,0.223848,21,14102.447,783.469278,671.545095,139.741531,2,6
0,0,17,17,15,20,35,63,62,125,0.000333,0.21372,21,13464.36792,748.02044,641.160377,145.041921,2,6
0,0,15,15,11,18,29,55,54,109,0.000333,0.176507,15,7942.798927,441.266607,529.519928,113.112398,2,6
0,0,17,17,14,21,35,63,59,122,0.000333,0.208591,14,8760.815393,486.711966,625.772528,145.541635,3,6
0,0,14,14,14,21,35,52,47,99,0.000333,0.169266,14,7109.186261,394.954792,507.799019,145.541635,3,6
0,0,15,15,11,18,29,55,54,109,0.000333,0.176507,15,7942.798927,441.266607,529.519928,113.112398,2,6
0,0,17,17,14,21,35,63,59,122,0.000333,0.208591,14,8760.815393,486.711966,625.772528,145.541635,3,6
0,0,14,14,14,21,35,52,47,99,0.000333,0.169266,14,7109.186261,394.954792,507.799019,145.541635,3,6
0,0,18,18,13,22,35,64,64,128,0.000333,0.218849,12,7878.578714,437.698817,656.548226,146.213212,3,6
0,0,20,20,16,25,41,72,69,141,0.000333,0.251805,16,12086.63732,671.479851,755.414833,180.096405,4,6
0,0,14,14,13,21,34,47,46,93,0.000333,0.157711,12,5677.608531,315.422696,473.134044,140.344382,3,6
0,0,8,8,9,15,24,28,32,60,0.000333,0.091699,8,2200.782,122.265667,275.09775,87.132684,1,6
0,0,10,10,13,18,31,36,37,73,0.000333,0.120552,12,4339.875968,241.10422,361.656331,123.164366,2,6
0,0,18,18,14,20,34,67,52,119,0.000333,0.201803,14,8475.713094,470.87295,605.408078,139.741531,3,6
0,0,21,21,17,23,40,80,60,140,0.000333,0.248357,16,11921.11893,662.284385,745.069933,173.528793,4,6
0,0,12,12,16,18,34,53,39,92,0.000333,0.156016,16,7488.745302,416.041406,468.046581,139.05865,3,6
0,0,15,15,14,19,33,52,39,91,0.000333,0.153013,14,6426.558108,357.031006,459.039865,134.013592,3,6
0,0,11,11,13,17,30,43,33,76,0.000333,0.124308,6,2237.542112,124.307895,372.923685,117.592585,2,6
0,0,13,13,11,16,27,63,43,106,0.000333,0.168006,10,5040.180752,280.010042,504.018075,102.053748,2,6
0,0,16,16,15,19,34,76,51,127,0.000333,0.215369,14,9045.508932,502.528274,646.107781,139.313982,3,6
0,0,10,10,14,16,30,46,33,79,0.000333,0.129215,14,5427.020999,301.501167,387.644357,117.302969,2,6
0,0,15,15,13,18,31,55,59,114,0.000333,0.188259,18,10166.01083,564.778379,564.778379,123.164366,2,6
0,0,9,9,13,15,28,37,29,66,0.000333,0.105762,6,1903.712549,105.761808,317.285425,106.709075,2,6
0,0,19,19,15,21,36,85,64,149,0.000333,0.256773,21,16176.69533,898.705296,770.318825,150.842025,2,6
0,0,9,9,13,16,29,37,29,66,0.000333,0.106876,6,1923.760474,106.875582,320.626746,112.105716,2,6
0,0,20,20,14,22,36,85,67,152,0.000333,0.261943,21,16502.40061,916.800034,785.8286,151.410465,2,6
0,0,9,9,13,16,29,39,29,68,0.000333,0.110114,6,1982.056246,110.114236,330.342708,112.105716,2,6
0,0,33,33,19,51,70,140,104,244,0.000333,0.498515,18,26919.81101,1495.545056,1495.545056,370.004315,11,6
0,0,36,36,21,54,75,153,112,265,0.000333,0.550212,20,33012.73906,1834.041059,1650.636953,403.002591,12,6
0,0,10,10,13,16,29,39,30,69,0.000333,0.111734,6,2011.204132,111.733563,335.200689,112.105716,2,6
0,0,29,29,21,53,74,129,93,222,0.000333,0.4595,10,13784.98647,765.832582,1378.498647,395.81845,12,6
0,0,28,28,21,53,74,128,91,219,0.000333,0.45329,10,13598.70287,755.483493,1359.870287,395.81845,12,6
0,0,13,13,10,16,26,48,59,107,0.000333,0.167649,15,7544.205748,419.122542,502.94705,97.219281,1,6
0,0,15,15,14,19,33,56,64,120,0.000333,0.201776,21,12711.87318,706.215177,605.327294,134.013592,2,6
0,0,9,9,13,19,32,35,29,64,0.000333,0.106667,6,1920,106.666667,320,128.816339,3,6
0,0,8,8,11,19,30,32,27,59,0.000333,0.096502,5,1447.532726,80.418485,289.506545,118.764371,3,6
0,0,9,9,11,19,30,33,29,62,0.000333,0.101409,5,1521.136085,84.50756,304.227217,118.764371,3,6
0,0,12,12,13,21,34,43,45,88,0.000333,0.149232,12,5372.36076,298.464487,447.69673,140.344382,4,6
0,0,12,12,14,21,35,44,36,80,0.000333,0.136781,7,2872.398489,159.577694,410.342641,145.541635,4,6
0,0,10,10,12,20,32,38,33,71,0.000333,0.118333,6,2130,118.333333,355,129.458112,3,6
0,0,11,11,12,20,32,39,35,74,0.000333,0.123333,6,2220,123.333333,370,129.458112,3,6
0,0,15,15,10,17,27,51,59,110,0.000333,0.174346,15,7845.564379,435.864688,523.037625,102.706149,2,6
0,0,18,18,14,20,34,64,67,131,0.000333,0.222153,21,13995.61028,777.533904,666.457632,139.741531,3,6
0,0,10,10,13,17,30,41,32,73,0.000333,0.119401,6,2149.218081,119.401004,358.203013,117.592585,2,6
0,0,35,35,20,50,70,145,114,259,0.000333,0.529161,20,31749.68603,1763.871446,1587.484301,368.631371,10,6
0,0,38,38,22,53,75,158,122,280,0.000333,0.581356,22,38369.52313,2131.640174,1744.069233,401.68728,11,6
0,0,10,10,13,16,29,39,30,69,0.000333,0.111734,6,2011.204132,111.733563,335.200689,112.105716,2,6
0,0,36,36,19,51,70,147,122,269,0.000333,0.549592,18,29677.98837,1648.777132,1648.777132,370.004315,10,6
0,0,39,39,21,54,75,160,130,290,0.000333,0.602119,20,36127.14841,2007.0638,1806.35742,403.002591,11,6
0,0,10,10,13,17,30,41,32,73,0.000333,0.119401,6,2149.218081,119.401004,358.203013,117.592585,2,6
0,0,38,38,19,52,71,152,132,284,0.000333,0.582176,18,31437.50728,1746.528182,1746.528182,377.133488,10,6
0,0,41,41,21,55,76,165,140,305,0.000333,0.635206,20,38112.35783,2117.353213,1905.617892,410.21345,11,6
0,0,10,10,13,17,30,41,32,73,0.000333,0.119401,6,2149.218081,119.401004,358.203013,117.592585,2,6
0,0,36,36,19,52,71,155,119,274,0.000333,0.561677,18,30330.55279,1685.030711,1685.030711,377.133488,10,6
0,0,39,39,21,55,76,168,127,295,0.000333,0.61438,20,36862.77233,2047.931796,1843.138616,410.21345,11,6
0,0,10,10,13,17,30,42,32,74,0.000333,0.121037,6,2178.659424,121.036635,363.109904,117.592585,2,6
0,0,9,9,10,14,24,36,29,65,0.000333,0.099341,10,2980.225625,165.56809,298.022563,86.52225,2,6
0,0,12,12,14,17,31,49,37,86,0.000333,0.14202,14,5964.852358,331.380687,426.060883,122.789837,3,6
0,0,10,10,13,17,30,41,32,73,0.000333,0.119401,6,2149.218081,119.401004,358.203013,117.592585,2,6
0,0,15,15,14,19,33,68,50,118,0.000333,0.198413,14,8333.339085,462.963283,595.238506,134.013592,3,6
0,0,18,18,17,22,39,81,58,139,0.000333,0.24489,16,11754.73454,653.040807,734.670908,167.594364,4,6
0,0,10,10,13,15,28,41,31,72,0.000333,0.115377,12,4153.554653,230.753036,346.129554,106.709075,2,6
0,0,10,10,13,14,27,46,34,80,0.000333,0.126797,12,4564.692002,253.594,380.391,101.408685,2,6
0,0,13,13,17,17,34,59,42,101,0.000333,0.171278,16,8221.339951,456.741108,513.833747,138.973737,3,6
0,0,12,12,17,16,33,57,39,96,0.000333,0.161421,16,7748.189367,430.454965,484.261835,133.486868,3,6
0,0,17,17,14,18,32,68,62,130,0.000333,0.216667,21,13650,758.333333,650,128.361619,1,6
0,0,20,20,18,20,38,81,70,151,0.000333,0.264146,27,21395.80047,1188.655582,792.437055,161.497212,2,6
0,0,9,9,12,19,31,33,29,62,0.000333,0.102387,6,1842.961027,102.386724,307.160171,123.730173,3,6
0,0,10,10,12,19,31,34,31,65,0.000333,0.107341,6,1932.136561,107.34092,322.02276,123.730173,3,6
0,0,16,16,14,20,34,70,52,122,0.000333,0.20689,14,8689.386533,482.743696,620.670467,139.741531,3,6
0,0,19,19,17,22,39,83,60,143,0.000333,0.251938,16,12093.00028,671.833349,755.812517,167.594364,4,6
0,0,10,10,13,15,28,41,31,72,0.000333,0.115377,12,4153.554653,230.753036,346.129554,106.709075,2,6
0,0,15,15,14,21,35,63,54,117,0.000333,0.200042,14,8401.765582,466.764755,600.126113,145.541635,3,6
0,0,26,26,19,48,67,115,89,204,0.000333,0.412494,9,11137.33975,618.741097,1237.482195,348.788823,9,6
0,0,25,25,19,48,67,114,87,201,0.000333,0.406428,9,10973.55535,609.641964,1219.283927,348.788823,9,6
0,0,17,17,12,18,30,74,59,133,0.000333,0.217539,18,11747.09609,652.616449,652.616449,118.0782,2,6
0,0,20,20,15,20,35,87,67,154,0.000333,0.263303,21,16588.10128,921.561182,789.909585,145.041921,3,6
0,0,10,10,14,15,29,44,32,76,0.000333,0.123069,14,5168.891779,287.160654,369.206556,111.906328,2,6
0,0,12,12,14,19,33,56,42,98,0.000333,0.164784,14,6920.908732,384.49493,494.350624,134.013592,6,6
0,0,13,13,10,16,26,52,43,95,0.000333,0.148847,10,4465.417732,248.078763,446.541773,97.219281,1,6
0,0,16,16,14,19,33,65,51,116,0.000333,0.19505,14,8192.09605,455.116447,585.149718,134.013592,2,6
0,0,9,9,13,16,29,37,30,67,0.000333,0.108495,6,1952.90836,108.494909,325.484727,112.105716,2,6
0,0,12,12,13,18,31,42,34,76,0.000333,0.125506,6,2259.113518,125.506307,376.51892,123.164366,2,6
0,0,11,11,13,18,31,40,32,72,0.000333,0.118901,6,2140.212806,118.900711,356.702134,123.164366,2,6
0,0,13,13,9,16,25,49,43,92,0.000333,0.142412,8,3417.878156,189.88212,427.234769,92.529325,1,6
0,0,16,16,13,19,32,62,51,113,0.000333,0.188333,12,6780,376.666667,565,128.816339,2,6
0,0,9,9,13,16,29,37,30,67,0.000333,0.108495,6,1952.90836,108.494909,325.484727,112.105716,2,6
0,0,13,13,13,18,31,45,38,83,0.000333,0.137066,12,4934.379525,274.132196,411.198294,123.164366,2,6
0,0,12,12,13,18,31,43,36,79,0.000333,0.130461,12,4696.578102,260.921006,391.381509,123.164366,2,6
0,0,14,14,10,19,29,51,48,99,0.000333,0.160313,10,4809.401185,267.188955,480.940119,113.929904,1,6
0,0,17,17,14,22,36,64,56,120,0.000333,0.206797,14,8685.474002,482.526333,620.391,151.410465,2,6
0,0,9,9,13,16,29,37,30,67,0.000333,0.108495,6,1952.90836,108.494909,325.484727,112.105716,2,6
0,0,13,13,14,20,34,46,39,85,0.000333,0.144145,7,3027.040391,168.168911,432.434342,139.741531,2,6
0,0,12,12,14,20,34,44,37,81,0.000333,0.137361,7,2884.591431,160.255079,412.08449,139.741531,2,6
0,0,16,16,11,20,31,69,55,124,0.000333,0.204773,10,6143.203425,341.289079,614.320342,124.49231,1,6
0,0,19,19,15,22,37,82,63,145,0.000333,0.25179,14,10575.19033,587.510574,755.370738,156.710855,2,6
0,0,10,10,14,15,29,44,32,76,0.000333,0.123069,14,5168.891779,287.160654,369.206556,111.906328,2,6
0,0,11,11,13,20,33,39,35,74,0.000333,0.124428,6,2239.710989,124.428388,373.285165,134.544278,3,6
0,0,12,12,13,20,33,40,37,77,0.000333,0.129473,6,2330.510083,129.472782,388.418347,134.544278,3,6
0,0,11,11,13,22,35,39,36,75,0.000333,0.128232,6,2308.177358,128.232075,384.696226,146.213212,3,6
0,0,12,12,13,22,35,40,38,78,0.000333,0.133361,6,2400.504452,133.361358,400.084075,146.213212,3,6
0,0,10,10,12,20,32,36,31,67,0.000333,0.111667,6,2010,111.666667,335,129.458112,3,6
0,0,11,11,12,20,32,37,33,70,0.000333,0.116667,6,2100,116.666667,350,129.458112,3,6
0,0,10,10,14,17,31,38,37,75,0.000333,0.123855,14,5201.906126,288.994785,371.564723,122.789837,2,6
0,0,14,14,11,18,29,57,50,107,0.000333,0.173268,10,5198.039665,288.779981,519.803966,113.112398,2,6
0,0,16,16,14,20,34,65,55,120,0.000333,0.203499,14,8546.937573,474.829865,610.495541,139.741531,3,6
0,0,16,16,13,19,32,62,53,115,0.000333,0.191667,12,6900,383.333333,575,128.816339,2,6
0,0,18,18,16,21,37,70,58,128,0.000333,0.22227,16,10668.96049,592.720027,666.810031,156.238666,3,6
0,0,14,14,11,19,30,57,51,108,0.000333,0.176648,10,5299.441843,294.413436,529.944184,118.764371,2,6
0,0,16,16,14,21,35,65,56,121,0.000333,0.206881,14,8689.005431,482.722524,620.643245,145.541635,3,6
0,0,8,8,10,14,24,36,30,66,0.000333,0.100869,10,3026.07525,168.115292,302.607525,86.52225,1,6
0,0,11,11,14,17,31,49,38,87,0.000333,0.143672,14,6034.211106,335.23395,431.015079,122.789837,2,6
0,0,10,10,14,16,30,46,33,79,0.000333,0.129215,14,5427.020999,301.501167,387.644357,117.302969,2,6
0,0,3,3,10,9,19,12,14,26,0.000333,0.036815,5,552.230577,30.679476,110.446115,61.748606,1,6
0,0,19,19,18,23,41,80,71,151,0.000333,0.269663,27,21842.73952,1213.485529,808.990353,179.100575,5,6
0,0,17,17,12,25,37,62,54,116,0.000333,0.201432,12,7251.559085,402.864394,604.29659,159.115955,3,6
0,0,20,20,15,27,42,75,62,137,0.000333,0.246249,14,10342.46482,574.581379,738.747487,186.985321,4,6
0,0,10,10,13,16,29,39,30,69,0.000333,0.111734,6,2011.204132,111.733563,335.200689,112.105716,2,6
0,0,13,13,14,23,37,53,41,94,0.000333,0.16323,7,3427.820315,190.434462,489.688616,157.344894,4,6
0,0,14,14,14,23,37,54,43,97,0.000333,0.168439,7,3537.218835,196.512158,505.316976,157.344894,4,6
0,0,16,16,13,22,35,62,49,111,0.000333,0.189783,12,6832.204979,379.566943,569.350415,146.213212,3,6
0,0,19,19,15,24,39,75,57,132,0.000333,0.232558,14,9767.4233,542.634628,697.673093,168.642459,4,6
0,0,10,10,13,16,29,39,30,69,0.000333,0.111734,6,2011.204132,111.733563,335.200689,112.105716,2,6
0,0,12,12,13,21,34,50,36,86,0.000333,0.145841,6,2625.130826,145.840601,437.521804,140.344382,4,6
0,0,13,13,13,21,34,51,38,89,0.000333,0.150928,6,2716.705157,150.928064,452.784193,140.344382,4,6
0,0,9,9,11,12,23,37,27,64,0.000333,0.096503,10,2895.079652,160.837758,289.507965,81.073298,2,6
0,0,12,12,15,15,30,50,35,85,0.000333,0.139029,14,5839.199809,324.399989,417.085701,117.206718,3,6
0,0,10,10,14,15,29,42,30,72,0.000333,0.116592,14,4896.844843,272.046936,349.774632,111.906328,2,6
0,0,15,15,14,20,34,54,51,105,0.000333,0.178061,14,7478.570377,415.476132,534.183598,139.741531,3,6
0,0,12,12,14,20,34,43,39,82,0.000333,0.139057,7,2920.203671,162.233537,417.171953,139.741531,3,6
0,0,27,27,20,49,69,118,90,208,0.000333,0.423524,10,12705.73087,705.873937,1270.573087,361.559344,10,6
0,0,26,26,20,49,69,117,88,205,0.000333,0.417416,10,12522.47514,695.693063,1252.247514,361.559344,10,6
0,0,18,18,16,21,37,79,55,134,0.000333,0.232689,16,11169.06802,620.503779,698.066751,156.238666,3,6
0,0,21,21,18,24,42,92,63,155,0.000333,0.278603,18,15044.56561,835.809201,835.809201,185.09775,4,6
0,0,10,10,13,15,28,41,31,72,0.000333,0.115377,12,4153.554653,230.753036,346.129554,106.709075,2,6
0,0,15,15,14,18,32,68,49,117,0.000333,0.195,14,8190,455,585,128.361619,3,6
0,0,18,18,17,21,38,81,57,138,0.000333,0.241405,16,11587.42395,643.745775,724.213997,161.725534,4,6
0,0,10,10,13,15,28,41,31,72,0.000333,0.115377,12,4153.554653,230.753036,346.129554,106.709075,2,6
0,0,18,18,16,23,39,86,57,143,0.000333,0.251938,16,12093.00028,671.833349,755.812517,168.041925,5,6
0,0,18,18,16,23,39,86,57,143,0.000333,0.251938,16,12093.00028,671.833349,755.812517,168.041925,5,6
0,0,18,18,16,23,39,86,57,143,0.000333,0.251938,16,12093.00028,671.833349,755.812517,168.041925,5,6
0,0,18,18,16,23,39,86,57,143,0.000333,0.251938,16,12093.00028,671.833349,755.812517,168.041925,5,6
0,0,17,17,15,20,35,58,53,111,0.000333,0.189783,14,7970.905808,442.8281,569.350415,145.041921,3,6
0,0,14,14,15,20,35,47,41,88,0.000333,0.150459,14,6319.276677,351.070926,451.376905,145.041921,3,6
0,0,15,15,14,20,34,54,51,105,0.000333,0.178061,14,7478.570377,415.476132,534.183598,139.741531,3,6
0,0,12,12,14,20,34,43,39,82,0.000333,0.139057,7,2920.203671,162.233537,417.171953,139.741531,3,6
0,0,17,17,16,20,36,59,53,112,0.000333,0.193011,16,9264.505603,514.694756,579.0316,150.438562,3,6
0,0,14,14,16,20,36,48,41,89,0.000333,0.153374,16,7361.973202,408.998511,460.123325,150.438562,3,6
0,0,18,18,10,19,29,64,73,137,0.000333,0.221848,15,9983.150945,554.619497,665.543396,113.929904,1,6
0,0,20,20,14,22,36,72,78,150,0.000333,0.258496,21,16285.26376,904.736875,775.48875,151.410465,2,6
0,0,8,8,11,15,26,33,31,64,0.000333,0.100276,10,3008.28142,167.126746,300.828142,96.657107,1,6
0,0,10,10,15,18,33,41,36,77,0.000333,0.129473,14,5437.856861,302.103159,388.418347,133.662009,2,6
0,0,17,17,11,21,32,60,64,124,0.000333,0.206667,15,9300,516.666667,620,130.292414,1,6
0,0,19,19,15,24,39,68,69,137,0.000333,0.241367,14,10137.40146,563.18897,724.100104,168.642459,2,6
0,0,15,15,15,23,38,56,53,109,0.000333,0.190675,14,8008.337386,444.907633,572.024099,162.645284,2,6
0,0,15,15,12,19,31,61,46,107,0.000333,0.1767,12,6361.188063,353.399337,530.099005,123.730173,2,6
0,0,18,18,15,21,36,74,54,128,0.000333,0.220583,14,9264.505603,514.694756,661.7504,150.842025,3,6
0,0,9,9,13,16,29,37,30,67,0.000333,0.108495,6,1952.90836,108.494909,325.484727,112.105716,2,6
0,0,19,19,13,20,33,91,62,153,0.000333,0.257264,18,13892.26141,771.7923,771.7923,134.544278,2,6
0,0,22,22,15,22,37,104,70,174,0.000333,0.302148,21,19035.3426,1057.519033,906.444886,156.710855,3,6
0,0,9,9,13,16,29,37,30,67,0.000333,0.108495,6,1952.90836,108.494909,325.484727,112.105716,2,6
0,0,15,15,14,21,35,63,54,117,0.000333,0.200042,14,8401.765582,466.764755,600.126113,145.541635,3,6
0,0,16,16,17,22,39,69,59,128,0.000333,0.22551,16,10824.50374,601.361319,676.531484,167.594364,3,6
0,0,12,12,11,17,28,49,45,94,0.000333,0.15063,10,4518.913627,251.050757,451.891363,107.540616,2,6
0,0,15,15,14,20,34,61,54,115,0.000333,0.195019,14,8190.815174,455.045287,585.058227,139.741531,3,6
0,0,18,18,11,21,32,67,72,139,0.000333,0.231667,15,10425,579.166667,695,130.292414,1,6
0,0,20,20,15,23,38,75,77,152,0.000333,0.265895,21,16751.38462,930.632479,797.684982,162.645284,2,6
0,0,7,7,10,13,23,27,29,56,0.000333,0.08444,10,2533.194695,140.733039,253.31947,81.324997,1,6
0,0,9,9,15,17,32,35,34,69,0.000333,0.115,14,4830,268.333333,345,128.090227,2,6
0,0,7,7,11,15,26,30,30,60,0.000333,0.094009,10,2820.263831,156.681324,282.026383,96.657107,1,6
0,0,9,9,14,18,32,38,35,73,0.000333,0.121667,7,2555,141.944444,365,128.361619,2,6
0,0,14,14,14,19,33,60,52,112,0.000333,0.188324,14,7909.609979,439.422777,564.972141,134.013592,2,6
0,0,17,17,14,19,33,77,53,130,0.000333,0.21859,14,9180.797297,510.044294,655.771236,134.013592,3,6
0,0,10,10,14,15,29,44,32,76,0.000333,0.123069,14,5168.891779,287.160654,369.206556,111.906328,2,6
0,0,9,9,11,12,23,37,27,64,0.000333,0.096503,10,2895.079652,160.837758,289.507965,81.073298,2,6
0,0,12,12,15,15,30,50,35,85,0.000333,0.139029,14,5839.199809,324.399989,417.085701,117.206718,3,6
0,0,10,10,14,15,29,42,30,72,0.000333,0.116592,14,4896.844843,272.046936,349.774632,111.906328,2,6
0,0,14,14,14,21,35,59,47,106,0.000333,0.181235,14,7611.855997,422.880889,543.704,145.541635,3,6
0,0,35,35,20,50,70,144,106,250,0.000333,0.510774,20,30646.41509,1702.578616,1532.320754,368.631371,11,6
0,0,38,38,22,53,75,157,114,271,0.000333,0.56267,22,37136.21703,2063.123168,1688.009865,401.68728,12,6
0,0,10,10,13,16,29,39,30,69,0.000333,0.111734,6,2011.204132,111.733563,335.200689,112.105716,2,6
0,0,31,31,22,52,74,133,95,228,0.000333,0.471918,11,15573.30904,865.183836,1415.755367,394.530361,12,6
0,0,30,30,22,52,74,132,93,225,0.000333,0.465709,11,15368.39708,853.799838,1397.127007,394.530361,12,6
0,0,14,14,12,17,29,49,50,99,0.000333,0.160313,12,5771.281422,320.626746,480.940119,112.506418,2,6
0,0,16,16,16,20,36,57,55,112,0.000333,0.193011,16,9264.505603,514.694756,579.0316,150.438562,3,6
0,0,11,11,13,18,31,37,36,73,0.000333,0.120552,12,4339.875968,241.10422,361.656331,123.164366,2,6
0,0,15,15,13,17,30,52,51,103,0.000333,0.16847,18,9097.375164,505.409731,505.409731,117.592585,3,6
0,0,17,17,16,20,36,60,56,116,0.000333,0.199904,16,9595.380803,533.076711,599.7113,150.438562,4,6
0,0,12,12,13,18,31,40,37,77,0.000333,0.127158,12,4577.677391,254.315411,381.473116,123.164366,3,6
0,0,13,13,13,19,32,61,47,108,0.000333,0.18,12,6480,360,540,128.816339,2,6
0,0,16,16,17,22,39,74,55,129,0.000333,0.227272,16,10909.07018,606.059454,681.816886,167.594364,3,6
0,0,9,9,13,16,29,37,30,67,0.000333,0.108495,6,1952.90836,108.494909,325.484727,112.105716,2,6
0,0,12,12,11,18,29,55,42,97,0.000333,0.157075,10,4712.241565,261.791198,471.224157,113.112398,2,6
0,0,15,15,14,21,35,68,50,118,0.000333,0.201752,14,8473.575544,470.754197,605.255396,145.541635,3,6
0,0,9,9,13,16,29,37,30,67,0.000333,0.108495,6,1952.90836,108.494909,325.484727,112.105716,2,6
0,0,18,18,16,24,40,87,58,145,0.000333,0.257227,16,12346.87318,685.937399,771.679574,174.0391,6,6
0,0,18,18,16,24,40,87,58,145,0.000333,0.257227,16,12346.87318,685.937399,771.679574,174.0391,6,6
0,0,7,7,9,15,24,24,29,53,0.000333,0.081001,4,972.01205,54.000669,243.003013,87.132684,1,6
0,0,10,10,13,18,31,36,38,74,0.000333,0.122204,12,4399.326324,244.407018,366.610527,123.164366,2,6
0,0,16,16,10,20,30,50,64,114,0.000333,0.186462,15,8390.782918,466.154607,559.385528,119.657843,1,6
0,0,19,19,14,23,37,62,73,135,0.000333,0.234425,21,14768.80029,820.488905,703.276204,157.344894,2,6
0,0,15,15,13,18,31,67,50,117,0.000333,0.193214,12,6955.69162,386.427312,579.640968,123.164366,2,6
0,0,18,18,17,20,37,80,58,138,0.000333,0.239635,16,11502.47303,639.02628,718.904564,155.92543,3,6
0,0,10,10,13,15,28,41,31,72,0.000333,0.115377,12,4153.554653,230.753036,346.129554,106.709075,2,6
0,0,5,5,11,12,23,18,17,35,0.000333,0.052775,5,791.623342,43.979075,158.324668,81.073298,2,6
0,0,12,12,11,15,26,34,54,88,0.000333,0.13788,15,6204.580428,344.698913,413.638695,96.657107,2,6
0,0,16,16,11,19,30,71,57,128,0.000333,0.209361,15,9421.229944,523.401664,628.081996,118.764371,1,6
0,0,19,19,15,21,36,84,65,149,0.000333,0.256773,21,16176.69533,898.705296,770.318825,150.842025,2,6
0,0,10,10,13,17,30,46,34,80,0.000333,0.13085,12,4710.614972,261.700832,392.551248,117.592585,2,6
0,0,35,35,21,50,71,145,106,251,0.000333,0.514529,20,30871.73054,1715.096141,1543.586527,374.431475,11,6
0,0,38,38,23,53,76,158,114,272,0.000333,0.566479,22,37387.59824,2077.088791,1699.436284,407.621709,12,6
0,0,10,10,13,16,29,39,30,69,0.000333,0.111734,6,2011.204132,111.733563,335.200689,112.105716,2,6
0,0,31,31,23,52,75,134,95,229,0.000333,0.475466,11,15690.39428,871.688571,1426.39948,400.46479,12,6
0,0,30,30,23,52,75,133,93,226,0.000333,0.469238,11,15484.84327,860.26907,1407.713024,400.46479,12,6
0,0,19,19,16,20,36,78,56,134,0.000333,0.230923,16,11084.3192,615.795511,692.76995,150.438562,3,6
0,0,9,9,13,15,28,34,27,61,0.000333,0.09775,6,1759.491901,97.74955,293.24865,106.709075,2,6
0,0,14,14,14,23,37,63,43,106,0.000333,0.184067,7,3865.414397,214.745244,552.202057,157.344894,5,6
0,0,15,15,14,23,37,64,45,109,0.000333,0.189277,7,3974.812918,220.82294,567.830417,157.344894,5,6
0,0,13,13,11,16,27,54,40,94,0.000333,0.148986,10,4469.594252,248.310792,446.959425,102.053748,2,6
0,0,16,16,14,19,33,67,48,115,0.000333,0.193368,14,8121.474532,451.19303,580.105324,134.013592,3,6
0,0,10,10,14,16,30,46,33,79,0.000333,0.129215,14,5427.020999,301.501167,387.644357,117.302969,2,6
0,0,13,13,14,19,33,53,38,91,0.000333,0.153013,14,6426.558108,357.031006,459.039865,134.013592,3,6
0,0,11,11,14,18,32,48,35,83,0.000333,0.138333,7,2905,161.388889,415,128.361619,2,6
0,0,10,10,15,16,31,31,37,68,0.000333,0.112295,14,4716.394887,262.021938,336.885349,122.603359,2,6
0,0,7,7,10,15,25,23,24,47,0.000333,0.072754,5,1091.306205,60.628122,218.261241,91.82264,1,6
0,0,7,7,12,14,26,38,28,66,0.000333,0.10341,12,3722.748257,206.819348,310.229021,96.322519,1,6
0,0,10,10,15,17,32,51,36,87,0.000333,0.145,14,6090,338.333333,435,128.090227,2,6
0,0,9,9,11,18,29,36,29,65,0.000333,0.105256,5,1578.843823,87.713546,315.768765,113.112398,3,6
0,0,12,12,15,21,36,49,37,86,0.000333,0.148205,7,3112.294851,172.905269,444.61355,150.842025,4,6
0,0,10,10,12,18,30,40,30,70,0.000333,0.114494,6,2060.89405,114.494114,343.482342,118.0782,3,6
0,0,13,13,9,16,25,50,56,106,0.000333,0.164083,12,5906.985073,328.165837,492.248756,92.529325,1,6
0,0,16,16,13,19,32,63,64,127,0.000333,0.211667,18,11430,635,635,128.816339,2,6
0,0,10,10,13,16,29,45,34,79,0.000333,0.127927,12,4605.365983,255.853666,383.780499,112.105716,2,6
0,0,12,12,16,15,31,35,48,83,0.000333,0.137066,24,9868.75905,548.264392,411.198294,122.603359,2,6
0,0,7,7,12,11,23,33,26,59,0.000333,0.088963,12,3202.681865,177.92677,266.890155,81.073298,1,6
0,0,10,10,16,15,31,46,34,80,0.000333,0.132112,16,6341.371277,352.298404,396.335705,122.603359,2,6
0,0,12,12,11,17,28,55,41,96,0.000333,0.153835,10,4615.060725,256.392263,461.506073,107.540616,2,6
0,0,15,15,14,20,34,68,49,117,0.000333,0.198411,14,8333.264134,462.959119,595.233152,139.741531,3,6
0,0,9,9,13,16,29,37,30,67,0.000333,0.108495,6,1952.90836,108.494909,325.484727,112.105716,2,6
0,0,12,12,10,17,27,46,39,85,0.000333,0.134722,10,4041.654377,224.536354,404.165438,102.706149,2,6
0,0,15,15,13,20,33,59,47,106,0.000333,0.178235,12,6416.46932,356.470518,534.705777,134.544278,3,6
0,0,9,9,13,16,29,37,30,67,0.000333,0.108495,6,1952.90836,108.494909,325.484727,112.105716,2,6
0,0,12,12,13,19,32,42,34,76,0.000333,0.126667,6,2280,126.666667,380,128.816339,3,6
0,0,10,10,13,17,30,37,30,67,0.000333,0.109587,6,1972.570019,109.587223,328.76167,117.592585,2,6
0,0,9,9,12,15,27,38,30,68,0.000333,0.107777,12,3879.988202,215.5549,323.33235,101.622909,2,6
0,0,12,12,15,18,33,51,38,89,0.000333,0.14965,14,6285.315073,349.184171,448.951077,133.662009,3,6
0,0,10,10,14,18,32,43,33,76,0.000333,0.126667,7,2660,147.777778,380,128.361619,2,6
0,0,12,12,12,20,32,45,38,83,0.000333,0.138333,6,2490,138.333333,415,129.458112,4,6
0,0,7,7,10,16,26,26,27,53,0.000333,0.083041,5,1245.616525,69.200918,249.123305,97.219281,1,6
0,0,16,16,14,25,39,60,51,111,0.000333,0.19556,14,8213.515048,456.306392,586.679646,169.399374,4,6
0,0,19,19,16,27,43,73,59,132,0.000333,0.238756,16,11460.27116,636.681731,716.266948,192.381963,5,6
0,0,14,14,16,24,40,57,49,106,0.000333,0.188041,16,9025.990049,501.443892,564.124378,174.0391,2,6
0,0,16,16,13,21,34,65,64,129,0.000333,0.218761,18,11813.08872,656.282707,656.282707,140.344382,1,6
0,0,18,18,17,23,40,73,69,142,0.000333,0.251905,24,18137.13095,1007.618386,755.713789,173.528793,2,6
0,0,11,11,13,22,35,39,36,75,0.000333,0.128232,6,2308.177358,128.232075,384.696226,146.213212,3,6
0,0,12,12,13,22,35,40,38,78,0.000333,0.133361,6,2400.504452,133.361358,400.084075,146.213212,3,6
0,0,11,11,15,22,37,43,37,80,0.000333,0.138919,7,2917.293885,162.071882,416.756269,156.710855,4,6
0,0,12,12,15,22,37,44,39,83,0.000333,0.144128,7,3026.692405,168.149578,432.384629,156.710855,4,6
0,0,10,10,11,15,26,37,30,67,0.000333,0.104976,10,3149.294611,174.960812,314.929461,96.657107,2,6
0,0,13,13,15,18,33,50,38,88,0.000333,0.147969,14,6214.693555,345.260753,443.906683,133.662009,3,6
0,0,25,25,19,46,65,130,97,227,0.000333,0.455692,18,24607.39488,1367.077494,1367.077494,334.794473,8,6
0,0,15,15,13,19,32,64,54,118,0.000333,0.196667,12,7080,393.333333,590,128.816339,1,6
0,0,18,18,17,21,38,77,62,139,0.000333,0.243154,16,11671.39079,648.410599,729.461924,161.725534,2,6
0,0,10,10,12,18,30,35,33,68,0.000333,0.111223,6,2002.011363,111.222854,333.668561,118.0782,2,6
0,0,11,11,12,18,30,36,35,71,0.000333,0.11613,6,2090.335394,116.129744,348.389232,118.0782,2,6
0,0,10,10,14,21,35,39,35,74,0.000333,0.126522,7,2656.968603,147.609367,379.566943,145.541635,3,6
0,0,11,11,14,21,35,40,37,77,0.000333,0.131652,7,2764.683546,153.59353,394.954792,145.541635,3,6
0,0,9,9,11,18,29,32,29,61,0.000333,0.098779,5,1481.684204,82.315789,296.336841,113.112398,2,6
0,0,10,10,11,18,29,33,31,64,0.000333,0.103637,5,1554.553918,86.364107,310.910784,113.112398,2,6
0,0,10,10,11,18,29,33,33,66,0.000333,0.106876,5,1603.133728,89.062985,320.626746,113.112398,2,6
0,0,11,11,11,18,29,34,35,69,0.000333,0.111734,5,1676.003443,93.111302,335.200689,113.112398,2,6
0,0,17,17,12,19,31,69,55,124,0.000333,0.204773,12,7371.84411,409.546895,614.320342,123.730173,3,6
0,0,20,20,16,22,38,82,63,145,0.000333,0.25365,16,12175.19183,676.399546,760.949489,162.107496,4,6
0,0,12,12,16,18,34,53,39,92,0.000333,0.156016,16,7488.745302,416.041406,468.046581,139.05865,3,6
0,0,14,14,16,19,35,54,42,96,0.000333,0.164137,16,7878.578714,437.698817,492.41117,144.710623,3,6
0,0,11,11,13,17,30,43,33,76,0.000333,0.124308,6,2237.542112,124.307895,372.923685,117.592585,2,6
0,0,13,13,11,17,28,62,42,104,0.000333,0.166655,10,4999.649119,277.758284,499.964912,107.540616,2,6
0,0,16,16,15,19,34,75,50,125,0.000333,0.211978,14,8903.059972,494.614443,635.932855,139.313982,3,6
0,0,10,10,14,16,30,46,33,79,0.000333,0.129215,14,5427.020999,301.501167,387.644357,117.302969,2,6
0,0,19,19,16,27,43,73,76,149,0.000333,0.269504,16,12936.21518,718.678621,808.513448,192.381963,3,6
0,0,22,22,18,29,47,86,84,170,0.000333,0.31476,18,16997.04189,944.280105,944.280105,215.940099,4,6
0,0,19,19,15,27,42,81,71,152,0.000333,0.273211,14,11474.85148,637.491749,819.632248,186.985321,3,6
0,0,22,22,17,29,46,94,79,173,0.000333,0.318525,16,15289.21949,849.401083,955.576218,210.368317,4,6
0,0,17,17,16,25,41,72,64,136,0.000333,0.242876,16,11658.03316,647.668509,728.627073,180.096405,3,6
0,0,20,20,18,27,45,85,72,157,0.000333,0.287407,18,15519.97685,862.220936,862.220936,203.440613,4,6
0,0,5,5,10,14,24,20,20,40,0.000333,0.061133,5,916.9925,50.944028,183.3985,86.52225,1,6
0,0,8,8,14,17,31,33,28,61,0.000333,0.100735,7,2115.441825,117.524546,302.205975,122.789837,2,6
0,0,15,15,13,19,32,52,52,104,0.000333,0.173333,12,6240,346.666667,520,128.816339,3,6
0,0,17,17,16,22,38,60,57,117,0.000333,0.204669,16,9824.120305,545.784461,614.007519,162.107496,4,6
0,0,12,12,13,20,33,40,38,78,0.000333,0.131154,6,2360.776448,131.154247,393.462741,134.544278,3,6
0,0,15,15,13,19,32,52,52,104,0.000333,0.173333,12,6240,346.666667,520,128.816339,3,6
0,0,17,17,16,22,38,60,57,117,0.000333,0.204669,16,9824.120305,545.784461,614.007519,162.107496,4,6
0,0,12,12,13,20,33,40,38,78,0.000333,0.131154,6,2360.776448,131.154247,393.462741,134.544278,3,6
0,0,16,16,12,18,30,58,57,115,0.000333,0.188097,18,10157.26353,564.292418,564.292418,118.0782,3,6
0,0,18,18,16,21,37,66,62,128,0.000333,0.22227,16,10668.96049,592.720027,666.810031,156.238666,4,6
0,0,13,13,16,20,36,46,43,89,0.000333,0.153374,16,7361.973202,408.998511,460.123325,150.438562,3,6
0,0,13,13,11,18,29,60,44,104,0.000333,0.16841,10,5052.300235,280.683346,505.230023,113.112398,2,6
0,0,16,16,14,21,35,73,52,125,0.000333,0.21372,14,8976.24528,498.680293,641.160377,145.541635,3,6
0,0,10,10,13,16,29,42,32,74,0.000333,0.11983,12,4313.887124,239.660396,359.490594,112.105716,2,6
0,0,7,7,11,13,24,22,19,41,0.000333,0.062661,5,939.917313,52.217628,187.983463,86.159464,3,6
0,0,15,15,13,19,32,70,57,127,0.000333,0.211667,18,11430,635,635,128.816339,1,6
0,0,18,18,17,22,39,83,65,148,0.000333,0.260747,16,12515.83245,695.324025,782.239528,167.594364,2,6
0,0,32,32,21,49,70,134,97,231,0.000333,0.471955,10,14158.64377,786.591321,1415.864377,367.359448,12,6
0,0,29,29,20,50,70,125,93,218,0.000333,0.445395,10,13361.83698,742.324276,1336.183698,368.631371,11,6
0,0,28,28,20,50,70,124,91,215,0.000333,0.439265,10,13177.95849,732.108805,1317.795849,368.631371,11,6
0,0,15,15,13,18,31,65,46,111,0.000333,0.183305,12,6598.989485,366.610527,549.91579,123.164366,2,6
0,0,18,18,16,21,37,78,54,132,0.000333,0.229216,16,11002.36551,611.242528,687.647844,156.238666,3,6
0,0,10,10,13,16,29,42,32,74,0.000333,0.11983,12,4313.887124,239.660396,359.490594,112.105716,2,6
0,0,29,29,20,50,70,128,105,233,0.000333,0.476041,20,28562.45886,1586.80327,1428.122943,368.631371,11,6
0,0,29,29,21,50,71,129,96,225,0.000333,0.461231,10,13836.93102,768.71839,1383.693102,374.431475,11,6
0,0,28,28,20,50,70,124,95,219,0.000333,0.447438,10,13423.12981,745.729434,1342.312981,368.631371,10,6
0,0,27,27,20,50,70,123,93,216,0.000333,0.441308,10,13239.25132,735.513962,1323.925132,368.631371,10,6
0,0,16,16,15,20,35,66,58,124,0.000333,0.21201,14,8904.435317,494.690851,636.031094,145.041921,2,6
0,0,28,28,21,50,71,126,91,217,0.000333,0.444832,10,13344.95125,741.386181,1334.495125,374.431475,12,6
0,0,27,27,20,50,70,121,90,211,0.000333,0.431093,10,12932.78717,718.488176,1293.278717,368.631371,11,6
0,0,26,26,20,50,70,120,88,208,0.000333,0.424964,10,12748.90868,708.272704,1274.890868,368.631371,11,6
0,0,16,16,17,22,39,66,59,125,0.000333,0.220225,16,10570.80444,587.266913,660.675277,167.594364,3,6
0,0,15,15,10,18,28,60,59,119,0.000333,0.190692,15,8581.128536,476.729363,572.075236,108.277931,1,6
0,0,17,17,14,20,34,68,64,132,0.000333,0.223848,21,14102.447,783.469278,671.545095,139.741531,2,6
0,0,17,17,12,19,31,67,64,131,0.000333,0.216333,18,11681.9949,648.999717,648.999717,123.730173,2,6
0,0,19,19,15,21,36,75,69,144,0.000333,0.248156,21,15633.8532,868.5474,744.4692,150.842025,3,6
0,0,18,18,13,23,36,67,52,119,0.000333,0.205074,12,7382.652902,410.147383,615.221075,152.147641,4,6
0,0,21,21,16,25,41,80,60,140,0.000333,0.250019,16,12000.91649,666.717583,750.057281,180.096405,5,6
0,0,10,10,13,16,29,39,30,69,0.000333,0.111734,6,2011.204132,111.733563,335.200689,112.105716,2,6
0,0,16,16,13,22,35,62,49,111,0.000333,0.189783,12,6832.204979,379.566943,569.350415,146.213212,3,6
0,0,19,19,15,24,39,75,57,132,0.000333,0.232558,14,9767.4233,542.634628,697.673093,168.642459,4,6
0,0,10,10,13,16,29,39,30,69,0.000333,0.111734,6,2011.204132,111.733563,335.200689,112.105716,2,6
0,0,12,12,13,21,34,50,36,86,0.000333,0.145841,6,2625.130826,145.840601,437.521804,140.344382,4,6
0,0,13,13,13,21,34,51,38,89,0.000333,0.150928,6,2716.705157,150.928064,452.784193,140.344382,4,6
0,0,15,15,11,22,33,58,44,102,0.000333,0.171509,10,5145.282002,285.849,514.5282,136.161243,4,6
0,0,18,18,14,24,38,71,52,123,0.000333,0.215165,14,9036.931178,502.051732,645.495084,163.342069,5,6
0,0,10,10,13,16,29,39,30,69,0.000333,0.111734,6,2011.204132,111.733563,335.200689,112.105716,2,6
0,0,12,12,13,21,34,50,35,85,0.000333,0.144145,6,2594.606049,144.144781,432.434342,140.344382,5,6
0,0,13,13,13,21,34,51,37,88,0.000333,0.149232,6,2686.18038,149.232243,447.69673,140.344382,5,6
0,0,15,15,14,21,35,72,47,119,0.000333,0.203462,14,8545.385506,474.743639,610.384679,145.541635,6,6
0,0,9,9,12,14,26,29,26,55,0.000333,0.086175,6,1551.145107,86.174728,258.524184,96.322519,2,6
0,0,15,15,14,21,35,72,47,119,0.000333,0.203462,14,8545.385506,474.743639,610.384679,145.541635,6,6
0,0,15,15,14,21,35,72,47,119,0.000333,0.203462,14,8545.385506,474.743639,610.384679,145.541635,6,6
0,0,10,10,13,15,28,42,37,79,0.000333,0.126594,12,4557.372466,253.187359,379.781039,106.709075,2,6
0,0,12,12,17,18,35,50,42,92,0.000333,0.157298,16,7550.304601,419.461367,471.894038,144.545518,3,6
0,0,17,17,12,25,37,62,54,116,0.000333,0.201432,12,7251.559085,402.864394,604.29659,159.115955,3,6
0,0,20,20,15,27,42,75,62,137,0.000333,0.246249,14,10342.46482,574.581379,738.747487,186.985321,4,6
0,0,10,10,13,16,29,39,30,69,0.000333,0.111734,6,2011.204132,111.733563,335.200689,112.105716,2,6
0,0,13,13,14,23,37,53,41,94,0.000333,0.16323,7,3427.820315,190.434462,489.688616,157.344894,4,6
0,0,14,14,14,23,37,54,43,97,0.000333,0.168439,7,3537.218835,196.512158,505.316976,157.344894,4,6
0,0,15,15,16,22,38,71,53,124,0.000333,0.216914,16,10411.88819,578.438233,650.743012,162.107496,6,6
0,0,26,26,19,47,66,142,101,243,0.000333,0.489596,18,26438.17988,1468.787771,1468.787771,341.776299,7,6
0,0,15,15,16,22,38,71,53,124,0.000333,0.216914,16,10411.88819,578.438233,650.743012,162.107496,6,6
0,0,25,25,20,45,65,113,83,196,0.000333,0.393461,10,11803.84091,655.76894,1180.384091,333.571951,10,6
0,0,24,24,19,47,66,108,81,189,0.000333,0.380797,9,10281.5144,571.195244,1142.390489,341.776299,9,6
0,0,23,23,19,47,66,107,79,186,0.000333,0.374752,9,10118.31576,562.128653,1124.257306,341.776299,9,6
0,0,20,20,13,22,35,86,71,157,0.000333,0.268432,18,14495.35381,805.297434,805.297434,146.213212,2,6
0,0,22,22,15,24,39,94,76,170,0.000333,0.299506,21,18868.88592,1048.27144,898.518377,168.642459,3,6
0,0,13,13,10,18,28,52,49,101,0.000333,0.161848,10,4855.428471,269.746026,485.542847,108.277931,1,6
0,0,15,15,14,20,34,60,54,114,0.000333,0.193324,14,8119.590695,451.088372,579.970764,139.741531,2,6
0,0,20,20,17,26,43,76,69,145,0.000333,0.262269,16,12588.93423,699.385235,786.808389,191.698301,4,6
0,0,24,24,18,46,64,105,81,186,0.000333,0.372,9,10044,558,1116,329.1425,8,6
0,0,23,23,18,46,64,104,79,183,0.000333,0.366,9,9882,549,1098,329.1425,8,6
0,0,7,7,12,14,26,32,30,62,0.000333,0.097142,12,3497.12715,194.284842,291.427263,96.322519,1,6
0,0,9,9,15,17,32,40,35,75,0.000333,0.125,14,5250,291.666667,375,128.090227,2,6
0,0,29,29,23,52,75,130,106,236,0.000333,0.49,22,32340.02664,1796.668147,1470.001211,400.46479,10,6
0,0,13,13,10,16,26,61,44,105,0.000333,0.164515,10,4935.461704,274.192317,493.54617,97.219281,1,6
0,0,16,16,14,18,32,74,52,126,0.000333,0.21,14,8820,490,630,128.361619,2,6
0,0,10,10,14,15,29,44,32,76,0.000333,0.123069,14,5168.891779,287.160654,369.206556,111.906328,2,6
0,0,14,14,11,17,28,64,45,109,0.000333,0.174667,10,5240.016865,291.112048,524.001687,107.540616,2,6
0,0,17,17,15,19,34,77,53,130,0.000333,0.220457,14,9259.182371,514.399021,661.370169,139.313982,3,6
0,0,10,10,14,15,29,44,32,76,0.000333,0.123069,14,5168.891779,287.160654,369.206556,111.906328,2,6
0,0,14,14,11,16,27,64,45,109,0.000333,0.172761,10,5182.827377,287.934854,518.282738,102.053748,2,6
0,0,17,17,15,18,33,77,53,130,0.000333,0.21859,14,9180.797297,510.044294,655.771236,133.662009,3,6
0,0,10,10,14,15,29,44,32,76,0.000333,0.123069,14,5168.891779,287.160654,369.206556,111.906328,2,6
0,0,16,16,12,18,30,68,48,116,0.000333,0.189733,12,6830.391709,379.466206,569.199309,118.0782,2,6
0,0,19,19,15,20,35,81,56,137,0.000333,0.234237,14,9837.964827,546.553601,702.711773,145.041921,3,6
0,0,10,10,14,15,29,44,32,76,0.000333,0.123069,14,5168.891779,287.160654,369.206556,111.906328,2,6
0,0,20,20,13,20,33,98,64,162,0.000333,0.272397,18,14709.45325,817.191847,817.191847,134.544278,2,6
0,0,23,23,15,22,37,111,72,183,0.000333,0.317777,21,20019.92928,1112.218294,953.329966,156.710855,3,6
0,0,10,10,14,15,29,44,32,76,0.000333,0.123069,14,5168.891779,287.160654,369.206556,111.906328,2,6
0,0,10,10,12,19,31,39,36,75,0.000333,0.123855,6,2229.38834,123.854908,371.564723,123.730173,2,6
0,0,10,10,12,19,31,39,36,75,0.000333,0.123855,6,2229.38834,123.854908,371.564723,123.730173,2,6
0,0,7,7,11,15,26,30,30,60,0.000333,0.094009,10,2820.263831,156.681324,282.026383,96.657107,1,6
0,0,9,9,14,18,32,38,35,73,0.000333,0.121667,7,2555,141.944444,365,128.361619,2,6
0,0,15,15,16,21,37,70,52,122,0.000333,0.211851,16,10168.85297,564.936276,635.553311,156.238666,5,6
0,0,15,15,16,21,37,70,52,122,0.000333,0.211851,16,10168.85297,564.936276,635.553311,156.238666,5,6
0,0,15,15,16,21,37,70,52,122,0.000333,0.211851,16,10168.85297,564.936276,635.553311,156.238666,5,6
0,0,15,15,16,21,37,70,52,122,0.000333,0.211851,16,10168.85297,564.936276,635.553311,156.238666,5,6
0,0,19,19,16,23,39,88,64,152,0.000333,0.267794,16,12854.0982,714.116566,803.381137,168.041925,5,6
0,0,15,15,13,22,35,61,53,114,0.000333,0.194913,12,7016.859167,389.825509,584.738264,146.213212,4,6
0,0,17,17,13,23,36,67,63,130,0.000333,0.22403,12,8065.083002,448.060167,672.09025,152.147641,4,6
0,0,19,19,12,21,33,67,68,135,0.000333,0.226998,18,12257.87771,680.993206,680.993206,135.258216,2,6
0,0,21,21,16,24,40,75,73,148,0.000333,0.262548,24,18903.48859,1050.193811,787.645358,174.0391,3,6
0,0,15,15,13,20,33,50,50,100,0.000333,0.168146,12,6053.272943,336.292941,504.439412,134.544278,2,6
0,0,33,33,19,50,69,140,103,243,0.000333,0.49479,18,26718.68597,1484.371443,1484.371443,362.903432,11,6
0,0,36,36,21,53,74,153,111,264,0.000333,0.546432,20,32785.91377,1821.439654,1639.295689,395.81845,12,6
0,0,10,10,13,16,29,39,30,69,0.000333,0.111734,6,2011.204132,111.733563,335.200689,112.105716,2,6
0,0,29,29,21,52,73,129,92,221,0.000333,0.455984,10,13679.51228,759.972904,1367.951228,388.661531,12,6
0,0,28,28,21,52,73,128,90,218,0.000333,0.449794,10,13493.81754,749.65653,1349.381754,388.661531,12,6
0,0,39,39,25,51,76,148,121,269,0.000333,0.560231,24,40336.62003,2240.923335,1680.692501,405.390097,10,6
0,0,12,12,17,18,35,55,41,96,0.000333,0.164137,16,7878.578714,437.698817,492.41117,144.545518,3,6
0,0,10,10,14,16,30,46,34,80,0.000333,0.13085,14,5495.717467,305.317637,392.551248,117.302969,2,6
0,0,28,28,19,49,68,122,92,214,0.000333,0.434239,9,11724.45343,651.358524,1302.717048,355.831405,11,6
0,0,27,27,19,49,68,121,90,211,0.000333,0.428152,9,11560.09194,642.22733,1284.45466,355.831405,11,6
0,0,13,13,11,19,30,55,48,103,0.000333,0.16847,10,5054.097313,280.783184,505.409731,118.764371,2,6
0,0,15,15,14,21,35,63,53,116,0.000333,0.198332,14,8329.95562,462.775312,594.99683,145.541635,3,6
0,0,18,18,13,21,34,83,65,148,0.000333,0.250982,18,13553.00101,752.944501,752.944501,140.344382,2,6
0,0,20,20,15,23,38,91,70,161,0.000333,0.281639,21,17743.24292,985.735718,844.91633,162.645284,3,6
0,0,9,9,11,18,29,32,28,60,0.000333,0.09716,5,1457.394299,80.96635,291.47886,113.112398,3,6
0,0,10,10,11,18,29,33,30,63,0.000333,0.102018,5,1530.264013,85.014667,306.052803,113.112398,3,6
0,0,9,9,11,18,29,32,29,61,0.000333,0.098779,5,1481.684204,82.315789,296.336841,113.112398,3,6
0,0,10,10,11,18,29,33,31,64,0.000333,0.103637,5,1554.553918,86.364107,310.910784,113.112398,3,6
0,0,17,17,15,22,37,59,60,119,0.000333,0.206642,14,8678.949307,482.16385,619.924951,156.710855,2,6
0,0,13,13,15,21,36,47,44,91,0.000333,0.156821,14,6586.484452,365.915803,470.463175,150.842025,2,6
0,0,16,16,17,21,38,60,56,116,0.000333,0.20292,16,9740.153465,541.119637,608.759592,161.725534,3,6
0,0,13,13,17,21,38,49,44,93,0.000333,0.162686,16,7808.91614,433.828674,488.057259,161.725534,3,6
0,0,10,10,12,18,30,38,35,73,0.000333,0.119401,6,2149.218081,119.401004,358.203013,118.0782,1,6
0,0,10,10,12,18,30,38,35,73,0.000333,0.119401,6,2149.218081,119.401004,358.203013,118.0782,1,6
0,0,10,10,12,18,30,38,35,73,0.000333,0.119401,6,2149.218081,119.401004,358.203013,118.0782,1,6
0,0,14,14,12,20,32,56,47,103,0.000333,0.171667,12,6180,343.333333,515,129.458112,1,6
0,0,19,19,13,21,34,62,73,135,0.000333,0.228936,18,12362.5347,686.807484,686.807484,140.344382,2,6
0,0,21,21,17,24,41,70,78,148,0.000333,0.264306,24,19030.02472,1057.223596,792.917697,179.525968,3,6
0,0,9,9,14,16,30,38,36,74,0.000333,0.121037,14,5083.538657,282.418814,363.109904,117.302969,2,6
0,0,11,11,17,19,36,46,41,87,0.000333,0.149928,16,7196.535602,399.807533,449.783475,150.197491,3,6
0,0,17,17,15,21,36,60,65,125,0.000333,0.215414,21,13571.05313,753.947396,646.240625,150.842025,2,6
0,0,19,19,19,24,43,68,70,138,0.000333,0.249608,18,13478.84165,748.824536,748.824536,190.749723,3,6
0,0,9,9,12,18,30,38,31,69,0.000333,0.112858,6,2031.452707,112.858484,338.575451,118.0782,4,6
0,0,11,11,13,21,34,41,33,74,0.000333,0.125491,6,2258.833502,125.49075,376.47225,140.344382,5,6
0,0,9,9,11,21,32,35,29,64,0.000333,0.106667,5,1600,88.888889,320,130.292414,4,6
0,0,10,10,11,21,32,36,31,67,0.000333,0.111667,5,1675,93.055556,335,130.292414,4,6
0,0,35,35,20,50,70,144,106,250,0.000333,0.510774,20,30646.41509,1702.578616,1532.320754,368.631371,11,6
0,0,38,38,22,53,75,157,114,271,0.000333,0.56267,22,37136.21703,2063.123168,1688.009865,401.68728,12,6
0,0,10,10,13,16,29,39,30,69,0.000333,0.111734,6,2011.204132,111.733563,335.200689,112.105716,2,6
0,0,31,31,22,52,74,133,95,228,0.000333,0.471918,11,15573.30904,865.183836,1415.755367,394.530361,12,6
0,0,30,30,22,52,74,132,93,225,0.000333,0.465709,11,15368.39708,853.799838,1397.127007,394.530361,12,6
0,0,18,18,17,22,39,67,67,134,0.000333,0.236081,24,16997.85354,944.325196,708.243897,167.594364,2,6
0,0,17,17,16,22,38,60,57,117,0.000333,0.204669,16,9824.120305,545.784461,614.007519,162.107496,4,6
0,0,12,12,13,20,33,40,38,78,0.000333,0.131154,6,2360.776448,131.154247,393.462741,134.544278,3,6
0,0,17,17,14,20,34,69,61,130,0.000333,0.220457,21,13888.77356,771.598531,661.370169,139.741531,2,6
0,0,19,19,18,22,40,77,66,143,0.000333,0.253679,27,20547.96437,1141.553576,761.035718,173.166146,3,6
0,0,19,19,16,21,37,74,64,138,0.000333,0.239635,24,17253.70955,958.539419,718.904564,156.238666,3,6
0,0,21,21,19,23,42,82,69,151,0.000333,0.271413,27,21984.47813,1221.359896,814.239931,184.752548,4,6
0,0,16,16,16,25,41,66,51,117,0.000333,0.208945,16,10029.33735,557.185408,626.833585,180.096405,5,6
0,0,19,19,18,27,45,79,59,138,0.000333,0.252625,18,13641.76309,757.875727,757.875727,203.440613,6,6
0,0,19,19,18,26,44,89,66,155,0.000333,0.282071,18,15231.81422,846.211901,846.211901,197.270083,6,6
0,0,16,16,15,24,39,66,55,121,0.000333,0.213178,14,8953.471359,497.415075,639.533668,168.642459,3,6
0,0,19,19,17,26,43,79,63,142,0.000333,0.256843,16,12328.47352,684.915196,770.529595,191.698301,4,6
0,0,21,21,18,27,45,95,72,167,0.000333,0.305713,18,16508.51041,917.139467,917.139467,203.440613,6,6
0,0,14,14,11,18,29,59,53,112,0.000333,0.181365,10,5440.938715,302.274373,544.093871,113.112398,1,6
0,0,16,16,15,21,36,67,58,125,0.000333,0.215414,14,9047.368753,502.631597,646.240625,150.842025,2,6
0,0,16,16,14,22,36,75,49,124,0.000333,0.21369,14,8974.989803,498.610545,641.0707,151.410465,6,6
0,0,7,7,10,12,22,34,26,60,0.000333,0.089189,10,2675.658971,148.647721,267.565897,76.238831,1,6
0,0,10,10,14,15,29,47,34,81,0.000333,0.131165,14,5508.950448,306.052803,393.496461,111.906328,2,6
0,0,16,16,11,18,29,80,59,139,0.000333,0.225086,15,10128.89038,562.716132,675.259358,113.112398,1,6
0,0,19,19,15,21,36,93,67,160,0.000333,0.275729,21,17370.94801,965.052667,827.188,150.842025,2,6
0,0,10,10,14,16,30,47,34,81,0.000333,0.132486,14,5564.413935,309.134108,397.458138,117.302969,2,6
0,0,13,13,10,15,25,52,56,108,0.000333,0.167179,15,7523.047027,417.947057,501.536468,91.82264,1,6
0,0,16,16,14,18,32,65,64,129,0.000333,0.215,21,13545,752.5,645,128.361619,2,6
0,0,10,10,14,15,29,47,34,81,0.000333,0.131165,14,5508.950448,306.052803,393.496461,111.906328,2,6
0,0,20,20,16,25,41,94,64,158,0.000333,0.282164,16,13543.89147,752.438415,846.493217,180.096405,6,6
0,0,18,18,16,24,40,87,58,145,0.000333,0.257227,16,12346.87318,685.937399,771.679574,174.0391,6,6
0,0,30,30,20,50,70,130,113,243,0.000333,0.496472,20,29788.31546,1654.906415,1489.415773,368.631371,10,6
0,0,18,18,13,21,34,64,63,127,0.000333,0.215369,18,11629.94006,646.107781,646.107781,140.344382,3,6
0,0,20,20,17,24,41,72,68,140,0.000333,0.250019,16,12000.91649,666.717583,750.057281,179.525968,4,6
0,0,14,14,14,20,34,47,45,92,0.000333,0.156016,14,6552.65214,364.03623,468.046581,139.741531,3,6
0,0,17,17,12,20,32,61,62,123,0.000333,0.205,18,11070,615,615,129.458112,2,6
0,0,19,19,16,23,39,69,67,136,0.000333,0.239605,16,11501.03523,638.946402,718.814702,168.041925,3,6
0,0,13,13,13,19,32,44,44,88,0.000333,0.146667,12,5280,293.333333,440,128.816339,2,6
0,0,12,12,9,16,25,45,54,99,0.000333,0.153247,12,5516.901153,306.494509,459.741763,92.529325,1,6
0,0,15,15,13,19,32,58,62,120,0.000333,0.2,18,10800,600,600,128.816339,2,6
0,0,9,9,13,16,29,40,32,72,0.000333,0.116592,12,4197.29558,233.183088,349.774632,112.105716,2,6
0,0,15,15,14,18,32,64,47,111,0.000333,0.185,14,7770,431.666667,555,128.361619,2,6
0,0,9,9,13,15,28,34,27,61,0.000333,0.09775,6,1759.491901,97.74955,293.24865,106.709075,2,6
0,0,18,18,17,23,40,68,67,135,0.000333,0.239487,16,11495.36469,638.631371,718.460293,173.528793,2,6
0,0,9,9,14,17,31,35,33,68,0.000333,0.112295,7,2358.197444,131.010969,336.885349,122.789837,2,6
0,0,13,13,11,16,27,63,43,106,0.000333,0.168006,10,5040.180752,280.010042,504.018075,102.053748,2,6
0,0,16,16,15,19,34,76,51,127,0.000333,0.215369,14,9045.508932,502.528274,646.107781,139.313982,3,6
0,0,10,10,14,16,30,46,33,79,0.000333,0.129215,14,5427.020999,301.501167,387.644357,117.302969,2,6
0,0,18,18,16,21,37,66,62,128,0.000333,0.22227,16,10668.96049,592.720027,666.810031,156.238666,4,6
0,0,13,13,16,20,36,46,43,89,0.000333,0.153374,16,7361.973202,408.998511,460.123325,150.438562,3,6
0,0,13,13,11,17,28,63,43,106,0.000333,0.16986,10,5095.796217,283.09979,509.579622,107.540616,2,6
0,0,16,16,15,20,35,76,51,127,0.000333,0.21714,14,9119.865204,506.659178,651.418943,145.041921,3,6
0,0,10,10,14,16,30,46,33,79,0.000333,0.129215,14,5427.020999,301.501167,387.644357,117.302969,2,6
0,0,14,14,11,17,28,69,48,117,0.000333,0.187487,10,5624.605259,312.47807,562.460526,107.540616,1,6
0,0,17,17,15,20,35,82,56,138,0.000333,0.235947,14,9909.774789,550.543044,707.841056,145.041921,2,6
0,0,10,10,14,16,30,46,33,79,0.000333,0.129215,14,5427.020999,301.501167,387.644357,117.302969,2,6
0,0,10,10,10,15,25,36,32,68,0.000333,0.105261,10,3157.822209,175.434567,315.782221,91.82264,2,6
0,0,13,13,14,18,32,49,40,89,0.000333,0.148333,14,6230,346.111111,445,128.361619,3,6
0,0,10,10,13,16,29,39,30,69,0.000333,0.111734,6,2011.204132,111.733563,335.200689,112.105716,2,6
0,0,15,15,13,21,34,61,62,123,0.000333,0.208586,12,7509.095154,417.171953,625.757929,140.344382,1,6
0,0,17,17,17,24,41,69,67,136,0.000333,0.242876,16,11658.03316,647.668509,728.627073,179.525968,2,6
0,0,13,13,11,17,28,63,43,106,0.000333,0.16986,10,5095.796217,283.09979,509.579622,107.540616,2,6
0,0,16,16,14,20,34,76,51,127,0.000333,0.215369,14,9045.508932,502.528274,646.107781,139.741531,3,6
0,0,10,10,14,16,30,46,33,79,0.000333,0.129215,14,5427.020999,301.501167,387.644357,117.302969,2,6
0,0,19,19,17,22,39,83,60,143,0.000333,0.251938,16,12093.00028,671.833349,755.812517,167.594364,4,6
0,0,10,10,13,15,28,41,31,72,0.000333,0.115377,12,4153.554653,230.753036,346.129554,106.709075,2,6
0,0,14,14,11,20,31,55,51,106,0.000333,0.175048,10,5251.448089,291.747116,525.144809,124.49231,2,6
0,0,16,16,14,22,36,63,56,119,0.000333,0.205074,14,8613.095052,478.505281,615.221075,151.410465,3,6
0,0,17,17,18,26,44,78,62,140,0.000333,0.254773,18,13757.76768,764.320427,764.320427,197.270083,5,6
0,0,20,20,20,28,48,91,70,161,0.000333,0.299726,20,17983.57925,999.087736,899.178963,221.0445,6,6
0,0,19,19,18,26,44,89,66,155,0.000333,0.282071,18,15231.81422,846.211901,846.211901,197.270083,6,6
0,0,16,16,15,24,39,60,51,111,0.000333,0.19556,14,8213.515048,456.306392,586.679646,168.642459,4,6
0,0,19,19,17,26,43,73,59,132,0.000333,0.238756,16,11460.27116,636.681731,716.266948,191.698301,5,6
0,0,14,14,16,24,40,57,49,106,0.000333,0.188041,16,9025.990049,501.443892,564.124378,174.0391,2,6
0,0,10,10,13,20,33,36,30,66,0.000333,0.110977,6,1997.580071,110.976671,332.930012,134.544278,4,6
0,0,11,11,13,20,33,37,32,69,0.000333,0.116021,6,2088.379165,116.021065,348.063194,134.544278,4,6
0,0,27,27,20,47,67,125,98,223,0.000333,0.450913,20,27054.75779,1503.042099,1352.737889,347.504238,8,6
0,0,18,18,15,20,35,69,66,135,0.000333,0.230818,21,14541.51735,807.862075,692.453207,145.041921,2,6
0,0,18,18,15,21,36,71,67,138,0.000333,0.237817,21,14982.44265,832.357925,713.44965,150.842025,2,6
0,0,20,20,14,23,37,80,74,154,0.000333,0.267419,21,16847.37218,935.965121,802.255818,157.344894,2,6
0,0,15,15,11,22,33,58,44,102,0.000333,0.171509,10,5145.282002,285.849,514.5282,136.161243,4,6
0,0,18,18,14,24,38,71,52,123,0.000333,0.215165,14,9036.931178,502.051732,645.495084,163.342069,5,6
0,0,10,10,13,16,29,39,30,69,0.000333,0.111734,6,2011.204132,111.733563,335.200689,112.105716,2,6
0,0,12,12,13,21,34,50,35,85,0.000333,0.144145,6,2594.606049,144.144781,432.434342,140.344382,5,6
0,0,13,13,13,21,34,51,37,88,0.000333,0.149232,6,2686.18038,149.232243,447.69673,140.344382,5,6
0,0,36,36,19,51,70,147,122,269,0.000333,0.549592,18,29677.98837,1648.777132,1648.777132,370.004315,10,6
0,0,39,39,21,54,75,160,130,290,0.000333,0.602119,20,36127.14841,2007.0638,1806.35742,403.002591,11,6
0,0,10,10,13,17,30,41,32,73,0.000333,0.119401,6,2149.218081,119.401004,358.203013,117.592585,2,6
0,0,28,28,21,51,72,142,101,243,0.000333,0.499764,10,14992.91775,832.939875,1499.291775,381.532358,9,6
0,0,31,31,23,54,77,155,109,264,0.000333,0.551477,22,36397.49623,2022.083124,1654.431647,414.80585,10,6
0,0,22,22,19,29,48,105,71,176,0.000333,0.327651,18,17693.1612,982.9534,982.9534,221.592072,6,6
0,0,13,13,11,17,28,46,46,92,0.000333,0.147426,10,4422.766528,245.709252,442.276653,107.540616,2,6
0,0,15,15,14,20,34,54,51,105,0.000333,0.178061,14,7478.570377,415.476132,534.183598,139.741531,3,6
0,0,12,12,14,20,34,43,39,82,0.000333,0.139057,7,2920.203671,162.233537,417.171953,139.741531,3,6
0,0,22,22,13,24,37,74,85,159,0.000333,0.276101,18,14909.45553,828.303085,828.303085,158.144816,2,6
0,0,24,24,17,27,44,82,90,172,0.000333,0.313007,24,22536.53372,1252.029651,939.022238,197.868831,3,6
0,0,22,22,12,24,36,82,82,164,0.000333,0.282623,18,15261.6186,847.8677,847.8677,153.05865,2,6
0,0,24,24,16,27,43,90,87,177,0.000333,0.32015,24,23050.77268,1280.598482,960.448862,192.381963,3,6
0,0,15,15,14,19,33,61,54,115,0.000333,0.193368,14,8121.474532,451.19303,580.105324,134.013592,3,6
0,0,17,17,17,22,39,69,59,128,0.000333,0.22551,16,10824.50374,601.361319,676.531484,167.594364,4,6
0,0,15,15,14,19,33,61,55,116,0.000333,0.19505,14,8192.09605,455.116447,585.149718,134.013592,3,6
0,0,17,17,17,22,39,69,60,129,0.000333,0.227272,16,10909.07018,606.059454,681.816886,167.594364,4,6
0,0,18,18,16,23,39,86,57,143,0.000333,0.251938,16,12093.00028,671.833349,755.812517,168.041925,5,6
0,0,16,16,14,20,34,67,49,116,0.000333,0.196715,14,8262.039654,459.002203,590.14569,139.741531,3,6
0,0,9,9,13,15,28,34,27,61,0.000333,0.09775,6,1759.491901,97.74955,293.24865,106.709075,2,6
0,0,15,15,11,17,28,55,43,98,0.000333,0.15704,10,4711.207824,261.733768,471.120782,107.540616,2,6
0,0,18,18,14,20,34,68,51,119,0.000333,0.201803,14,8475.713094,470.87295,605.408078,139.741531,3,6
0,0,10,10,13,16,29,42,32,74,0.000333,0.11983,12,4313.887124,239.660396,359.490594,112.105716,2,6
0,0,15,15,14,20,34,54,41,95,0.000333,0.161103,14,6766.325579,375.906977,483.30897,139.741531,3,6
0,0,11,11,13,18,31,45,35,80,0.000333,0.132112,6,2378.014229,132.111902,396.335705,123.164366,2,6
0,0,13,13,10,16,26,51,40,91,0.000333,0.14258,10,4277.400144,237.633341,427.740014,97.219281,2,6
0,0,16,16,13,19,32,64,48,112,0.000333,0.186667,12,6720,373.333333,560,128.816339,3,6
0,0,10,10,13,16,29,42,32,74,0.000333,0.11983,12,4313.887124,239.660396,359.490594,112.105716,2,6
0,0,13,13,13,19,32,50,38,88,0.000333,0.146667,12,5280,293.333333,440,128.816339,3,6
0,0,11,11,13,18,31,45,35,80,0.000333,0.132112,6,2378.014229,132.111902,396.335705,123.164366,2,6
0,0,14,14,12,18,30,57,46,103,0.000333,0.16847,12,6064.916776,336.939821,505.409731,118.0782,2,6
0,0,17,17,16,21,37,70,54,124,0.000333,0.215324,16,10335.55548,574.197527,645.972217,156.238666,3,6
0,0,10,10,13,16,29,42,32,74,0.000333,0.11983,12,4313.887124,239.660396,359.490594,112.105716,2,6
0,0,14,14,16,21,37,56,44,100,0.000333,0.173648,16,8335.125385,463.062521,520.945337,156.238666,3,6
0,0,11,11,13,18,31,45,35,80,0.000333,0.132112,6,2378.014229,132.111902,396.335705,123.164366,2,6
0,0,25,25,20,45,65,114,85,199,0.000333,0.399484,10,11984.51195,665.806219,1198.451195,333.571951,8,6
0,0,24,24,19,46,65,108,81,189,0.000333,0.379409,9,10244.04765,569.113758,1138.227517,334.794473,8,6
0,0,23,23,19,46,65,107,79,186,0.000333,0.373387,9,10081.44372,560.080207,1120.160413,334.794473,8,6
0,0,15,15,16,22,38,54,59,113,0.000333,0.197672,16,9488.252944,527.125164,593.015809,162.107496,2,6
0,0,14,14,11,17,28,64,46,110,0.000333,0.17627,10,5288.090414,293.782801,528.809041,107.540616,2,6
0,0,17,17,14,19,33,77,54,131,0.000333,0.220272,14,9251.418815,513.967712,660.81563,134.013592,3,6
0,0,10,10,14,15,29,44,32,76,0.000333,0.123069,14,5168.891779,287.160654,369.206556,111.906328,2,6
0,0,9,9,14,15,29,42,33,75,0.000333,0.12145,14,5100.880045,283.382225,364.348575,111.906328,2,6
0,0,12,12,17,18,35,55,41,96,0.000333,0.164137,16,7878.578714,437.698817,492.41117,144.545518,3,6
0,0,10,10,14,16,30,46,34,80,0.000333,0.13085,14,5495.717467,305.317637,392.551248,117.302969,2,6
0,0,13,13,11,16,27,55,48,103,0.000333,0.163251,15,7346.301191,408.127844,489.753413,102.053748,2,6
0,0,15,15,14,19,33,63,53,116,0.000333,0.19505,14,8192.09605,455.116447,585.149718,134.013592,3,6
0,0,36,36,20,51,71,148,117,265,0.000333,0.543228,20,32593.65973,1810.758874,1629.682987,375.732254,11,6
0,0,39,39,22,54,76,161,125,286,0.000333,0.595636,22,39311.95992,2183.997773,1786.907269,408.871421,12,6
0,0,10,10,13,16,29,39,30,69,0.000333,0.111734,6,2011.204132,111.733563,335.200689,112.105716,2,6
0,0,14,14,13,20,33,61,53,114,0.000333,0.191687,12,6900.731155,383.373953,575.06093,134.544278,2,6
0,0,16,16,17,22,39,69,58,127,0.000333,0.223749,16,10739.93731,596.663184,671.246082,167.594364,3,6
0,0,17,17,14,21,35,70,61,131,0.000333,0.223979,14,9407.105053,522.616947,671.936075,145.541635,2,6
0,0,19,19,18,23,41,78,66,144,0.000333,0.257162,18,13886.7748,771.487489,771.487489,179.100575,3,6
0,0,24,24,19,46,65,105,81,186,0.000333,0.373387,9,10081.44372,560.080207,1120.160413,334.794473,8,6
0,0,23,23,19,46,65,104,79,183,0.000333,0.367364,9,9918.839788,551.046655,1102.09331,334.794473,8,6
0,0,8,8,12,16,28,30,23,53,0.000333,0.08493,6,1528.738865,84.929937,254.789811,107.01955,2,6
0,0,14,14,13,17,30,48,32,80,0.000333,0.13085,6,2355.307486,130.850416,392.551248,117.592585,4,6
0,0,9,9,11,14,25,28,24,52,0.000333,0.080494,5,1207.402609,67.077923,241.480522,91.356717,4,6
0,0,20,20,13,23,36,81,75,156,0.000333,0.268836,18,14517.1494,806.5083,806.5083,152.147641,2,6
0,0,22,22,17,25,42,89,80,169,0.000333,0.303767,24,21871.23947,1215.068859,911.301644,185.583273,3,6
0,0,9,9,12,15,27,36,35,71,0.000333,0.112532,12,4051.164152,225.064675,337.597013,101.622909,2,6
0,0,11,11,16,18,34,44,40,84,0.000333,0.142449,16,6837.550059,379.863892,427.346879,139.05865,3,6
0,0,9,9,11,14,25,28,22,50,0.000333,0.077398,5,1160.964047,64.498003,232.192809,91.356717,4,6
0,0,13,13,11,16,27,62,43,105,0.000333,0.166421,10,4992.631877,277.368438,499.263188,102.053748,2,6
0,0,16,16,14,19,33,75,51,126,0.000333,0.211865,14,8898.311227,494.350624,635.593659,134.013592,3,6
0,0,10,10,14,15,29,44,32,76,0.000333,0.123069,14,5168.891779,287.160654,369.206556,111.906328,2,6
0,0,22,22,19,22,41,94,67,161,0.000333,0.287522,27,23289.27856,1293.848809,862.565873,178.818118,4,6
0,0,10,10,13,15,28,41,31,72,0.000333,0.115377,12,4153.554653,230.753036,346.129554,106.709075,2,6
0,0,19,19,18,20,38,83,59,142,0.000333,0.248402,18,13413.70272,745.205707,745.205707,161.497212,4,6
0,0,10,10,13,15,28,41,31,72,0.000333,0.115377,12,4153.554653,230.753036,346.129554,106.709075,2,6
0,0,19,19,18,21,39,83,59,142,0.000333,0.250176,18,13509.48807,750.527115,750.527115,167.297316,4,6
0,0,10,10,13,15,28,41,31,72,0.000333,0.115377,12,4153.554653,230.753036,346.129554,106.709075,2,6
0,0,21,21,18,24,42,88,69,157,0.000333,0.282198,18,15238.68904,846.593835,846.593835,185.09775,3,6
0,0,10,10,13,15,28,41,31,72,0.000333,0.115377,12,4153.554653,230.753036,346.129554,106.709075,2,6
0,0,9,9,12,17,29,37,30,67,0.000333,0.108495,6,1952.90836,108.494909,325.484727,112.506418,3,6
0,0,9,9,12,17,29,37,30,67,0.000333,0.108495,6,1952.90836,108.494909,325.484727,112.506418,3,6
0,0,9,9,12,17,29,37,30,67,0.000333,0.108495,6,1952.90836,108.494909,325.484727,112.506418,3,6
0,0,11,11,9,15,24,43,37,80,0.000333,0.122266,8,2934.376,163.020889,366.797,87.132684,1,6
0,0,14,14,13,18,31,56,45,101,0.000333,0.166791,12,6004.485928,333.582552,500.373827,123.164366,2,6
0,0,9,9,13,16,29,37,30,67,0.000333,0.108495,6,1952.90836,108.494909,325.484727,112.105716,2,6
0,0,11,11,13,17,30,39,32,71,0.000333,0.11613,6,2090.335394,116.129744,348.389232,117.592585,2,6
0,0,10,10,13,17,30,37,30,67,0.000333,0.109587,6,1972.570019,109.587223,328.76167,117.592585,2,6
0,0,12,12,10,16,26,46,38,84,0.000333,0.131612,10,3948.369363,219.353854,394.836936,97.219281,2,6
0,0,15,15,13,19,32,59,46,105,0.000333,0.175,12,6300,350,525,128.816339,3,6
0,0,9,9,13,16,29,37,30,67,0.000333,0.108495,6,1952.90836,108.494909,325.484727,112.105716,2,6
0,0,12,12,13,18,31,42,33,75,0.000333,0.123855,6,2229.38834,123.854908,371.564723,123.164366,3,6
0,0,10,10,13,17,30,37,30,67,0.000333,0.109587,6,1972.570019,109.587223,328.76167,117.592585,2,6
0,0,11,11,13,21,34,41,33,74,0.000333,0.125491,6,2258.833502,125.49075,376.47225,140.344382,5,6
0,0,9,9,11,21,32,35,29,64,0.000333,0.106667,5,1600,88.888889,320,130.292414,4,6
0,0,10,10,11,21,32,36,31,67,0.000333,0.111667,5,1675,93.055556,335,130.292414,4,6
0,0,6,6,11,15,26,26,27,53,0.000333,0.083041,5,1245.616525,69.200918,249.123305,96.657107,1,6
0,0,9,9,14,18,32,38,36,74,0.000333,0.123333,14,5180,287.777778,370,128.361619,2,6
0,0,7,7,12,14,26,38,28,66,0.000333,0.10341,12,3722.748257,206.819348,310.229021,96.322519,1,6
0,0,10,10,15,17,32,51,36,87,0.000333,0.145,14,6090,338.333333,435,128.090227,2,6
0,0,19,19,15,28,43,76,60,136,0.000333,0.245991,14,10331.60809,573.978227,737.972007,193.209297,6,6
0,0,22,22,17,30,47,89,68,157,0.000333,0.29069,16,13953.1272,775.173733,872.07045,216.693586,7,6
0,0,16,16,17,25,42,71,55,126,0.000333,0.226477,16,10870.91192,603.939551,679.431995,185.583273,4,6
0,0,19,19,16,26,42,76,58,134,0.000333,0.240857,16,11561.12855,642.28492,722.570535,186.211433,6,6
0,0,22,22,18,28,46,89,66,155,0.000333,0.285384,18,15410.73786,856.152103,856.152103,209.664588,7,6
0,0,16,16,17,25,42,71,55,126,0.000333,0.226477,16,10870.91192,603.939551,679.431995,185.583273,4,6
0,0,9,9,11,14,25,29,24,53,0.000333,0.082041,5,1230.62189,68.367883,246.124378,91.356717,4,6
0,0,15,15,11,20,31,67,52,119,0.000333,0.196516,10,5895.493609,327.527423,589.549361,124.49231,1,6
0,0,18,18,15,22,37,80,60,140,0.000333,0.243108,14,10210.5286,567.251589,729.323471,156.710855,2,6
0,0,10,10,14,16,30,46,33,79,0.000333,0.129215,14,5427.020999,301.501167,387.644357,117.302969,2,6
0,0,13,13,12,14,26,37,28,65,0.000333,0.101843,12,3666.34298,203.685721,305.528582,96.322519,4,6
0,0,9,9,11,19,30,32,28,60,0.000333,0.098138,5,1472.067179,81.78151,294.413436,118.764371,3,6
0,0,10,10,11,19,30,33,30,63,0.000333,0.103045,5,1545.670538,85.870585,309.134108,118.764371,3,6
0,0,9,9,11,14,25,29,22,51,0.000333,0.078946,5,1184.183328,65.787963,236.836666,91.356717,4,6
0,0,22,22,17,24,41,84,88,172,0.000333,0.307166,24,22115.97468,1228.66526,921.498945,179.525968,3,6
0,0,18,18,16,23,39,86,57,143,0.000333,0.251938,16,12093.00028,671.833349,755.812517,168.041925,5,6
0,0,31,31,22,52,74,142,100,242,0.000333,0.500896,11,16529.56486,918.309159,1502.687714,394.530361,12,6
0,0,30,30,22,52,74,141,98,239,0.000333,0.494686,11,16324.6529,906.925161,1484.059354,394.530361,12,6
0,0,26,26,23,48,71,117,96,213,0.000333,0.436632,22,28817.715,1600.984167,1309.896136,372.120125,8,6
0,0,24,24,19,44,63,127,86,213,0.000333,0.424387,9,11458.44561,636.580312,1273.160624,320.925614,9,6
0,0,15,15,14,21,35,74,49,123,0.000333,0.210301,14,8832.625355,490.701409,630.901811,145.541635,5,6
0,0,13,13,10,18,28,52,54,106,0.000333,0.16986,15,7643.694326,424.649685,509.579622,108.277931,1,6
0,0,16,16,14,21,35,64,63,127,0.000333,0.21714,21,13679.79781,759.988767,651.418943,145.541635,2,6
0,0,7,7,12,12,24,22,19,41,0.000333,0.062661,6,1127.900775,62.661154,187.983463,86.0391,3,6
0,0,25,25,19,45,64,109,83,192,0.000333,0.384,9,10368,576,1152,327.844012,8,6
0,0,24,24,19,45,64,108,81,189,0.000333,0.378,9,10206,567,1134,327.844012,8,6
0,0,26,26,19,47,66,112,88,200,0.000333,0.40296,9,10879.90942,604.439412,1208.878824,341.776299,8,6
0,0,25,25,19,47,66,111,86,197,0.000333,0.396915,9,10716.71077,595.372821,1190.745642,341.776299,8,6
0,0,12,12,9,16,25,41,44,85,0.000333,0.131576,8,3157.822209,175.434567,394.727776,92.529325,1,6
0,0,14,14,13,19,32,49,49,98,0.000333,0.163333,12,5880,326.666667,490,128.816339,2,6
0,0,11,11,13,19,32,38,37,75,0.000333,0.125,6,2250,125,375,128.816339,2,6
0,0,13,13,11,16,27,54,40,94,0.000333,0.148986,10,4469.594252,248.310792,446.959425,102.053748,2,6
0,0,16,16,14,19,33,67,48,115,0.000333,0.193368,14,8121.474532,451.19303,580.105324,134.013592,3,6
0,0,10,10,14,16,30,46,33,79,0.000333,0.129215,14,5427.020999,301.501167,387.644357,117.302969,2,6
0,0,13,13,14,19,33,53,38,91,0.000333,0.153013,14,6426.558108,357.031006,459.039865,134.013592,3,6
0,0,11,11,14,18,32,48,35,83,0.000333,0.138333,7,2905,161.388889,415,128.361619,2,6
0,0,13,13,11,17,28,54,41,95,0.000333,0.152233,10,4566.987176,253.72151,456.698718,107.540616,2,6
0,0,16,16,14,20,34,67,49,116,0.000333,0.196715,14,8262.039654,459.002203,590.14569,139.741531,3,6
0,0,10,10,14,16,30,46,33,79,0.000333,0.129215,14,5427.020999,301.501167,387.644357,117.302969,2,6
0,0,13,13,14,20,34,53,39,92,0.000333,0.156016,7,3276.32607,182.018115,468.046581,139.741531,3,6
0,0,11,11,14,18,32,48,35,83,0.000333,0.138333,7,2905,161.388889,415,128.361619,2,6
0,0,13,13,11,17,28,54,41,95,0.000333,0.152233,10,4566.987176,253.72151,456.698718,107.540616,2,6
0,0,16,16,14,20,34,67,49,116,0.000333,0.196715,14,8262.039654,459.002203,590.14569,139.741531,3,6
0,0,10,10,14,16,30,46,33,79,0.000333,0.129215,14,5427.020999,301.501167,387.644357,117.302969,2,6
0,0,13,13,14,20,34,53,39,92,0.000333,0.156016,7,3276.32607,182.018115,468.046581,139.741531,3,6
0,0,11,11,14,18,32,48,35,83,0.000333,0.138333,7,2905,161.388889,415,128.361619,2,6
0,0,13,13,10,18,28,44,46,90,0.000333,0.144221,10,4326.61943,240.367746,432.661943,108.277931,2,6
0,0,15,15,13,21,34,52,51,103,0.000333,0.17467,12,6288.104072,349.339115,524.008673,140.344382,3,6
0,0,12,12,13,21,34,41,39,80,0.000333,0.135666,6,2441.982164,135.665676,406.997027,140.344382,3,6
0,0,15,15,11,21,32,58,58,116,0.000333,0.193333,10,5800,322.222222,580,130.292414,1,6
0,0,17,17,15,24,39,66,63,129,0.000333,0.227272,14,9545.436407,530.302023,681.816886,168.642459,2,6
0,0,16,16,10,18,28,58,59,117,0.000333,0.187487,15,8436.907888,468.717105,562.460526,108.277931,1,6
0,0,18,18,14,21,35,66,64,130,0.000333,0.222269,21,14002.94264,777.941258,666.806792,145.541635,2,6
0,0,15,15,14,21,35,55,52,107,0.000333,0.182944,14,7683.665959,426.870331,548.833283,145.541635,2,6
0,0,14,14,10,17,27,52,53,105,0.000333,0.166421,15,7488.947816,416.052656,499.263188,102.706149,1,6
0,0,16,16,14,20,34,60,58,118,0.000333,0.200107,14,8404.488614,466.916034,600.320615,139.741531,2,6
0,0,13,13,14,20,34,49,46,95,0.000333,0.161103,14,6766.325579,375.906977,483.30897,139.741531,2,6
0,0,33,33,19,51,70,140,104,244,0.000333,0.498515,18,26919.81101,1495.545056,1495.545056,370.004315,11,6
0,0,36,36,21,54,75,153,112,265,0.000333,0.550212,20,33012.73906,1834.041059,1650.636953,403.002591,12,6
0,0,10,10,13,16,29,39,30,69,0.000333,0.111734,6,2011.204132,111.733563,335.200689,112.105716,2,6
0,0,29,29,21,53,74,129,93,222,0.000333,0.4595,10,13784.98647,765.832582,1378.498647,395.81845,12,6
0,0,28,28,21,53,74,128,91,219,0.000333,0.45329,10,13598.70287,755.483493,1359.870287,395.81845,12,6
0,0,13,13,10,18,28,44,46,90,0.000333,0.144221,10,4326.61943,240.367746,432.661943,108.277931,2,6
0,0,15,15,13,21,34,52,51,103,0.000333,0.17467,12,6288.104072,349.339115,524.008673,140.344382,3,6
0,0,12,12,13,21,34,41,39,80,0.000333,0.135666,6,2441.982164,135.665676,406.997027,140.344382,3,6
0,0,16,16,14,21,35,65,56,121,0.000333,0.206881,14,8689.005431,482.722524,620.643245,145.541635,3,6
0,0,14,14,11,15,26,59,45,104,0.000333,0.162949,15,7332.68596,407.371442,488.845731,96.657107,1,6
0,0,17,17,15,18,33,72,53,125,0.000333,0.210183,14,8827.689709,490.427206,630.549265,133.662009,2,6
0,0,10,10,14,15,29,44,32,76,0.000333,0.123069,14,5168.891779,287.160654,369.206556,111.906328,2,6
0,0,13,13,14,18,32,52,39,91,0.000333,0.151667,14,6370,353.888889,455,128.361619,2,6
0,0,12,12,14,18,32,50,37,87,0.000333,0.145,14,6090,338.333333,435,128.361619,2,6
0,0,12,12,11,18,29,49,45,94,0.000333,0.152217,10,4566.502135,253.694563,456.650214,113.112398,2,6
0,0,15,15,14,21,35,61,54,115,0.000333,0.196623,14,8258.145657,458.78587,589.867547,145.541635,3,6
0,0,16,16,14,21,35,72,53,125,0.000333,0.21372,14,8976.24528,498.680293,641.160377,145.541635,3,6
0,0,19,19,17,24,41,85,61,146,0.000333,0.260734,16,12515.24148,695.291193,782.202593,179.525968,4,6
0,0,12,12,16,18,34,53,39,92,0.000333,0.156016,16,7488.745302,416.041406,468.046581,139.05865,3,6
0,0,18,18,16,21,37,63,61,124,0.000333,0.215324,16,10335.55548,574.197527,645.972217,156.238666,3,6
0,0,13,13,13,19,32,43,42,85,0.000333,0.141667,12,5100,283.333333,425,128.816339,2,6
0,0,17,17,16,22,38,60,57,117,0.000333,0.204669,16,9824.120305,545.784461,614.007519,162.107496,4,6
0,0,12,12,13,20,33,40,38,78,0.000333,0.131154,6,2360.776448,131.154247,393.462741,134.544278,3,6
0,0,13,13,9,16,25,50,56,106,0.000333,0.164083,12,5906.985073,328.165837,492.248756,92.529325,1,6
0,0,16,16,13,19,32,63,64,127,0.000333,0.211667,18,11430,635,635,128.816339,2,6
0,0,10,10,13,16,29,45,34,79,0.000333,0.127927,12,4605.365983,255.853666,383.780499,112.105716,2,6
0,0,15,15,10,17,27,60,52,112,0.000333,0.177516,15,7988.211004,443.7895,532.5474,102.706149,1,6
0,0,18,18,14,20,34,73,60,133,0.000333,0.225544,21,14209.28372,789.404651,676.632558,139.741531,2,6
0,0,10,10,13,17,30,46,34,80,0.000333,0.13085,12,4710.614972,261.700832,392.551248,117.592585,2,6
0,0,16,16,10,18,28,69,56,125,0.000333,0.200306,15,9013.790479,500.766138,600.919365,108.277931,1,6
0,0,19,19,14,21,35,82,64,146,0.000333,0.249625,21,15726.38173,873.687874,748.87532,145.541635,2,6
0,0,10,10,13,17,30,45,34,79,0.000333,0.129215,12,4651.732285,258.429571,387.644357,117.592585,2,6
0,0,32,32,21,53,74,143,105,248,0.000333,0.513315,10,15399.44435,855.524686,1539.944435,395.81845,11,6
0,0,31,31,21,53,74,142,103,245,0.000333,0.507105,10,15213.16075,845.175597,1521.316075,395.81845,11,6
0,0,26,26,21,46,67,116,89,205,0.000333,0.414516,10,12435.48284,690.860158,1243.548284,346.322516,9,6
0,0,25,25,21,46,67,115,87,202,0.000333,0.40845,10,12253.50017,680.750009,1225.350016,346.322516,9,6
0,0,25,25,19,46,65,109,83,192,0.000333,0.385432,9,10406.65158,578.14731,1156.29462,334.794473,9,6
0,0,24,24,19,46,65,108,81,189,0.000333,0.379409,9,10244.04765,569.113758,1138.227517,334.794473,9,6
0,0,15,15,14,23,37,65,52,117,0.000333,0.203169,14,8533.084613,474.060256,609.506044,157.344894,4,6
0,0,16,16,14,23,37,66,54,120,0.000333,0.208378,14,8751.881654,486.215647,625.134404,157.344894,4,6
0,0,33,33,19,49,68,140,103,243,0.000333,0.493084,18,26626.56247,1479.25347,1479.25347,355.831405,11,6
0,0,36,36,21,52,73,153,111,264,0.000333,0.544705,20,32682.27367,1815.681871,1634.113684,388.661531,12,6
0,0,10,10,13,16,29,39,30,69,0.000333,0.111734,6,2011.204132,111.733563,335.200689,112.105716,2,6
0,0,29,29,21,51,72,129,92,221,0.000333,0.454518,10,13635.53425,757.529681,1363.553425,381.532358,12,6
0,0,28,28,21,51,72,128,90,218,0.000333,0.448348,10,13450.4365,747.246472,1345.04365,381.532358,12,6
0,0,15,15,12,19,31,59,54,113,0.000333,0.186608,12,6717.890197,373.216122,559.824183,123.730173,1,6
0,0,18,18,16,21,37,71,63,134,0.000333,0.232689,24,16753.60202,930.755668,698.066751,156.238666,2,6
0,0,6,6,11,12,23,26,24,50,0.000333,0.075393,10,2261.780978,125.654499,226.178098,81.073298,1,6
0,0,9,9,15,16,31,39,32,71,0.000333,0.117249,14,4924.471133,273.58173,351.747938,122.603359,2,6
0,0,17,17,14,19,33,74,64,138,0.000333,0.232042,21,14618.65416,812.147453,696.126388,134.013592,1,6
0,0,20,20,18,21,39,87,72,159,0.000333,0.280126,27,22690.23173,1260.568429,840.378953,167.297316,2,6
0,0,7,7,12,14,26,38,28,66,0.000333,0.10341,12,3722.748257,206.819348,310.229021,96.322519,1,6
0,0,10,10,15,17,32,51,36,87,0.000333,0.145,14,6090,338.333333,435,128.090227,2,6
0,0,13,13,10,17,27,51,41,92,0.000333,0.145817,10,4374.496502,243.027583,437.44965,102.706149,2,6
0,0,16,16,13,20,33,64,49,113,0.000333,0.190006,12,6840.198426,380.011024,570.016535,134.544278,3,6
0,0,10,10,13,16,29,42,32,74,0.000333,0.11983,12,4313.887124,239.660396,359.490594,112.105716,2,6
0,0,13,13,13,20,33,50,39,89,0.000333,0.14965,6,2693.70646,149.650359,448.951077,134.544278,3,6
0,0,11,11,13,18,31,45,35,80,0.000333,0.132112,6,2378.014229,132.111902,396.335705,123.164366,2,6
0,0,16,16,10,20,30,60,66,126,0.000333,0.206089,15,9274.023226,515.223513,618.268215,119.657843,1,6
0,0,19,19,14,22,36,72,75,147,0.000333,0.253326,21,15959.55848,886.642138,759.978975,151.410465,2,6
0,0,18,18,10,21,31,66,76,142,0.000333,0.234499,15,10552.43814,586.246563,703.495876,125.457947,1,6
0,0,21,21,14,23,37,78,85,163,0.000333,0.283047,21,17831.95887,990.664382,849.140899,157.344894,2,6
0,0,17,17,11,21,32,65,69,134,0.000333,0.223333,15,10050,558.333333,670,130.292414,1,6
0,0,19,19,15,23,38,73,74,147,0.000333,0.257148,21,16200.35223,900.019569,771.445344,162.645284,2,6
0,0,16,16,11,20,31,73,63,136,0.000333,0.22459,15,10106.56047,561.475582,673.770698,124.49231,1,6
0,0,18,18,15,22,37,81,68,149,0.000333,0.258736,21,16300.37958,905.576643,776.208551,156.710855,2,6
0,0,14,14,14,23,37,47,56,103,0.000333,0.178858,14,7512.031753,417.335097,536.573697,157.344894,3,6
0,0,14,14,13,23,36,53,51,104,0.000333,0.179224,12,6452.066402,358.448133,537.6722,152.147641,3,6
0,0,4,4,10,11,21,17,16,33,0.000333,0.048315,5,724.732375,40.26291,144.946475,71.273029,2,6
0,0,13,13,15,22,37,53,48,101,0.000333,0.175385,14,7366.167059,409.231503,526.15479,156.710855,3,6
0,0,9,9,12,15,27,38,30,68,0.000333,0.107777,12,3879.988202,215.5549,323.33235,101.622909,2,6
0,0,12,12,15,18,33,51,38,89,0.000333,0.14965,14,6285.315073,349.184171,448.951077,133.662009,3,6
0,0,10,10,14,18,32,43,33,76,0.000333,0.126667,7,2660,147.777778,380,128.361619,2,6
0,0,15,15,11,22,33,58,44,102,0.000333,0.171509,10,5145.282002,285.849,514.5282,136.161243,4,6
0,0,18,18,14,24,38,71,52,123,0.000333,0.215165,14,9036.931178,502.051732,645.495084,163.342069,5,6
0,0,10,10,13,16,29,39,30,69,0.000333,0.111734,6,2011.204132,111.733563,335.200689,112.105716,2,6
0,0,12,12,13,21,34,50,35,85,0.000333,0.144145,6,2594.606049,144.144781,432.434342,140.344382,5,6
0,0,13,13,13,21,34,51,37,88,0.000333,0.149232,6,2686.18038,149.232243,447.69673,140.344382,5,6
0,0,24,24,19,45,64,127,86,213,0.000333,0.426,9,11502,639,1278,327.844012,9,6
0,0,15,15,14,21,35,74,49,123,0.000333,0.210301,14,8832.625355,490.701409,630.901811,145.541635,5,6
0,0,18,18,17,21,38,80,59,139,0.000333,0.243154,16,11671.39079,648.410599,729.461924,161.725534,3,6
0,0,10,10,13,15,28,41,32,73,0.000333,0.116979,12,4211.242912,233.95794,350.936909,106.709075,2,6
0,0,17,17,14,20,34,74,54,128,0.000333,0.217065,14,9116.733412,506.48519,651.195244,139.741531,3,6
0,0,10,10,13,15,28,41,32,73,0.000333,0.116979,12,4211.242912,233.95794,350.936909,106.709075,2,6
0,0,19,19,15,20,35,78,56,134,0.000333,0.229108,14,9622.53494,534.585274,687.323924,145.041921,3,6
0,0,10,10,13,15,28,41,32,73,0.000333,0.116979,12,4211.242912,233.95794,350.936909,106.709075,2,6
0,0,5,5,11,12,23,18,17,35,0.000333,0.052775,5,791.623342,43.979075,158.324668,81.073298,2,6
0,0,10,10,13,14,27,32,28,60,0.000333,0.095098,12,3423.519002,190.1955,285.29325,101.408685,2,6
0,0,14,14,10,17,27,65,51,116,0.000333,0.183856,15,8273.504254,459.639125,551.56695,102.706149,1,6
0,0,17,17,14,19,33,78,59,137,0.000333,0.230361,21,14512.72188,806.262327,691.081994,134.013592,2,6
0,0,10,10,14,16,30,49,35,84,0.000333,0.137393,14,5770.50334,320.583519,412.17881,117.302969,2,6
0,0,10,10,12,17,29,30,32,62,0.000333,0.100398,6,1807.16893,100.398274,301.194822,112.506418,2,6
0,0,12,12,11,19,30,49,46,95,0.000333,0.155385,10,4661.546066,258.974781,466.154607,118.764371,2,6
0,0,15,15,14,22,36,61,55,116,0.000333,0.199904,14,8395.958202,466.442122,599.7113,151.410465,3,6
0,0,12,12,11,18,29,49,46,95,0.000333,0.153836,10,4615.081945,256.393441,461.508195,113.112398,2,6
0,0,15,15,14,21,35,61,55,116,0.000333,0.198332,14,8329.95562,462.775312,594.99683,145.541635,3,6
0,0,31,31,21,55,76,155,111,266,0.000333,0.553983,20,33238.97437,1846.609687,1661.948719,410.21345,11,6
0,0,34,34,23,57,80,168,119,287,0.000333,0.604798,22,39916.65399,2217.591888,1814.393363,436.516656,12,6
0,0,22,22,19,29,48,105,71,176,0.000333,0.327651,18,17693.1612,982.9534,982.9534,221.592072,6,6
0,0,31,31,21,55,76,155,111,266,0.000333,0.553983,20,33238.97437,1846.609687,1661.948719,410.21345,11,6
0,0,34,34,23,57,80,168,119,287,0.000333,0.604798,22,39916.65399,2217.591888,1814.393363,436.516656,12,6
0,0,22,22,19,29,48,105,71,176,0.000333,0.327651,18,17693.1612,982.9534,982.9534,221.592072,6,6
0,0,18,18,16,24,40,87,58,145,0.000333,0.257227,16,12346.87318,685.937399,771.679574,174.0391,6,6
0,0,18,18,16,24,40,87,58,145,0.000333,0.257227,16,12346.87318,685.937399,771.679574,174.0391,6,6
0,0,17,17,17,22,39,69,59,128,0.000333,0.22551,16,10824.50374,601.361319,676.531484,167.594364,4,6
0,0,9,9,12,14,26,29,26,55,0.000333,0.086175,6,1551.145107,86.174728,258.524184,96.322519,2,6
0,0,16,16,14,19,33,63,56,119,0.000333,0.200094,14,8403.960603,466.8867,600.2829,134.013592,3,6
0,0,18,18,17,21,38,71,61,132,0.000333,0.230909,16,11083.62291,615.756828,692.726432,161.725534,4,6
0,0,10,10,10,14,24,32,52,84,0.000333,0.128379,15,5777.052751,320.947375,385.13685,86.52225,2,6
0,0,12,12,14,20,34,43,43,86,0.000333,0.145841,14,6125.305261,340.294737,437.521804,139.741531,3,6
0,0,9,9,15,17,32,40,35,75,0.000333,0.125,14,5250,291.666667,375,128.090227,2,6
0,0,18,18,17,23,40,73,69,142,0.000333,0.251905,24,18137.13095,1007.618386,755.713789,173.528793,2,6
0,0,20,20,14,23,37,83,74,157,0.000333,0.272628,21,17175.56775,954.198208,817.884178,157.344894,2,6
0,0,20,20,15,23,38,75,77,152,0.000333,0.265895,21,16751.38462,930.632479,797.684982,162.645284,2,6
0,0,17,17,14,19,33,61,67,128,0.000333,0.215227,21,13559.33139,753.296188,645.682447,134.013592,1,6
0,0,19,19,18,21,39,69,72,141,0.000333,0.248414,27,20121.52625,1117.862569,745.241713,167.297316,2,6
0,0,7,7,12,15,27,34,31,65,0.000333,0.103023,12,3708.812252,206.045125,309.067688,101.622909,1,6
0,0,9,9,15,18,33,42,36,78,0.000333,0.131154,14,5508.478378,306.026577,393.462741,133.662009,2,6
0,0,19,19,13,20,33,79,70,149,0.000333,0.250538,18,13529.06503,751.614724,751.614724,134.544278,2,6
0,0,22,22,17,22,39,92,78,170,0.000333,0.299506,24,21564.44105,1198.024503,898.518377,167.594364,3,6
0,0,10,10,13,15,28,44,33,77,0.000333,0.123389,12,4441.995948,246.777553,370.166329,106.709075,2,6
0,0,20,20,15,20,35,87,67,154,0.000333,0.263303,21,16588.10128,921.561182,789.909585,145.041921,3,6
0,0,10,10,14,15,29,44,32,76,0.000333,0.123069,14,5168.891779,287.160654,369.206556,111.906328,2,6
0,0,18,18,14,19,33,80,62,142,0.000333,0.238768,21,15042.38326,835.687959,716.303965,134.013592,2,6
0,0,10,10,14,15,29,47,34,81,0.000333,0.131165,14,5508.950448,306.052803,393.496461,111.906328,2,6
0,0,9,9,13,12,25,41,30,71,0.000333,0.109905,12,3956.565474,219.809193,329.713789,91.125266,2,6
0,0,12,12,17,15,32,54,38,92,0.000333,0.153333,16,7360,408.888889,460,128.090227,3,6
0,0,10,10,14,13,27,45,31,76,0.000333,0.120457,14,5059.200302,281.066683,361.37145,101.408685,2,6
0,0,18,18,14,19,33,77,62,139,0.000333,0.233724,21,14724.58643,818.03258,701.170783,134.013592,2,6
0,0,21,21,18,21,39,90,70,160,0.000333,0.281888,27,22832.93759,1268.496533,845.664355,167.297316,3,6
0,0,10,10,13,15,28,41,31,72,0.000333,0.115377,12,4153.554653,230.753036,346.129554,106.709075,2,6
0,0,20,20,19,23,42,76,64,140,0.000333,0.251641,18,13588.63991,754.924439,754.924439,184.752548,4,6
0,0,9,9,11,14,25,27,24,51,0.000333,0.078946,5,1184.183328,65.787963,236.836666,91.356717,4,6
0,0,9,9,12,12,24,27,22,49,0.000333,0.074888,6,1347.978975,74.887721,224.663163,86.0391,4,6
0,0,9,9,12,14,26,27,22,49,0.000333,0.076774,6,1381.929277,76.773849,230.321546,96.322519,4,6
0,0,9,9,11,13,24,27,22,49,0.000333,0.074888,5,1123.315813,62.406434,224.663163,86.159464,4,6
0,0,8,8,12,16,28,30,23,53,0.000333,0.08493,6,1528.738865,84.929937,254.789811,107.01955,2,6
0,0,14,14,13,16,29,47,32,79,0.000333,0.127927,12,4605.365983,255.853666,383.780499,112.105716,4,6
0,0,7,7,11,12,23,21,20,41,0.000333,0.061822,5,927.330201,51.518344,185.46604,81.073298,2,6
0,0,18,18,15,23,38,69,57,126,0.000333,0.220413,14,9257.344134,514.296896,661.238867,162.645284,3,6
0,0,19,19,14,28,42,75,71,146,0.000333,0.262426,14,11021.89681,612.327601,787.278344,187.908907,2,6
0,0,22,22,16,30,46,88,79,167,0.000333,0.307478,16,14758.95755,819.942086,922.434847,211.206718,3,6
0,0,18,18,15,27,42,75,68,143,0.000333,0.257034,14,10795.41948,599.745527,771.101391,186.985321,2,6
0,0,21,21,17,29,46,88,76,164,0.000333,0.301955,16,14493.82657,805.212587,905.864161,210.368317,3,6
0,0,7,7,12,13,25,31,30,61,0.000333,0.094425,12,3399.302731,188.850152,283.275228,91.125266,1,6
0,0,9,9,16,17,33,39,35,74,0.000333,0.124428,16,5972.562637,331.809035,373.285165,133.486868,2,6
0,0,7,7,11,13,24,22,19,41,0.000333,0.062661,5,939.917313,52.217628,187.983463,86.159464,3,6
0,0,11,11,18,18,36,43,40,83,0.000333,0.143035,18,7723.867952,429.103775,429.103775,150.1173,3,6
0,0,11,11,17,19,36,46,41,87,0.000333,0.149928,16,7196.535602,399.807533,449.783475,150.197491,3,6
0,0,13,13,15,23,38,57,49,106,0.000333,0.185427,14,7787.92443,432.662468,556.280316,162.645284,4,6
0,0,7,7,10,16,26,26,27,53,0.000333,0.083041,5,1245.616525,69.200918,249.123305,97.219281,1,6
0,0,13,13,11,19,30,55,48,103,0.000333,0.16847,10,5054.097313,280.783184,505.409731,118.764371,2,6
0,0,15,15,14,21,35,63,53,116,0.000333,0.198332,14,8329.95562,462.775312,594.99683,145.541635,3,6
0,0,13,13,12,21,33,48,49,97,0.000333,0.163102,12,5871.674755,326.204153,489.30623,135.258216,3,6
0,0,13,13,11,18,29,55,49,104,0.000333,0.16841,10,5052.300235,280.683346,505.230023,113.112398,2,6
0,0,15,15,14,21,35,63,54,117,0.000333,0.200042,14,8401.765582,466.764755,600.126113,145.541635,3,6
0,0,12,12,14,18,32,55,41,96,0.000333,0.16,14,6720,373.333333,480,128.361619,5,6
0,0,7,7,8,17,25,26,23,49,0.000333,0.07585,4,910.195813,50.566434,227.548953,93.486868,2,6
0,0,10,10,12,20,32,39,31,70,0.000333,0.116667,6,2100,116.666667,350,129.458112,3,6
0,0,9,9,10,18,28,31,25,56,0.000333,0.089737,5,1346.059378,74.781077,269.211876,108.277931,2,6
0,0,12,12,14,21,35,44,33,77,0.000333,0.131652,7,2764.683546,153.59353,394.954792,145.541635,3,6
0,0,7,7,8,17,25,26,23,49,0.000333,0.07585,4,910.195813,50.566434,227.548953,93.486868,2,6
0,0,10,10,12,20,32,39,31,70,0.000333,0.116667,6,2100,116.666667,350,129.458112,3,6
0,0,7,7,8,16,24,26,23,49,0.000333,0.074888,4,898.65265,49.925147,224.663163,88,2,6
0,0,10,10,12,19,31,39,31,70,0.000333,0.115598,6,2080.76245,115.597914,346.793742,123.730173,3,6
0,0,6,6,9,15,24,27,22,49,0.000333,0.074888,4,898.65265,49.925147,224.663163,87.132684,1,6
0,0,9,9,13,18,31,40,30,70,0.000333,0.115598,6,2080.76245,115.597914,346.793742,123.164366,2,6
0,0,9,9,11,15,26,29,24,53,0.000333,0.083041,5,1245.616525,69.200918,249.123305,96.657107,4,6
0,0,18,18,15,23,38,65,63,128,0.000333,0.223912,14,9404.286104,522.460339,671.734722,162.645284,2,6
0,0,17,17,15,18,33,77,53,130,0.000333,0.21859,14,9180.797297,510.044294,655.771236,133.662009,3,6
0,0,10,10,14,15,29,44,32,76,0.000333,0.123069,14,5168.891779,287.160654,369.206556,111.906328,2,6
0,0,15,15,13,22,35,61,45,106,0.000333,0.181235,12,6524.447998,362.469333,543.704,146.213212,6,6
0,0,9,9,12,18,30,40,33,73,0.000333,0.119401,6,2149.218081,119.401004,358.203013,118.0782,3,6
0,0,29,29,21,51,72,148,112,260,0.000333,0.534727,20,32083.61001,1782.422778,1604.1805,381.532358,7,6
0,0,32,32,23,54,77,161,120,281,0.000333,0.586989,22,38741.2744,2152.293022,1760.967018,414.80585,8,6
0,0,31,31,21,52,73,157,119,276,0.000333,0.569464,20,34167.83157,1898.212865,1708.391578,388.661531,7,6
0,0,34,34,23,55,78,170,127,297,0.000333,0.622255,22,41068.8181,2281.601005,1866.764459,422.016709,8,6
0,0,5,5,10,14,24,20,20,40,0.000333,0.061133,5,916.9925,50.944028,183.3985,86.52225,1,6
0,0,8,8,14,17,31,33,28,61,0.000333,0.100735,7,2115.441825,117.524546,302.205975,122.789837,2,6
0,0,30,30,21,52,73,157,116,273,0.000333,0.563274,20,33796.44209,1877.580116,1689.822105,388.661531,7,6
0,0,33,33,23,55,78,170,124,294,0.000333,0.615969,22,40653.98155,2258.554531,1847.908252,422.016709,8,6
0,0,4,4,12,12,24,19,17,36,0.000333,0.05502,6,990.3519,55.01955,165.05865,86.0391,2,6
0,0,25,25,21,46,67,112,87,199,0.000333,0.402384,10,12071.51749,670.639861,1207.151749,346.322516,8,6
0,0,24,24,21,46,67,111,85,196,0.000333,0.396318,10,11889.53481,660.529712,1188.953481,346.322516,8,6
0,0,15,15,13,18,31,59,47,106,0.000333,0.175048,12,6301.737707,350.096539,525.144809,123.164366,3,6
0,0,18,18,16,21,37,72,55,127,0.000333,0.220534,16,10585.60924,588.089402,661.600577,156.238666,4,6
0,0,10,10,13,15,28,41,31,72,0.000333,0.115377,12,4153.554653,230.753036,346.129554,106.709075,2,6
0,0,13,13,13,19,32,49,38,87,0.000333,0.145,12,5220,290,435,128.816339,3,6
0,0,11,11,13,17,30,44,34,78,0.000333,0.127579,12,4592.849597,255.158311,382.737466,117.592585,2,6
0,0,15,15,13,18,31,59,47,106,0.000333,0.175048,12,6301.737707,350.096539,525.144809,123.164366,3,6
0,0,18,18,16,21,37,72,55,127,0.000333,0.220534,16,10585.60924,588.089402,661.600577,156.238666,4,6
0,0,10,10,13,15,28,41,31,72,0.000333,0.115377,12,4153.554653,230.753036,346.129554,106.709075,2,6
0,0,13,13,13,19,32,49,38,87,0.000333,0.145,12,5220,290,435,128.816339,3,6
0,0,11,11,13,17,30,44,34,78,0.000333,0.127579,12,4592.849597,255.158311,382.737466,117.592585,2,6
0,0,14,14,12,16,28,56,45,101,0.000333,0.161848,12,5826.514166,323.695231,485.542847,107.01955,2,6
0,0,17,17,16,19,35,69,53,122,0.000333,0.208591,16,10012.36045,556.242247,625.772528,144.710623,3,6
0,0,10,10,13,15,28,41,31,72,0.000333,0.115377,12,4153.554653,230.753036,346.129554,106.709075,2,6
0,0,12,12,13,17,30,46,36,82,0.000333,0.134122,12,4828.380346,268.243353,402.365029,117.592585,2,6
0,0,11,11,13,17,30,44,34,78,0.000333,0.127579,12,4592.849597,255.158311,382.737466,117.592585,2,6
0,0,25,25,19,45,64,108,85,193,0.000333,0.386,9,10422,579,1158,327.844012,7,6
0,0,24,24,19,45,64,107,83,190,0.000333,0.38,9,10260,570,1140,327.844012,7,6
0,0,35,35,21,50,71,146,110,256,0.000333,0.524778,20,31486.70525,1749.261403,1574.335263,374.431475,10,6
0,0,38,38,23,53,76,159,118,277,0.000333,0.576892,22,38074.87027,2115.27057,1730.675921,407.621709,11,6
0,0,10,10,13,16,29,39,30,69,0.000333,0.111734,6,2011.204132,111.733563,335.200689,112.105716,2,6
0,0,19,19,13,22,35,76,71,147,0.000333,0.251335,18,13572.08286,754.004603,754.004603,146.213212,2,6
0,0,21,21,17,25,42,84,76,160,0.000333,0.28759,24,20706.4989,1150.36105,862.770788,185.583273,3,6
0,0,19,19,14,22,36,79,71,150,0.000333,0.258496,21,16285.26376,904.736875,775.48875,151.410465,2,6
0,0,21,21,18,25,43,87,76,163,0.000333,0.294827,27,23880.99119,1326.721733,884.481155,191.155055,3,6
0,0,16,16,13,18,31,62,64,126,0.000333,0.208076,18,11236.11723,624.228735,624.228735,123.164366,2,6
0,0,10,10,13,15,28,44,34,78,0.000333,0.124991,12,4499.684207,249.982456,374.973684,106.709075,2,6
0,0,16,16,11,19,30,80,58,138,0.000333,0.225717,15,10157.26353,564.292418,677.150902,118.764371,1,6
0,0,19,19,15,21,36,93,66,159,0.000333,0.274006,21,17262.37958,959.021088,822.018075,150.842025,2,6
0,0,10,10,14,17,31,49,35,84,0.000333,0.138717,14,5826.134861,323.674159,416.15249,122.789837,2,6
0,0,18,18,10,19,29,77,71,148,0.000333,0.23966,15,10784.71781,599.150989,718.981187,113.929904,1,6
0,0,21,21,14,21,35,90,79,169,0.000333,0.28895,21,18203.82543,1011.323635,866.84883,145.541635,2,6
0,0,10,10,14,16,30,49,35,84,0.000333,0.137393,14,5770.50334,320.583519,412.17881,117.302969,2,6
0,0,13,13,10,16,26,54,57,111,0.000333,0.173916,15,7826.232131,434.790674,521.748809,97.219281,1,6
0,0,16,16,14,19,33,67,65,132,0.000333,0.221953,21,13983.0605,776.836694,665.860024,134.013592,2,6
0,0,10,10,14,16,30,49,35,84,0.000333,0.137393,14,5770.50334,320.583519,412.17881,117.302969,2,6
0,0,15,15,14,20,34,71,46,117,0.000333,0.198411,14,8333.264134,462.959119,595.233152,139.741531,5,6
0,0,14,14,10,19,29,54,52,106,0.000333,0.171649,10,5149.459855,286.081103,514.945985,113.929904,1,6
0,0,17,17,14,21,35,66,61,127,0.000333,0.21714,14,9119.865204,506.659178,651.418943,145.541635,2,6
0,0,13,13,11,20,31,51,48,99,0.000333,0.163488,10,4904.654347,272.480797,490.465435,124.49231,2,6
0,0,16,16,14,22,36,63,57,120,0.000333,0.206797,14,8685.474002,482.526333,620.391,151.410465,3,6
0,0,13,13,11,18,29,51,47,98,0.000333,0.158694,10,4760.821375,264.490076,476.082138,113.112398,2,6
0,0,16,16,15,20,35,63,56,119,0.000333,0.203462,14,8545.385506,474.743639,610.384679,145.041921,3,6
0,0,14,14,13,21,34,57,53,110,0.000333,0.18654,12,6715.45095,373.080608,559.620913,140.344382,2,6
0,0,17,17,17,23,40,69,62,131,0.000333,0.232391,16,11154.76129,619.70896,697.17258,173.528793,3,6
0,0,15,15,13,20,33,49,49,98,0.000333,0.164784,12,5932.207484,329.567082,494.350624,134.544278,3,6
0,0,12,12,13,20,33,38,37,75,0.000333,0.12611,6,2269.977354,126.109853,378.329559,134.544278,3,6
0,0,31,31,21,51,72,142,100,242,0.000333,0.497707,10,14931.2185,829.512139,1493.12185,381.532358,12,6
0,0,30,30,21,51,72,141,98,239,0.000333,0.491537,10,14746.12075,819.228931,1474.612075,381.532358,12,6
0,0,9,9,12,18,30,38,31,69,0.000333,0.112858,6,2031.452707,112.858484,338.575451,118.0782,4,6
0,0,9,9,12,18,30,38,31,69,0.000333,0.112858,6,2031.452707,112.858484,338.575451,118.0782,4,6
0,0,10,10,14,17,31,34,33,67,0.000333,0.110644,7,2323.51807,129.084337,331.931153,122.789837,2,6
0,0,15,15,13,19,32,51,62,113,0.000333,0.188333,18,10170,565,565,128.816339,2,6
0,0,19,19,15,21,36,75,69,144,0.000333,0.248156,21,15633.8532,868.5474,744.4692,150.842025,3,6
0,0,17,17,14,20,34,68,60,128,0.000333,0.217065,21,13675.10012,759.727784,651.195244,139.741531,2,6
0,0,15,15,11,20,31,64,58,122,0.000333,0.201471,10,6044.119499,335.784417,604.41195,124.49231,2,6
0,0,17,17,14,23,37,72,63,135,0.000333,0.234425,14,9845.866861,546.992603,703.276204,157.344894,3,6
0,0,19,19,13,22,35,87,69,156,0.000333,0.266723,18,14403.02671,800.168151,800.168151,146.213212,2,6
0,0,21,21,15,25,40,95,74,169,0.000333,0.299802,14,12591.68187,699.537882,899.405848,174.699764,3,6
0,0,28,28,20,49,69,126,91,217,0.000333,0.44185,10,13255.49807,736.41656,1325.549807,361.559344,12,6
0,0,27,27,19,51,70,121,90,211,0.000333,0.431093,9,11639.50845,646.639358,1293.278717,370.004315,11,6
0,0,26,26,19,51,70,120,88,208,0.000333,0.424964,9,11474.01781,637.445434,1274.890868,370.004315,11,6
0,0,28,28,20,49,69,126,93,219,0.000333,0.445922,10,13377.66856,743.203809,1337.766856,361.559344,12,6
0,0,27,27,19,51,70,121,91,212,0.000333,0.433136,9,11694.672,649.704,1299.408,370.004315,11,6
0,0,26,26,19,51,70,120,89,209,0.000333,0.427007,9,11529.18136,640.510075,1281.020151,370.004315,11,6
0,0,15,15,13,18,31,67,45,112,0.000333,0.184957,12,6658.439841,369.913325,554.869987,123.164366,2,6
0,0,18,18,16,20,36,80,53,133,0.000333,0.2292,16,11001.6004,611.200022,687.600025,150.438562,3,6
0,0,10,10,14,16,30,46,33,79,0.000333,0.129215,14,5427.020999,301.501167,387.644357,117.302969,2,6
0,0,21,21,14,22,36,95,72,167,0.000333,0.287792,21,18130.92698,1007.273721,863.377475,151.410465,2,6
0,0,10,10,14,16,30,49,34,83,0.000333,0.135757,14,5701.806872,316.767048,407.271919,117.302969,2,6
0,0,21,21,15,22,37,87,75,162,0.000333,0.28131,21,17722.56035,984.586686,843.931445,156.710855,2,6
0,0,10,10,14,17,31,46,36,82,0.000333,0.135415,14,5687.417364,315.967631,406.244097,122.789837,2,6
0,0,11,11,14,16,30,47,37,84,0.000333,0.137393,14,5770.50334,320.583519,412.17881,117.302969,2,6
0,0,10,10,14,15,29,44,32,76,0.000333,0.123069,14,5168.891779,287.160654,369.206556,111.906328,2,6
0,0,10,10,15,16,31,49,35,84,0.000333,0.138717,14,5826.134861,323.674159,416.15249,122.603359,2,6
0,0,24,24,18,44,62,105,80,185,0.000333,0.367175,9,9913.736857,550.763159,1101.526317,315.273641,8,6
0,0,23,23,18,44,62,104,78,182,0.000333,0.361221,9,9752.973556,541.831864,1083.663728,315.273641,8,6
0,0,18,18,15,19,34,78,58,136,0.000333,0.230632,21,14529.79388,807.210771,691.894946,139.313982,2,6
0,0,21,21,19,21,40,91,66,157,0.000333,0.278514,27,22559.65319,1253.314066,835.542711,172.949289,3,6
0,0,10,10,13,15,28,41,31,72,0.000333,0.115377,12,4153.554653,230.753036,346.129554,106.709075,2,6
0,0,5,5,11,12,23,18,17,35,0.000333,0.052775,5,791.623342,43.979075,158.324668,81.073298,2,6
0,0,10,10,13,14,27,31,35,66,0.000333,0.104608,12,3765.870902,209.21505,313.822575,101.408685,2,6
0,0,4,4,10,11,21,17,16,33,0.000333,0.048315,5,724.732375,40.26291,144.946475,71.273029,2,6
0,0,17,17,17,28,45,72,62,134,0.000333,0.245303,16,11774.53304,654.140724,735.908315,204.092806,4,6
0,0,20,20,19,30,49,85,70,155,0.000333,0.290093,18,15665.04047,870.280026,870.280026,227.917341,5,6
0,0,14,14,16,24,40,57,49,106,0.000333,0.188041,16,9025.990049,501.443892,564.124378,174.0391,2,6
0,0,16,16,14,25,39,60,55,115,0.000333,0.202607,14,8509.497572,472.749865,607.821255,169.399374,2,6
0,0,19,19,16,27,43,73,63,136,0.000333,0.245991,16,11807.55211,655.975117,737.972007,192.381963,3,6
0,0,16,16,16,25,41,63,55,118,0.000333,0.21073,16,10115.05819,561.947677,632.191137,180.096405,2,6
0,0,16,16,14,25,39,60,55,115,0.000333,0.202607,14,8509.497572,472.749865,607.821255,169.399374,2,6
0,0,19,19,16,27,43,73,63,136,0.000333,0.245991,16,11807.55211,655.975117,737.972007,192.381963,3,6
0,0,16,16,16,25,41,63,55,118,0.000333,0.21073,16,10115.05819,561.947677,632.191137,180.096405,2,6
0,0,16,16,13,19,32,64,63,127,0.000333,0.211667,18,11430,635,635,128.816339,2,6
0,0,18,18,17,22,39,72,68,140,0.000333,0.246652,24,17758.95146,986.608414,739.956311,167.594364,3,6
0,0,15,15,11,20,31,60,58,118,0.000333,0.194865,10,5845.951646,324.775091,584.595165,124.49231,1,6
0,0,17,17,15,23,38,68,63,131,0.000333,0.22916,14,9624.69906,534.705503,687.478504,162.645284,2,6
0,0,15,15,16,20,36,67,50,117,0.000333,0.201627,16,9678.099603,537.6722,604.881225,150.438562,6,6
0,0,13,13,11,17,28,55,48,103,0.000333,0.165053,10,4951.57557,275.087532,495.157557,107.540616,2,6
0,0,15,15,15,20,35,63,53,116,0.000333,0.198332,14,8329.95562,462.775312,594.99683,145.041921,3,6
0,0,18,18,14,23,37,73,67,140,0.000333,0.243108,14,10210.5286,567.251589,729.323471,157.344894,3,6
0,0,20,20,17,26,43,81,72,153,0.000333,0.27674,16,13283.49612,737.972007,830.218507,191.698301,4,6
0,0,29,29,19,49,68,122,93,215,0.000333,0.436268,9,11779.2406,654.402255,1308.804511,355.831405,10,6
0,0,28,28,19,49,68,121,91,212,0.000333,0.430181,9,11614.8791,645.271061,1290.542122,355.831405,10,6
0,0,34,34,20,55,75,154,113,267,0.000333,0.554365,20,33261.89181,1847.882878,1663.09459,404.413346,12,6
0,0,33,33,20,55,75,153,111,264,0.000333,0.548136,20,32888.16269,1827.120149,1644.408134,404.413346,12,6
0,0,27,27,18,49,67,118,90,208,0.000333,0.420582,9,11355.71897,630.873276,1261.746552,350.179432,10,6
0,0,26,26,18,49,67,117,88,205,0.000333,0.414516,9,11191.93456,621.774142,1243.548284,350.179432,10,6
0,0,15,15,14,20,34,71,46,117,0.000333,0.198411,14,8333.264134,462.959119,595.233152,139.741531,5,6
0,0,15,15,14,20,34,71,46,117,0.000333,0.198411,14,8333.264134,462.959119,595.233152,139.741531,5,6
0,0,15,15,14,20,34,71,46,117,0.000333,0.198411,14,8333.264134,462.959119,595.233152,139.741531,5,6
0,0,25,25,18,47,65,108,86,194,0.000333,0.389446,9,10515.0542,584.169678,1168.339356,336.124326,7,6
0,0,24,24,18,47,65,107,84,191,0.000333,0.383424,9,10352.45027,575.136126,1150.272252,336.124326,7,6
0,0,17,17,15,21,36,80,50,130,0.000333,0.22403,14,9409.263503,522.736861,672.09025,150.842025,5,6
0,0,13,13,11,16,27,37,56,93,0.000333,0.147402,15,6633.068066,368.503781,442.204538,102.053748,2,6
0,0,4,4,10,11,21,17,16,33,0.000333,0.048315,5,724.732375,40.26291,144.946475,71.273029,2,6
0,0,15,15,11,19,30,66,55,121,0.000333,0.197911,10,5937.337621,329.85209,593.733762,118.764371,1,6
0,0,18,18,15,21,36,79,63,142,0.000333,0.24471,21,15416.71635,856.484242,734.12935,150.842025,2,6
0,0,9,9,13,17,30,41,32,73,0.000333,0.119401,6,2149.218081,119.401004,358.203013,117.592585,2,6
0,0,16,16,10,19,29,64,66,130,0.000333,0.210513,15,9473.06294,526.281274,631.537529,113.929904,1,6
0,0,18,18,14,21,35,72,71,143,0.000333,0.244496,21,15403.2369,855.735383,733.487471,145.541635,2,6
0,0,16,16,13,20,33,63,50,113,0.000333,0.190006,12,6840.198426,380.011024,570.016535,134.544278,3,6
0,0,19,19,16,23,39,76,58,134,0.000333,0.236081,16,11331.90236,629.550131,708.243897,168.041925,4,6
0,0,12,12,16,18,34,53,39,92,0.000333,0.156016,16,7488.745302,416.041406,468.046581,139.05865,3,6
0,0,13,13,13,19,32,48,37,85,0.000333,0.141667,6,2550,141.666667,425,128.816339,3,6
0,0,11,11,13,17,30,43,33,76,0.000333,0.124308,6,2237.542112,124.307895,372.923685,117.592585,2,6
0,0,14,14,14,23,37,63,43,106,0.000333,0.184067,7,3865.414397,214.745244,552.202057,157.344894,5,6
0,0,15,15,14,23,37,64,45,109,0.000333,0.189277,7,3974.812918,220.82294,567.830417,157.344894,5,6
0,0,14,14,14,24,38,63,44,107,0.000333,0.187176,7,3930.697708,218.372095,561.528244,163.342069,5,6
0,0,15,15,14,24,38,64,46,110,0.000333,0.192424,7,4040.904185,224.494677,577.272026,163.342069,5,6
0,0,13,13,10,16,26,61,44,105,0.000333,0.164515,10,4935.461704,274.192317,493.54617,97.219281,1,6
0,0,16,16,14,18,32,74,52,126,0.000333,0.21,14,8820,490,630,128.361619,2,6
0,0,10,10,14,15,29,44,32,76,0.000333,0.123069,14,5168.891779,287.160654,369.206556,111.906328,2,6
0,0,15,15,11,17,28,70,50,120,0.000333,0.192294,10,5768.825906,320.490328,576.882591,107.540616,1,6
0,0,18,18,15,19,34,83,58,141,0.000333,0.239111,21,15063.97747,836.887637,717.332261,139.313982,2,6
0,0,10,10,14,15,29,44,32,76,0.000333,0.123069,14,5168.891779,287.160654,369.206556,111.906328,2,6
0,0,12,12,14,18,32,55,41,96,0.000333,0.16,14,6720,373.333333,480,128.361619,5,6
0,0,12,12,13,18,31,47,42,89,0.000333,0.146974,12,5291.081659,293.948981,440.923472,123.164366,3,6
0,0,31,31,21,54,75,155,113,268,0.000333,0.556441,20,33386.46818,1854.803788,1669.323409,403.002591,9,6
0,0,34,34,23,56,79,168,121,289,0.000333,0.607264,22,40079.438,2226.635444,1821.792636,429.253801,10,6
0,0,24,24,19,30,49,111,77,188,0.000333,0.351855,18,19000.17811,1055.565451,1055.565451,227.917341,6,6
0,0,13,13,16,18,34,53,43,96,0.000333,0.162799,16,7814.342924,434.130162,488.396433,139.05865,3,6
0,0,10,10,13,15,28,41,31,72,0.000333,0.115377,12,4153.554653,230.753036,346.129554,106.709075,2,6
0,0,23,23,17,24,41,101,78,179,0.000333,0.319667,24,23016.04341,1278.669078,959.001809,179.525968,3,6
0,0,10,10,13,16,29,46,33,79,0.000333,0.127927,12,4605.365983,255.853666,383.780499,112.105716,2,6
0,0,4,4,12,10,22,17,17,34,0.000333,0.05054,6,909.72405,50.540225,151.620675,76.238831,2,6
0,0,13,13,11,17,28,62,42,104,0.000333,0.166655,10,4999.649119,277.758284,499.964912,107.540616,2,6
0,0,16,16,14,19,33,75,50,125,0.000333,0.210183,14,8827.689709,490.427206,630.549265,134.013592,3,6
0,0,10,10,14,16,30,46,33,79,0.000333,0.129215,14,5427.020999,301.501167,387.644357,117.302969,2,6
0,0,13,13,11,18,29,62,43,105,0.000333,0.170029,10,5100.880045,283.382225,510.088004,113.112398,2,6
0,0,16,16,14,20,34,75,51,126,0.000333,0.213673,14,8974.284452,498.571358,641.020318,139.741531,3,6
0,0,10,10,14,16,30,46,33,79,0.000333,0.129215,14,5427.020999,301.501167,387.644357,117.302969,2,6
0,0,13,13,11,17,28,62,42,104,0.000333,0.166655,10,4999.649119,277.758284,499.964912,107.540616,2,6
0,0,16,16,14,19,33,75,50,125,0.000333,0.210183,14,8827.689709,490.427206,630.549265,134.013592,3,6
0,0,10,10,14,16,30,46,33,79,0.000333,0.129215,14,5427.020999,301.501167,387.644357,117.302969,2,6
0,0,13,13,11,18,29,62,43,105,0.000333,0.170029,10,5100.880045,283.382225,510.088004,113.112398,2,6
0,0,16,16,14,20,34,75,51,126,0.000333,0.213673,14,8974.284452,498.571358,641.020318,139.741531,3,6
0,0,10,10,14,16,30,46,33,79,0.000333,0.129215,14,5427.020999,301.501167,387.644357,117.302969,2,6
0,0,13,13,11,17,28,62,42,104,0.000333,0.166655,10,4999.649119,277.758284,499.964912,107.540616,2,6
0,0,16,16,14,19,33,75,50,125,0.000333,0.210183,14,8827.689709,490.427206,630.549265,134.013592,3,6
0,0,10,10,14,16,30,46,33,79,0.000333,0.129215,14,5427.020999,301.501167,387.644357,117.302969,2,6
0,0,15,15,13,20,33,49,49,98,0.000333,0.164784,12,5932.207484,329.567082,494.350624,134.544278,3,6
0,0,12,12,13,20,33,38,37,75,0.000333,0.12611,6,2269.977354,126.109853,378.329559,134.544278,3,6
0,0,20,20,16,24,40,92,63,155,0.000333,0.274966,16,13198.38168,733.243426,824.898855,174.0391,5,6
0,0,20,20,16,24,40,92,63,155,0.000333,0.274966,16,13198.38168,733.243426,824.898855,174.0391,5,6
0,0,9,9,12,17,29,37,30,67,0.000333,0.108495,6,1952.90836,108.494909,325.484727,112.506418,3,6
0,0,11,11,10,14,24,38,31,69,0.000333,0.105454,10,3163.624125,175.756896,316.362413,86.52225,2,6
0,0,14,14,14,17,31,51,39,90,0.000333,0.148626,14,6242.287351,346.793742,445.877668,122.789837,3,6
0,0,10,10,13,16,29,39,30,69,0.000333,0.111734,6,2011.204132,111.733563,335.200689,112.105716,2,6
0,0,11,11,10,14,24,38,31,69,0.000333,0.105454,10,3163.624125,175.756896,316.362413,86.52225,2,6
0,0,14,14,14,17,31,51,39,90,0.000333,0.148626,14,6242.287351,346.793742,445.877668,122.789837,3,6
0,0,10,10,13,16,29,39,30,69,0.000333,0.111734,6,2011.204132,111.733563,335.200689,112.105716,2,6
0,0,7,7,10,15,25,24,24,48,0.000333,0.074302,5,1114.525486,61.918083,222.905097,91.82264,1,6
0,0,23,23,20,45,65,103,77,180,0.000333,0.361342,10,10840.26206,602.236781,1084.026206,333.571951,8,6
0,0,22,22,20,45,65,102,75,177,0.000333,0.35532,10,10659.59103,592.199502,1065.959103,333.571951,8,6
0,0,23,23,19,44,63,103,77,180,0.000333,0.358637,9,9683.193476,537.955193,1075.910386,320.925614,8,6
0,0,22,22,19,44,63,102,75,177,0.000333,0.35266,9,9521.806918,528.989273,1057.978546,320.925614,8,6
0,0,25,25,20,45,65,107,80,187,0.000333,0.375394,10,11261.82781,625.657101,1126.182781,333.571951,8,6
0,0,24,24,20,45,65,106,78,184,0.000333,0.369372,10,11081.15678,615.619821,1108.115678,333.571951,8,6
0,0,27,27,19,50,69,119,91,210,0.000333,0.427597,9,11545.11122,641.395068,1282.790136,362.903432,10,6
0,0,26,26,19,50,69,118,89,207,0.000333,0.421488,9,11380.18106,632.232281,1264.464563,362.903432,10,6
0,0,27,27,18,51,69,119,92,211,0.000333,0.429633,9,11600.08794,644.44933,1288.89866,364.352342,10,6
0,0,26,26,18,51,69,118,90,208,0.000333,0.423524,9,11435.15778,635.286544,1270.573087,364.352342,10,6
0,0,6,6,8,11,19,15,16,31,0.000333,0.043895,4,526.743012,29.263501,131.685753,62.053748,3,6
0,0,17,17,15,19,34,57,57,114,0.000333,0.193324,21,12179.38604,676.632558,579.970764,139.313982,2,6
0,0,20,20,18,22,40,70,65,135,0.000333,0.239487,18,12932.28527,718.460293,718.460293,173.166146,3,6
0,0,18,18,17,22,39,62,60,122,0.000333,0.21494,16,10317.10513,573.172507,644.819071,167.594364,2,6
0,0,11,11,10,14,24,38,31,69,0.000333,0.105454,10,3163.624125,175.756896,316.362413,86.52225,2,6
0,0,14,14,14,17,31,51,39,90,0.000333,0.148626,14,6242.287351,346.793742,445.877668,122.789837,3,6
0,0,10,10,13,16,29,39,30,69,0.000333,0.111734,6,2011.204132,111.733563,335.200689,112.105716,2,6
0,0,5,5,10,12,22,16,15,31,0.000333,0.046081,5,691.211901,38.400661,138.24238,76.238831,2,6
0,0,5,5,10,12,22,16,15,31,0.000333,0.046081,5,691.211901,38.400661,138.24238,76.238831,2,6
0,0,5,5,10,13,23,16,16,32,0.000333,0.048251,5,723.769913,40.20944,144.753983,81.324997,2,6
0,0,7,7,11,14,25,20,18,38,0.000333,0.058822,5,882.332676,49.018482,176.466535,91.356717,2,6
0,0,22,22,17,44,61,98,76,174,0.000333,0.343983,8,8255.586374,458.643687,1031.948297,309.70186,7,6
0,0,21,21,17,44,61,97,74,171,0.000333,0.338052,8,8113.248678,450.736038,1014.156085,309.70186,7,6
0,0,4,4,10,12,22,15,15,30,0.000333,0.044594,5,668.914743,37.16193,133.782949,76.238831,2,6
0,0,5,5,10,14,24,18,17,35,0.000333,0.053491,5,802.368438,44.576024,160.473688,86.52225,3,6
0,0,7,7,11,16,27,27,20,47,0.000333,0.074493,5,1117.398563,62.077698,223.479713,102.053748,3,6
0,0,31,31,18,49,67,139,102,241,0.000333,0.487309,18,26314.69491,1461.927495,1461.927495,350.179432,10,6
0,0,34,34,20,51,71,152,110,262,0.000333,0.537078,20,32224.67491,1790.259717,1611.233745,375.732254,11,6
0,0,10,10,13,16,29,39,30,69,0.000333,0.111734,6,2011.204132,111.733563,335.200689,112.105716,2,6
0,0,29,29,20,51,71,131,95,226,0.000333,0.463281,10,13898.42849,772.134916,1389.842849,375.732254,11,6
0,0,28,28,20,51,71,130,93,223,0.000333,0.457131,10,13713.93608,761.885338,1371.393608,375.732254,11,6
0,0,32,32,18,50,68,142,103,245,0.000333,0.497143,18,26845.71113,1491.428396,1491.428396,357.25146,11,6
0,0,35,35,20,52,72,155,111,266,0.000333,0.547067,20,32824.00101,1823.555612,1641.20005,382.861427,12,6
0,0,10,10,13,16,29,39,30,69,0.000333,0.111734,6,2011.204132,111.733563,335.200689,112.105716,2,6
0,0,30,30,20,52,72,134,96,230,0.000333,0.473028,10,14190.8275,788.379306,1419.08275,382.861427,12,6
0,0,29,29,20,52,72,133,94,227,0.000333,0.466858,10,14005.72975,778.096097,1400.572975,382.861427,12,6
0,0,15,15,14,21,35,70,50,120,0.000333,0.205171,14,8617.195468,478.733082,615.513962,145.541635,5,6
0,0,14,14,10,16,26,47,43,90,0.000333,0.141013,10,4230.395746,235.021986,423.039575,97.219281,2,6
0,0,17,17,14,19,33,60,51,111,0.000333,0.186643,14,7838.988461,435.499359,559.927747,134.013592,3,6
0,0,10,10,13,17,30,41,32,73,0.000333,0.119401,6,2149.218081,119.401004,358.203013,117.592585,2,6
0,0,15,15,16,27,43,80,55,135,0.000333,0.244182,16,11720.73187,651.151771,732.545742,192.381963,7,6
0,0,15,15,16,27,43,80,55,135,0.000333,0.244182,16,11720.73187,651.151771,732.545742,192.381963,7,6
0,0,18,18,15,21,36,82,58,140,0.000333,0.241263,14,10133.053,562.947389,723.7895,150.842025,5,6
0,0,17,17,14,21,35,78,56,134,0.000333,0.229108,14,9622.53494,534.585274,687.323924,145.541635,5,6
0,0,16,16,10,17,27,52,53,105,0.000333,0.166421,15,7488.947816,416.052656,499.263188,102.706149,2,6
0,0,19,19,14,20,34,65,61,126,0.000333,0.213673,21,13461.42668,747.857038,641.020318,139.741531,3,6
0,0,10,10,13,17,30,41,32,73,0.000333,0.119401,6,2149.218081,119.401004,358.203013,117.592585,2,6
0,0,10,10,11,15,26,37,30,67,0.000333,0.104976,10,3149.294611,174.960812,314.929461,96.657107,2,6
0,0,13,13,15,18,33,50,38,88,0.000333,0.147969,14,6214.693555,345.260753,443.906683,133.662009,3,6
0,0,16,16,12,17,29,59,50,109,0.000333,0.176507,12,6354.239142,353.013286,529.519928,112.506418,2,6
0,0,19,19,15,20,35,72,58,130,0.000333,0.222269,14,9335.295091,518.627505,666.806792,145.041921,3,6
0,0,10,10,13,17,30,42,32,74,0.000333,0.121037,6,2178.659424,121.036635,363.109904,117.592585,2,6
0,0,9,9,10,14,24,36,29,65,0.000333,0.099341,10,2980.225625,165.56809,298.022563,86.52225,2,6
0,0,12,12,14,17,31,49,37,86,0.000333,0.14202,14,5964.852358,331.380687,426.060883,122.789837,3,6
0,0,10,10,13,17,30,41,32,73,0.000333,0.119401,6,2149.218081,119.401004,358.203013,117.592585,2,6
0,0,16,16,10,18,28,53,54,107,0.000333,0.171462,15,7715.80465,428.655814,514.386977,108.277931,2,6
0,0,19,19,14,21,35,66,62,128,0.000333,0.218849,14,9191.675166,510.64862,656.548226,145.541635,3,6
0,0,10,10,13,17,30,41,32,73,0.000333,0.119401,6,2149.218081,119.401004,358.203013,117.592585,2,6
0,0,27,27,18,50,68,121,92,213,0.000333,0.43221,9,11669.66627,648.314793,1296.629585,357.25146,10,6
0,0,26,26,18,50,68,120,90,210,0.000333,0.426122,9,11505.30477,639.183598,1278.367197,357.25146,10,6
0,0,7,7,12,24,36,38,33,71,0.000333,0.122355,6,2202.388051,122.354892,367.064675,153.05865,2,6
0,0,10,10,17,32,49,61,50,111,0.000333,0.207744,8,4985.862342,276.992352,623.232793,229.486868,3,6
0,0,7,7,12,24,36,38,33,71,0.000333,0.122355,6,2202.388051,122.354892,367.064675,153.05865,2,6
0,0,10,10,17,32,49,61,50,111,0.000333,0.207744,8,4985.862342,276.992352,623.232793,229.486868,3,6
0,0,7,7,12,24,36,38,33,71,0.000333,0.122355,6,2202.388051,122.354892,367.064675,153.05865,2,6
0,0,10,10,17,32,49,61,50,111,0.000333,0.207744,8,4985.862342,276.992352,623.232793,229.486868,3,6
0,0,10,10,18,30,48,62,48,110,0.000333,0.204782,9,5529.112876,307.172938,614.345875,222.265368,3,6
0,0,10,10,18,30,48,62,48,110,0.000333,0.204782,9,5529.112876,307.172938,614.345875,222.265368,3,6
0,0,7,7,12,24,36,38,33,71,0.000333,0.122355,6,2202.388051,122.354892,367.064675,153.05865,2,6
0,0,10,10,17,32,49,61,50,111,0.000333,0.207744,8,4985.862342,276.992352,623.232793,229.486868,3,6
0,0,7,7,12,24,36,38,33,71,0.000333,0.122355,6,2202.388051,122.354892,367.064675,153.05865,2,6
0,0,10,10,17,32,49,61,50,111,0.000333,0.207744,8,4985.862342,276.992352,623.232793,229.486868,3,6
0,0,15,15,10,17,27,51,59,110,0.000333,0.174346,15,7845.564379,435.864688,523.037625,102.706149,2,6
0,0,18,18,14,20,34,64,67,131,0.000333,0.222153,21,13995.61028,777.533904,666.457632,139.741531,3,6
0,0,10,10,13,17,30,41,32,73,0.000333,0.119401,6,2149.218081,119.401004,358.203013,117.592585,2,6
0,0,14,14,12,17,29,47,44,91,0.000333,0.147359,12,5304.915247,294.717514,442.076271,112.506418,2,6
0,0,17,17,15,20,35,60,52,112,0.000333,0.191493,14,8042.715771,446.817543,574.479698,145.041921,3,6
0,0,10,10,13,18,31,42,32,74,0.000333,0.122204,6,2199.663162,122.203509,366.610527,123.164366,2,6
0,0,8,8,12,18,30,30,24,54,0.000333,0.088324,6,1589.832553,88.324031,264.972092,118.0782,3,6
0,0,12,12,15,21,36,49,34,83,0.000333,0.143035,7,3003.726426,166.87369,429.103775,150.842025,4,6
0,0,16,16,16,35,51,96,70,166,0.000333,0.313874,16,15065.96171,836.997873,941.622607,243.524906,7,6
0,0,15,15,16,34,50,92,67,159,0.000333,0.299124,8,7178.985073,398.832504,897.373134,236.973737,7,6
0,0,19,19,18,42,60,116,86,202,0.000333,0.397731,18,21477.45421,1193.1919,1193.1919,301.535982,8,6
0,0,28,28,21,51,72,127,98,225,0.000333,0.462744,10,13882.33125,771.240625,1388.233125,381.532358,10,6
0,0,27,27,21,51,72,126,96,222,0.000333,0.456574,10,13697.2335,760.957417,1369.72335,381.532358,10,6
0,0,16,16,11,18,29,50,54,104,0.000333,0.16841,15,7578.450352,421.02502,505.230023,113.112398,2,6
0,0,19,19,15,21,36,63,62,125,0.000333,0.215414,14,9047.368753,502.631597,646.240625,150.842025,3,6
0,0,10,10,13,18,31,41,34,75,0.000333,0.123855,6,2229.38834,123.854908,371.564723,123.164366,2,6
0,0,14,14,12,17,29,50,40,90,0.000333,0.145739,12,5246.619475,291.47886,437.21829,112.506418,2,6
0,0,17,17,15,20,35,63,48,111,0.000333,0.189783,14,7970.905808,442.8281,569.350415,145.041921,3,6
0,0,10,10,13,16,29,39,30,69,0.000333,0.111734,6,2011.204132,111.733563,335.200689,112.105716,2,6
0,0,22,22,20,43,63,102,77,179,0.000333,0.356644,10,10699.33106,594.407281,1069.933106,319.767946,8,6
0,0,21,21,20,43,63,101,75,176,0.000333,0.350667,10,10520.01267,584.445148,1052.001267,319.767946,8,6
0,0,36,36,23,55,78,160,113,273,0.000333,0.571972,22,37750.12573,2097.229207,1715.914806,422.016709,14,6
0,0,35,35,23,55,78,159,111,270,0.000333,0.565686,22,37335.28918,2074.182732,1697.058599,422.016709,14,6
0,0,15,15,11,20,31,50,45,95,0.000333,0.156883,10,4706.486495,261.471472,470.648649,124.49231,2,6
0,0,18,18,15,23,38,63,53,116,0.000333,0.20292,14,8522.634282,473.479682,608.759592,162.645284,3,6
0,0,10,10,13,16,29,39,30,69,0.000333,0.111734,6,2011.204132,111.733563,335.200689,112.105716,2,6
0,0,15,15,12,17,29,52,42,94,0.000333,0.152217,12,5479.802563,304.433476,456.650214,112.506418,2,6
0,0,18,18,16,20,36,65,50,115,0.000333,0.19818,16,9512.662003,528.481222,594.541375,150.438562,3,6
0,0,10,10,13,16,29,39,30,69,0.000333,0.111734,6,2011.204132,111.733563,335.200689,112.105716,2,6
0,0,5,5,11,14,25,27,20,47,0.000333,0.072754,5,1091.306205,60.628122,218.261241,91.356717,2,6
0,0,5,5,11,13,24,27,20,47,0.000333,0.071831,5,1077.466188,59.859233,215.493238,86.159464,2,6
0,0,6,6,12,16,28,29,22,51,0.000333,0.081725,6,1471.050606,81.725034,245.175101,107.01955,5,6
0,0,7,7,12,17,29,30,24,54,0.000333,0.087444,6,1573.985842,87.443658,262.330974,112.506418,5,6
0,0,13,13,10,17,27,46,35,81,0.000333,0.128382,10,3851.458877,213.969938,385.145888,102.706149,3,6
0,0,16,16,14,20,34,59,43,102,0.000333,0.172974,14,7264.896937,403.605385,518.92121,139.741531,4,6
0,0,10,10,13,16,29,39,30,69,0.000333,0.111734,6,2011.204132,111.733563,335.200689,112.105716,2,6
0,0,6,6,12,16,28,29,23,52,0.000333,0.083327,6,1499.894736,83.327485,249.982456,107.01955,5,6
0,0,7,7,12,17,29,30,25,55,0.000333,0.089063,6,1603.133728,89.062985,267.188955,112.506418,5,6
0,0,14,14,10,16,26,45,43,88,0.000333,0.13788,10,4136.386952,229.799275,413.638695,97.219281,2,6
0,0,17,17,14,19,33,58,51,109,0.000333,0.18328,14,7697.745426,427.652524,549.838959,134.013592,3,6
0,0,10,10,13,17,30,41,32,73,0.000333,0.119401,6,2149.218081,119.401004,358.203013,117.592585,2,6
0,0,16,16,11,17,28,51,48,99,0.000333,0.158643,10,4759.281373,264.404521,475.928137,107.540616,3,6
0,0,19,19,15,20,35,64,56,120,0.000333,0.205171,14,8617.195468,478.733082,615.513962,145.041921,4,6
0,0,10,10,13,16,29,39,30,69,0.000333,0.111734,6,2011.204132,111.733563,335.200689,112.105716,2,6
0,0,16,16,12,17,29,52,42,94,0.000333,0.152217,12,5479.802563,304.433476,456.650214,112.506418,3,6
0,0,19,19,16,20,36,65,50,115,0.000333,0.19818,16,9512.662003,528.481222,594.541375,150.438562,4,6
0,0,10,10,13,16,29,39,30,69,0.000333,0.111734,6,2011.204132,111.733563,335.200689,112.105716,2,6
0,0,33,33,18,50,68,143,108,251,0.000333,0.509318,18,27503.15712,1527.953173,1527.953173,357.25146,10,6
0,0,36,36,20,52,72,156,116,272,0.000333,0.559407,20,33564.39201,1864.688445,1678.2196,382.861427,11,6
0,0,10,10,13,16,29,39,30,69,0.000333,0.111734,6,2011.204132,111.733563,335.200689,112.105716,2,6
0,0,31,31,20,52,72,135,101,236,0.000333,0.485367,10,14561.023,808.945722,1456.1023,382.861427,11,6
0,0,30,30,20,52,72,134,99,233,0.000333,0.479198,10,14375.92525,798.662514,1437.592525,382.861427,11,6
0,0,21,21,17,43,60,95,71,166,0.000333,0.326848,8,7844.350711,435.797262,980.543839,302.816253,8,6
0,0,20,20,17,43,60,94,69,163,0.000333,0.320941,8,7702.585337,427.921408,962.823167,302.816253,8,6
0,0,26,26,19,52,71,133,100,233,0.000333,0.47763,9,12896.01971,716.445539,1432.891079,377.133488,9,6
0,0,13,13,10,16,26,45,34,79,0.000333,0.123778,10,3713.347377,206.297077,371.334738,97.219281,3,6
0,0,16,16,14,19,33,58,42,100,0.000333,0.168146,14,7062.151767,392.341765,504.439412,134.013592,4,6
0,0,10,10,13,16,29,39,30,69,0.000333,0.111734,6,2011.204132,111.733563,335.200689,112.105716,2,6
0,0,19,19,16,30,46,101,74,175,0.000333,0.322208,16,15465.97348,859.220749,966.623342,211.206718,7,6
0,0,10,10,10,19,29,34,34,68,0.000333,0.110114,5,1651.713538,91.761863,330.342708,113.929904,2,6
0,0,11,11,10,19,29,35,36,71,0.000333,0.114972,5,1724.583253,95.810181,344.916651,113.929904,2,6
0,0,9,9,11,19,30,35,30,65,0.000333,0.106316,5,1594.739444,88.596636,318.947889,118.764371,3,6
0,0,10,10,11,19,30,36,32,68,0.000333,0.111223,5,1668.342803,92.685711,333.668561,118.764371,3,6
0,0,13,13,10,17,27,45,35,80,0.000333,0.126797,10,3803.910002,211.328333,380.391,102.706149,3,6
0,0,16,16,14,20,34,58,43,101,0.000333,0.171278,14,7193.672458,399.64847,513.833747,139.741531,4,6
0,0,10,10,13,16,29,39,30,69,0.000333,0.111734,6,2011.204132,111.733563,335.200689,112.105716,2,6
0,0,28,28,22,48,70,126,90,216,0.000333,0.441308,11,14563.17645,809.065358,1323.925132,366.185696,12,6
0,0,27,27,22,48,70,125,88,213,0.000333,0.435179,11,14360.91011,797.828339,1305.537283,366.185696,12,6
0,0,25,25,17,46,63,109,85,194,0.000333,0.386531,8,9276.738441,515.374358,1159.592305,323.570718,9,6
0,0,24,24,17,46,63,108,83,191,0.000333,0.380553,8,9133.283723,507.404651,1141.660465,323.570718,9,6
0,0,17,17,15,18,33,56,56,112,0.000333,0.188324,21,11864.41497,659.134165,564.972141,133.662009,2,6
0,0,20,20,18,21,39,69,64,133,0.000333,0.234319,27,18979.87937,1054.437743,702.958495,167.297316,3,6
0,0,18,18,17,21,38,61,59,120,0.000333,0.209917,16,10076.02083,559.778935,629.751302,161.725534,2,6
0,0,8,8,10,18,28,32,29,61,0.000333,0.09775,5,1466.243251,81.457958,293.24865,108.277931,2,6
0,0,9,9,10,18,28,33,31,64,0.000333,0.102557,5,1538.353575,85.464088,307.670715,108.277931,2,6
0,0,11,11,12,21,33,40,33,73,0.000333,0.122747,6,2209.444624,122.746924,368.240771,135.258216,3,6
0,0,12,12,12,21,33,41,35,76,0.000333,0.127791,6,2300.243718,127.791318,383.373953,135.258216,3,6
0,0,7,7,13,21,34,39,30,69,0.000333,0.117012,6,2106.209616,117.011645,351.034936,140.344382,2,6
0,0,10,10,18,29,47,62,47,109,0.000333,0.201817,9,5449.051663,302.725092,605.450185,215.940099,3,6
0,0,7,7,12,25,37,41,35,76,0.000333,0.131973,6,2375.510735,131.972819,395.918456,159.115955,2,6
0,0,10,10,17,33,50,64,52,116,0.000333,0.218229,8,5237.498544,290.972141,654.687318,235.951874,3,6
0,0,15,15,12,16,28,50,37,87,0.000333,0.139413,12,5018.878539,278.826585,418.239878,107.01955,3,6
0,0,18,18,16,19,35,63,45,108,0.000333,0.184654,16,8863.401053,492.41117,553.962566,144.710623,4,6
0,0,10,10,13,16,29,39,30,69,0.000333,0.111734,6,2011.204132,111.733563,335.200689,112.105716,2,6
0,0,34,34,21,56,77,155,111,266,0.000333,0.555655,10,16669.6522,926.091789,1666.96522,417.450542,14,6
0,0,33,33,21,56,77,154,109,263,0.000333,0.549388,10,16481.6486,915.647145,1648.16486,417.450542,14,6
0,0,34,34,21,55,76,155,110,265,0.000333,0.5519,20,33114.01582,1839.667546,1655.700791,410.21345,14,6
0,0,33,33,21,55,76,154,108,262,0.000333,0.545652,10,16369.57009,909.42056,1636.957009,410.21345,14,6
0,0,13,13,10,16,26,45,34,79,0.000333,0.123778,10,3713.347377,206.297077,371.334738,97.219281,3,6
0,0,16,16,14,19,33,58,42,100,0.000333,0.168146,14,7062.151767,392.341765,504.439412,134.013592,4,6
0,0,10,10,13,16,29,39,30,69,0.000333,0.111734,6,2011.204132,111.733563,335.200689,112.105716,2,6
0,0,16,16,12,18,30,57,41,98,0.000333,0.160292,12,5770.50334,320.583519,480.875278,118.0782,3,6
0,0,19,19,15,21,36,70,49,119,0.000333,0.205074,14,8613.095052,478.505281,615.221075,150.842025,4,6
0,0,10,10,13,16,29,39,30,69,0.000333,0.111734,6,2011.204132,111.733563,335.200689,112.105716,2,6
0,0,7,7,10,15,25,24,24,48,0.000333,0.074302,5,1114.525486,61.918083,222.905097,91.82264,1,6
0,0,7,7,10,15,25,24,24,48,0.000333,0.074302,5,1114.525486,61.918083,222.905097,91.82264,1,6
0,0,12,12,10,16,26,43,34,77,0.000333,0.120645,10,3619.338583,201.074366,361.933858,97.219281,2,6
0,0,15,15,14,19,33,56,42,98,0.000333,0.164784,14,6920.908732,384.49493,494.350624,134.013592,3,6
0,0,10,10,13,16,29,39,30,69,0.000333,0.111734,6,2011.204132,111.733563,335.200689,112.105716,2,6
0,0,13,13,10,18,28,46,36,82,0.000333,0.131401,10,3942.031036,219.001724,394.203104,108.277931,3,6
0,0,16,16,14,21,35,59,44,103,0.000333,0.176105,14,7396.42611,410.912562,528.316151,145.541635,4,6
0,0,10,10,13,16,29,39,30,69,0.000333,0.111734,6,2011.204132,111.733563,335.200689,112.105716,2,6
0,0,13,13,11,16,27,46,35,81,0.000333,0.128382,10,3851.458877,213.969938,385.145888,102.053748,3,6
0,0,16,16,15,19,34,59,43,102,0.000333,0.172974,14,7264.896937,403.605385,518.92121,139.313982,4,6
0,0,10,10,13,16,29,39,30,69,0.000333,0.111734,6,2011.204132,111.733563,335.200689,112.105716,2,6
0,0,11,11,10,14,24,38,31,69,0.000333,0.105454,10,3163.624125,175.756896,316.362413,86.52225,2,6
0,0,14,14,14,17,31,51,39,90,0.000333,0.148626,14,6242.287351,346.793742,445.877668,122.789837,3,6
0,0,10,10,13,16,29,39,30,69,0.000333,0.111734,6,2011.204132,111.733563,335.200689,112.105716,2,6
0,0,12,12,10,15,25,42,33,75,0.000333,0.116096,10,3482.892142,193.494008,348.289214,91.82264,2,6
0,0,15,15,14,18,32,55,41,96,0.000333,0.16,14,6720,373.333333,480,128.361619,3,6
0,0,10,10,13,16,29,39,30,69,0.000333,0.111734,6,2011.204132,111.733563,335.200689,112.105716,2,6
0,0,9,9,13,18,31,29,25,54,0.000333,0.089176,6,1605.159605,89.175534,267.526601,123.164366,3,6
0,0,6,6,11,13,24,21,16,37,0.000333,0.056548,5,848.218063,47.123226,169.643613,86.159464,3,6
0,0,7,7,11,19,30,24,23,47,0.000333,0.076875,5,1153.11929,64.062183,230.623858,118.764371,3,6
0,0,4,4,9,12,21,16,14,30,0.000333,0.043923,4,527.078091,29.282116,131.769523,71.548875,3,6
0,0,7,7,11,18,29,24,22,46,0.000333,0.074489,5,1117.335629,62.074202,223.467126,113.112398,3,6
0,0,4,4,9,11,20,16,13,29,0.000333,0.041779,4,501.343659,27.852426,125.335915,66.583073,3,6
0,0,5,5,11,17,28,23,21,44,0.000333,0.070508,5,1057.618083,58.75656,211.523617,107.540616,2,6
0,0,9,9,14,20,34,42,31,73,0.000333,0.123795,7,2599.693512,144.427417,371.384787,139.741531,3,6
0,0,11,11,10,15,25,37,31,68,0.000333,0.105261,10,3157.822209,175.434567,315.782221,91.82264,2,6
0,0,14,14,14,18,32,50,39,89,0.000333,0.148333,14,6230,346.111111,445,128.361619,3,6
0,0,10,10,13,16,29,39,30,69,0.000333,0.111734,6,2011.204132,111.733563,335.200689,112.105716,2,6
0,0,15,15,12,19,31,52,39,91,0.000333,0.150277,12,5409.982371,300.554576,450.831864,123.730173,3,6
0,0,18,18,15,22,37,65,47,112,0.000333,0.194486,14,8168.422877,453.801271,583.458777,156.710855,4,6
0,0,10,10,13,16,29,39,30,69,0.000333,0.111734,6,2011.204132,111.733563,335.200689,112.105716,2,6
0,0,7,7,9,12,21,19,20,39,0.000333,0.0571,4,685.201518,38.066751,171.300379,71.548875,7,6
0,0,7,7,12,15,27,33,23,56,0.000333,0.088758,6,1597.642201,88.7579,266.2737,101.622909,3,6
0,0,27,27,18,51,69,119,91,210,0.000333,0.427597,9,11545.11122,641.395068,1282.790136,364.352342,10,6
0,0,26,26,18,51,69,118,89,207,0.000333,0.421488,9,11380.18106,632.232281,1264.464563,364.352342,10,6
0,0,9,9,12,17,29,38,30,68,0.000333,0.110114,6,1982.056246,110.114236,330.342708,112.506418,3,6
0,0,9,9,12,17,29,38,30,68,0.000333,0.110114,6,1982.056246,110.114236,330.342708,112.506418,3,6
0,0,36,36,18,53,71,151,125,276,0.000333,0.565777,18,30551.94369,1697.330205,1697.330205,378.638434,10,6
0,0,39,39,20,55,75,164,133,297,0.000333,0.616653,20,36999.18302,2055.510168,1849.959151,404.413346,11,6
0,0,10,10,13,18,31,41,34,75,0.000333,0.123855,6,2229.38834,123.854908,371.564723,123.164366,2,6
0,0,14,14,12,16,28,50,40,90,0.000333,0.144221,12,5191.943316,288.441295,432.661943,107.01955,3,6
0,0,17,17,16,19,35,63,48,111,0.000333,0.189783,16,9109.606638,506.089258,569.350415,144.710623,4,6
0,0,10,10,13,16,29,39,30,69,0.000333,0.111734,6,2011.204132,111.733563,335.200689,112.105716,2,6
0,0,13,13,10,16,26,44,35,79,0.000333,0.123778,10,3713.347377,206.297077,371.334738,97.219281,3,6
0,0,16,16,14,19,33,57,43,100,0.000333,0.168146,14,7062.151767,392.341765,504.439412,134.013592,4,6
0,0,10,10,13,16,29,39,30,69,0.000333,0.111734,6,2011.204132,111.733563,335.200689,112.105716,2,6
0,0,13,13,10,16,26,44,35,79,0.000333,0.123778,10,3713.347377,206.297077,371.334738,97.219281,3,6
0,0,16,16,14,19,33,57,43,100,0.000333,0.168146,14,7062.151767,392.341765,504.439412,134.013592,4,6
0,0,10,10,13,16,29,39,30,69,0.000333,0.111734,6,2011.204132,111.733563,335.200689,112.105716,2,6
0,0,13,13,10,15,25,44,34,78,0.000333,0.12074,10,3622.207828,201.233768,362.220783,91.82264,3,6
0,0,16,16,14,18,32,57,42,99,0.000333,0.165,14,6930,385,495,128.361619,4,6
0,0,10,10,13,16,29,39,30,69,0.000333,0.111734,6,2011.204132,111.733563,335.200689,112.105716,2,6
0,0,9,9,13,16,29,34,26,60,0.000333,0.09716,6,1748.873158,97.15962,291.47886,112.105716,4,6
0,0,6,6,11,18,29,26,23,49,0.000333,0.079347,5,1190.205344,66.122519,238.041069,113.112398,3,6
0,0,10,10,14,21,35,45,33,78,0.000333,0.133361,7,2800.588527,155.588252,400.084075,145.541635,4,6
0,0,36,36,20,54,74,153,113,266,0.000333,0.550572,20,33034.29191,1835.238439,1651.714595,397.202487,13,6
0,0,39,39,22,56,78,166,121,287,0.000333,0.601303,22,39686.02961,2204.779423,1803.910437,423.319371,14,6
0,0,10,10,13,16,29,39,30,69,0.000333,0.111734,6,2011.204132,111.733563,335.200689,112.105716,2,6
0,0,32,32,22,55,77,142,102,244,0.000333,0.509699,11,16820.05508,934.447504,1529.095916,416.08228,14,6
0,0,31,31,22,55,77,141,100,241,0.000333,0.503432,11,16613.25112,922.958396,1510.295556,416.08228,14,6
0,0,39,39,21,55,76,162,121,283,0.000333,0.589388,20,35363.26973,1964.626096,1768.163486,410.21345,13,6
0,0,42,42,23,57,80,175,129,304,0.000333,0.640622,22,42281.0551,2348.947505,1921.866141,436.516656,14,6
0,0,10,10,13,16,29,39,30,69,0.000333,0.111734,6,2011.204132,111.733563,335.200689,112.105716,2,6
0,0,25,25,22,44,66,113,80,193,0.000333,0.388856,11,12832.24872,712.902706,1166.568065,338.322487,10,6
0,0,24,24,22,44,66,112,78,190,0.000333,0.382812,11,12632.78371,701.821317,1148.434883,338.322487,10,6
0,0,13,13,10,14,24,44,34,78,0.000333,0.119209,10,3576.270751,198.681708,357.627075,86.52225,3,6
0,0,16,16,14,17,31,57,42,99,0.000333,0.163488,14,6866.516086,381.473116,490.465435,122.789837,4,6
0,0,10,10,13,16,29,39,30,69,0.000333,0.111734,6,2011.204132,111.733563,335.200689,112.105716,2,6
0,0,15,15,12,15,27,49,37,86,0.000333,0.136307,12,4907.043902,272.61355,408.920325,101.622909,3,6
0,0,18,18,16,18,34,62,45,107,0.000333,0.181453,16,8709.736384,483.874244,544.358524,139.05865,4,6
0,0,10,10,13,16,29,39,30,69,0.000333,0.111734,6,2011.204132,111.733563,335.200689,112.105716,2,6
0,0,13,13,10,15,25,44,34,78,0.000333,0.12074,10,3622.207828,201.233768,362.220783,91.82264,3,6
0,0,16,16,14,18,32,57,42,99,0.000333,0.165,14,6930,385,495,128.361619,4,6
0,0,10,10,13,16,29,39,30,69,0.000333,0.111734,6,2011.204132,111.733563,335.200689,112.105716,2,6
0,0,18,18,10,18,28,55,63,118,0.000333,0.189089,15,8509.018212,472.723234,567.267881,108.277931,2,6
0,0,21,21,14,21,35,68,71,139,0.000333,0.237657,21,14972.37713,831.798729,712.970339,145.541635,3,6
0,0,10,10,13,17,30,41,32,73,0.000333,0.119401,6,2149.218081,119.401004,358.203013,117.592585,2,6
0,0,16,16,10,17,27,50,53,103,0.000333,0.163251,15,7346.301191,408.127844,489.753413,102.706149,2,6
0,0,19,19,14,20,34,63,61,124,0.000333,0.210282,21,13247.75324,735.986291,630.845392,139.741531,3,6
0,0,10,10,13,17,30,41,32,73,0.000333,0.119401,6,2149.218081,119.401004,358.203013,117.592585,2,6
0,0,9,9,10,14,24,36,29,65,0.000333,0.099341,10,2980.225625,165.56809,298.022563,86.52225,2,6
0,0,12,12,14,17,31,49,37,86,0.000333,0.14202,14,5964.852358,331.380687,426.060883,122.789837,3,6
0,0,10,10,13,17,30,41,32,73,0.000333,0.119401,6,2149.218081,119.401004,358.203013,117.592585,2,6
0,0,23,23,17,45,62,105,79,184,0.000333,0.365191,8,8764.576969,486.920943,1095.572121,316.620258,9,6
0,0,22,22,17,45,62,104,77,181,0.000333,0.359237,8,8621.676257,478.982014,1077.709532,316.620258,9,6
0,0,15,15,15,19,34,72,45,117,0.000333,0.198411,14,8333.264134,462.959119,595.233152,139.313982,5,6
0,0,15,15,14,20,34,72,46,118,0.000333,0.200107,14,8404.488614,466.916034,600.320615,139.741531,5,6
0,0,6,6,11,18,29,26,22,48,0.000333,0.077728,5,1165.915439,64.77308,233.183088,113.112398,3,6
0,0,10,10,14,21,35,45,32,77,0.000333,0.131652,7,2764.683546,153.59353,394.954792,145.541635,4,6
0,0,17,17,10,19,29,58,53,111,0.000333,0.179745,10,5392.358905,299.575495,539.23589,113.929904,2,6
0,0,20,20,14,22,36,71,61,132,0.000333,0.227477,14,9554.021403,530.778967,682.4301,151.410465,3,6
0,0,10,10,13,18,31,43,32,75,0.000333,0.123855,6,2229.38834,123.854908,371.564723,123.164366,2,6
0,0,16,16,12,18,30,58,50,108,0.000333,0.176648,12,6359.330212,353.296123,529.944184,118.0782,2,6
0,0,19,19,15,21,36,71,58,129,0.000333,0.222307,14,9336.884553,518.715808,666.920325,150.842025,3,6
0,0,10,10,13,17,30,42,32,74,0.000333,0.121037,6,2178.659424,121.036635,363.109904,117.592585,2,6
0,0,9,9,12,13,25,33,29,62,0.000333,0.095973,12,3455.029005,191.946056,287.919084,91.125266,9,6
0,0,10,10,10,19,29,37,39,76,0.000333,0.123069,10,3692.065556,205.114753,369.206556,113.929904,2,6
0,0,11,11,10,19,29,38,41,79,0.000333,0.127927,10,3837.804986,213.211388,383.780499,113.929904,2,6
0,0,10,10,11,21,32,38,36,74,0.000333,0.123333,5,1850,102.777778,370,130.292414,2,6
0,0,11,11,11,21,32,39,38,77,0.000333,0.128333,5,1925,106.944444,385,130.292414,2,6
0,0,10,10,10,19,29,36,35,71,0.000333,0.114972,5,1724.583253,95.810181,344.916651,113.929904,2,6
0,0,11,11,10,19,29,37,37,74,0.000333,0.11983,5,1797.452968,99.858498,359.490594,113.929904,2,6
0,0,6,6,11,19,30,24,25,49,0.000333,0.080146,5,1202.188196,66.788233,240.437639,118.764371,3,6
0,0,35,35,19,51,70,150,117,267,0.000333,0.545506,18,29457.33418,1636.518566,1636.518566,370.004315,11,6
0,0,38,38,21,53,74,163,125,288,0.000333,0.596108,20,35766.45139,1987.025077,1788.322569,395.81845,12,6
0,0,10,10,13,16,29,39,30,69,0.000333,0.111734,6,2011.204132,111.733563,335.200689,112.105716,2,6
0,0,11,11,10,15,25,37,31,68,0.000333,0.105261,10,3157.822209,175.434567,315.782221,91.82264,2,6
0,0,14,14,14,18,32,50,39,89,0.000333,0.148333,14,6230,346.111111,445,128.361619,3,6
0,0,10,10,13,16,29,39,30,69,0.000333,0.111734,6,2011.204132,111.733563,335.200689,112.105716,2,6
0,0,11,11,10,15,25,37,31,68,0.000333,0.105261,10,3157.822209,175.434567,315.782221,91.82264,2,6
0,0,14,14,14,18,32,50,39,89,0.000333,0.148333,14,6230,346.111111,445,128.361619,3,6
0,0,10,10,13,16,29,39,30,69,0.000333,0.111734,6,2011.204132,111.733563,335.200689,112.105716,2,6
0,0,9,9,10,14,24,36,29,65,0.000333,0.099341,10,2980.225625,165.56809,298.022563,86.52225,2,6
0,0,12,12,14,17,31,49,37,86,0.000333,0.14202,14,5964.852358,331.380687,426.060883,122.789837,3,6
0,0,10,10,13,17,30,41,32,73,0.000333,0.119401,6,2149.218081,119.401004,358.203013,117.592585,2,6
0,0,8,8,10,14,24,24,21,45,0.000333,0.068774,5,1031.616563,57.312031,206.323313,86.52225,2,6
0,0,8,8,10,14,24,24,21,45,0.000333,0.068774,5,1031.616563,57.312031,206.323313,86.52225,2,6
0,0,11,11,13,29,42,74,52,126,0.000333,0.226477,6,4076.591972,226.477332,679.431995,188.987165,6,6
0,0,13,13,13,32,45,83,60,143,0.000333,0.261778,6,4712.009957,261.778331,785.334993,208.105716,6,6
0,0,12,12,13,30,43,77,54,131,0.000333,0.236947,6,4265.044097,236.946894,710.840683,195.312434,7,6
0,0,14,14,13,33,46,86,62,148,0.000333,0.272496,6,4904.923017,272.495723,817.487169,214.570722,7,6
0,0,12,12,13,30,43,77,53,130,0.000333,0.235138,6,4232.486509,235.138139,705.414418,195.312434,7,6
0,0,14,14,13,33,46,86,61,147,0.000333,0.270655,6,4871.781645,270.654536,811.963608,214.570722,7,6
0,0,11,11,13,29,42,74,52,126,0.000333,0.226477,6,4076.591972,226.477332,679.431995,188.987165,6,6
0,0,13,13,13,32,45,83,60,143,0.000333,0.261778,6,4712.009957,261.778331,785.334993,208.105716,6,6
0,0,12,12,13,31,44,77,54,131,0.000333,0.238395,6,4291.113252,238.395181,715.185542,201.685802,7,6
0,0,14,14,13,34,47,86,62,148,0.000333,0.274026,6,4932.4749,274.026383,822.07915,221.079453,7,6
0,0,10,10,10,15,25,36,32,68,0.000333,0.105261,10,3157.822209,175.434567,315.782221,91.82264,2,6
0,0,13,13,14,18,32,49,40,89,0.000333,0.148333,14,6230,346.111111,445,128.361619,3,6
0,0,10,10,13,16,29,39,30,69,0.000333,0.111734,6,2011.204132,111.733563,335.200689,112.105716,2,6
0,0,38,38,19,55,74,160,125,285,0.000333,0.589898,18,31854.49577,1769.694209,1769.694209,398.685407,12,6
0,0,41,41,21,57,78,173,133,306,0.000333,0.641111,20,38466.66158,2137.036754,1923.333079,424.713397,13,6
0,0,10,10,13,18,31,42,32,74,0.000333,0.122204,6,2199.663162,122.203509,366.610527,123.164366,2,6
0,0,39,39,19,56,75,168,129,297,0.000333,0.616653,18,33299.26472,1849.959151,1849.959151,405.922498,12,6
0,0,42,42,21,58,79,181,137,318,0.000333,0.668201,20,40092.04556,2227.335864,2004.602278,432.001564,13,6
0,0,10,10,13,17,30,42,32,74,0.000333,0.121037,6,2178.659424,121.036635,363.109904,117.592585,2,6
0,0,9,9,10,14,24,36,29,65,0.000333,0.099341,10,2980.225625,165.56809,298.022563,86.52225,2,6
0,0,12,12,14,17,31,49,37,86,0.000333,0.14202,14,5964.852358,331.380687,426.060883,122.789837,3,6
0,0,10,10,13,17,30,41,32,73,0.000333,0.119401,6,2149.218081,119.401004,358.203013,117.592585,2,6
0,0,27,27,18,50,68,119,91,210,0.000333,0.426122,9,11505.30477,639.183598,1278.367197,357.25146,9,6
0,0,26,26,18,50,68,118,89,207,0.000333,0.420035,9,11340.94327,630.052404,1260.104808,357.25146,9,6
0,0,15,15,14,20,34,72,46,118,0.000333,0.200107,14,8404.488614,466.916034,600.320615,139.741531,5,6
0,0,30,30,20,49,69,135,99,234,0.000333,0.476465,20,28587.89446,1588.216359,1429.394723,361.559344,9,6
0,0,29,29,20,49,69,134,97,231,0.000333,0.470356,10,14110.6915,783.927305,1411.06915,361.559344,9,6
0,0,29,29,20,48,68,134,94,228,0.000333,0.462647,10,13879.41528,771.078627,1387.941528,354.516762,10,6
0,0,28,28,20,48,68,133,92,225,0.000333,0.45656,10,13696.79139,760.932855,1369.679139,354.516762,10,6
0,0,26,26,21,47,68,119,87,206,0.000333,0.418006,10,12540.17345,696.676303,1254.017345,353.304342,11,6
0,0,25,25,21,47,68,118,85,203,0.000333,0.411918,10,12357.54957,686.530532,1235.754957,353.304342,11,6
0,0,10,10,11,15,26,37,30,67,0.000333,0.104976,10,3149.294611,174.960812,314.929461,96.657107,2,6
0,0,13,13,15,18,33,50,38,88,0.000333,0.147969,14,6214.693555,345.260753,443.906683,133.662009,3,6
0,0,15,15,11,15,26,49,45,94,0.000333,0.14728,15,6627.620003,368.201111,441.841334,96.657107,2,6
0,0,18,18,15,18,33,62,53,115,0.000333,0.193368,14,8121.474532,451.19303,580.105324,133.662009,3,6
0,0,10,10,13,16,29,39,30,69,0.000333,0.111734,6,2011.204132,111.733563,335.200689,112.105716,2,6
0,0,15,15,10,17,27,51,59,110,0.000333,0.174346,15,7845.564379,435.864688,523.037625,102.706149,2,6
0,0,18,18,14,20,34,64,67,131,0.000333,0.222153,21,13995.61028,777.533904,666.457632,139.741531,3,6
0,0,10,10,13,17,30,41,32,73,0.000333,0.119401,6,2149.218081,119.401004,358.203013,117.592585,2,6
0,0,29,29,20,50,70,134,95,229,0.000333,0.467869,10,14036.05811,779.781006,1403.605811,368.631371,10,6
0,0,28,28,20,50,70,133,93,226,0.000333,0.461739,10,13852.17962,769.565534,1385.217962,368.631371,10,6
0,0,13,13,10,17,27,43,35,78,0.000333,0.123627,10,3708.812252,206.045125,370.881225,102.706149,3,6
0,0,16,16,14,20,34,56,43,99,0.000333,0.167886,14,7051.223498,391.734639,503.658821,139.741531,4,6
0,0,10,10,13,16,29,39,30,69,0.000333,0.111734,6,2011.204132,111.733563,335.200689,112.105716,2,6
0,0,13,13,11,16,27,43,34,77,0.000333,0.122042,10,3661.263377,203.403521,366.126338,102.053748,3,6
0,0,16,16,15,19,34,56,42,98,0.000333,0.16619,14,6979.999018,387.777723,498.571358,139.313982,4,6
0,0,10,10,13,16,29,39,30,69,0.000333,0.111734,6,2011.204132,111.733563,335.200689,112.105716,2,6
0,0,11,11,12,21,33,45,45,90,0.000333,0.151332,12,5447.945649,302.663647,453.995471,135.258216,4,6
0,0,29,29,18,46,64,129,93,222,0.000333,0.444,18,23976,1332,1332,329.1425,9,6
0,0,32,32,20,49,69,142,101,243,0.000333,0.49479,20,29687.42886,1649.301603,1484.371443,361.559344,10,6
0,0,10,10,13,16,29,39,30,69,0.000333,0.111734,6,2011.204132,111.733563,335.200689,112.105716,2,6
0,0,27,27,20,49,69,121,86,207,0.000333,0.421488,10,12644.64563,702.480313,1264.464563,361.559344,10,6
0,0,26,26,20,49,69,120,84,204,0.000333,0.41538,10,12461.38989,692.299438,1246.138989,361.559344,10,6
0,0,29,29,18,46,64,129,94,223,0.000333,0.446,18,24084,1338,1338,329.1425,9,6
0,0,32,32,20,49,69,142,102,244,0.000333,0.496827,20,29809.59935,1656.088853,1490.479967,361.559344,10,6
0,0,10,10,13,16,29,39,30,69,0.000333,0.111734,6,2011.204132,111.733563,335.200689,112.105716,2,6
0,0,27,27,20,49,69,121,87,208,0.000333,0.423524,10,12705.73087,705.873937,1270.573087,361.559344,10,6
0,0,26,26,20,49,69,120,85,205,0.000333,0.417416,10,12522.47514,695.693063,1252.247514,361.559344,10,6
0,0,29,29,18,45,63,129,93,222,0.000333,0.442319,18,23885.21057,1326.956143,1326.956143,322.192039,9,6
0,0,32,32,20,48,68,142,101,243,0.000333,0.493084,20,29585.06941,1643.614967,1479.25347,354.516762,10,6
0,0,10,10,13,16,29,39,30,69,0.000333,0.111734,6,2011.204132,111.733563,335.200689,112.105716,2,6
0,0,27,27,20,48,68,121,86,207,0.000333,0.420035,10,12601.04808,700.058227,1260.104808,354.516762,10,6
0,0,26,26,20,48,68,120,84,204,0.000333,0.413947,10,12418.4242,689.912455,1241.84242,354.516762,10,6
0,0,31,31,20,46,66,134,96,230,0.000333,0.463404,20,27804.21295,1544.678497,1390.210647,340.522412,9,6
0,0,34,34,22,49,71,147,104,251,0.000333,0.514529,22,33958.90359,1886.605755,1543.586527,373.228278,10,6
0,0,10,10,13,16,29,39,30,69,0.000333,0.111734,6,2011.204132,111.733563,335.200689,112.105716,2,6
0,0,29,29,22,49,71,126,89,215,0.000333,0.440732,11,14544.15194,808.008441,1322.195631,373.228278,10,6
0,0,28,28,22,49,71,125,87,212,0.000333,0.434582,11,14341.21028,796.733905,1303.746389,373.228278,10,6
0,0,10,10,11,15,26,37,30,67,0.000333,0.104976,10,3149.294611,174.960812,314.929461,96.657107,2,6
0,0,13,13,15,18,33,50,38,88,0.000333,0.147969,14,6214.693555,345.260753,443.906683,133.662009,3,6
0,0,10,10,14,14,28,40,28,68,0.000333,0.108967,14,4576.601886,254.25566,326.900135,106.605938,2,6
0,0,37,37,19,54,73,155,122,277,0.000333,0.571527,18,30862.46525,1714.581403,1714.581403,391.474548,12,6
0,0,40,40,21,56,77,168,130,298,0.000333,0.622501,20,37350.04778,2075.002655,1867.502389,417.450542,13,6
0,0,10,10,13,17,30,41,32,73,0.000333,0.119401,6,2149.218081,119.401004,358.203013,117.592585,2,6
0,0,33,33,21,56,77,144,111,255,0.000333,0.532677,10,15980.30568,887.79476,1598.030568,417.450542,13,6
0,0,32,32,21,56,77,143,109,252,0.000333,0.52641,10,15792.30208,877.350116,1579.230208,417.450542,13,6
0,0,7,7,11,19,30,24,23,47,0.000333,0.076875,5,1153.11929,64.062183,230.623858,118.764371,3,6
0,0,4,4,9,12,21,16,14,30,0.000333,0.043923,4,527.078091,29.282116,131.769523,71.548875,3,6
0,0,9,9,12,18,30,28,25,53,0.000333,0.086688,6,1560.391209,86.688401,260.065202,118.0782,3,6
0,0,6,6,10,13,23,20,16,36,0.000333,0.054283,5,814.241152,45.23562,162.84823,81.324997,3,6
0,0,5,5,11,12,23,21,18,39,0.000333,0.058806,5,882.094581,49.005255,176.418916,81.073298,2,6
0,0,23,23,20,46,66,112,83,195,0.000333,0.392886,10,11786.56853,654.809363,1178.656853,340.522412,11,6
0,0,22,22,20,46,66,111,81,192,0.000333,0.386841,10,11605.23671,644.735373,1160.523671,340.522412,11,6
0,0,24,24,20,48,68,115,85,200,0.000333,0.405831,10,12174.92568,676.38476,1217.492568,354.516762,12,6
0,0,23,23,20,48,68,114,83,197,0.000333,0.399743,10,11992.3018,666.238989,1199.23018,354.516762,12,6
0,0,27,27,19,51,70,124,93,217,0.000333,0.443351,9,11970.48973,665.027207,1330.054415,370.004315,9,6
0,0,26,26,19,51,70,123,91,214,0.000333,0.437222,9,11804.99909,655.833283,1311.666566,370.004315,9,6
0,0,13,13,11,14,25,44,34,78,0.000333,0.12074,10,3622.207828,201.233768,362.220783,91.356717,3,6
0,0,16,16,15,17,32,57,42,99,0.000333,0.165,14,6930,385,495,128.090227,4,6
0,0,10,10,13,16,29,39,30,69,0.000333,0.111734,6,2011.204132,111.733563,335.200689,112.105716,2,6
0,0,9,9,12,17,29,38,30,68,0.000333,0.110114,6,1982.056246,110.114236,330.342708,112.506418,3,6
0,0,15,15,12,15,27,49,37,86,0.000333,0.136307,12,4907.043902,272.61355,408.920325,101.622909,3,6
0,0,18,18,16,18,34,62,45,107,0.000333,0.181453,16,8709.736384,483.874244,544.358524,139.05865,4,6
0,0,10,10,13,16,29,39,30,69,0.000333,0.111734,6,2011.204132,111.733563,335.200689,112.105716,2,6
0,0,31,31,18,47,65,136,105,241,0.000333,0.483797,18,26125.03157,1451.390643,1451.390643,336.124326,8,6
0,0,34,34,20,50,70,149,113,262,0.000333,0.535291,20,32117.44301,1784.302389,1605.87215,368.631371,9,6
0,0,10,10,13,18,31,42,32,74,0.000333,0.122204,6,2199.663162,122.203509,366.610527,123.164366,2,6
0,0,9,9,10,14,24,36,29,65,0.000333,0.099341,10,2980.225625,165.56809,298.022563,86.52225,2,6
0,0,12,12,14,17,31,49,37,86,0.000333,0.14202,14,5964.852358,331.380687,426.060883,122.789837,3,6
0,0,10,10,13,17,30,41,32,73,0.000333,0.119401,6,2149.218081,119.401004,358.203013,117.592585,2,6
0,0,12,12,10,15,25,42,33,75,0.000333,0.116096,10,3482.892142,193.494008,348.289214,91.82264,2,6
0,0,15,15,14,18,32,55,41,96,0.000333,0.16,14,6720,373.333333,480,128.361619,3,6
0,0,10,10,13,16,29,39,30,69,0.000333,0.111734,6,2011.204132,111.733563,335.200689,112.105716,2,6
0,0,15,15,11,22,33,57,44,101,0.000333,0.169828,10,5094.838061,283.046559,509.483806,136.161243,4,6
0,0,18,18,14,24,38,70,52,122,0.000333,0.213416,14,8963.460193,497.970011,640.247157,163.342069,5,6
0,0,10,10,13,16,29,39,30,69,0.000333,0.111734,6,2011.204132,111.733563,335.200689,112.105716,2,6
0,0,12,12,13,21,34,48,35,83,0.000333,0.140753,6,2533.556495,140.753139,422.259416,140.344382,5,6
0,0,13,13,13,22,35,49,37,86,0.000333,0.147039,6,2646.710037,147.039446,441.118339,146.213212,5,6
0,0,15,15,11,21,32,57,43,100,0.000333,0.166667,10,5000,277.777778,500,130.292414,4,6
0,0,18,18,14,23,37,70,51,121,0.000333,0.210115,14,8824.814001,490.267445,630.343857,157.344894,5,6
0,0,10,10,13,16,29,39,30,69,0.000333,0.111734,6,2011.204132,111.733563,335.200689,112.105716,2,6
0,0,12,12,13,20,33,48,34,82,0.000333,0.13788,6,2481.841907,137.880106,413.640318,134.544278,5,6
0,0,13,13,13,21,34,49,36,85,0.000333,0.144145,6,2594.606049,144.144781,432.434342,140.344382,5,6
0,0,17,17,15,24,39,64,57,121,0.000333,0.213178,14,8953.471359,497.415075,639.533668,168.642459,3,6
0,0,20,20,17,26,43,77,65,142,0.000333,0.256843,16,12328.47352,684.915196,770.529595,191.698301,4,6
0,0,18,18,16,26,42,69,60,129,0.000333,0.23187,16,11129.74316,618.319064,695.608948,186.211433,3,6
0,0,11,11,12,27,39,70,48,118,0.000333,0.207892,6,3742.064771,207.892487,623.677462,171.401513,7,6
0,0,13,13,12,31,43,79,56,135,0.000333,0.244182,6,4395.274451,244.181914,732.545742,196.599636,7,6
0,0,13,13,10,17,27,45,35,80,0.000333,0.126797,10,3803.910002,211.328333,380.391,102.706149,3,6
0,0,16,16,14,20,34,58,43,101,0.000333,0.171278,14,7193.672458,399.64847,513.833747,139.741531,4,6
0,0,10,10,13,16,29,39,30,69,0.000333,0.111734,6,2011.204132,111.733563,335.200689,112.105716,2,6
0,0,5,5,10,12,22,15,15,30,0.000333,0.044594,5,668.914743,37.16193,133.782949,76.238831,2,6
0,0,7,7,11,13,24,19,17,36,0.000333,0.05502,5,825.29325,45.849625,165.05865,86.159464,2,6
0,0,5,5,10,11,21,15,14,29,0.000333,0.042459,5,636.886026,35.382557,127.377205,71.273029,2,6
0,0,5,5,10,11,21,15,14,29,0.000333,0.042459,5,636.886026,35.382557,127.377205,71.273029,2,6
0,0,7,7,12,13,25,20,17,37,0.000333,0.057274,6,1030.936074,57.274226,171.822679,91.125266,2,6
0,0,37,37,18,52,70,154,132,286,0.000333,0.584325,18,31553.54897,1752.974943,1752.974943,371.481515,10,6
0,0,40,40,20,54,74,167,140,307,0.000333,0.635434,20,38126.04367,2118.113537,1906.302183,397.202487,11,6
0,0,10,10,13,17,30,41,32,73,0.000333,0.119401,6,2149.218081,119.401004,358.203013,117.592585,2,6
0,0,15,15,10,17,27,51,59,110,0.000333,0.174346,15,7845.564379,435.864688,523.037625,102.706149,2,6
0,0,18,18,14,20,34,64,67,131,0.000333,0.222153,21,13995.61028,777.533904,666.457632,139.741531,3,6
0,0,10,10,13,17,30,41,32,73,0.000333,0.119401,6,2149.218081,119.401004,358.203013,117.592585,2,6
0,0,9,9,10,14,24,36,29,65,0.000333,0.099341,10,2980.225625,165.56809,298.022563,86.52225,2,6
0,0,12,12,14,17,31,49,37,86,0.000333,0.14202,14,5964.852358,331.380687,426.060883,122.789837,3,6
0,0,10,10,13,17,30,41,32,73,0.000333,0.119401,6,2149.218081,119.401004,358.203013,117.592585,2,6
0,0,21,21,16,26,42,117,70,187,0.000333,0.336121,16,16133.81373,896.322985,1008.363358,186.211433,8,6
0,0,8,8,13,21,34,35,26,61,0.000333,0.103445,6,1862.0114,103.445078,310.335233,140.344382,3,6
0,0,20,20,16,26,42,105,64,169,0.000333,0.303767,16,14580.82631,810.045906,911.301644,186.211433,7,6
0,0,17,17,10,20,30,61,54,115,0.000333,0.188097,10,5642.924185,313.495788,564.292418,119.657843,2,6
0,0,20,20,14,23,37,74,62,136,0.000333,0.236162,14,9918.799208,551.0444,708.485658,157.344894,3,6
0,0,10,10,13,18,31,43,32,75,0.000333,0.123855,6,2229.38834,123.854908,371.564723,123.164366,2,6
0,0,11,11,12,20,32,41,37,78,0.000333,0.13,6,2340,130,390,129.458112,2,6
0,0,10,10,12,20,32,40,35,75,0.000333,0.125,6,2250,125,375,129.458112,2,6
0,0,13,13,10,15,25,44,34,78,0.000333,0.12074,10,3622.207828,201.233768,362.220783,91.82264,3,6
0,0,16,16,14,18,32,57,42,99,0.000333,0.165,14,6930,385,495,128.361619,4,6
0,0,10,10,13,16,29,39,30,69,0.000333,0.111734,6,2011.204132,111.733563,335.200689,112.105716,2,6
0,0,15,15,14,20,34,72,46,118,0.000333,0.200107,14,8404.488614,466.916034,600.320615,139.741531,5,6
0,0,13,13,10,15,25,44,34,78,0.000333,0.12074,10,3622.207828,201.233768,362.220783,91.82264,3,6
0,0,16,16,14,18,32,57,42,99,0.000333,0.165,14,6930,385,495,128.361619,4,6
0,0,10,10,13,16,29,39,30,69,0.000333,0.111734,6,2011.204132,111.733563,335.200689,112.105716,2,6
0,0,14,14,14,22,36,61,43,104,0.000333,0.179224,7,3763.705401,209.094745,537.6722,151.410465,4,6
0,0,15,15,14,23,37,62,45,107,0.000333,0.185804,7,3901.880571,216.771143,557.41151,157.344894,4,6
0,0,10,10,11,22,33,45,44,89,0.000333,0.14965,10,4489.510766,249.417265,448.951077,136.161243,3,6
0,0,11,11,10,15,25,37,31,68,0.000333,0.105261,10,3157.822209,175.434567,315.782221,91.82264,2,6
0,0,14,14,14,18,32,50,39,89,0.000333,0.148333,14,6230,346.111111,445,128.361619,3,6
0,0,10,10,13,16,29,39,30,69,0.000333,0.111734,6,2011.204132,111.733563,335.200689,112.105716,2,6
0,0,8,8,12,14,26,28,24,52,0.000333,0.081474,6,1466.537192,81.474288,244.422865,96.322519,2,6
0,0,11,11,10,15,25,37,31,68,0.000333,0.105261,10,3157.822209,175.434567,315.782221,91.82264,2,6
0,0,14,14,14,18,32,50,39,89,0.000333,0.148333,14,6230,346.111111,445,128.361619,3,6
0,0,10,10,13,16,29,39,30,69,0.000333,0.111734,6,2011.204132,111.733563,335.200689,112.105716,2,6
0,0,11,11,10,15,25,37,31,68,0.000333,0.105261,10,3157.822209,175.434567,315.782221,91.82264,2,6
0,0,14,14,14,18,32,50,39,89,0.000333,0.148333,14,6230,346.111111,445,128.361619,3,6
0,0,10,10,13,16,29,39,30,69,0.000333,0.111734,6,2011.204132,111.733563,335.200689,112.105716,2,6
0,0,13,13,10,16,26,41,37,78,0.000333,0.122211,10,3666.34298,203.685721,366.634298,97.219281,2,6
0,0,16,16,14,19,33,54,45,99,0.000333,0.166465,14,6991.530249,388.418347,499.395018,134.013592,3,6
0,0,10,10,13,16,29,39,30,69,0.000333,0.111734,6,2011.204132,111.733563,335.200689,112.105716,2,6
0,0,11,11,10,15,25,37,31,68,0.000333,0.105261,10,3157.822209,175.434567,315.782221,91.82264,2,6
0,0,14,14,14,18,32,50,39,89,0.000333,0.148333,14,6230,346.111111,445,128.361619,3,6
0,0,10,10,13,16,29,39,30,69,0.000333,0.111734,6,2011.204132,111.733563,335.200689,112.105716,2,6
0,0,24,24,18,47,65,106,82,188,0.000333,0.377402,9,10189.84634,566.102574,1132.205149,336.124326,8,6
0,0,23,23,18,47,65,105,80,185,0.000333,0.371379,9,10027.24241,557.069023,1114.138045,336.124326,8,6
0,0,32,32,18,50,68,142,103,245,0.000333,0.497143,18,26845.71113,1491.428396,1491.428396,357.25146,11,6
0,0,35,35,20,52,72,155,111,266,0.000333,0.547067,20,32824.00101,1823.555612,1641.20005,382.861427,12,6
0,0,10,10,13,16,29,39,30,69,0.000333,0.111734,6,2011.204132,111.733563,335.200689,112.105716,2,6
0,0,30,30,20,52,72,134,96,230,0.000333,0.473028,10,14190.8275,788.379306,1419.08275,382.861427,12,6
0,0,29,29,20,52,72,133,94,227,0.000333,0.466858,10,14005.72975,778.096097,1400.572975,382.861427,12,6
0,0,9,9,12,12,24,36,29,65,0.000333,0.099341,12,3576.270751,198.681708,298.022563,86.0391,2,6
0,0,12,12,16,16,32,49,37,86,0.000333,0.143333,16,6880,382.222222,430,128,3,6
0,0,10,10,15,16,31,41,32,73,0.000333,0.120552,14,5063.188629,281.288257,361.656331,122.603359,2,6
0,0,13,13,10,16,26,45,34,79,0.000333,0.123778,10,3713.347377,206.297077,371.334738,97.219281,3,6
0,0,16,16,14,19,33,58,42,100,0.000333,0.168146,14,7062.151767,392.341765,504.439412,134.013592,4,6
0,0,10,10,13,16,29,39,30,69,0.000333,0.111734,6,2011.204132,111.733563,335.200689,112.105716,2,6
0,0,25,25,20,47,67,116,89,205,0.000333,0.414516,10,12435.48284,690.860158,1243.548284,347.504238,11,6
0,0,24,24,20,47,67,115,87,202,0.000333,0.40845,10,12253.50017,680.750009,1225.350016,347.504238,11,6
0,0,35,35,20,51,71,154,110,264,0.000333,0.541178,20,32470.66479,1803.925822,1623.53324,375.732254,11,6
0,0,38,38,21,53,74,167,118,285,0.000333,0.589898,20,35393.88418,1966.326899,1769.694209,395.81845,12,6
0,0,10,10,13,16,29,39,30,69,0.000333,0.111734,6,2011.204132,111.733563,335.200689,112.105716,2,6
0,0,32,32,21,53,74,143,100,243,0.000333,0.502966,10,15088.97168,838.276204,1508.897168,395.81845,12,6
0,0,31,31,21,53,74,142,98,240,0.000333,0.496756,10,14902.68808,827.927115,1490.268808,395.81845,12,6
0,0,32,32,18,50,68,142,103,245,0.000333,0.497143,18,26845.71113,1491.428396,1491.428396,357.25146,11,6
0,0,35,35,20,52,72,155,111,266,0.000333,0.547067,20,32824.00101,1823.555612,1641.20005,382.861427,12,6
0,0,10,10,13,16,29,39,30,69,0.000333,0.111734,6,2011.204132,111.733563,335.200689,112.105716,2,6
0,0,30,30,20,52,72,134,96,230,0.000333,0.473028,10,14190.8275,788.379306,1419.08275,382.861427,12,6
0,0,29,29,20,52,72,133,94,227,0.000333,0.466858,10,14005.72975,778.096097,1400.572975,382.861427,12,6
0,0,14,14,14,22,36,61,42,103,0.000333,0.177501,7,3727.515926,207.084218,532.502275,151.410465,5,6
0,0,15,15,14,23,37,62,44,106,0.000333,0.184067,7,3865.414397,214.745244,552.202057,157.344894,5,6
0,0,14,14,14,22,36,61,42,103,0.000333,0.177501,7,3727.515926,207.084218,532.502275,151.410465,5,6
0,0,15,15,14,23,37,62,44,106,0.000333,0.184067,7,3865.414397,214.745244,552.202057,157.344894,5,6
0,0,16,16,11,21,32,59,52,111,0.000333,0.185,10,5550,308.333333,555,130.292414,3,6
0,0,19,19,14,23,37,72,60,132,0.000333,0.229216,14,9627.06982,534.837212,687.647844,157.344894,4,6
0,0,10,10,13,17,30,41,32,73,0.000333,0.119401,6,2149.218081,119.401004,358.203013,117.592585,2,6
0,0,18,18,11,22,33,64,62,126,0.000333,0.211865,10,6355.93659,353.107588,635.593659,136.161243,3,6
0,0,21,21,14,24,38,77,70,147,0.000333,0.257148,14,10800.23482,600.013046,771.445344,163.342069,4,6
0,0,10,10,13,17,30,41,32,73,0.000333,0.119401,6,2149.218081,119.401004,358.203013,117.592585,2,6
0,0,16,16,11,21,32,59,52,111,0.000333,0.185,10,5550,308.333333,555,130.292414,3,6
0,0,19,19,14,23,37,72,60,132,0.000333,0.229216,14,9627.06982,534.837212,687.647844,157.344894,4,6
0,0,10,10,13,17,30,41,32,73,0.000333,0.119401,6,2149.218081,119.401004,358.203013,117.592585,2,6
0,0,13,13,13,21,34,50,43,93,0.000333,0.157711,12,5677.608531,315.422696,473.134044,140.344382,4,6
0,0,14,14,13,21,34,51,45,96,0.000333,0.162799,12,5860.757193,325.597622,488.396433,140.344382,4,6
0,0,15,15,10,17,27,51,59,110,0.000333,0.174346,15,7845.564379,435.864688,523.037625,102.706149,2,6
0,0,18,18,14,20,34,64,67,131,0.000333,0.222153,21,13995.61028,777.533904,666.457632,139.741531,3,6
0,0,10,10,13,17,30,41,32,73,0.000333,0.119401,6,2149.218081,119.401004,358.203013,117.592585,2,6
0,0,5,5,11,14,25,21,19,40,0.000333,0.061918,5,928.771238,51.598402,185.754248,91.356717,2,6
0,0,5,5,11,13,24,21,18,39,0.000333,0.059605,5,894.067688,49.670427,178.813538,86.159464,2,6
0,0,38,38,22,57,79,160,127,287,0.000333,0.603062,22,39802.07164,2211.226202,1809.185075,430.582226,12,6
0,0,41,41,24,59,83,173,135,308,0.000333,0.654504,24,47124.29148,2618.016193,1963.512145,457.11504,13,6
0,0,39,39,24,59,83,165,130,295,0.000333,0.626879,24,45135.27917,2507.51551,1880.636632,457.11504,12,6
0,0,26,26,19,47,66,115,85,200,0.000333,0.40296,9,10879.90942,604.439412,1208.878824,341.776299,8,6
0,0,25,25,19,47,66,114,83,197,0.000333,0.396915,9,10716.71077,595.372821,1190.745642,341.776299,8,6
0,0,26,26,20,46,66,111,84,195,0.000333,0.392886,10,11786.56853,654.809363,1178.656853,340.522412,8,6
0,0,25,25,20,46,66,110,82,192,0.000333,0.386841,10,11605.23671,644.735373,1160.523671,340.522412,8,6
0,0,24,24,18,46,64,106,82,188,0.000333,0.376,9,10152,564,1128,329.1425,8,6
0,0,23,23,18,46,64,105,80,185,0.000333,0.37,9,9990,555,1110,329.1425,8,6
0,0,24,24,18,46,64,106,81,187,0.000333,0.374,9,10098,561,1122,329.1425,8,6
0,0,23,23,18,46,64,105,79,184,0.000333,0.368,9,9936,552,1104,329.1425,8,6
0,0,17,17,15,18,33,56,56,112,0.000333,0.188324,21,11864.41497,659.134165,564.972141,133.662009,2,6
0,0,20,20,18,21,39,69,64,133,0.000333,0.234319,27,18979.87937,1054.437743,702.958495,167.297316,3,6
0,0,18,18,17,21,38,61,59,120,0.000333,0.209917,16,10076.02083,559.778935,629.751302,161.725534,2,6
0,0,34,34,18,51,69,149,115,264,0.000333,0.53755,18,29027.70822,1612.650457,1612.650457,364.352342,10,6
0,0,37,37,20,53,73,162,123,285,0.000333,0.588033,20,35281.99999,1960.11111,1764.099999,390.018346,11,6
0,0,10,10,13,18,31,42,32,74,0.000333,0.122204,6,2199.663162,122.203509,366.610527,123.164366,2,6
0,0,22,22,20,43,63,109,81,190,0.000333,0.378561,10,11356.83186,630.935103,1135.683185,319.767946,9,6
0,0,21,21,20,43,63,108,79,187,0.000333,0.372584,10,11177.51346,620.97297,1117.751346,319.767946,9,6
0,0,20,20,20,42,62,99,73,172,0.000333,0.341374,10,10241.21765,568.956536,1024.121765,312.915894,8,6
0,0,19,19,20,42,62,98,71,169,0.000333,0.33542,10,10062.59177,559.032876,1006.259176,312.915894,8,6
0,0,21,21,20,44,64,102,75,177,0.000333,0.354,10,10620,590,1062,326.653553,9,6
0,0,20,20,20,44,64,101,73,174,0.000333,0.348,10,10440,580,1044,326.653553,9,6
0,0,22,22,20,43,63,103,79,182,0.000333,0.362622,10,10878.64946,604.369414,1087.864946,319.767946,8,6
0,0,21,21,20,43,63,102,77,179,0.000333,0.356644,10,10699.33106,594.407281,1069.933106,319.767946,8,6
0,0,16,16,11,19,30,49,54,103,0.000333,0.16847,10,5054.097313,280.783184,505.409731,118.764371,2,6
0,0,19,19,15,22,37,62,62,124,0.000333,0.215324,14,9043.611043,502.422836,645.972217,156.710855,3,6
0,0,10,10,13,18,31,41,34,75,0.000333,0.123855,6,2229.38834,123.854908,371.564723,123.164366,2,6
0,0,16,16,10,19,29,55,51,106,0.000333,0.171649,10,5149.459855,286.081103,514.945985,113.929904,2,6
0,0,19,19,14,22,36,68,59,127,0.000333,0.21886,14,9192.126653,510.673703,656.580475,151.410465,3,6
0,0,10,10,13,18,31,43,32,75,0.000333,0.123855,6,2229.38834,123.854908,371.564723,123.164366,2,6
0,0,23,23,18,45,63,103,79,182,0.000333,0.362622,9,9790.784515,543.932473,1087.864946,322.192039,7,6
0,0,22,22,18,45,63,102,77,179,0.000333,0.356644,9,9629.397957,534.966553,1069.933106,322.192039,7,6
0,0,11,11,10,15,25,37,31,68,0.000333,0.105261,10,3157.822209,175.434567,315.782221,91.82264,2,6
0,0,14,14,14,18,32,50,39,89,0.000333,0.148333,14,6230,346.111111,445,128.361619,3,6
0,0,10,10,13,16,29,39,30,69,0.000333,0.111734,6,2011.204132,111.733563,335.200689,112.105716,2,6
0,0,7,7,13,15,28,28,22,50,0.000333,0.080123,6,1442.206477,80.122582,240.367746,106.709075,3,6
0,0,5,5,11,14,25,23,19,42,0.000333,0.065014,5,975.2098,54.178322,195.04196,91.356717,3,6
0,0,5,5,11,14,25,23,19,42,0.000333,0.065014,5,975.2098,54.178322,195.04196,91.356717,3,6
0,0,4,4,10,11,21,14,14,28,0.000333,0.040995,5,614.924439,34.162469,122.984888,71.273029,2,6
0,0,9,9,11,21,32,36,40,76,0.000333,0.126667,5,1900,105.555556,380,130.292414,3,6
0,0,10,10,12,23,35,36,47,83,0.000333,0.14191,12,5108.765885,283.820327,425.73049,147.061475,3,6
0,0,21,21,20,43,63,102,75,177,0.000333,0.35266,10,10579.78547,587.765859,1057.978546,319.767946,9,6
0,0,20,20,20,43,63,101,73,174,0.000333,0.346682,10,10400.46707,577.803726,1040.046707,319.767946,9,6
0,0,27,27,18,51,69,119,93,212,0.000333,0.431669,9,11655.06466,647.503592,1295.007185,364.352342,9,6
0,0,26,26,18,51,69,118,91,209,0.000333,0.425561,9,11490.1345,638.340806,1276.681611,364.352342,9,6
0,0,6,6,8,11,19,15,15,30,0.000333,0.042479,4,509.751302,28.319517,127.437825,62.053748,3,6
0,0,15,15,11,21,32,57,43,100,0.000333,0.166667,10,5000,277.777778,500,130.292414,4,6
0,0,18,18,14,23,37,70,51,121,0.000333,0.210115,14,8824.814001,490.267445,630.343857,157.344894,5,6
0,0,10,10,13,16,29,39,30,69,0.000333,0.111734,6,2011.204132,111.733563,335.200689,112.105716,2,6
0,0,12,12,13,20,33,48,34,82,0.000333,0.13788,6,2481.841907,137.880106,413.640318,134.544278,5,6
0,0,13,13,13,21,34,49,36,85,0.000333,0.144145,6,2594.606049,144.144781,432.434342,140.344382,5,6
0,0,14,14,13,33,46,86,61,147,0.000333,0.270655,6,4871.781645,270.654536,811.963608,214.570722,7,6
0,0,13,13,10,17,27,45,35,80,0.000333,0.126797,10,3803.910002,211.328333,380.391,102.706149,3,6
0,0,16,16,14,20,34,58,43,101,0.000333,0.171278,14,7193.672458,399.64847,513.833747,139.741531,4,6
0,0,10,10,13,16,29,39,30,69,0.000333,0.111734,6,2011.204132,111.733563,335.200689,112.105716,2,6
0,0,13,13,10,16,26,45,34,79,0.000333,0.123778,10,3713.347377,206.297077,371.334738,97.219281,3,6
0,0,16,16,14,19,33,58,42,100,0.000333,0.168146,14,7062.151767,392.341765,504.439412,134.013592,4,6
0,0,10,10,13,16,29,39,30,69,0.000333,0.111734,6,2011.204132,111.733563,335.200689,112.105716,2,6
0,0,15,15,12,16,28,50,37,87,0.000333,0.139413,12,5018.878539,278.826585,418.239878,107.01955,3,6
0,0,18,18,16,19,35,63,45,108,0.000333,0.184654,16,8863.401053,492.41117,553.962566,144.710623,4,6
0,0,10,10,13,16,29,39,30,69,0.000333,0.111734,6,2011.204132,111.733563,335.200689,112.105716,2,6
0,0,6,6,12,15,27,22,21,43,0.000333,0.068153,6,1226.760976,68.153388,204.460163,101.622909,2,6
0,0,8,8,10,16,26,38,26,64,0.000333,0.100276,5,1504.14071,83.563373,300.828142,97.219281,5,6
0,0,13,13,11,22,33,65,42,107,0.000333,0.179917,5,2698.750854,149.930603,539.750171,136.161243,8,6
0,0,10,10,12,17,29,43,29,72,0.000333,0.116592,6,2098.64779,116.591544,349.774632,112.506418,5,6
0,0,15,15,13,23,36,70,45,115,0.000333,0.19818,6,3567.248251,198.180458,594.541375,152.147641,8,6
0,0,25,25,21,46,67,112,86,198,0.000333,0.400362,10,12010.8566,667.269811,1201.08566,346.322516,8,6
0,0,24,24,21,46,67,111,84,195,0.000333,0.394296,10,11828.87392,657.159662,1182.887392,346.322516,8,6
0,0,4,4,10,12,22,15,15,30,0.000333,0.044594,5,668.914743,37.16193,133.782949,76.238831,2,6
0,0,14,14,11,20,31,54,42,96,0.000333,0.158534,10,4756.028458,264.223803,475.602846,124.49231,3,6
0,0,17,17,14,22,36,67,50,117,0.000333,0.201627,14,8468.337152,470.463175,604.881225,151.410465,4,6
0,0,10,10,13,16,29,39,30,69,0.000333,0.111734,6,2011.204132,111.733563,335.200689,112.105716,2,6
0,0,11,11,13,19,32,45,33,78,0.000333,0.13,6,2340,130,390,128.816339,4,6
0,0,12,12,13,20,33,46,35,81,0.000333,0.136199,6,2451.575542,136.198641,408.595924,134.544278,4,6
0,0,18,18,12,22,34,65,57,122,0.000333,0.20689,12,7448.0456,413.780311,620.670467,141.127046,4,6
0,0,21,21,15,24,39,78,65,143,0.000333,0.251938,14,10581.37524,587.85418,755.812517,168.642459,5,6
0,0,10,10,13,16,29,39,30,69,0.000333,0.111734,6,2011.204132,111.733563,335.200689,112.105716,2,6
0,0,15,15,11,22,33,57,44,101,0.000333,0.169828,10,5094.838061,283.046559,509.483806,136.161243,4,6
0,0,18,18,14,24,38,70,52,122,0.000333,0.213416,14,8963.460193,497.970011,640.247157,163.342069,5,6
0,0,10,10,13,16,29,39,30,69,0.000333,0.111734,6,2011.204132,111.733563,335.200689,112.105716,2,6
0,0,12,12,13,21,34,48,35,83,0.000333,0.140753,6,2533.556495,140.753139,422.259416,140.344382,5,6
0,0,13,13,13,22,35,49,37,86,0.000333,0.147039,6,2646.710037,147.039446,441.118339,146.213212,5,6
0,0,5,5,10,13,23,18,16,34,0.000333,0.051267,5,769.005533,42.72253,153.801107,81.324997,3,6
0,0,8,8,10,18,28,30,25,55,0.000333,0.088135,5,1322.022604,73.4457,264.404521,108.277931,3,6
0,0,9,9,10,18,28,31,27,58,0.000333,0.092942,5,1394.132927,77.451829,278.826585,108.277931,3,6
0,0,8,8,10,19,29,30,26,56,0.000333,0.090682,5,1360.234679,75.568593,272.046936,113.929904,3,6
0,0,9,9,10,19,29,31,28,59,0.000333,0.09554,5,1433.104394,79.616911,286.620879,113.929904,3,6
0,0,13,13,10,17,27,45,35,80,0.000333,0.126797,10,3803.910002,211.328333,380.391,102.706149,3,6
0,0,16,16,14,20,34,58,43,101,0.000333,0.171278,14,7193.672458,399.64847,513.833747,139.741531,4,6
0,0,10,10,13,16,29,39,30,69,0.000333,0.111734,6,2011.204132,111.733563,335.200689,112.105716,2,6
0,0,9,9,14,21,35,37,32,69,0.000333,0.117974,7,2477.443697,137.635761,353.920528,145.541635,3,6
0,0,10,10,14,21,35,38,34,72,0.000333,0.123103,7,2585.158641,143.619924,369.308377,145.541635,3,6
0,0,8,8,10,17,27,38,27,65,0.000333,0.103023,5,1545.338438,85.852135,309.067688,102.706149,5,6
0,0,13,13,11,23,34,65,43,108,0.000333,0.183149,5,2747.229934,152.623885,549.445987,142.095673,8,6
0,0,14,14,11,15,26,46,43,89,0.000333,0.139446,10,4183.391349,232.410631,418.339135,96.657107,2,6
0,0,17,17,15,18,33,59,51,110,0.000333,0.184961,14,7768.366944,431.575941,554.883353,133.662009,3,6
0,0,10,10,13,16,29,39,30,69,0.000333,0.111734,6,2011.204132,111.733563,335.200689,112.105716,2,6
0,0,13,13,10,15,25,43,41,84,0.000333,0.130028,10,3900.839199,216.713289,390.08392,91.82264,2,6
0,0,16,16,14,18,32,56,49,105,0.000333,0.175,14,7350,408.333333,525,128.361619,3,6
0,0,10,10,13,17,30,41,32,73,0.000333,0.119401,6,2149.218081,119.401004,358.203013,117.592585,2,6
0,0,14,14,12,15,27,47,39,86,0.000333,0.136307,12,4907.043902,272.61355,408.920325,101.622909,2,6
0,0,17,17,16,18,34,60,47,107,0.000333,0.181453,16,8709.736384,483.874244,544.358524,139.05865,3,6
0,0,10,10,13,16,29,39,30,69,0.000333,0.111734,6,2011.204132,111.733563,335.200689,112.105716,2,6
0,0,17,17,10,17,27,53,61,114,0.000333,0.180686,15,8130.857629,451.714313,542.057175,102.706149,2,6
0,0,20,20,14,20,34,66,69,135,0.000333,0.228936,21,14422.95716,801.275397,686.807484,139.741531,3,6
0,0,10,10,13,17,30,41,32,73,0.000333,0.119401,6,2149.218081,119.401004,358.203013,117.592585,2,6
0,0,36,36,19,55,74,153,114,267,0.000333,0.552641,18,29842.63288,1657.924049,1657.924049,398.685407,13,6
0,0,39,39,21,57,78,166,122,288,0.000333,0.603399,20,36203.91678,2011.32871,1810.195839,424.713397,14,6
0,0,10,10,13,16,29,39,30,69,0.000333,0.111734,6,2011.204132,111.733563,335.200689,112.105716,2,6
0,0,32,32,21,56,77,142,103,245,0.000333,0.511788,10,15353.62703,852.979279,1535.362702,417.450542,14,6
0,0,31,31,21,56,77,141,101,242,0.000333,0.505521,10,15165.62343,842.534635,1516.562343,417.450542,14,6
0,0,36,36,19,55,74,153,114,267,0.000333,0.552641,18,29842.63288,1657.924049,1657.924049,398.685407,13,6
0,0,39,39,21,57,78,166,122,288,0.000333,0.603399,20,36203.91678,2011.32871,1810.195839,424.713397,14,6
0,0,10,10,13,16,29,39,30,69,0.000333,0.111734,6,2011.204132,111.733563,335.200689,112.105716,2,6
0,0,32,32,21,56,77,142,103,245,0.000333,0.511788,10,15353.62703,852.979279,1535.362702,417.450542,14,6
0,0,31,31,21,56,77,141,101,242,0.000333,0.505521,10,15165.62343,842.534635,1516.562343,417.450542,14,6
0,0,5,5,10,12,22,17,15,32,0.000333,0.047567,5,713.509059,39.639392,142.701812,76.238831,3,6
0,0,9,9,12,12,24,36,29,65,0.000333,0.099341,12,3576.270751,198.681708,298.022563,86.0391,2,6
0,0,12,12,16,16,32,49,37,86,0.000333,0.143333,16,6880,382.222222,430,128,3,6
0,0,10,10,15,16,31,41,32,73,0.000333,0.120552,14,5063.188629,281.288257,361.656331,122.603359,2,6
0,0,6,6,11,19,30,24,25,49,0.000333,0.080146,5,1202.188196,66.788233,240.437639,118.764371,3,6
0,0,21,21,20,42,62,102,74,176,0.000333,0.349313,10,10479.38551,582.188084,1047.938551,312.915894,10,6
0,0,20,20,20,42,62,101,72,173,0.000333,0.343359,10,10300.75962,572.264423,1030.075962,312.915894,10,6
0,0,21,21,20,43,63,102,74,176,0.000333,0.350667,10,10520.01267,584.445148,1052.001267,319.767946,10,6
0,0,20,20,20,43,63,101,72,173,0.000333,0.34469,10,10340.69427,574.483015,1034.069427,319.767946,10,6
0,0,28,28,25,49,74,140,98,238,0.000333,0.492617,24,35468.39762,1970.466535,1477.849901,391.217187,14,6
0,0,27,27,25,49,74,139,96,235,0.000333,0.486407,12,17510.65849,972.814361,1459.221541,391.217187,14,6
0,0,25,25,20,47,67,122,91,213,0.000333,0.430692,10,12920.76998,717.820554,1292.076998,347.504238,11,6
0,0,24,24,20,47,67,121,89,210,0.000333,0.424626,10,12738.7873,707.710406,1273.87873,347.504238,11,6
0,0,32,32,18,48,66,144,109,253,0.000333,0.509744,18,27526.17082,1529.231712,1529.231712,343.13685,8,6
0,0,35,35,20,51,71,157,117,274,0.000333,0.561677,20,33700.61422,1872.256345,1685.030711,375.732254,9,6
0,0,10,10,13,17,30,42,32,74,0.000333,0.121037,6,2178.659424,121.036635,363.109904,117.592585,2,6
0,0,10,10,10,15,25,36,32,68,0.000333,0.105261,10,3157.822209,175.434567,315.782221,91.82264,2,6
0,0,13,13,14,18,32,49,40,89,0.000333,0.148333,14,6230,346.111111,445,128.361619,3,6
0,0,10,10,13,16,29,39,30,69,0.000333,0.111734,6,2011.204132,111.733563,335.200689,112.105716,2,6
0,0,33,33,18,48,66,144,112,256,0.000333,0.515788,18,27852.5681,1547.364895,1547.364895,343.13685,8,6
0,0,36,36,20,51,71,157,120,277,0.000333,0.567827,20,34069.59904,1892.755502,1703.479952,375.732254,9,6
0,0,10,10,13,18,31,43,32,75,0.000333,0.123855,6,2229.38834,123.854908,371.564723,123.164366,2,6
0,0,9,9,10,18,28,33,28,61,0.000333,0.09775,5,1466.243251,81.457958,293.24865,108.277931,3,6
0,0,10,10,10,19,29,34,30,64,0.000333,0.103637,5,1554.553918,86.364107,310.910784,113.929904,3,6
0,0,9,9,10,18,28,33,29,62,0.000333,0.099352,5,1490.280026,82.793335,298.056005,108.277931,3,6
0,0,10,10,10,19,29,34,31,65,0.000333,0.105256,5,1578.843823,87.713546,315.768765,113.929904,3,6
0,0,11,11,12,20,32,38,31,69,0.000333,0.115,6,2070,115,345,129.458112,3,6
0,0,12,12,12,20,32,39,33,72,0.000333,0.12,6,2160,120,360,129.458112,3,6
0,0,9,9,10,19,29,33,29,62,0.000333,0.100398,5,1505.974108,83.665228,301.194822,113.929904,3,6
0,0,10,10,10,20,30,34,31,65,0.000333,0.106316,5,1594.739444,88.596636,318.947889,119.657843,3,6
0,0,37,37,21,54,75,159,119,278,0.000333,0.577204,20,34632.23192,1924.012884,1731.611596,403.002591,13,6
0,0,40,40,23,56,79,172,127,299,0.000333,0.628277,22,41466.26976,2303.681653,1884.830444,429.253801,14,6
0,0,10,10,13,16,29,39,30,69,0.000333,0.111734,6,2011.204132,111.733563,335.200689,112.105716,2,6
0,0,33,33,23,55,78,148,108,256,0.000333,0.536354,11,17699.69265,983.316258,1609.062968,422.016709,14,6
0,0,32,32,23,55,78,147,106,253,0.000333,0.530069,11,17492.27438,971.793021,1590.206761,422.016709,14,6
0,0,39,39,20,55,75,161,127,288,0.000333,0.597967,20,35877.99566,1993.221981,1793.899783,404.413346,13,6
0,0,42,42,22,57,79,174,135,309,0.000333,0.649289,22,42853.10153,2380.727863,1947.868251,430.582226,14,6
0,0,10,10,13,16,29,39,30,69,0.000333,0.111734,6,2011.204132,111.733563,335.200689,112.105716,2,6
0,0,39,39,21,55,76,165,120,285,0.000333,0.593553,20,35613.18683,1978.510379,1780.659341,410.21345,13,6
0,0,42,42,22,57,79,178,128,306,0.000333,0.642986,22,42437.052,2357.614,1928.956909,430.582226,14,6
0,0,10,10,13,16,29,39,30,69,0.000333,0.111734,6,2011.204132,111.733563,335.200689,112.105716,2,6
0,0,34,34,22,56,78,151,106,257,0.000333,0.538449,11,17768.83207,987.157337,1615.34837,423.319371,14,6
0,0,33,33,22,56,78,150,104,254,0.000333,0.532164,11,17561.4138,975.6341,1596.492164,423.319371,14,6
0,0,15,15,10,17,27,51,59,110,0.000333,0.174346,15,7845.564379,435.864688,523.037625,102.706149,2,6
0,0,18,18,14,20,34,64,67,131,0.000333,0.222153,21,13995.61028,777.533904,666.457632,139.741531,3,6
0,0,10,10,13,17,30,41,32,73,0.000333,0.119401,6,2149.218081,119.401004,358.203013,117.592585,2,6
0,0,19,19,12,24,36,66,65,131,0.000333,0.225753,12,8127.122102,451.506783,677.260175,153.05865,3,6
0,0,22,22,15,26,41,79,73,152,0.000333,0.271449,14,11400.87067,633.381704,814.347905,180.814792,4,6
0,0,10,10,13,18,31,41,34,75,0.000333,0.123855,6,2229.38834,123.854908,371.564723,123.164366,2,6
0,0,36,36,19,55,74,153,114,267,0.000333,0.552641,18,29842.63288,1657.924049,1657.924049,398.685407,13,6
0,0,39,39,21,57,78,166,122,288,0.000333,0.603399,20,36203.91678,2011.32871,1810.195839,424.713397,14,6
0,0,10,10,13,16,29,39,30,69,0.000333,0.111734,6,2011.204132,111.733563,335.200689,112.105716,2,6
0,0,32,32,21,56,77,142,103,245,0.000333,0.511788,10,15353.62703,852.979279,1535.362702,417.450542,14,6
0,0,31,31,21,56,77,141,101,242,0.000333,0.505521,10,15165.62343,842.534635,1516.562343,417.450542,14,6
0,0,15,15,12,18,30,53,47,100,0.000333,0.163563,12,5888.268715,327.12604,490.68906,118.0782,2,6
0,0,18,18,15,21,36,66,55,121,0.000333,0.20852,14,8757.852952,486.547386,625.560925,150.842025,3,6
0,0,10,10,13,18,31,42,32,74,0.000333,0.122204,6,2199.663162,122.203509,366.610527,123.164366,2,6
0,0,18,18,10,19,29,58,64,122,0.000333,0.197558,15,8890.105221,493.894735,592.673681,113.929904,2,6
0,0,21,21,14,22,36,71,72,143,0.000333,0.246433,21,15525.28478,862.515821,739.299275,151.410465,3,6
0,0,10,10,13,17,30,41,32,73,0.000333,0.119401,6,2149.218081,119.401004,358.203013,117.592585,2,6
0,0,14,14,10,17,27,48,44,92,0.000333,0.145817,10,4374.496502,243.027583,437.44965,102.706149,2,6
0,0,17,17,14,20,34,61,52,113,0.000333,0.191628,14,8048.366215,447.131456,574.883301,139.741531,3,6
0,0,10,10,13,17,30,41,32,73,0.000333,0.119401,6,2149.218081,119.401004,358.203013,117.592585,2,6
0,0,9,9,12,16,28,31,26,57,0.000333,0.09134,6,1644.115383,91.339744,274.019231,107.01955,3,6
0,0,9,9,12,16,28,31,26,57,0.000333,0.09134,6,1644.115383,91.339744,274.019231,107.01955,3,6
0,0,39,39,21,55,76,165,120,285,0.000333,0.593553,20,35613.18683,1978.510379,1780.659341,410.21345,13,6
0,0,42,42,22,57,79,178,128,306,0.000333,0.642986,22,42437.052,2357.614,1928.956909,430.582226,14,6
0,0,10,10,13,16,29,39,30,69,0.000333,0.111734,6,2011.204132,111.733563,335.200689,112.105716,2,6
0,0,34,34,22,56,78,151,106,257,0.000333,0.538449,11,17768.83207,987.157337,1615.34837,423.319371,14,6
0,0,33,33,22,56,78,150,104,254,0.000333,0.532164,11,17561.4138,975.6341,1596.492164,423.319371,14,6
0,0,36,36,19,54,73,153,113,266,0.000333,0.548831,18,29636.87999,1646.493333,1646.493333,391.474548,13,6
0,0,39,39,21,56,77,166,121,287,0.000333,0.599523,20,35971.35474,1998.408597,1798.567737,417.450542,14,6
0,0,10,10,13,16,29,39,30,69,0.000333,0.111734,6,2011.204132,111.733563,335.200689,112.105716,2,6
0,0,32,32,21,55,76,142,102,244,0.000333,0.508165,10,15244.94313,846.941285,1524.494313,410.21345,14,6
0,0,31,31,21,55,76,141,100,241,0.000333,0.501917,10,15057.50531,836.528073,1505.750531,410.21345,14,6
0,0,24,24,20,45,65,106,82,188,0.000333,0.377402,10,11322.05149,629.00286,1132.205149,333.571951,7,6
0,0,23,23,20,45,65,105,80,185,0.000333,0.371379,10,11141.38045,618.965581,1114.138045,333.571951,7,6
0,0,24,24,19,45,64,104,82,186,0.000333,0.372,9,10044,558,1116,327.844012,7,6
0,0,23,23,19,45,64,103,80,183,0.000333,0.366,9,9882,549,1098,327.844012,7,6
0,0,24,24,19,47,66,106,83,189,0.000333,0.380797,9,10281.5144,571.195244,1142.390489,341.776299,7,6
0,0,23,23,19,47,66,105,81,186,0.000333,0.374752,9,10118.31576,562.128653,1124.257306,341.776299,7,6
0,0,7,7,12,24,36,38,33,71,0.000333,0.122355,6,2202.388051,122.354892,367.064675,153.05865,2,6
0,0,10,10,17,32,49,61,50,111,0.000333,0.207744,8,4985.862342,276.992352,623.232793,229.486868,3,6
0,0,9,9,10,19,29,33,30,63,0.000333,0.102018,5,1530.264013,85.014667,306.052803,113.929904,3,6
0,0,10,10,10,20,30,34,32,66,0.000333,0.107952,5,1619.273897,89.959661,323.854779,119.657843,3,6
0,0,7,7,14,22,36,41,35,76,0.000333,0.130971,7,2750.400101,152.800006,392.9143,151.410465,2,6
0,0,10,10,19,30,49,64,52,116,0.000333,0.217102,9,5861.757077,325.653171,651.306342,227.917341,3,6
0,0,9,9,19,28,47,61,49,110,0.000333,0.203668,9,5499.042963,305.502387,611.004774,215.316561,3,6
0,0,16,16,16,31,47,66,70,136,0.000333,0.251808,16,12086.78534,671.488075,755.424084,217.580086,2,6
0,0,19,19,21,38,59,89,87,176,0.000333,0.345115,20,20706.90353,1150.38353,1035.345177,291.659911,3,6
0,0,18,18,21,36,57,86,84,170,0.000333,0.33053,20,19831.82605,1101.768114,991.591302,278.355966,3,6
0,0,7,7,12,23,35,39,32,71,0.000333,0.121393,6,2185.074565,121.393031,364.179094,147.061475,2,6
0,0,10,10,17,30,47,62,49,111,0.000333,0.20552,8,4932.4749,274.026383,616.559363,216.693586,3,6
0,0,9,9,17,28,45,59,46,105,0.000333,0.192215,8,4613.156601,256.286478,576.644575,204.092806,3,6
0,0,9,9,10,18,28,33,29,62,0.000333,0.099352,5,1490.280026,82.793335,298.056005,108.277931,3,6
0,0,10,10,10,19,29,34,31,65,0.000333,0.105256,5,1578.843823,87.713546,315.768765,113.929904,3,6
0,0,23,23,19,45,64,103,77,180,0.000333,0.36,9,9720,540,1080,327.844012,8,6
0,0,22,22,19,45,64,102,75,177,0.000333,0.354,9,9558,531,1062,327.844012,8,6
0,0,11,11,14,17,31,36,28,64,0.000333,0.10569,7,2219.479947,123.304442,317.068564,122.789837,3,6
0,0,16,16,12,18,30,55,43,98,0.000333,0.160292,12,5770.50334,320.583519,480.875278,118.0782,3,6
0,0,19,19,16,21,37,68,51,119,0.000333,0.206642,16,9918.799208,551.0444,619.924951,156.238666,4,6
0,0,10,10,13,16,29,39,30,69,0.000333,0.111734,6,2011.204132,111.733563,335.200689,112.105716,2,6
0,0,5,5,11,13,24,18,16,34,0.000333,0.051963,5,779.443625,43.302424,155.888725,86.159464,3,6
0,0,5,5,11,13,24,18,16,34,0.000333,0.051963,5,779.443625,43.302424,155.888725,86.159464,3,6
0,0,6,6,11,18,29,26,23,49,0.000333,0.079347,5,1190.205344,66.122519,238.041069,113.112398,3,6
0,0,10,10,14,21,35,45,33,78,0.000333,0.133361,7,2800.588527,155.588252,400.084075,145.541635,4,6
0,0,6,6,11,19,30,26,23,49,0.000333,0.080146,5,1202.188196,66.788233,240.437639,118.764371,3,6
0,0,10,10,14,22,36,45,33,78,0.000333,0.134418,7,2822.779051,156.821058,403.25415,151.410465,4,6
0,0,27,27,18,52,70,121,93,214,0.000333,0.437222,9,11804.99909,655.833283,1311.666566,371.481515,10,6
0,0,26,26,18,52,70,120,91,211,0.000333,0.431093,9,11639.50845,646.639358,1293.278717,371.481515,10,6
0,0,29,29,19,51,70,125,95,220,0.000333,0.449481,9,12135.98037,674.221132,1348.442264,370.004315,10,6
0,0,28,28,19,51,70,124,93,217,0.000333,0.443351,9,11970.48973,665.027207,1330.054415,370.004315,10,6
0,0,27,27,18,52,70,121,93,214,0.000333,0.437222,9,11804.99909,655.833283,1311.666566,371.481515,10,6
0,0,26,26,18,52,70,120,91,211,0.000333,0.431093,9,11639.50845,646.639358,1293.278717,371.481515,10,6
0,0,11,11,10,14,24,38,31,69,0.000333,0.105454,10,3163.624125,175.756896,316.362413,86.52225,2,6
0,0,14,14,14,17,31,51,39,90,0.000333,0.148626,14,6242.287351,346.793742,445.877668,122.789837,3,6
0,0,10,10,13,16,29,39,30,69,0.000333,0.111734,6,2011.204132,111.733563,335.200689,112.105716,2,6
0,0,15,15,10,17,27,47,51,98,0.000333,0.155326,15,6989.684628,388.315813,465.978975,102.706149,2,6
0,0,18,18,14,20,34,60,59,119,0.000333,0.201803,14,8475.713094,470.87295,605.408078,139.741531,3,6
0,0,10,10,13,17,30,41,32,73,0.000333,0.119401,6,2149.218081,119.401004,358.203013,117.592585,2,6
0,0,15,15,10,17,27,51,59,110,0.000333,0.174346,15,7845.564379,435.864688,523.037625,102.706149,2,6
0,0,18,18,14,20,34,64,67,131,0.000333,0.222153,21,13995.61028,777.533904,666.457632,139.741531,3,6
0,0,10,10,13,17,30,41,32,73,0.000333,0.119401,6,2149.218081,119.401004,358.203013,117.592585,2,6
0,0,6,6,10,12,22,18,17,35,0.000333,0.052027,5,780.400533,43.355585,156.080107,76.238831,2,6
0,0,6,6,12,16,28,29,22,51,0.000333,0.081725,6,1471.050606,81.725034,245.175101,107.01955,4,6
0,0,7,7,12,17,29,30,24,54,0.000333,0.087444,6,1573.985842,87.443658,262.330974,112.506418,4,6
0,0,15,15,12,17,29,48,37,85,0.000333,0.137643,12,4955.140615,275.28559,412.928385,112.506418,3,6
0,0,18,18,16,20,36,61,45,106,0.000333,0.182671,16,8768.192802,487.121822,548.01205,150.438562,4,6
0,0,10,10,13,16,29,39,30,69,0.000333,0.111734,6,2011.204132,111.733563,335.200689,112.105716,2,6
0,0,21,21,17,42,59,95,70,165,0.000333,0.323545,8,7765.088825,431.393824,970.636103,295.9642,8,6
0,0,20,20,17,42,59,94,68,162,0.000333,0.317663,8,7623.905392,423.5503,952.988174,295.9642,8,6
0,0,10,10,12,18,30,41,32,73,0.000333,0.119401,6,2149.218081,119.401004,358.203013,118.0782,3,6
0,0,29,29,19,46,65,129,93,222,0.000333,0.445655,18,24065.38178,1336.965654,1336.965654,334.794473,9,6
0,0,32,32,21,49,70,142,101,243,0.000333,0.496472,20,29788.31546,1654.906415,1489.415773,367.359448,10,6
0,0,10,10,13,16,29,39,30,69,0.000333,0.111734,6,2011.204132,111.733563,335.200689,112.105716,2,6
0,0,27,27,21,49,70,121,86,207,0.000333,0.422921,10,12687.61585,704.867547,1268.761585,367.359448,10,6
0,0,26,26,21,49,70,120,84,204,0.000333,0.416791,10,12503.73736,694.652075,1250.373735,367.359448,10,6
0,0,17,17,16,28,44,86,61,147,0.000333,0.267512,16,12840.58317,713.365732,802.536448,198.605938,7,6
0,0,10,10,11,21,32,36,34,70,0.000333,0.116667,5,1750,97.222222,350,130.292414,2,6
0,0,11,11,11,21,32,37,36,73,0.000333,0.121667,5,1825,101.388889,365,130.292414,2,6
0,0,13,13,10,16,26,43,34,77,0.000333,0.120645,10,3619.338583,201.074366,361.933858,97.219281,3,6
0,0,16,16,14,19,33,56,42,98,0.000333,0.164784,14,6920.908732,384.49493,494.350624,134.013592,4,6
0,0,10,10,13,16,29,39,30,69,0.000333,0.111734,6,2011.204132,111.733563,335.200689,112.105716,2,6
0,0,40,40,19,57,76,162,135,297,0.000333,0.618545,18,33401.42049,1855.634471,1855.634471,413.185354,12,6
0,0,43,43,21,59,80,175,143,318,0.000333,0.670124,20,40207.46268,2233.747927,2010.373134,439.314606,13,6
0,0,10,10,13,18,31,41,34,75,0.000333,0.123855,6,2229.38834,123.854908,371.564723,123.164366,2,6
0,0,13,13,10,17,27,43,35,78,0.000333,0.123627,10,3708.812252,206.045125,370.881225,102.706149,3,6
0,0,16,16,14,20,34,56,43,99,0.000333,0.167886,14,7051.223498,391.734639,503.658821,139.741531,4,6
0,0,10,10,13,16,29,39,30,69,0.000333,0.111734,6,2011.204132,111.733563,335.200689,112.105716,2,6
0,0,33,33,20,52,72,148,109,257,0.000333,0.528557,20,31713.41451,1761.856362,1585.670725,382.861427,11,6
0,0,32,32,20,52,72,147,107,254,0.000333,0.522387,20,31343.21901,1741.289945,1567.16095,382.861427,11,6
0,0,24,24,20,47,67,111,82,193,0.000333,0.390252,10,11707.55214,650.419563,1170.755214,347.504238,8,6
0,0,23,23,20,47,67,110,80,190,0.000333,0.384186,10,11525.56946,640.309415,1152.556946,347.504238,8,6
0,0,24,24,19,48,67,111,83,194,0.000333,0.392274,9,10591.39173,588.410651,1176.821303,348.788823,8,6
0,0,23,23,19,48,67,110,81,191,0.000333,0.386208,9,10427.60732,579.311518,1158.623035,348.788823,8,6
0,0,24,24,19,47,66,111,82,193,0.000333,0.388856,9,10499.11259,583.284033,1166.568065,341.776299,8,6
0,0,23,23,19,47,66,110,80,190,0.000333,0.382812,9,10335.91394,574.217441,1148.434883,341.776299,8,6
0,0,24,24,19,47,66,111,82,193,0.000333,0.388856,9,10499.11259,583.284033,1166.568065,341.776299,8,6
0,0,23,23,19,47,66,110,80,190,0.000333,0.382812,9,10335.91394,574.217441,1148.434883,341.776299,8,6
0,0,24,24,19,48,67,111,83,194,0.000333,0.392274,9,10591.39173,588.410651,1176.821303,348.788823,8,6
0,0,23,23,19,48,67,110,81,191,0.000333,0.386208,9,10427.60732,579.311518,1158.623035,348.788823,8,6
0,0,13,13,10,17,27,46,35,81,0.000333,0.128382,10,3851.458877,213.969938,385.145888,102.706149,3,6
0,0,16,16,14,20,34,59,43,102,0.000333,0.172974,14,7264.896937,403.605385,518.92121,139.741531,4,6
0,0,10,10,13,16,29,39,30,69,0.000333,0.111734,6,2011.204132,111.733563,335.200689,112.105716,2,6
0,0,13,13,10,18,28,46,36,82,0.000333,0.131401,10,3942.031036,219.001724,394.203104,108.277931,3,6
0,0,16,16,14,21,35,59,44,103,0.000333,0.176105,14,7396.42611,410.912562,528.316151,145.541635,4,6
0,0,10,10,13,16,29,39,30,69,0.000333,0.111734,6,2011.204132,111.733563,335.200689,112.105716,2,6
0,0,16,16,12,20,32,58,42,100,0.000333,0.166667,12,6000,333.333333,500,129.458112,3,6
0,0,19,19,15,23,38,71,50,121,0.000333,0.211666,14,8889.989208,493.888289,634.999229,162.645284,4,6
0,0,10,10,13,16,29,39,30,69,0.000333,0.111734,6,2011.204132,111.733563,335.200689,112.105716,2,6
0,0,13,13,10,16,26,43,34,77,0.000333,0.120645,10,3619.338583,201.074366,361.933858,97.219281,3,6
0,0,16,16,14,19,33,56,42,98,0.000333,0.164784,14,6920.908732,384.49493,494.350624,134.013592,4,6
0,0,10,10,13,16,29,39,30,69,0.000333,0.111734,6,2011.204132,111.733563,335.200689,112.105716,2,6
0,0,9,9,12,16,28,41,28,69,0.000333,0.110569,6,1990.244938,110.569163,331.70749,107.01955,5,6
0,0,13,13,12,22,34,66,42,108,0.000333,0.183149,6,3296.675921,183.148662,549.445987,141.127046,8,6
0,0,5,5,12,15,27,26,21,47,0.000333,0.074493,6,1340.878276,74.493238,223.479713,101.622909,3,6
0,0,6,6,12,16,28,27,23,50,0.000333,0.080123,6,1442.206477,80.122582,240.367746,107.01955,3,6
0,0,7,7,9,12,21,19,20,39,0.000333,0.0571,4,685.201518,38.066751,171.300379,71.548875,7,6
0,0,28,28,18,45,63,126,92,218,0.000333,0.434349,18,23454.84642,1303.047023,1303.047023,322.192039,8,6
0,0,31,31,20,48,68,139,100,239,0.000333,0.484968,20,29098.07238,1616.559577,1454.903619,354.516762,9,6
0,0,10,10,13,16,29,39,30,69,0.000333,0.111734,6,2011.204132,111.733563,335.200689,112.105716,2,6
0,0,26,26,20,48,68,118,85,203,0.000333,0.411918,10,12357.54957,686.530532,1235.754957,354.516762,9,6
0,0,25,25,20,48,68,117,83,200,0.000333,0.405831,10,12174.92568,676.38476,1217.492568,354.516762,9,6
0,0,14,14,12,16,28,48,44,92,0.000333,0.147426,12,5307.319834,294.851102,442.276653,107.01955,2,6
0,0,17,17,15,19,34,61,52,113,0.000333,0.191628,14,8048.366215,447.131456,574.883301,139.313982,3,6
0,0,10,10,13,18,31,42,32,74,0.000333,0.122204,6,2199.663162,122.203509,366.610527,123.164366,2,6
0,0,13,13,14,22,36,48,36,84,0.000333,0.144758,7,3039.915901,168.884217,434.2737,151.410465,5,6
0,0,21,21,20,44,64,102,75,177,0.000333,0.354,10,10620,590,1062,326.653553,10,6
0,0,20,20,20,44,64,101,73,174,0.000333,0.348,10,10440,580,1044,326.653553,10,6
0,0,11,11,10,14,24,38,31,69,0.000333,0.105454,10,3163.624125,175.756896,316.362413,86.52225,2,6
0,0,14,14,14,17,31,51,39,90,0.000333,0.148626,14,6242.287351,346.793742,445.877668,122.789837,3,6
0,0,10,10,13,16,29,39,30,69,0.000333,0.111734,6,2011.204132,111.733563,335.200689,112.105716,2,6
0,0,9,9,12,15,27,38,30,68,0.000333,0.107777,12,3879.988202,215.5549,323.33235,101.622909,2,6
0,0,12,12,15,18,33,51,38,89,0.000333,0.14965,14,6285.315073,349.184171,448.951077,133.662009,3,6
0,0,10,10,14,18,32,43,33,76,0.000333,0.126667,7,2660,147.777778,380,128.361619,2,6
0,0,14,14,14,18,32,48,46,94,0.000333,0.156667,14,6580,365.555556,470,128.361619,2,6
0,0,17,17,17,21,38,61,54,115,0.000333,0.201171,16,9656.186625,536.454812,603.511664,161.725534,3,6
0,0,15,15,16,21,37,53,49,102,0.000333,0.177121,16,8501.827893,472.323772,531.364243,156.238666,2,6
0,0,15,15,15,19,34,66,53,119,0.000333,0.201803,14,8475.713094,470.87295,605.408078,139.313982,5,6
0,0,15,15,16,27,43,80,55,135,0.000333,0.244182,16,11720.73187,651.151771,732.545742,192.381963,7,6
0,0,36,36,19,54,73,153,114,267,0.000333,0.550894,18,29748.29683,1652.683157,1652.683157,391.474548,13,6
0,0,39,39,21,56,77,166,122,288,0.000333,0.601612,20,36096.69047,2005.371693,1804.834524,417.450542,14,6
0,0,10,10,13,16,29,39,30,69,0.000333,0.111734,6,2011.204132,111.733563,335.200689,112.105716,2,6
0,0,32,32,21,55,76,142,103,245,0.000333,0.510247,10,15307.42241,850.412356,1530.742241,410.21345,14,6
0,0,31,31,21,55,76,141,101,242,0.000333,0.503999,10,15119.98458,839.999143,1511.998458,410.21345,14,6
0,0,12,12,10,15,25,40,33,73,0.000333,0.113001,10,3390.015019,188.334168,339.001502,91.82264,2,6
0,0,15,15,14,18,32,53,41,94,0.000333,0.156667,14,6580,365.555556,470,128.361619,3,6
0,0,10,10,13,16,29,39,30,69,0.000333,0.111734,6,2011.204132,111.733563,335.200689,112.105716,2,6
0,0,10,10,11,15,26,37,30,67,0.000333,0.104976,10,3149.294611,174.960812,314.929461,96.657107,2,6
0,0,13,13,15,18,33,50,38,88,0.000333,0.147969,14,6214.693555,345.260753,443.906683,133.662009,3,6
0,0,10,10,14,14,28,40,28,68,0.000333,0.108967,14,4576.601886,254.25566,326.900135,106.605938,2,6
0,0,15,15,12,16,28,49,41,90,0.000333,0.144221,12,5191.943316,288.441295,432.661943,107.01955,2,6
0,0,18,18,16,19,35,62,49,111,0.000333,0.189783,16,9109.606638,506.089258,569.350415,144.710623,3,6
0,0,10,10,13,16,29,39,30,69,0.000333,0.111734,6,2011.204132,111.733563,335.200689,112.105716,2,6
0,0,14,14,10,16,26,44,39,83,0.000333,0.130045,10,3901.364966,216.742498,390.136497,97.219281,2,6
0,0,17,17,14,19,33,57,47,104,0.000333,0.174872,14,7344.637838,408.035435,524.616988,134.013592,3,6
0,0,10,10,13,16,29,39,30,69,0.000333,0.111734,6,2011.204132,111.733563,335.200689,112.105716,2,6
0,0,26,26,20,47,67,113,85,198,0.000333,0.400362,10,12010.8566,667.269811,1201.08566,347.504238,8,6
0,0,25,25,20,47,67,112,83,195,0.000333,0.394296,10,11828.87392,657.159662,1182.887392,347.504238,8,6
0,0,26,26,19,47,66,112,85,197,0.000333,0.396915,9,10716.71077,595.372821,1190.745642,341.776299,8,6
0,0,25,25,19,47,66,111,83,194,0.000333,0.390871,9,10553.51213,586.30623,1172.612459,341.776299,8,6
0,0,15,15,15,22,37,52,38,90,0.000333,0.156284,7,3281.95562,182.330868,468.850803,156.710855,5,6
0,0,26,26,19,49,68,116,87,203,0.000333,0.411918,9,11121.79461,617.877478,1235.754957,355.831405,10,6
0,0,25,25,19,49,68,115,85,200,0.000333,0.405831,9,10957.43311,608.746284,1217.492568,355.831405,10,6
0,0,13,13,14,21,35,48,35,83,0.000333,0.14191,7,2980.113433,165.561857,425.73049,145.541635,5,6
0,0,13,13,14,21,35,48,35,83,0.000333,0.14191,7,2980.113433,165.561857,425.73049,145.541635,5,6
0,0,9,9,12,17,29,41,29,70,0.000333,0.113353,6,2040.352018,113.35289,340.05867,112.506418,5,6
0,0,13,13,12,23,35,66,43,109,0.000333,0.186364,6,3354.551093,186.36395,559.091849,147.061475,8,6
0,0,9,9,10,14,24,36,29,65,0.000333,0.099341,10,2980.225625,165.56809,298.022563,86.52225,2,6
0,0,12,12,14,17,31,49,37,86,0.000333,0.14202,14,5964.852358,331.380687,426.060883,122.789837,3,6
0,0,10,10,13,17,30,41,32,73,0.000333,0.119401,6,2149.218081,119.401004,358.203013,117.592585,2,6
0,0,14,14,10,16,26,45,43,88,0.000333,0.13788,10,4136.386952,229.799275,413.638695,97.219281,2,6
0,0,17,17,14,19,33,58,51,109,0.000333,0.18328,14,7697.745426,427.652524,549.838959,134.013592,3,6
0,0,10,10,13,17,30,41,32,73,0.000333,0.119401,6,2149.218081,119.401004,358.203013,117.592585,2,6
0,0,15,15,10,17,27,51,59,110,0.000333,0.174346,15,7845.564379,435.864688,523.037625,102.706149,2,6
0,0,18,18,14,20,34,64,67,131,0.000333,0.222153,21,13995.61028,777.533904,666.457632,139.741531,3,6
0,0,10,10,13,17,30,41,32,73,0.000333,0.119401,6,2149.218081,119.401004,358.203013,117.592585,2,6
0,0,10,10,11,15,26,37,30,67,0.000333,0.104976,10,3149.294611,174.960812,314.929461,96.657107,2,6
0,0,13,13,15,18,33,50,38,88,0.000333,0.147969,14,6214.693555,345.260753,443.906683,133.662009,3,6
0,0,18,18,13,23,36,72,59,131,0.000333,0.225753,12,8127.122102,451.506783,677.260175,152.147641,3,6
0,0,21,21,15,25,40,85,67,152,0.000333,0.269644,14,11325.06299,629.170166,808.93307,174.699764,4,6
0,0,10,10,13,17,30,42,32,74,0.000333,0.121037,6,2178.659424,121.036635,363.109904,117.592585,2,6
0,0,8,8,10,14,24,24,21,45,0.000333,0.068774,5,1031.616563,57.312031,206.323313,86.52225,2,6
0,0,8,8,10,14,24,24,21,45,0.000333,0.068774,5,1031.616563,57.312031,206.323313,86.52225,2,6
0,0,6,6,11,19,30,26,23,49,0.000333,0.080146,5,1202.188196,66.788233,240.437639,118.764371,3,6
0,0,10,10,14,22,36,45,33,78,0.000333,0.134418,7,2822.779051,156.821058,403.25415,151.410465,4,6
0,0,7,7,14,19,33,32,28,60,0.000333,0.100888,7,2118.64553,117.702529,302.663647,134.013592,3,6
0,0,11,11,17,22,39,51,38,89,0.000333,0.1568,8,3763.20638,209.067021,470.400797,167.594364,4,6
0,0,37,37,19,54,73,155,122,277,0.000333,0.571527,18,30862.46525,1714.581403,1714.581403,391.474548,12,6
0,0,40,40,21,56,77,168,130,298,0.000333,0.622501,20,37350.04778,2075.002655,1867.502389,417.450542,13,6
0,0,10,10,13,17,30,41,32,73,0.000333,0.119401,6,2149.218081,119.401004,358.203013,117.592585,2,6
0,0,6,6,13,16,29,29,23,52,0.000333,0.084205,6,1515.69007,84.205004,252.615012,112.105716,4,6
0,0,7,7,13,17,30,30,25,55,0.000333,0.08996,6,1619.273897,89.959661,269.878983,117.592585,4,6
0,0,17,17,11,19,30,52,56,108,0.000333,0.176648,10,5299.441843,294.413436,529.944184,118.764371,2,6
0,0,20,20,15,22,37,65,64,129,0.000333,0.224006,14,9408.272778,522.681821,672.019484,156.710855,3,6
0,0,10,10,13,18,31,41,34,75,0.000333,0.123855,6,2229.38834,123.854908,371.564723,123.164366,2,6
0,0,31,31,21,50,71,143,98,241,0.000333,0.49403,10,14820.89056,823.382809,1482.089056,374.431475,10,6
0,0,30,30,21,50,71,142,96,238,0.000333,0.48788,10,14636.39814,813.13323,1463.639814,374.431475,10,6
0,0,29,29,20,49,69,134,94,228,0.000333,0.464248,10,13927.43576,773.746431,1392.743576,361.559344,10,6
0,0,28,28,20,49,69,133,92,225,0.000333,0.458139,10,13744.18003,763.565557,1374.418003,361.559344,10,6
0,0,14,14,10,15,25,46,43,89,0.000333,0.137768,10,4133.032009,229.612889,413.303201,91.82264,2,6
0,0,17,17,14,18,32,59,51,110,0.000333,0.183333,14,7700,427.777778,550,128.361619,3,6
0,0,10,10,13,17,30,41,32,73,0.000333,0.119401,6,2149.218081,119.401004,358.203013,117.592585,2,6
0,0,8,8,11,20,31,35,31,66,0.000333,0.108992,5,1634.884782,90.826932,326.976956,124.49231,4,6
0,0,18,18,16,29,45,92,70,162,0.000333,0.29656,16,14234.88323,790.826846,889.680202,204.881449,7,6
0,0,15,15,14,20,34,72,46,118,0.000333,0.200107,14,8404.488614,466.916034,600.320615,139.741531,5,6
0,0,15,15,14,20,34,72,46,118,0.000333,0.200107,14,8404.488614,466.916034,600.320615,139.741531,5,6
0,0,13,13,10,17,27,43,35,78,0.000333,0.123627,10,3708.812252,206.045125,370.881225,102.706149,3,6
0,0,16,16,14,20,34,56,43,99,0.000333,0.167886,14,7051.223498,391.734639,503.658821,139.741531,4,6
0,0,10,10,13,16,29,39,30,69,0.000333,0.111734,6,2011.204132,111.733563,335.200689,112.105716,2,6
0,0,13,13,10,16,26,43,35,78,0.000333,0.122211,10,3666.34298,203.685721,366.634298,97.219281,3,6
0,0,16,16,14,19,33,56,43,99,0.000333,0.166465,14,6991.530249,388.418347,499.395018,134.013592,4,6
0,0,10,10,13,16,29,39,30,69,0.000333,0.111734,6,2011.204132,111.733563,335.200689,112.105716,2,6
0,0,13,13,10,16,26,43,34,77,0.000333,0.120645,10,3619.338583,201.074366,361.933858,97.219281,3,6
0,0,16,16,14,19,33,56,42,98,0.000333,0.164784,14,6920.908732,384.49493,494.350624,134.013592,4,6
0,0,10,10,13,16,29,39,30,69,0.000333,0.111734,6,2011.204132,111.733563,335.200689,112.105716,2,6
0,0,13,13,10,16,26,43,34,77,0.000333,0.120645,10,3619.338583,201.074366,361.933858,97.219281,3,6
0,0,16,16,14,19,33,56,42,98,0.000333,0.164784,14,6920.908732,384.49493,494.350624,134.013592,4,6
0,0,10,10,13,16,29,39,30,69,0.000333,0.111734,6,2011.204132,111.733563,335.200689,112.105716,2,6
0,0,13,13,10,17,27,43,35,78,0.000333,0.123627,10,3708.812252,206.045125,370.881225,102.706149,3,6
0,0,16,16,14,20,34,56,43,99,0.000333,0.167886,14,7051.223498,391.734639,503.658821,139.741531,4,6
0,0,10,10,13,16,29,39,30,69,0.000333,0.111734,6,2011.204132,111.733563,335.200689,112.105716,2,6
0,0,7,7,12,18,30,36,29,65,0.000333,0.106316,6,1913.687332,106.315963,318.947889,118.0782,4,6
0,0,8,8,12,18,30,37,31,68,0.000333,0.111223,6,2002.011363,111.222854,333.668561,118.0782,4,6
0,0,8,8,11,20,31,35,31,66,0.000333,0.108992,5,1634.884782,90.826932,326.976956,124.49231,4,6
0,0,12,12,14,18,32,56,41,97,0.000333,0.161667,14,6790,377.222222,485,128.361619,5,6
0,0,5,5,10,14,24,18,17,35,0.000333,0.053491,5,802.368438,44.576024,160.473688,86.52225,3,6
0,0,5,5,10,13,23,18,16,34,0.000333,0.051267,5,769.005533,42.72253,153.801107,81.324997,3,6
0,0,5,5,10,13,23,18,17,35,0.000333,0.052775,5,791.623342,43.979075,158.324668,81.324997,3,6
0,0,8,8,11,20,31,35,31,66,0.000333,0.108992,5,1634.884782,90.826932,326.976956,124.49231,4,6
0,0,13,13,10,16,26,41,37,78,0.000333,0.122211,10,3666.34298,203.685721,366.634298,97.219281,2,6
0,0,16,16,14,19,33,54,45,99,0.000333,0.166465,14,6991.530249,388.418347,499.395018,134.013592,3,6
0,0,10,10,13,16,29,39,30,69,0.000333,0.111734,6,2011.204132,111.733563,335.200689,112.105716,2,6
0,0,34,34,20,50,70,148,110,258,0.000333,0.527118,20,31627.10037,1757.061132,1581.355018,368.631371,10,6
0,0,37,37,22,52,74,161,118,279,0.000333,0.577479,22,38113.62476,2117.423598,1732.437489,394.530361,11,6
0,0,10,10,13,16,29,39,30,69,0.000333,0.111734,6,2011.204132,111.733563,335.200689,112.105716,2,6
0,0,33,33,18,50,68,143,108,251,0.000333,0.509318,18,27503.15712,1527.953173,1527.953173,357.25146,10,6
0,0,36,36,20,52,72,156,116,272,0.000333,0.559407,20,33564.39201,1864.688445,1678.2196,382.861427,11,6
0,0,10,10,13,16,29,39,30,69,0.000333,0.111734,6,2011.204132,111.733563,335.200689,112.105716,2,6
0,0,31,31,20,52,72,135,101,236,0.000333,0.485367,10,14561.023,808.945722,1456.1023,382.861427,11,6
0,0,30,30,20,52,72,134,99,233,0.000333,0.479198,10,14375.92525,798.662514,1437.592525,382.861427,11,6
0,0,9,9,12,13,25,33,29,62,0.000333,0.095973,12,3455.029005,191.946056,287.919084,91.125266,9,6
0,0,9,9,12,13,25,33,29,62,0.000333,0.095973,12,3455.029005,191.946056,287.919084,91.125266,9,6
0,0,9,9,12,13,25,33,29,62,0.000333,0.095973,12,3455.029005,191.946056,287.919084,91.125266,9,6
0,0,16,16,12,13,25,73,56,129,0.000333,0.199686,24,14377.37876,798.743265,599.057448,91.125266,16,6
0,0,15,15,11,22,33,57,44,101,0.000333,0.169828,10,5094.838061,283.046559,509.483806,136.161243,4,6
0,0,18,18,14,24,38,70,52,122,0.000333,0.213416,14,8963.460193,497.970011,640.247157,163.342069,5,6
0,0,10,10,13,16,29,39,30,69,0.000333,0.111734,6,2011.204132,111.733563,335.200689,112.105716,2,6
0,0,12,12,13,21,34,48,35,83,0.000333,0.140753,6,2533.556495,140.753139,422.259416,140.344382,5,6
0,0,13,13,13,22,35,49,37,86,0.000333,0.147039,6,2646.710037,147.039446,441.118339,146.213212,5,6
0,0,15,15,11,22,33,57,44,101,0.000333,0.169828,10,5094.838061,283.046559,509.483806,136.161243,4,6
0,0,18,18,14,24,38,70,52,122,0.000333,0.213416,14,8963.460193,497.970011,640.247157,163.342069,5,6
0,0,10,10,13,16,29,39,30,69,0.000333,0.111734,6,2011.204132,111.733563,335.200689,112.105716,2,6
0,0,12,12,13,21,34,48,35,83,0.000333,0.140753,6,2533.556495,140.753139,422.259416,140.344382,5,6
0,0,13,13,13,22,35,49,37,86,0.000333,0.147039,6,2646.710037,147.039446,441.118339,146.213212,5,6
0,0,38,38,22,57,79,160,127,287,0.000333,0.603062,22,39802.07164,2211.226202,1809.185075,430.582226,12,6
0,0,41,41,24,59,83,173,135,308,0.000333,0.654504,24,47124.29148,2618.016193,1963.512145,457.11504,13,6
0,0,39,39,24,59,83,165,130,295,0.000333,0.626879,24,45135.27917,2507.51551,1880.636632,457.11504,12,6
0,0,32,32,19,50,69,142,103,245,0.000333,0.498863,18,26938.59285,1496.588492,1496.588492,362.903432,11,6
0,0,35,35,21,52,73,155,111,266,0.000333,0.548831,20,32929.86665,1829.437036,1646.493333,388.661531,12,6
0,0,10,10,13,16,29,39,30,69,0.000333,0.111734,6,2011.204132,111.733563,335.200689,112.105716,2,6
0,0,30,30,21,52,73,134,96,230,0.000333,0.474553,10,14236.59649,790.922027,1423.659649,388.661531,12,6
0,0,29,29,21,52,73,133,94,227,0.000333,0.468363,10,14050.90175,780.605653,1405.090175,388.661531,12,6
0,0,33,33,20,50,70,148,109,257,0.000333,0.525075,20,31504.51471,1750.250817,1575.225735,368.631371,11,6
0,0,36,36,22,52,74,161,117,278,0.000333,0.575409,22,37977.01678,2109.834266,1726.228036,394.530361,12,6
0,0,10,10,13,16,29,39,30,69,0.000333,0.111734,6,2011.204132,111.733563,335.200689,112.105716,2,6
0,0,31,31,22,52,74,140,102,242,0.000333,0.500896,11,16529.56486,918.309159,1502.687714,394.530361,12,6
0,0,30,30,22,52,74,139,100,239,0.000333,0.494686,11,16324.6529,906.925161,1484.059354,394.530361,12,6
0,0,16,16,18,28,46,97,70,167,0.000333,0.307478,18,16603.82724,922.434847,922.434847,209.664588,5,6
0,0,16,16,15,36,51,95,65,160,0.000333,0.302529,7,6353.116383,352.95091,907.588055,244.720659,7,6
0,0,14,14,14,31,45,81,56,137,0.000333,0.250795,7,5266.687119,292.593729,752.383874,206.883055,7,6
0,0,16,16,14,34,48,90,64,154,0.000333,0.286695,7,6020.589576,334.477199,860.084225,226.276706,7,6
0,0,15,15,14,20,34,72,46,118,0.000333,0.200107,14,8404.488614,466.916034,600.320615,139.741531,5,6
0,0,27,27,19,51,70,119,93,212,0.000333,0.433136,9,11694.672,649.704,1299.408,370.004315,9,6
0,0,26,26,19,51,70,118,91,209,0.000333,0.427007,9,11529.18136,640.510075,1281.020151,370.004315,9,6
0,0,30,30,20,49,69,136,103,239,0.000333,0.486646,20,29198.7469,1622.152606,1459.937345,361.559344,9,6
0,0,29,29,20,49,69,135,101,236,0.000333,0.480537,20,28832.23544,1601.790858,1441.611772,361.559344,9,6
0,0,32,32,18,50,68,142,103,245,0.000333,0.497143,18,26845.71113,1491.428396,1491.428396,357.25146,11,6
0,0,35,35,20,52,72,155,111,266,0.000333,0.547067,20,32824.00101,1823.555612,1641.20005,382.861427,12,6
0,0,10,10,13,16,29,39,30,69,0.000333,0.111734,6,2011.204132,111.733563,335.200689,112.105716,2,6
0,0,30,30,20,52,72,134,96,230,0.000333,0.473028,10,14190.8275,788.379306,1419.08275,382.861427,12,6
0,0,29,29,20,52,72,133,94,227,0.000333,0.466858,10,14005.72975,778.096097,1400.572975,382.861427,12,6
0,0,15,15,12,15,27,49,37,86,0.000333,0.136307,12,4907.043902,272.61355,408.920325,101.622909,3,6
0,0,18,18,16,18,34,62,45,107,0.000333,0.181453,16,8709.736384,483.874244,544.358524,139.05865,4,6
0,0,10,10,13,16,29,39,30,69,0.000333,0.111734,6,2011.204132,111.733563,335.200689,112.105716,2,6
0,0,13,13,10,16,26,44,35,79,0.000333,0.123778,10,3713.347377,206.297077,371.334738,97.219281,3,6
0,0,16,16,14,19,33,57,43,100,0.000333,0.168146,14,7062.151767,392.341765,504.439412,134.013592,4,6
0,0,10,10,13,16,29,39,30,69,0.000333,0.111734,6,2011.204132,111.733563,335.200689,112.105716,2,6
0,0,9,9,13,17,30,34,27,61,0.000333,0.099773,6,1795.921958,99.773442,299.320326,117.592585,4,6
0,0,36,36,19,55,74,153,114,267,0.000333,0.552641,18,29842.63288,1657.924049,1657.924049,398.685407,13,6
0,0,39,39,21,57,78,166,122,288,0.000333,0.603399,20,36203.91678,2011.32871,1810.195839,424.713397,14,6
0,0,10,10,13,16,29,39,30,69,0.000333,0.111734,6,2011.204132,111.733563,335.200689,112.105716,2,6
0,0,32,32,21,56,77,142,103,245,0.000333,0.511788,10,15353.62703,852.979279,1535.362702,417.450542,14,6
0,0,31,31,21,56,77,141,101,242,0.000333,0.505521,10,15165.62343,842.534635,1516.562343,417.450542,14,6
0,0,6,6,11,17,28,26,22,48,0.000333,0.076918,5,1153.765181,64.098066,230.753036,107.540616,3,6
0,0,10,10,14,20,34,45,32,77,0.000333,0.130578,7,2742.142471,152.341248,391.734639,139.741531,4,6
0,0,13,13,12,32,44,79,57,136,0.000333,0.247494,6,4454.896201,247.494233,742.4827,203.01955,7,6
0,0,18,18,15,21,36,82,58,140,0.000333,0.241263,14,10133.053,562.947389,723.7895,150.842025,5,6
0,0,34,34,21,59,80,251,178,429,0.000333,0.904036,30,81363.21458,4520.178588,2712.107153,439.314606,19,6
0,0,64,64,23,61,84,364,257,621,0.000333,1.32321,44,174663.6813,9703.537848,3969.62912,465.816903,27,6
0,0,49,49,22,64,86,289,211,500,0.000333,1.071044,33,106033.3685,5890.742692,3213.132377,482.107496,22,6
0,0,64,64,24,59,83,365,255,620,0.000333,1.317508,48,189721.1735,10540.06519,3952.524447,457.11504,27,6
0,0,52,52,23,62,85,302,214,516,0.000333,1.102415,33,109139.1089,6063.283826,3307.245723,473.202096,23,6
0,0,35,35,23,59,82,201,146,347,0.000333,0.735357,22,48533.552,2696.308445,2206.070546,451.117865,17,6
0,0,33,33,23,52,75,177,126,303,0.000333,0.629111,22,41521.30539,2306.739188,1887.332063,400.46479,13,6
0,0,9,9,12,12,24,36,29,65,0.000333,0.099341,12,3576.270751,198.681708,298.022563,86.0391,2,6
0,0,12,12,16,16,32,49,37,86,0.000333,0.143333,16,6880,382.222222,430,128,3,6
0,0,10,10,15,16,31,41,32,73,0.000333,0.120552,14,5063.188629,281.288257,361.656331,122.603359,2,6
0,0,17,17,17,20,37,58,57,115,0.000333,0.199696,16,9585.394193,532.5219,599.087137,155.92543,2,6
0,0,20,20,19,23,42,71,65,136,0.000333,0.244452,18,13200.39305,733.355169,733.355169,184.752548,3,6
0,0,18,18,18,23,41,63,60,123,0.000333,0.21966,18,11861.62014,658.978897,658.978897,179.100575,2,6
0,0,11,11,14,18,32,38,29,67,0.000333,0.111667,7,2345,130.277778,335,128.361619,4,6
0,0,26,26,19,50,69,116,88,204,0.000333,0.41538,9,11215.2509,623.069495,1246.138989,362.903432,10,6
0,0,25,25,19,50,69,115,86,201,0.000333,0.409271,9,11050.32074,613.906708,1227.813416,362.903432,10,6
0,0,24,24,17,46,63,108,80,188,0.000333,0.374576,8,8989.829005,499.434945,1123.728626,323.570718,10,6
0,0,23,23,17,46,63,107,78,185,0.000333,0.368599,8,8846.374287,491.465238,1105.796786,323.570718,10,6
0,0,26,26,19,46,65,113,83,196,0.000333,0.393461,9,10623.45682,590.192046,1180.384091,334.794473,10,6
0,0,25,25,19,46,65,112,81,193,0.000333,0.387439,9,10460.85289,581.158494,1162.316988,334.794473,10,6
0,0,24,24,17,46,63,108,81,189,0.000333,0.376569,8,9037.647244,502.091514,1129.705906,323.570718,10,6
0,0,23,23,17,46,63,107,79,186,0.000333,0.370591,8,8894.192526,494.121807,1111.774066,323.570718,10,6
0,0,24,24,17,46,63,108,80,188,0.000333,0.374576,8,8989.829005,499.434945,1123.728626,323.570718,10,6
0,0,23,23,17,46,63,107,78,185,0.000333,0.368599,8,8846.374287,491.465238,1105.796786,323.570718,10,6
0,0,24,24,17,46,63,108,80,188,0.000333,0.374576,8,8989.829005,499.434945,1123.728626,323.570718,10,6
0,0,23,23,17,46,63,107,78,185,0.000333,0.368599,8,8846.374287,491.465238,1105.796786,323.570718,10,6
0,0,8,8,10,18,28,32,29,61,0.000333,0.09775,5,1466.243251,81.457958,293.24865,108.277931,2,6
0,0,9,9,10,18,28,33,31,64,0.000333,0.102557,5,1538.353575,85.464088,307.670715,108.277931,2,6
0,0,10,10,17,20,37,54,36,90,0.000333,0.156284,8,3750.806423,208.378135,468.850803,155.92543,7,6
0,0,11,11,17,20,37,55,38,93,0.000333,0.161493,8,3875.833304,215.324072,484.479163,155.92543,7,6
0,0,33,33,18,50,68,143,108,251,0.000333,0.509318,18,27503.15712,1527.953173,1527.953173,357.25146,10,6
0,0,36,36,20,52,72,156,116,272,0.000333,0.559407,20,33564.39201,1864.688445,1678.2196,382.861427,11,6
0,0,10,10,13,16,29,39,30,69,0.000333,0.111734,6,2011.204132,111.733563,335.200689,112.105716,2,6
0,0,31,31,20,52,72,135,101,236,0.000333,0.485367,10,14561.023,808.945722,1456.1023,382.861427,11,6
0,0,30,30,20,52,72,134,99,233,0.000333,0.479198,10,14375.92525,798.662514,1437.592525,382.861427,11,6
0,0,32,32,18,50,68,142,104,246,0.000333,0.499172,18,26955.28546,1497.515859,1497.515859,357.25146,11,6
0,0,35,35,20,52,72,155,112,267,0.000333,0.549123,20,32947.39951,1830.411084,1647.369975,382.861427,12,6
0,0,10,10,13,16,29,39,30,69,0.000333,0.111734,6,2011.204132,111.733563,335.200689,112.105716,2,6
0,0,30,30,20,52,72,134,97,231,0.000333,0.475084,10,14252.52675,791.807042,1425.252675,382.861427,12,6
0,0,29,29,20,52,72,133,95,228,0.000333,0.468914,10,14067.429,781.523834,1406.7429,382.861427,12,6
0,0,5,5,9,13,22,19,17,36,0.000333,0.053513,4,642.158153,35.675453,160.539538,76.635041,2,6
0,0,6,6,9,14,23,20,19,39,0.000333,0.058806,4,705.675665,39.204204,176.418916,81.832294,2,6
0,0,35,35,20,51,71,151,111,262,0.000333,0.537078,20,32224.67491,1790.259717,1611.233745,375.732254,11,6
0,0,38,38,22,53,75,164,119,283,0.000333,0.587585,22,38780.62517,2154.479176,1762.755689,401.68728,12,6
0,0,10,10,13,16,29,39,30,69,0.000333,0.111734,6,2011.204132,111.733563,335.200689,112.105716,2,6
0,0,9,9,12,15,27,38,30,68,0.000333,0.107777,12,3879.988202,215.5549,323.33235,101.622909,2,6
0,0,12,12,15,18,33,51,38,89,0.000333,0.14965,14,6285.315073,349.184171,448.951077,133.662009,3,6
0,0,10,10,14,18,32,43,33,76,0.000333,0.126667,7,2660,147.777778,380,128.361619,2,6
0,0,9,9,10,14,24,36,29,65,0.000333,0.099341,10,2980.225625,165.56809,298.022563,86.52225,2,6
0,0,12,12,14,17,31,49,37,86,0.000333,0.14202,14,5964.852358,331.380687,426.060883,122.789837,3,6
0,0,10,10,13,17,30,41,32,73,0.000333,0.119401,6,2149.218081,119.401004,358.203013,117.592585,2,6
0,0,9,9,12,15,27,38,30,68,0.000333,0.107777,12,3879.988202,215.5549,323.33235,101.622909,2,6
0,0,12,12,15,18,33,51,38,89,0.000333,0.14965,14,6285.315073,349.184171,448.951077,133.662009,3,6
0,0,10,10,14,18,32,43,33,76,0.000333,0.126667,7,2660,147.777778,380,128.361619,2,6
0,0,24,24,18,47,65,106,82,188,0.000333,0.377402,9,10189.84634,566.102574,1132.205149,336.124326,8,6
0,0,23,23,18,47,65,105,80,185,0.000333,0.371379,9,10027.24241,557.069023,1114.138045,336.124326,8,6
0,0,21,21,20,42,62,102,74,176,0.000333,0.349313,10,10479.38551,582.188084,1047.938551,312.915894,10,6
0,0,20,20,20,42,62,101,72,173,0.000333,0.343359,10,10300.75962,572.264423,1030.075962,312.915894,10,6
0,0,21,21,20,43,63,102,75,177,0.000333,0.35266,10,10579.78547,587.765859,1057.978546,319.767946,10,6
0,0,20,20,20,43,63,101,73,174,0.000333,0.346682,10,10400.46707,577.803726,1040.046707,319.767946,10,6
0,0,21,21,20,44,64,102,75,177,0.000333,0.354,10,10620,590,1062,326.653553,10,6
0,0,20,20,20,44,64,101,73,174,0.000333,0.348,10,10440,580,1044,326.653553,10,6
0,0,9,9,12,15,27,38,30,68,0.000333,0.107777,12,3879.988202,215.5549,323.33235,101.622909,2,6
0,0,12,12,15,18,33,51,38,89,0.000333,0.14965,14,6285.315073,349.184171,448.951077,133.662009,3,6
0,0,10,10,14,18,32,43,33,76,0.000333,0.126667,7,2660,147.777778,380,128.361619,2,6
0,0,33,33,18,48,66,144,112,256,0.000333,0.515788,18,27852.5681,1547.364895,1547.364895,343.13685,8,6
0,0,36,36,20,51,71,157,120,277,0.000333,0.567827,20,34069.59904,1892.755502,1703.479952,375.732254,9,6
0,0,10,10,13,18,31,43,32,75,0.000333,0.123855,6,2229.38834,123.854908,371.564723,123.164366,2,6
0,0,9,9,12,15,27,38,30,68,0.000333,0.107777,12,3879.988202,215.5549,323.33235,101.622909,2,6
0,0,12,12,15,18,33,51,38,89,0.000333,0.14965,14,6285.315073,349.184171,448.951077,133.662009,3,6
0,0,10,10,14,18,32,43,33,76,0.000333,0.126667,7,2660,147.777778,380,128.361619,2,6
0,0,15,15,11,20,31,57,43,100,0.000333,0.16514,10,4954.19631,275.233128,495.419631,124.49231,4,6
0,0,18,18,14,22,36,70,51,121,0.000333,0.20852,14,8757.852952,486.547386,625.560925,151.410465,5,6
0,0,10,10,13,16,29,39,30,69,0.000333,0.111734,6,2011.204132,111.733563,335.200689,112.105716,2,6
0,0,12,12,13,20,33,48,34,82,0.000333,0.13788,6,2481.841907,137.880106,413.640318,134.544278,5,6
0,0,13,13,13,21,34,49,36,85,0.000333,0.144145,6,2594.606049,144.144781,432.434342,140.344382,5,6
0,0,27,27,18,50,68,119,91,210,0.000333,0.426122,9,11505.30477,639.183598,1278.367197,357.25146,10,6
0,0,26,26,18,50,68,118,89,207,0.000333,0.420035,9,11340.94327,630.052404,1260.104808,357.25146,10,6
0,0,27,27,18,50,68,119,92,211,0.000333,0.428152,9,11560.09194,642.22733,1284.45466,357.25146,10,6
0,0,26,26,18,50,68,118,90,208,0.000333,0.422064,9,11395.73044,633.096135,1266.192271,357.25146,10,6
0,0,34,34,18,51,69,149,115,264,0.000333,0.53755,18,29027.70822,1612.650457,1612.650457,364.352342,10,6
0,0,37,37,20,53,73,162,123,285,0.000333,0.588033,20,35281.99999,1960.11111,1764.099999,390.018346,11,6
0,0,10,10,13,18,31,42,32,74,0.000333,0.122204,6,2199.663162,122.203509,366.610527,123.164366,2,6
0,0,24,24,18,46,64,106,80,186,0.000333,0.372,9,10044,558,1116,329.1425,8,6
0,0,23,23,18,46,64,105,78,183,0.000333,0.366,9,9882,549,1098,329.1425,8,6
0,0,34,34,19,50,69,147,114,261,0.000333,0.531442,18,28697.8479,1594.324883,1594.324883,362.903432,10,6
0,0,37,37,21,52,73,160,122,282,0.000333,0.581844,20,34910.61051,1939.478362,1745.530526,388.661531,11,6
0,0,10,10,13,16,29,39,30,69,0.000333,0.111734,6,2011.204132,111.733563,335.200689,112.105716,2,6
0,0,36,36,18,52,70,157,122,279,0.000333,0.570023,18,30781.25931,1710.069962,1710.069962,371.481515,10,6
0,0,39,39,20,54,74,170,130,300,0.000333,0.620945,20,37256.72019,2069.817789,1862.83601,397.202487,11,6
0,0,10,10,13,18,31,43,32,75,0.000333,0.123855,6,2229.38834,123.854908,371.564723,123.164366,2,6
0,0,5,5,11,15,26,23,20,43,0.000333,0.067373,5,1010.594539,56.144141,202.118908,96.657107,3,6
0,0,5,5,11,15,26,23,20,43,0.000333,0.067373,5,1010.594539,56.144141,202.118908,96.657107,3,6
0,0,5,5,12,14,26,23,19,42,0.000333,0.065806,6,1184.510809,65.806156,197.418468,96.322519,3,6
0,0,27,27,22,50,72,123,94,217,0.000333,0.446291,11,14727.61098,818.20061,1338.873725,380.300305,10,6
0,0,26,26,22,50,72,122,92,214,0.000333,0.440121,11,14524.00345,806.889081,1320.36395,380.300305,10,6
0,0,26,26,19,48,67,116,87,203,0.000333,0.410472,9,11082.74495,615.708053,1231.416106,348.788823,10,6
0,0,25,25,19,48,67,115,85,200,0.000333,0.404406,9,10918.96054,606.608919,1213.217838,348.788823,10,6
0,0,15,15,10,17,27,47,51,98,0.000333,0.155326,15,6989.684628,388.315813,465.978975,102.706149,2,6
0,0,18,18,14,20,34,60,59,119,0.000333,0.201803,14,8475.713094,470.87295,605.408078,139.741531,3,6
0,0,10,10,13,17,30,41,32,73,0.000333,0.119401,6,2149.218081,119.401004,358.203013,117.592585,2,6
0,0,9,9,11,12,23,37,27,64,0.000333,0.096503,10,2895.079652,160.837758,289.507965,81.073298,2,6
0,0,12,12,15,15,30,50,35,85,0.000333,0.139029,14,5839.199809,324.399989,417.085701,117.206718,3,6
0,0,10,10,14,15,29,42,30,72,0.000333,0.116592,14,4896.844843,272.046936,349.774632,111.906328,2,6
0,0,13,13,10,16,26,42,41,83,0.000333,0.130045,10,3901.364966,216.742498,390.136497,97.219281,2,6
0,0,16,16,14,19,33,55,49,104,0.000333,0.174872,14,7344.637838,408.035435,524.616988,134.013592,3,6
0,0,10,10,13,17,30,41,32,73,0.000333,0.119401,6,2149.218081,119.401004,358.203013,117.592585,2,6
0,0,14,14,11,19,30,44,42,86,0.000333,0.140664,10,4219.925912,234.440328,421.992591,118.764371,2,6
0,0,17,17,15,22,37,57,50,107,0.000333,0.185804,14,7803.761142,433.542286,557.41151,156.710855,3,6
0,0,10,10,13,16,29,39,30,69,0.000333,0.111734,6,2011.204132,111.733563,335.200689,112.105716,2,6
0,0,13,13,10,16,26,42,41,83,0.000333,0.130045,10,3901.364966,216.742498,390.136497,97.219281,2,6
0,0,16,16,14,19,33,55,49,104,0.000333,0.174872,14,7344.637838,408.035435,524.616988,134.013592,3,6
0,0,10,10,13,17,30,41,32,73,0.000333,0.119401,6,2149.218081,119.401004,358.203013,117.592585,2,6
0,0,14,14,12,16,28,46,39,85,0.000333,0.136208,12,4903.50202,272.416779,408.625168,107.01955,2,6
0,0,17,17,16,19,35,59,47,106,0.000333,0.181235,16,8699.263997,483.292444,543.704,144.710623,3,6
0,0,10,10,13,16,29,39,30,69,0.000333,0.111734,6,2011.204132,111.733563,335.200689,112.105716,2,6
0,0,16,16,12,16,28,53,42,95,0.000333,0.152233,12,5480.384611,304.465812,456.698718,107.01955,3,6
0,0,19,19,16,19,35,66,50,116,0.000333,0.198332,16,9519.949279,528.886071,594.99683,144.710623,4,6
0,0,10,10,13,16,29,39,30,69,0.000333,0.111734,6,2011.204132,111.733563,335.200689,112.105716,2,6
0,0,13,13,10,16,26,44,35,79,0.000333,0.123778,10,3713.347377,206.297077,371.334738,97.219281,3,6
0,0,16,16,14,19,33,57,43,100,0.000333,0.168146,14,7062.151767,392.341765,504.439412,134.013592,4,6
0,0,10,10,13,16,29,39,30,69,0.000333,0.111734,6,2011.204132,111.733563,335.200689,112.105716,2,6
0,0,5,5,11,14,25,29,21,50,0.000333,0.077398,5,1160.964047,64.498003,232.192809,91.356717,3,6
0,0,5,5,11,14,25,29,20,49,0.000333,0.07585,5,1137.744766,63.208043,227.548953,91.356717,3,6
0,0,29,29,18,47,65,129,94,223,0.000333,0.447663,18,24173.7844,1342.988022,1342.988022,336.124326,9,6
0,0,32,32,20,50,70,142,102,244,0.000333,0.498515,20,29910.90112,1661.716729,1495.545056,368.631371,10,6
0,0,10,10,13,16,29,39,30,69,0.000333,0.111734,6,2011.204132,111.733563,335.200689,112.105716,2,6
0,0,27,27,20,50,70,121,87,208,0.000333,0.424964,10,12748.90868,708.272704,1274.890868,368.631371,10,6
0,0,26,26,20,50,70,120,85,205,0.000333,0.418834,10,12565.03019,698.057232,1256.503018,368.631371,10,6
0,0,32,32,20,47,67,141,100,241,0.000333,0.487309,20,29238.5499,1624.363883,1461.927495,347.504238,9,6
0,0,35,35,21,50,71,154,108,262,0.000333,0.537078,20,32224.67491,1790.259717,1611.233745,374.431475,10,6
0,0,10,10,13,16,29,39,30,69,0.000333,0.111734,6,2011.204132,111.733563,335.200689,112.105716,2,6
0,0,29,29,21,50,71,130,90,220,0.000333,0.450981,10,13529.44366,751.635759,1352.944366,374.431475,10,6
0,0,28,28,21,50,71,129,88,217,0.000333,0.444832,10,13344.95125,741.386181,1334.495125,374.431475,10,6
0,0,30,30,20,46,66,135,99,234,0.000333,0.471463,20,28287.76448,1571.542471,1414.388224,340.522412,9,6
0,0,33,33,22,49,71,148,107,255,0.000333,0.522729,22,34500.08134,1916.671186,1568.185515,373.228278,10,6
0,0,10,10,13,16,29,39,30,69,0.000333,0.111734,6,2011.204132,111.733563,335.200689,112.105716,2,6
0,0,28,28,22,49,71,127,92,219,0.000333,0.448932,11,14814.74081,823.041156,1346.794619,373.228278,10,6
0,0,27,27,22,49,71,126,90,216,0.000333,0.442782,11,14611.79916,811.76662,1328.345378,373.228278,10,6
0,0,28,28,18,45,63,126,92,218,0.000333,0.434349,18,23454.84642,1303.047023,1303.047023,322.192039,8,6
0,0,31,31,20,48,68,139,100,239,0.000333,0.484968,20,29098.07238,1616.559577,1454.903619,354.516762,9,6
0,0,10,10,13,16,29,39,30,69,0.000333,0.111734,6,2011.204132,111.733563,335.200689,112.105716,2,6
0,0,26,26,20,48,68,118,85,203,0.000333,0.411918,10,12357.54957,686.530532,1235.754957,354.516762,9,6
0,0,25,25,20,48,68,117,83,200,0.000333,0.405831,10,12174.92568,676.38476,1217.492568,354.516762,9,6
0,0,13,13,10,15,25,43,34,77,0.000333,0.119192,10,3575.769266,198.653848,357.576927,91.82264,3,6
0,0,16,16,14,18,32,56,42,98,0.000333,0.163333,14,6860,381.111111,490,128.361619,4,6
0,0,10,10,13,16,29,39,30,69,0.000333,0.111734,6,2011.204132,111.733563,335.200689,112.105716,2,6
0,0,29,29,18,46,64,129,93,222,0.000333,0.444,18,23976,1332,1332,329.1425,9,6
0,0,32,32,20,49,69,142,101,243,0.000333,0.49479,20,29687.42886,1649.301603,1484.371443,361.559344,10,6
0,0,10,10,13,16,29,39,30,69,0.000333,0.111734,6,2011.204132,111.733563,335.200689,112.105716,2,6
0,0,27,27,20,49,69,121,86,207,0.000333,0.421488,10,12644.64563,702.480313,1264.464563,361.559344,10,6
0,0,26,26,20,49,69,120,84,204,0.000333,0.41538,10,12461.38989,692.299438,1246.138989,361.559344,10,6
0,0,31,31,19,46,65,133,96,229,0.000333,0.459707,18,24824.20013,1379.122229,1379.122229,334.794473,9,6
0,0,34,34,21,49,70,146,104,250,0.000333,0.510774,20,30646.41509,1702.578616,1532.320754,367.359448,10,6
0,0,10,10,13,16,29,39,30,69,0.000333,0.111734,6,2011.204132,111.733563,335.200689,112.105716,2,6
0,0,29,29,21,49,70,125,89,214,0.000333,0.437222,10,13116.66566,728.703648,1311.666566,367.359448,10,6
0,0,28,28,21,49,70,124,87,211,0.000333,0.431093,10,12932.78717,718.488176,1293.278717,367.359448,10,6
0,0,25,25,21,47,68,118,89,207,0.000333,0.420035,10,12601.04808,700.058227,1260.104808,353.304342,11,6
0,0,24,24,21,47,68,117,87,204,0.000333,0.413947,10,12418.4242,689.912455,1241.84242,353.304342,11,6
0,0,11,11,10,15,25,37,31,68,0.000333,0.105261,10,3157.822209,175.434567,315.782221,91.82264,2,6
0,0,14,14,14,18,32,50,39,89,0.000333,0.148333,14,6230,346.111111,445,128.361619,3,6
0,0,10,10,13,16,29,39,30,69,0.000333,0.111734,6,2011.204132,111.733563,335.200689,112.105716,2,6
0,0,34,34,21,54,75,156,112,268,0.000333,0.556441,20,33386.46818,1854.803788,1669.323409,403.002591,11,6
0,0,33,33,21,54,75,155,110,265,0.000333,0.550212,20,33012.73906,1834.041059,1650.636953,403.002591,11,6
0,0,30,30,18,46,64,130,98,228,0.000333,0.456,18,24624,1368,1368,329.1425,8,6
0,0,33,33,20,49,69,143,106,249,0.000333,0.507008,20,30420.4518,1690.0251,1521.02259,361.559344,9,6
0,0,10,10,13,16,29,39,30,69,0.000333,0.111734,6,2011.204132,111.733563,335.200689,112.105716,2,6
0,0,28,28,20,49,69,122,91,213,0.000333,0.433705,10,13011.15709,722.842061,1301.115709,361.559344,9,6
0,0,27,27,20,49,69,121,89,210,0.000333,0.427597,10,12827.90136,712.661187,1282.790136,361.559344,9,6
0,0,4,4,10,12,22,18,17,35,0.000333,0.052027,5,780.400533,43.355585,156.080107,76.238831,1,6
0,0,15,15,12,20,32,57,43,100,0.000333,0.166667,12,6000,333.333333,500,129.458112,4,6
0,0,18,18,15,22,37,70,51,121,0.000333,0.210115,14,8824.814001,490.267445,630.343857,156.710855,5,6
0,0,10,10,13,16,29,39,30,69,0.000333,0.111734,6,2011.204132,111.733563,335.200689,112.105716,2,6
0,0,12,12,14,20,34,48,34,82,0.000333,0.139057,7,2920.203671,162.233537,417.171953,139.741531,5,6
0,0,13,13,14,21,35,49,36,85,0.000333,0.14533,7,3051.923395,169.5513,435.989056,145.541635,5,6
0,0,18,18,12,22,34,65,57,122,0.000333,0.20689,12,7448.0456,413.780311,620.670467,141.127046,4,6
0,0,21,21,15,24,39,78,65,143,0.000333,0.251938,14,10581.37524,587.85418,755.812517,168.642459,5,6
0,0,10,10,13,16,29,39,30,69,0.000333,0.111734,6,2011.204132,111.733563,335.200689,112.105716,2,6
0,0,5,5,11,12,23,21,18,39,0.000333,0.058806,5,882.094581,49.005255,176.418916,81.073298,2,6
0,0,5,5,11,13,24,21,18,39,0.000333,0.059605,5,894.067688,49.670427,178.813538,86.159464,2,6
0,0,5,5,11,13,24,21,19,40,0.000333,0.061133,5,916.9925,50.944028,183.3985,86.159464,2,6
0,0,15,15,11,21,32,57,44,101,0.000333,0.168333,10,5050,280.555556,505,130.292414,4,6
0,0,18,18,14,23,37,70,52,122,0.000333,0.211851,14,8897.746348,494.319242,635.553311,157.344894,5,6
0,0,10,10,13,16,29,39,30,69,0.000333,0.111734,6,2011.204132,111.733563,335.200689,112.105716,2,6
0,0,12,12,13,20,33,48,35,83,0.000333,0.139562,6,2512.108271,139.561571,418.684712,134.544278,5,6
0,0,13,13,13,21,34,49,37,86,0.000333,0.145841,6,2625.130826,145.840601,437.521804,140.344382,5,6
0,0,17,17,15,17,32,55,56,111,0.000333,0.185,21,11655,647.5,555,128.090227,2,6
0,0,20,20,18,20,38,68,64,132,0.000333,0.230909,27,18703.61366,1039.089648,692.726432,161.497212,3,6
0,0,18,18,17,20,37,60,59,119,0.000333,0.206642,16,9918.799208,551.0444,619.924951,155.92543,2,6
0,0,7,7,9,12,21,19,20,39,0.000333,0.0571,4,685.201518,38.066751,171.300379,71.548875,7,6
0,0,10,10,12,23,35,42,38,80,0.000333,0.136781,6,2462.055848,136.78088,410.342641,147.061475,4,6
0,0,12,12,14,18,32,56,41,97,0.000333,0.161667,14,6790,377.222222,485,128.361619,5,6
0,0,9,9,10,14,24,36,29,65,0.000333,0.099341,10,2980.225625,165.56809,298.022563,86.52225,2,6
0,0,12,12,14,17,31,49,37,86,0.000333,0.14202,14,5964.852358,331.380687,426.060883,122.789837,3,6
0,0,10,10,13,17,30,41,32,73,0.000333,0.119401,6,2149.218081,119.401004,358.203013,117.592585,2,6
0,0,39,39,19,56,75,168,129,297,0.000333,0.616653,18,33299.26472,1849.959151,1849.959151,405.922498,12,6
0,0,42,42,21,58,79,181,137,318,0.000333,0.668201,20,40092.04556,2227.335864,2004.602278,432.001564,13,6
0,0,10,10,13,17,30,42,32,74,0.000333,0.121037,6,2178.659424,121.036635,363.109904,117.592585,2,6
0,0,38,38,20,54,74,158,124,282,0.000333,0.583689,20,35021.31698,1945.628721,1751.065849,397.202487,12,6
0,0,41,41,22,56,78,171,132,303,0.000333,0.634826,22,41898.49119,2327.693955,1904.476872,423.319371,13,6
0,0,10,10,13,16,29,39,30,69,0.000333,0.111734,6,2011.204132,111.733563,335.200689,112.105716,2,6
0,0,15,15,10,17,27,51,59,110,0.000333,0.174346,15,7845.564379,435.864688,523.037625,102.706149,2,6
0,0,18,18,14,20,34,64,67,131,0.000333,0.222153,21,13995.61028,777.533904,666.457632,139.741531,3,6
0,0,10,10,13,17,30,41,32,73,0.000333,0.119401,6,2149.218081,119.401004,358.203013,117.592585,2,6
0,0,38,38,19,55,74,160,125,285,0.000333,0.589898,18,31854.49577,1769.694209,1769.694209,398.685407,12,6
0,0,41,41,21,57,78,173,133,306,0.000333,0.641111,20,38466.66158,2137.036754,1923.333079,424.713397,13,6
0,0,10,10,13,18,31,42,32,74,0.000333,0.122204,6,2199.663162,122.203509,366.610527,123.164366,2,6
0,0,11,11,10,15,25,37,31,68,0.000333,0.105261,10,3157.822209,175.434567,315.782221,91.82264,2,6
0,0,14,14,14,18,32,50,39,89,0.000333,0.148333,14,6230,346.111111,445,128.361619,3,6
0,0,10,10,13,16,29,39,30,69,0.000333,0.111734,6,2011.204132,111.733563,335.200689,112.105716,2,6
0,0,12,12,14,18,32,56,41,97,0.000333,0.161667,14,6790,377.222222,485,128.361619,5,6
0,0,12,12,14,18,32,56,41,97,0.000333,0.161667,14,6790,377.222222,485,128.361619,5,6
0,0,14,14,13,32,45,86,61,147,0.000333,0.269101,6,4843.814431,269.100802,807.302405,208.105716,7,6
0,0,11,11,10,15,25,37,31,68,0.000333,0.105261,10,3157.822209,175.434567,315.782221,91.82264,2,6
0,0,14,14,14,18,32,50,39,89,0.000333,0.148333,14,6230,346.111111,445,128.361619,3,6
0,0,10,10,13,16,29,39,30,69,0.000333,0.111734,6,2011.204132,111.733563,335.200689,112.105716,2,6
0,0,25,25,19,48,67,113,86,199,0.000333,0.402384,9,10864.36574,603.575874,1207.151749,348.788823,9,6
0,0,24,24,19,48,67,112,84,196,0.000333,0.396318,9,10700.58133,594.476741,1188.953481,348.788823,9,6
0,0,26,26,18,48,66,116,87,203,0.000333,0.409004,9,11043.10806,613.506003,1227.012006,343.13685,10,6
0,0,25,25,18,48,66,115,85,200,0.000333,0.40296,9,10879.90942,604.439412,1208.878824,343.13685,10,6
0,0,24,24,18,47,65,106,81,187,0.000333,0.375394,9,10135.64503,563.091391,1126.182781,336.124326,8,6
0,0,23,23,18,47,65,105,79,184,0.000333,0.369372,9,9973.041098,554.057839,1108.115678,336.124326,8,6
0,0,15,15,14,20,34,72,46,118,0.000333,0.200107,14,8404.488614,466.916034,600.320615,139.741531,5,6
0,0,10,10,11,15,26,37,30,67,0.000333,0.104976,10,3149.294611,174.960812,314.929461,96.657107,2,6
0,0,13,13,15,18,33,50,38,88,0.000333,0.147969,14,6214.693555,345.260753,443.906683,133.662009,3,6
0,0,10,10,14,14,28,40,28,68,0.000333,0.108967,14,4576.601886,254.25566,326.900135,106.605938,2,6
0,0,13,13,10,15,25,44,34,78,0.000333,0.12074,10,3622.207828,201.233768,362.220783,91.82264,3,6
0,0,16,16,14,18,32,57,42,99,0.000333,0.165,14,6930,385,495,128.361619,4,6
0,0,10,10,13,16,29,39,30,69,0.000333,0.111734,6,2011.204132,111.733563,335.200689,112.105716,2,6
0,0,36,36,19,55,74,153,114,267,0.000333,0.552641,18,29842.63288,1657.924049,1657.924049,398.685407,13,6
0,0,39,39,21,57,78,166,122,288,0.000333,0.603399,20,36203.91678,2011.32871,1810.195839,424.713397,14,6
0,0,10,10,13,16,29,39,30,69,0.000333,0.111734,6,2011.204132,111.733563,335.200689,112.105716,2,6
0,0,32,32,21,56,77,142,103,245,0.000333,0.511788,10,15353.62703,852.979279,1535.362702,417.450542,14,6
0,0,31,31,21,56,77,141,101,242,0.000333,0.505521,10,15165.62343,842.534635,1516.562343,417.450542,14,6
0,0,35,35,19,53,72,150,112,262,0.000333,0.53884,18,29097.36631,1616.52035,1616.52035,384.290407,12,6
0,0,38,38,21,55,76,163,120,283,0.000333,0.589388,20,35363.26973,1964.626096,1768.163486,410.21345,13,6
0,0,10,10,13,16,29,39,30,69,0.000333,0.111734,6,2011.204132,111.733563,335.200689,112.105716,2,6
0,0,31,31,21,54,75,139,101,240,0.000333,0.498305,10,14949.16486,830.509159,1494.916486,403.002591,13,6
0,0,30,30,21,54,75,138,99,237,0.000333,0.492077,10,14762.3003,820.127794,1476.23003,403.002591,13,6
0,0,14,14,15,33,48,60,61,121,0.000333,0.22526,7,4730.463238,262.803513,675.780463,225.068365,2,6
0,0,17,17,20,41,61,83,78,161,0.000333,0.318283,10,9548.487113,530.471506,954.848711,306.098194,3,6
0,0,16,16,16,32,48,64,72,136,0.000333,0.253185,16,12152.8784,675.159911,759.5549,224,2,6
0,0,19,19,21,40,61,87,89,176,0.000333,0.347937,20,20876.19543,1159.788635,1043.809771,305.11579,3,6
0,0,12,12,13,30,43,77,53,130,0.000333,0.235138,6,4232.486509,235.138139,705.414418,195.312434,7,6
0,0,14,14,13,33,46,86,61,147,0.000333,0.270655,6,4871.781645,270.654536,811.963608,214.570722,7,6
0,0,29,29,20,50,70,124,94,218,0.000333,0.445395,10,13361.83698,742.324276,1336.183698,368.631371,10,6
0,0,28,28,20,50,70,123,92,215,0.000333,0.439265,10,13177.95849,732.108805,1317.795849,368.631371,10,6
0,0,7,7,12,14,26,21,18,39,0.000333,0.061106,6,1099.902894,61.105716,183.317149,96.322519,2,6
0,0,8,8,11,16,27,38,26,64,0.000333,0.101438,5,1521.564001,84.531333,304.3128,102.053748,5,6
0,0,13,13,12,22,34,65,42,107,0.000333,0.181453,6,3266.151144,181.452841,544.358524,141.127046,8,6
0,0,7,7,10,15,25,35,25,60,0.000333,0.092877,5,1393.156857,77.397603,278.631371,91.82264,4,6
0,0,12,12,11,21,32,62,41,103,0.000333,0.171667,5,2575,143.055556,515,130.292414,7,6
0,0,8,8,12,15,27,38,27,65,0.000333,0.103023,6,1854.406126,103.022563,309.067688,101.622909,4,6
0,0,12,12,12,21,33,63,41,104,0.000333,0.174872,6,3147.70193,174.872329,524.616988,135.258216,7,6
0,0,12,12,12,21,33,42,35,77,0.000333,0.129473,6,2330.510083,129.472782,388.418347,135.258216,3,6
0,0,11,11,12,21,33,41,33,74,0.000333,0.124428,6,2239.710989,124.428388,373.285165,135.258216,3,6
0,0,17,17,13,24,37,70,52,122,0.000333,0.211851,12,7626.639727,423.702207,635.553311,158.144816,4,6
0,0,16,16,13,24,37,69,50,119,0.000333,0.206642,12,7439.099406,413.2833,619.924951,158.144816,4,6
0,0,11,11,14,23,37,45,39,84,0.000333,0.145865,7,3063.158579,170.175477,437.594083,157.344894,3,6
0,0,10,10,14,23,37,44,37,81,0.000333,0.140655,7,2953.760058,164.097781,421.965723,157.344894,3,6
0,0,15,15,11,19,30,49,44,93,0.000333,0.152114,10,4563.408254,253.522681,456.340825,118.764371,2,6
0,0,18,18,15,22,37,62,52,114,0.000333,0.197959,14,8314.287572,461.904865,593.877684,156.710855,3,6
0,0,10,10,13,16,29,39,30,69,0.000333,0.111734,6,2011.204132,111.733563,335.200689,112.105716,2,6
0,0,16,16,12,17,29,54,42,96,0.000333,0.155455,12,5596.394106,310.910784,466.366176,112.506418,3,6
0,0,19,19,16,20,36,67,50,117,0.000333,0.201627,16,9678.099603,537.6722,604.881225,150.438562,4,6
0,0,10,10,13,16,29,39,30,69,0.000333,0.111734,6,2011.204132,111.733563,335.200689,112.105716,2,6
0,0,14,14,12,15,27,47,39,86,0.000333,0.136307,12,4907.043902,272.61355,408.920325,101.622909,2,6
0,0,17,17,16,18,34,60,47,107,0.000333,0.181453,16,8709.736384,483.874244,544.358524,139.05865,3,6
0,0,10,10,13,16,29,39,30,69,0.000333,0.111734,6,2011.204132,111.733563,335.200689,112.105716,2,6
0,0,16,16,15,25,40,70,46,116,0.000333,0.205781,7,4321.405613,240.07809,617.343659,174.699764,5,6
0,0,17,17,15,25,40,71,48,119,0.000333,0.211103,7,4433.166103,246.287006,633.309443,174.699764,5,6
0,0,10,10,11,21,32,36,49,85,0.000333,0.141667,10,4250,236.111111,425,130.292414,3,6
0,0,14,14,12,15,27,48,39,87,0.000333,0.137892,12,4964.102552,275.783475,413.675213,101.622909,2,6
0,0,17,17,15,18,33,61,47,108,0.000333,0.181598,14,7627.123908,423.729106,544.794565,133.662009,3,6
0,0,10,10,13,16,29,39,30,69,0.000333,0.111734,6,2011.204132,111.733563,335.200689,112.105716,2,6
0,0,16,16,12,16,28,53,42,95,0.000333,0.152233,12,5480.384611,304.465812,456.698718,107.01955,3,6
0,0,19,19,16,19,35,66,50,116,0.000333,0.198332,16,9519.949279,528.886071,594.99683,144.710623,4,6
0,0,10,10,13,16,29,39,30,69,0.000333,0.111734,6,2011.204132,111.733563,335.200689,112.105716,2,6
0,0,12,12,10,14,24,41,33,74,0.000333,0.113096,10,3392.872251,188.492903,339.287225,86.52225,2,6
0,0,15,15,14,17,31,54,41,95,0.000333,0.156883,14,6589.081093,366.060061,470.648649,122.789837,3,6
0,0,10,10,13,16,29,39,30,69,0.000333,0.111734,6,2011.204132,111.733563,335.200689,112.105716,2,6
0,0,7,7,11,15,26,26,19,45,0.000333,0.070507,5,1057.598937,58.755496,211.519787,96.657107,3,6
0,0,24,24,20,48,68,115,85,200,0.000333,0.405831,10,12174.92568,676.38476,1217.492568,354.516762,11,6
0,0,23,23,20,48,68,114,83,197,0.000333,0.399743,10,11992.3018,666.238989,1199.23018,354.516762,11,6
0,0,30,30,18,46,64,131,102,233,0.000333,0.466,18,25164,1398,1398,329.1425,8,6
0,0,33,33,20,49,69,144,110,254,0.000333,0.517188,20,31031.30424,1723.961347,1551.565212,361.559344,9,6
0,0,10,10,13,17,30,41,32,73,0.000333,0.119401,6,2149.218081,119.401004,358.203013,117.592585,2,6
0,0,13,13,10,18,28,46,36,82,0.000333,0.131401,10,3942.031036,219.001724,394.203104,108.277931,3,6
0,0,16,16,14,21,35,59,44,103,0.000333,0.176105,14,7396.42611,410.912562,528.316151,145.541635,4,6
0,0,10,10,13,16,29,39,30,69,0.000333,0.111734,6,2011.204132,111.733563,335.200689,112.105716,2,6
0,0,15,15,12,18,30,51,38,89,0.000333,0.145571,12,5240.559156,291.142175,436.713263,118.0782,3,6
0,0,18,18,16,21,37,64,46,110,0.000333,0.191013,16,9168.637924,509.368774,573.03987,156.238666,4,6
0,0,10,10,13,16,29,39,30,69,0.000333,0.111734,6,2011.204132,111.733563,335.200689,112.105716,2,6
0,0,13,13,10,17,27,46,36,82,0.000333,0.129967,10,3899.007752,216.611542,389.900775,102.706149,3,6
0,0,16,16,14,20,34,59,44,103,0.000333,0.17467,14,7336.121417,407.562301,524.008673,139.741531,4,6
0,0,10,10,13,16,29,39,30,69,0.000333,0.111734,6,2011.204132,111.733563,335.200689,112.105716,2,6
0,0,16,16,11,17,28,51,48,99,0.000333,0.158643,10,4759.281373,264.404521,475.928137,107.540616,3,6
0,0,19,19,15,20,35,64,56,120,0.000333,0.205171,14,8617.195468,478.733082,615.513962,145.041921,4,6
0,0,10,10,13,16,29,39,30,69,0.000333,0.111734,6,2011.204132,111.733563,335.200689,112.105716,2,6
0,0,16,16,12,17,29,52,42,94,0.000333,0.152217,12,5479.802563,304.433476,456.650214,112.506418,3,6
0,0,19,19,16,20,36,65,50,115,0.000333,0.19818,16,9512.662003,528.481222,594.541375,150.438562,4,6
0,0,10,10,13,16,29,39,30,69,0.000333,0.111734,6,2011.204132,111.733563,335.200689,112.105716,2,6
0,0,13,13,14,21,35,58,41,99,0.000333,0.169266,7,3554.593131,197.477396,507.799019,145.541635,4,6
0,0,14,14,14,22,36,59,43,102,0.000333,0.175777,7,3691.326451,205.073692,527.33235,151.410465,4,6
0,0,14,14,15,22,37,61,42,103,0.000333,0.178858,7,3756.015877,208.667549,536.573697,156.710855,5,6
0,0,15,15,15,23,38,62,44,106,0.000333,0.185427,7,3893.962215,216.331234,556.280316,162.645284,5,6
0,0,38,38,19,57,76,157,123,280,0.000333,0.58314,18,31489.55467,1749.419704,1749.419704,413.185354,12,6
0,0,41,41,21,59,80,170,131,301,0.000333,0.6343,20,38058.00713,2114.33373,1902.900357,439.314606,13,6
0,0,10,10,13,16,29,39,30,69,0.000333,0.111734,6,2011.204132,111.733563,335.200689,112.105716,2,6
0,0,33,33,21,58,79,145,108,253,0.000333,0.531619,10,15948.56529,886.031405,1594.856529,432.001564,13,6
0,0,32,32,21,58,79,144,106,250,0.000333,0.525315,10,15759.45187,875.525104,1575.945187,432.001564,13,6
0,0,37,37,19,54,73,157,118,275,0.000333,0.567401,18,30639.63157,1702.201754,1702.201754,391.474548,12,6
0,0,40,40,21,56,77,170,126,296,0.000333,0.618323,20,37099.37632,2061.076462,1854.968816,417.450542,13,6
0,0,10,10,13,16,29,39,30,69,0.000333,0.111734,6,2011.204132,111.733563,335.200689,112.105716,2,6
0,0,32,32,21,55,76,142,103,245,0.000333,0.510247,10,15307.42241,850.412356,1530.742241,410.21345,13,6
0,0,31,31,21,55,76,141,101,242,0.000333,0.503999,10,15119.98458,839.999143,1511.998458,410.21345,13,6
0,0,9,9,11,12,23,37,27,64,0.000333,0.096503,10,2895.079652,160.837758,289.507965,81.073298,2,6
0,0,12,12,15,15,30,50,35,85,0.000333,0.139029,14,5839.199809,324.399989,417.085701,117.206718,3,6
0,0,10,10,14,15,29,42,30,72,0.000333,0.116592,14,4896.844843,272.046936,349.774632,111.906328,2,6
0,0,9,9,11,12,23,37,27,64,0.000333,0.096503,10,2895.079652,160.837758,289.507965,81.073298,2,6
0,0,12,12,15,15,30,50,35,85,0.000333,0.139029,14,5839.199809,324.399989,417.085701,117.206718,3,6
0,0,10,10,14,15,29,42,30,72,0.000333,0.116592,14,4896.844843,272.046936,349.774632,111.906328,2,6
0,0,17,17,12,24,36,61,53,114,0.000333,0.196457,12,7072.457402,392.9143,589.37145,153.05865,3,6
0,0,20,20,15,26,41,74,61,135,0.000333,0.24109,14,10125.77329,562.54296,723.269521,180.814792,4,6
0,0,10,10,13,16,29,39,30,69,0.000333,0.111734,6,2011.204132,111.733563,335.200689,112.105716,2,6
0,0,13,13,14,23,37,51,40,91,0.000333,0.15802,7,3318.421794,184.356766,474.060256,157.344894,4,6
0,0,14,14,14,23,37,52,42,94,0.000333,0.16323,7,3427.820315,190.434462,489.688616,157.344894,4,6
0,0,6,6,9,10,19,16,15,31,0.000333,0.043895,4,526.743012,29.263501,131.685753,61.748606,1,6
0,0,9,9,10,14,24,36,29,65,0.000333,0.099341,10,2980.225625,165.56809,298.022563,86.52225,2,6
0,0,12,12,14,17,31,49,37,86,0.000333,0.14202,14,5964.852358,331.380687,426.060883,122.789837,3,6
0,0,10,10,13,17,30,41,32,73,0.000333,0.119401,6,2149.218081,119.401004,358.203013,117.592585,2,6
0,0,5,5,10,13,23,17,16,33,0.000333,0.049759,5,746.387723,41.465985,149.277545,81.324997,3,6
0,0,17,17,12,21,33,61,46,107,0.000333,0.179917,12,6477.002049,359.833447,539.750171,135.258216,4,6
0,0,20,20,15,23,38,74,54,128,0.000333,0.223912,14,9404.286104,522.460339,671.734722,162.645284,5,6
0,0,10,10,13,16,29,39,30,69,0.000333,0.111734,6,2011.204132,111.733563,335.200689,112.105716,2,6
0,0,14,14,14,22,36,52,37,89,0.000333,0.153374,7,3220.863276,178.936849,460.123325,151.410465,5,6
0,0,15,15,14,22,36,53,39,92,0.000333,0.158544,7,3329.431701,184.968428,475.6331,151.410465,5,6
0,0,15,15,11,21,32,57,43,100,0.000333,0.166667,10,5000,277.777778,500,130.292414,4,6
0,0,18,18,14,23,37,70,51,121,0.000333,0.210115,14,8824.814001,490.267445,630.343857,157.344894,5,6
0,0,10,10,13,16,29,39,30,69,0.000333,0.111734,6,2011.204132,111.733563,335.200689,112.105716,2,6
0,0,12,12,13,20,33,48,34,82,0.000333,0.13788,6,2481.841907,137.880106,413.640318,134.544278,5,6
0,0,13,13,13,21,34,49,36,85,0.000333,0.144145,6,2594.606049,144.144781,432.434342,140.344382,5,6
0,0,8,8,10,18,28,30,26,56,0.000333,0.089737,5,1346.059378,74.781077,269.211876,108.277931,3,6
0,0,9,9,10,18,28,31,28,59,0.000333,0.094545,5,1418.169702,78.787206,283.63394,108.277931,3,6
0,0,27,27,18,51,69,119,92,211,0.000333,0.429633,9,11600.08794,644.44933,1288.89866,364.352342,10,6
0,0,26,26,18,51,69,118,90,208,0.000333,0.423524,9,11435.15778,635.286544,1270.573087,364.352342,10,6
0,0,10,10,11,17,28,31,28,59,0.000333,0.094545,5,1418.169702,78.787206,283.63394,107.540616,2,6
0,0,15,15,10,17,27,51,59,110,0.000333,0.174346,15,7845.564379,435.864688,523.037625,102.706149,2,6
0,0,18,18,14,20,34,64,67,131,0.000333,0.222153,21,13995.61028,777.533904,666.457632,139.741531,3,6
0,0,10,10,13,17,30,41,32,73,0.000333,0.119401,6,2149.218081,119.401004,358.203013,117.592585,2,6
0,0,6,6,11,19,30,24,25,49,0.000333,0.080146,5,1202.188196,66.788233,240.437639,118.764371,3,6
0,0,6,6,11,19,30,24,25,49,0.000333,0.080146,5,1202.188196,66.788233,240.437639,118.764371,3,6
0,0,6,6,9,15,24,22,19,41,0.000333,0.062661,4,751.93385,41.774103,187.983463,87.132684,3,6
0,0,7,7,9,16,25,23,21,44,0.000333,0.06811,4,817.318689,45.406594,204.329672,92.529325,3,6
0,0,6,6,12,17,29,26,22,48,0.000333,0.077728,6,1399.098527,77.727696,233.183088,112.506418,3,6
0,0,10,10,15,20,35,45,32,77,0.000333,0.131652,7,2764.683546,153.59353,394.954792,145.041921,4,6
0,0,21,21,16,26,42,117,70,187,0.000333,0.336121,16,16133.81373,896.322985,1008.363358,186.211433,8,6
0,0,7,7,12,20,32,31,24,55,0.000333,0.091667,6,1650,91.666667,275,129.458112,3,6
0,0,6,6,11,19,30,26,23,49,0.000333,0.080146,5,1202.188196,66.788233,240.437639,118.764371,3,6
0,0,10,10,14,22,36,45,33,78,0.000333,0.134418,7,2822.779051,156.821058,403.25415,151.410465,4,6
0,0,29,29,18,45,63,129,93,222,0.000333,0.442319,18,23885.21057,1326.956143,1326.956143,322.192039,9,6
0,0,32,32,20,48,68,142,101,243,0.000333,0.493084,20,29585.06941,1643.614967,1479.25347,354.516762,10,6
0,0,10,10,13,16,29,39,30,69,0.000333,0.111734,6,2011.204132,111.733563,335.200689,112.105716,2,6
0,0,27,27,20,48,68,121,86,207,0.000333,0.420035,10,12601.04808,700.058227,1260.104808,354.516762,10,6
0,0,26,26,20,48,68,120,84,204,0.000333,0.413947,10,12418.4242,689.912455,1241.84242,354.516762,10,6
0,0,29,29,18,46,64,129,93,222,0.000333,0.444,18,23976,1332,1332,329.1425,9,6
0,0,32,32,20,49,69,142,101,243,0.000333,0.49479,20,29687.42886,1649.301603,1484.371443,361.559344,10,6
0,0,10,10,13,16,29,39,30,69,0.000333,0.111734,6,2011.204132,111.733563,335.200689,112.105716,2,6
0,0,27,27,20,49,69,121,86,207,0.000333,0.421488,10,12644.64563,702.480313,1264.464563,361.559344,10,6
0,0,26,26,20,49,69,120,84,204,0.000333,0.41538,10,12461.38989,692.299438,1246.138989,361.559344,10,6
0,0,29,29,18,46,64,129,93,222,0.000333,0.444,18,23976,1332,1332,329.1425,9,6
0,0,32,32,20,49,69,142,101,243,0.000333,0.49479,20,29687.42886,1649.301603,1484.371443,361.559344,10,6
0,0,10,10,13,16,29,39,30,69,0.000333,0.111734,6,2011.204132,111.733563,335.200689,112.105716,2,6
0,0,27,27,20,49,69,121,86,207,0.000333,0.421488,10,12644.64563,702.480313,1264.464563,361.559344,10,6
0,0,26,26,20,49,69,120,84,204,0.000333,0.41538,10,12461.38989,692.299438,1246.138989,361.559344,10,6
0,0,24,24,18,47,65,106,81,187,0.000333,0.375394,9,10135.64503,563.091391,1126.182781,336.124326,8,6
0,0,23,23,18,47,65,105,79,184,0.000333,0.369372,9,9973.041098,554.057839,1108.115678,336.124326,8,6
0,0,24,24,18,46,64,106,80,186,0.000333,0.372,9,10044,558,1116,329.1425,8,6
0,0,23,23,18,46,64,105,78,183,0.000333,0.366,9,9882,549,1098,329.1425,8,6
0,0,30,30,18,46,64,131,102,233,0.000333,0.466,18,25164,1398,1398,329.1425,8,6
0,0,33,33,20,49,69,144,110,254,0.000333,0.517188,20,31031.30424,1723.961347,1551.565212,361.559344,9,6
0,0,10,10,13,17,30,41,32,73,0.000333,0.119401,6,2149.218081,119.401004,358.203013,117.592585,2,6
0,0,28,28,20,49,69,123,95,218,0.000333,0.443886,10,13316.58332,739.810184,1331.658332,361.559344,9,6
0,0,27,27,20,49,69,122,93,215,0.000333,0.437778,10,13133.32758,729.62931,1313.332758,361.559344,9,6
0,0,22,22,21,43,64,105,79,184,0.000333,0.368,10,11040,613.333333,1104,325.56805,8,6
0,0,21,21,21,43,64,104,77,181,0.000333,0.362,10,10860,603.333333,1086,325.56805,8,6
0,0,25,25,19,49,68,114,88,202,0.000333,0.409889,9,11067.00745,614.833747,1229.667494,355.831405,7,6
0,0,24,24,19,49,68,113,86,199,0.000333,0.403802,9,10902.64595,605.702553,1211.405105,355.831405,7,6
0,0,6,6,10,14,24,22,18,40,0.000333,0.061133,5,916.9925,50.944028,183.3985,86.52225,3,6
0,0,7,7,10,15,25,23,20,43,0.000333,0.066562,5,998.429081,55.468282,199.685816,91.82264,3,6
0,0,15,15,14,20,34,53,49,102,0.000333,0.172974,14,7264.896937,403.605385,518.92121,139.741531,2,6
0,0,18,18,17,23,40,66,57,123,0.000333,0.218199,16,10473.55449,581.864138,654.597156,173.528793,3,6
0,0,16,16,16,23,39,58,52,110,0.000333,0.193798,16,9302.307905,516.794884,581.394244,168.041925,2,6
0,0,9,9,10,14,24,36,29,65,0.000333,0.099341,10,2980.225625,165.56809,298.022563,86.52225,2,6
0,0,12,12,14,17,31,49,37,86,0.000333,0.14202,14,5964.852358,331.380687,426.060883,122.789837,3,6
0,0,10,10,13,17,30,41,32,73,0.000333,0.119401,6,2149.218081,119.401004,358.203013,117.592585,2,6
0,0,8,8,11,18,29,30,26,56,0.000333,0.090682,5,1360.234679,75.568593,272.046936,113.112398,2,6
0,0,9,9,11,18,29,31,28,59,0.000333,0.09554,5,1433.104394,79.616911,286.620879,113.112398,2,6
0,0,23,23,18,46,64,103,78,181,0.000333,0.362,9,9774,543,1086,329.1425,8,6
0,0,22,22,18,46,64,102,76,178,0.000333,0.356,9,9612,534,1068,329.1425,8,6
0,0,29,29,18,46,64,129,93,222,0.000333,0.444,18,23976,1332,1332,329.1425,9,6
0,0,32,32,20,49,69,142,101,243,0.000333,0.49479,20,29687.42886,1649.301603,1484.371443,361.559344,10,6
0,0,10,10,13,16,29,39,30,69,0.000333,0.111734,6,2011.204132,111.733563,335.200689,112.105716,2,6
0,0,27,27,20,49,69,121,86,207,0.000333,0.421488,10,12644.64563,702.480313,1264.464563,361.559344,10,6
0,0,26,26,20,49,69,120,84,204,0.000333,0.41538,10,12461.38989,692.299438,1246.138989,361.559344,10,6
0,0,29,29,18,46,64,129,93,222,0.000333,0.444,18,23976,1332,1332,329.1425,9,6
0,0,32,32,20,49,69,142,101,243,0.000333,0.49479,20,29687.42886,1649.301603,1484.371443,361.559344,10,6
0,0,10,10,13,16,29,39,30,69,0.000333,0.111734,6,2011.204132,111.733563,335.200689,112.105716,2,6
0,0,27,27,20,49,69,121,86,207,0.000333,0.421488,10,12644.64563,702.480313,1264.464563,361.559344,10,6
0,0,26,26,20,49,69,120,84,204,0.000333,0.41538,10,12461.38989,692.299438,1246.138989,361.559344,10,6
0,0,14,14,11,18,29,45,42,87,0.000333,0.140881,10,4226.443466,234.802415,422.644347,113.112398,2,6
0,0,17,17,15,21,36,58,50,108,0.000333,0.186117,14,7816.926602,434.2737,558.3519,150.842025,3,6
0,0,10,10,13,16,29,39,30,69,0.000333,0.111734,6,2011.204132,111.733563,335.200689,112.105716,2,6
0,0,12,12,14,30,44,77,53,130,0.000333,0.236575,7,4968.082773,276.004598,709.72611,200.509687,7,6
0,0,14,14,14,33,47,86,61,147,0.000333,0.272175,7,5715.671928,317.537329,816.524561,219.767975,7,6
0,0,29,29,21,51,72,129,95,224,0.000333,0.460688,10,13820.632,767.812889,1382.0632,381.532358,10,6
0,0,28,28,21,51,72,128,93,221,0.000333,0.454518,10,13635.53425,757.529681,1363.553425,381.532358,10,6
0,0,16,16,10,18,28,56,51,107,0.000333,0.171462,10,5143.869767,285.770543,514.386977,108.277931,2,6
0,0,19,19,14,21,35,69,59,128,0.000333,0.218849,14,9191.675166,510.64862,656.548226,145.541635,3,6
0,0,10,10,13,18,31,43,32,75,0.000333,0.123855,6,2229.38834,123.854908,371.564723,123.164366,2,6
0,0,14,14,12,16,28,48,44,92,0.000333,0.147426,12,5307.319834,294.851102,442.276653,107.01955,2,6
0,0,17,17,15,19,34,61,52,113,0.000333,0.191628,14,8048.366215,447.131456,574.883301,139.313982,3,6
0,0,10,10,13,18,31,42,32,74,0.000333,0.122204,6,2199.663162,122.203509,366.610527,123.164366,2,6
0,0,14,14,11,19,30,44,42,86,0.000333,0.140664,10,4219.925912,234.440328,421.992591,118.764371,2,6
0,0,17,17,15,22,37,57,50,107,0.000333,0.185804,14,7803.761142,433.542286,557.41151,156.710855,3,6
0,0,10,10,13,16,29,39,30,69,0.000333,0.111734,6,2011.204132,111.733563,335.200689,112.105716,2,6
0,0,13,13,12,16,28,44,37,81,0.000333,0.129799,12,4672.748984,259.597166,389.395749,107.01955,2,6
0,0,16,16,15,19,34,57,45,102,0.000333,0.172974,14,7264.896937,403.605385,518.92121,139.313982,3,6
0,0,10,10,13,16,29,39,30,69,0.000333,0.111734,6,2011.204132,111.733563,335.200689,112.105716,2,6
0,0,9,9,12,13,25,29,25,54,0.000333,0.083589,6,1504.609405,83.589411,250.768234,91.125266,2,6
0,0,8,8,10,13,23,24,23,47,0.000333,0.070869,5,1063.03706,59.057614,212.607412,81.324997,2,6
0,0,13,13,11,15,26,43,34,77,0.000333,0.120645,10,3619.338583,201.074366,361.933858,96.657107,3,6
0,0,16,16,15,18,33,56,42,98,0.000333,0.164784,14,6920.908732,384.49493,494.350624,133.662009,4,6
0,0,10,10,13,16,29,39,30,69,0.000333,0.111734,6,2011.204132,111.733563,335.200689,112.105716,2,6
0,0,24,24,18,48,66,108,83,191,0.000333,0.384826,9,10390.31349,577.239638,1154.479277,343.13685,8,6
0,0,23,23,18,48,66,107,81,188,0.000333,0.378782,9,10227.11485,568.173047,1136.346094,343.13685,8,6
0,0,13,13,15,21,36,48,35,83,0.000333,0.143035,7,3003.726426,166.87369,429.103775,150.842025,5,6
0,0,17,17,11,19,30,54,56,110,0.000333,0.179919,10,5397.579655,299.865536,539.757966,118.764371,2,6
0,0,20,20,15,22,37,67,64,131,0.000333,0.227479,14,9554.137473,530.785415,682.438391,156.710855,3,6
0,0,10,10,13,18,31,41,34,75,0.000333,0.123855,6,2229.38834,123.854908,371.564723,123.164366,2,6
0,0,10,10,10,15,25,36,32,68,0.000333,0.105261,10,3157.822209,175.434567,315.782221,91.82264,2,6
0,0,13,13,14,18,32,49,40,89,0.000333,0.148333,14,6230,346.111111,445,128.361619,3,6
0,0,10,10,13,16,29,39,30,69,0.000333,0.111734,6,2011.204132,111.733563,335.200689,112.105716,2,6
0,0,28,28,18,45,63,126,92,218,0.000333,0.434349,18,23454.84642,1303.047023,1303.047023,322.192039,8,6
0,0,31,31,20,48,68,139,100,239,0.000333,0.484968,20,29098.07238,1616.559577,1454.903619,354.516762,9,6
0,0,10,10,13,16,29,39,30,69,0.000333,0.111734,6,2011.204132,111.733563,335.200689,112.105716,2,6
0,0,26,26,20,48,68,118,85,203,0.000333,0.411918,10,12357.54957,686.530532,1235.754957,354.516762,9,6
0,0,25,25,20,48,68,117,83,200,0.000333,0.405831,10,12174.92568,676.38476,1217.492568,354.516762,9,6
0,0,31,31,18,49,67,133,103,236,0.000333,0.477199,18,25768.74688,1431.597049,1431.597049,350.179432,8,6
0,0,34,34,20,52,72,146,111,257,0.000333,0.528557,20,31713.41451,1761.856362,1585.670725,382.861427,9,6
0,0,10,10,13,16,29,39,30,69,0.000333,0.111734,6,2011.204132,111.733563,335.200689,112.105716,2,6
0,0,28,28,20,51,71,124,92,216,0.000333,0.442782,10,13283.45378,737.969654,1328.345378,375.732254,9,6
0,0,27,27,20,51,71,123,90,213,0.000333,0.436632,10,13098.96137,727.720076,1309.896136,375.732254,9,6
0,0,15,15,14,19,33,52,48,100,0.000333,0.168146,14,7062.151767,392.341765,504.439412,134.013592,2,6
0,0,18,18,17,22,39,65,56,121,0.000333,0.213178,16,10232.5387,568.474372,639.533668,167.594364,3,6
0,0,16,16,16,22,38,57,51,108,0.000333,0.188925,16,9068.418743,503.801041,566.776171,162.107496,2,6
0,0,9,9,10,19,29,33,29,62,0.000333,0.100398,5,1505.974108,83.665228,301.194822,113.929904,3,6
0,0,10,10,10,20,30,34,31,65,0.000333,0.106316,5,1594.739444,88.596636,318.947889,119.657843,3,6
0,0,11,11,11,21,32,42,32,74,0.000333,0.123333,5,1850,102.777778,370,130.292414,3,6
0,0,12,12,11,21,32,43,34,77,0.000333,0.128333,5,1925,106.944444,385,130.292414,3,6
0,0,37,37,19,54,73,154,118,272,0.000333,0.561211,18,30305.38104,1683.63228,1683.63228,391.474548,12,6
0,0,40,40,21,56,77,167,126,293,0.000333,0.612056,20,36723.36913,2040.187174,1836.168456,417.450542,13,6
0,0,10,10,13,16,29,39,30,69,0.000333,0.111734,6,2011.204132,111.733563,335.200689,112.105716,2,6
0,0,33,33,21,56,77,143,107,250,0.000333,0.522232,10,15666.96635,870.38702,1566.696635,417.450542,13,6
0,0,32,32,21,56,77,142,105,247,0.000333,0.515965,10,15478.96276,859.942375,1547.896276,417.450542,13,6
0,0,39,39,20,55,75,161,127,288,0.000333,0.597967,20,35877.99566,1993.221981,1793.899783,404.413346,13,6
0,0,42,42,22,57,79,174,135,309,0.000333,0.649289,22,42853.10153,2380.727863,1947.868251,430.582226,14,6
0,0,10,10,13,16,29,39,30,69,0.000333,0.111734,6,2011.204132,111.733563,335.200689,112.105716,2,6
0,0,39,39,21,55,76,162,121,283,0.000333,0.589388,20,35363.26973,1964.626096,1768.163486,410.21345,13,6
0,0,42,42,23,57,80,175,129,304,0.000333,0.640622,22,42281.0551,2348.947505,1921.866141,436.516656,14,6
0,0,10,10,13,16,29,39,30,69,0.000333,0.111734,6,2011.204132,111.733563,335.200689,112.105716,2,6
0,0,35,35,19,53,72,150,112,262,0.000333,0.53884,18,29097.36631,1616.52035,1616.52035,384.290407,12,6
0,0,38,38,21,55,76,163,120,283,0.000333,0.589388,20,35363.26973,1964.626096,1768.163486,410.21345,13,6
0,0,10,10,13,16,29,39,30,69,0.000333,0.111734,6,2011.204132,111.733563,335.200689,112.105716,2,6
0,0,31,31,21,54,75,139,101,240,0.000333,0.498305,10,14949.16486,830.509159,1494.916486,403.002591,13,6
0,0,30,30,21,54,75,138,99,237,0.000333,0.492077,10,14762.3003,820.127794,1476.23003,403.002591,13,6
0,0,36,36,20,54,74,153,113,266,0.000333,0.550572,20,33034.29191,1835.238439,1651.714595,397.202487,13,6
0,0,39,39,22,56,78,166,121,287,0.000333,0.601303,22,39686.02961,2204.779423,1803.910437,423.319371,14,6
0,0,10,10,13,16,29,39,30,69,0.000333,0.111734,6,2011.204132,111.733563,335.200689,112.105716,2,6
0,0,32,32,22,55,77,142,102,244,0.000333,0.509699,11,16820.05508,934.447504,1529.095916,416.08228,14,6
0,0,31,31,22,55,77,141,100,241,0.000333,0.503432,11,16613.25112,922.958396,1510.295556,416.08228,14,6
0,0,36,36,19,55,74,153,114,267,0.000333,0.552641,18,29842.63288,1657.924049,1657.924049,398.685407,13,6
0,0,39,39,21,57,78,166,122,288,0.000333,0.603399,20,36203.91678,2011.32871,1810.195839,424.713397,14,6
0,0,10,10,13,16,29,39,30,69,0.000333,0.111734,6,2011.204132,111.733563,335.200689,112.105716,2,6
0,0,32,32,21,56,77,142,103,245,0.000333,0.511788,10,15353.62703,852.979279,1535.362702,417.450542,14,6
0,0,31,31,21,56,77,141,101,242,0.000333,0.505521,10,15165.62343,842.534635,1516.562343,417.450542,14,6
0,0,21,21,20,43,63,102,74,176,0.000333,0.350667,10,10520.01267,584.445148,1052.001267,319.767946,9,6
0,0,20,20,20,43,63,101,72,173,0.000333,0.34469,10,10340.69427,574.483015,1034.069427,319.767946,9,6
0,0,7,7,12,24,36,42,34,76,0.000333,0.130971,6,2357.485801,130.971433,392.9143,153.05865,2,6
0,0,10,10,17,31,48,65,51,116,0.000333,0.215952,8,5182.845201,287.935844,647.85565,223.066954,3,6
0,0,9,9,17,29,46,62,48,110,0.000333,0.202531,8,4860.734521,270.040807,607.591815,210.368317,3,6
0,0,15,15,16,19,35,67,49,116,0.000333,0.198332,16,9519.949279,528.886071,594.99683,144.710623,5,6
0,0,14,14,14,19,33,62,47,109,0.000333,0.18328,14,7697.745426,427.652524,549.838959,134.013592,5,6
0,0,14,14,10,17,27,47,40,87,0.000333,0.137892,10,4136.752127,229.819563,413.675213,102.706149,2,6
0,0,17,17,14,20,34,60,48,108,0.000333,0.183149,14,7692.243816,427.346879,549.445987,139.741531,3,6
0,0,10,10,13,16,29,39,30,69,0.000333,0.111734,6,2011.204132,111.733563,335.200689,112.105716,2,6
0,0,14,14,12,17,29,50,40,90,0.000333,0.145739,12,5246.619475,291.47886,437.21829,112.506418,2,6
0,0,17,17,15,20,35,63,48,111,0.000333,0.189783,14,7970.905808,442.8281,569.350415,145.041921,3,6
0,0,10,10,13,16,29,39,30,69,0.000333,0.111734,6,2011.204132,111.733563,335.200689,112.105716,2,6
0,0,16,16,11,18,29,54,49,103,0.000333,0.166791,10,5003.720425,277.984468,500.372042,113.112398,3,6
0,0,19,19,15,21,36,67,57,124,0.000333,0.21369,14,8974.989803,498.610545,641.0707,150.842025,4,6
0,0,10,10,13,16,29,39,30,69,0.000333,0.111734,6,2011.204132,111.733563,335.200689,112.105716,2,6
0,0,23,23,21,43,64,106,77,183,0.000333,0.366,10,10980,610,1098,325.56805,9,6
0,0,22,22,21,43,64,105,75,180,0.000333,0.36,10,10800,600,1080,325.56805,9,6
0,0,21,21,20,43,63,102,74,176,0.000333,0.350667,10,10520.01267,584.445148,1052.001267,319.767946,9,6
0,0,20,20,20,43,63,101,72,173,0.000333,0.34469,10,10340.69427,574.483015,1034.069427,319.767946,9,6
0,0,21,21,20,44,64,102,75,177,0.000333,0.354,10,10620,590,1062,326.653553,9,6
0,0,20,20,20,44,64,101,73,174,0.000333,0.348,10,10440,580,1044,326.653553,9,6
0,0,34,34,18,48,66,141,122,263,0.000333,0.529892,18,28614.16176,1589.675653,1589.675653,343.13685,8,6
0,0,37,37,20,51,71,154,130,284,0.000333,0.582176,20,34930.56364,1940.586869,1746.528182,375.732254,9,6
0,0,10,10,13,17,30,41,32,73,0.000333,0.119401,6,2149.218081,119.401004,358.203013,117.592585,2,6
0,0,30,30,18,46,64,131,102,233,0.000333,0.466,18,25164,1398,1398,329.1425,8,6
0,0,33,33,20,49,69,144,110,254,0.000333,0.517188,20,31031.30424,1723.961347,1551.565212,361.559344,9,6
0,0,10,10,13,17,30,41,32,73,0.000333,0.119401,6,2149.218081,119.401004,358.203013,117.592585,2,6
0,0,18,18,19,32,51,88,63,151,0.000333,0.285512,9,7708.82604,428.268113,856.536227,240.710623,4,6
0,0,17,17,19,31,50,86,61,147,0.000333,0.276549,9,7466.821739,414.82343,829.64686,234.290708,4,6
0,0,36,36,19,37,56,157,108,265,0.000333,0.512983,18,27701.08298,1538.949054,1538.949054,273.460397,23,6
0,0,65,65,23,89,112,305,229,534,0.000333,1.211709,22,79972.80562,4442.933646,3635.127528,680.3822,23,6
0,0,10,10,16,29,45,64,52,116,0.000333,0.212352,8,5096.439673,283.135537,637.054959,204.881449,4,6
0,0,10,10,16,29,45,64,52,116,0.000333,0.212352,8,5096.439673,283.135537,637.054959,204.881449,4,6
0,0,10,10,16,29,45,64,52,116,0.000333,0.212352,8,5096.439673,283.135537,637.054959,204.881449,4,6
0,0,10,10,16,29,45,63,51,114,0.000333,0.20869,8,5008.570024,278.25389,626.071253,204.881449,4,6
0,0,6,6,15,24,39,46,38,84,0.000333,0.147991,7,3107.816505,172.656472,443.973786,168.642459,3,6
0,0,54,54,22,48,70,338,166,504,0.000333,1.02972,33,101942.2351,5663.457508,3089.158641,366.185696,39,6
0,0,43,43,20,31,51,277,118,395,0.000333,0.746869,30,67218.2403,3734.346683,2240.60801,240.018648,38,6
0,0,54,54,22,48,70,338,166,504,0.000333,1.02972,33,101942.2351,5663.457508,3089.158641,366.185696,39,6
0,0,43,43,20,31,51,277,118,395,0.000333,0.746869,30,67218.2403,3734.346683,2240.60801,240.018648,38,6
0,0,54,54,22,48,70,338,166,504,0.000333,1.02972,33,101942.2351,5663.457508,3089.158641,366.185696,39,6
0,0,43,43,20,31,51,277,118,395,0.000333,0.746869,30,67218.2403,3734.346683,2240.60801,240.018648,38,6
0,0,54,54,22,48,70,338,166,504,0.000333,1.02972,33,101942.2351,5663.457508,3089.158641,366.185696,39,6
0,0,51,51,22,47,69,333,160,493,0.000333,1.003834,33,99379.58439,5521.088022,3011.502557,359.173172,39,6
0,0,54,54,22,48,70,338,166,504,0.000333,1.02972,33,101942.2351,5663.457508,3089.158641,366.185696,39,6
0,0,43,43,20,31,51,277,118,395,0.000333,0.746869,30,67218.2403,3734.346683,2240.60801,240.018648,38,6
0,0,54,54,22,48,70,338,166,504,0.000333,1.02972,33,101942.2351,5663.457508,3089.158641,366.185696,39,6
0,0,54,54,22,48,70,338,166,504,0.000333,1.02972,33,101942.2351,5663.457508,3089.158641,366.185696,39,6
0,0,43,43,20,31,51,277,118,395,0.000333,0.746869,30,67218.2403,3734.346683,2240.60801,240.018648,38,6
0,0,54,54,22,48,70,338,166,504,0.000333,1.02972,33,101942.2351,5663.457508,3089.158641,366.185696,39,6
0,0,43,43,20,31,51,277,118,395,0.000333,0.746869,30,67218.2403,3734.346683,2240.60801,240.018648,38,6
0,0,54,54,22,48,70,338,166,504,0.000333,1.02972,33,101942.2351,5663.457508,3089.158641,366.185696,39,6
0,0,43,43,20,31,51,277,118,395,0.000333,0.746869,30,67218.2403,3734.346683,2240.60801,240.018648,38,6
0,0,43,43,20,31,51,277,118,395,0.000333,0.746869,30,67218.2403,3734.346683,2240.60801,240.018648,38,6
0,0,54,54,22,48,70,338,166,504,0.000333,1.02972,33,101942.2351,5663.457508,3089.158641,366.185696,39,6
0,0,51,51,22,47,69,333,160,493,0.000333,1.003834,33,99379.58439,5521.088022,3011.502557,359.173172,39,6
0,0,44,44,20,33,53,282,122,404,0.000333,0.77136,30,69422.39591,3856.799773,2314.079864,252.903568,38,6
0,0,44,44,22,36,58,285,124,409,0.000333,0.798638,33,79065.16949,4392.509416,2395.914227,284.224796,38,6
0,0,43,43,20,31,51,277,118,395,0.000333,0.746869,30,67218.2403,3734.346683,2240.60801,240.018648,38,6
0,0,43,43,20,31,51,277,118,395,0.000333,0.746869,30,67218.2403,3734.346683,2240.60801,240.018648,38,6
0,0,44,44,20,33,53,282,122,404,0.000333,0.77136,30,69422.39591,3856.799773,2314.079864,252.903568,38,6
0,0,44,44,20,33,53,282,122,404,0.000333,0.77136,30,69422.39591,3856.799773,2314.079864,252.903568,38,6
0,0,44,44,22,36,58,285,124,409,0.000333,0.798638,33,79065.16949,4392.509416,2395.914227,284.224796,38,6
0,0,43,43,20,31,51,277,118,395,0.000333,0.746869,30,67218.2403,3734.346683,2240.60801,240.018648,38,6
0,0,44,44,20,33,53,282,122,404,0.000333,0.77136,30,69422.39591,3856.799773,2314.079864,252.903568,38,6
0,0,44,44,20,33,53,282,122,404,0.000333,0.77136,30,69422.39591,3856.799773,2314.079864,252.903568,39,6
0,0,44,44,20,33,53,282,122,404,0.000333,0.77136,30,69422.39591,3856.799773,2314.079864,252.903568,38,6
0,0,44,44,20,33,53,282,122,404,0.000333,0.77136,30,69422.39591,3856.799773,2314.079864,252.903568,38,6
0,0,44,44,20,33,53,282,122,404,0.000333,0.77136,30,69422.39591,3856.799773,2314.079864,252.903568,38,6
0,0,44,44,20,33,53,282,122,404,0.000333,0.77136,30,69422.39591,3856.799773,2314.079864,252.903568,38,6
0,0,54,54,22,48,70,338,166,504,0.000333,1.02972,33,101942.2351,5663.457508,3089.158641,366.185696,39,6
0,0,43,43,20,31,51,277,118,395,0.000333,0.746869,30,67218.2403,3734.346683,2240.60801,240.018648,38,6
0,0,43,43,20,31,51,277,118,395,0.000333,0.746869,30,67218.2403,3734.346683,2240.60801,240.018648,38,6
0,0,43,43,20,31,51,277,118,395,0.000333,0.746869,30,67218.2403,3734.346683,2240.60801,240.018648,38,6
0,0,43,43,20,31,51,277,118,395,0.000333,0.746869,30,67218.2403,3734.346683,2240.60801,240.018648,38,6
0,0,43,43,20,31,51,277,118,395,0.000333,0.746869,30,67218.2403,3734.346683,2240.60801,240.018648,38,6
0,0,43,43,20,31,51,277,118,395,0.000333,0.746869,30,67218.2403,3734.346683,2240.60801,240.018648,38,6
0,0,43,43,20,31,51,277,118,395,0.000333,0.746869,30,67218.2403,3734.346683,2240.60801,240.018648,38,6
0,0,43,43,20,31,51,277,118,395,0.000333,0.746869,30,67218.2403,3734.346683,2240.60801,240.018648,38,6
0,0,43,43,20,31,51,277,118,395,0.000333,0.746869,30,67218.2403,3734.346683,2240.60801,240.018648,38,6
0,0,43,43,20,31,51,277,118,395,0.000333,0.746869,30,67218.2403,3734.346683,2240.60801,240.018648,38,6
0,0,54,54,22,48,70,338,166,504,0.000333,1.02972,33,101942.2351,5663.457508,3089.158641,366.185696,39,6
0,0,15,15,18,44,62,137,100,237,0.000333,0.470382,18,25400.60146,1411.144526,1411.144526,315.273641,2,6
0,0,17,17,18,29,47,81,60,141,0.000333,0.261066,18,14097.54651,783.197028,783.197028,215.940099,4,6
0,0,16,16,18,28,46,79,58,137,0.000333,0.252243,18,13621.10378,756.727988,756.727988,209.664588,4,6
0,0,30,30,25,35,60,150,125,275,0.000333,0.541465,36,58478.2169,3248.789828,1624.394914,295.62131,26,6
0,0,15,15,20,32,52,103,84,187,0.000333,0.355327,20,21319.64455,1184.424697,1065.982227,246.438562,6,6
0,0,15,15,20,32,52,103,84,187,0.000333,0.355327,20,21319.64455,1184.424697,1065.982227,246.438562,6,6
0,0,55,55,30,46,76,334,243,577,0.000333,1.201685,75,270379.0631,15021.05906,3605.054175,401.290568,47,6
0,0,25,25,25,32,57,144,102,246,0.000333,0.478297,36,51656.07397,2869.781887,1434.890943,276.096405,12,6
0,0,55,55,30,46,76,334,243,577,0.000333,1.201685,75,270379.0631,15021.05906,3605.054175,401.290568,47,6
0,0,25,25,25,32,57,144,102,246,0.000333,0.478297,36,51656.07397,2869.781887,1434.890943,276.096405,12,6
0,0,31,31,24,38,62,142,130,272,0.000333,0.539847,36,58303.49027,3239.082793,1619.541396,309.460346,5,6
0,0,29,29,23,38,61,134,124,258,0.000333,0.510043,33,50494.29769,2805.238761,1530.130233,303.463171,5,6
0,0,11,11,15,27,42,45,39,84,0.000333,0.150985,7,3170.682645,176.149036,452.954664,186.985321,1,6
0,0,42,42,25,37,62,175,172,347,0.000333,0.688702,48,99173.09375,5509.616319,2066.10612,308.846179,8,6
0,0,41,41,23,34,57,164,160,324,0.000333,0.629952,44,83153.68004,4619.648891,1889.856365,277.015662,5,6
0,0,18,18,19,30,49,83,72,155,0.000333,0.290093,18,15665.04047,870.280026,870.280026,227.917341,1,6
1,0,26,27,24,52,76,122,88,210,0.000333,0.437355,12,15744.77733,874.709852,1312.064778,406.461965,9,6
1,0,40,41,29,75,104,190,146,336,0.000333,0.750449,14,31518.86843,1751.048246,2251.347745,608.042851,11,6
1,0,15,16,25,36,61,96,75,171,0.000333,0.338052,24,24339.74603,1352.208113,1014.156085,302.213705,16,6
0,0,42,42,22,48,70,275,210,485,0.000333,0.990901,44,130798.8996,7266.605532,2972.702263,366.185696,15,6
0,0,45,45,22,48,70,295,224,519,0.000333,1.060366,44,139968.307,7776.017054,3181.097886,366.185696,15,6
0,0,20,20,21,32,53,134,107,241,0.000333,0.460143,30,41412.86489,2300.714716,1380.42883,252.238666,8,6
0,0,30,30,21,43,64,210,161,371,0.000333,0.742,30,66780,3710,2226,325.56805,8,6
0,0,42,42,22,48,70,275,210,485,0.000333,0.990901,44,130798.8996,7266.605532,2972.702263,366.185696,15,6
0,0,45,45,22,48,70,295,224,519,0.000333,1.060366,44,139968.307,7776.017054,3181.097886,366.185696,15,6
0,0,20,20,21,32,53,134,107,241,0.000333,0.460143,30,41412.86489,2300.714716,1380.42883,252.238666,8,6
0,0,30,30,21,43,64,210,161,371,0.000333,0.742,30,66780,3710,2226,325.56805,8,6
0,0,20,20,21,32,53,134,107,241,0.000333,0.460143,30,41412.86489,2300.714716,1380.42883,252.238666,8,6
0,0,19,19,20,29,49,114,90,204,0.000333,0.3818,30,34362.02425,1909.001347,1145.400808,227.320011,8,6
0,0,30,30,21,43,64,210,161,371,0.000333,0.742,30,66780,3710,2226,325.56805,8,6
0,0,40,40,24,45,69,284,205,489,0.000333,0.995689,48,143379.286,7965.515892,2987.068459,357.172489,31,6
0,0,39,39,26,49,75,275,202,477,0.000333,0.990382,52,154499.6188,8583.312156,2971.146515,397.332215,24,6
0,0,39,39,26,51,77,263,196,459,0.000333,0.958818,39,112181.7459,6232.319215,2876.455022,411.505125,24,6
0,0,38,38,24,44,68,246,181,427,0.000333,0.866449,48,124768.6384,6931.591022,2599.346633,350.254091,24,6
0,0,38,38,24,44,68,246,181,427,0.000333,0.866449,48,124768.6384,6931.591022,2599.346633,350.254091,24,6
0,0,40,40,24,45,69,284,205,489,0.000333,0.995689,48,143379.286,7965.515892,2987.068459,357.172489,31,6
0,0,39,39,26,49,75,275,202,477,0.000333,0.990382,52,154499.6188,8583.312156,2971.146515,397.332215,24,6
0,0,39,39,26,51,77,263,196,459,0.000333,0.958818,39,112181.7459,6232.319215,2876.455022,411.505125,24,6
0,0,38,38,24,44,68,246,181,427,0.000333,0.866449,48,124768.6384,6931.591022,2599.346633,350.254091,24,6
0,0,38,38,24,44,68,246,181,427,0.000333,0.866449,48,124768.6384,6931.591022,2599.346633,350.254091,24,6
0,0,49,49,27,66,93,256,195,451,0.000333,0.983054,26,76678.17622,4259.898679,2949.160624,527.311974,13,6
0,0,40,40,25,58,83,201,160,361,0.000333,0.76713,24,55233.34163,3068.51898,2301.389235,455.859302,13,6
0,0,45,45,26,63,89,225,175,400,0.000333,0.863431,26,67347.62768,3741.534871,2590.293372,498.780068,9,6
0,0,24,24,26,44,70,132,108,240,0.000333,0.490343,26,38246.72603,2124.818113,1471.027924,362.426424,11,6
0,0,53,53,25,59,84,267,208,475,0.000333,1.012117,36,109308.6279,6072.701552,3036.350776,463.172345,21,6
0,0,53,53,25,59,84,267,208,475,0.000333,1.012117,36,109308.6279,6072.701552,3036.350776,463.172345,21,6
0,0,51,51,25,54,79,255,198,453,0.000333,0.951871,36,102802.0564,5711.225358,2855.612679,426.86033,19,6
0,0,31,31,22,48,70,178,131,309,0.000333,0.631316,22,41666.86595,2314.825886,1893.948452,366.185696,15,6
0,0,36,36,18,37,55,156,106,262,0.000333,0.504905,18,27264.89241,1514.716245,1514.716245,267.808425,22,6
0,0,78,78,29,56,85,409,317,726,0.000333,1.551073,70,325725.2474,18095.84708,4653.21782,466.093324,18,6
0,0,36,36,22,40,62,174,131,305,0.000333,0.605343,33,59928.98586,3329.388104,1816.029875,310.984619,12,6
0,0,35,35,22,40,62,172,128,300,0.000333,0.59542,33,58946.54347,3274.807971,1786.258893,310.984619,12,6
0,0,26,26,19,31,50,105,81,186,0.000333,0.349919,18,18895.63052,1049.757251,1049.757251,234.290708,6,6
0,0,31,31,19,34,53,133,100,233,0.000333,0.444868,18,24022.89839,1334.605466,1334.605466,253.684359,8,6
0,0,36,36,21,39,60,174,130,304,0.000333,0.598565,30,53870.84223,2992.824568,1795.694741,298.369352,11,6
0,0,36,36,21,39,60,174,130,304,0.000333,0.598565,30,53870.84223,2992.824568,1795.694741,298.369352,11,6
0,0,40,40,22,40,62,190,142,332,0.000333,0.658931,33,65234.17478,3624.120821,1976.793175,310.984619,13,6
0,0,39,39,22,40,62,186,139,325,0.000333,0.645038,33,63858.75543,3547.708635,1935.113801,310.984619,13,6
0,0,38,38,22,39,61,185,139,324,0.000333,0.64052,33,63411.44361,3522.857979,1921.558897,304.238182,13,6
0,0,31,31,19,35,54,128,97,225,0.000333,0.431617,18,23307.29438,1294.849688,1294.849688,260.235528,8,6
0,0,26,26,19,31,50,105,81,186,0.000333,0.349919,18,18895.63052,1049.757251,1049.757251,234.290708,6,6
0,0,69,69,29,75,104,472,370,842,0.000333,1.88059,56,315939.1336,17552.17409,5641.770243,608.042851,52,6
0,0,55,55,27,59,86,283,233,516,0.000333,1.105318,39,129322.1519,7184.563996,3315.952613,475.457902,16,6
0,0,35,35,24,47,71,191,163,354,0.000333,0.72567,36,78372.37729,4354.020961,2177.01048,371.104776,12,6
0,0,17,17,16,33,49,93,68,161,0.000333,0.301323,16,14463.49256,803.527364,903.968285,230.465006,7,6
0,0,19,19,17,37,54,95,70,165,0.000333,0.316519,8,7596.451503,422.025083,949.556438,262.236643,7,6
0,0,19,19,17,37,54,95,69,164,0.000333,0.314601,8,7550.412403,419.467356,943.80155,262.236643,7,6
0,0,18,18,16,34,50,89,64,153,0.000333,0.287837,8,6908.079976,383.782221,863.509997,236.973737,5,6
0,0,17,17,17,33,50,88,62,150,0.000333,0.282193,8,6772.627428,376.257079,846.578428,235.951874,7,6
0,0,18,18,17,35,52,101,72,173,0.000333,0.328725,16,15778.81714,876.600952,986.176071,249.011774,7,6
0,0,11,11,18,31,49,65,49,114,0.000333,0.213359,9,5760.6923,320.038461,640.076922,228.638736,3,6
0,0,11,11,18,31,49,65,49,114,0.000333,0.213359,9,5760.6923,320.038461,640.076922,228.638736,3,6
0,0,10,10,19,33,52,59,45,104,0.000333,0.197615,9,5335.611576,296.422865,592.845731,247.175629,3,6
0,0,9,9,16,29,45,50,40,90,0.000333,0.164756,8,3954.134229,219.674124,494.266779,204.881449,3,6
0,0,7,7,13,26,39,43,34,77,0.000333,0.135659,6,2441.855825,135.658657,406.975971,170.317149,3,6
0,0,8,8,14,28,42,51,37,88,0.000333,0.158175,7,3321.667532,184.537085,474.523933,187.908907,4,6
0,0,11,11,16,24,40,56,44,100,0.000333,0.177398,8,4257.542476,236.530138,532.192809,174.0391,7,6
0,0,8,8,16,22,38,42,33,75,0.000333,0.131198,8,3148.756508,174.930917,393.594564,162.107496,5,6
0,0,13,13,18,27,45,67,51,118,0.000333,0.216013,9,5832.347988,324.019333,648.038665,203.440613,5,6
0,0,13,13,18,27,45,67,51,118,0.000333,0.216013,9,5832.347988,324.019333,648.038665,203.440613,5,6
0,0,13,13,18,27,45,67,51,118,0.000333,0.216013,9,5832.347988,324.019333,648.038665,203.440613,5,6
1,0,11,12,14,24,38,68,54,122,0.000333,0.213416,14,8963.460193,497.970011,640.247157,163.342069,4,6
1,0,15,16,15,26,41,80,62,142,0.000333,0.253591,14,10650.81339,591.711855,760.772385,180.814792,4,6
0,0,76,76,29,83,112,507,401,908,0.000333,2.060359,56,346140.3831,19230.02128,6181.078269,670.009722,29,6
0,0,76,76,29,83,112,507,401,908,0.000333,2.060359,56,346140.3831,19230.02128,6181.078269,670.009722,29,6
0,0,76,76,29,83,112,507,401,908,0.000333,2.060359,56,346140.3831,19230.02128,6181.078269,670.009722,29,6
0,0,13,13,13,35,48,66,60,126,0.000333,0.234568,6,4222.231651,234.568425,703.705275,227.630622,4,6
0,0,14,14,17,36,53,79,63,142,0.000333,0.271122,8,6506.917636,361.495424,813.364705,255.604168,7,6
0,0,53,53,26,82,108,355,283,638,0.000333,1.436539,39,168075.1108,9337.506157,4309.618226,643.530697,18,6
0,0,52,52,26,80,106,340,272,612,0.000333,1.372496,39,160582.0054,8921.222523,4117.487318,627.96568,18,6
0,0,53,53,26,86,112,357,292,649,0.000333,1.472658,39,172300.9604,9572.27558,4417.973344,674.870202,18,6
0,0,29,29,21,51,72,164,125,289,0.000333,0.594369,20,35662.16651,1981.231473,1783.108325,381.532358,12,6
0,0,76,76,29,83,112,507,401,908,0.000333,2.060359,56,346140.3831,19230.02128,6181.078269,670.009722,29,6
0,0,76,76,29,83,112,507,401,908,0.000333,2.060359,56,346140.3831,19230.02128,6181.078269,670.009722,29,6
0,0,9,9,14,24,38,43,37,80,0.000333,0.139945,7,2938.839408,163.268856,419.834201,163.342069,5,6
0,0,8,8,11,23,34,33,33,66,0.000333,0.111924,5,1678.862738,93.270152,335.772548,142.095673,3,6
0,0,10,10,15,24,39,47,39,86,0.000333,0.151515,7,3181.812136,176.767341,454.544591,168.642459,6,6
0,0,4,4,12,15,27,23,23,46,0.000333,0.072908,6,1312.348951,72.908275,218.724825,101.622909,3,6
0,0,9,9,12,24,36,40,37,77,0.000333,0.132695,6,2388.505351,132.694742,398.084225,153.05865,6,6
0,0,10,10,13,26,39,50,45,95,0.000333,0.167371,6,3012.679265,167.37107,502.113211,170.317149,6,6
0,0,11,11,13,26,39,58,51,109,0.000333,0.192036,6,3456.653051,192.036281,576.108842,170.317149,6,6
0,0,9,9,12,25,37,45,41,86,0.000333,0.149338,6,2688.077937,149.337663,448.012989,159.115955,6,6
0,0,9,9,12,25,37,45,41,86,0.000333,0.149338,6,2688.077937,149.337663,448.012989,159.115955,6,6
0,0,10,10,13,24,37,53,47,100,0.000333,0.173648,6,3125.672019,173.648446,520.945337,158.144816,5,6
0,0,8,8,12,24,36,42,39,81,0.000333,0.139588,6,2512.583551,139.587975,418.763925,153.05865,5,6
0,0,8,8,12,24,36,42,39,81,0.000333,0.139588,6,2512.583551,139.587975,418.763925,153.05865,5,6
0,0,7,7,12,22,34,34,33,67,0.000333,0.11362,6,2045.160062,113.620003,340.86001,141.127046,4,6
0,0,7,7,12,24,36,39,37,76,0.000333,0.130971,6,2357.485801,130.971433,392.9143,153.05865,4,6
0,0,7,7,12,23,35,39,37,76,0.000333,0.129942,6,2338.953056,129.941836,389.825509,147.061475,4,6
0,0,7,7,12,23,35,39,37,76,0.000333,0.129942,6,2338.953056,129.941836,389.825509,147.061475,4,6
0,0,6,6,12,23,35,36,35,71,0.000333,0.121393,6,2185.074565,121.393031,364.179094,147.061475,3,6
0,0,6,6,12,22,34,36,35,71,0.000333,0.120403,6,2167.25917,120.403287,361.209862,141.127046,3,6
0,0,3,3,11,20,31,25,26,51,0.000333,0.084221,5,1263.320059,70.184448,252.664012,124.49231,1,6
0,0,30,30,17,27,44,114,95,209,0.000333,0.38034,24,27384.509,1521.361611,1141.021208,197.868831,8,6
0,0,43,43,17,29,46,165,136,301,0.000333,0.554197,32,53202.94876,2955.719376,1662.592149,210.368317,8,6
0,0,80,80,26,103,129,379,298,677,0.000333,1.5822,26,123411.6222,6856.201231,4746.600852,810.920987,22,6
0,0,51,51,25,69,94,232,189,421,0.000333,0.919827,24,66227.56576,3679.309209,2759.481907,537.584592,11,6
0,0,51,51,25,69,94,232,189,421,0.000333,0.919827,24,66227.56576,3679.309209,2759.481907,537.584592,11,6
0,0,49,49,23,69,92,222,181,403,0.000333,0.876332,22,57837.9003,3213.216683,2628.995468,525.530113,10,6
0,0,47,47,23,68,91,215,177,392,0.000333,0.850352,22,56123.22098,3117.956721,2551.055499,517.989398,10,6
0,0,12,12,19,34,53,89,79,168,0.000333,0.320764,18,17321.23146,962.290636,962.290636,253.684359,5,6
0,0,19,19,20,44,64,131,115,246,0.000333,0.492,20,29520,1640,1476,326.653553,6,6
0,0,12,12,15,26,41,63,47,110,0.000333,0.196444,7,4125.315044,229.184169,589.330721,180.814792,6,6
0,0,12,12,15,26,41,63,47,110,0.000333,0.196444,7,4125.315044,229.184169,589.330721,180.814792,6,6
0,0,10,10,15,23,38,52,38,90,0.000333,0.157438,7,3306.194333,183.677463,472.313476,162.645284,6,6
0,0,10,10,15,22,37,51,39,90,0.000333,0.156284,7,3281.95562,182.330868,468.850803,156.710855,5,6
0,0,9,9,15,22,37,46,35,81,0.000333,0.140655,7,2953.760058,164.097781,421.965723,156.710855,5,6
0,0,11,11,15,23,38,57,42,99,0.000333,0.173182,7,3636.813767,202.045209,519.544824,162.645284,6,6
0,0,8,8,15,23,38,42,34,76,0.000333,0.132947,7,2791.897437,155.105413,398.842491,162.645284,4,6
0,0,75,75,31,89,120,401,242,643,0.000333,1.480377,30,133233.9196,7401.884422,4441.130653,729.920361,49,6
0,0,76,76,31,90,121,412,247,659,0.000333,1.519844,30,136785.9262,7599.218122,4559.530873,737.846864,50,6
0,0,74,74,31,88,119,398,240,638,0.000333,1.466298,30,131966.812,7331.489555,4398.893733,722.010068,49,6
0,0,59,59,28,83,111,333,202,535,0.000333,1.211671,28,101780.3497,5654.463871,3635.012488,663.734211,40,6
0,0,54,54,26,81,107,302,175,477,0.000333,1.071893,26,83607.67357,4644.870754,3215.679753,635.739283,38,6
0,0,75,75,31,89,120,401,242,643,0.000333,1.480377,30,133233.9196,7401.884422,4441.130653,729.920361,49,6
0,0,76,76,31,90,121,412,247,659,0.000333,1.519844,30,136785.9262,7599.218122,4559.530873,737.846864,50,6
0,0,74,74,31,88,119,398,240,638,0.000333,1.466298,30,131966.812,7331.489555,4398.893733,722.010068,49,6
0,0,59,59,28,83,111,333,202,535,0.000333,1.211671,28,101780.3497,5654.463871,3635.012488,663.734211,40,6
0,0,76,76,31,91,122,411,246,657,0.000333,1.517831,30,136604.8329,7589.157385,4553.494431,745.789398,50,6
0,0,68,68,30,101,131,380,242,622,0.000333,1.458263,30,131243.6732,7291.315178,4374.789107,819.686078,43,6
0,0,56,56,27,78,105,303,181,484,0.000333,1.083232,26,84492.06559,4694.003644,3249.694831,618.643336,35,6
0,0,70,70,30,82,112,380,222,602,0.000333,1.366009,30,122940.8299,6830.046105,4098.027663,668.525982,45,6
0,0,62,62,28,79,107,346,207,553,0.000333,1.242677,28,104384.8748,5799.159712,3728.031243,632.604617,41,6
0,0,70,70,30,82,112,381,223,604,0.000333,1.370547,30,123349.2712,6852.737288,4111.642373,668.525982,45,6
0,0,75,75,31,89,120,401,242,643,0.000333,1.480377,30,133233.9196,7401.884422,4441.130653,729.920361,49,6
0,0,76,76,31,90,121,412,247,659,0.000333,1.519844,30,136785.9262,7599.218122,4559.530873,737.846864,50,6
0,0,74,74,31,88,119,398,240,638,0.000333,1.466298,30,131966.812,7331.489555,4398.893733,722.010068,49,6
0,0,59,59,28,83,111,333,202,535,0.000333,1.211671,28,101780.3497,5654.463871,3635.012488,663.734211,40,6
0,0,76,76,31,91,122,411,246,657,0.000333,1.517831,30,136604.8329,7589.157385,4553.494431,745.789398,50,6
0,0,54,54,26,81,107,302,175,477,0.000333,1.071893,26,83607.67357,4644.870754,3215.679753,635.739283,38,6
0,0,75,75,31,89,120,401,242,643,0.000333,1.480377,30,133233.9196,7401.884422,4441.130653,729.920361,49,6
0,0,76,76,31,90,121,412,247,659,0.000333,1.519844,30,136785.9262,7599.218122,4559.530873,737.846864,50,6
0,0,74,74,31,88,119,398,240,638,0.000333,1.466298,30,131966.812,7331.489555,4398.893733,722.010068,49,6
0,0,59,59,28,83,111,333,202,535,0.000333,1.211671,28,101780.3497,5654.463871,3635.012488,663.734211,40,6
0,0,76,76,31,91,122,411,246,657,0.000333,1.517831,30,136604.8329,7589.157385,4553.494431,745.789398,50,6
0,0,54,54,26,81,107,302,175,477,0.000333,1.071893,26,83607.67357,4644.870754,3215.679753,635.739283,38,6
0,0,37,37,23,58,81,245,152,397,0.000333,0.838973,22,55372.24993,3076.236107,2516.920451,443.804823,13,6
0,0,72,72,31,88,119,390,240,630,0.000333,1.447912,30,130312.0557,7239.558651,4343.735191,722.010068,46,6
0,0,71,71,31,88,119,386,238,624,0.000333,1.434122,30,129070.9885,7170.610474,4302.366284,722.010068,45,6
0,0,64,64,28,80,108,353,214,567,0.000333,1.276674,28,107240.594,5957.810777,3830.021214,640.360185,41,6
0,0,75,75,31,89,120,401,242,643,0.000333,1.480377,30,133233.9196,7401.884422,4441.130653,729.920361,49,6
0,0,76,76,31,90,121,412,247,659,0.000333,1.519844,30,136785.9262,7599.218122,4559.530873,737.846864,50,6
0,0,74,74,31,88,119,398,240,638,0.000333,1.466298,30,131966.812,7331.489555,4398.893733,722.010068,49,6
0,0,59,59,28,83,111,333,202,535,0.000333,1.211671,28,101780.3497,5654.463871,3635.012488,663.734211,40,6
0,0,76,76,31,91,122,411,246,657,0.000333,1.517831,30,136604.8329,7589.157385,4553.494431,745.789398,50,6
0,0,54,54,26,81,107,302,175,477,0.000333,1.071893,26,83607.67357,4644.870754,3215.679753,635.739283,38,6
0,0,12,12,18,23,41,55,43,98,0.000333,0.175013,9,4725.360868,262.520048,525.040096,179.100575,4,6
0,0,11,11,15,24,39,53,46,99,0.000333,0.174418,7,3662.783738,203.487985,523.25482,168.642459,3,6
0,0,12,12,17,25,42,61,50,111,0.000333,0.199516,16,9576.755743,532.041986,598.547234,185.583273,3,6
0,0,12,12,17,25,42,61,50,111,0.000333,0.199516,16,9576.755743,532.041986,598.547234,185.583273,3,6
0,0,5,5,12,20,32,28,29,57,0.000333,0.095,6,1710,95,285,129.458112,1,6
0,0,11,11,18,26,44,67,54,121,0.000333,0.220197,18,11890.64207,660.591226,660.591226,197.270083,3,6
3,0,54,57,20,59,79,232,195,427,0.000333,0.897238,30,80751.43138,4486.190632,2691.714379,433.514502,10,6
1,0,41,42,18,47,65,179,152,331,0.000333,0.664468,27,53821.90115,2990.105619,1993.403746,336.124326,6,6
1,0,28,29,17,46,63,122,109,231,0.000333,0.460251,16,22092.0266,1227.334811,1380.751662,323.570718,4,6
1,0,97,98,18,48,66,399,314,713,0.000333,1.436551,54,232721.2624,12928.95902,4309.653007,343.13685,15,6
1,0,83,84,22,69,91,457,351,808,0.000333,1.752766,55,289206.3938,16067.02188,5258.298069,519.595683,9,6
1,0,45,46,18,47,65,188,156,344,0.000333,0.690565,27,55935.75225,3107.541792,2071.694528,336.124326,7,6
3,0,38,41,19,47,66,159,132,291,0.000333,0.586306,18,31660.5364,1758.918689,1758.918689,341.776299,7,6
3,0,93,96,20,66,86,377,293,670,0.000333,1.435199,40,172223.8954,9567.99419,4305.597386,485.368574,16,6
3,0,79,82,23,77,100,435,330,765,0.000333,1.694183,44,223632.1993,12424.01108,5082.549985,586.584489,10,6
3,0,42,45,21,54,75,176,144,320,0.000333,0.664407,20,39864.43962,2214.69109,1993.221981,403.002591,9,6
0,0,60,60,24,65,89,265,225,490,0.000333,1.057703,36,114231.9377,6346.218762,3173.109381,501.493008,15,6
0,0,59,59,24,65,89,261,222,483,0.000333,1.042593,36,112600.0529,6255.558494,3127.779247,501.493008,14,6
0,0,60,60,24,66,90,266,226,492,0.000333,1.064664,36,114983.702,6387.983447,3193.991723,508.969112,15,6
0,0,59,59,24,65,89,261,222,483,0.000333,1.042593,36,112600.0529,6255.558494,3127.779247,501.493008,14,6
0,0,13,13,22,23,45,73,43,116,0.000333,0.212352,11,7007.604551,389.311364,637.054959,202.149421,10,6
0,0,12,12,22,22,44,68,39,107,0.000333,0.19472,11,6425.751015,356.986168,584.159183,196.214991,8,6
0,0,63,63,30,59,89,421,249,670,0.000333,1.446247,60,260324.4839,14462.47133,4338.741399,494.282658,17,6
0,0,49,49,27,58,85,320,204,524,0.000333,1.119507,39,130982.3132,7276.795176,3358.520851,468.14486,14,6
0,0,65,65,30,62,92,423,246,669,0.000333,1.454754,45,196391.8327,10910.65737,4364.262949,516.366889,17,6
0,0,51,51,27,61,88,322,201,523,0.000333,1.126094,39,131753.0267,7319.612596,3378.282737,490.15694,14,6
0,0,63,63,30,59,89,419,249,668,0.000333,1.44193,60,259547.3959,14419.29977,4325.789932,494.282658,17,6
0,0,49,49,27,58,85,318,204,522,0.000333,1.115234,39,130482.3807,7249.021149,3345.702069,468.14486,14,6
0,0,65,65,30,62,92,423,246,669,0.000333,1.454754,45,196391.8327,10910.65737,4364.262949,516.366889,17,6
0,0,51,51,27,61,88,322,201,523,0.000333,1.126094,39,131753.0267,7319.612596,3378.282737,490.15694,14,6
0,0,63,63,30,59,89,419,246,665,0.000333,1.435454,60,258381.7639,14354.54244,4306.362732,494.282658,17,6
0,0,49,49,27,58,85,318,201,519,0.000333,1.108825,39,129732.4819,7207.360108,3326.473896,468.14486,14,6
0,0,65,65,30,62,92,423,246,669,0.000333,1.454754,45,196391.8327,10910.65737,4364.262949,516.366889,17,6
0,0,51,51,27,61,88,322,201,523,0.000333,1.126094,39,131753.0267,7319.612596,3378.282737,490.15694,14,6
0,0,23,23,19,46,65,129,105,234,0.000333,0.469745,18,25366.21323,1409.234068,1409.234068,334.794473,10,6
0,0,21,21,19,44,63,117,97,214,0.000333,0.426379,18,23024.48227,1279.137904,1279.137904,320.925614,6,6
0,0,21,21,19,43,62,109,92,201,0.000333,0.398931,18,21542.28225,1196.793458,1196.793458,314.040007,8,6
0,0,19,19,19,40,59,97,84,181,0.000333,0.354919,18,19165.65106,1064.758392,1064.758392,293.587747,4,6
1,0,3,4,15,16,31,30,21,51,0.000333,0.084221,7,1768.648083,98.258227,252.664012,122.603359,2,6
1,0,20,21,32,47,79,149,92,241,0.000333,0.506404,16,24307.37857,1350.40992,1519.21116,421.065676,8,6
1,0,40,41,29,47,76,271,212,483,0.000333,1.005916,56,168993.9434,9388.55241,3017.748989,401.947125,28,6
1,0,41,42,29,47,76,278,216,494,0.000333,1.028825,56,172842.6667,9602.370374,3086.476192,401.947125,28,6
1,0,41,42,29,47,76,278,216,494,0.000333,1.028825,56,172842.6667,9602.370374,3086.476192,401.947125,28,6
0,0,75,75,37,106,143,494,368,862,0.000333,2.05727,54,333277.691,18515.42728,6171.809092,905.909343,32,6
0,0,72,72,35,98,133,478,347,825,0.000333,1.940203,51,296851.0085,16491.72269,5820.608009,827.76647,35,6
0,0,54,54,35,81,116,348,260,608,0.000333,1.389884,51,212652.2747,11814.01526,4169.652445,693.052756,27,6
0,0,75,75,37,103,140,470,353,823,0.000333,1.9558,54,316839.5958,17602.19977,5867.399923,881.459329,32,6
0,0,72,72,35,95,130,454,332,786,0.000333,1.83986,51,281498.6362,15638.81312,5519.581101,803.661188,35,6
0,0,54,54,33,77,110,324,245,569,0.000333,1.286198,48,185212.4965,10289.58314,3858.593677,649.00757,27,6
0,0,83,83,41,115,156,554,417,971,0.000333,2.358042,60,424447.5333,23580.41852,7074.125555,1006.890988,33,6
0,0,71,71,35,98,133,488,355,843,0.000333,1.982534,51,303327.7578,16851.5421,5947.603093,827.76647,34,6
0,0,53,53,35,81,116,358,268,626,0.000333,1.431032,51,218947.9013,12163.77229,4293.096103,693.052756,26,6
0,0,78,78,32,100,132,487,379,866,0.000333,2.033482,48,292821.3748,16267.85415,6100.445307,824.385619,32,6
0,0,68,68,32,97,129,414,314,728,0.000333,1.701391,48,245000.3252,13611.12918,5104.173442,800.191546,32,6
0,0,68,68,32,98,130,414,316,730,0.000333,1.708776,48,246063.7682,13670.20934,5126.328504,808.241565,32,6
0,0,85,85,32,108,140,529,378,907,0.000333,2.15542,48,310380.4654,17243.35919,6466.259696,889.52785,42,6
0,0,73,73,30,87,117,466,336,802,0.000333,1.836678,45,247951.4627,13775.08126,5510.032505,707.742802,43,6
0,0,66,66,30,91,121,390,292,682,0.000333,1.572888,45,212339.9128,11796.66182,4718.664728,739.41603,29,6
0,0,63,63,30,87,117,372,279,651,0.000333,1.490869,45,201267.3345,11181.51858,4472.607432,707.742802,29,6
0,0,63,63,30,86,116,371,277,648,0.000333,1.481324,45,199978.7258,11109.92921,4443.971685,699.865487,29,6
0,0,63,63,30,86,116,371,277,648,0.000333,1.481324,45,199978.7258,11109.92921,4443.971685,699.865487,29,6
0,0,63,63,30,87,117,372,279,651,0.000333,1.490869,45,201267.3345,11181.51858,4472.607432,707.742802,29,6
0,0,78,78,32,100,132,487,379,866,0.000333,2.033482,48,292821.3748,16267.85415,6100.445307,824.385619,32,6
0,0,68,68,32,97,129,414,314,728,0.000333,1.701391,48,245000.3252,13611.12918,5104.173442,800.191546,32,6
0,0,68,68,32,98,130,414,316,730,0.000333,1.708776,48,246063.7682,13670.20934,5126.328504,808.241565,32,6
0,0,85,85,32,108,140,529,378,907,0.000333,2.15542,48,310380.4654,17243.35919,6466.259696,889.52785,42,6
0,0,73,73,30,87,117,466,336,802,0.000333,1.836678,45,247951.4627,13775.08126,5510.032505,707.742802,43,6
0,0,66,66,30,91,121,390,292,682,0.000333,1.572888,45,212339.9128,11796.66182,4718.664728,739.41603,29,6
0,0,63,63,30,87,117,372,279,651,0.000333,1.490869,45,201267.3345,11181.51858,4472.607432,707.742802,29,6
0,0,63,63,30,86,116,371,277,648,0.000333,1.481324,45,199978.7258,11109.92921,4443.971685,699.865487,29,6
0,0,63,63,30,86,116,371,277,648,0.000333,1.481324,45,199978.7258,11109.92921,4443.971685,699.865487,29,6
0,0,63,63,30,87,117,372,279,651,0.000333,1.490869,45,201267.3345,11181.51858,4472.607432,707.742802,29,6
0,0,78,78,32,100,132,487,379,866,0.000333,2.033482,48,292821.3748,16267.85415,6100.445307,824.385619,32,6
0,0,68,68,32,97,129,414,314,728,0.000333,1.701391,48,245000.3252,13611.12918,5104.173442,800.191546,32,6
0,0,68,68,32,98,130,414,316,730,0.000333,1.708776,48,246063.7682,13670.20934,5126.328504,808.241565,32,6
0,0,85,85,32,108,140,529,378,907,0.000333,2.15542,48,310380.4654,17243.35919,6466.259696,889.52785,42,6
0,0,73,73,30,87,117,466,336,802,0.000333,1.836678,45,247951.4627,13775.08126,5510.032505,707.742802,43,6
0,0,66,66,30,91,121,390,292,682,0.000333,1.572888,45,212339.9128,11796.66182,4718.664728,739.41603,29,6
0,0,63,63,30,87,117,372,279,651,0.000333,1.490869,45,201267.3345,11181.51858,4472.607432,707.742802,29,6
0,0,63,63,30,86,116,371,277,648,0.000333,1.481324,45,199978.7258,11109.92921,4443.971685,699.865487,29,6
0,0,63,63,30,86,116,371,277,648,0.000333,1.481324,45,199978.7258,11109.92921,4443.971685,699.865487,29,6
0,0,63,63,30,87,117,372,279,651,0.000333,1.490869,45,201267.3345,11181.51858,4472.607432,707.742802,29,6
1,0,7,8,8,22,30,37,38,75,0.000333,0.122672,4,1472.067179,81.78151,368.016795,122.107496,1,6
1,0,33,34,25,63,88,220,162,382,0.000333,0.822501,24,59220.06908,3290.003838,2467.502878,492.66504,14,6
1,0,24,25,23,49,72,148,104,252,0.000333,0.518274,22,34206.06421,1900.3369,1554.8211,379.162707,13,6
1,0,24,25,22,49,71,144,104,248,0.000333,0.508379,22,33553.02028,1864.056682,1525.137286,373.228278,13,6
1,0,19,20,21,45,66,117,80,197,0.000333,0.396915,10,11907.45642,661.525356,1190.745642,339.372055,13,6
1,0,28,29,25,61,86,194,145,339,0.000333,0.726168,24,52284.09004,2904.671669,2178.503752,477.871382,11,6
1,0,30,31,25,64,89,214,158,372,0.000333,0.802991,24,57815.34807,3211.963782,2408.972836,500.096405,11,6
1,0,21,22,23,49,72,136,98,234,0.000333,0.481254,22,31762.77391,1764.59855,1443.76245,379.162707,10,6
1,0,24,25,22,49,71,144,104,248,0.000333,0.508379,22,33553.02028,1864.056682,1525.137286,373.228278,13,6
1,0,22,23,22,48,70,151,103,254,0.000333,0.518946,22,34250.4335,1902.801861,1556.837886,366.185696,13,6
1,0,29,30,23,52,75,169,120,289,0.000333,0.600043,22,39602.82923,2200.15718,1800.128602,400.46479,16,6
1,0,21,22,23,59,82,175,131,306,0.000333,0.64847,22,42799.0401,2377.72445,1945.410913,451.117865,7,6
1,0,17,18,20,50,70,137,103,240,0.000333,0.490343,20,29420.55848,1634.475471,1471.027924,368.631371,6,6
1,0,30,31,25,45,70,206,120,326,0.000333,0.666049,24,47955.51033,2664.195018,1998.146264,363.229794,23,6
1,0,9,10,14,35,49,80,67,147,0.000333,0.275121,7,5777.53643,320.974246,825.362347,232.827875,1,6
1,0,3,4,10,9,19,16,11,27,0.000333,0.038231,5,573.470214,31.859456,114.694043,61.748606,1,6
1,0,3,4,12,15,27,33,17,50,0.000333,0.079248,6,1426.466251,79.248125,237.744375,101.622909,1,6
1,0,40,41,29,76,105,264,189,453,0.000333,1.013851,28,85163.49015,4731.305008,3041.55322,615.72394,18,6
1,0,28,29,29,62,91,208,146,354,0.000333,0.76792,28,64505.26047,3583.625582,2303.759303,510.04162,14,6
1,0,37,38,28,66,94,228,166,394,0.000333,0.860836,28,72310.22421,4017.234678,2582.508008,533.53595,16,6
1,0,25,26,28,52,80,172,123,295,0.000333,0.621656,28,52219.12606,2901.062559,1864.968788,431.028803,12,6
1,0,37,38,28,66,94,228,166,394,0.000333,0.860836,28,72310.22421,4017.234678,2582.508008,533.53595,15,6
1,0,25,26,28,52,80,172,123,295,0.000333,0.621656,28,52219.12606,2901.062559,1864.968788,431.028803,11,6
1,0,50,51,30,83,113,301,218,519,0.000333,1.179891,30,106190.1864,5899.454802,3539.672881,676.334991,22,6
1,0,31,32,29,65,94,222,156,378,0.000333,0.825878,28,69373.76841,3854.098245,2477.634586,532.335357,16,6
1,0,36,37,28,65,93,225,164,389,0.000333,0.847911,28,71224.51777,3956.917654,2543.732778,526.059846,15,6
1,0,24,25,28,51,79,169,121,290,0.000333,0.609365,28,51186.69968,2843.705538,1828.096417,423.89963,11,6
1,0,36,37,28,65,93,225,164,389,0.000333,0.847911,28,71224.51777,3956.917654,2543.732778,526.059846,15,6
1,0,24,25,28,51,79,169,121,290,0.000333,0.609365,28,51186.69968,2843.705538,1828.096417,423.89963,11,6
0,0,19,19,23,34,57,109,86,195,0.000333,0.379138,22,25023.09816,1390.17212,1137.413553,277.015662,6,6
0,0,19,19,23,34,57,109,86,195,0.000333,0.379138,22,25023.09816,1390.17212,1137.413553,277.015662,6,6
0,0,16,16,22,32,54,90,73,163,0.000333,0.312682,22,20637.02658,1146.501477,938.046663,258.107496,8,6
0,0,20,20,23,30,53,124,85,209,0.000333,0.399045,22,26336.97825,1463.165458,1197.135375,251.248643,11,6
0,0,15,15,13,21,34,64,57,121,0.000333,0.205194,12,7386.996045,410.388669,615.583004,140.344382,5,6
0,0,14,14,15,19,34,56,42,98,0.000333,0.16619,14,6979.999018,387.777723,498.571358,139.313982,9,6
0,0,13,13,14,18,32,51,40,91,0.000333,0.151667,14,6370,353.888889,455,128.361619,5,6
0,0,15,15,16,24,40,71,61,132,0.000333,0.234165,16,11239.91214,624.439563,702.494509,174.0391,7,6
0,0,56,56,29,56,85,263,207,470,0.000333,1.004138,42,126521.3771,7028.965393,3012.41374,466.093324,27,6
0,0,18,18,16,25,41,107,91,198,0.000333,0.353598,24,25459.08713,1414.393729,1060.795297,180.096405,3,6
0,0,10,10,16,26,42,79,68,147,0.000333,0.264224,16,12682.73058,704.596143,792.670661,186.211433,3,6
0,0,10,10,16,26,42,79,68,147,0.000333,0.264224,16,12682.73058,704.596143,792.670661,186.211433,3,6
0,0,10,10,16,25,41,81,70,151,0.000333,0.269663,16,12943.84564,719.102536,808.990353,180.096405,3,6
0,0,8,8,13,25,38,69,59,128,0.000333,0.223912,12,8060.816661,447.823148,671.734722,164.202121,2,6
0,0,8,8,13,24,37,69,59,128,0.000333,0.22227,12,8001.72037,444.540021,666.810031,158.144816,2,6
0,0,8,8,13,24,37,71,61,132,0.000333,0.229216,12,8251.774131,458.431896,687.647844,158.144816,2,6
0,0,8,8,12,24,36,61,54,115,0.000333,0.19818,12,7134.496502,396.360917,594.541375,153.05865,2,6
0,0,8,8,12,24,36,81,71,152,0.000333,0.261943,12,9429.943203,523.885733,785.8286,153.05865,1,6
0,0,8,8,12,23,35,81,71,152,0.000333,0.259884,18,14033.71833,779.651019,779.651019,147.061475,1,6
0,0,8,8,12,23,35,83,73,156,0.000333,0.266723,18,14403.02671,800.168151,800.168151,147.061475,1,6
0,0,18,18,16,25,41,107,91,198,0.000333,0.353598,24,25459.08713,1414.393729,1060.795297,180.096405,3,6
0,0,10,10,16,25,41,82,70,152,0.000333,0.271449,16,13029.56648,723.864804,814.347905,180.096405,3,6
0,0,8,8,13,24,37,72,61,133,0.000333,0.230952,12,8314.287572,461.904865,692.857298,158.144816,2,6
0,0,8,8,12,24,36,61,54,115,0.000333,0.19818,12,7134.496502,396.360917,594.541375,153.05865,2,6
0,0,8,8,12,23,35,84,73,157,0.000333,0.268432,18,14495.35381,805.297434,805.297434,147.061475,1,6
0,0,9,9,14,22,36,57,44,101,0.000333,0.174054,14,7310.273952,406.126331,522.162425,151.410465,5,6
0,0,9,9,14,22,36,57,44,101,0.000333,0.174054,14,7310.273952,406.126331,522.162425,151.410465,6,6
0,0,11,11,17,28,45,67,52,119,0.000333,0.217844,8,5228.244148,290.458008,653.530518,204.092806,6,6
0,0,9,9,14,22,36,57,44,101,0.000333,0.174054,14,7310.273952,406.126331,522.162425,151.410465,5,6
0,0,9,9,14,22,36,57,44,101,0.000333,0.174054,14,7310.273952,406.126331,522.162425,151.410465,6,6
0,0,11,11,17,28,45,67,52,119,0.000333,0.217844,8,5228.244148,290.458008,653.530518,204.092806,6,6
0,0,8,8,14,21,35,47,37,84,0.000333,0.14362,7,3016.018414,167.556579,430.859773,145.541635,4,6
0,0,8,8,14,21,35,47,37,84,0.000333,0.14362,7,3016.018414,167.556579,430.859773,145.541635,5,6
0,0,10,10,17,27,44,57,45,102,0.000333,0.185621,8,4454.896201,247.494233,556.862025,197.868831,5,6
0,0,10,10,14,22,36,63,48,111,0.000333,0.191287,14,8034.063452,446.336858,573.861675,151.410465,5,6
0,0,10,10,14,22,36,63,48,111,0.000333,0.191287,14,8034.063452,446.336858,573.861675,151.410465,6,6
0,0,12,12,17,28,45,73,56,129,0.000333,0.23615,16,11335.18479,629.732488,708.449049,204.092806,6,6
0,0,7,7,14,21,35,37,30,67,0.000333,0.114554,7,2405.633735,133.646319,343.661962,145.541635,3,6
0,0,7,7,14,21,35,37,30,67,0.000333,0.114554,7,2405.633735,133.646319,343.661962,145.541635,4,6
0,0,9,9,17,27,44,47,38,85,0.000333,0.154684,8,3712.413501,206.245194,464.051688,197.868831,4,6
0,0,11,11,14,23,37,69,52,121,0.000333,0.210115,14,8824.814001,490.267445,630.343857,157.344894,5,6
0,0,11,11,14,23,37,69,52,121,0.000333,0.210115,14,8824.814001,490.267445,630.343857,157.344894,6,6
0,0,13,13,17,29,46,79,60,139,0.000333,0.255925,16,12284.40179,682.466766,767.775112,210.368317,6,6
0,0,4,4,10,17,27,26,23,49,0.000333,0.077663,5,1164.947438,64.719302,232.989488,102.706149,2,6
0,0,4,4,10,17,27,26,23,49,0.000333,0.077663,5,1164.947438,64.719302,232.989488,102.706149,2,6
0,0,7,7,13,20,33,27,23,50,0.000333,0.084073,6,1513.318236,84.073235,252.219706,134.544278,3,6
0,0,7,7,13,20,33,27,23,50,0.000333,0.084073,6,1513.318236,84.073235,252.219706,134.544278,3,6
0,0,7,7,13,20,33,27,23,50,0.000333,0.084073,6,1513.318236,84.073235,252.219706,134.544278,3,6
0,0,7,7,13,20,33,27,23,50,0.000333,0.084073,6,1513.318236,84.073235,252.219706,134.544278,3,6
0,0,6,6,11,21,32,27,26,53,0.000333,0.088333,5,1325,73.611111,265,130.292414,2,6
0,0,6,6,11,21,32,27,26,53,0.000333,0.088333,5,1325,73.611111,265,130.292414,2,6
0,0,6,6,11,21,32,27,26,53,0.000333,0.088333,5,1325,73.611111,265,130.292414,2,6
0,0,6,6,11,21,32,27,26,53,0.000333,0.088333,5,1325,73.611111,265,130.292414,2,6
0,0,6,6,11,20,31,25,23,48,0.000333,0.079267,5,1189.007114,66.055951,237.801423,124.49231,2,6
0,0,6,6,11,20,31,25,23,48,0.000333,0.079267,5,1189.007114,66.055951,237.801423,124.49231,2,6
0,0,6,6,11,18,29,23,21,44,0.000333,0.07125,5,1068.755819,59.375323,213.751164,113.112398,2,6
0,0,6,6,11,18,29,23,21,44,0.000333,0.07125,5,1068.755819,59.375323,213.751164,113.112398,2,6
0,0,6,6,11,21,32,27,24,51,0.000333,0.085,5,1275,70.833333,255,130.292414,2,6
0,0,6,6,11,21,32,27,24,51,0.000333,0.085,5,1275,70.833333,255,130.292414,2,6
0,0,6,6,11,19,30,23,22,45,0.000333,0.073603,5,1104.050384,61.336132,220.810077,118.764371,2,6
0,0,6,6,11,19,30,23,22,45,0.000333,0.073603,5,1104.050384,61.336132,220.810077,118.764371,2,6
0,0,7,7,12,20,32,23,23,46,0.000333,0.076667,6,1380,76.666667,230,129.458112,3,6
0,0,7,7,12,20,32,23,23,46,0.000333,0.076667,6,1380,76.666667,230,129.458112,3,6
0,0,6,6,12,15,27,18,17,35,0.000333,0.055474,6,998.526375,55.473688,166.421063,101.622909,2,6
0,0,6,6,11,16,27,21,19,40,0.000333,0.063399,5,950.9775,52.832083,190.1955,102.053748,2,6
0,0,6,6,11,16,27,21,19,40,0.000333,0.063399,5,950.9775,52.832083,190.1955,102.053748,2,6
0,0,8,8,13,19,32,33,24,57,0.000333,0.095,6,1710,95,285,128.816339,4,6
0,0,8,8,13,19,32,33,24,57,0.000333,0.095,6,1710,95,285,128.816339,4,6
0,0,7,7,14,17,31,30,21,51,0.000333,0.084221,7,1768.648083,98.258227,252.664012,122.789837,3,6
0,0,6,6,11,14,25,19,16,35,0.000333,0.054178,5,812.674833,45.148602,162.534967,91.356717,2,6
0,0,7,7,13,18,31,28,22,50,0.000333,0.08257,6,1486.258893,82.569939,247.709816,123.164366,3,6
0,0,7,7,13,18,31,28,22,50,0.000333,0.08257,6,1486.258893,82.569939,247.709816,123.164366,3,6
0,0,6,6,14,16,30,25,19,44,0.000333,0.071968,7,1511.322303,83.96235,215.903186,117.302969,2,6
0,0,6,6,14,16,30,24,19,43,0.000333,0.070332,7,1476.974069,82.054115,210.996296,117.302969,2,6
0,0,6,6,11,19,30,23,22,45,0.000333,0.073603,5,1104.050384,61.336132,220.810077,118.764371,2,6
0,0,6,6,11,19,30,23,22,45,0.000333,0.073603,5,1104.050384,61.336132,220.810077,118.764371,2,6
0,0,6,6,11,18,29,23,21,44,0.000333,0.07125,5,1068.755819,59.375323,213.751164,113.112398,3,6
0,0,6,6,11,18,29,23,21,44,0.000333,0.07125,5,1068.755819,59.375323,213.751164,113.112398,3,6
0,0,18,18,23,41,64,110,77,187,0.000333,0.374,11,12342,685.666667,1122,323.701557,6,6
0,0,17,17,23,41,64,106,75,181,0.000333,0.362,11,11946,663.666667,1086,323.701557,6,6
0,0,17,17,23,41,64,106,75,181,0.000333,0.362,11,11946,663.666667,1086,323.701557,6,6
0,0,18,18,23,41,64,110,77,187,0.000333,0.374,11,12342,685.666667,1122,323.701557,6,6
0,0,13,13,19,25,44,70,45,115,0.000333,0.209278,9,5650.511725,313.917318,627.834636,196.807027,5,6
0,0,13,13,19,26,45,70,45,115,0.000333,0.210521,9,5684.067955,315.781553,631.563106,202.922055,4,6
0,0,6,6,11,18,29,23,21,44,0.000333,0.07125,5,1068.755819,59.375323,213.751164,113.112398,2,6
0,0,6,6,11,18,29,23,21,44,0.000333,0.07125,5,1068.755819,59.375323,213.751164,113.112398,2,6
0,0,6,6,11,18,29,23,21,44,0.000333,0.07125,5,1068.755819,59.375323,213.751164,113.112398,2,6
0,0,6,6,11,18,29,23,21,44,0.000333,0.07125,5,1068.755819,59.375323,213.751164,113.112398,2,6
0,0,6,6,11,18,29,23,21,44,0.000333,0.07125,5,1068.755819,59.375323,213.751164,113.112398,2,6
0,0,6,6,11,18,29,23,21,44,0.000333,0.07125,5,1068.755819,59.375323,213.751164,113.112398,2,6
0,0,6,6,12,18,30,24,21,45,0.000333,0.073603,6,1324.860461,73.603359,220.810077,118.0782,2,6
0,0,6,6,12,18,30,24,21,45,0.000333,0.073603,6,1324.860461,73.603359,220.810077,118.0782,2,6
0,0,5,5,12,13,25,26,20,46,0.000333,0.071206,6,1281.704308,71.205795,213.617385,91.125266,1,6
0,0,5,5,12,13,25,26,20,46,0.000333,0.071206,6,1281.704308,71.205795,213.617385,91.125266,1,6
0,0,5,5,12,13,25,26,20,46,0.000333,0.071206,6,1281.704308,71.205795,213.617385,91.125266,1,6
0,0,8,8,18,23,41,48,39,87,0.000333,0.155369,9,4194.96322,233.053512,466.107024,179.100575,3,6
0,0,7,7,18,21,39,42,33,75,0.000333,0.132135,9,3567.646498,198.202583,396.405166,167.297316,3,6
0,0,8,8,18,23,41,48,39,87,0.000333,0.155369,9,4194.96322,233.053512,466.107024,179.100575,3,6
0,0,8,8,15,24,39,43,34,77,0.000333,0.135659,7,2848.831796,158.268433,406.975971,168.642459,2,6
0,0,8,8,15,24,39,43,34,77,0.000333,0.135659,7,2848.831796,158.268433,406.975971,168.642459,2,6
0,0,7,7,15,24,39,40,31,71,0.000333,0.125088,7,2626.844903,145.935828,375.263558,168.642459,2,6
0,0,12,12,22,22,44,68,39,107,0.000333,0.19472,11,6425.751015,356.986168,584.159183,196.214991,8,6
0,0,13,13,22,23,45,73,43,116,0.000333,0.212352,11,7007.604551,389.311364,637.054959,202.149421,10,6
0,0,63,63,30,59,89,421,249,670,0.000333,1.446247,60,260324.4839,14462.47133,4338.741399,494.282658,17,6
0,0,49,49,27,58,85,320,204,524,0.000333,1.119507,39,130982.3132,7276.795176,3358.520851,468.14486,14,6
0,0,65,65,30,62,92,423,246,669,0.000333,1.454754,45,196391.8327,10910.65737,4364.262949,516.366889,17,6
0,0,51,51,27,61,88,322,201,523,0.000333,1.126094,39,131753.0267,7319.612596,3378.282737,490.15694,14,6
0,0,63,63,30,59,89,419,249,668,0.000333,1.44193,60,259547.3959,14419.29977,4325.789932,494.282658,17,6
0,0,49,49,27,58,85,318,204,522,0.000333,1.115234,39,130482.3807,7249.021149,3345.702069,468.14486,14,6
0,0,65,65,30,62,92,423,246,669,0.000333,1.454754,45,196391.8327,10910.65737,4364.262949,516.366889,17,6
0,0,51,51,27,61,88,322,201,523,0.000333,1.126094,39,131753.0267,7319.612596,3378.282737,490.15694,14,6
0,0,63,63,30,59,89,419,246,665,0.000333,1.435454,60,258381.7639,14354.54244,4306.362732,494.282658,17,6
0,0,49,49,27,58,85,318,201,519,0.000333,1.108825,39,129732.4819,7207.360108,3326.473896,468.14486,14,6
0,0,65,65,30,62,92,423,246,669,0.000333,1.454754,45,196391.8327,10910.65737,4364.262949,516.366889,17,6
0,0,51,51,27,61,88,322,201,523,0.000333,1.126094,39,131753.0267,7319.612596,3378.282737,490.15694,14,6
0,0,18,18,18,36,54,99,79,178,0.000333,0.341457,18,18438.65956,1024.369975,1024.369975,261.17595,9,6
0,0,16,16,18,34,52,87,71,158,0.000333,0.300223,18,16212.05056,900.669475,900.669475,248.032387,5,6
0,0,21,21,19,43,62,109,92,201,0.000333,0.398931,18,21542.28225,1196.793458,1196.793458,314.040007,8,6
0,0,19,19,19,40,59,97,84,181,0.000333,0.354919,18,19165.65106,1064.758392,1064.758392,293.587747,4,6
0,0,6,6,14,11,25,34,19,53,0.000333,0.082041,7,1722.870646,95.715036,246.124378,91.356717,5,0
0,0,6,6,14,13,27,36,20,56,0.000333,0.088758,7,1863.915901,103.550883,266.2737,101.408685,4,0
0,0,9,9,15,15,30,64,35,99,0.000333,0.161927,14,6800.950366,377.830576,485.782169,117.206718,5,0
0,0,9,9,15,17,32,66,36,102,0.000333,0.17,14,7140,396.666667,510,128.090227,4,0
0,0,9,9,15,15,30,64,35,99,0.000333,0.161927,14,6800.950366,377.830576,485.782169,117.206718,5,0
0,0,9,9,15,17,32,66,36,102,0.000333,0.17,14,7140,396.666667,510,128.090227,4,0
0,0,4,4,13,21,34,149,46,195,0.000333,0.330685,12,11904.66305,661.370169,992.055254,140.344382,1,0
0,0,4,4,13,20,33,149,45,194,0.000333,0.326204,12,11743.34951,652.408306,978.612459,134.544278,1,0
0,0,28,28,24,37,61,163,102,265,0.000333,0.523882,24,37719.48947,2095.527193,1571.645394,302.788875,9,0
0,0,26,26,24,36,60,135,90,225,0.000333,0.443017,24,31897.20922,1772.067179,1329.050384,296.1564,9,0
0,0,32,32,26,57,83,162,115,277,0.000333,0.588629,26,45913.03399,2550.72411,1765.885922,454.686163,16,0
0,0,29,29,25,54,79,151,106,257,0.000333,0.540024,12,19440.85983,1080.047768,1620.071652,426.86033,16,0
0,0,40,40,30,71,101,260,193,453,0.000333,1.00539,30,90485.09405,5026.949669,3016.169802,583.838763,22,0
0,0,35,35,26,66,92,230,166,396,0.000333,0.86111,26,67166.5939,3731.477439,2583.330535,521.141445,20,0
0,0,84,84,37,91,128,546,395,941,0.000333,2.195667,72,474264,26348,6587,784.959087,46,0
0,0,87,87,34,91,125,578,441,1019,0.000333,2.366045,68,482673.1247,26815.17359,7098.134186,765.183049,57,0
0,0,71,71,34,76,110,477,346,823,0.000333,1.860353,68,379512.015,21084.00083,5581.059044,647.816228,37,0
0,0,73,73,34,79,113,481,355,836,0.000333,1.900557,68,387713.5337,21539.64076,5701.669613,670.972416,41,0
0,0,87,87,34,91,125,578,441,1019,0.000333,2.366045,68,482673.1247,26815.17359,7098.134186,765.183049,57,0
0,0,71,71,34,75,109,474,342,816,0.000333,1.840946,68,375553.0118,20864.05621,5522.838409,640.135138,37,0
0,0,73,73,34,78,112,478,351,829,0.000333,1.881099,68,383744.2117,21319.12287,5643.29723,663.23511,41,0
0,0,87,87,34,90,124,575,437,1012,0.000333,2.345882,68,478559.9733,26586.66518,7037.646666,757.240515,57,0
0,0,71,71,34,75,109,474,342,816,0.000333,1.840946,68,375553.0118,20864.05621,5522.838409,640.135138,37,0
0,0,73,73,34,78,112,478,351,829,0.000333,1.881099,68,383744.2117,21319.12287,5643.29723,663.23511,41,0
0,0,87,87,34,90,124,575,437,1012,0.000333,2.345882,68,478559.9733,26586.66518,7037.646666,757.240515,57,0
0,0,31,31,26,54,80,158,111,269,0.000333,0.566866,26,44215.5651,2456.420283,1700.598658,432.975358,16,0
0,0,28,28,25,51,76,147,102,249,0.000333,0.518578,24,37337.61482,2074.311934,1555.733951,405.390097,16,0
0,0,39,39,30,70,100,256,189,445,0.000333,0.985505,30,88695.48013,4927.526674,2956.516004,576.256529,22,0
0,0,34,34,26,65,91,226,162,388,0.000333,0.841675,26,65650.63233,3647.257352,2525.02432,513.665341,20,0
0,0,83,83,37,90,127,542,391,933,0.000333,2.173481,72,469471.8825,26081.77125,6520.442813,777.016553,46,0
0,0,86,86,34,90,124,574,437,1011,0.000333,2.343564,68,478087.0879,26560.39378,7030.69247,757.240515,57,0
0,0,70,70,34,75,109,473,342,815,0.000333,1.83869,68,375092.7753,20838.48752,5516.070225,640.135138,37,0
0,0,72,72,34,78,112,477,351,828,0.000333,1.87883,68,383281.3115,21293.4062,5636.489875,663.23511,41,0
0,0,86,86,34,90,124,574,437,1011,0.000333,2.343564,68,478087.0879,26560.39378,7030.69247,757.240515,57,0
0,0,70,70,34,74,108,470,338,808,0.000333,1.819316,68,371140.5389,20618.91883,5457.949102,632.473286,37,0
0,0,72,72,34,77,111,474,347,821,0.000333,1.859405,68,379318.649,21073.25828,5578.215426,655.5163,41,0
0,0,86,86,34,89,123,571,433,1004,0.000333,2.323428,68,473979.3503,26332.18613,6970.284563,749.314012,57,0
0,0,70,70,34,74,108,470,338,808,0.000333,1.819316,68,371140.5389,20618.91883,5457.949102,632.473286,37,0
0,0,72,72,34,77,111,474,347,821,0.000333,1.859405,68,379318.649,21073.25828,5578.215426,655.5163,41,0
0,0,86,86,34,89,123,571,433,1004,0.000333,2.323428,68,473979.3503,26332.18613,6970.284563,749.314012,57,0
0,0,12,12,24,28,52,91,50,141,0.000333,0.267921,12,9645.144003,535.841334,803.762,244.645038,9,0
0,0,12,12,23,26,49,86,47,133,0.000333,0.248919,11,8214.320502,456.351139,746.756409,226.253358,9,0
0,0,3,3,9,6,15,10,7,17,0.000333,0.022139,4,265.668561,14.759364,66.41714,44.0391,1,0
0,0,7,7,14,15,29,46,27,73,0.000333,0.118211,7,2482.428289,137.912683,354.632613,111.906328,2,0
0,0,46,46,24,65,89,393,228,621,0.000333,1.340477,36,144771.4966,8042.860921,4021.430461,501.493008,28,0
0,0,35,35,25,62,87,299,180,479,0.000333,1.028723,24,74068.07843,4114.893246,3086.169935,485.256576,24,0
0,0,60,60,30,83,113,490,294,784,0.000333,1.78234,45,240615.9138,13367.55077,5347.020307,676.334991,31,0
0,0,35,35,25,61,86,299,179,478,0.000333,1.023918,24,73722.10927,4095.672737,3071.754553,477.871382,24,0
0,0,35,35,25,61,86,298,179,477,0.000333,1.021776,24,73567.87891,4087.104384,3065.328288,477.871382,24,0
0,0,53,53,24,70,94,429,249,678,0.000333,1.481337,36,159984.4047,8888.022483,4444.011241,539.088911,31,0
0,0,35,35,25,61,86,299,179,478,0.000333,1.023918,24,73722.10927,4095.672737,3071.754553,477.871382,24,0
0,0,35,35,25,60,85,299,179,478,0.000333,1.02123,24,73528.53282,4084.91849,3063.688867,470.50984,24,0
0,0,35,35,25,61,86,298,179,477,0.000333,1.021776,24,73567.87891,4087.104384,3065.328288,477.871382,24,0
0,0,50,50,24,69,93,385,231,616,0.000333,1.342707,36,145012.3858,8056.243655,4028.121828,531.527288,34,0
0,0,47,47,26,64,90,373,219,592,0.000333,1.281059,39,149883.9043,8326.883572,3843.177033,506.211433,32,0
0,0,53,53,24,70,94,397,238,635,0.000333,1.387388,36,149837.9011,8324.327842,4162.163921,539.088911,36,0
0,0,47,47,26,64,90,373,219,592,0.000333,1.281059,39,149883.9043,8326.883572,3843.177033,506.211433,32,0
0,0,39,39,24,50,74,314,175,489,0.000333,1.012141,36,109311.217,6072.845392,3036.422696,392.23191,26,0
0,0,28,28,25,47,72,220,127,347,0.000333,0.713655,24,51383.13541,2854.618634,2140.963976,377.162081,22,0
0,0,53,53,31,72,103,411,241,652,0.000333,1.453199,45,196181.9255,10898.99586,4359.598344,597.814686,29,0
0,0,28,28,25,46,71,220,126,346,0.000333,0.709271,24,51067.50008,2837.083338,2127.812503,370.180255,22,0
0,0,28,28,25,46,71,219,126,345,0.000333,0.707221,24,50919.90615,2828.883675,2121.662756,370.180255,22,0
0,0,46,46,24,55,79,350,196,546,0.000333,1.147288,36,123907.1144,6883.728577,3441.864289,428.013884,29,0
0,0,28,28,25,46,71,220,126,346,0.000333,0.709271,24,51067.50008,2837.083338,2127.812503,370.180255,22,0
0,0,28,28,25,45,70,220,126,346,0.000333,0.706911,24,50897.56617,2827.642565,2120.731924,363.229794,22,0
0,0,28,28,25,46,71,219,126,345,0.000333,0.707221,24,50919.90615,2828.883675,2121.662756,370.180255,22,0
0,0,43,43,24,54,78,306,178,484,0.000333,1.014045,36,109516.8483,6084.269348,3042.134674,420.803025,32,0
0,0,40,40,26,49,75,294,166,460,0.000333,0.955086,39,111745.0073,6208.055962,2865.256598,397.332215,30,0
0,0,46,46,24,55,79,318,185,503,0.000333,1.056934,36,114148.8618,6341.603433,3170.801716,428.013884,34,0
0,0,40,40,26,49,75,294,166,460,0.000333,0.955086,39,111745.0073,6208.055962,2865.256598,397.332215,30,0
0,0,44,44,26,46,72,262,186,448,0.000333,0.921375,52,143734.5728,7985.254046,2764.126401,376.295283,34,0
0,0,42,42,26,46,72,252,178,430,0.000333,0.884356,39,103469.6423,5748.31346,2653.067751,376.295283,33,0
0,0,43,43,26,47,73,263,186,449,0.000333,0.92641,39,108390.0179,6021.667658,2779.231227,383.277109,33,0
0,0,43,43,26,47,73,267,188,455,0.000333,0.93879,52,146451.2491,8136.180504,2816.370174,383.277109,34,0
0,0,64,64,35,78,113,508,349,857,0.000333,1.948298,68,397452.7492,22080.70829,5844.893371,669.786279,24,0
0,0,46,46,24,65,89,393,228,621,0.000333,1.340477,36,144771.4966,8042.860921,4021.430461,501.493008,28,0
0,0,35,35,25,61,86,298,179,477,0.000333,1.021776,24,73567.87891,4087.104384,3065.328288,477.871382,24,0
0,0,35,35,25,61,86,299,179,478,0.000333,1.023918,24,73722.10927,4095.672737,3071.754553,477.871382,24,0
0,0,35,35,25,60,85,299,179,478,0.000333,1.02123,24,73528.53282,4084.91849,3063.688867,470.50984,24,0
0,0,35,35,25,62,87,299,180,479,0.000333,1.028723,24,74068.07843,4114.893246,3086.169935,485.256576,24,0
0,0,35,35,25,61,86,298,179,477,0.000333,1.021776,24,73567.87891,4087.104384,3065.328288,477.871382,24,0
0,0,35,35,25,61,86,299,179,478,0.000333,1.023918,24,73722.10927,4095.672737,3071.754553,477.871382,24,0
0,0,42,42,25,65,90,335,200,535,0.000333,1.157714,36,125033.0906,6946.282813,3473.141407,507.550313,27,0
0,0,50,50,24,69,93,385,231,616,0.000333,1.342707,36,145012.3858,8056.243655,4028.121828,531.527288,34,0
0,0,47,47,26,64,90,373,219,592,0.000333,1.281059,39,149883.9043,8326.883572,3843.177033,506.211433,32,0
0,0,53,53,24,70,94,397,238,635,0.000333,1.387388,36,149837.9011,8324.327842,4162.163921,539.088911,36,0
0,0,47,47,26,64,90,373,219,592,0.000333,1.281059,39,149883.9043,8326.883572,3843.177033,506.211433,32,0
0,0,39,39,24,50,74,314,175,489,0.000333,1.012141,36,109311.217,6072.845392,3036.422696,392.23191,26,0
0,0,28,28,25,46,71,219,126,345,0.000333,0.707221,24,50919.90615,2828.883675,2121.662756,370.180255,22,0
0,0,28,28,25,46,71,220,126,346,0.000333,0.709271,24,51067.50008,2837.083338,2127.812503,370.180255,22,0
0,0,28,28,25,45,70,220,126,346,0.000333,0.706911,24,50897.56617,2827.642565,2120.731924,363.229794,22,0
0,0,64,64,30,76,106,505,290,795,0.000333,1.782899,45,240691.3543,13371.7419,5348.696761,622.049209,33,0
0,0,28,28,25,47,72,220,127,347,0.000333,0.713655,24,51383.13541,2854.618634,2140.963976,377.162081,22,0
0,0,28,28,25,46,71,219,126,345,0.000333,0.707221,24,50919.90615,2828.883675,2121.662756,370.180255,22,0
0,0,28,28,25,46,71,220,126,346,0.000333,0.709271,24,51067.50008,2837.083338,2127.812503,370.180255,22,0
0,0,35,35,25,50,75,256,147,403,0.000333,0.836738,24,60245.13437,3346.95191,2510.213932,398.289214,25,0
0,0,43,43,24,54,78,306,178,484,0.000333,1.014045,36,109516.8483,6084.269348,3042.134674,420.803025,32,0
0,0,40,40,26,49,75,294,166,460,0.000333,0.955086,39,111745.0073,6208.055962,2865.256598,397.332215,30,0
0,0,46,46,24,55,79,318,185,503,0.000333,1.056934,36,114148.8618,6341.603433,3170.801716,428.013884,34,0
0,0,40,40,26,49,75,294,166,460,0.000333,0.955086,39,111745.0073,6208.055962,2865.256598,397.332215,30,0
0,0,50,50,21,52,73,295,170,465,0.000333,0.959423,30,86348.0526,4797.114033,2878.26842,388.661531,9,0
0,0,17,17,19,21,40,92,52,144,0.000333,0.255453,18,13794.43762,766.357646,766.357646,172.949289,5,0
0,0,14,14,21,27,48,103,58,161,0.000333,0.299726,20,17983.57925,999.087736,899.178963,220.620628,10,0
0,0,19,19,16,43,59,165,95,260,0.000333,0.509829,16,24471.79509,1359.544171,1529.487193,297.329384,4,0
0,0,13,13,16,32,48,127,70,197,0.000333,0.366746,16,17603.8018,977.988989,1100.237613,224,3,0
0,0,66,66,36,65,101,447,313,760,0.000333,1.686747,72,364337.3323,20240.96291,5060.240727,577.571208,51,0
0,0,67,67,37,71,108,454,327,781,0.000333,1.758522,72,379840.834,21102.26856,5275.567139,629.38182,50,0
0,0,66,66,36,65,101,442,309,751,0.000333,1.666772,72,360022.8113,20001.26729,5000.316824,577.571208,50,0
0,0,31,31,31,46,77,193,131,324,0.000333,0.676813,30,60913.16518,3384.064732,2030.438839,407.663936,13,0
0,0,24,24,25,40,65,125,89,214,0.000333,0.429596,24,30930.88109,1718.382283,1288.786712,328.973529,16,0
0,0,25,25,29,42,71,146,105,251,0.000333,0.514529,28,43220.42276,2401.134598,1543.586527,367.358781,11,0
0,0,21,21,26,45,71,127,100,227,0.000333,0.465331,26,36295.8075,2016.43375,1395.992596,369.344822,25,0
0,0,37,37,28,53,81,215,152,367,0.000333,0.775575,28,65148.29863,3619.349924,2326.724951,438.185722,29,0
0,0,31,31,26,38,64,229,159,388,0.000333,0.776,52,121056,6725.333333,2328,321.632678,31,0
0,0,71,71,29,47,76,349,269,618,0.000333,1.287073,70,270285.3442,15015.85246,3861.219203,401.947125,24,0
0,0,36,36,27,46,73,190,146,336,0.000333,0.69326,39,81111.46102,4506.192279,2079.781052,382.465813,19,0
0,0,29,29,31,46,77,183,123,306,0.000333,0.639212,30,57529.10044,3196.061136,1917.636681,407.663936,12,0
0,0,22,22,25,39,64,115,81,196,0.000333,0.392,24,28224,1568,1176,322.227091,15,0
0,0,23,23,29,42,71,136,97,233,0.000333,0.47763,28,40120.95021,2228.941678,1432.891079,367.358781,10,0
0,0,19,19,26,44,70,117,92,209,0.000333,0.427007,26,33306.52391,1850.36244,1281.020151,362.426424,24,0
0,0,35,35,28,53,81,205,144,349,0.000333,0.737536,28,61953.01423,3441.834124,2212.607651,438.185722,28,0
0,0,29,29,26,37,63,219,151,370,0.000333,0.737198,52,115002.8657,6389.048096,2211.593572,314.961207,30,0
0,0,69,69,29,47,76,339,261,600,0.000333,1.249586,70,262412.9556,14578.49753,3748.756508,401.947125,23,0
0,0,34,34,27,46,73,180,138,318,0.000333,0.656121,39,76766.20418,4264.789121,1968.36421,382.465813,18,0
0,0,30,30,31,47,78,194,131,325,0.000333,0.680919,30,61282.67163,3404.592869,2042.755721,414.645762,12,0
0,0,23,23,25,40,65,126,89,215,0.000333,0.431603,24,31075.41792,1726.412106,1294.80908,328.973529,15,0
0,0,24,24,29,43,72,147,105,252,0.000333,0.518274,28,43534.99081,2418.610601,1554.8211,374.210833,10,0
0,0,20,20,26,45,71,128,100,228,0.000333,0.467381,26,36455.70092,2025.316718,1402.142343,369.344822,24,0
0,0,36,36,28,54,82,216,152,368,0.000333,0.77986,28,65508.21586,3639.345325,2339.579138,445.369863,28,0
0,0,30,30,26,38,64,230,159,389,0.000333,0.778,52,121368,6742.666667,2334,321.632678,30,0
0,0,70,70,29,48,77,350,269,619,0.000333,1.293047,70,271539.8608,15085.54782,3879.140869,408.959649,23,0
0,0,35,35,27,47,74,191,146,337,0.000333,0.697529,39,81610.84558,4533.935866,2092.585784,389.447639,18,0
0,0,30,30,31,47,78,198,133,331,0.000333,0.693489,30,62414.04403,3467.446891,2080.468134,414.645762,13,0
0,0,23,23,25,40,65,130,91,221,0.000333,0.443648,24,31942.63888,1774.591049,1330.943287,328.973529,16,0
0,0,24,24,29,43,72,151,107,258,0.000333,0.530614,28,44571.53821,2476.196567,1591.84065,374.210833,11,0
0,0,20,20,26,45,71,132,102,234,0.000333,0.47968,26,37415.06148,2078.614526,1439.040826,369.344822,25,0
0,0,36,36,28,54,82,220,154,374,0.000333,0.792575,28,66576.28459,3698.682477,2377.72445,445.369863,29,0
0,0,30,30,26,38,64,234,161,395,0.000333,0.79,52,123240,6846.666667,2370,321.632678,31,0
0,0,70,70,29,48,77,354,271,625,0.000333,1.305581,70,274171.9112,15231.77284,3916.741588,408.959649,24,0
0,0,35,35,27,47,74,195,148,343,0.000333,0.709948,39,83063.85767,4614.65876,2129.842504,389.447639,19,0
0,0,80,80,35,81,116,591,381,972,0.000333,2.221986,68,453285.1119,25182.50621,6665.957527,693.052756,34,0
0,0,11,11,18,20,38,68,45,113,0.000333,0.197672,18,10674.28456,593.015809,593.015809,161.497212,5,0
0,0,16,16,18,37,55,103,63,166,0.000333,0.319902,9,8637.351412,479.852856,959.705712,267.808425,13,0
0,0,54,54,30,47,77,304,177,481,0.000333,1.004775,45,135644.5947,7535.810815,3014.324326,408.272394,21,0
0,0,48,48,30,42,72,277,155,432,0.000333,0.888469,45,119943.342,6663.519002,2665.407601,373.68405,19,0
0,0,52,52,30,44,74,271,160,431,0.000333,0.892091,45,120432.348,6690.686001,2676.274401,387.421709,21,0
0,0,46,46,30,39,69,222,130,352,0.000333,0.716734,45,96759.0274,5375.501522,2150.200609,353.337404,19,0
0,0,28,28,25,52,77,134,98,232,0.000333,0.484631,12,17446.73373,969.262985,1453.894477,412.51927,16,0
0,0,31,31,26,55,81,145,107,252,0.000333,0.532547,13,20769.34861,1153.852701,1597.642201,440.186217,16,0
0,0,40,40,30,71,101,260,193,453,0.000333,1.00539,30,90485.09405,5026.949669,3016.169802,583.838763,22,0
0,0,35,35,26,66,92,230,166,396,0.000333,0.86111,26,67166.5939,3731.477439,2583.330535,521.141445,20,0
0,0,84,84,37,90,127,543,391,934,0.000333,2.17581,72,469975.0678,26109.72599,6527.431497,777.016553,46,0
0,0,87,87,34,90,124,575,437,1012,0.000333,2.345882,68,478559.9733,26586.66518,7037.646666,757.240515,57,0
0,0,71,71,34,75,109,474,342,816,0.000333,1.840946,68,375553.0118,20864.05621,5522.838409,640.135138,37,0
0,0,73,73,34,78,112,478,351,829,0.000333,1.881099,68,383744.2117,21319.12287,5643.29723,663.23511,41,0
0,0,87,87,34,90,124,575,437,1012,0.000333,2.345882,68,478559.9733,26586.66518,7037.646666,757.240515,57,0
0,0,71,71,34,76,110,477,346,823,0.000333,1.860353,68,379512.015,21084.00083,5581.059044,647.816228,37,0
0,0,73,73,34,79,113,481,355,836,0.000333,1.900557,68,387713.5337,21539.64076,5701.669613,670.972416,41,0
0,0,87,87,34,91,125,578,441,1019,0.000333,2.366045,68,482673.1247,26815.17359,7098.134186,765.183049,57,0
0,0,71,71,34,76,110,477,346,823,0.000333,1.860353,68,379512.015,21084.00083,5581.059044,647.816228,37,0
0,0,73,73,34,79,113,481,355,836,0.000333,1.900557,68,387713.5337,21539.64076,5701.669613,670.972416,41,0
0,0,87,87,34,91,125,578,441,1019,0.000333,2.366045,68,482673.1247,26815.17359,7098.134186,765.183049,57,0
0,0,27,27,25,49,74,130,94,224,0.000333,0.463639,12,16691.01065,927.278369,1390.917554,391.217187,16,0
0,0,30,30,26,52,78,141,103,244,0.000333,0.511213,13,19937.29584,1107.627547,1533.638141,418.634298,16,0
0,0,39,39,30,70,100,256,189,445,0.000333,0.985505,30,88695.48013,4927.526674,2956.516004,576.256529,22,0
0,0,34,34,26,65,91,226,162,388,0.000333,0.841675,26,65650.63233,3647.257352,2525.02432,513.665341,20,0
0,0,83,83,37,89,126,539,387,926,0.000333,2.153654,72,465189.2071,25843.84484,6460.961209,769.09005,46,0
0,0,86,86,34,89,123,571,433,1004,0.000333,2.323428,68,473979.3503,26332.18613,6970.284563,749.314012,57,0
0,0,70,70,34,74,108,470,338,808,0.000333,1.819316,68,371140.5389,20618.91883,5457.949102,632.473286,37,0
0,0,72,72,34,77,111,474,347,821,0.000333,1.859405,68,379318.649,21073.25828,5578.215426,655.5163,41,0
0,0,86,86,34,89,123,571,433,1004,0.000333,2.323428,68,473979.3503,26332.18613,6970.284563,749.314012,57,0
0,0,70,70,34,75,109,473,342,815,0.000333,1.83869,68,375092.7753,20838.48752,5516.070225,640.135138,37,0
0,0,72,72,34,78,112,477,351,828,0.000333,1.87883,68,383281.3115,21293.4062,5636.489875,663.23511,41,0
0,0,86,86,34,90,124,574,437,1011,0.000333,2.343564,68,478087.0879,26560.39378,7030.69247,757.240515,57,0
0,0,70,70,34,75,109,473,342,815,0.000333,1.83869,68,375092.7753,20838.48752,5516.070225,640.135138,37,0
0,0,72,72,34,78,112,477,351,828,0.000333,1.87883,68,383281.3115,21293.4062,5636.489875,663.23511,41,0
0,0,86,86,34,90,124,574,437,1011,0.000333,2.343564,68,478087.0879,26560.39378,7030.69247,757.240515,57,0
0,0,12,12,24,28,52,91,50,141,0.000333,0.267921,12,9645.144003,535.841334,803.762,244.645038,9,0
0,0,12,12,23,26,49,86,47,133,0.000333,0.248919,11,8214.320502,456.351139,746.756409,226.253358,9,0
0,0,3,3,9,6,15,10,7,17,0.000333,0.022139,4,265.668561,14.759364,66.41714,44.0391,1,0
0,0,7,7,14,15,29,46,27,73,0.000333,0.118211,7,2482.428289,137.912683,354.632613,111.906328,2,0
0,0,18,18,19,34,53,96,63,159,0.000333,0.30358,9,8196.65417,455.369676,910.739352,253.684359,10,0
0,0,36,36,26,49,75,213,130,343,0.000333,0.712162,26,55548.60508,3086.033616,2136.484811,397.332215,15,0
0,0,58,58,30,99,129,625,347,972,0.000333,2.271638,45,306671.0802,17037.28223,6814.912892,803.513023,11,0
0,0,54,54,30,99,129,609,330,939,0.000333,2.194514,45,296259.4077,16458.85598,6583.542393,803.513023,11,0
0,0,70,70,28,109,137,610,364,974,0.000333,2.304494,42,290366.2965,16131.46091,6913.483249,872.338029,21,0
0,0,69,69,28,108,136,609,362,971,0.000333,2.293975,42,289040.9096,16057.82831,6881.926419,864.133788,21,0
0,0,72,72,27,110,137,603,377,980,0.000333,2.31869,39,271286.7862,15071.48812,6956.071441,874.331531,24,0
0,0,71,71,27,109,136,602,375,977,0.000333,2.30815,39,270053.5966,15002.97759,6924.451196,866.114054,24,0
0,0,32,32,23,72,95,442,197,639,0.000333,1.399379,22,92359.03014,5131.05723,4198.137734,548.276525,3,0
0,0,31,31,23,71,94,441,195,636,0.000333,1.389573,22,91711.80721,5095.100401,4168.71851,540.67397,3,0
0,0,29,29,23,68,91,432,187,619,0.000333,1.342775,22,88623.14741,4923.508189,4028.324882,517.989398,3,0
0,0,18,18,14,45,59,171,94,265,0.000333,0.519633,14,21824.60571,1212.478095,1558.900408,300.436358,2,0
0,0,41,41,16,44,60,286,183,469,0.000333,0.923444,32,88650.61406,4925.034114,2770.331689,304.214991,4,0
0,0,35,35,14,42,56,270,170,440,0.000333,0.851745,28,71546.61264,3974.811813,2555.236166,279.780301,1,0
0,0,34,34,16,42,58,259,163,422,0.000333,0.824023,24,59329.63152,3296.09064,2472.06798,290.477332,2,0
0,0,34,34,16,42,58,252,161,413,0.000333,0.806449,24,58064.30762,3225.794868,2419.346151,290.477332,2,0
0,0,36,36,16,42,58,274,172,446,0.000333,0.870887,32,83605.10476,4644.728042,2612.659524,290.477332,2,0
0,0,35,35,16,42,58,263,165,428,0.000333,0.835739,24,60173.18078,3342.954488,2507.215866,290.477332,3,0
0,0,35,35,16,42,58,257,164,421,0.000333,0.82207,24,59189.03998,3288.279999,2466.209999,290.477332,3,0
0,0,37,37,16,42,58,278,174,452,0.000333,0.882602,32,84729.83711,4707.213173,2647.80741,290.477332,3,0
0,0,36,36,16,42,58,267,167,434,0.000333,0.847455,24,61016.73005,3389.818336,2542.363752,290.477332,4,0
0,0,36,36,16,42,58,261,166,427,0.000333,0.833786,24,60032.58924,3335.143847,2501.357885,290.477332,4,0
0,0,38,38,16,42,58,282,176,458,0.000333,0.894318,32,85854.56947,4769.698304,2682.955296,290.477332,4,0
0,0,18,18,14,34,48,127,82,209,0.000333,0.389086,14,16341.60028,907.866682,1167.257163,226.276706,1,0
0,0,17,17,14,34,48,126,80,206,0.000333,0.383501,14,16107.03185,894.835103,1150.502275,226.276706,1,0
0,0,18,18,14,31,45,116,78,194,0.000333,0.35514,14,14915.87301,828.659612,1065.419501,206.883055,1,0
0,0,17,17,14,31,45,115,76,191,0.000333,0.349648,14,14685.21518,815.845288,1048.943941,206.883055,1,0
0,0,19,19,14,36,50,127,82,209,0.000333,0.393189,14,16513.92321,917.440178,1179.565944,239.420269,4,0
0,0,18,18,14,36,50,126,80,206,0.000333,0.387545,14,16276.88125,904.271181,1162.634375,239.420269,4,0
0,0,4,4,9,17,26,25,20,45,0.000333,0.070507,4,846.079149,47.004397,211.519787,98.016193,1,0
0,0,14,14,19,25,44,80,54,134,0.000333,0.243855,18,13168.14906,731.563837,731.563837,196.807027,6,0
0,0,8,8,12,14,26,26,22,48,0.000333,0.075207,6,1353.726639,75.207035,225.621106,96.322519,2,0
0,0,8,8,12,14,26,26,22,48,0.000333,0.075207,6,1353.726639,75.207035,225.621106,96.322519,2,0
0,0,13,13,23,27,50,110,70,180,0.000333,0.338631,22,22349.67051,1241.648362,1015.894114,232.423888,8,0
0,0,15,15,23,27,50,113,74,187,0.000333,0.3518,22,23218.82437,1289.934687,1055.401107,232.423888,9,0
0,0,14,14,23,27,50,126,78,204,0.000333,0.383782,22,25329.62658,1407.201477,1151.346663,232.423888,8,0
0,0,16,16,23,27,50,129,82,211,0.000333,0.396951,33,39298.17065,2183.231703,1190.853656,232.423888,9,0
0,0,20,20,22,46,68,171,103,274,0.000333,0.555988,22,36695.22601,2038.623667,1667.964819,352.191346,16,0
0,0,20,20,23,44,67,169,99,268,0.000333,0.541904,22,35765.66187,1986.981215,1625.711903,344.256916,16,0
0,0,14,14,22,42,64,149,90,239,0.000333,0.478,22,31548,1752.666667,1434,324.584827,15,0
0,0,16,16,20,30,50,112,65,177,0.000333,0.332988,20,19979.25091,1109.958384,998.962546,233.64528,12,0
0,0,14,14,19,27,46,100,60,160,0.000333,0.29459,18,15907.85843,883.769913,883.769913,209.092585,10,0
0,0,12,12,19,25,44,96,60,156,0.000333,0.28389,18,15330.08399,851.671333,851.671333,196.807027,8,0
0,0,26,26,24,44,68,132,89,221,0.000333,0.448443,24,32287.90291,1793.772384,1345.329288,350.254091,11,0
0,0,4,4,12,18,30,32,24,56,0.000333,0.091595,6,1648.71524,91.595291,274.785873,118.0782,2,0
0,0,58,58,30,99,129,625,347,972,0.000333,2.271638,45,306671.0802,17037.28223,6814.912892,803.513023,11,0
0,0,54,54,30,99,129,609,330,939,0.000333,2.194514,45,296259.4077,16458.85598,6583.542393,803.513023,11,0
0,0,70,70,28,109,137,610,364,974,0.000333,2.304494,42,290366.2965,16131.46091,6913.483249,872.338029,21,0
0,0,69,69,28,108,136,609,362,971,0.000333,2.293975,42,289040.9096,16057.82831,6881.926419,864.133788,21,0
0,0,72,72,27,110,137,603,377,980,0.000333,2.31869,39,271286.7862,15071.48812,6956.071441,874.331531,24,0
0,0,71,71,27,109,136,602,375,977,0.000333,2.30815,39,270053.5966,15002.97759,6924.451196,866.114054,24,0
0,0,32,32,23,72,95,442,197,639,0.000333,1.399379,22,92359.03014,5131.05723,4198.137734,548.276525,3,0
0,0,31,31,23,71,94,441,195,636,0.000333,1.389573,22,91711.80721,5095.100401,4168.71851,540.67397,3,0
0,0,29,29,23,68,91,432,187,619,0.000333,1.342775,22,88623.14741,4923.508189,4028.324882,517.989398,3,0
0,0,18,18,14,45,59,171,94,265,0.000333,0.519633,14,21824.60571,1212.478095,1558.900408,300.436358,2,0
0,0,41,41,16,44,60,286,183,469,0.000333,0.923444,32,88650.61406,4925.034114,2770.331689,304.214991,4,0
0,0,35,35,14,42,56,270,170,440,0.000333,0.851745,28,71546.61264,3974.811813,2555.236166,279.780301,1,0
0,0,34,34,16,42,58,259,163,422,0.000333,0.824023,24,59329.63152,3296.09064,2472.06798,290.477332,2,0
0,0,34,34,16,42,58,252,161,413,0.000333,0.806449,24,58064.30762,3225.794868,2419.346151,290.477332,2,0
0,0,36,36,16,42,58,274,172,446,0.000333,0.870887,32,83605.10476,4644.728042,2612.659524,290.477332,2,0
0,0,35,35,16,42,58,263,165,428,0.000333,0.835739,24,60173.18078,3342.954488,2507.215866,290.477332,3,0
0,0,35,35,16,42,58,257,164,421,0.000333,0.82207,24,59189.03998,3288.279999,2466.209999,290.477332,3,0
0,0,37,37,16,42,58,278,174,452,0.000333,0.882602,32,84729.83711,4707.213173,2647.80741,290.477332,3,0
0,0,36,36,16,42,58,267,167,434,0.000333,0.847455,24,61016.73005,3389.818336,2542.363752,290.477332,4,0
0,0,36,36,16,42,58,261,166,427,0.000333,0.833786,24,60032.58924,3335.143847,2501.357885,290.477332,4,0
0,0,38,38,16,42,58,282,176,458,0.000333,0.894318,32,85854.56947,4769.698304,2682.955296,290.477332,4,0
0,0,18,18,14,34,48,127,82,209,0.000333,0.389086,14,16341.60028,907.866682,1167.257163,226.276706,1,0
0,0,17,17,14,34,48,126,80,206,0.000333,0.383501,14,16107.03185,894.835103,1150.502275,226.276706,1,0
0,0,18,18,14,31,45,116,78,194,0.000333,0.35514,14,14915.87301,828.659612,1065.419501,206.883055,1,0
0,0,17,17,14,31,45,115,76,191,0.000333,0.349648,14,14685.21518,815.845288,1048.943941,206.883055,1,0
0,0,19,19,14,36,50,127,82,209,0.000333,0.393189,14,16513.92321,917.440178,1179.565944,239.420269,4,0
0,0,18,18,14,36,50,126,80,206,0.000333,0.387545,14,16276.88125,904.271181,1162.634375,239.420269,4,0
0,0,10,10,13,20,33,56,40,96,0.000333,0.161421,12,5811.142026,322.841224,484.261835,134.544278,8,0
0,0,12,12,14,21,35,55,45,100,0.000333,0.170976,14,7180.996224,398.944235,512.928302,145.541635,8,0
0,0,8,8,13,17,30,40,32,72,0.000333,0.117765,6,2119.776737,117.765374,353.296123,117.592585,7,0
0,0,7,7,13,17,30,36,29,65,0.000333,0.106316,6,1913.687332,106.315963,318.947889,117.592585,6,0
0,0,6,6,14,17,31,33,26,59,0.000333,0.097433,7,2046.083076,113.671282,292.297582,122.789837,5,0
0,0,6,6,12,16,28,30,23,53,0.000333,0.08493,6,1528.738865,84.929937,254.789811,107.01955,4,0
0,0,6,6,13,16,29,31,23,54,0.000333,0.087444,6,1573.985842,87.443658,262.330974,112.105716,4,0
0,0,29,29,22,39,61,146,90,236,0.000333,0.466551,22,30792.38826,1710.688236,1399.654012,304.238182,14,0
0,0,18,18,17,28,45,88,56,144,0.000333,0.263609,16,12653.22953,702.957196,790.826846,204.092806,10,0
0,0,19,19,18,31,49,89,61,150,0.000333,0.280735,9,7579.85829,421.103238,842.206477,228.638736,14,0
0,0,31,31,31,45,76,196,134,330,0.000333,0.687272,30,61854.48238,3436.360132,2061.816079,400.713475,13,0
0,0,21,21,26,45,71,127,100,227,0.000333,0.465331,26,36295.8075,2016.43375,1395.992596,369.344822,25,0
0,0,25,25,29,42,71,146,105,251,0.000333,0.514529,28,43220.42276,2401.134598,1543.586527,367.358781,11,0
0,0,24,24,25,40,65,125,89,214,0.000333,0.429596,24,30930.88109,1718.382283,1288.786712,328.973529,16,0
0,0,39,39,28,61,89,223,170,393,0.000333,0.848321,28,71258.97067,3958.831704,2544.963238,496.380915,39,0
0,0,36,36,31,51,82,214,156,370,0.000333,0.784098,45,105853.2409,5880.735604,2352.294242,442.873778,23,0
0,0,29,29,31,45,76,186,126,312,0.000333,0.649784,30,58480.60153,3248.922307,1949.353384,400.713475,12,0
0,0,19,19,26,44,70,117,92,209,0.000333,0.427007,26,33306.52391,1850.36244,1281.020151,362.426424,24,0
0,0,23,23,29,42,71,136,97,233,0.000333,0.47763,28,40120.95021,2228.941678,1432.891079,367.358781,10,0
0,0,22,22,25,39,64,115,81,196,0.000333,0.392,24,28224,1568,1176,322.227091,15,0
0,0,37,37,28,61,89,213,162,375,0.000333,0.809467,28,67995.20103,3777.511168,2428.400037,496.380915,38,0
0,0,34,34,31,51,82,204,148,352,0.000333,0.745953,30,67135.74917,3729.763843,2237.858306,442.873778,22,0
0,0,30,30,31,46,77,197,134,331,0.000333,0.691435,30,62229.19035,3457.177242,2074.306345,407.663936,12,0
0,0,20,20,26,45,71,128,100,228,0.000333,0.467381,26,36455.70092,2025.316718,1402.142343,369.344822,24,0
0,0,24,24,29,43,72,147,105,252,0.000333,0.518274,28,43534.99081,2418.610601,1554.8211,374.210833,10,0
0,0,23,23,25,40,65,126,89,215,0.000333,0.431603,24,31075.41792,1726.412106,1294.80908,328.973529,15,0
0,0,38,38,28,62,90,224,170,394,0.000333,0.852597,28,71618.12336,3978.784631,2557.79012,503.766109,38,0
0,0,35,35,31,52,83,215,156,371,0.000333,0.78838,45,106431.2833,5912.849073,2365.139629,450.002951,22,0
0,0,30,30,31,46,77,201,136,337,0.000333,0.703969,30,63357.21193,3519.845107,2111.907064,407.663936,13,0
0,0,20,20,26,45,71,132,102,234,0.000333,0.47968,26,37415.06148,2078.614526,1439.040826,369.344822,25,0
0,0,24,24,29,43,72,151,107,258,0.000333,0.530614,28,44571.53821,2476.196567,1591.84065,374.210833,11,0
0,0,23,23,25,40,65,130,91,221,0.000333,0.443648,24,31942.63888,1774.591049,1330.943287,328.973529,16,0
0,0,38,38,28,62,90,228,172,400,0.000333,0.86558,28,72708.75468,4039.37526,2596.741239,503.766109,39,0
0,0,35,35,31,52,83,219,158,377,0.000333,0.80113,45,108152.544,6008.474664,2403.389866,450.002951,23,0
0,0,79,79,35,86,121,576,397,973,0.000333,2.244018,68,457779.6672,25432.20374,6732.05393,732.183674,29,0
0,0,11,11,18,20,38,68,45,113,0.000333,0.197672,18,10674.28456,593.015809,593.015809,161.497212,5,0
0,0,55,55,31,52,83,379,223,602,0.000333,1.279258,60,230266.4243,12792.57913,3837.773738,450.002951,21,0
0,0,53,53,31,49,80,346,206,552,0.000333,1.163235,60,209382.2585,11632.3477,3489.704308,428.700868,21,0
0,0,47,47,31,44,75,297,176,473,0.000333,0.982077,60,176773.8744,9820.770802,2946.231241,393.795077,19,0
0,0,42,42,27,56,83,227,163,390,0.000333,0.828755,26,64642.89983,3591.272213,2486.265378,453.593838,30,0
0,0,40,40,27,56,83,217,155,372,0.000333,0.790505,26,61659.38138,3425.521188,2371.514668,453.593838,29,0
0,0,41,41,27,57,84,228,163,391,0.000333,0.833132,26,64984.29892,3610.238829,2499.396112,460.856693,29,0
0,0,41,41,27,57,84,232,165,397,0.000333,0.845917,26,65981.50044,3665.638913,2537.750017,460.856693,30,0
0,0,63,63,34,77,111,504,346,850,0.000333,1.925084,68,392717.2371,21817.62428,5775.253486,655.5163,24,0
0,0,11,11,18,20,38,68,45,113,0.000333,0.197672,18,10674.28456,593.015809,593.015809,161.497212,5,0
0,0,25,25,20,35,55,155,93,248,0.000333,0.477926,20,28675.54418,1593.085788,1433.777209,265.963467,5,0
0,0,24,24,19,36,55,153,92,245,0.000333,0.472144,18,25495.79634,1416.43313,1416.43313,266.827923,5,0
0,0,35,35,21,41,62,238,138,376,0.000333,0.746259,30,67163.33438,3731.296355,2238.777813,311.898298,10,0
0,0,36,36,21,42,63,239,141,380,0.000333,0.757122,30,68140.99113,3785.610618,2271.366371,318.715998,10,0
0,0,47,47,21,41,62,324,187,511,0.000333,1.014198,40,121703.7726,6761.320699,3042.594315,311.898298,15,0
0,0,48,48,21,42,63,325,190,515,0.000333,1.0261,40,123131.9664,6840.664801,3078.299161,318.715998,15,0
0,0,56,56,21,40,61,394,228,622,0.000333,1.22964,50,184445.9312,10246.99618,3688.918624,305.11579,19,0
0,0,31,31,20,42,62,217,127,344,0.000333,0.682748,30,61447.30592,3413.739218,2048.243531,312.915894,8,0
0,0,35,35,21,48,69,180,121,301,0.000333,0.612889,20,36773.31723,2042.962068,1838.665861,360.316866,9,0
0,0,33,33,21,48,69,176,116,292,0.000333,0.594563,20,35673.78283,1981.876824,1783.689141,360.316866,9,0
0,0,48,48,22,58,80,265,174,439,0.000333,0.925109,33,91585.77231,5088.098462,2775.326434,437.870393,11,0
0,0,49,49,22,58,80,269,176,445,0.000333,0.937753,33,92837.51407,5157.639671,2813.258002,437.870393,12,0
0,0,50,50,22,58,80,271,178,449,0.000333,0.946182,33,93672.00858,5204.000477,2838.545715,437.870393,12,0
0,0,53,53,22,58,80,279,185,464,0.000333,0.977792,33,96801.36299,5377.853499,2933.374636,437.870393,13,0
0,0,54,54,22,58,80,281,187,468,0.000333,0.986221,33,97635.8575,5424.214305,2958.662348,437.870393,13,0
0,0,56,56,22,58,80,287,191,478,0.000333,1.007294,33,99722.09377,5540.11632,3021.881629,437.870393,14,0
0,0,57,57,22,58,80,295,195,490,0.000333,1.032582,33,102225.5773,5679.198739,3097.744766,437.870393,14,0
0,0,58,58,22,58,80,297,197,494,0.000333,1.041011,33,103060.0718,5725.559545,3123.032479,437.870393,14,0
0,0,31,31,21,48,69,170,112,282,0.000333,0.574201,20,34452.07794,1914.00433,1722.603897,360.316866,8,0
0,0,32,32,21,48,69,174,114,288,0.000333,0.586418,20,35185.10087,1954.727826,1759.255044,360.316866,9,0
0,0,23,23,20,39,59,149,90,239,0.000333,0.468651,20,28119.03378,1562.168543,1405.951689,292.569248,8,0
0,0,42,42,19,45,64,218,141,359,0.000333,0.718,27,58158,3231,2154,327.844012,5,0
0,0,39,39,17,44,61,218,134,352,0.000333,0.695873,24,50102.86903,2783.492724,2087.619543,309.70186,6,0
0,0,41,41,19,45,64,216,139,355,0.000333,0.71,27,57510,3195,2130,327.844012,5,0
0,0,38,38,17,44,61,216,132,348,0.000333,0.687966,24,49533.51824,2751.862125,2063.896593,309.70186,6,0
0,0,40,40,19,45,64,214,137,351,0.000333,0.702,27,56862,3159,2106,327.844012,5,0
0,0,37,37,17,44,61,214,130,344,0.000333,0.680058,16,32642.77831,1813.487684,2040.173644,309.70186,6,0
0,0,37,37,19,45,64,206,130,336,0.000333,0.672,18,36288,2016,2016,327.844012,4,0
0,0,34,34,17,44,61,206,123,329,0.000333,0.650404,16,31219.40135,1734.411186,1951.212584,309.70186,5,0
0,0,36,36,19,45,64,204,128,332,0.000333,0.664,18,35856,1992,1992,327.844012,4,0
0,0,33,33,17,44,61,204,121,325,0.000333,0.642497,16,30839.83416,1713.32412,1927.489635,309.70186,5,0
0,0,35,35,18,45,63,200,126,326,0.000333,0.649531,18,35074.67859,1948.593255,1948.593255,322.192039,3,0
0,0,32,32,16,44,60,200,119,319,0.000333,0.628099,16,30148.7696,1674.931644,1884.2981,304.214991,4,0
0,0,6,6,12,14,26,38,22,60,0.000333,0.094009,6,1692.158299,94.008794,282.026383,96.322519,4,0
0,0,118,118,29,78,107,544,335,879,0.000333,1.97525,56,331841.9709,18435.66505,5925.749481,631.142822,46,0
0,0,117,117,29,78,107,541,334,875,0.000333,1.966261,56,330331.8823,18351.77124,5898.783613,631.142822,45,0
0,0,123,123,22,60,82,608,300,908,0.000333,1.924219,55,317496.1471,17638.67484,5772.65722,452.520931,62,0
0,0,114,114,22,59,81,580,283,863,0.000333,1.823764,44,240736.7843,13374.2658,5471.290552,445.183436,59,0
0,0,110,110,22,57,79,563,274,837,0.000333,1.758755,44,232155.6374,12897.53541,5276.264486,430.582226,57,0
0,0,20,20,22,46,68,171,103,274,0.000333,0.555988,22,36695.22601,2038.623667,1667.964819,352.191346,16,0
0,0,20,20,23,44,67,169,99,268,0.000333,0.541904,22,35765.66187,1986.981215,1625.711903,344.256916,16,0
0,0,14,14,22,42,64,149,90,239,0.000333,0.478,22,31548,1752.666667,1434,324.584827,15,0
0,0,18,18,21,34,55,123,73,196,0.000333,0.377716,20,22662.93008,1259.051671,1133.146504,265.212402,13,0
0,0,14,14,19,27,46,100,60,160,0.000333,0.29459,18,15907.85843,883.769913,883.769913,209.092585,10,0
0,0,12,12,19,25,44,96,60,156,0.000333,0.28389,18,15330.08399,851.671333,851.671333,196.807027,8,0
0,0,26,26,21,31,52,152,90,242,0.000333,0.459835,20,27590.12824,1532.784902,1379.506412,245.818752,12,0
0,0,17,17,19,34,53,79,57,136,0.000333,0.259666,9,7010.974636,389.498591,778.997182,253.684359,8,0
0,0,21,21,19,34,53,93,69,162,0.000333,0.309308,18,16702.61605,927.923114,927.923114,253.684359,9,0
0,0,25,25,19,34,53,107,81,188,0.000333,0.35895,18,19383.28282,1076.849045,1076.849045,253.684359,10,0
0,0,19,19,12,14,26,72,57,129,0.000333,0.202119,24,14552.56137,808.475632,606.356724,96.322519,5,0
0,0,17,17,19,34,53,79,57,136,0.000333,0.259666,9,7010.974636,389.498591,778.997182,253.684359,8,0
0,0,21,21,19,34,53,93,69,162,0.000333,0.309308,18,16702.61605,927.923114,927.923114,253.684359,9,0
0,0,25,25,19,34,53,107,81,188,0.000333,0.35895,18,19383.28282,1076.849045,1076.849045,253.684359,10,0
0,0,19,19,12,14,26,72,57,129,0.000333,0.202119,24,14552.56137,808.475632,606.356724,96.322519,5,0
0,0,4,4,12,18,30,32,24,56,0.000333,0.091595,6,1648.71524,91.595291,274.785873,118.0782,2,0
0,0,28,28,25,52,77,134,98,232,0.000333,0.484631,12,17446.73373,969.262985,1453.894477,412.51927,16,0
0,0,31,31,26,55,81,145,107,252,0.000333,0.532547,13,20769.34861,1153.852701,1597.642201,440.186217,16,0
0,0,37,37,27,66,93,236,171,407,0.000333,0.887146,26,69197.37854,3844.298808,2661.437636,527.311974,20,0
0,0,38,38,29,71,100,254,188,442,0.000333,0.978861,28,82224.36421,4568.020234,2936.584436,577.513494,22,0
0,0,73,73,34,79,113,481,355,836,0.000333,1.900557,68,387713.5337,21539.64076,5701.669613,670.972416,41,0
0,0,73,73,34,79,113,481,355,836,0.000333,1.900557,68,387713.5337,21539.64076,5701.669613,670.972416,41,0
0,0,71,71,34,76,110,477,346,823,0.000333,1.860353,68,379512.015,21084.00083,5581.059044,647.816228,37,0
0,0,73,73,34,78,112,478,351,829,0.000333,1.881099,68,383744.2117,21319.12287,5643.29723,663.23511,41,0
0,0,71,71,34,75,109,474,342,816,0.000333,1.840946,68,375553.0118,20864.05621,5522.838409,640.135138,37,0
0,0,73,73,34,78,112,478,351,829,0.000333,1.881099,68,383744.2117,21319.12287,5643.29723,663.23511,41,0
0,0,71,71,34,75,109,474,342,816,0.000333,1.840946,68,375553.0118,20864.05621,5522.838409,640.135138,37,0
0,0,27,27,25,49,74,130,94,224,0.000333,0.463639,12,16691.01065,927.278369,1390.917554,391.217187,16,0
0,0,30,30,26,52,78,141,103,244,0.000333,0.511213,13,19937.29584,1107.627547,1533.638141,418.634298,16,0
0,0,36,36,27,65,92,232,167,399,0.000333,0.867634,26,67675.43173,3759.746207,2602.90122,519.83587,20,0
0,0,37,37,29,70,99,250,184,434,0.000333,0.959047,28,80559.94165,4475.552314,2877.140773,569.93126,22,0
0,0,72,72,34,78,112,477,351,828,0.000333,1.87883,68,383281.3115,21293.4062,5636.489875,663.23511,41,0
0,0,72,72,34,78,112,477,351,828,0.000333,1.87883,68,383281.3115,21293.4062,5636.489875,663.23511,41,0
0,0,70,70,34,75,109,473,342,815,0.000333,1.83869,68,375092.7753,20838.48752,5516.070225,640.135138,37,0
0,0,72,72,34,77,111,474,347,821,0.000333,1.859405,68,379318.649,21073.25828,5578.215426,655.5163,41,0
0,0,70,70,34,74,108,470,338,808,0.000333,1.819316,68,371140.5389,20618.91883,5457.949102,632.473286,37,0
0,0,72,72,34,77,111,474,347,821,0.000333,1.859405,68,379318.649,21073.25828,5578.215426,655.5163,41,0
0,0,70,70,34,74,108,470,338,808,0.000333,1.819316,68,371140.5389,20618.91883,5457.949102,632.473286,37,0
0,0,12,12,24,28,52,91,50,141,0.000333,0.267921,12,9645.144003,535.841334,803.762,244.645038,9,0
0,0,12,12,23,26,49,86,47,133,0.000333,0.248919,11,8214.320502,456.351139,746.756409,226.253358,9,0
0,0,3,3,9,6,15,10,7,17,0.000333,0.022139,4,265.668561,14.759364,66.41714,44.0391,1,0
0,0,7,7,14,15,29,46,27,73,0.000333,0.118211,7,2482.428289,137.912683,354.632613,111.906328,2,0
0,0,23,23,24,36,60,116,77,193,0.000333,0.38001,24,27360.71724,1520.039847,1140.029885,296.1564,7,0
0,0,23,23,23,38,61,119,79,198,0.000333,0.391429,22,25834.29184,1435.238436,1174.285993,303.463171,7,0
0,0,28,28,25,45,70,148,97,245,0.000333,0.500558,24,36040.18414,2002.232452,1501.674339,363.229794,10,0
0,0,16,16,16,32,48,89,57,146,0.000333,0.271802,8,6523.236201,362.402011,815.404525,224,4,0
0,0,27,27,22,45,67,147,95,242,0.000333,0.489331,22,32295.85885,1794.214381,1467.993584,345.240885,9,0
0,0,8,8,12,20,32,40,28,68,0.000333,0.113333,6,2040,113.333333,340,129.458112,4,0
0,0,21,21,19,36,55,110,73,183,0.000333,0.352663,18,19043.7989,1057.988828,1057.988828,266.827923,9,0
0,0,11,11,15,24,39,63,40,103,0.000333,0.181465,7,3810.775,211.709722,544.396429,168.642459,5,0
0,0,13,13,12,13,25,472,50,522,0.000333,0.808031,18,43633.67276,2424.092931,2424.092931,91.125266,4,0
0,0,12,12,12,12,24,312,46,358,0.000333,0.547139,18,29545.49836,1641.416575,1641.416575,86.0391,4,0
0,0,29,29,21,34,55,430,114,544,0.000333,1.048353,30,94351.79053,5241.76614,3145.059684,265.212402,13,0
0,0,12,12,11,11,22,160,46,206,0.000333,0.306214,20,18372.85827,1020.714348,918.642913,76.107496,3,0
0,0,12,12,11,11,22,160,46,206,0.000333,0.306214,20,18372.85827,1020.714348,918.642913,76.107496,3,0
0,0,11,11,18,20,38,68,45,113,0.000333,0.197672,18,10674.28456,593.015809,593.015809,161.497212,5,0
0,0,4,4,13,21,34,149,46,195,0.000333,0.330685,12,11904.66305,661.370169,992.055254,140.344382,1,0
0,0,4,4,13,20,33,149,45,194,0.000333,0.326204,12,11743.34951,652.408306,978.612459,134.544278,1,0
0,0,2,2,6,5,11,6,7,13,0.000333,0.014991,3,134.917833,7.495435,44.972611,27.119415,1,0
0,0,2,2,6,5,11,6,7,13,0.000333,0.014991,3,134.917833,7.495435,44.972611,27.119415,1,0
0,0,2,2,6,5,11,6,7,13,0.000333,0.014991,3,134.917833,7.495435,44.972611,27.119415,1,0
0,0,2,2,8,5,13,8,7,15,0.000333,0.018502,4,222.026383,12.334799,55.506596,35.60964,1,0
0,0,8,8,12,14,26,26,22,48,0.000333,0.075207,6,1353.726639,75.207035,225.621106,96.322519,2,0
0,0,33,33,27,37,64,170,124,294,0.000333,0.588,39,68796,3822,1764,321.131737,9,0
0,0,70,70,29,47,76,320,227,547,0.000333,1.139205,56,191386.5156,10632.5842,3417.61635,401.947125,21,0
0,0,61,61,29,47,76,290,206,496,0.000333,1.032991,56,173542.4346,9641.246367,3098.972047,401.947125,23,0
0,0,3,3,12,14,26,18,21,39,0.000333,0.061106,6,1099.902894,61.105716,183.317149,96.322519,1,0
0,0,31,31,31,46,77,193,131,324,0.000333,0.676813,30,60913.16518,3384.064732,2030.438839,407.663936,13,0
0,0,24,24,27,41,68,144,106,250,0.000333,0.507289,26,39568.50847,2198.25047,1521.86571,348.041595,10,0
0,0,71,71,29,47,76,350,271,621,0.000333,1.293321,70,271597.409,15088.74495,3879.962986,401.947125,24,0
0,0,36,36,27,46,73,189,144,333,0.000333,0.687071,39,80387.25155,4465.958419,2061.211578,382.465813,19,0
0,0,41,41,27,55,82,218,158,376,0.000333,0.796813,26,62151.4284,3452.857133,2390.439554,446.356747,29,0
0,0,31,31,25,41,66,181,132,313,0.000333,0.630632,36,68108.23294,3783.790719,1891.895359,335.756037,19,0
0,0,29,29,31,46,77,183,123,306,0.000333,0.639212,30,57529.10044,3196.061136,1917.636681,407.663936,12,0
0,0,22,22,27,41,68,134,98,232,0.000333,0.470764,26,36719.57586,2039.976437,1412.291379,348.041595,9,0
0,0,69,69,29,47,76,340,263,603,0.000333,1.255833,70,263725.0203,14651.39002,3767.500291,401.947125,23,0
0,0,34,34,27,46,73,179,136,315,0.000333,0.649932,26,50694.66314,2816.370174,1949.794736,382.465813,18,0
0,0,39,39,27,55,82,208,150,358,0.000333,0.758668,26,59176.09406,3287.560781,2276.003618,446.356747,28,0
0,0,30,30,25,41,66,179,129,308,0.000333,0.620558,36,67020.242,3723.346778,1861.673389,335.756037,19,0
0,0,30,30,31,47,78,194,131,325,0.000333,0.680919,30,61282.67163,3404.592869,2042.755721,414.645762,12,0
0,0,23,23,27,42,69,145,106,251,0.000333,0.51108,26,39864.23061,2214.679478,1533.239639,354.859294,9,0
0,0,70,70,29,48,77,351,271,622,0.000333,1.299314,70,272855.886,15158.66033,3897.941228,408.959649,23,0
0,0,35,35,27,47,74,190,144,334,0.000333,0.691319,39,80884.33954,4493.574419,2073.957424,389.447639,18,0
0,0,40,40,27,56,83,219,158,377,0.000333,0.80113,26,62488.13651,3471.563139,2403.389866,453.593838,28,0
0,0,31,31,25,42,67,190,137,327,0.000333,0.661204,36,71410.00195,3967.222331,1983.611165,342.573737,19,0
0,0,30,30,31,47,78,198,133,331,0.000333,0.693489,30,62414.04403,3467.446891,2080.468134,414.645762,13,0
0,0,23,23,27,42,69,149,108,257,0.000333,0.523297,26,40817.16042,2267.620023,1569.890785,354.859294,10,0
0,0,70,70,29,48,77,355,273,628,0.000333,1.311847,70,275487.9363,15304.88535,3935.541948,408.959649,24,0
0,0,35,35,27,47,74,194,146,340,0.000333,0.703738,39,82337.35163,4574.297313,2111.214144,389.447639,19,0
0,0,40,40,27,56,83,223,160,383,0.000333,0.81388,26,63482.64266,3526.813481,2441.640102,453.593838,29,0
0,0,30,30,25,42,67,186,134,320,0.000333,0.64705,36,69881.34747,3882.297082,1941.148541,342.573737,19,0
0,0,64,64,35,78,113,508,349,857,0.000333,1.948298,68,397452.7492,22080.70829,5844.893371,669.786279,24,0
0,0,11,11,18,20,38,68,45,113,0.000333,0.197672,18,10674.28456,593.015809,593.015809,161.497212,5,0
0,0,10,10,16,23,39,58,37,95,0.000333,0.167371,8,4016.905686,223.161427,502.113211,168.041925,8,0
0,0,57,57,37,56,93,489,323,812,0.000333,1.769932,90,477881.7259,26548.98477,5309.796955,517.96165,26,0
0,0,53,53,35,73,108,443,297,740,0.000333,1.666206,68,339905.9391,18883.66328,4998.616752,631.382098,20,0
0,0,49,49,31,46,77,314,184,498,0.000333,1.040287,60,187251.5818,10402.86566,3120.859697,407.663936,21,0
0,0,43,43,31,41,72,287,162,449,0.000333,0.923432,45,124663.3347,6925.740814,2770.296326,373.239718,19,0
0,0,47,47,31,43,74,281,167,448,0.000333,0.927278,45,125182.5799,6954.58777,2781.835108,386.90947,21,0
0,0,41,41,31,38,69,232,137,369,0.000333,0.751349,45,101432.0486,5635.113811,2254.045525,353.001331,19,0
0,0,2,2,6,5,11,6,7,13,0.000333,0.014991,3,134.917833,7.495435,44.972611,27.119415,1,0
0,0,2,2,6,5,11,6,7,13,0.000333,0.014991,3,134.917833,7.495435,44.972611,27.119415,1,0
0,0,2,2,6,5,11,6,7,13,0.000333,0.014991,3,134.917833,7.495435,44.972611,27.119415,1,0
0,0,2,2,8,5,13,8,7,15,0.000333,0.018502,4,222.026383,12.334799,55.506596,35.60964,1,0
0,0,7,7,14,16,30,39,27,66,0.000333,0.107952,7,2266.983455,125.943525,323.854779,117.302969,2,0
0,0,3,3,8,8,16,11,11,22,0.000333,0.029333,4,352,19.555556,88,48,1,0
0,0,9,9,15,15,30,45,30,75,0.000333,0.122672,14,5152.235125,286.235285,368.016795,117.206718,3,0
0,0,6,6,11,11,22,28,19,47,0.000333,0.069864,5,1047.96643,58.220357,209.593286,76.107496,2,0
0,0,8,8,14,14,28,43,29,72,0.000333,0.115377,14,4845.813761,269.211876,346.129554,106.605938,3,0
0,0,6,6,11,17,28,47,33,80,0.000333,0.128196,5,1922.941969,106.830109,384.588394,107.540616,3,0
0,0,5,5,13,13,26,44,26,70,0.000333,0.109677,12,3948.369363,219.353854,329.03078,96.211433,2,0
0,0,4,4,13,12,25,39,23,62,0.000333,0.095973,6,1727.514503,95.973028,287.919084,91.125266,2,0
0,0,22,22,16,25,41,102,71,173,0.000333,0.308952,16,14829.70395,823.872442,926.856497,180.096405,5,0
0,0,4,4,11,9,20,22,14,36,0.000333,0.051863,5,777.947057,43.219281,155.589411,66.583073,2,0
0,0,57,57,27,65,92,353,247,600,0.000333,1.304712,39,152651.3498,8480.630543,3914.137174,519.83587,16,0
0,0,25,25,24,40,64,148,104,252,0.000333,0.504,24,36288,2016,1512,322.916224,11,0
0,0,64,64,27,77,104,402,281,683,0.000333,1.525467,39,178479.6128,9915.534043,4576.400327,610.924526,17,0
0,0,26,26,24,42,66,156,112,268,0.000333,0.539966,24,38877.54298,2159.863499,1619.897624,336.516432,10,0
0,0,19,19,21,40,61,137,96,233,0.000333,0.460621,20,27637.23599,1535.402,1381.8618,305.11579,7,0
0,0,41,41,27,30,57,176,119,295,0.000333,0.573568,39,67107.39961,3728.188867,1720.702554,275.58868,13,0
0,0,47,47,27,31,58,218,141,359,0.000333,0.701005,52,109356.7892,6075.377179,2103.015177,281.962048,16,0
0,0,30,30,26,30,56,158,93,251,0.000333,0.485882,39,56848.19733,3158.233185,1457.646085,269.418151,9,0
0,0,27,27,25,28,53,148,89,237,0.000333,0.452506,36,48870.61732,2715.034295,1357.517148,250.702343,9,0
0,0,20,20,24,25,49,113,70,183,0.000333,0.342497,24,24659.80564,1369.989202,1027.491901,226.135505,7,0
0,0,72,72,26,49,75,544,216,760,0.000333,1.577967,52,246162.9146,13675.71748,4733.902205,397.332215,70,0
0,0,71,71,27,49,76,563,228,791,0.000333,1.64737,52,256989.7545,14277.20858,4942.110663,403.502745,67,0
0,0,70,70,27,50,77,562,226,788,0.000333,1.646076,52,256787.8453,14265.99141,4938.227794,410.574772,66,0
0,0,70,70,28,48,76,562,224,786,0.000333,1.636957,56,275008.7774,15278.26541,4910.871026,402.684138,66,0
0,0,71,71,27,49,76,554,226,780,0.000333,1.624461,52,253415.9399,14078.66333,4873.38346,403.502745,67,0
0,0,70,70,27,50,77,562,226,788,0.000333,1.646076,52,256787.8453,14265.99141,4938.227794,410.574772,66,0
0,0,70,70,28,48,76,562,224,786,0.000333,1.636957,56,275008.7774,15278.26541,4910.871026,402.684138,66,0
0,0,77,77,29,60,89,635,264,899,0.000333,1.940561,56,326014.3238,18111.90688,5821.684354,495.294885,70,0
0,0,77,77,29,60,89,635,264,899,0.000333,1.940561,56,326014.3238,18111.90688,5821.684354,495.294885,70,0
0,0,74,74,27,52,79,579,241,820,0.000333,1.723033,52,268793.2111,14932.95617,5169.100214,424.804828,68,0
0,0,74,74,27,52,79,578,241,819,0.000333,1.720932,52,268465.4145,14914.74525,5162.796433,424.804828,68,0
0,0,8,8,13,25,38,49,35,84,0.000333,0.146942,6,2644.955467,146.94197,440.825911,164.202121,4,0
0,0,18,18,20,30,50,104,69,173,0.000333,0.325462,20,19527.74242,1084.874579,976.387121,233.64528,9,0
0,0,10,10,13,20,33,56,40,96,0.000333,0.161421,12,5811.142026,322.841224,484.261835,134.544278,8,0
0,0,12,12,14,21,35,55,45,100,0.000333,0.170976,14,7180.996224,398.944235,512.928302,145.541635,8,0
0,0,8,8,13,17,30,40,32,72,0.000333,0.117765,6,2119.776737,117.765374,353.296123,117.592585,7,0
0,0,7,7,13,17,30,36,29,65,0.000333,0.106316,6,1913.687332,106.315963,318.947889,117.592585,6,0
0,0,6,6,14,17,31,33,26,59,0.000333,0.097433,7,2046.083076,113.671282,292.297582,122.789837,5,0
0,0,6,6,12,16,28,30,23,53,0.000333,0.08493,6,1528.738865,84.929937,254.789811,107.01955,4,0
0,0,6,6,13,16,29,31,23,54,0.000333,0.087444,6,1573.985842,87.443658,262.330974,112.105716,4,0
0,0,8,8,14,30,44,55,41,96,0.000333,0.174702,7,3668.738048,203.81878,524.105435,200.509687,4,0
0,0,22,22,22,40,62,120,85,205,0.000333,0.40687,22,26853.42536,1491.856964,1220.610244,310.984619,9,0
0,0,5,5,11,18,29,34,25,59,0.000333,0.09554,5,1433.104394,79.616911,286.620879,113.112398,2,0
0,0,26,26,23,45,68,148,105,253,0.000333,0.513376,22,33882.81817,1882.378787,1540.128099,351.175314,15,0
0,0,27,27,25,46,71,155,110,265,0.000333,0.543228,24,39112.39168,2172.910649,1629.682987,370.180255,16,0
0,0,25,25,23,44,67,140,100,240,0.000333,0.485287,22,32028.95093,1779.386163,1455.861406,344.256916,15,0
0,0,23,23,23,42,65,126,91,217,0.000333,0.435618,22,28750.78394,1597.265774,1306.853815,330.519257,14,0
0,0,29,29,25,49,74,185,127,312,0.000333,0.645783,24,46496.3868,2583.1326,1937.34945,391.217187,15,0
0,0,22,22,23,43,66,119,87,206,0.000333,0.415048,22,27393.19415,1521.844119,1245.145189,337.371309,12,0
0,0,22,22,23,43,66,119,87,206,0.000333,0.415048,22,27393.19415,1521.844119,1245.145189,337.371309,12,0
0,0,22,22,23,44,67,120,88,208,0.000333,0.420582,22,27758.42414,1542.134674,1261.746552,344.256916,12,0
0,0,22,22,23,43,66,119,87,206,0.000333,0.415048,22,27393.19415,1521.844119,1245.145189,337.371309,12,0
0,0,21,21,23,42,65,111,82,193,0.000333,0.387439,11,12785.48687,710.304826,1162.316988,330.519257,12,0
0,0,39,39,25,57,82,194,130,324,0.000333,0.686616,24,49436.32439,2746.462466,2059.846849,448.571136,16,0
0,0,21,21,22,45,67,154,106,260,0.000333,0.525728,22,34698.03017,1927.668343,1577.18319,345.240885,10,0
0,0,3,3,11,13,24,20,16,36,0.000333,0.05502,5,825.29325,45.849625,165.05865,86.159464,1,0
0,0,89,89,39,76,115,560,332,892,0.000333,2.035392,76,464069.4615,25781.63675,6106.177125,680.973178,60,0
0,0,35,35,27,44,71,200,131,331,0.000333,0.678522,26,52924.72371,2940.262428,2035.566297,368.596954,24,0
0,0,36,36,28,50,78,223,146,369,0.000333,0.773104,28,64940.77573,3607.820874,2319.313419,416.798747,36,0
0,0,48,48,28,62,90,299,201,500,0.000333,1.081976,42,136328.915,7573.828612,3245.926548,503.766109,27,0
0,0,63,63,37,65,102,436,259,695,0.000333,1.545779,54,250416.1231,13912.00684,4637.335613,584.203682,39,0
0,0,36,36,27,44,71,202,131,333,0.000333,0.682622,26,53244.51056,2958.028364,2047.865791,368.596954,24,0
0,0,37,37,28,50,78,225,146,371,0.000333,0.777295,28,65292.75825,3627.375458,2331.884223,416.798747,36,0
0,0,49,49,28,62,90,301,201,502,0.000333,1.086303,42,136874.2307,7604.123927,3258.910254,503.766109,27,0
0,0,66,66,27,45,72,386,212,598,0.000333,1.229872,52,191859.9878,10658.88821,3689.615151,375.515352,43,0
0,0,90,90,39,76,115,563,333,896,0.000333,2.04452,76,466150.4905,25897.24947,6133.559086,680.973178,60,0
0,0,36,36,27,44,71,203,132,335,0.000333,0.686722,39,80346.44612,4463.691451,2060.165285,368.596954,24,0
0,0,37,37,28,50,78,226,147,373,0.000333,0.781485,28,65644.74077,3646.930043,2344.455028,416.798747,36,0
0,0,49,49,28,62,90,302,202,504,0.000333,1.090631,42,137419.5463,7634.419241,3271.893961,503.766109,27,0
0,0,64,64,37,65,102,439,260,699,0.000333,1.554675,72,335809.8226,18656.10126,4664.025314,584.203682,39,0
0,0,37,37,27,44,71,205,132,337,0.000333,0.690822,39,80826.12639,4490.340355,2072.464779,368.596954,24,0
0,0,38,38,28,50,78,228,147,375,0.000333,0.785675,28,65996.7233,3666.484628,2357.025832,416.798747,36,0
0,0,50,50,28,62,90,304,202,506,0.000333,1.094959,42,137964.862,7664.714556,3284.877667,503.766109,27,0
0,0,67,67,27,45,72,389,213,602,0.000333,1.238098,52,193143.3322,10730.18513,3714.294851,375.515352,43,0
0,0,11,11,15,17,32,128,72,200,0.000333,0.333333,28,28000,1555.555556,1000,128.090227,19,0
0,0,46,46,30,42,72,292,165,457,0.000333,0.939885,45,126884.5077,7049.139314,2819.655726,373.68405,29,0
0,0,79,79,37,85,122,562,353,915,0.000333,2.113875,72,456596.9758,25366.49866,6341.624664,737.548004,66,0
0,0,54,54,36,70,106,408,263,671,0.000333,1.504812,54,243779.4698,13543.30388,4514.434625,615.167111,36,0
0,0,31,31,27,52,79,222,157,379,0.000333,0.796378,39,93176.18324,5176.454624,2389.132904,424.804828,37,0
0,0,60,60,30,75,105,373,283,656,0.000333,1.468182,45,198204.5277,11011.36265,4404.54506,614.36812,30,0
0,0,60,60,31,74,105,383,280,663,0.000333,1.483848,45,200319.515,11128.86195,4451.544778,613.079635,32,0
0,0,32,32,20,42,62,158,108,266,0.000333,0.527939,20,31676.32437,1759.795798,1583.816219,312.915894,10,0
0,0,34,34,20,43,63,165,114,279,0.000333,0.555887,20,33353.22197,1852.956776,1667.661099,319.767946,10,0
0,0,30,30,18,42,60,144,101,245,0.000333,0.482396,18,26049.38753,1447.188196,1447.188196,301.535982,10,0
0,0,17,17,20,38,58,132,77,209,0.000333,0.408106,20,24486.36056,1360.353364,1224.318028,285.859807,11,0
0,0,20,20,22,43,65,148,90,238,0.000333,0.477775,22,31533.11787,1751.839882,1433.32354,331.43688,12,0
0,0,20,20,22,41,63,149,89,238,0.000333,0.474198,22,31297.03768,1738.724316,1422.592622,317.767128,13,0
0,0,25,25,22,49,71,184,121,305,0.000333,0.625224,22,41264.80317,2292.489065,1875.672871,373.228278,16,0
0,0,30,30,22,50,72,213,140,353,0.000333,0.725995,22,47915.63756,2661.979865,2177.983526,380.300305,19,0
0,0,17,17,22,37,59,143,82,225,0.000333,0.441198,22,29119.08309,1617.726839,1323.594686,290.85727,11,0
0,0,20,20,24,42,66,159,95,254,0.000333,0.511759,24,36846.62655,2047.034808,1535.276106,336.516432,12,0
0,0,20,20,24,40,64,160,94,254,0.000333,0.508,24,36576,2032,1524,322.916224,13,0
0,0,25,25,24,48,72,195,126,321,0.000333,0.660182,24,47533.10221,2640.727901,1980.545925,378.1173,16,0
0,0,30,30,24,49,73,224,145,369,0.000333,0.761348,24,54817.08629,3045.393683,2284.045262,385.159882,19,0
0,0,3,3,10,14,24,23,18,41,0.000333,0.062661,5,939.917313,52.217628,187.983463,86.52225,2,0
0,0,13,13,20,30,50,99,76,175,0.000333,0.329225,20,19753.49666,1097.416481,987.674833,233.64528,9,0
0,0,18,18,20,32,52,128,95,223,0.000333,0.423733,20,25423.96114,1412.442286,1271.198057,246.438562,12,0
0,0,39,39,25,33,58,220,130,350,0.000333,0.683431,36,73810.56054,4100.586697,2050.293348,282.561411,21,0
0,0,7,7,18,22,40,148,44,192,0.000333,0.340603,18,18392.5835,1021.810194,1021.810194,173.166146,1,0
0,0,8,8,14,79,93,307,206,513,0.000333,1.118196,14,46964.23858,2609.124366,3354.58847,551.301648,4,0
0,0,7,7,14,83,97,326,225,551,0.000333,1.212184,14,50911.72767,2828.429315,3636.551976,582.431242,3,0
0,0,7,7,14,77,91,328,224,552,0.000333,1.197434,14,50292.23698,2794.013166,3592.302641,535.845533,3,0
0,0,7,7,14,70,84,280,183,463,0.000333,0.986548,14,41435.00153,2301.94453,2959.642967,482.35278,3,0
0,0,29,29,24,46,70,141,96,237,0.000333,0.484213,24,34863.3618,1936.853433,1452.640075,364.12295,9,0
0,0,22,22,19,26,45,96,74,170,0.000333,0.311205,18,16805.07048,933.615026,933.615026,202.922055,7,0
0,0,35,35,24,49,73,163,117,280,0.000333,0.577717,24,41595.62104,2310.867835,1733.150876,385.159882,10,0
0,0,68,68,29,101,130,529,383,912,0.000333,2.1348,42,268984.7767,14943.59871,6404.399445,813.360809,24,0
0,0,43,43,24,71,95,286,215,501,0.000333,1.097166,36,118493.9158,6582.99532,3291.49766,546.671146,15,0
0,0,48,48,24,75,99,320,246,566,0.000333,1.250739,36,135079.7705,7504.431694,3752.215847,577.200502,15,0
0,0,87,87,27,78,105,543,398,941,0.000333,2.106035,65,410676.8271,22815.37928,6318.105032,618.643336,34,0
0,0,58,58,26,82,108,396,291,687,0.000333,1.546869,39,180983.7008,10054.65005,4640.607714,643.530697,19,0
0,0,62,62,28,88,116,450,327,777,0.000333,1.776217,42,223803.3518,12433.51954,5328.651233,703.03592,22,0
0,0,30,30,21,66,87,240,182,422,0.000333,0.906307,20,54378.44311,3021.024617,2718.922155,491.168678,11,0
0,0,56,56,26,84,110,485,352,837,0.000333,1.891999,52,295151.9002,16397.32779,5675.99808,659.166096,20,0
0,0,69,69,26,64,90,503,340,843,0.000333,1.824211,65,355721.0904,19762.2828,5472.63216,506.211433,33,0
0,0,60,60,29,78,107,372,269,641,0.000333,1.440427,42,181493.7742,10082.98746,4321.280338,631.142822,22,0
0,0,28,28,21,56,77,162,124,286,0.000333,0.597434,20,35846.01901,1991.445501,1792.300951,417.450542,11,0
0,0,54,54,27,88,115,407,294,701,0.000333,1.599563,39,187148.8525,10397.15847,4798.688526,696.811945,20,0
0,0,61,61,29,83,112,400,290,690,0.000333,1.565692,42,197277.1456,10959.84143,4697.074896,670.009722,23,0
0,0,29,29,21,62,83,190,145,335,0.000333,0.711879,20,42712.76419,2372.931344,2135.63821,461.398837,12,0
0,0,55,55,27,92,119,435,315,750,0.000333,1.723704,39,201673.4196,11204.07887,5171.113322,728.549663,21,0
0,0,72,72,27,71,98,544,372,916,0.000333,2.019691,65,393839.8241,21879.99023,6059.074217,565.014008,33,0
0,0,73,73,27,64,91,543,371,914,0.000333,1.982708,65,386628.0796,21479.33775,5948.124301,512.381963,35,0
0,0,74,74,27,60,87,491,331,822,0.000333,1.765367,65,344246.471,19124.80394,5296.099554,482.795398,35,0
0,0,71,71,26,58,84,485,326,811,0.000333,1.728056,65,336971.0129,18720.61183,5184.16943,461.97433,34,0
0,0,73,73,27,53,80,455,305,760,0.000333,1.601555,65,312303.2479,17350.18044,4804.665352,431.961747,35,0
0,0,73,73,27,55,82,464,311,775,0.000333,1.642368,65,320261.6822,17792.31568,4927.102804,446.356747,35,0
0,0,74,74,27,109,136,561,411,972,0.000333,2.296338,39,268671.5414,14926.19674,6889.013882,866.114054,23,0
0,0,70,70,26,60,86,483,321,804,0.000333,1.722239,65,335836.5961,18657.58867,5166.716863,476.624868,35,0
0,0,6,6,14,15,29,36,27,63,0.000333,0.102018,7,2142.369619,119.020534,306.052803,111.906328,3,0
0,0,6,6,12,12,24,25,20,45,0.000333,0.068774,6,1237.939875,68.774438,206.323313,86.0391,1,0
0,0,24,24,22,30,52,119,85,204,0.000333,0.38763,22,25583.57346,1421.309636,1162.889703,245.314213,8,0
0,0,24,24,21,31,52,136,96,232,0.000333,0.440834,30,39675.06044,2204.170024,1322.502015,245.818752,9,0
0,0,7,7,19,19,38,46,30,76,0.000333,0.132947,9,3589.582419,199.421246,398.842491,161.421246,4,0
0,0,12,12,18,27,45,60,40,100,0.000333,0.183062,9,4942.667787,274.592655,549.18531,203.440613,4,0
0,0,14,14,18,28,46,67,46,113,0.000333,0.208054,9,5617.462509,312.081251,624.162501,209.664588,4,0
0,0,10,10,14,25,39,51,34,85,0.000333,0.149753,7,3144.81432,174.711907,449.259189,169.399374,4,0
0,0,123,123,29,78,107,562,349,911,0.000333,2.047159,56,343922.6798,19106.81554,6141.476425,631.142822,46,0
0,0,70,70,22,56,78,346,222,568,0.000333,1.190036,33,117813.5792,6545.198844,3570.10846,423.319371,28,0
0,0,122,122,29,78,107,559,348,907,0.000333,2.03817,56,342412.5912,19022.92173,6114.510557,631.142822,45,0
0,0,69,69,22,56,78,343,221,564,0.000333,1.181656,33,116983.9061,6499.105894,3544.966851,423.319371,27,0
0,0,85,85,24,55,79,399,257,656,0.000333,1.378427,48,198493.4482,11027.41379,4135.280171,428.013884,35,0
0,0,84,84,24,54,78,394,253,647,0.000333,1.355552,48,195199.4513,10844.41396,4066.655236,420.803025,35,0
0,0,83,83,24,54,78,388,251,639,0.000333,1.338791,48,192785.8569,10710.32538,4016.372018,420.803025,34,0
0,0,82,82,24,54,78,376,247,623,0.000333,1.305269,48,187958.668,10442.14822,3915.805582,420.803025,32,0
0,0,81,81,24,55,79,371,243,614,0.000333,1.290174,48,185785.0262,10321.39035,3870.521379,428.013884,31,0
0,0,81,81,24,55,79,371,244,615,0.000333,1.292275,48,186087.6077,10338.20043,3876.82516,428.013884,31,0
0,0,80,80,24,54,78,366,240,606,0.000333,1.269651,48,182829.7797,10157.20999,3808.953745,420.803025,31,0
0,0,117,117,21,56,77,569,300,869,0.000333,1.815279,50,272291.8752,15127.3264,5445.837504,417.450542,54,0
0,0,108,108,21,56,77,541,283,824,0.000333,1.721277,50,258191.6055,14343.97808,5163.83211,417.450542,51,0
0,0,104,104,21,54,75,524,274,798,0.000333,1.656866,50,248529.8658,13807.21476,4970.597315,403.002591,49,0
0,0,26,26,23,39,62,117,86,203,0.000333,0.402901,22,26591.44072,1477.302262,1208.701851,310.172612,9,0
0,0,116,116,28,76,104,529,325,854,0.000333,1.907392,56,320441.8291,17802.32384,5722.175519,609.448429,45,0
0,0,69,69,22,56,78,342,220,562,0.000333,1.177465,33,116569.0696,6476.05942,3532.396047,423.319371,28,0
0,0,25,25,23,39,62,114,85,199,0.000333,0.394962,22,26067.47145,1448.192858,1184.885066,310.172612,8,0
0,0,115,115,28,76,104,526,324,850,0.000333,1.898458,56,318940.9306,17718.94059,5695.37376,609.448429,44,0
0,0,68,68,22,56,78,339,219,558,0.000333,1.169085,33,115739.3965,6429.96647,3507.254438,423.319371,27,0
0,0,15,15,18,27,45,68,57,125,0.000333,0.228827,18,12356.66947,686.481637,686.481637,203.440613,4,0
0,0,81,81,26,45,71,315,217,532,0.000333,1.090555,52,170126.6043,9451.478017,3271.665468,369.344822,31,0
0,0,131,131,28,75,103,582,360,942,0.000333,2.099561,56,352726.2758,19595.90421,6298.683497,601.76734,52,0
0,0,84,84,24,55,79,395,255,650,0.000333,1.365819,48,196677.9593,10926.5533,4097.457486,428.013884,35,0
0,0,80,80,26,44,70,310,213,523,0.000333,1.068538,52,166691.9809,9260.665607,3205.615018,362.426424,31,0
0,0,130,130,28,74,102,577,356,933,0.000333,2.075124,56,348620.8793,19367.82663,6225.372844,594.105487,52,0
0,0,83,83,24,54,78,390,251,641,0.000333,1.342981,48,193389.2555,10743.84753,4028.942822,420.803025,35,0
0,0,79,79,26,44,70,304,211,515,0.000333,1.052194,52,164142.1992,9119.011066,3156.580754,362.426424,30,0
0,0,129,129,28,74,102,571,354,925,0.000333,2.057331,56,345631.6327,19201.75737,6171.993441,594.105487,51,0
0,0,82,82,24,54,78,384,249,633,0.000333,1.32622,48,190975.661,10609.75895,3978.659605,420.803025,34,0
0,0,78,78,26,44,70,292,207,499,0.000333,1.019504,52,159042.6357,8835.701985,3058.512225,362.426424,28,0
0,0,128,128,28,74,102,559,350,909,0.000333,2.021745,56,339653.1396,18869.61887,6065.234636,594.105487,49,0
0,0,81,81,24,54,78,372,245,617,0.000333,1.292698,48,186148.4721,10341.58178,3878.093169,420.803025,32,0
0,0,54,54,26,45,71,200,144,344,0.000333,0.705171,39,82505.00736,4583.61152,2115.513009,369.344822,19,0
0,0,127,127,28,75,103,554,346,900,0.000333,2.00595,56,336999.6266,18722.20148,6017.850474,601.76734,48,0
0,0,80,80,24,55,79,367,241,608,0.000333,1.277566,48,183969.5374,10220.52985,3832.698695,428.013884,31,0
0,0,54,54,26,45,71,200,145,345,0.000333,0.707221,39,82744.84749,4596.935972,2121.662756,369.344822,19,0
0,0,127,127,28,75,103,554,347,901,0.000333,2.008179,56,337374.0706,18743.00392,6024.536975,601.76734,48,0
0,0,80,80,24,55,79,367,242,609,0.000333,1.279667,48,184272.1188,10237.33994,3839.002476,428.013884,31,0
0,0,53,53,26,44,70,195,141,336,0.000333,0.68648,39,80318.12465,4462.118036,2059.439094,362.426424,19,0
0,0,126,126,28,74,102,549,343,892,0.000333,1.983934,56,333300.9907,18516.72171,5951.803405,594.105487,48,0
0,0,79,79,24,54,78,362,238,600,0.000333,1.25708,48,181019.5839,10056.64355,3771.241331,420.803025,31,0
0,0,116,116,21,56,77,565,298,863,0.000333,1.802746,50,270411.8392,15022.87996,5408.236785,417.450542,54,0
0,0,107,107,21,56,77,537,281,818,0.000333,1.708744,50,256311.5695,14239.53164,5126.23139,417.450542,51,0
0,0,103,103,21,54,75,520,272,792,0.000333,1.644408,50,246661.2201,13703.40112,4933.224403,403.002591,49,0
0,0,23,23,18,28,46,87,67,154,0.000333,0.283543,18,15311.31374,850.628541,850.628541,209.664588,7,0
0,0,4,4,7,11,18,15,15,30,0.000333,0.041699,3,375.29325,20.849625,125.09775,57.705232,2,0
0,0,37,37,19,20,39,145,62,207,0.000333,0.364693,27,29540.113,1641.117389,1094.078259,167.149185,18,0
0,0,37,37,19,18,37,142,60,202,0.000333,0.35077,27,28412.35866,1578.46437,1052.30958,155.769273,18,0
0,0,5,5,8,13,21,24,23,47,0.000333,0.068813,4,825.755675,45.875315,206.438919,72.105716,3,0
0,0,10,10,14,36,50,93,83,176,0.000333,0.331106,14,13906.46165,772.581203,993.318689,239.420269,6,0
0,0,3,3,7,6,13,14,9,23,0.000333,0.02837,3,255.330341,14.185019,85.110114,35.161259,3,0
0,0,44,44,22,43,65,283,179,462,0.000333,0.927445,44,122422.6929,6801.260717,2782.33393,331.43688,17,0
0,0,42,42,22,40,62,275,173,448,0.000333,0.88916,44,117369.1177,6520.506537,2667.479947,310.984619,17,0
0,0,55,55,28,49,77,354,228,582,0.000333,1.215757,56,204247.1069,11347.0615,3647.269767,409.72672,20,0
0,0,41,41,22,40,62,274,172,446,0.000333,0.885191,44,116845.1484,6491.397133,2655.571554,310.984619,16,0
0,0,60,60,28,50,78,401,253,654,0.000333,1.370218,70,287745.7136,15985.87298,4110.653051,416.798747,23,0
0,0,72,72,29,52,81,493,313,806,0.000333,1.703306,84,429233.2046,23846.28914,5109.919102,437.304314,26,0
0,0,37,37,21,37,58,243,156,399,0.000333,0.779111,40,93493.37668,5194.076482,2337.334417,284.98844,15,0
0,0,16,16,21,21,42,84,62,146,0.000333,0.262426,20,15745.56688,874.753715,787.278344,184.477332,6,0
0,0,17,17,22,25,47,89,67,156,0.000333,0.288839,22,19063.34894,1059.074941,866.515861,214.2039,6,0
0,0,30,30,21,31,52,156,105,261,0.000333,0.495938,30,44634.44299,2479.691277,1487.814766,245.818752,15,0
0,0,84,84,29,55,84,527,322,849,0.000333,1.809026,70,379895.4244,21105.30136,5427.077492,458.856233,34,0
0,0,12,12,14,19,33,51,37,88,0.000333,0.147969,7,3107.346778,172.630377,443.906683,134.013592,3,0
0,0,4,4,8,10,18,17,13,30,0.000333,0.041699,4,500.391,27.7995,125.09775,57.219281,1,0
0,0,5,5,8,15,23,18,18,36,0.000333,0.054283,4,651.392922,36.188496,162.84823,82.603359,5,0
0,0,3,3,9,13,22,16,16,32,0.000333,0.047567,4,570.807247,31.711514,142.701812,76.635041,1,0
0,0,4,4,11,14,25,28,23,51,0.000333,0.078946,5,1184.183328,65.787963,236.836666,91.356717,2,0
0,0,6,6,20,20,40,58,41,99,0.000333,0.175624,20,10537.41763,585.41209,526.870881,172.877124,6,0
0,0,7,7,19,18,37,61,42,103,0.000333,0.178858,18,9658.32654,536.573697,536.573697,155.769273,7,0
0,0,7,7,19,18,37,60,40,100,0.000333,0.173648,18,9377.016058,520.945337,520.945337,155.769273,7,0
0,0,6,6,19,17,36,57,40,97,0.000333,0.167161,18,9026.689053,501.482725,501.482725,150.197491,6,0
0,0,59,59,29,57,86,463,276,739,0.000333,1.583003,56,265944.5406,14774.6967,4749.009654,473.35618,40,0
0,0,58,58,31,47,78,412,240,652,0.000333,1.366027,75,307356.1685,17075.3427,4098.082247,414.645762,35,0
0,0,3,3,11,10,21,19,14,33,0.000333,0.048315,5,724.732375,40.26291,144.946475,71.273029,2,0
0,0,4,4,11,13,24,27,19,46,0.000333,0.070303,5,1054.541375,58.585632,210.908275,86.159464,1,0
0,0,37,37,21,37,58,182,99,281,0.000333,0.548698,20,32921.85319,1828.991844,1646.09266,284.98844,14,0
0,0,38,38,21,38,59,189,101,290,0.000333,0.568655,20,34119.32969,1895.518316,1705.966484,291.659911,15,0
0,0,45,45,23,47,70,244,132,376,0.000333,0.768203,22,50701.42912,2816.746062,2304.610414,365.107601,21,0
0,0,41,41,21,43,64,207,112,319,0.000333,0.638,20,38280,2126.666667,1914,325.56805,18,0
0,0,37,37,21,37,58,189,102,291,0.000333,0.568224,20,34093.44939,1894.080522,1704.67247,284.98844,14,0
0,0,38,38,21,38,59,196,104,300,0.000333,0.588264,20,35295.8583,1960.881016,1764.792915,291.659911,15,0
0,0,45,45,23,47,70,251,135,386,0.000333,0.788634,22,52049.87138,2891.659521,2365.903245,365.107601,21,0
0,0,41,41,21,43,64,214,115,329,0.000333,0.658,20,39480,2193.333333,1974,325.56805,18,0
0,0,33,33,21,34,55,170,90,260,0.000333,0.501051,20,30063.07051,1670.170584,1503.153526,265.212402,12,0
0,0,34,34,21,35,56,177,92,269,0.000333,0.520726,20,31243.56948,1735.75386,1562.178474,271.763571,13,0
0,0,41,41,23,44,67,232,123,355,0.000333,0.717821,22,47376.15658,2632.008699,2153.461663,344.256916,19,0
0,0,37,37,21,40,61,195,103,298,0.000333,0.58912,20,35347.19453,1963.73303,1767.359727,305.11579,16,0
0,0,28,28,21,30,51,144,77,221,0.000333,0.417869,20,25072.12001,1392.895556,1253.606001,239.445384,10,0
0,0,29,29,21,31,52,151,79,230,0.000333,0.437034,20,26222.0227,1456.779039,1311.101135,245.818752,11,0
0,0,36,36,23,40,63,206,110,316,0.000333,0.629607,22,41554.05003,2308.558335,1888.820456,316.919049,17,0
0,0,32,32,21,36,57,169,90,259,0.000333,0.503573,20,30214.37027,1678.576126,1510.718514,278.355966,14,0
0,0,31,31,21,31,52,166,86,252,0.000333,0.478837,20,28730.21618,1596.123121,1436.510809,245.818752,10,0
0,0,32,32,21,32,53,173,88,261,0.000333,0.498329,20,29899.74477,1661.096932,1494.987239,252.238666,11,0
0,0,39,39,23,41,64,228,119,347,0.000333,0.694,22,45804,2544.666667,2082,323.701557,17,0
0,0,35,35,21,37,58,191,99,290,0.000333,0.566271,20,33976.28977,1887.571654,1698.814489,284.98844,14,0
0,0,36,36,21,36,57,180,97,277,0.000333,0.53857,20,32314.21068,1795.233927,1615.710534,278.355966,14,0
0,0,37,37,21,37,58,187,99,286,0.000333,0.558461,20,33507.65129,1861.536183,1675.382565,284.98844,15,0
0,0,44,44,23,46,69,242,130,372,0.000333,0.757457,22,49992.16415,2777.342453,2272.371098,358.125775,21,0
0,0,40,40,21,42,63,205,110,315,0.000333,0.627614,20,37656.86352,2092.047973,1882.843176,318.715998,18,0
0,0,31,31,18,32,50,156,83,239,0.000333,0.449627,18,24279.86933,1348.881629,1348.881629,235.05865,12,0
0,0,32,32,18,33,51,163,85,248,0.000333,0.46892,18,25321.70673,1406.761485,1406.761485,241.523656,13,0
0,0,39,39,20,42,62,218,116,334,0.000333,0.662901,20,39774.03135,2209.668409,1988.701568,312.915894,19,0
0,0,35,35,18,38,56,181,96,277,0.000333,0.536212,18,28955.47164,1608.637313,1608.637313,274.479896,16,0
0,0,23,23,18,28,46,121,65,186,0.000333,0.342461,18,18492.88543,1027.382524,1027.382524,209.664588,8,0
0,0,24,24,18,29,47,128,67,195,0.000333,0.361048,18,19496.60687,1083.144826,1083.144826,215.940099,9,0
0,0,31,31,20,38,58,183,98,281,0.000333,0.548698,20,32921.85319,1828.991844,1646.09266,285.859807,15,0
0,0,27,27,18,34,52,146,78,224,0.000333,0.425633,18,22984.17294,1276.898497,1276.898497,248.032387,12,0
0,0,5,5,14,21,35,53,31,84,0.000333,0.14362,7,3016.018414,167.556579,430.859773,145.541635,3,0
0,0,21,21,29,28,57,131,68,199,0.000333,0.386915,28,32500.86316,1805.603509,1160.745113,275.487387,10,0
0,0,14,14,23,22,45,89,44,133,0.000333,0.243472,22,16069.16216,892.731231,730.416462,202.149421,5,0
0,0,5,5,15,14,29,36,23,59,0.000333,0.09554,7,2006.346151,111.463675,286.620879,111.906328,2,0
0,0,13,13,25,26,51,128,70,198,0.000333,0.37438,24,26955.36523,1497.52029,1123.140218,238.307837,7,0
0,0,12,12,24,26,50,126,69,195,0.000333,0.366851,24,26413.24697,1467.402609,1100.551957,232.250533,7,0
0,0,24,24,17,38,55,146,64,210,0.000333,0.404695,8,9712.684319,539.593573,1214.08554,268.908114,4,0
0,0,14,14,17,30,47,93,61,154,0.000333,0.285136,16,13686.50693,760.361496,855.406683,216.693586,8,0
0,0,19,19,19,45,64,136,86,222,0.000333,0.444,9,11988,666,1332,327.844012,10,0
0,0,79,79,32,67,99,582,346,928,0.000333,2.050681,80,492163.4355,27342.41308,6152.042943,566.427976,47,0
0,0,79,79,32,68,100,582,347,929,0.000333,2.057381,80,493771.392,27431.744,6172.1424,573.947473,47,0
0,0,79,79,30,62,92,567,336,903,0.000333,1.963592,75,441808.2335,24544.90186,5890.776446,516.366889,47,0
0,0,17,17,16,30,46,75,53,128,0.000333,0.235672,8,5656.127443,314.229302,707.01593,211.206718,4,0
0,0,17,17,16,30,46,73,52,125,0.000333,0.230148,8,5523.561956,306.864553,690.445245,211.206718,4,0
0,0,21,21,18,38,56,97,68,165,0.000333,0.319405,9,8623.922059,479.106781,958.213562,274.479896,7,0
0,0,5,5,9,13,22,24,18,42,0.000333,0.062432,4,749.184512,41.621362,187.296128,76.635041,1,0
0,0,22,22,20,46,66,127,84,211,0.000333,0.425122,10,12753.67159,708.537311,1275.367159,340.522412,13,0
0,0,12,12,19,23,42,65,45,110,0.000333,0.197718,9,5338.394249,296.577458,593.154917,184.752548,6,0
0,0,31,31,31,46,77,193,131,324,0.000333,0.676813,30,60913.16518,3384.064732,2030.438839,407.663936,13,0
0,0,25,25,25,40,65,129,92,221,0.000333,0.443648,24,31942.63888,1774.591049,1330.943287,328.973529,16,0
0,0,25,25,25,41,66,130,94,224,0.000333,0.451315,24,32494.66279,1805.259044,1353.944283,335.756037,16,0
0,0,24,24,27,41,68,144,106,250,0.000333,0.507289,26,39568.50847,2198.25047,1521.86571,348.041595,10,0
0,0,18,18,26,36,62,101,73,174,0.000333,0.345343,26,26936.78411,1496.488006,1036.030158,308.328733,10,0
0,0,24,24,25,40,65,125,89,214,0.000333,0.429596,24,30930.88109,1718.382283,1288.786712,328.973529,16,0
0,0,25,25,29,42,71,146,105,251,0.000333,0.514529,28,43220.42276,2401.134598,1543.586527,367.358781,11,0
0,0,25,25,29,41,70,149,108,257,0.000333,0.525075,28,44106.32059,2450.351144,1575.225735,360.541081,11,0
0,0,23,23,25,40,65,121,87,208,0.000333,0.417551,24,30063.66012,1670.20334,1252.652505,328.973529,15,0
0,0,17,17,24,35,59,100,73,173,0.000333,0.339232,24,24424.73394,1356.929663,1017.697248,289.564006,7,0
0,0,24,24,25,40,65,124,89,213,0.000333,0.427588,24,30786.34426,1710.352459,1282.764344,328.973529,16,0
0,0,21,21,26,45,71,127,100,227,0.000333,0.465331,26,36295.8075,2016.43375,1395.992596,369.344822,25,0
0,0,44,44,26,46,72,262,186,448,0.000333,0.921375,52,143734.5728,7985.254046,2764.126401,376.295283,34,0
0,0,35,35,27,56,83,210,158,368,0.000333,0.782005,26,60996.37728,3388.687627,2346.014511,453.593838,39,0
0,0,29,29,26,45,71,180,129,309,0.000333,0.633424,26,49407.06836,2744.837131,1900.27186,369.344822,20,0
0,0,37,37,31,50,81,222,159,381,0.000333,0.805161,45,108696.7283,6038.707128,2415.482851,435.772895,24,0
0,0,31,31,26,43,69,176,125,301,0.000333,0.612889,26,47805.3124,2655.850689,1838.665861,355.540817,21,0
0,0,37,37,26,50,76,205,146,351,0.000333,0.731008,26,57018.58649,3167.699249,2193.022557,404.404242,29,0
0,0,37,37,26,49,75,205,146,351,0.000333,0.728772,26,56844.19937,3158.011076,2186.31536,397.332215,29,0
0,0,37,37,26,50,76,206,148,354,0.000333,0.737255,26,57505.92483,3194.773602,2211.76634,404.404242,29,0
0,0,36,36,29,50,79,220,160,380,0.000333,0.798479,42,100608.3407,5589.352263,2395.436684,423.074258,23,0
0,0,30,30,27,44,71,177,127,304,0.000333,0.623174,26,48607.60123,2700.422291,1869.523124,368.596954,23,0
0,0,32,32,25,41,66,189,135,324,0.000333,0.652795,36,70501.81301,3916.767389,1958.383695,335.756037,20,0
0,0,36,36,26,49,75,201,143,344,0.000333,0.714238,26,55710.55437,3095.030798,2142.71363,397.332215,29,0
0,0,33,33,26,45,71,207,151,358,0.000333,0.73387,39,85862.76928,4770.153849,2201.609469,369.344822,23,0
0,0,35,35,26,41,67,235,165,400,0.000333,0.808812,52,126174.6552,7009.703065,2426.435676,341.871065,32,0
0,0,37,37,31,51,82,222,159,381,0.000333,0.807409,45,109000.2291,6055.568284,2422.227314,442.873778,24,0
0,0,30,30,26,44,70,180,129,309,0.000333,0.631316,26,49242.65976,2735.70332,1893.948452,362.426424,21,0
0,0,37,37,31,50,81,225,162,387,0.000333,0.817841,45,110408.4878,6133.804878,2453.521951,435.772895,24,0
0,0,35,35,26,49,75,197,141,338,0.000333,0.70178,26,54738.85865,3041.047703,2105.340717,397.332215,28,0
0,0,38,38,25,40,65,233,168,401,0.000333,0.80499,48,115918.5357,6439.918648,2414.969493,328.973529,32,0
0,0,36,36,25,40,65,201,144,345,0.000333,0.692572,36,74797.80824,4155.433791,2077.716895,328.973529,24,0
0,0,29,29,26,44,70,176,127,303,0.000333,0.619058,26,48286.49161,2682.582867,1857.172754,362.426424,20,0
0,0,36,36,26,49,75,200,143,343,0.000333,0.712162,26,55548.60508,3086.033616,2136.484811,397.332215,29,0
0,0,33,33,27,53,80,203,154,357,0.000333,0.752309,26,58680.13658,3260.007588,2256.92833,431.961747,38,0
0,0,19,19,24,38,62,118,89,207,0.000333,0.41084,24,29580.44727,1643.358182,1232.518636,309.460346,7,0
0,0,24,24,23,38,61,130,92,222,0.000333,0.438875,22,28965.72116,1609.206731,1316.623689,303.463171,10,0
0,0,26,26,23,32,55,145,104,249,0.000333,0.479853,33,47505.43277,2639.190709,1439.558569,264.041925,10,0
0,0,71,71,29,47,76,349,269,618,0.000333,1.287073,70,270285.3442,15015.85246,3861.219203,401.947125,24,0
0,0,36,36,27,46,73,190,146,336,0.000333,0.69326,39,81111.46102,4506.192279,2079.781052,382.465813,19,0
0,0,35,35,26,41,67,235,165,400,0.000333,0.808812,52,126174.6552,7009.703065,2426.435676,341.871065,32,0
0,0,31,31,28,53,81,204,152,356,0.000333,0.752329,28,63195.62483,3510.868046,2256.986601,438.185722,38,0
0,0,25,25,27,43,70,174,123,297,0.000333,0.606799,26,47330.32346,2629.462414,1820.397056,361.711347,19,0
0,0,33,33,31,48,79,216,153,369,0.000333,0.775365,45,104674.2793,5815.23774,2326.095096,421.658286,23,0
0,0,27,27,27,42,69,170,119,289,0.000333,0.588455,26,45899.45277,2549.969598,1765.363568,354.859294,20,0
0,0,33,33,27,48,75,199,140,339,0.000333,0.703857,26,54900.80794,3050.044885,2111.569536,396.460163,28,0
0,0,33,33,27,47,74,199,140,339,0.000333,0.701668,26,54730.12197,3040.562331,2105.004691,389.447639,28,0
0,0,33,33,27,48,75,200,142,342,0.000333,0.710085,26,55386.6558,3077.036433,2130.255992,396.460163,28,0
0,0,32,32,29,47,76,214,154,368,0.000333,0.766412,42,96567.96765,5364.887092,2299.237325,401.947125,22,0
0,0,26,26,28,43,71,171,121,292,0.000333,0.598575,28,50280.33245,2793.351803,1795.726159,367.935322,22,0
0,0,28,28,26,39,65,183,129,312,0.000333,0.626326,39,73280.17155,4071.120642,1878.978758,328.342119,19,0
0,0,32,32,27,47,74,195,137,332,0.000333,0.68718,26,53600.00145,2977.777858,2061.538517,389.447639,28,0
0,0,29,29,26,43,69,201,145,346,0.000333,0.704516,39,82428.42902,4579.357168,2113.549462,355.540817,22,0
0,0,31,31,26,38,64,229,159,388,0.000333,0.776,52,121056,6725.333333,2328,321.632678,31,0
0,0,33,33,31,48,79,216,153,369,0.000333,0.775365,45,104674.2793,5815.23774,2326.095096,421.658286,23,0
0,0,26,26,27,43,70,174,123,297,0.000333,0.606799,26,47330.32346,2629.462414,1820.397056,361.711347,20,0
0,0,33,33,31,47,78,219,156,375,0.000333,0.785675,45,106066.1624,5892.56458,2357.025832,414.645762,23,0
0,0,31,31,27,47,74,191,135,326,0.000333,0.674761,26,52631.32673,2923.962596,2024.281797,389.447639,27,0
0,0,34,34,26,41,67,227,162,389,0.000333,0.78657,39,92028.63911,5112.702173,2359.708695,341.871065,31,0
0,0,32,32,26,41,67,195,138,333,0.000333,0.673336,39,78780.30032,4376.683351,2020.0077,341.871065,23,0
0,0,25,25,27,42,69,170,121,291,0.000333,0.592527,26,46217.09604,2567.616447,1777.580617,354.859294,19,0
0,0,32,32,27,47,74,194,137,331,0.000333,0.68511,26,53438.55567,2968.808648,2055.329064,389.447639,28,0
0,0,29,29,28,50,78,197,148,345,0.000333,0.722821,28,60716.98543,3373.165857,2168.463766,416.798747,37,0
0,0,20,20,24,38,62,118,89,207,0.000333,0.41084,24,29580.44727,1643.358182,1232.518636,309.460346,8,0
0,0,38,38,25,40,65,233,168,401,0.000333,0.80499,48,115918.5357,6439.918648,2414.969493,328.973529,32,0
0,0,34,34,27,56,83,202,155,357,0.000333,0.75863,26,59173.116,3287.395333,2275.889077,453.593838,38,0
0,0,28,28,26,45,71,172,126,298,0.000333,0.610875,26,47648.24068,2647.124482,1832.624642,369.344822,19,0
0,0,36,36,31,50,81,214,156,370,0.000333,0.781915,45,105558.5025,5864.361253,2345.744501,435.772895,23,0
0,0,30,30,26,43,69,168,122,290,0.000333,0.590491,26,46058.2744,2558.793022,1771.472092,355.540817,20,0
0,0,36,36,26,50,76,197,143,340,0.000333,0.708098,26,55231.67922,3068.426623,2124.295355,404.404242,28,0
0,0,36,36,26,49,75,197,143,340,0.000333,0.705933,26,55062.75722,3059.042068,2117.798355,397.332215,28,0
0,0,36,36,26,50,76,198,145,343,0.000333,0.714346,26,55719.01757,3095.500976,2143.039137,404.404242,28,0
0,0,35,35,29,50,79,212,157,369,0.000333,0.775365,42,97695.99404,5427.555224,2326.095096,423.074258,22,0
0,0,29,29,27,44,71,169,124,293,0.000333,0.600625,26,46848.77356,2602.709642,1801.875906,368.596954,22,0
0,0,31,31,25,41,66,181,132,313,0.000333,0.630632,36,68108.23294,3783.790719,1891.895359,335.756037,19,0
0,0,35,35,26,49,75,193,140,333,0.000333,0.691399,26,53929.11222,2996.06179,2074.196624,397.332215,28,0
0,0,32,32,26,45,71,199,148,347,0.000333,0.711321,39,83224.52777,4623.584876,2133.96225,369.344822,22,0
0,0,34,34,26,41,67,227,162,389,0.000333,0.78657,39,92028.63911,5112.702173,2359.708695,341.871065,31,0
0,0,36,36,31,51,82,214,156,370,0.000333,0.784098,45,105853.2409,5880.735604,2352.294242,442.873778,23,0
0,0,29,29,26,44,70,172,126,298,0.000333,0.608842,26,47489.68482,2638.315823,1826.526339,362.426424,20,0
0,0,36,36,31,50,81,217,159,376,0.000333,0.794595,45,107270.262,5959.459003,2383.783601,435.772895,23,0
0,0,34,34,26,49,75,189,138,327,0.000333,0.678941,26,52957.41651,2942.078695,2036.823712,397.332215,27,0
0,0,37,37,25,40,65,225,165,390,0.000333,0.782908,48,112738.7255,6263.262526,2348.723447,328.973529,31,0
0,0,35,35,25,40,65,193,141,334,0.000333,0.67049,36,72412.95058,4022.941699,2011.47085,328.973529,23,0
0,0,28,28,26,44,70,168,124,292,0.000333,0.596584,26,46533.51667,2585.19537,1789.750641,362.426424,19,0
0,0,35,35,26,49,75,192,140,332,0.000333,0.689323,26,53767.16294,2987.064608,2067.967805,397.332215,28,0
0,0,32,32,27,53,80,195,151,346,0.000333,0.729129,26,56872.06514,3159.559175,2187.387121,431.961747,37,0
0,0,36,36,25,40,65,201,144,345,0.000333,0.692572,36,74797.80824,4155.433791,2077.716895,328.973529,24,0
0,0,32,32,26,51,77,170,131,301,0.000333,0.628768,26,49043.87147,2724.659526,1886.302749,411.505125,30,0
0,0,26,26,24,39,63,140,102,242,0.000333,0.482167,24,34716.0418,1928.668989,1446.501741,316.169787,11,0
0,0,34,34,29,44,73,182,132,314,0.000333,0.647868,42,81631.40628,4535.078127,1943.604911,381.09644,15,0
0,0,28,28,24,37,61,136,98,234,0.000333,0.462598,24,33307.02089,1850.390049,1387.792537,302.788875,12,0
0,0,34,34,25,44,69,165,119,284,0.000333,0.578274,24,41635.7027,2313.094594,1734.820946,356.311396,20,0
0,0,34,34,25,43,68,165,119,284,0.000333,0.57628,24,41492.14673,2305.119263,1728.839447,349.425789,20,0
0,0,34,34,25,44,69,166,121,287,0.000333,0.584382,24,42075.51646,2337.528692,1753.146519,356.311396,20,0
0,0,33,33,27,44,71,180,133,313,0.000333,0.641624,39,75069.96309,4170.553505,1924.870848,368.596954,14,0
0,0,27,27,26,38,64,137,100,237,0.000333,0.474,26,36972,2054,1422,321.632678,14,0
0,0,29,29,23,35,58,149,108,257,0.000333,0.501834,33,49681.53682,2760.085379,1505.501116,283.566831,11,0
0,0,33,33,25,43,68,161,116,277,0.000333,0.562076,24,40469.45297,2248.302943,1686.227207,349.425789,20,0
0,0,30,30,24,39,63,167,124,291,0.000333,0.579796,36,62617.98448,3478.776915,1739.388458,316.169787,14,0
0,0,32,32,26,41,67,195,138,333,0.000333,0.673336,39,78780.30032,4376.683351,2020.0077,341.871065,23,0
0,0,34,34,29,45,74,182,132,314,0.000333,0.649923,28,54593.51399,3032.972999,1949.768357,388.014838,15,0
0,0,27,27,24,38,62,140,102,242,0.000333,0.480305,24,34581.97217,1921.220676,1440.915507,309.460346,12,0
0,0,34,34,29,44,73,185,135,320,0.000333,0.660248,42,83191.24207,4621.735671,1980.743859,381.09644,15,0
0,0,32,32,25,43,68,157,114,271,0.000333,0.549901,24,39592.85832,2199.60324,1649.70243,349.425789,19,0
0,0,35,35,25,40,65,193,141,334,0.000333,0.67049,36,72412.95058,4022.941699,2011.47085,328.973529,23,0
0,0,33,33,23,34,57,161,117,278,0.000333,0.540514,33,53510.93299,2972.829611,1621.543424,277.015662,15,0
0,0,26,26,24,38,62,136,100,236,0.000333,0.468397,24,33724.5679,1873.587106,1405.190329,309.460346,11,0
0,0,33,33,25,43,68,160,116,276,0.000333,0.560047,24,40323.35386,2240.186326,1680.139744,349.425789,20,0
0,0,30,30,26,48,74,163,127,290,0.000333,0.600247,26,46819.27838,2601.071021,1800.741476,390.289633,29,0
0,0,10,10,15,21,36,55,37,92,0.000333,0.158544,7,3329.431701,184.968428,475.6331,150.842025,5,0
0,0,29,29,31,46,77,183,123,306,0.000333,0.639212,30,57529.10044,3196.061136,1917.636681,407.663936,12,0
0,0,23,23,25,40,65,119,84,203,0.000333,0.407514,24,29340.97599,1630.054221,1222.540666,328.973529,15,0
0,0,23,23,25,41,66,120,86,206,0.000333,0.415048,24,29883.48453,1660.193585,1245.145189,335.756037,15,0
0,0,22,22,27,41,68,134,98,232,0.000333,0.470764,26,36719.57586,2039.976437,1412.291379,348.041595,9,0
0,0,16,16,26,35,61,91,65,156,0.000333,0.308398,13,12027.53532,668.196407,925.195025,301.736338,9,0
0,0,22,22,25,39,64,115,81,196,0.000333,0.392,24,28224,1568,1176,322.227091,15,0
0,0,23,23,29,42,71,136,97,233,0.000333,0.47763,28,40120.95021,2228.941678,1432.891079,367.358781,10,0
0,0,23,23,29,41,70,139,100,239,0.000333,0.4883,28,41017.16195,2278.731219,1464.898641,360.541081,10,0
0,0,21,21,25,39,64,111,79,190,0.000333,0.38,24,27360,1520,1140,322.227091,14,0
0,0,15,15,24,34,58,90,65,155,0.000333,0.302662,12,10895.84465,605.324703,907.987054,283.012837,6,0
0,0,22,22,25,39,64,114,81,195,0.000333,0.39,24,28080,1560,1170,322.227091,15,0
0,0,19,19,26,44,70,117,92,209,0.000333,0.427007,26,33306.52391,1850.36244,1281.020151,362.426424,24,0
0,0,42,42,26,46,72,252,178,430,0.000333,0.884356,39,103469.6423,5748.31346,2653.067751,376.295283,33,0
0,0,33,33,27,55,82,200,150,350,0.000333,0.741714,26,57853.72324,3214.095736,2225.143202,446.356747,38,0
0,0,27,27,26,44,70,170,121,291,0.000333,0.59454,26,46374.15531,2576.341961,1783.621358,362.426424,19,0
0,0,35,35,31,50,81,212,151,363,0.000333,0.767122,45,103561.4498,5753.413878,2301.365551,435.772895,23,0
0,0,29,29,26,42,68,166,117,283,0.000333,0.574251,26,44791.55159,2488.419533,1722.751984,348.688764,20,0
0,0,35,35,26,50,76,195,138,333,0.000333,0.69352,26,54094.55641,3005.253134,2080.559862,404.404242,28,0
0,0,35,35,26,49,75,195,138,333,0.000333,0.691399,26,53929.11222,2996.06179,2074.196624,397.332215,28,0
0,0,35,35,26,50,76,196,140,336,0.000333,0.699768,26,54581.89476,3032.327487,2099.303645,404.404242,28,0
0,0,34,34,29,50,79,210,152,362,0.000333,0.760656,42,95842.6825,5324.593472,2281.968631,423.074258,22,0
0,0,28,28,27,43,70,167,119,286,0.000333,0.584325,26,45577.34851,2532.074917,1752.974943,361.711347,22,0
0,0,31,31,25,41,66,187,132,319,0.000333,0.642721,36,69413.82207,3856.323448,1928.161724,335.756037,20,0
0,0,34,34,26,48,74,191,135,326,0.000333,0.674761,26,52631.32673,2923.962596,2024.281797,390.289633,28,0
0,0,31,31,26,44,70,197,143,340,0.000333,0.694652,39,81274.29281,4515.238489,2083.956226,362.426424,22,0
0,0,33,33,26,40,66,225,157,382,0.000333,0.769653,39,90049.38359,5002.743533,2308.958554,335.088556,31,0
0,0,35,35,31,51,82,212,151,363,0.000333,0.769264,30,69233.74133,3846.318963,2307.791378,442.873778,23,0
0,0,28,28,26,43,69,170,121,291,0.000333,0.592527,26,46217.09604,2567.616447,1777.580617,355.540817,20,0
0,0,35,35,31,50,81,215,154,369,0.000333,0.779802,45,105273.2093,5848.511628,2339.404651,435.772895,23,0
0,0,33,33,26,48,74,187,133,320,0.000333,0.662342,26,51662.652,2870.147333,1987.025077,390.289633,27,0
0,0,36,36,25,39,64,223,160,383,0.000333,0.766,48,110304,6128,2298,322.227091,31,0
0,0,34,34,25,39,64,191,136,327,0.000333,0.654,36,70632,3924,1962,322.227091,23,0
0,0,27,27,26,43,69,166,119,285,0.000333,0.58031,26,45264.16623,2514.675901,1740.92947,355.540817,19,0
0,0,34,34,26,48,74,190,135,325,0.000333,0.672691,26,52469.88094,2914.993386,2018.072344,390.289633,28,0
0,0,31,31,27,52,79,193,146,339,0.000333,0.712327,26,55561.52351,3086.751306,2136.981674,424.804828,37,0
0,0,17,17,24,38,62,108,81,189,0.000333,0.375114,24,27008.23446,1500.45747,1125.343103,309.460346,6,0
0,0,23,23,23,38,61,128,89,217,0.000333,0.42899,22,28313.34005,1572.963336,1286.970002,303.463171,10,0
0,0,25,25,23,32,55,143,101,244,0.000333,0.470217,33,46551.50841,2586.194912,1410.65177,264.041925,10,0
0,0,69,69,29,47,76,339,261,600,0.000333,1.249586,70,262412.9556,14578.49753,3748.756508,401.947125,23,0
0,0,34,34,27,46,73,180,138,318,0.000333,0.656121,39,76766.20418,4264.789121,1968.36421,382.465813,18,0
0,0,33,33,26,40,66,225,157,382,0.000333,0.769653,39,90049.38359,5002.743533,2308.958554,335.088556,31,0
0,0,29,29,28,52,80,194,144,338,0.000333,0.712271,28,59830.72749,3323.929305,2136.811696,431.028803,37,0
0,0,23,23,27,42,69,164,115,279,0.000333,0.568093,26,44311.23641,2461.735356,1704.278323,354.859294,18,0
0,0,31,31,31,48,79,206,145,351,0.000333,0.737542,45,99568.21692,5531.567607,2212.627043,421.658286,22,0
0,0,25,25,27,41,68,160,111,271,0.000333,0.549901,26,42892.26318,2382.90351,1649.70243,348.041595,19,0
0,0,31,31,27,48,75,189,132,321,0.000333,0.666484,26,51985.72079,2888.095599,1999.4508,396.460163,27,0
0,0,31,31,27,47,74,189,132,321,0.000333,0.664412,26,51824.09779,2879.116544,1993.23453,389.447639,27,0
0,0,31,31,27,48,75,190,134,324,0.000333,0.672712,26,52471.56865,2915.087147,2018.137256,396.460163,27,0
0,0,30,30,29,47,76,204,146,350,0.000333,0.728925,42,91844.53445,5102.474136,2186.77463,401.947125,21,0
0,0,24,24,28,42,70,161,113,274,0.000333,0.559808,28,47023.85931,2612.436628,1679.423547,361.08327,21,0
0,0,27,27,26,39,65,181,126,307,0.000333,0.616289,39,72105.80983,4005.878324,1848.866919,328.342119,19,0
0,0,30,30,27,46,73,185,129,314,0.000333,0.647868,26,50533.7277,2807.429317,1943.604911,382.465813,27,0
0,0,27,27,26,42,68,191,137,328,0.000333,0.665563,39,77870.82467,4326.156926,1996.687812,348.688764,21,0
0,0,29,29,26,37,63,219,151,370,0.000333,0.737198,52,115002.8657,6389.048096,2211.593572,314.961207,30,0
0,0,31,31,31,48,79,206,145,351,0.000333,0.737542,45,99568.21692,5531.567607,2212.627043,421.658286,22,0
0,0,24,24,27,42,69,164,115,279,0.000333,0.568093,26,44311.23641,2461.735356,1704.278323,354.859294,19,0
0,0,31,31,31,47,78,209,148,357,0.000333,0.747963,45,100974.9866,5609.72148,2243.888592,414.645762,22,0
0,0,29,29,27,46,73,181,127,308,0.000333,0.635489,26,49568.11507,2753.78417,1906.465964,382.465813,26,0
0,0,32,32,26,40,66,217,154,371,0.000333,0.74749,39,87456.33851,4858.685473,2242.470218,335.088556,30,0
0,0,30,30,26,40,66,185,130,315,0.000333,0.634661,39,74255.38176,4125.298986,1903.984148,335.088556,22,0
0,0,23,23,27,41,68,160,113,273,0.000333,0.553959,26,43208.81125,2400.489514,1661.877356,348.041595,18,0
0,0,30,30,27,46,73,184,129,313,0.000333,0.645805,26,50372.79226,2798.488459,1937.415087,382.465813,27,0
0,0,27,27,28,49,77,187,140,327,0.000333,0.68308,28,57378.69757,3187.70542,2049.239199,409.72672,36,0
0,0,18,18,24,38,62,108,81,189,0.000333,0.375114,24,27008.23446,1500.45747,1125.343103,309.460346,7,0
0,0,36,36,25,39,64,223,160,383,0.000333,0.766,48,110304,6128,2298,322.227091,31,0
0,0,32,32,27,55,82,192,147,339,0.000333,0.718403,26,56035.46337,3113.081298,2155.21013,446.356747,37,0
0,0,26,26,26,44,70,162,118,280,0.000333,0.572066,26,44621.18036,2478.954465,1716.199245,362.426424,18,0
0,0,34,34,31,50,81,204,148,352,0.000333,0.743876,30,66948.81603,3719.378668,2231.627201,435.772895,22,0
0,0,28,28,26,42,68,158,114,272,0.000333,0.55193,26,43050.53721,2391.696512,1655.789893,348.688764,19,0
0,0,34,34,26,50,76,187,135,322,0.000333,0.670611,26,52307.64914,2905.980508,2011.832659,404.404242,27,0
0,0,34,34,26,49,75,187,135,322,0.000333,0.66856,26,52147.67008,2897.092782,2005.679618,397.332215,27,0
0,0,34,34,26,50,76,188,137,325,0.000333,0.676859,26,52794.98749,2933.05486,2030.576442,404.404242,27,0
0,0,33,33,29,50,79,202,149,351,0.000333,0.737542,28,61953.55719,3441.864289,2212.627043,423.074258,21,0
0,0,27,27,27,43,70,159,116,275,0.000333,0.561851,26,43824.37357,2434.687421,1685.55283,361.711347,21,0
0,0,30,30,25,41,66,179,129,308,0.000333,0.620558,36,67020.242,3723.346778,1861.673389,335.756037,19,0
0,0,33,33,26,48,74,183,132,315,0.000333,0.651993,26,50855.42307,2825.301281,1955.97781,390.289633,27,0
0,0,30,30,26,44,70,189,140,329,0.000333,0.672178,39,78644.83039,4369.157244,2016.534113,362.426424,21,0
0,0,32,32,26,40,66,217,154,371,0.000333,0.74749,39,87456.33851,4858.685473,2242.470218,335.088556,30,0
0,0,34,34,31,51,82,204,148,352,0.000333,0.745953,30,67135.74917,3729.763843,2237.858306,442.873778,22,0
0,0,27,27,26,43,69,162,118,280,0.000333,0.570129,26,44470.05805,2470.55878,1710.386848,355.540817,19,0
0,0,34,34,31,50,81,207,151,358,0.000333,0.756555,45,102134.9835,5674.165753,2269.666301,435.772895,22,0
0,0,32,32,26,48,74,179,130,309,0.000333,0.639574,26,49886.74834,2771.486019,1918.72109,390.289633,26,0
0,0,35,35,25,39,64,215,157,372,0.000333,0.744,48,107136,5952,2232,322.227091,30,0
0,0,33,33,25,39,64,183,133,316,0.000333,0.632,36,68256,3792,1896,322.227091,22,0
0,0,26,26,26,43,69,158,116,274,0.000333,0.557912,26,43517.12823,2417.618235,1673.735701,355.540817,18,0
0,0,33,33,26,48,74,182,132,314,0.000333,0.649923,26,50693.97728,2816.332071,1949.768357,390.289633,27,0
0,0,30,30,27,52,79,185,143,328,0.000333,0.689213,26,53758.64222,2986.591234,2067.640085,424.804828,36,0
0,0,34,34,25,39,64,191,136,327,0.000333,0.654,36,70632,3924,1962,322.227091,23,0
0,0,30,30,26,50,76,160,123,283,0.000333,0.589388,26,45972.25064,2554.013925,1768.163486,404.404242,29,0
0,0,24,24,24,38,62,130,94,224,0.000333,0.44458,24,32009.75937,1778.319965,1333.739974,309.460346,10,0
0,0,32,32,29,44,73,172,124,296,0.000333,0.610729,28,51301.26594,2850.07033,1832.188069,381.09644,14,0
0,0,26,26,24,36,60,126,90,216,0.000333,0.425296,24,30621.32085,1701.184492,1275.888369,296.1564,11,0
0,0,32,32,25,44,69,155,111,266,0.000333,0.541623,24,38996.82013,2166.490007,1624.867506,356.311396,19,0
0,0,32,32,25,43,68,155,111,266,0.000333,0.539755,24,38862.36278,2159.020154,1619.265116,349.425789,19,0
0,0,32,32,25,44,69,156,113,269,0.000333,0.547731,24,39436.63389,2190.924105,1643.193079,356.311396,19,0
0,0,31,31,27,44,71,170,125,295,0.000333,0.604725,26,47168.56041,2620.475578,1814.1754,368.596954,13,0
0,0,25,25,26,37,63,127,92,219,0.000333,0.436341,26,34034.63188,1890.812882,1309.024303,314.961207,13,0
0,0,28,28,23,35,58,147,105,252,0.000333,0.49207,33,48714.96996,2706.38722,1476.211211,283.566831,11,0
0,0,31,31,25,42,67,151,108,259,0.000333,0.523706,24,37706.81041,2094.8228,1571.1171,342.573737,19,0
0,0,28,28,24,38,62,157,116,273,0.000333,0.541832,36,58517.84134,3250.991185,1625.495593,309.460346,13,0
0,0,30,30,26,40,66,185,130,315,0.000333,0.634661,39,74255.38176,4125.298986,1903.984148,335.088556,22,0
0,0,32,32,29,45,74,172,124,296,0.000333,0.612666,28,51463.94949,2859.108305,1837.998196,388.014838,14,0
0,0,25,25,24,37,61,130,94,224,0.000333,0.442828,24,31883.64393,1771.313551,1328.485164,302.788875,11,0
0,0,32,32,29,44,73,175,127,302,0.000333,0.623109,28,52341.15647,2907.842026,1869.327017,381.09644,14,0
0,0,30,30,25,42,67,147,106,253,0.000333,0.511574,24,36833.29356,2046.294087,1534.720565,342.573737,18,0
0,0,33,33,25,39,64,183,133,316,0.000333,0.632,36,68256,3792,1896,322.227091,22,0
0,0,31,31,23,33,56,151,109,260,0.000333,0.503304,33,49827.10523,2768.172513,1509.91228,270.506931,14,0
0,0,24,24,24,37,61,126,92,218,0.000333,0.430967,24,31029.61775,1723.867653,1292.90074,302.788875,10,0
0,0,31,31,25,42,67,150,108,258,0.000333,0.521684,24,37561.22427,2086.734682,1565.051011,342.573737,19,0
0,0,28,28,26,47,73,153,119,272,0.000333,0.561211,26,43774.43928,2431.913293,1683.63228,383.277109,28,0
0,0,33,33,23,38,61,206,143,349,0.000333,0.689942,33,68304.30192,3794.68344,2069.827331,303.463171,11,0
0,0,30,30,31,47,78,194,131,325,0.000333,0.680919,30,61282.67163,3404.592869,2042.755721,414.645762,12,0
0,0,24,24,25,41,66,130,92,222,0.000333,0.447285,24,32204.53187,1789.140659,1341.855494,335.756037,15,0
0,0,24,24,25,42,67,131,94,225,0.000333,0.454957,24,32756.88163,1819.826757,1364.870068,342.573737,15,0
0,0,23,23,27,42,69,145,106,251,0.000333,0.51108,26,39864.23061,2214.679478,1533.239639,354.859294,9,0
0,0,17,17,26,36,62,102,73,175,0.000333,0.347328,26,27091.59321,1505.088512,1041.984354,308.328733,9,0
0,0,23,23,25,40,65,126,89,215,0.000333,0.431603,24,31075.41792,1726.412106,1294.80908,328.973529,15,0
0,0,24,24,29,43,72,147,105,252,0.000333,0.518274,28,43534.99081,2418.610601,1554.8211,374.210833,10,0
0,0,24,24,29,42,71,150,108,258,0.000333,0.528878,28,44425.77319,2468.098511,1586.634757,367.358781,10,0
0,0,22,22,25,40,65,122,87,209,0.000333,0.419558,24,30208.19695,1678.233164,1258.674873,328.973529,14,0
0,0,16,16,24,35,59,101,73,174,0.000333,0.341193,24,24565.91737,1364.773187,1023.579891,289.564006,6,0
0,0,23,23,25,40,65,125,89,214,0.000333,0.429596,24,30930.88109,1718.382283,1288.786712,328.973529,15,0
0,0,20,20,26,45,71,128,100,228,0.000333,0.467381,26,36455.70092,2025.316718,1402.142343,369.344822,24,0
0,0,43,43,26,47,73,263,186,449,0.000333,0.92641,39,108390.0179,6021.667658,2779.231227,383.277109,33,0
0,0,34,34,27,56,83,211,158,369,0.000333,0.78413,26,61162.1283,3397.896017,2352.38955,453.593838,38,0
0,0,28,28,26,45,71,181,129,310,0.000333,0.635474,26,49566.96178,2753.720099,1906.421607,369.344822,19,0
0,0,36,36,31,51,82,223,159,382,0.000333,0.809528,45,109286.319,6071.462164,2428.584866,442.873778,23,0
0,0,30,30,26,43,69,177,125,302,0.000333,0.614925,26,47964.13404,2664.674113,1844.774386,355.540817,20,0
0,0,36,36,26,51,77,206,146,352,0.000333,0.735303,26,57353.63042,3186.312801,2205.908862,411.505125,28,0
0,0,36,36,26,50,76,206,146,352,0.000333,0.73309,26,57181.0326,3176.724034,2199.270485,404.404242,28,0
0,0,36,36,26,51,77,207,148,355,0.000333,0.74157,26,57842.43977,3213.468876,2224.709222,411.505125,28,0
0,0,35,35,29,51,80,221,160,381,0.000333,0.802885,42,101163.4934,5620.194076,2408.654604,430.175141,22,0
0,0,29,29,27,44,71,178,127,305,0.000333,0.625224,26,48767.49466,2709.305259,1875.672871,368.596954,22,0
0,0,32,32,25,42,67,198,140,338,0.000333,0.683446,36,73812.17327,4100.676293,2050.338146,342.573737,20,0
0,0,35,35,26,49,75,202,143,345,0.000333,0.716314,26,55872.50365,3104.027981,2148.942448,397.332215,28,0
0,0,32,32,26,45,71,208,151,359,0.000333,0.73592,39,86102.60942,4783.478301,2207.759216,369.344822,22,0
0,0,34,34,26,41,67,236,165,401,0.000333,0.810834,52,126490.0918,7027.227322,2432.501765,341.871065,31,0
0,0,36,36,31,52,83,223,159,382,0.000333,0.811755,45,109586.9278,6088.162657,2435.265063,450.002951,23,0
0,0,29,29,26,44,70,181,129,310,0.000333,0.633359,26,49402.02112,2744.556729,1900.077735,362.426424,20,0
0,0,36,36,31,51,82,226,162,388,0.000333,0.822243,45,111002.858,6166.825444,2466.730178,442.873778,23,0
0,0,34,34,26,49,75,198,141,339,0.000333,0.703857,26,54900.80794,3050.044885,2111.569536,397.332215,27,0
0,0,37,37,25,40,65,234,168,402,0.000333,0.806997,48,116207.6093,6455.978296,2420.991861,328.973529,31,0
0,0,35,35,25,40,65,202,144,346,0.000333,0.69458,36,75014.61348,4167.478527,2083.739263,328.973529,23,0
0,0,28,28,26,44,70,177,127,304,0.000333,0.621101,26,48445.85297,2691.436276,1863.302037,362.426424,19,0
0,0,35,35,26,49,75,201,143,344,0.000333,0.714238,26,55710.55437,3095.030798,2142.71363,397.332215,28,0
0,0,32,32,27,53,80,204,154,358,0.000333,0.754417,26,58844.50671,3269.139262,2263.250258,431.961747,37,0
0,0,18,18,24,39,63,119,89,208,0.000333,0.414425,24,29838.58138,1657.698965,1243.274224,316.169787,6,0
0,0,24,24,23,39,62,139,97,236,0.000333,0.468397,22,30914.18724,1717.454847,1405.190329,310.172612,10,0
0,0,26,26,23,33,56,154,109,263,0.000333,0.509111,33,50402.03337,2800.112965,1527.334345,270.506931,10,0
0,0,70,70,29,48,77,350,269,619,0.000333,1.293047,70,271539.8608,15085.54782,3879.140869,408.959649,23,0
0,0,35,35,27,47,74,191,146,337,0.000333,0.697529,39,81610.84558,4533.935866,2092.585784,389.447639,18,0
0,0,34,34,26,41,67,236,165,401,0.000333,0.810834,52,126490.0918,7027.227322,2432.501765,341.871065,31,0
0,0,30,30,28,53,81,205,152,357,0.000333,0.754442,28,63373.14063,3520.730035,2263.326451,438.185722,37,0
0,0,24,24,27,43,70,175,123,298,0.000333,0.608842,26,47489.68482,2638.315823,1826.526339,361.711347,18,0
0,0,32,32,31,49,80,217,153,370,0.000333,0.779704,45,105260.1028,5847.783488,2339.113395,428.700868,22,0
0,0,26,26,27,42,69,171,119,290,0.000333,0.590491,26,46058.2744,2558.793022,1771.472092,354.859294,19,0
0,0,32,32,27,49,76,200,140,340,0.000333,0.708098,26,55231.67922,3068.426623,2124.295355,403.502745,27,0
0,0,32,32,27,48,75,200,140,340,0.000333,0.705933,26,55062.75722,3059.042068,2117.798355,396.460163,27,0
0,0,32,32,27,49,76,201,142,343,0.000333,0.714346,26,55719.01757,3095.500976,2143.039137,403.502745,27,0
0,0,31,31,29,48,77,215,154,369,0.000333,0.770815,42,97122.65781,5395.703212,2312.444234,408.959649,21,0
0,0,25,25,28,43,71,172,121,293,0.000333,0.600625,28,50452.52537,2802.918076,1801.875906,367.935322,21,0
0,0,28,28,26,40,66,192,134,326,0.000333,0.656824,39,76848.42683,4269.357046,1970.472483,335.088556,19,0
0,0,31,31,27,47,74,196,137,333,0.000333,0.689249,26,53761.44724,2986.747069,2067.747971,389.447639,27,0
0,0,28,28,26,43,69,202,145,347,0.000333,0.706553,39,82666.66147,4592.592304,2119.657987,355.540817,21,0
0,0,30,30,26,38,64,230,159,389,0.000333,0.778,52,121368,6742.666667,2334,321.632678,30,0
0,0,32,32,31,49,80,217,153,370,0.000333,0.779704,45,105260.1028,5847.783488,2339.113395,428.700868,22,0
0,0,25,25,27,43,70,175,123,298,0.000333,0.608842,26,47489.68482,2638.315823,1826.526339,361.711347,19,0
0,0,32,32,31,48,79,220,156,376,0.000333,0.790074,45,106659.9703,5925.553903,2370.221561,421.658286,22,0
0,0,30,30,27,47,74,192,135,327,0.000333,0.67683,26,52792.77252,2932.931806,2030.491251,389.447639,26,0
0,0,33,33,26,41,67,228,162,390,0.000333,0.788592,39,92265.21659,5125.845366,2365.774784,341.871065,30,0
0,0,31,31,26,41,67,196,138,334,0.000333,0.675358,39,79016.8778,4389.826544,2026.07379,341.871065,22,0
0,0,24,24,27,42,69,171,121,292,0.000333,0.594563,26,46375.91768,2576.439871,1783.689141,354.859294,18,0
0,0,31,31,27,47,74,195,137,332,0.000333,0.68718,26,53600.00145,2977.777858,2061.538517,389.447639,27,0
0,0,28,28,28,50,78,198,148,346,0.000333,0.724916,28,60892.9767,3382.94315,2174.749168,416.798747,36,0
0,0,19,19,24,39,63,119,89,208,0.000333,0.414425,24,29838.58138,1657.698965,1243.274224,316.169787,7,0
0,0,37,37,25,40,65,234,168,402,0.000333,0.806997,48,116207.6093,6455.978296,2420.991861,328.973529,31,0
0,0,33,33,27,56,83,203,155,358,0.000333,0.760755,26,59338.86703,3296.603724,2282.264116,453.593838,37,0
0,0,27,27,26,45,71,173,126,299,0.000333,0.612925,26,47808.13411,2656.00745,1838.774389,369.344822,18,0
0,0,35,35,31,51,82,215,156,371,0.000333,0.786217,45,106139.3307,5896.629484,2358.651794,442.873778,22,0
0,0,29,29,26,43,69,169,122,291,0.000333,0.592527,26,46217.09604,2567.616447,1777.580617,355.540817,19,0
0,0,35,35,26,51,77,198,143,341,0.000333,0.712325,26,55561.32947,3086.740526,2136.97421,411.505125,27,0
0,0,35,35,26,50,76,198,143,341,0.000333,0.710181,26,55394.12533,3077.451407,2130.543282,404.404242,27,0
0,0,35,35,26,51,77,199,145,344,0.000333,0.718592,26,56050.13882,3113.896601,2155.77457,411.505125,27,0
0,0,34,34,29,51,80,213,157,370,0.000333,0.779704,42,98242.7626,5457.931255,2339.113395,430.175141,21,0
0,0,28,28,27,44,71,170,124,294,0.000333,0.602675,26,47008.66698,2611.59261,1808.025653,368.596954,21,0
0,0,31,31,25,42,67,190,137,327,0.000333,0.661204,36,71410.00195,3967.222331,1983.611165,342.573737,19,0
0,0,34,34,26,49,75,194,140,334,0.000333,0.693475,26,54091.06151,3005.058973,2080.425443,397.332215,27,0
0,0,31,31,26,45,71,200,148,348,0.000333,0.713371,39,83464.36791,4636.909328,2140.111998,369.344822,21,0
0,0,33,33,26,41,67,228,162,390,0.000333,0.788592,39,92265.21659,5125.845366,2365.774784,341.871065,30,0
0,0,35,35,31,52,83,215,156,371,0.000333,0.78838,45,106431.2833,5912.849073,2365.139629,450.002951,22,0
0,0,28,28,26,44,70,173,126,299,0.000333,0.610885,26,47649.04617,2647.169232,1832.655622,362.426424,19,0
0,0,35,35,31,51,82,218,159,377,0.000333,0.798932,45,107855.8698,5991.992764,2396.797106,442.873778,22,0
0,0,33,33,26,49,75,190,138,328,0.000333,0.681018,26,53119.36579,2951.075877,2043.05253,397.332215,26,0
0,0,36,36,25,40,65,226,165,391,0.000333,0.784915,48,113027.7991,6279.322173,2354.745815,328.973529,30,0
0,0,34,34,25,40,65,194,141,335,0.000333,0.672498,36,72629.75583,4034.986435,2017.493217,328.973529,22,0
0,0,27,27,26,44,70,169,124,293,0.000333,0.598627,26,46692.87802,2594.048779,1795.879924,362.426424,18,0
0,0,34,34,26,49,75,193,140,333,0.000333,0.691399,26,53929.11222,2996.06179,2074.196624,397.332215,27,0
0,0,31,31,27,53,80,196,151,347,0.000333,0.731236,26,57036.43527,3168.690848,2193.709049,431.961747,36,0
0,0,35,35,25,40,65,202,144,346,0.000333,0.69458,36,75014.61348,4167.478527,2083.739263,328.973529,23,0
0,0,31,31,26,51,77,171,131,302,0.000333,0.630857,26,49206.80792,2733.711551,1892.569535,411.505125,29,0
0,0,25,25,24,39,63,141,102,243,0.000333,0.48416,24,34859.49651,1936.638695,1452.479021,316.169787,10,0
0,0,33,33,29,45,74,183,132,315,0.000333,0.651993,28,54767.37869,3042.632149,1955.97781,388.014838,14,0
0,0,27,27,24,37,61,137,98,235,0.000333,0.464574,24,33449.35858,1858.297699,1393.723274,302.788875,11,0
0,0,33,33,25,45,70,166,119,285,0.000333,0.582282,24,41924.29584,2329.127546,1746.84566,363.229794,19,0
0,0,33,33,25,44,69,166,119,285,0.000333,0.58031,24,41782.30728,2321.239294,1740.92947,356.311396,19,0
0,0,33,33,25,45,70,167,121,288,0.000333,0.588411,24,42365.60421,2353.644679,1765.233509,363.229794,19,0
0,0,32,32,27,45,72,181,133,314,0.000333,0.645785,26,50371.26771,2798.403762,1937.35645,375.515352,13,0
0,0,26,26,26,38,64,138,100,238,0.000333,0.476,26,37128,2062.666667,1428,321.632678,13,0
0,0,29,29,23,36,59,158,113,271,0.000333,0.531399,33,52608.47679,2922.693155,1594.196266,290.159225,11,0
0,0,32,32,25,43,68,162,116,278,0.000333,0.564105,24,40615.55208,2256.41956,1692.31467,349.425789,19,0
0,0,29,29,24,39,63,168,124,292,0.000333,0.581789,36,62833.16656,3490.731475,1745.365738,316.169787,13,0
0,0,31,31,26,41,67,196,138,334,0.000333,0.675358,39,79016.8778,4389.826544,2026.07379,341.871065,22,0
0,0,33,33,29,46,75,183,132,315,0.000333,0.654026,28,54938.18085,3052.121158,1962.077888,394.965299,14,0
0,0,26,26,24,38,62,141,102,243,0.000333,0.48229,24,34724.87288,1929.159605,1446.869703,309.460346,11,0
0,0,33,33,29,45,74,186,135,321,0.000333,0.664412,42,83715.85028,4650.880571,1993.23453,388.014838,14,0
0,0,31,31,25,43,68,158,114,272,0.000333,0.55193,24,39738.95743,2207.719857,1655.789893,349.425789,18,0
0,0,34,34,25,40,65,194,141,335,0.000333,0.672498,36,72629.75583,4034.986435,2017.493217,328.973529,22,0
0,0,32,32,23,34,57,162,117,279,0.000333,0.542459,33,53703.41836,2983.523242,1627.376314,277.015662,14,0
0,0,25,25,24,38,62,137,100,237,0.000333,0.470382,24,33867.46861,1881.526034,1411.144526,309.460346,10,0
0,0,32,32,25,43,68,161,116,277,0.000333,0.562076,24,40469.45297,2248.302943,1686.227207,349.425789,19,0
0,0,29,29,26,48,74,164,127,291,0.000333,0.602317,26,46980.72416,2610.040231,1806.950929,390.289633,28,0
0,0,33,33,25,38,63,210,145,355,0.000333,0.707311,36,76389.63742,4243.868746,2121.934373,315.51765,12,0
0,0,30,30,31,47,78,198,133,331,0.000333,0.693489,30,62414.04403,3467.446891,2080.468134,414.645762,13,0
0,0,24,24,25,41,66,134,94,228,0.000333,0.459374,24,33074.92462,1837.495812,1378.121859,335.756037,16,0
0,0,24,24,25,42,67,135,96,231,0.000333,0.467089,24,33630.39847,1868.355471,1401.266603,342.573737,16,0
0,0,23,23,27,42,69,149,108,257,0.000333,0.523297,26,40817.16042,2267.620023,1569.890785,354.859294,10,0
0,0,17,17,26,36,62,106,75,181,0.000333,0.359237,26,28020.44784,1556.691546,1077.709532,308.328733,10,0
0,0,23,23,25,40,65,130,91,221,0.000333,0.443648,24,31942.63888,1774.591049,1330.943287,328.973529,16,0
0,0,24,24,29,43,72,151,107,258,0.000333,0.530614,28,44571.53821,2476.196567,1591.84065,374.210833,11,0
0,0,24,24,29,42,71,154,110,264,0.000333,0.541178,28,45458.93071,2525.49615,1623.53324,367.358781,11,0
0,0,22,22,25,40,65,126,89,215,0.000333,0.431603,24,31075.41792,1726.412106,1294.80908,328.973529,15,0
0,0,16,16,24,35,59,105,75,180,0.000333,0.352959,24,25413.01797,1411.834332,1058.875749,289.564006,7,0
0,0,23,23,25,40,65,129,91,220,0.000333,0.44164,24,31798.10205,1766.561225,1324.920919,328.973529,16,0
0,0,20,20,26,45,71,132,102,234,0.000333,0.47968,26,37415.06148,2078.614526,1439.040826,369.344822,25,0
0,0,43,43,26,47,73,267,188,455,0.000333,0.93879,52,146451.2491,8136.180504,2816.370174,383.277109,34,0
0,0,34,34,27,56,83,215,160,375,0.000333,0.79688,26,62156.63446,3453.146359,2390.639787,453.593838,39,0
0,0,28,28,26,45,71,185,131,316,0.000333,0.647773,26,50526.32233,2807.017907,1943.32009,369.344822,20,0
0,0,36,36,31,51,82,227,161,388,0.000333,0.822243,45,111002.858,6166.825444,2466.730178,442.873778,24,0
0,0,30,30,26,43,69,181,127,308,0.000333,0.627142,26,48917.06385,2717.614658,1881.425533,355.540817,21,0
0,0,36,36,26,51,77,210,148,358,0.000333,0.747837,26,58331.24912,3240.624951,2243.509582,411.505125,29,0
0,0,36,36,26,50,76,210,148,358,0.000333,0.745586,26,58155.7093,3230.872739,2236.75805,404.404242,29,0
0,0,36,36,26,51,77,211,150,361,0.000333,0.754103,26,58820.05847,3267.781026,2262.309941,411.505125,29,0
0,0,35,35,29,51,80,225,162,387,0.000333,0.815529,42,102756.6193,5708.70107,2446.586173,430.175141,23,0
0,0,29,29,27,44,71,182,129,311,0.000333,0.637524,26,49726.85521,2762.603067,1912.571354,368.596954,23,0
0,0,31,31,25,42,67,194,137,331,0.000333,0.669292,36,72283.51879,4015.751044,2007.875522,342.573737,20,0
0,0,35,35,26,49,75,206,145,351,0.000333,0.728772,26,56844.19937,3158.011076,2186.31536,397.332215,29,0
0,0,32,32,26,45,71,212,153,365,0.000333,0.748219,39,87541.65025,4863.425014,2244.657699,369.344822,23,0
0,0,34,34,26,41,67,240,167,407,0.000333,0.822966,52,128382.7116,7132.372868,2468.898301,341.871065,32,0
0,0,36,36,31,52,83,227,161,388,0.000333,0.824505,45,111308.1885,6183.788248,2473.515299,450.002951,24,0
0,0,29,29,26,44,70,185,131,316,0.000333,0.645618,26,50358.18927,2797.677182,1936.853433,362.426424,21,0
0,0,36,36,31,51,82,230,164,394,0.000333,0.834958,45,112719.397,6262.188725,2504.87549,442.873778,24,0
0,0,34,34,26,49,75,202,143,345,0.000333,0.716314,26,55872.50365,3104.027981,2148.942448,397.332215,28,0
0,0,37,37,25,40,65,238,170,408,0.000333,0.819042,48,117942.0513,6552.336181,2457.126068,328.973529,32,0
0,0,35,35,25,40,65,206,146,352,0.000333,0.706624,36,76315.44493,4239.74694,2119.87347,328.973529,24,0
0,0,28,28,26,44,70,181,129,310,0.000333,0.633359,26,49402.02112,2744.556729,1900.077735,362.426424,20,0
0,0,35,35,26,49,75,205,145,350,0.000333,0.726696,26,56682.25008,3149.013894,2180.086542,397.332215,29,0
0,0,32,32,27,53,80,208,156,364,0.000333,0.767061,26,59830.72749,3323.929305,2301.181827,431.961747,38,0
0,0,18,18,24,39,63,123,91,214,0.000333,0.426379,24,30699.30969,1705.517205,1279.137904,316.169787,7,0
0,0,23,23,23,39,62,135,94,229,0.000333,0.454504,22,29997.24101,1666.51339,1363.510955,310.172612,10,0
0,0,25,25,23,33,56,150,106,256,0.000333,0.495561,33,49060.53438,2725.585243,1486.68286,270.506931,10,0
0,0,70,70,29,48,77,354,271,625,0.000333,1.305581,70,274171.9112,15231.77284,3916.741588,408.959649,24,0
0,0,35,35,27,47,74,195,148,343,0.000333,0.709948,39,83063.85767,4614.65876,2129.842504,389.447639,19,0
0,0,34,34,26,41,67,240,167,407,0.000333,0.822966,52,128382.7116,7132.372868,2468.898301,341.871065,32,0
0,0,30,30,28,53,81,209,154,363,0.000333,0.767122,28,64438.23543,3579.901968,2301.365551,438.185722,38,0
0,0,24,24,27,43,70,179,125,304,0.000333,0.621101,26,48445.85297,2691.436276,1863.302037,361.711347,19,0
0,0,32,32,31,49,80,221,155,376,0.000333,0.792348,45,106967.0234,5942.612409,2377.044964,428.700868,23,0
0,0,26,26,27,42,69,175,121,296,0.000333,0.602708,26,47011.20422,2611.733568,1808.123239,354.859294,20,0
0,0,32,32,27,49,76,204,142,346,0.000333,0.720594,26,56206.35591,3122.575328,2161.78292,403.502745,28,0
0,0,32,32,27,48,75,204,142,346,0.000333,0.71839,26,56034.45294,3113.025163,2155.171267,396.460163,28,0
0,0,32,32,27,49,76,205,144,349,0.000333,0.726842,26,56693.69426,3149.649681,2180.526702,403.502745,28,0
0,0,31,31,29,48,77,219,156,375,0.000333,0.783348,42,98701.88802,5483.438223,2350.044953,408.959649,22,0
0,0,25,25,28,43,71,176,123,299,0.000333,0.612925,28,51485.68288,2860.315716,1838.774389,367.935322,22,0
0,0,27,27,26,40,66,188,131,319,0.000333,0.642721,39,75198.30724,4177.683735,1928.161724,335.088556,19,0
0,0,31,31,27,47,74,200,139,339,0.000333,0.701668,26,54730.12197,3040.562331,2105.004691,389.447639,28,0
0,0,28,28,26,43,69,206,147,353,0.000333,0.71877,39,84096.0562,4672.003122,2156.309133,355.540817,22,0
0,0,30,30,26,38,64,234,161,395,0.000333,0.79,52,123240,6846.666667,2370,321.632678,31,0
0,0,32,32,31,49,80,221,155,376,0.000333,0.792348,45,106967.0234,5942.612409,2377.044964,428.700868,23,0
0,0,25,25,27,43,70,179,125,304,0.000333,0.621101,26,48445.85297,2691.436276,1863.302037,361.711347,20,0
0,0,32,32,31,48,79,224,158,382,0.000333,0.802681,45,108361.9911,6020.110615,2408.044246,421.658286,23,0
0,0,30,30,27,47,74,196,137,333,0.000333,0.689249,26,53761.44724,2986.747069,2067.747971,389.447639,27,0
0,0,33,33,26,41,67,232,164,396,0.000333,0.800724,52,124912.9086,6939.606034,2402.171319,341.871065,31,0
0,0,31,31,26,41,67,200,140,340,0.000333,0.68749,39,80436.34267,4468.685704,2062.470325,341.871065,23,0
0,0,24,24,27,42,69,175,123,298,0.000333,0.60678,26,47328.84749,2629.380416,1820.340288,354.859294,19,0
0,0,31,31,27,47,74,199,139,338,0.000333,0.699598,26,54568.67618,3031.593121,2098.795238,389.447639,28,0
0,0,28,28,28,50,78,202,150,352,0.000333,0.737487,42,92923.3864,5162.410356,2212.461581,416.798747,37,0
0,0,19,19,24,39,63,123,91,214,0.000333,0.426379,24,30699.30969,1705.517205,1279.137904,316.169787,8,0
0,0,37,37,25,40,65,238,170,408,0.000333,0.819042,48,117942.0513,6552.336181,2457.126068,328.973529,32,0
0,0,33,33,27,56,83,207,157,364,0.000333,0.773505,26,60333.37318,3351.854065,2320.514353,453.593838,38,0
0,0,27,27,26,45,71,177,128,305,0.000333,0.625224,26,48767.49466,2709.305259,1875.672871,369.344822,19,0
0,0,35,35,31,51,82,219,158,377,0.000333,0.798932,45,107855.8698,5991.992764,2396.797106,442.873778,23,0
0,0,29,29,26,43,69,173,124,297,0.000333,0.604744,26,47170.02586,2620.556992,1814.231764,355.540817,20,0
0,0,35,35,26,51,77,202,145,347,0.000333,0.724858,26,56538.94817,3141.052676,2174.57493,411.505125,28,0
0,0,35,35,26,50,76,202,145,347,0.000333,0.722677,26,56368.80203,3131.600113,2168.030847,404.404242,28,0
0,0,35,35,26,51,77,203,147,350,0.000333,0.731125,26,57027.75752,3168.208751,2193.375289,411.505125,28,0
0,0,34,34,29,51,80,217,159,376,0.000333,0.792348,42,99835.88847,5546.438249,2377.044964,430.175141,22,0
0,0,28,28,27,44,71,174,126,300,0.000333,0.614975,26,47968.02753,2664.890418,1844.924136,368.596954,22,0
0,0,30,30,25,42,67,186,134,320,0.000333,0.64705,36,69881.34747,3882.297082,1941.148541,342.573737,19,0
0,0,34,34,26,49,75,198,142,340,0.000333,0.705933,26,55062.75722,3059.042068,2117.798355,397.332215,28,0
0,0,31,31,26,45,71,204,150,354,0.000333,0.72567,39,84903.40873,4716.856041,2177.01048,369.344822,22,0
0,0,33,33,26,41,67,232,164,396,0.000333,0.800724,52,124912.9086,6939.606034,2402.171319,341.871065,31,0
0,0,35,35,31,52,83,219,158,377,0.000333,0.80113,45,108152.544,6008.474664,2403.389866,450.002951,23,0
0,0,28,28,26,44,70,177,128,305,0.000333,0.623144,26,48605.21432,2700.289685,1869.43132,362.426424,20,0
0,0,35,35,31,51,82,222,161,383,0.000333,0.811647,45,109572.4088,6087.356044,2434.942418,442.873778,23,0
0,0,33,33,26,49,75,194,140,334,0.000333,0.693475,26,54091.06151,3005.058973,2080.425443,397.332215,27,0
0,0,36,36,25,40,65,230,167,397,0.000333,0.79696,48,114762.241,6375.680058,2390.880022,328.973529,31,0
0,0,34,34,25,40,65,198,143,341,0.000333,0.684542,36,73930.58727,4107.254848,2053.627424,328.973529,23,0
0,0,27,27,26,44,70,173,126,299,0.000333,0.610885,26,47649.04617,2647.169232,1832.655622,362.426424,19,0
0,0,34,34,26,49,75,197,142,339,0.000333,0.703857,26,54900.80794,3050.044885,2111.569536,397.332215,28,0
0,0,31,31,27,53,80,200,153,353,0.000333,0.74388,26,58022.65606,3223.480892,2231.640617,431.961747,37,0
0,0,35,35,25,40,65,206,146,352,0.000333,0.706624,36,76315.44493,4239.74694,2119.87347,328.973529,24,0
0,0,31,31,26,51,77,175,133,308,0.000333,0.64339,26,50184.42662,2788.023701,1930.170255,411.505125,30,0
0,0,25,25,24,39,63,145,104,249,0.000333,0.496114,24,35720.22482,1984.456935,1488.342701,316.169787,11,0
0,0,33,33,29,45,74,187,134,321,0.000333,0.664412,28,55810.56685,3100.587047,1993.23453,388.014838,15,0
0,0,27,27,24,37,61,141,100,241,0.000333,0.476436,24,34303.38476,1905.743598,1429.307698,302.788875,12,0
0,0,33,33,25,45,70,170,121,291,0.000333,0.59454,24,42806.91259,2378.161811,1783.621358,363.229794,20,0
0,0,33,33,25,44,69,170,121,291,0.000333,0.592527,24,42661.93481,2370.107489,1777.580617,356.311396,20,0
0,0,33,33,25,45,70,171,123,294,0.000333,0.60067,24,43248.22097,2402.678943,1802.009207,363.229794,20,0
0,0,32,32,27,45,72,185,135,320,0.000333,0.658125,39,77000.66402,4277.814668,1974.376,375.515352,14,0
0,0,26,26,26,38,64,142,102,244,0.000333,0.488,26,38064,2114.666667,1464,321.632678,14,0
0,0,28,28,23,36,59,154,110,264,0.000333,0.517673,33,51249.58625,2847.199236,1553.017765,290.159225,11,0
0,0,32,32,25,43,68,166,118,284,0.000333,0.57628,24,41492.14673,2305.119263,1728.839447,349.425789,20,0
0,0,29,29,24,39,63,172,126,298,0.000333,0.593743,36,64124.25902,3562.458834,1781.229417,316.169787,14,0
0,0,31,31,26,41,67,200,140,340,0.000333,0.68749,39,80436.34267,4468.685704,2062.470325,341.871065,23,0
0,0,33,33,29,46,75,187,134,321,0.000333,0.666484,28,55984.62239,3110.256799,1999.4508,394.965299,15,0
0,0,26,26,24,38,62,145,104,249,0.000333,0.494198,24,35582.27715,1976.793175,1482.594881,309.460346,12,0
0,0,33,33,29,45,74,190,137,327,0.000333,0.67683,42,85280.63252,4737.812918,2030.491251,388.014838,15,0
0,0,31,31,25,43,68,162,116,278,0.000333,0.564105,24,40615.55208,2256.41956,1692.31467,349.425789,19,0
0,0,34,34,25,40,65,198,143,341,0.000333,0.684542,36,73930.58727,4107.254848,2053.627424,328.973529,23,0
0,0,32,32,23,34,57,166,119,285,0.000333,0.554125,33,54858.33058,3047.685032,1662.373654,277.015662,15,0
0,0,25,25,24,38,62,141,102,243,0.000333,0.48229,24,34724.87288,1929.159605,1446.869703,309.460346,11,0
0,0,32,32,25,43,68,165,118,283,0.000333,0.574251,24,41346.04762,2297.002645,1722.751984,349.425789,20,0
0,0,29,29,26,48,74,168,129,297,0.000333,0.614736,26,47949.39889,2663.855494,1844.20765,390.289633,29,0
0,0,68,68,34,80,114,541,370,911,0.000333,2.074921,68,423283.8706,23515.77059,6224.762803,678.727984,26,0
0,0,63,63,34,78,112,498,345,843,0.000333,1.912867,68,390224.8136,21679.15631,5738.600199,663.23511,24,0
0,0,66,66,34,79,113,523,359,882,0.000333,2.005133,68,409047.0535,22724.8363,6015.397845,670.972416,25,0
0,0,64,64,35,78,113,508,349,857,0.000333,1.948298,68,397452.7492,22080.70829,5844.893371,669.786279,24,0
0,0,11,11,18,20,38,68,45,113,0.000333,0.197672,18,10674.28456,593.015809,593.015809,161.497212,5,0
0,0,57,57,37,56,93,489,323,812,0.000333,1.769932,90,477881.7259,26548.98477,5309.796955,517.96165,26,0
0,0,53,53,35,73,108,443,297,740,0.000333,1.666206,68,339905.9391,18883.66328,4998.616752,631.382098,20,0
0,0,11,11,20,26,46,88,63,151,0.000333,0.278019,20,16681.15711,926.73095,834.057855,208.649995,3,0
0,0,49,49,31,46,77,314,184,498,0.000333,1.040287,60,187251.5818,10402.86566,3120.859697,407.663936,21,0
0,0,19,19,24,31,55,166,104,270,0.000333,0.520322,36,56194.81642,3121.934245,1560.967123,263.619186,7,0
0,0,49,49,31,46,77,314,184,498,0.000333,1.040287,60,187251.5818,10402.86566,3120.859697,407.663936,21,0
0,0,50,50,30,44,74,294,163,457,0.000333,0.945907,45,127697.4085,7094.30047,2837.720188,387.421709,21,0
0,0,41,41,31,47,78,549,308,857,0.000333,1.79553,90,484793.0731,26932.94851,5386.589702,414.645762,15,0
0,0,44,44,32,53,85,453,285,738,0.000333,1.57671,80,378410.4409,21022.80227,4730.130511,463.579784,16,0
0,0,43,43,31,41,72,287,162,449,0.000333,0.923432,45,124663.3347,6925.740814,2770.296326,373.239718,19,0
0,0,13,13,21,26,47,139,82,221,0.000333,0.409188,30,36826.92409,2045.940227,1227.564136,214.450099,5,0
0,0,43,43,31,41,72,287,162,449,0.000333,0.923432,45,124663.3347,6925.740814,2770.296326,373.239718,19,0
0,0,44,44,30,39,69,267,141,408,0.000333,0.830759,45,112152.509,6230.694946,2492.277978,353.337404,19,0
0,0,47,47,31,43,74,281,167,448,0.000333,0.927278,45,125182.5799,6954.58777,2781.835108,386.90947,21,0
0,0,17,17,24,28,52,133,87,220,0.000333,0.418032,36,45147.48257,2508.193476,1254.096738,244.645038,7,0
0,0,47,47,31,43,74,281,167,448,0.000333,0.927278,45,125182.5799,6954.58777,2781.835108,386.90947,21,0
0,0,48,48,30,41,71,261,146,407,0.000333,0.834316,45,112632.6185,6257.367694,2502.947078,366.86635,21,0
0,0,41,41,31,38,69,232,137,369,0.000333,0.751349,45,101432.0486,5635.113811,2254.045525,353.001331,19,0
0,0,11,11,20,23,43,84,57,141,0.000333,0.255034,20,15302.06661,850.114812,765.10333,190.480487,5,0
0,0,41,41,31,38,69,232,137,369,0.000333,0.751349,45,101432.0486,5635.113811,2254.045525,353.001331,19,0
0,0,42,42,30,36,66,212,116,328,0.000333,0.660854,45,89215.2572,4956.403178,1982.561271,333.324018,19,0
0,0,51,51,33,60,93,623,346,969,0.000333,2.112148,80,506915.591,28161.97728,6336.444888,520.878442,25,0
0,0,60,60,32,69,101,562,351,913,0.000333,2.026316,80,486315.7667,27017.54259,6078.947084,581.488188,26,0
0,0,63,63,33,67,100,569,357,926,0.000333,2.050737,80,492176.8665,27343.15925,6152.210832,572.892982,30,0
0,0,52,52,32,55,87,577,324,901,0.000333,1.935031,80,464407.3672,25800.40929,5805.09209,477.974784,19,0
0,0,61,61,33,65,98,516,329,845,0.000333,1.863143,80,447154.3855,24841.9103,5589.429818,557.918914,20,0
0,0,64,64,34,63,97,523,335,858,0.000333,1.887575,85,481331.6436,26740.64687,5662.725219,549.542372,24,0
0,0,66,66,33,74,107,582,368,950,0.000333,2.134798,64,409881.1928,22771.17738,6404.393637,625.964555,25,0
0,0,69,69,34,72,106,589,374,963,0.000333,2.159662,85,550713.9288,30595.21827,6478.987398,617.208337,29,0
0,0,20,20,22,46,68,171,103,274,0.000333,0.555988,22,36695.22601,2038.623667,1667.964819,352.191346,16,0
0,0,20,20,23,44,67,169,99,268,0.000333,0.541904,22,35765.66187,1986.981215,1625.711903,344.256916,16,0
0,0,14,14,22,42,64,149,90,239,0.000333,0.478,22,31548,1752.666667,1434,324.584827,15,0
0,0,18,18,21,34,55,123,73,196,0.000333,0.377716,20,22662.93008,1259.051671,1133.146504,265.212402,13,0
0,0,14,14,19,27,46,100,60,160,0.000333,0.29459,18,15907.85843,883.769913,883.769913,209.092585,10,0
0,0,12,12,19,25,44,96,60,156,0.000333,0.28389,18,15330.08399,851.671333,851.671333,196.807027,8,0
0,0,4,4,12,18,30,32,24,56,0.000333,0.091595,6,1648.71524,91.595291,274.785873,118.0782,2,0
0,0,26,26,20,37,57,156,96,252,0.000333,0.489963,20,29397.76567,1633.209204,1469.888284,279.188336,5,0
0,0,23,23,19,35,54,152,89,241,0.000333,0.462309,18,24964.70198,1386.927888,1386.927888,260.235528,5,0
0,0,36,36,21,42,63,239,141,380,0.000333,0.757122,30,68140.99113,3785.610618,2271.366371,318.715998,10,0
0,0,35,35,21,41,62,238,138,376,0.000333,0.746259,30,67163.33438,3731.296355,2238.777813,311.898298,10,0
0,0,48,48,21,42,63,325,190,515,0.000333,1.0261,40,123131.9664,6840.664801,3078.299161,318.715998,15,0
0,0,56,56,21,40,61,394,228,622,0.000333,1.22964,50,184445.9312,10246.99618,3688.918624,305.11579,19,0
0,0,47,47,21,41,62,324,187,511,0.000333,1.014198,40,121703.7726,6761.320699,3042.594315,311.898298,15,0
0,0,31,31,20,42,62,217,127,344,0.000333,0.682748,30,61447.30592,3413.739218,2048.243531,312.915894,8,0
0,0,35,35,21,48,69,180,121,301,0.000333,0.612889,20,36773.31723,2042.962068,1838.665861,360.316866,9,0
0,0,33,33,21,48,69,176,116,292,0.000333,0.594563,20,35673.78283,1981.876824,1783.689141,360.316866,9,0
0,0,48,48,22,58,80,265,174,439,0.000333,0.925109,33,91585.77231,5088.098462,2775.326434,437.870393,11,0
0,0,49,49,22,58,80,269,176,445,0.000333,0.937753,33,92837.51407,5157.639671,2813.258002,437.870393,12,0
0,0,50,50,22,58,80,271,178,449,0.000333,0.946182,33,93672.00858,5204.000477,2838.545715,437.870393,12,0
0,0,53,53,22,58,80,279,185,464,0.000333,0.977792,33,96801.36299,5377.853499,2933.374636,437.870393,13,0
0,0,54,54,22,58,80,281,187,468,0.000333,0.986221,33,97635.8575,5424.214305,2958.662348,437.870393,13,0
0,0,56,56,22,58,80,287,191,478,0.000333,1.007294,33,99722.09377,5540.11632,3021.881629,437.870393,14,0
0,0,57,57,22,58,80,295,195,490,0.000333,1.032582,33,102225.5773,5679.198739,3097.744766,437.870393,14,0
0,0,58,58,22,58,80,297,197,494,0.000333,1.041011,33,103060.0718,5725.559545,3123.032479,437.870393,14,0
0,0,31,31,21,48,69,170,112,282,0.000333,0.574201,20,34452.07794,1914.00433,1722.603897,360.316866,8,0
0,0,32,32,21,48,69,174,114,288,0.000333,0.586418,20,35185.10087,1954.727826,1759.255044,360.316866,9,0
0,0,23,23,20,39,59,149,90,239,0.000333,0.468651,20,28119.03378,1562.168543,1405.951689,292.569248,8,0
0,0,44,44,19,47,66,229,147,376,0.000333,0.757564,27,61362.6891,3409.038283,2272.692189,341.776299,6,0
0,0,37,37,17,39,56,207,128,335,0.000333,0.648488,24,46691.13357,2593.951865,1945.463899,275.617555,5,0
0,0,43,43,19,47,66,227,145,372,0.000333,0.749505,27,60709.89454,3372.771919,2248.514612,341.776299,6,0
0,0,36,36,17,39,56,205,126,331,0.000333,0.640745,24,46133.6275,2562.979306,1922.234479,275.617555,5,0
0,0,42,42,19,47,66,225,143,368,0.000333,0.741446,27,60057.09997,3336.505554,2224.337036,341.776299,6,0
0,0,35,35,17,39,56,203,124,327,0.000333,0.633002,24,45576.12143,2532.006746,1899.00506,275.617555,5,0
0,0,39,39,19,47,66,217,136,353,0.000333,0.711224,18,38406.08023,2133.671124,2133.671124,341.776299,5,0
0,0,32,32,17,39,56,195,117,312,0.000333,0.603965,24,43485.47366,2415.859648,1811.894736,275.617555,4,0
0,0,38,38,19,47,66,215,134,349,0.000333,0.703165,18,37970.88386,2109.493548,2109.493548,341.776299,5,0
0,0,31,31,17,39,56,193,115,308,0.000333,0.596222,16,28618.64506,1589.924725,1788.665316,275.617555,4,0
0,0,37,37,18,47,65,211,132,343,0.000333,0.688557,18,37182.09888,2065.67216,2065.67216,336.124326,4,0
0,0,30,30,16,39,55,189,113,302,0.000333,0.58199,16,27935.53014,1551.973896,1745.970633,270.130687,3,0
0,0,2,2,6,5,11,6,7,13,0.000333,0.014991,3,134.917833,7.495435,44.972611,27.119415,1,0
0,0,2,2,6,5,11,6,7,13,0.000333,0.014991,3,134.917833,7.495435,44.972611,27.119415,1,0
0,0,2,2,6,5,11,6,7,13,0.000333,0.014991,3,134.917833,7.495435,44.972611,27.119415,1,0
0,0,2,2,8,5,13,8,7,15,0.000333,0.018502,4,222.026383,12.334799,55.506596,35.60964,1,0
0,0,2,2,6,5,11,6,7,13,0.000333,0.014991,3,134.917833,7.495435,44.972611,27.119415,1,0
0,0,2,2,6,5,11,6,7,13,0.000333,0.014991,3,134.917833,7.495435,44.972611,27.119415,1,0
0,0,2,2,6,5,11,6,7,13,0.000333,0.014991,3,134.917833,7.495435,44.972611,27.119415,1,0
0,0,2,2,8,5,13,8,7,15,0.000333,0.018502,4,222.026383,12.334799,55.506596,35.60964,1,0
0,0,13,13,23,27,50,110,70,180,0.000333,0.338631,22,22349.67051,1241.648362,1015.894114,232.423888,8,0
0,0,15,15,23,27,50,113,74,187,0.000333,0.3518,22,23218.82437,1289.934687,1055.401107,232.423888,9,0
0,0,14,14,23,27,50,126,78,204,0.000333,0.383782,22,25329.62658,1407.201477,1151.346663,232.423888,8,0
0,0,16,16,23,27,50,129,82,211,0.000333,0.396951,33,39298.17065,2183.231703,1190.853656,232.423888,9,0
0,0,6,6,15,26,41,43,36,79,0.000333,0.141082,7,2962.726259,164.595903,423.246608,180.814792,2,0
0,0,5,5,15,24,39,38,33,71,0.000333,0.125088,7,2626.844903,145.935828,375.263558,168.642459,2,0
0,0,7,7,11,14,25,24,23,47,0.000333,0.072754,5,1091.306205,60.628122,218.261241,91.356717,1,0
0,0,6,6,10,10,20,18,15,33,0.000333,0.047541,5,713.118136,39.617674,142.623627,66.438562,1,0
0,0,7,7,10,16,26,22,28,50,0.000333,0.078341,5,1175.10993,65.283885,235.021986,97.219281,1,0
0,0,6,6,9,13,22,16,18,34,0.000333,0.05054,4,606.4827,33.693483,151.620675,76.635041,1,0
0,0,7,7,13,27,40,41,40,81,0.000333,0.143692,6,2586.457054,143.692059,431.076176,176.487679,2,0
0,0,6,6,13,25,38,36,37,73,0.000333,0.1277,6,2298.592251,127.699569,383.098708,164.202121,2,0
0,0,50,50,21,52,73,295,170,465,0.000333,0.959423,30,86348.0526,4797.114033,2878.26842,388.661531,9,0
0,0,17,17,19,21,40,92,52,144,0.000333,0.255453,18,13794.43762,766.357646,766.357646,172.949289,5,0
0,0,14,14,21,27,48,103,58,161,0.000333,0.299726,20,17983.57925,999.087736,899.178963,220.620628,10,0
0,0,19,19,16,43,59,165,95,260,0.000333,0.509829,16,24471.79509,1359.544171,1529.487193,297.329384,4,0
0,0,13,13,16,32,48,127,70,197,0.000333,0.366746,16,17603.8018,977.988989,1100.237613,224,3,0
0,0,12,12,19,23,42,65,45,110,0.000333,0.197718,9,5338.394249,296.577458,593.154917,184.752548,6,0
0,0,31,31,31,45,76,196,134,330,0.000333,0.687272,30,61854.48238,3436.360132,2061.816079,400.713475,13,0
0,0,25,25,29,42,71,146,105,251,0.000333,0.514529,28,43220.42276,2401.134598,1543.586527,367.358781,11,0
0,0,25,25,25,41,66,129,92,221,0.000333,0.44527,24,32059.46641,1781.081467,1335.8111,335.756037,16,0
0,0,24,24,25,40,65,125,89,214,0.000333,0.429596,24,30930.88109,1718.382283,1288.786712,328.973529,16,0
0,0,25,25,25,41,66,130,94,224,0.000333,0.451315,24,32494.66279,1805.259044,1353.944283,335.756037,16,0
0,0,25,25,25,40,65,129,92,221,0.000333,0.443648,24,31942.63888,1774.591049,1330.943287,328.973529,16,0
0,0,18,18,26,36,62,101,73,174,0.000333,0.345343,26,26936.78411,1496.488006,1036.030158,308.328733,10,0
0,0,25,25,29,42,71,146,105,251,0.000333,0.514529,28,43220.42276,2401.134598,1543.586527,367.358781,11,0
0,0,24,24,27,41,68,144,106,250,0.000333,0.507289,26,39568.50847,2198.25047,1521.86571,348.041595,10,0
0,0,26,26,27,50,77,148,115,263,0.000333,0.549388,26,42852.28637,2380.682576,1648.16486,410.574772,26,0
0,0,17,17,24,35,59,100,73,173,0.000333,0.339232,24,24424.73394,1356.929663,1017.697248,289.564006,7,0
0,0,23,23,25,40,65,121,87,208,0.000333,0.417551,24,30063.66012,1670.20334,1252.652505,328.973529,15,0
0,0,33,33,25,43,68,160,116,276,0.000333,0.560047,24,40323.35386,2240.186326,1680.139744,349.425789,20,0
0,0,34,34,29,44,73,185,135,320,0.000333,0.660248,42,83191.24207,4621.735671,1980.743859,381.09644,15,0
0,0,28,28,24,37,61,136,98,234,0.000333,0.462598,24,33307.02089,1850.390049,1387.792537,302.788875,12,0
0,0,34,34,29,45,74,182,132,314,0.000333,0.649923,28,54593.51399,3032.972999,1949.768357,388.014838,15,0
0,0,33,33,23,34,57,161,117,278,0.000333,0.540514,33,53510.93299,2972.829611,1621.543424,277.015662,15,0
0,0,40,40,26,46,72,214,156,370,0.000333,0.760957,39,89032.01777,4946.223209,2282.872251,376.295283,24,0
0,0,34,34,25,44,69,165,119,284,0.000333,0.578274,24,41635.7027,2313.094594,1734.820946,356.311396,20,0
0,0,33,33,25,43,68,161,116,277,0.000333,0.562076,24,40469.45297,2248.302943,1686.227207,349.425789,20,0
0,0,34,34,25,44,69,166,121,287,0.000333,0.584382,24,42075.51646,2337.528692,1753.146519,356.311396,20,0
0,0,34,34,25,43,68,165,119,284,0.000333,0.57628,24,41492.14673,2305.119263,1728.839447,349.425789,20,0
0,0,27,27,26,38,64,137,100,237,0.000333,0.474,26,36972,2054,1422,321.632678,14,0
0,0,29,29,23,35,58,149,108,257,0.000333,0.501834,33,49681.53682,2760.085379,1505.501116,283.566831,11,0
0,0,27,27,24,38,62,140,102,242,0.000333,0.480305,24,34581.97217,1921.220676,1440.915507,309.460346,12,0
0,0,26,26,24,39,63,140,102,242,0.000333,0.482167,24,34716.0418,1928.668989,1446.501741,316.169787,11,0
0,0,36,36,25,40,65,201,144,345,0.000333,0.692572,36,74797.80824,4155.433791,2077.716895,328.973529,24,0
0,0,34,34,29,44,73,182,132,314,0.000333,0.647868,42,81631.40628,4535.078127,1943.604911,381.09644,15,0
0,0,32,32,26,41,67,195,138,333,0.000333,0.673336,39,78780.30032,4376.683351,2020.0077,341.871065,23,0
0,0,33,33,27,44,71,180,133,313,0.000333,0.641624,39,75069.96309,4170.553505,1924.870848,368.596954,14,0
0,0,30,30,26,48,74,163,127,290,0.000333,0.600247,26,46819.27838,2601.071021,1800.741476,390.289633,29,0
0,0,32,32,26,51,77,170,131,301,0.000333,0.628768,26,49043.87147,2724.659526,1886.302749,411.505125,30,0
0,0,30,30,24,39,63,167,124,291,0.000333,0.579796,36,62617.98448,3478.776915,1739.388458,316.169787,14,0
0,0,26,26,24,38,62,136,100,236,0.000333,0.468397,24,33724.5679,1873.587106,1405.190329,309.460346,11,0
0,0,32,32,25,43,68,157,114,271,0.000333,0.549901,24,39592.85832,2199.60324,1649.70243,349.425789,19,0
0,0,35,35,26,49,75,192,140,332,0.000333,0.689323,26,53767.16294,2987.064608,2067.967805,397.332215,28,0
0,0,36,36,31,50,81,217,159,376,0.000333,0.794595,45,107270.262,5959.459003,2383.783601,435.772895,23,0
0,0,30,30,26,43,69,168,122,290,0.000333,0.590491,26,46058.2744,2558.793022,1771.472092,355.540817,20,0
0,0,36,36,31,51,82,214,156,370,0.000333,0.784098,45,105853.2409,5880.735604,2352.294242,442.873778,23,0
0,0,35,35,25,40,65,193,141,334,0.000333,0.67049,36,72412.95058,4022.941699,2011.47085,328.973529,23,0
0,0,37,37,25,40,65,225,165,390,0.000333,0.782908,48,112738.7255,6263.262526,2348.723447,328.973529,31,0
0,0,36,36,26,50,76,197,143,340,0.000333,0.708098,26,55231.67922,3068.426623,2124.295355,404.404242,28,0
0,0,35,35,26,49,75,193,140,333,0.000333,0.691399,26,53929.11222,2996.06179,2074.196624,397.332215,28,0
0,0,36,36,26,50,76,198,145,343,0.000333,0.714346,26,55719.01757,3095.500976,2143.039137,404.404242,28,0
0,0,36,36,26,49,75,197,143,340,0.000333,0.705933,26,55062.75722,3059.042068,2117.798355,397.332215,28,0
0,0,29,29,27,44,71,169,124,293,0.000333,0.600625,26,46848.77356,2602.709642,1801.875906,368.596954,22,0
0,0,31,31,25,41,66,181,132,313,0.000333,0.630632,36,68108.23294,3783.790719,1891.895359,335.756037,19,0
0,0,29,29,26,44,70,172,126,298,0.000333,0.608842,26,47489.68482,2638.315823,1826.526339,362.426424,20,0
0,0,28,28,26,45,71,172,126,298,0.000333,0.610875,26,47648.24068,2647.124482,1832.624642,369.344822,19,0
0,0,38,38,25,40,65,233,168,401,0.000333,0.80499,48,115918.5357,6439.918648,2414.969493,328.973529,32,0
0,0,36,36,31,50,81,214,156,370,0.000333,0.781915,45,105558.5025,5864.361253,2345.744501,435.772895,23,0
0,0,34,34,26,41,67,227,162,389,0.000333,0.78657,39,92028.63911,5112.702173,2359.708695,341.871065,31,0
0,0,35,35,29,50,79,212,157,369,0.000333,0.775365,42,97695.99404,5427.555224,2326.095096,423.074258,22,0
0,0,32,32,27,53,80,195,151,346,0.000333,0.729129,26,56872.06514,3159.559175,2187.387121,431.961747,37,0
0,0,34,34,27,56,83,202,155,357,0.000333,0.75863,26,59173.116,3287.395333,2275.889077,453.593838,38,0
0,0,32,32,26,45,71,199,148,347,0.000333,0.711321,39,83224.52777,4623.584876,2133.96225,369.344822,22,0
0,0,28,28,26,44,70,168,124,292,0.000333,0.596584,26,46533.51667,2585.19537,1789.750641,362.426424,19,0
0,0,34,34,26,49,75,189,138,327,0.000333,0.678941,26,52957.41651,2942.078695,2036.823712,397.332215,27,0
0,0,26,26,23,32,55,145,104,249,0.000333,0.479853,33,47505.43277,2639.190709,1439.558569,264.041925,10,0
0,0,24,24,23,38,61,130,92,222,0.000333,0.438875,22,28965.72116,1609.206731,1316.623689,303.463171,10,0
0,0,20,20,24,38,62,118,89,207,0.000333,0.41084,24,29580.44727,1643.358182,1232.518636,309.460346,8,0
0,0,19,19,24,38,62,118,89,207,0.000333,0.41084,24,29580.44727,1643.358182,1232.518636,309.460346,7,0
0,0,36,36,26,49,75,200,143,343,0.000333,0.712162,26,55548.60508,3086.033616,2136.484811,397.332215,29,0
0,0,37,37,31,50,81,225,162,387,0.000333,0.817841,45,110408.4878,6133.804878,2453.521951,435.772895,24,0
0,0,31,31,26,43,69,176,125,301,0.000333,0.612889,26,47805.3124,2655.850689,1838.665861,355.540817,21,0
0,0,37,37,31,51,82,222,159,381,0.000333,0.807409,45,109000.2291,6055.568284,2422.227314,442.873778,24,0
0,0,36,36,25,40,65,201,144,345,0.000333,0.692572,36,74797.80824,4155.433791,2077.716895,328.973529,24,0
0,0,38,38,25,40,65,233,168,401,0.000333,0.80499,48,115918.5357,6439.918648,2414.969493,328.973529,32,0
0,0,37,37,26,50,76,205,146,351,0.000333,0.731008,26,57018.58649,3167.699249,2193.022557,404.404242,29,0
0,0,36,36,26,49,75,201,143,344,0.000333,0.714238,26,55710.55437,3095.030798,2142.71363,397.332215,29,0
0,0,37,37,26,50,76,206,148,354,0.000333,0.737255,26,57505.92483,3194.773602,2211.76634,404.404242,29,0
0,0,37,37,26,49,75,205,146,351,0.000333,0.728772,26,56844.19937,3158.011076,2186.31536,397.332215,29,0
0,0,30,30,27,44,71,177,127,304,0.000333,0.623174,26,48607.60123,2700.422291,1869.523124,368.596954,23,0
0,0,32,32,25,41,66,189,135,324,0.000333,0.652795,36,70501.81301,3916.767389,1958.383695,335.756037,20,0
0,0,30,30,26,44,70,180,129,309,0.000333,0.631316,26,49242.65976,2735.70332,1893.948452,362.426424,21,0
0,0,29,29,26,45,71,180,129,309,0.000333,0.633424,26,49407.06836,2744.837131,1900.27186,369.344822,20,0
0,0,39,39,25,40,65,241,171,412,0.000333,0.827072,48,119098.3459,6616.574771,2481.215539,328.973529,33,0
0,0,37,37,31,50,81,222,159,381,0.000333,0.805161,45,108696.7283,6038.707128,2415.482851,435.772895,24,0
0,0,35,35,26,41,67,235,165,400,0.000333,0.808812,52,126174.6552,7009.703065,2426.435676,341.871065,32,0
0,0,36,36,29,50,79,220,160,380,0.000333,0.798479,42,100608.3407,5589.352263,2395.436684,423.074258,23,0
0,0,33,33,27,53,80,203,154,357,0.000333,0.752309,26,58680.13658,3260.007588,2256.92833,431.961747,38,0
0,0,35,35,27,56,83,210,158,368,0.000333,0.782005,26,60996.37728,3388.687627,2346.014511,453.593838,39,0
0,0,33,33,26,45,71,207,151,358,0.000333,0.73387,39,85862.76928,4770.153849,2201.609469,369.344822,23,0
0,0,29,29,26,44,70,176,127,303,0.000333,0.619058,26,48286.49161,2682.582867,1857.172754,362.426424,20,0
0,0,35,35,26,49,75,197,141,338,0.000333,0.70178,26,54738.85865,3041.047703,2105.340717,397.332215,28,0
0,0,32,32,27,47,74,194,137,331,0.000333,0.68511,26,53438.55567,2968.808648,2055.329064,389.447639,28,0
0,0,33,33,31,47,78,219,156,375,0.000333,0.785675,45,106066.1624,5892.56458,2357.025832,414.645762,23,0
0,0,27,27,27,42,69,170,119,289,0.000333,0.588455,26,45899.45277,2549.969598,1765.363568,354.859294,20,0
0,0,33,33,31,48,79,216,153,369,0.000333,0.775365,45,104674.2793,5815.23774,2326.095096,421.658286,23,0
0,0,32,32,26,41,67,195,138,333,0.000333,0.673336,39,78780.30032,4376.683351,2020.0077,341.871065,23,0
0,0,34,34,26,41,67,227,162,389,0.000333,0.78657,39,92028.63911,5112.702173,2359.708695,341.871065,31,0
0,0,33,33,27,48,75,199,140,339,0.000333,0.703857,26,54900.80794,3050.044885,2111.569536,396.460163,28,0
0,0,32,32,27,47,74,195,137,332,0.000333,0.68718,26,53600.00145,2977.777858,2061.538517,389.447639,28,0
0,0,33,33,27,48,75,200,142,342,0.000333,0.710085,26,55386.6558,3077.036433,2130.255992,396.460163,28,0
0,0,33,33,27,47,74,199,140,339,0.000333,0.701668,26,54730.12197,3040.562331,2105.004691,389.447639,28,0
0,0,26,26,28,43,71,171,121,292,0.000333,0.598575,28,50280.33245,2793.351803,1795.726159,367.935322,22,0
0,0,28,28,26,39,65,183,129,312,0.000333,0.626326,39,73280.17155,4071.120642,1878.978758,328.342119,19,0
0,0,26,26,27,43,70,174,123,297,0.000333,0.606799,26,47330.32346,2629.462414,1820.397056,361.711347,20,0
0,0,25,25,27,43,70,174,123,297,0.000333,0.606799,26,47330.32346,2629.462414,1820.397056,361.711347,19,0
0,0,35,35,26,41,67,235,165,400,0.000333,0.808812,52,126174.6552,7009.703065,2426.435676,341.871065,32,0
0,0,33,33,31,48,79,216,153,369,0.000333,0.775365,45,104674.2793,5815.23774,2326.095096,421.658286,23,0
0,0,31,31,26,38,64,229,159,388,0.000333,0.776,52,121056,6725.333333,2328,321.632678,31,0
0,0,32,32,29,47,76,214,154,368,0.000333,0.766412,42,96567.96765,5364.887092,2299.237325,401.947125,22,0
0,0,29,29,28,50,78,197,148,345,0.000333,0.722821,28,60716.98543,3373.165857,2168.463766,416.798747,37,0
0,0,31,31,28,53,81,204,152,356,0.000333,0.752329,28,63195.62483,3510.868046,2256.986601,438.185722,38,0
0,0,29,29,26,43,69,201,145,346,0.000333,0.704516,39,82428.42902,4579.357168,2113.549462,355.540817,22,0
0,0,25,25,27,42,69,170,121,291,0.000333,0.592527,26,46217.09604,2567.616447,1777.580617,354.859294,19,0
0,0,31,31,27,47,74,191,135,326,0.000333,0.674761,26,52631.32673,2923.962596,2024.281797,389.447639,27,0
0,0,71,71,29,47,76,350,271,621,0.000333,1.293321,70,271597.409,15088.74495,3879.962986,401.947125,24,0
0,0,36,36,27,46,73,189,144,333,0.000333,0.687071,39,80387.25155,4465.958419,2061.211578,382.465813,19,0
0,0,10,10,15,21,36,55,37,92,0.000333,0.158544,7,3329.431701,184.968428,475.6331,150.842025,5,0
0,0,29,29,31,45,76,186,126,312,0.000333,0.649784,30,58480.60153,3248.922307,1949.353384,400.713475,12,0
0,0,23,23,29,42,71,136,97,233,0.000333,0.47763,28,40120.95021,2228.941678,1432.891079,367.358781,10,0
0,0,23,23,25,41,66,119,84,203,0.000333,0.409004,24,29448.28815,1636.016008,1227.012006,335.756037,15,0
0,0,22,22,25,39,64,115,81,196,0.000333,0.392,24,28224,1568,1176,322.227091,15,0
0,0,23,23,25,41,66,120,86,206,0.000333,0.415048,24,29883.48453,1660.193585,1245.145189,335.756037,15,0
0,0,23,23,25,40,65,119,84,203,0.000333,0.407514,24,29340.97599,1630.054221,1222.540666,328.973529,15,0
0,0,16,16,26,35,61,91,65,156,0.000333,0.308398,13,12027.53532,668.196407,925.195025,301.736338,9,0
0,0,23,23,29,42,71,136,97,233,0.000333,0.47763,28,40120.95021,2228.941678,1432.891079,367.358781,10,0
0,0,22,22,27,41,68,134,98,232,0.000333,0.470764,26,36719.57586,2039.976437,1412.291379,348.041595,9,0
0,0,24,24,27,50,77,138,107,245,0.000333,0.511788,26,39919.43026,2217.746126,1535.362702,410.574772,25,0
0,0,15,15,24,34,58,90,65,155,0.000333,0.302662,12,10895.84465,605.324703,907.987054,283.012837,6,0
0,0,21,21,25,39,64,111,79,190,0.000333,0.38,24,27360,1520,1140,322.227091,14,0
0,0,31,31,25,42,67,150,108,258,0.000333,0.521684,24,37561.22427,2086.734682,1565.051011,342.573737,19,0
0,0,32,32,29,44,73,175,127,302,0.000333,0.623109,28,52341.15647,2907.842026,1869.327017,381.09644,14,0
0,0,26,26,24,36,60,126,90,216,0.000333,0.425296,24,30621.32085,1701.184492,1275.888369,296.1564,11,0
0,0,32,32,29,45,74,172,124,296,0.000333,0.612666,28,51463.94949,2859.108305,1837.998196,388.014838,14,0
0,0,31,31,23,33,56,151,109,260,0.000333,0.503304,33,49827.10523,2768.172513,1509.91228,270.506931,14,0
0,0,38,38,26,46,72,204,148,352,0.000333,0.723938,39,84700.73042,4705.596134,2171.813601,376.295283,23,0
0,0,32,32,25,44,69,155,111,266,0.000333,0.541623,24,38996.82013,2166.490007,1624.867506,356.311396,19,0
0,0,31,31,25,42,67,151,108,259,0.000333,0.523706,24,37706.81041,2094.8228,1571.1171,342.573737,19,0
0,0,32,32,25,44,69,156,113,269,0.000333,0.547731,24,39436.63389,2190.924105,1643.193079,356.311396,19,0
0,0,32,32,25,43,68,155,111,266,0.000333,0.539755,24,38862.36278,2159.020154,1619.265116,349.425789,19,0
0,0,25,25,26,37,63,127,92,219,0.000333,0.436341,26,34034.63188,1890.812882,1309.024303,314.961207,13,0
0,0,28,28,23,35,58,147,105,252,0.000333,0.49207,33,48714.96996,2706.38722,1476.211211,283.566831,11,0
0,0,25,25,24,37,61,130,94,224,0.000333,0.442828,24,31883.64393,1771.313551,1328.485164,302.788875,11,0
0,0,24,24,24,38,62,130,94,224,0.000333,0.44458,24,32009.75937,1778.319965,1333.739974,309.460346,10,0
0,0,34,34,25,39,64,191,136,327,0.000333,0.654,36,70632,3924,1962,322.227091,23,0
0,0,32,32,29,44,73,172,124,296,0.000333,0.610729,28,51301.26594,2850.07033,1832.188069,381.09644,14,0
0,0,30,30,26,40,66,185,130,315,0.000333,0.634661,39,74255.38176,4125.298986,1903.984148,335.088556,22,0
0,0,31,31,27,44,71,170,125,295,0.000333,0.604725,26,47168.56041,2620.475578,1814.1754,368.596954,13,0
0,0,28,28,26,47,73,153,119,272,0.000333,0.561211,26,43774.43928,2431.913293,1683.63228,383.277109,28,0
0,0,30,30,26,50,76,160,123,283,0.000333,0.589388,26,45972.25064,2554.013925,1768.163486,404.404242,29,0
0,0,28,28,24,38,62,157,116,273,0.000333,0.541832,36,58517.84134,3250.991185,1625.495593,309.460346,13,0
0,0,24,24,24,37,61,126,92,218,0.000333,0.430967,24,31029.61775,1723.867653,1292.90074,302.788875,10,0
0,0,30,30,25,42,67,147,106,253,0.000333,0.511574,24,36833.29356,2046.294087,1534.720565,342.573737,18,0
0,0,33,33,26,48,74,182,132,314,0.000333,0.649923,26,50693.97728,2816.332071,1949.768357,390.289633,27,0
0,0,34,34,31,50,81,207,151,358,0.000333,0.756555,45,102134.9835,5674.165753,2269.666301,435.772895,22,0
0,0,28,28,26,42,68,158,114,272,0.000333,0.55193,26,43050.53721,2391.696512,1655.789893,348.688764,19,0
0,0,34,34,31,51,82,204,148,352,0.000333,0.745953,30,67135.74917,3729.763843,2237.858306,442.873778,22,0
0,0,33,33,25,39,64,183,133,316,0.000333,0.632,36,68256,3792,1896,322.227091,22,0
0,0,35,35,25,39,64,215,157,372,0.000333,0.744,48,107136,5952,2232,322.227091,30,0
0,0,34,34,26,50,76,187,135,322,0.000333,0.670611,26,52307.64914,2905.980508,2011.832659,404.404242,27,0
0,0,33,33,26,48,74,183,132,315,0.000333,0.651993,26,50855.42307,2825.301281,1955.97781,390.289633,27,0
0,0,34,34,26,50,76,188,137,325,0.000333,0.676859,26,52794.98749,2933.05486,2030.576442,404.404242,27,0
0,0,34,34,26,49,75,187,135,322,0.000333,0.66856,26,52147.67008,2897.092782,2005.679618,397.332215,27,0
0,0,27,27,27,43,70,159,116,275,0.000333,0.561851,26,43824.37357,2434.687421,1685.55283,361.711347,21,0
0,0,30,30,25,41,66,179,129,308,0.000333,0.620558,36,67020.242,3723.346778,1861.673389,335.756037,19,0
0,0,27,27,26,43,69,162,118,280,0.000333,0.570129,26,44470.05805,2470.55878,1710.386848,355.540817,19,0
0,0,26,26,26,44,70,162,118,280,0.000333,0.572066,26,44621.18036,2478.954465,1716.199245,362.426424,18,0
0,0,36,36,25,39,64,223,160,383,0.000333,0.766,48,110304,6128,2298,322.227091,31,0
0,0,34,34,31,50,81,204,148,352,0.000333,0.743876,30,66948.81603,3719.378668,2231.627201,435.772895,22,0
0,0,32,32,26,40,66,217,154,371,0.000333,0.74749,39,87456.33851,4858.685473,2242.470218,335.088556,30,0
0,0,33,33,29,50,79,202,149,351,0.000333,0.737542,28,61953.55719,3441.864289,2212.627043,423.074258,21,0
0,0,30,30,27,52,79,185,143,328,0.000333,0.689213,26,53758.64222,2986.591234,2067.640085,424.804828,36,0
0,0,32,32,27,55,82,192,147,339,0.000333,0.718403,26,56035.46337,3113.081298,2155.21013,446.356747,37,0
0,0,30,30,26,44,70,189,140,329,0.000333,0.672178,39,78644.83039,4369.157244,2016.534113,362.426424,21,0
0,0,26,26,26,43,69,158,116,274,0.000333,0.557912,26,43517.12823,2417.618235,1673.735701,355.540817,18,0
0,0,32,32,26,48,74,179,130,309,0.000333,0.639574,26,49886.74834,2771.486019,1918.72109,390.289633,26,0
0,0,25,25,23,32,55,143,101,244,0.000333,0.470217,33,46551.50841,2586.194912,1410.65177,264.041925,10,0
0,0,23,23,23,38,61,128,89,217,0.000333,0.42899,22,28313.34005,1572.963336,1286.970002,303.463171,10,0
0,0,18,18,24,38,62,108,81,189,0.000333,0.375114,24,27008.23446,1500.45747,1125.343103,309.460346,7,0
0,0,17,17,24,38,62,108,81,189,0.000333,0.375114,24,27008.23446,1500.45747,1125.343103,309.460346,6,0
0,0,34,34,26,48,74,190,135,325,0.000333,0.672691,26,52469.88094,2914.993386,2018.072344,390.289633,28,0
0,0,35,35,31,50,81,215,154,369,0.000333,0.779802,45,105273.2093,5848.511628,2339.404651,435.772895,23,0
0,0,29,29,26,42,68,166,117,283,0.000333,0.574251,26,44791.55159,2488.419533,1722.751984,348.688764,20,0
0,0,35,35,31,51,82,212,151,363,0.000333,0.769264,30,69233.74133,3846.318963,2307.791378,442.873778,23,0
0,0,34,34,25,39,64,191,136,327,0.000333,0.654,36,70632,3924,1962,322.227091,23,0
0,0,36,36,25,39,64,223,160,383,0.000333,0.766,48,110304,6128,2298,322.227091,31,0
0,0,35,35,26,50,76,195,138,333,0.000333,0.69352,26,54094.55641,3005.253134,2080.559862,404.404242,28,0
0,0,34,34,26,48,74,191,135,326,0.000333,0.674761,26,52631.32673,2923.962596,2024.281797,390.289633,28,0
0,0,35,35,26,50,76,196,140,336,0.000333,0.699768,26,54581.89476,3032.327487,2099.303645,404.404242,28,0
0,0,35,35,26,49,75,195,138,333,0.000333,0.691399,26,53929.11222,2996.06179,2074.196624,397.332215,28,0
0,0,28,28,27,43,70,167,119,286,0.000333,0.584325,26,45577.34851,2532.074917,1752.974943,361.711347,22,0
0,0,31,31,25,41,66,187,132,319,0.000333,0.642721,36,69413.82207,3856.323448,1928.161724,335.756037,20,0
0,0,28,28,26,43,69,170,121,291,0.000333,0.592527,26,46217.09604,2567.616447,1777.580617,355.540817,20,0
0,0,27,27,26,44,70,170,121,291,0.000333,0.59454,26,46374.15531,2576.341961,1783.621358,362.426424,19,0
0,0,37,37,25,39,64,231,163,394,0.000333,0.788,48,113472,6304,2364,322.227091,32,0
0,0,35,35,31,50,81,212,151,363,0.000333,0.767122,45,103561.4498,5753.413878,2301.365551,435.772895,23,0
0,0,33,33,26,40,66,225,157,382,0.000333,0.769653,39,90049.38359,5002.743533,2308.958554,335.088556,31,0
0,0,34,34,29,50,79,210,152,362,0.000333,0.760656,42,95842.6825,5324.593472,2281.968631,423.074258,22,0
0,0,31,31,27,52,79,193,146,339,0.000333,0.712327,26,55561.52351,3086.751306,2136.981674,424.804828,37,0
0,0,33,33,27,55,82,200,150,350,0.000333,0.741714,26,57853.72324,3214.095736,2225.143202,446.356747,38,0
0,0,31,31,26,44,70,197,143,340,0.000333,0.694652,39,81274.29281,4515.238489,2083.956226,362.426424,22,0
0,0,27,27,26,43,69,166,119,285,0.000333,0.58031,26,45264.16623,2514.675901,1740.92947,355.540817,19,0
0,0,33,33,26,48,74,187,133,320,0.000333,0.662342,26,51662.652,2870.147333,1987.025077,390.289633,27,0
0,0,30,30,27,46,73,184,129,313,0.000333,0.645805,26,50372.79226,2798.488459,1937.415087,382.465813,27,0
0,0,31,31,31,47,78,209,148,357,0.000333,0.747963,45,100974.9866,5609.72148,2243.888592,414.645762,22,0
0,0,25,25,27,41,68,160,111,271,0.000333,0.549901,26,42892.26318,2382.90351,1649.70243,348.041595,19,0
0,0,31,31,31,48,79,206,145,351,0.000333,0.737542,45,99568.21692,5531.567607,2212.627043,421.658286,22,0
0,0,30,30,26,40,66,185,130,315,0.000333,0.634661,39,74255.38176,4125.298986,1903.984148,335.088556,22,0
0,0,32,32,26,40,66,217,154,371,0.000333,0.74749,39,87456.33851,4858.685473,2242.470218,335.088556,30,0
0,0,31,31,27,48,75,189,132,321,0.000333,0.666484,26,51985.72079,2888.095599,1999.4508,396.460163,27,0
0,0,30,30,27,46,73,185,129,314,0.000333,0.647868,26,50533.7277,2807.429317,1943.604911,382.465813,27,0
0,0,31,31,27,48,75,190,134,324,0.000333,0.672712,26,52471.56865,2915.087147,2018.137256,396.460163,27,0
0,0,31,31,27,47,74,189,132,321,0.000333,0.664412,26,51824.09779,2879.116544,1993.23453,389.447639,27,0
0,0,24,24,28,42,70,161,113,274,0.000333,0.559808,28,47023.85931,2612.436628,1679.423547,361.08327,21,0
0,0,27,27,26,39,65,181,126,307,0.000333,0.616289,39,72105.80983,4005.878324,1848.866919,328.342119,19,0
0,0,24,24,27,42,69,164,115,279,0.000333,0.568093,26,44311.23641,2461.735356,1704.278323,354.859294,19,0
0,0,23,23,27,42,69,164,115,279,0.000333,0.568093,26,44311.23641,2461.735356,1704.278323,354.859294,18,0
0,0,33,33,26,40,66,225,157,382,0.000333,0.769653,39,90049.38359,5002.743533,2308.958554,335.088556,31,0
0,0,31,31,31,48,79,206,145,351,0.000333,0.737542,45,99568.21692,5531.567607,2212.627043,421.658286,22,0
0,0,29,29,26,37,63,219,151,370,0.000333,0.737198,52,115002.8657,6389.048096,2211.593572,314.961207,30,0
0,0,30,30,29,47,76,204,146,350,0.000333,0.728925,42,91844.53445,5102.474136,2186.77463,401.947125,21,0
0,0,27,27,28,49,77,187,140,327,0.000333,0.68308,28,57378.69757,3187.70542,2049.239199,409.72672,36,0
0,0,29,29,28,52,80,194,144,338,0.000333,0.712271,28,59830.72749,3323.929305,2136.811696,431.028803,37,0
0,0,27,27,26,42,68,191,137,328,0.000333,0.665563,39,77870.82467,4326.156926,1996.687812,348.688764,21,0
0,0,23,23,27,41,68,160,113,273,0.000333,0.553959,26,43208.81125,2400.489514,1661.877356,348.041595,18,0
0,0,29,29,27,46,73,181,127,308,0.000333,0.635489,26,49568.11507,2753.78417,1906.465964,382.465813,26,0
0,0,69,69,29,47,76,340,263,603,0.000333,1.255833,70,263725.0203,14651.39002,3767.500291,401.947125,23,0
0,0,34,34,27,46,73,179,136,315,0.000333,0.649932,26,50694.66314,2816.370174,1949.794736,382.465813,18,0
0,0,33,33,23,38,61,206,143,349,0.000333,0.689942,33,68304.30192,3794.68344,2069.827331,303.463171,11,0
0,0,30,30,31,46,77,197,134,331,0.000333,0.691435,30,62229.19035,3457.177242,2074.306345,407.663936,12,0
0,0,24,24,29,43,72,147,105,252,0.000333,0.518274,28,43534.99081,2418.610601,1554.8211,374.210833,10,0
0,0,24,24,25,42,67,130,92,222,0.000333,0.448891,24,32320.12321,1795.5624,1346.6718,342.573737,15,0
0,0,23,23,25,40,65,126,89,215,0.000333,0.431603,24,31075.41792,1726.412106,1294.80908,328.973529,15,0
0,0,24,24,25,42,67,131,94,225,0.000333,0.454957,24,32756.88163,1819.826757,1364.870068,342.573737,15,0
0,0,24,24,25,41,66,130,92,222,0.000333,0.447285,24,32204.53187,1789.140659,1341.855494,335.756037,15,0
0,0,17,17,26,36,62,102,73,175,0.000333,0.347328,26,27091.59321,1505.088512,1041.984354,308.328733,9,0
0,0,24,24,29,43,72,147,105,252,0.000333,0.518274,28,43534.99081,2418.610601,1554.8211,374.210833,10,0
0,0,23,23,27,42,69,145,106,251,0.000333,0.51108,26,39864.23061,2214.679478,1533.239639,354.859294,9,0
0,0,25,25,27,51,78,149,115,264,0.000333,0.553115,26,43143.00083,2396.833379,1659.346186,417.675655,25,0
0,0,16,16,24,35,59,101,73,174,0.000333,0.341193,24,24565.91737,1364.773187,1023.579891,289.564006,6,0
0,0,22,22,25,40,65,122,87,209,0.000333,0.419558,24,30208.19695,1678.233164,1258.674873,328.973529,14,0
0,0,32,32,25,43,68,161,116,277,0.000333,0.562076,24,40469.45297,2248.302943,1686.227207,349.425789,19,0
0,0,33,33,29,45,74,186,135,321,0.000333,0.664412,42,83715.85028,4650.880571,1993.23453,388.014838,14,0
0,0,27,27,24,37,61,137,98,235,0.000333,0.464574,24,33449.35858,1858.297699,1393.723274,302.788875,11,0
0,0,33,33,29,46,75,183,132,315,0.000333,0.654026,28,54938.18085,3052.121158,1962.077888,394.965299,14,0
0,0,32,32,23,34,57,162,117,279,0.000333,0.542459,33,53703.41836,2983.523242,1627.376314,277.015662,14,0
0,0,39,39,26,47,73,215,156,371,0.000333,0.765475,39,89560.57154,4975.587308,2296.424911,383.277109,23,0
0,0,33,33,25,45,70,166,119,285,0.000333,0.582282,24,41924.29584,2329.127546,1746.84566,363.229794,19,0
0,0,32,32,25,43,68,162,116,278,0.000333,0.564105,24,40615.55208,2256.41956,1692.31467,349.425789,19,0
0,0,33,33,25,45,70,167,121,288,0.000333,0.588411,24,42365.60421,2353.644679,1765.233509,363.229794,19,0
0,0,33,33,25,44,69,166,119,285,0.000333,0.58031,24,41782.30728,2321.239294,1740.92947,356.311396,19,0
0,0,26,26,26,38,64,138,100,238,0.000333,0.476,26,37128,2062.666667,1428,321.632678,13,0
0,0,29,29,23,36,59,158,113,271,0.000333,0.531399,33,52608.47679,2922.693155,1594.196266,290.159225,11,0
0,0,26,26,24,38,62,141,102,243,0.000333,0.48229,24,34724.87288,1929.159605,1446.869703,309.460346,11,0
0,0,25,25,24,39,63,141,102,243,0.000333,0.48416,24,34859.49651,1936.638695,1452.479021,316.169787,10,0
0,0,35,35,25,40,65,202,144,346,0.000333,0.69458,36,75014.61348,4167.478527,2083.739263,328.973529,23,0
0,0,33,33,29,45,74,183,132,315,0.000333,0.651993,28,54767.37869,3042.632149,1955.97781,388.014838,14,0
0,0,31,31,26,41,67,196,138,334,0.000333,0.675358,39,79016.8778,4389.826544,2026.07379,341.871065,22,0
0,0,32,32,27,45,72,181,133,314,0.000333,0.645785,26,50371.26771,2798.403762,1937.35645,375.515352,13,0
0,0,29,29,26,48,74,164,127,291,0.000333,0.602317,26,46980.72416,2610.040231,1806.950929,390.289633,28,0
0,0,31,31,26,51,77,171,131,302,0.000333,0.630857,26,49206.80792,2733.711551,1892.569535,411.505125,29,0
0,0,29,29,24,39,63,168,124,292,0.000333,0.581789,36,62833.16656,3490.731475,1745.365738,316.169787,13,0
0,0,25,25,24,38,62,137,100,237,0.000333,0.470382,24,33867.46861,1881.526034,1411.144526,309.460346,10,0
0,0,31,31,25,43,68,158,114,272,0.000333,0.55193,24,39738.95743,2207.719857,1655.789893,349.425789,18,0
0,0,34,34,26,49,75,193,140,333,0.000333,0.691399,26,53929.11222,2996.06179,2074.196624,397.332215,27,0
0,0,35,35,31,51,82,218,159,377,0.000333,0.798932,45,107855.8698,5991.992764,2396.797106,442.873778,22,0
0,0,29,29,26,43,69,169,122,291,0.000333,0.592527,26,46217.09604,2567.616447,1777.580617,355.540817,19,0
0,0,35,35,31,52,83,215,156,371,0.000333,0.78838,45,106431.2833,5912.849073,2365.139629,450.002951,22,0
0,0,34,34,25,40,65,194,141,335,0.000333,0.672498,36,72629.75583,4034.986435,2017.493217,328.973529,22,0
0,0,36,36,25,40,65,226,165,391,0.000333,0.784915,48,113027.7991,6279.322173,2354.745815,328.973529,30,0
0,0,35,35,26,51,77,198,143,341,0.000333,0.712325,26,55561.32947,3086.740526,2136.97421,411.505125,27,0
0,0,34,34,26,49,75,194,140,334,0.000333,0.693475,26,54091.06151,3005.058973,2080.425443,397.332215,27,0
0,0,35,35,26,51,77,199,145,344,0.000333,0.718592,26,56050.13882,3113.896601,2155.77457,411.505125,27,0
0,0,35,35,26,50,76,198,143,341,0.000333,0.710181,26,55394.12533,3077.451407,2130.543282,404.404242,27,0
0,0,28,28,27,44,71,170,124,294,0.000333,0.602675,26,47008.66698,2611.59261,1808.025653,368.596954,21,0
0,0,31,31,25,42,67,190,137,327,0.000333,0.661204,36,71410.00195,3967.222331,1983.611165,342.573737,19,0
0,0,28,28,26,44,70,173,126,299,0.000333,0.610885,26,47649.04617,2647.169232,1832.655622,362.426424,19,0
0,0,27,27,26,45,71,173,126,299,0.000333,0.612925,26,47808.13411,2656.00745,1838.774389,369.344822,18,0
0,0,37,37,25,40,65,234,168,402,0.000333,0.806997,48,116207.6093,6455.978296,2420.991861,328.973529,31,0
0,0,35,35,31,51,82,215,156,371,0.000333,0.786217,45,106139.3307,5896.629484,2358.651794,442.873778,22,0
0,0,33,33,26,41,67,228,162,390,0.000333,0.788592,39,92265.21659,5125.845366,2365.774784,341.871065,30,0
0,0,34,34,29,51,80,213,157,370,0.000333,0.779704,42,98242.7626,5457.931255,2339.113395,430.175141,21,0
0,0,31,31,27,53,80,196,151,347,0.000333,0.731236,26,57036.43527,3168.690848,2193.709049,431.961747,36,0
0,0,33,33,27,56,83,203,155,358,0.000333,0.760755,26,59338.86703,3296.603724,2282.264116,453.593838,37,0
0,0,31,31,26,45,71,200,148,348,0.000333,0.713371,39,83464.36791,4636.909328,2140.111998,369.344822,21,0
0,0,27,27,26,44,70,169,124,293,0.000333,0.598627,26,46692.87802,2594.048779,1795.879924,362.426424,18,0
0,0,33,33,26,49,75,190,138,328,0.000333,0.681018,26,53119.36579,2951.075877,2043.05253,397.332215,26,0
0,0,26,26,23,33,56,154,109,263,0.000333,0.509111,33,50402.03337,2800.112965,1527.334345,270.506931,10,0
0,0,24,24,23,39,62,139,97,236,0.000333,0.468397,22,30914.18724,1717.454847,1405.190329,310.172612,10,0
0,0,19,19,24,39,63,119,89,208,0.000333,0.414425,24,29838.58138,1657.698965,1243.274224,316.169787,7,0
0,0,18,18,24,39,63,119,89,208,0.000333,0.414425,24,29838.58138,1657.698965,1243.274224,316.169787,6,0
0,0,35,35,26,49,75,201,143,344,0.000333,0.714238,26,55710.55437,3095.030798,2142.71363,397.332215,28,0
0,0,36,36,31,51,82,226,162,388,0.000333,0.822243,45,111002.858,6166.825444,2466.730178,442.873778,23,0
0,0,30,30,26,43,69,177,125,302,0.000333,0.614925,26,47964.13404,2664.674113,1844.774386,355.540817,20,0
0,0,36,36,31,52,83,223,159,382,0.000333,0.811755,45,109586.9278,6088.162657,2435.265063,450.002951,23,0
0,0,35,35,25,40,65,202,144,346,0.000333,0.69458,36,75014.61348,4167.478527,2083.739263,328.973529,23,0
0,0,37,37,25,40,65,234,168,402,0.000333,0.806997,48,116207.6093,6455.978296,2420.991861,328.973529,31,0
0,0,36,36,26,51,77,206,146,352,0.000333,0.735303,26,57353.63042,3186.312801,2205.908862,411.505125,28,0
0,0,35,35,26,49,75,202,143,345,0.000333,0.716314,26,55872.50365,3104.027981,2148.942448,397.332215,28,0
0,0,36,36,26,51,77,207,148,355,0.000333,0.74157,26,57842.43977,3213.468876,2224.709222,411.505125,28,0
0,0,36,36,26,50,76,206,146,352,0.000333,0.73309,26,57181.0326,3176.724034,2199.270485,404.404242,28,0
0,0,29,29,27,44,71,178,127,305,0.000333,0.625224,26,48767.49466,2709.305259,1875.672871,368.596954,22,0
0,0,32,32,25,42,67,198,140,338,0.000333,0.683446,36,73812.17327,4100.676293,2050.338146,342.573737,20,0
0,0,29,29,26,44,70,181,129,310,0.000333,0.633359,26,49402.02112,2744.556729,1900.077735,362.426424,20,0
0,0,28,28,26,45,71,181,129,310,0.000333,0.635474,26,49566.96178,2753.720099,1906.421607,369.344822,19,0
0,0,38,38,25,40,65,242,171,413,0.000333,0.829079,48,119387.4195,6632.634418,2487.237907,328.973529,32,0
0,0,36,36,31,51,82,223,159,382,0.000333,0.809528,45,109286.319,6071.462164,2428.584866,442.873778,23,0
0,0,34,34,26,41,67,236,165,401,0.000333,0.810834,52,126490.0918,7027.227322,2432.501765,341.871065,31,0
0,0,35,35,29,51,80,221,160,381,0.000333,0.802885,42,101163.4934,5620.194076,2408.654604,430.175141,22,0
0,0,32,32,27,53,80,204,154,358,0.000333,0.754417,26,58844.50671,3269.139262,2263.250258,431.961747,37,0
0,0,34,34,27,56,83,211,158,369,0.000333,0.78413,26,61162.1283,3397.896017,2352.38955,453.593838,38,0
0,0,32,32,26,45,71,208,151,359,0.000333,0.73592,39,86102.60942,4783.478301,2207.759216,369.344822,22,0
0,0,28,28,26,44,70,177,127,304,0.000333,0.621101,26,48445.85297,2691.436276,1863.302037,362.426424,19,0
0,0,34,34,26,49,75,198,141,339,0.000333,0.703857,26,54900.80794,3050.044885,2111.569536,397.332215,27,0
0,0,31,31,27,47,74,195,137,332,0.000333,0.68718,26,53600.00145,2977.777858,2061.538517,389.447639,27,0
0,0,32,32,31,48,79,220,156,376,0.000333,0.790074,45,106659.9703,5925.553903,2370.221561,421.658286,22,0
0,0,26,26,27,42,69,171,119,290,0.000333,0.590491,26,46058.2744,2558.793022,1771.472092,354.859294,19,0
0,0,32,32,31,49,80,217,153,370,0.000333,0.779704,45,105260.1028,5847.783488,2339.113395,428.700868,22,0
0,0,31,31,26,41,67,196,138,334,0.000333,0.675358,39,79016.8778,4389.826544,2026.07379,341.871065,22,0
0,0,33,33,26,41,67,228,162,390,0.000333,0.788592,39,92265.21659,5125.845366,2365.774784,341.871065,30,0
0,0,32,32,27,49,76,200,140,340,0.000333,0.708098,26,55231.67922,3068.426623,2124.295355,403.502745,27,0
0,0,31,31,27,47,74,196,137,333,0.000333,0.689249,26,53761.44724,2986.747069,2067.747971,389.447639,27,0
0,0,32,32,27,49,76,201,142,343,0.000333,0.714346,26,55719.01757,3095.500976,2143.039137,403.502745,27,0
0,0,32,32,27,48,75,200,140,340,0.000333,0.705933,26,55062.75722,3059.042068,2117.798355,396.460163,27,0
0,0,25,25,28,43,71,172,121,293,0.000333,0.600625,28,50452.52537,2802.918076,1801.875906,367.935322,21,0
0,0,28,28,26,40,66,192,134,326,0.000333,0.656824,39,76848.42683,4269.357046,1970.472483,335.088556,19,0
0,0,25,25,27,43,70,175,123,298,0.000333,0.608842,26,47489.68482,2638.315823,1826.526339,361.711347,19,0
0,0,24,24,27,43,70,175,123,298,0.000333,0.608842,26,47489.68482,2638.315823,1826.526339,361.711347,18,0
0,0,34,34,26,41,67,236,165,401,0.000333,0.810834,52,126490.0918,7027.227322,2432.501765,341.871065,31,0
0,0,32,32,31,49,80,217,153,370,0.000333,0.779704,45,105260.1028,5847.783488,2339.113395,428.700868,22,0
0,0,30,30,26,38,64,230,159,389,0.000333,0.778,52,121368,6742.666667,2334,321.632678,30,0
0,0,31,31,29,48,77,215,154,369,0.000333,0.770815,42,97122.65781,5395.703212,2312.444234,408.959649,21,0
0,0,28,28,28,50,78,198,148,346,0.000333,0.724916,28,60892.9767,3382.94315,2174.749168,416.798747,36,0
0,0,30,30,28,53,81,205,152,357,0.000333,0.754442,28,63373.14063,3520.730035,2263.326451,438.185722,37,0
0,0,28,28,26,43,69,202,145,347,0.000333,0.706553,39,82666.66147,4592.592304,2119.657987,355.540817,21,0
0,0,24,24,27,42,69,171,121,292,0.000333,0.594563,26,46375.91768,2576.439871,1783.689141,354.859294,18,0
0,0,30,30,27,47,74,192,135,327,0.000333,0.67683,26,52792.77252,2932.931806,2030.491251,389.447639,26,0
0,0,70,70,29,48,77,351,271,622,0.000333,1.299314,70,272855.886,15158.66033,3897.941228,408.959649,23,0
0,0,35,35,27,47,74,190,144,334,0.000333,0.691319,39,80884.33954,4493.574419,2073.957424,389.447639,18,0
0,0,33,33,25,38,63,210,145,355,0.000333,0.707311,36,76389.63742,4243.868746,2121.934373,315.51765,12,0
0,0,30,30,31,46,77,201,136,337,0.000333,0.703969,30,63357.21193,3519.845107,2111.907064,407.663936,13,0
0,0,24,24,29,43,72,151,107,258,0.000333,0.530614,28,44571.53821,2476.196567,1591.84065,374.210833,11,0
0,0,24,24,25,42,67,134,94,228,0.000333,0.461023,24,33193.64005,1844.091114,1383.068335,342.573737,16,0
0,0,23,23,25,40,65,130,91,221,0.000333,0.443648,24,31942.63888,1774.591049,1330.943287,328.973529,16,0
0,0,24,24,25,42,67,135,96,231,0.000333,0.467089,24,33630.39847,1868.355471,1401.266603,342.573737,16,0
0,0,24,24,25,41,66,134,94,228,0.000333,0.459374,24,33074.92462,1837.495812,1378.121859,335.756037,16,0
0,0,17,17,26,36,62,106,75,181,0.000333,0.359237,26,28020.44784,1556.691546,1077.709532,308.328733,10,0
0,0,24,24,29,43,72,151,107,258,0.000333,0.530614,28,44571.53821,2476.196567,1591.84065,374.210833,11,0
0,0,23,23,27,42,69,149,108,257,0.000333,0.523297,26,40817.16042,2267.620023,1569.890785,354.859294,10,0
0,0,25,25,27,51,78,153,117,270,0.000333,0.565686,26,44123.52358,2451.306865,1697.058599,417.675655,26,0
0,0,16,16,24,35,59,105,75,180,0.000333,0.352959,24,25413.01797,1411.834332,1058.875749,289.564006,7,0
0,0,22,22,25,40,65,126,89,215,0.000333,0.431603,24,31075.41792,1726.412106,1294.80908,328.973529,15,0
0,0,32,32,25,43,68,165,118,283,0.000333,0.574251,24,41346.04762,2297.002645,1722.751984,349.425789,20,0
0,0,33,33,29,45,74,190,137,327,0.000333,0.67683,42,85280.63252,4737.812918,2030.491251,388.014838,15,0
0,0,27,27,24,37,61,141,100,241,0.000333,0.476436,24,34303.38476,1905.743598,1429.307698,302.788875,12,0
0,0,33,33,29,46,75,187,134,321,0.000333,0.666484,28,55984.62239,3110.256799,1999.4508,394.965299,15,0
0,0,32,32,23,34,57,166,119,285,0.000333,0.554125,33,54858.33058,3047.685032,1662.373654,277.015662,15,0
0,0,39,39,26,47,73,219,158,377,0.000333,0.777855,39,91008.99049,5056.055027,2333.563859,383.277109,24,0
0,0,33,33,25,45,70,170,121,291,0.000333,0.59454,24,42806.91259,2378.161811,1783.621358,363.229794,20,0
0,0,32,32,25,43,68,166,118,284,0.000333,0.57628,24,41492.14673,2305.119263,1728.839447,349.425789,20,0
0,0,33,33,25,45,70,171,123,294,0.000333,0.60067,24,43248.22097,2402.678943,1802.009207,363.229794,20,0
0,0,33,33,25,44,69,170,121,291,0.000333,0.592527,24,42661.93481,2370.107489,1777.580617,356.311396,20,0
0,0,26,26,26,38,64,142,102,244,0.000333,0.488,26,38064,2114.666667,1464,321.632678,14,0
0,0,28,28,23,36,59,154,110,264,0.000333,0.517673,33,51249.58625,2847.199236,1553.017765,290.159225,11,0
0,0,26,26,24,38,62,145,104,249,0.000333,0.494198,24,35582.27715,1976.793175,1482.594881,309.460346,12,0
0,0,25,25,24,39,63,145,104,249,0.000333,0.496114,24,35720.22482,1984.456935,1488.342701,316.169787,11,0
0,0,35,35,25,40,65,206,146,352,0.000333,0.706624,36,76315.44493,4239.74694,2119.87347,328.973529,24,0
0,0,33,33,29,45,74,187,134,321,0.000333,0.664412,28,55810.56685,3100.587047,1993.23453,388.014838,15,0
0,0,31,31,26,41,67,200,140,340,0.000333,0.68749,39,80436.34267,4468.685704,2062.470325,341.871065,23,0
0,0,32,32,27,45,72,185,135,320,0.000333,0.658125,39,77000.66402,4277.814668,1974.376,375.515352,14,0
0,0,29,29,26,48,74,168,129,297,0.000333,0.614736,26,47949.39889,2663.855494,1844.20765,390.289633,29,0
0,0,31,31,26,51,77,175,133,308,0.000333,0.64339,26,50184.42662,2788.023701,1930.170255,411.505125,30,0
0,0,29,29,24,39,63,172,126,298,0.000333,0.593743,36,64124.25902,3562.458834,1781.229417,316.169787,14,0
0,0,25,25,24,38,62,141,102,243,0.000333,0.48229,24,34724.87288,1929.159605,1446.869703,309.460346,11,0
0,0,31,31,25,43,68,162,116,278,0.000333,0.564105,24,40615.55208,2256.41956,1692.31467,349.425789,19,0
0,0,34,34,26,49,75,197,142,339,0.000333,0.703857,26,54900.80794,3050.044885,2111.569536,397.332215,28,0
0,0,35,35,31,51,82,222,161,383,0.000333,0.811647,45,109572.4088,6087.356044,2434.942418,442.873778,23,0
0,0,29,29,26,43,69,173,124,297,0.000333,0.604744,26,47170.02586,2620.556992,1814.231764,355.540817,20,0
0,0,35,35,31,52,83,219,158,377,0.000333,0.80113,45,108152.544,6008.474664,2403.389866,450.002951,23,0
0,0,34,34,25,40,65,198,143,341,0.000333,0.684542,36,73930.58727,4107.254848,2053.627424,328.973529,23,0
0,0,36,36,25,40,65,230,167,397,0.000333,0.79696,48,114762.241,6375.680058,2390.880022,328.973529,31,0
0,0,35,35,26,51,77,202,145,347,0.000333,0.724858,26,56538.94817,3141.052676,2174.57493,411.505125,28,0
0,0,34,34,26,49,75,198,142,340,0.000333,0.705933,26,55062.75722,3059.042068,2117.798355,397.332215,28,0
0,0,35,35,26,51,77,203,147,350,0.000333,0.731125,26,57027.75752,3168.208751,2193.375289,411.505125,28,0
0,0,35,35,26,50,76,202,145,347,0.000333,0.722677,26,56368.80203,3131.600113,2168.030847,404.404242,28,0
0,0,28,28,27,44,71,174,126,300,0.000333,0.614975,26,47968.02753,2664.890418,1844.924136,368.596954,22,0
0,0,30,30,25,42,67,186,134,320,0.000333,0.64705,36,69881.34747,3882.297082,1941.148541,342.573737,19,0
0,0,28,28,26,44,70,177,128,305,0.000333,0.623144,26,48605.21432,2700.289685,1869.43132,362.426424,20,0
0,0,27,27,26,45,71,177,128,305,0.000333,0.625224,26,48767.49466,2709.305259,1875.672871,369.344822,19,0
0,0,37,37,25,40,65,238,170,408,0.000333,0.819042,48,117942.0513,6552.336181,2457.126068,328.973529,32,0
0,0,35,35,31,51,82,219,158,377,0.000333,0.798932,45,107855.8698,5991.992764,2396.797106,442.873778,23,0
0,0,33,33,26,41,67,232,164,396,0.000333,0.800724,52,124912.9086,6939.606034,2402.171319,341.871065,31,0
0,0,34,34,29,51,80,217,159,376,0.000333,0.792348,42,99835.88847,5546.438249,2377.044964,430.175141,22,0
0,0,31,31,27,53,80,200,153,353,0.000333,0.74388,26,58022.65606,3223.480892,2231.640617,431.961747,37,0
0,0,33,33,27,56,83,207,157,364,0.000333,0.773505,26,60333.37318,3351.854065,2320.514353,453.593838,38,0
0,0,31,31,26,45,71,204,150,354,0.000333,0.72567,39,84903.40873,4716.856041,2177.01048,369.344822,22,0
0,0,27,27,26,44,70,173,126,299,0.000333,0.610885,26,47649.04617,2647.169232,1832.655622,362.426424,19,0
0,0,33,33,26,49,75,194,140,334,0.000333,0.693475,26,54091.06151,3005.058973,2080.425443,397.332215,27,0
0,0,25,25,23,33,56,150,106,256,0.000333,0.495561,33,49060.53438,2725.585243,1486.68286,270.506931,10,0
0,0,23,23,23,39,62,135,94,229,0.000333,0.454504,22,29997.24101,1666.51339,1363.510955,310.172612,10,0
0,0,19,19,24,39,63,123,91,214,0.000333,0.426379,24,30699.30969,1705.517205,1279.137904,316.169787,8,0
0,0,18,18,24,39,63,123,91,214,0.000333,0.426379,24,30699.30969,1705.517205,1279.137904,316.169787,7,0
0,0,35,35,26,49,75,205,145,350,0.000333,0.726696,26,56682.25008,3149.013894,2180.086542,397.332215,29,0
0,0,36,36,31,51,82,230,164,394,0.000333,0.834958,45,112719.397,6262.188725,2504.87549,442.873778,24,0
0,0,30,30,26,43,69,181,127,308,0.000333,0.627142,26,48917.06385,2717.614658,1881.425533,355.540817,21,0
0,0,36,36,31,52,83,227,161,388,0.000333,0.824505,45,111308.1885,6183.788248,2473.515299,450.002951,24,0
0,0,35,35,25,40,65,206,146,352,0.000333,0.706624,36,76315.44493,4239.74694,2119.87347,328.973529,24,0
0,0,37,37,25,40,65,238,170,408,0.000333,0.819042,48,117942.0513,6552.336181,2457.126068,328.973529,32,0
0,0,36,36,26,51,77,210,148,358,0.000333,0.747837,26,58331.24912,3240.624951,2243.509582,411.505125,29,0
0,0,35,35,26,49,75,206,145,351,0.000333,0.728772,26,56844.19937,3158.011076,2186.31536,397.332215,29,0
0,0,36,36,26,51,77,211,150,361,0.000333,0.754103,26,58820.05847,3267.781026,2262.309941,411.505125,29,0
0,0,36,36,26,50,76,210,148,358,0.000333,0.745586,26,58155.7093,3230.872739,2236.75805,404.404242,29,0
0,0,29,29,27,44,71,182,129,311,0.000333,0.637524,26,49726.85521,2762.603067,1912.571354,368.596954,23,0
0,0,31,31,25,42,67,194,137,331,0.000333,0.669292,36,72283.51879,4015.751044,2007.875522,342.573737,20,0
0,0,29,29,26,44,70,185,131,316,0.000333,0.645618,26,50358.18927,2797.677182,1936.853433,362.426424,21,0
0,0,28,28,26,45,71,185,131,316,0.000333,0.647773,26,50526.32233,2807.017907,1943.32009,369.344822,20,0
0,0,38,38,25,40,65,246,173,419,0.000333,0.841124,48,121121.8615,6728.992303,2523.372114,328.973529,33,0
0,0,36,36,31,51,82,227,161,388,0.000333,0.822243,45,111002.858,6166.825444,2466.730178,442.873778,24,0
0,0,34,34,26,41,67,240,167,407,0.000333,0.822966,52,128382.7116,7132.372868,2468.898301,341.871065,32,0
0,0,35,35,29,51,80,225,162,387,0.000333,0.815529,42,102756.6193,5708.70107,2446.586173,430.175141,23,0
0,0,32,32,27,53,80,208,156,364,0.000333,0.767061,26,59830.72749,3323.929305,2301.181827,431.961747,38,0
0,0,34,34,27,56,83,215,160,375,0.000333,0.79688,26,62156.63446,3453.146359,2390.639787,453.593838,39,0
0,0,32,32,26,45,71,212,153,365,0.000333,0.748219,39,87541.65025,4863.425014,2244.657699,369.344822,23,0
0,0,28,28,26,44,70,181,129,310,0.000333,0.633359,26,49402.02112,2744.556729,1900.077735,362.426424,20,0
0,0,34,34,26,49,75,202,143,345,0.000333,0.716314,26,55872.50365,3104.027981,2148.942448,397.332215,28,0
0,0,31,31,27,47,74,199,139,338,0.000333,0.699598,26,54568.67618,3031.593121,2098.795238,389.447639,28,0
0,0,32,32,31,48,79,224,158,382,0.000333,0.802681,45,108361.9911,6020.110615,2408.044246,421.658286,23,0
0,0,26,26,27,42,69,175,121,296,0.000333,0.602708,26,47011.20422,2611.733568,1808.123239,354.859294,20,0
0,0,32,32,31,49,80,221,155,376,0.000333,0.792348,45,106967.0234,5942.612409,2377.044964,428.700868,23,0
0,0,31,31,26,41,67,200,140,340,0.000333,0.68749,39,80436.34267,4468.685704,2062.470325,341.871065,23,0
0,0,33,33,26,41,67,232,164,396,0.000333,0.800724,52,124912.9086,6939.606034,2402.171319,341.871065,31,0
0,0,32,32,27,49,76,204,142,346,0.000333,0.720594,26,56206.35591,3122.575328,2161.78292,403.502745,28,0
0,0,31,31,27,47,74,200,139,339,0.000333,0.701668,26,54730.12197,3040.562331,2105.004691,389.447639,28,0
0,0,32,32,27,49,76,205,144,349,0.000333,0.726842,26,56693.69426,3149.649681,2180.526702,403.502745,28,0
0,0,32,32,27,48,75,204,142,346,0.000333,0.71839,26,56034.45294,3113.025163,2155.171267,396.460163,28,0
0,0,25,25,28,43,71,176,123,299,0.000333,0.612925,28,51485.68288,2860.315716,1838.774389,367.935322,22,0
0,0,27,27,26,40,66,188,131,319,0.000333,0.642721,39,75198.30724,4177.683735,1928.161724,335.088556,19,0
0,0,25,25,27,43,70,179,125,304,0.000333,0.621101,26,48445.85297,2691.436276,1863.302037,361.711347,20,0
0,0,24,24,27,43,70,179,125,304,0.000333,0.621101,26,48445.85297,2691.436276,1863.302037,361.711347,19,0
0,0,34,34,26,41,67,240,167,407,0.000333,0.822966,52,128382.7116,7132.372868,2468.898301,341.871065,32,0
0,0,32,32,31,49,80,221,155,376,0.000333,0.792348,45,106967.0234,5942.612409,2377.044964,428.700868,23,0
0,0,30,30,26,38,64,234,161,395,0.000333,0.79,52,123240,6846.666667,2370,321.632678,31,0
0,0,31,31,29,48,77,219,156,375,0.000333,0.783348,42,98701.88802,5483.438223,2350.044953,408.959649,22,0
0,0,28,28,28,50,78,202,150,352,0.000333,0.737487,42,92923.3864,5162.410356,2212.461581,416.798747,37,0
0,0,30,30,28,53,81,209,154,363,0.000333,0.767122,28,64438.23543,3579.901968,2301.365551,438.185722,38,0
0,0,28,28,26,43,69,206,147,353,0.000333,0.71877,39,84096.0562,4672.003122,2156.309133,355.540817,22,0
0,0,24,24,27,42,69,175,123,298,0.000333,0.60678,26,47328.84749,2629.380416,1820.340288,354.859294,19,0
0,0,30,30,27,47,74,196,137,333,0.000333,0.689249,26,53761.44724,2986.747069,2067.747971,389.447639,27,0
0,0,70,70,29,48,77,355,273,628,0.000333,1.311847,70,275487.9363,15304.88535,3935.541948,408.959649,24,0
0,0,35,35,27,47,74,194,146,340,0.000333,0.703738,39,82337.35163,4574.297313,2111.214144,389.447639,19,0
0,0,68,68,34,80,114,541,370,911,0.000333,2.074921,68,423283.8706,23515.77059,6224.762803,678.727984,26,0
0,0,63,63,34,78,112,498,345,843,0.000333,1.912867,68,390224.8136,21679.15631,5738.600199,663.23511,24,0
0,0,60,60,34,76,110,479,332,811,0.000333,1.833228,68,373978.4255,20776.57919,5499.682728,647.816228,23,0
0,0,80,80,35,81,116,591,381,972,0.000333,2.221986,68,453285.1119,25182.50621,6665.957527,693.052756,34,0
0,0,11,11,18,20,38,68,45,113,0.000333,0.197672,18,10674.28456,593.015809,593.015809,161.497212,5,0
0,0,23,23,19,31,50,107,72,179,0.000333,0.33675,18,18184.50464,1010.250258,1010.250258,234.290708,13,0
0,0,29,29,36,52,88,316,207,523,0.000333,1.126094,54,182427.2678,10134.84821,3378.282737,482.540165,13,0
0,0,11,11,20,26,46,88,63,151,0.000333,0.278019,20,16681.15711,926.73095,834.057855,208.649995,3,0
0,0,19,19,24,31,55,166,104,270,0.000333,0.520322,36,56194.81642,3121.934245,1560.967123,263.619186,7,0
0,0,49,49,31,46,77,314,184,498,0.000333,1.040287,60,187251.5818,10402.86566,3120.859697,407.663936,21,0
0,0,49,49,31,46,77,314,184,498,0.000333,1.040287,60,187251.5818,10402.86566,3120.859697,407.663936,21,0
0,0,50,50,30,44,74,294,163,457,0.000333,0.945907,45,127697.4085,7094.30047,2837.720188,387.421709,21,0
0,0,44,44,32,53,85,453,285,738,0.000333,1.57671,80,378410.4409,21022.80227,4730.130511,463.579784,16,0
0,0,41,41,31,47,78,549,308,857,0.000333,1.79553,90,484793.0731,26932.94851,5386.589702,414.645762,15,0
0,0,13,13,21,26,47,139,82,221,0.000333,0.409188,30,36826.92409,2045.940227,1227.564136,214.450099,5,0
0,0,43,43,31,41,72,287,162,449,0.000333,0.923432,45,124663.3347,6925.740814,2770.296326,373.239718,19,0
0,0,43,43,31,41,72,287,162,449,0.000333,0.923432,45,124663.3347,6925.740814,2770.296326,373.239718,19,0
0,0,44,44,30,39,69,267,141,408,0.000333,0.830759,45,112152.509,6230.694946,2492.277978,353.337404,19,0
0,0,17,17,24,28,52,133,87,220,0.000333,0.418032,36,45147.48257,2508.193476,1254.096738,244.645038,7,0
0,0,47,47,31,43,74,281,167,448,0.000333,0.927278,45,125182.5799,6954.58777,2781.835108,386.90947,21,0
0,0,47,47,31,43,74,281,167,448,0.000333,0.927278,45,125182.5799,6954.58777,2781.835108,386.90947,21,0
0,0,48,48,30,41,71,261,146,407,0.000333,0.834316,45,112632.6185,6257.367694,2502.947078,366.86635,21,0
0,0,11,11,20,23,43,84,57,141,0.000333,0.255034,20,15302.06661,850.114812,765.10333,190.480487,5,0
0,0,41,41,31,38,69,232,137,369,0.000333,0.751349,45,101432.0486,5635.113811,2254.045525,353.001331,19,0
0,0,41,41,31,38,69,232,137,369,0.000333,0.751349,45,101432.0486,5635.113811,2254.045525,353.001331,19,0
0,0,42,42,30,36,66,212,116,328,0.000333,0.660854,45,89215.2572,4956.403178,1982.561271,333.324018,19,0
0,0,60,60,32,69,101,562,351,913,0.000333,2.026316,80,486315.7667,27017.54259,6078.947084,581.488188,26,0
0,0,63,63,33,67,100,569,357,926,0.000333,2.050737,80,492176.8665,27343.15925,6152.210832,572.892982,30,0
0,0,51,51,33,60,93,623,346,969,0.000333,2.112148,80,506915.591,28161.97728,6336.444888,520.878442,25,0
0,0,61,61,33,65,98,516,329,845,0.000333,1.863143,80,447154.3855,24841.9103,5589.429818,557.918914,20,0
0,0,64,64,34,63,97,523,335,858,0.000333,1.887575,85,481331.6436,26740.64687,5662.725219,549.542372,24,0
0,0,52,52,32,55,87,577,324,901,0.000333,1.935031,80,464407.3672,25800.40929,5805.09209,477.974784,19,0
0,0,66,66,33,74,107,582,368,950,0.000333,2.134798,64,409881.1928,22771.17738,6404.393637,625.964555,25,0
0,0,69,69,34,72,106,589,374,963,0.000333,2.159662,85,550713.9288,30595.21827,6478.987398,617.208337,29,0
0,0,8,8,17,22,39,48,32,80,0.000333,0.140944,8,3382.65742,187.925412,422.832178,167.594364,4,0
0,0,11,11,19,27,46,60,41,101,0.000333,0.18596,9,5020.917818,278.939879,557.879758,209.092585,5,0
0,0,22,22,22,44,66,130,83,213,0.000333,0.429152,11,14162.01542,786.778635,1287.455947,338.322487,10,0
0,0,33,33,31,49,80,248,156,404,0.000333,0.851353,45,114932.6528,6385.147376,2554.05895,428.700868,13,0
0,0,25,25,25,40,65,129,92,221,0.000333,0.443648,24,31942.63888,1774.591049,1330.943287,328.973529,16,0
0,0,25,25,29,42,71,146,105,251,0.000333,0.514529,28,43220.42276,2401.134598,1543.586527,367.358781,11,0
0,0,21,21,26,45,71,127,100,227,0.000333,0.465331,26,36295.8075,2016.43375,1395.992596,369.344822,25,0
0,0,37,37,27,47,74,216,153,369,0.000333,0.763763,39,89360.24339,4964.457966,2291.288292,389.447639,24,0
0,0,71,71,29,47,76,349,269,618,0.000333,1.287073,70,270285.3442,15015.85246,3861.219203,401.947125,24,0
0,0,36,36,27,46,73,190,146,336,0.000333,0.69326,39,81111.46102,4506.192279,2079.781052,382.465813,19,0
0,0,29,29,27,44,71,169,124,293,0.000333,0.600625,26,46848.77356,2602.709642,1801.875906,368.596954,22,0
0,0,31,31,31,49,80,238,148,386,0.000333,0.813421,45,109811.891,6100.660612,2440.264245,428.700868,12,0
0,0,23,23,25,40,65,119,84,203,0.000333,0.407514,24,29340.97599,1630.054221,1222.540666,328.973529,15,0
0,0,23,23,29,42,71,136,97,233,0.000333,0.47763,28,40120.95021,2228.941678,1432.891079,367.358781,10,0
0,0,19,19,26,44,70,117,92,209,0.000333,0.427007,26,33306.52391,1850.36244,1281.020151,362.426424,24,0
0,0,35,35,27,47,74,206,145,351,0.000333,0.726506,39,85001.20712,4722.289285,2179.518131,389.447639,23,0
0,0,69,69,29,47,76,339,261,600,0.000333,1.249586,70,262412.9556,14578.49753,3748.756508,401.947125,23,0
0,0,34,34,27,46,73,180,138,318,0.000333,0.656121,39,76766.20418,4264.789121,1968.36421,382.465813,18,0
0,0,27,27,27,43,70,159,116,275,0.000333,0.561851,26,43824.37357,2434.687421,1685.55283,361.711347,21,0
0,0,32,32,31,50,81,249,156,405,0.000333,0.85588,45,115543.7663,6419.098128,2567.639251,435.772895,12,0
0,0,24,24,25,41,66,130,92,222,0.000333,0.447285,24,32204.53187,1789.140659,1341.855494,335.756037,15,0
0,0,24,24,29,43,72,147,105,252,0.000333,0.518274,28,43534.99081,2418.610601,1554.8211,374.210833,10,0
0,0,20,20,26,45,71,128,100,228,0.000333,0.467381,26,36455.70092,2025.316718,1402.142343,369.344822,24,0
0,0,36,36,27,48,75,217,153,370,0.000333,0.768221,39,89881.8537,4993.436317,2304.662915,396.460163,23,0
0,0,70,70,29,48,77,350,269,619,0.000333,1.293047,70,271539.8608,15085.54782,3879.140869,408.959649,23,0
0,0,35,35,27,47,74,191,146,337,0.000333,0.697529,39,81610.84558,4533.935866,2092.585784,389.447639,18,0
0,0,28,28,27,44,71,170,124,294,0.000333,0.602675,26,47008.66698,2611.59261,1808.025653,368.596954,21,0
0,0,32,32,31,50,81,253,158,411,0.000333,0.868559,45,117255.5258,6514.195878,2605.678351,435.772895,13,0
0,0,24,24,25,41,66,134,94,228,0.000333,0.459374,24,33074.92462,1837.495812,1378.121859,335.756037,16,0
0,0,24,24,29,43,72,151,107,258,0.000333,0.530614,28,44571.53821,2476.196567,1591.84065,374.210833,11,0
0,0,20,20,26,45,71,132,102,234,0.000333,0.47968,26,37415.06148,2078.614526,1439.040826,369.344822,25,0
0,0,36,36,27,48,75,221,155,376,0.000333,0.780679,39,91339.39728,5074.41096,2342.035828,396.460163,24,0
0,0,70,70,29,48,77,354,271,625,0.000333,1.305581,70,274171.9112,15231.77284,3916.741588,408.959649,24,0
0,0,35,35,27,47,74,195,148,343,0.000333,0.709948,39,83063.85767,4614.65876,2129.842504,389.447639,19,0
0,0,28,28,27,44,71,174,126,300,0.000333,0.614975,26,47968.02753,2664.890418,1844.924136,368.596954,22,0
0,0,68,68,34,80,114,541,370,911,0.000333,2.074921,68,423283.8706,23515.77059,6224.762803,678.727984,26,0
0,0,63,63,34,78,112,498,345,843,0.000333,1.912867,68,390224.8136,21679.15631,5738.600199,663.23511,24,0
0,0,66,66,34,79,113,523,359,882,0.000333,2.005133,68,409047.0535,22724.8363,6015.397845,670.972416,25,0
0,0,63,63,34,77,111,504,346,850,0.000333,1.925084,68,392717.2371,21817.62428,5775.253486,655.5163,24,0
0,0,11,11,18,20,38,68,45,113,0.000333,0.197672,18,10674.28456,593.015809,593.015809,161.497212,5,0
0,0,26,26,20,43,63,147,91,238,0.000333,0.474198,20,28451.85244,1580.658469,1422.592622,319.767946,17,0
0,0,54,54,30,47,77,304,177,481,0.000333,1.004775,45,135644.5947,7535.810815,3014.324326,408.272394,21,0
0,0,19,19,24,31,55,166,104,270,0.000333,0.520322,36,56194.81642,3121.934245,1560.967123,263.619186,7,0
0,0,49,49,31,46,77,314,184,498,0.000333,1.040287,60,187251.5818,10402.86566,3120.859697,407.663936,21,0
0,0,48,48,30,42,72,277,155,432,0.000333,0.888469,45,119943.342,6663.519002,2665.407601,373.68405,19,0
0,0,43,43,31,41,72,287,162,449,0.000333,0.923432,45,124663.3347,6925.740814,2770.296326,373.239718,19,0
0,0,52,52,30,44,74,271,160,431,0.000333,0.892091,45,120432.348,6690.686001,2676.274401,387.421709,21,0
0,0,17,17,24,28,52,133,87,220,0.000333,0.418032,36,45147.48257,2508.193476,1254.096738,244.645038,7,0
0,0,47,47,31,43,74,281,167,448,0.000333,0.927278,45,125182.5799,6954.58777,2781.835108,386.90947,21,0
0,0,46,46,30,39,69,222,130,352,0.000333,0.716734,45,96759.0274,5375.501522,2150.200609,353.337404,19,0
0,0,11,11,20,23,43,84,57,141,0.000333,0.255034,20,15302.06661,850.114812,765.10333,190.480487,5,0
0,0,41,41,31,38,69,232,137,369,0.000333,0.751349,45,101432.0486,5635.113811,2254.045525,353.001331,19,0
0,0,16,16,15,28,43,84,54,138,0.000333,0.249608,7,5241.771753,291.209542,748.824536,193.209297,4,0
0,0,13,13,15,27,42,78,48,126,0.000333,0.226477,7,4756.023967,264.223554,679.431995,186.985321,4,0
0,0,11,11,13,21,34,63,41,104,0.000333,0.176365,6,3174.576813,176.365378,529.096135,140.344382,6,0
0,0,3,3,11,13,24,17,14,31,0.000333,0.047378,5,710.669188,39.481622,142.133838,86.159464,1,0
0,0,3,3,11,13,24,17,14,31,0.000333,0.047378,5,710.669188,39.481622,142.133838,86.159464,1,0
0,0,3,3,11,13,24,17,14,31,0.000333,0.047378,5,710.669188,39.481622,142.133838,86.159464,1,0
0,0,3,3,10,16,26,16,17,33,0.000333,0.051705,5,775.572553,43.087364,155.114511,97.219281,1,0
0,0,3,3,10,18,28,18,22,40,0.000333,0.064098,5,961.470984,53.415055,192.294197,108.277931,1,0
0,0,3,3,10,17,27,20,19,39,0.000333,0.061814,5,927.203063,51.511281,185.440613,102.706149,1,0
0,0,11,11,15,24,39,55,40,95,0.000333,0.167371,7,3514.792476,195.266249,502.113211,168.642459,3,0
0,0,10,10,15,22,37,50,37,87,0.000333,0.151074,7,3172.5571,176.253172,453.222443,156.710855,3,0
0,0,8,8,14,22,36,44,33,77,0.000333,0.132695,7,2786.589576,154.810532,398.084225,151.410465,2,0
0,0,11,11,15,25,40,55,40,95,0.000333,0.168528,7,3539.082183,196.615677,505.583169,174.699764,3,0
0,0,10,10,15,23,38,50,37,87,0.000333,0.15219,7,3195.987856,177.554881,456.569694,162.645284,3,0
0,0,8,8,14,22,36,44,33,77,0.000333,0.132695,7,2786.589576,154.810532,398.084225,151.410465,2,0
0,0,11,11,15,25,40,55,40,95,0.000333,0.168528,7,3539.082183,196.615677,505.583169,174.699764,3,0
0,0,10,10,15,23,38,50,37,87,0.000333,0.15219,7,3195.987856,177.554881,456.569694,162.645284,3,0
0,0,8,8,14,22,36,44,33,77,0.000333,0.132695,7,2786.589576,154.810532,398.084225,151.410465,2,0
0,0,11,11,14,26,40,56,41,97,0.000333,0.172076,7,3613.589176,200.754954,516.227025,175.514402,3,0
0,0,10,10,14,24,38,51,38,89,0.000333,0.155689,7,3269.458841,181.636602,467.065549,163.342069,3,0
0,0,11,11,14,26,40,55,41,96,0.000333,0.170302,7,3576.33568,198.685316,510.905097,175.514402,3,0
0,0,10,10,14,24,38,50,38,88,0.000333,0.153939,7,3232.723348,179.595742,461.817621,163.342069,3,0
0,0,13,13,15,26,41,59,43,102,0.000333,0.182157,7,3825.292131,212.51623,546.470304,180.814792,3,0
0,0,12,12,15,24,39,54,40,94,0.000333,0.165609,7,3477.79466,193.210814,496.827809,168.642459,3,0
0,0,13,13,15,26,41,59,43,102,0.000333,0.182157,7,3825.292131,212.51623,546.470304,180.814792,3,0
0,0,12,12,15,24,39,54,40,94,0.000333,0.165609,7,3477.79466,193.210814,496.827809,168.642459,3,0
0,0,22,22,16,25,41,102,71,173,0.000333,0.308952,16,14829.70395,823.872442,926.856497,180.096405,5,0
0,0,4,4,11,9,20,22,14,36,0.000333,0.051863,5,777.947057,43.219281,155.589411,66.583073,2,0
0,0,30,30,25,43,68,171,123,294,0.000333,0.596571,24,42953.13781,2386.285434,1789.714075,349.425789,14,0
0,0,52,52,27,62,89,330,228,558,0.000333,1.204486,39,140924.9109,7829.161718,3613.459254,497.542134,13,0
0,0,37,37,26,56,82,220,157,377,0.000333,0.798932,26,62316.72475,3462.040264,2396.797106,447.423308,15,0
0,0,53,53,26,63,89,338,236,574,0.000333,1.239024,39,144965.7686,8053.65381,3717.070989,498.780068,12,0
0,0,19,19,21,40,61,137,96,233,0.000333,0.460621,20,27637.23599,1535.402,1381.8618,305.11579,7,0
0,0,13,13,23,27,50,110,70,180,0.000333,0.338631,22,22349.67051,1241.648362,1015.894114,232.423888,8,0
0,0,15,15,23,27,50,113,74,187,0.000333,0.3518,22,23218.82437,1289.934687,1055.401107,232.423888,9,0
0,0,14,14,23,27,50,126,78,204,0.000333,0.383782,22,25329.62658,1407.201477,1151.346663,232.423888,8,0
0,0,16,16,23,27,50,129,82,211,0.000333,0.396951,33,39298.17065,2183.231703,1190.853656,232.423888,9,0
0,0,3,3,11,11,22,16,13,29,0.000333,0.043108,5,646.617585,35.923199,129.323517,76.107496,1,0
0,0,3,3,11,11,22,16,13,29,0.000333,0.043108,5,646.617585,35.923199,129.323517,76.107496,1,0
0,0,10,10,17,26,43,67,41,108,0.000333,0.195346,8,4688.292748,260.460708,586.036594,191.698301,4,0
0,0,7,7,15,21,36,51,31,82,0.000333,0.141311,7,2967.536951,164.863164,423.93385,150.842025,4,0
0,0,9,9,17,25,42,66,39,105,0.000333,0.188731,8,4529.546635,251.64148,566.193329,185.583273,4,0
0,0,7,7,16,20,36,51,29,80,0.000333,0.137865,8,3308.752001,183.819556,413.594,150.438562,4,0
0,0,3,3,11,11,22,15,12,27,0.000333,0.040135,5,602.023269,33.445737,120.404654,76.107496,2,0
0,0,12,12,18,22,40,52,34,86,0.000333,0.152562,9,4119.172345,228.842908,457.685816,173.166146,6,0
0,0,2,2,6,5,11,6,7,13,0.000333,0.014991,3,134.917833,7.495435,44.972611,27.119415,1,0
0,0,2,2,6,5,11,6,7,13,0.000333,0.014991,3,134.917833,7.495435,44.972611,27.119415,1,0
0,0,2,2,6,5,11,6,7,13,0.000333,0.014991,3,134.917833,7.495435,44.972611,27.119415,1,0
0,0,2,2,8,5,13,8,7,15,0.000333,0.018502,4,222.026383,12.334799,55.506596,35.60964,1,0
0,0,47,47,26,63,89,276,170,446,0.000333,0.962726,26,75092.60487,4171.811381,2888.17711,498.780068,19,0
0,0,46,46,26,63,89,275,168,443,0.000333,0.95625,26,74587.49766,4143.74987,2868.74991,498.780068,19,0
0,0,8,8,19,11,30,165,28,193,0.000333,0.315677,18,17046.53793,947.029885,947.029885,118.764371,8,0
0,0,17,17,17,28,45,84,54,138,0.000333,0.252625,8,6063.005818,336.833657,757.875727,204.092806,10,0
0,0,25,25,19,34,53,135,84,219,0.000333,0.418138,18,22579.46243,1254.41458,1254.41458,253.684359,14,0
0,0,17,17,17,28,45,84,54,138,0.000333,0.252625,8,6063.005818,336.833657,757.875727,204.092806,10,0
0,0,24,24,22,39,61,109,76,185,0.000333,0.365729,11,12069.05048,670.502805,1097.186407,304.238182,11,0
0,0,28,28,22,39,61,123,88,211,0.000333,0.417129,22,27530.48272,1529.471262,1251.385578,304.238182,12,0
0,0,26,26,19,23,42,108,80,188,0.000333,0.337919,27,27371.40324,1520.633513,1013.755675,184.752548,11,0
0,0,32,32,22,39,61,137,100,237,0.000333,0.468528,22,30922.86448,1717.936915,1405.584749,304.238182,13,0
0,0,10,10,16,25,41,64,39,103,0.000333,0.183943,8,4414.622852,245.256825,551.827856,180.096405,4,0
0,0,7,7,14,20,34,48,29,77,0.000333,0.130578,7,2742.142471,152.341248,391.734639,139.741531,4,0
0,0,9,9,16,24,40,63,37,100,0.000333,0.177398,8,4257.542476,236.530138,532.192809,174.0391,4,0
0,0,7,7,15,19,34,48,27,75,0.000333,0.127187,7,2670.917992,148.384333,381.559713,139.313982,4,0
0,0,23,23,23,38,61,206,118,324,0.000333,0.64052,33,63411.44361,3522.857979,1921.558897,303.463171,13,0
0,0,25,25,23,39,62,213,124,337,0.000333,0.668855,33,66216.61717,3678.700954,2006.564157,310.172612,13,0
0,0,23,23,21,39,60,202,117,319,0.000333,0.628099,30,56528.943,3140.496833,1884.2981,298.369352,13,0
0,0,29,29,19,27,46,155,117,272,0.000333,0.500803,36,54086.71867,3004.817704,1502.408852,209.092585,5,0
0,0,28,28,18,26,44,147,112,259,0.000333,0.471331,36,50903.74041,2827.985578,1413.992789,197.270083,5,0
0,0,31,31,19,33,52,164,135,299,0.000333,0.568144,36,61359.53313,3408.862951,1704.431476,247.175629,5,0
0,0,30,30,19,31,50,156,131,287,0.000333,0.539929,36,58312.32215,3239.573453,1619.786726,234.290708,4,0
0,0,32,32,19,34,53,174,139,313,0.000333,0.597613,36,64542.20768,3585.678205,1792.839102,253.684359,5,0
0,0,32,32,19,28,47,174,130,304,0.000333,0.562865,36,60789.42039,3377.190022,1688.595011,215.316561,6,0
0,0,31,31,18,27,45,166,125,291,0.000333,0.53271,36,57532.65304,3196.258502,1598.129251,203.440613,6,0
0,0,34,34,18,34,52,183,148,331,0.000333,0.628949,36,67926.43968,3773.691093,1886.845547,248.032387,6,0
0,0,33,33,18,32,50,175,144,319,0.000333,0.60013,36,64814.04448,3600.780249,1800.390125,235.05865,5,0
0,0,35,35,18,35,53,193,152,345,0.000333,0.658711,36,71140.77205,3952.265114,1976.132557,254.583556,6,0
0,0,20,20,17,25,42,132,97,229,0.000333,0.411614,24,29636.17656,1646.454253,1234.84069,185.583273,3,0
0,0,19,19,16,24,40,124,92,216,0.000333,0.383179,24,27588.87524,1532.715291,1149.536468,174.0391,3,0
0,0,22,22,16,31,47,141,115,256,0.000333,0.473992,24,34127.39391,1895.966328,1421.974746,217.580086,3,0
0,0,21,21,16,29,45,133,111,244,0.000333,0.446671,24,32160.29173,1786.682874,1340.012156,204.881449,2,0
0,0,23,23,16,32,48,151,119,270,0.000333,0.502647,24,36190.55701,2010.5865,1507.939875,224,3,0
0,0,19,19,17,25,42,130,95,225,0.000333,0.404424,24,29118.51408,1617.695227,1213.27142,185.583273,3,0
0,0,18,18,16,24,40,122,90,212,0.000333,0.376083,24,27077.97015,1504.331675,1128.248756,174.0391,3,0
0,0,21,21,16,31,47,139,113,252,0.000333,0.466585,24,33594.15338,1866.341854,1399.756391,217.580086,3,0
0,0,20,20,16,29,45,131,109,240,0.000333,0.439348,24,31633.07384,1757.392991,1318.044743,204.881449,2,0
0,0,22,22,16,32,48,149,117,266,0.000333,0.4952,24,35654.40061,1980.800034,1485.600025,224,3,0
0,0,3,3,8,13,21,15,17,32,0.000333,0.046851,4,562.21663,31.234257,140.554158,72.105716,1,0
0,0,3,3,7,13,20,15,19,34,0.000333,0.048982,3,440.836666,24.490926,146.945555,67.757201,1,0
0,0,5,5,11,15,26,23,22,45,0.000333,0.070507,5,1057.598937,58.755496,211.519787,96.657107,2,0
0,0,4,4,9,15,24,23,23,46,0.000333,0.070303,4,843.6331,46.868506,210.908275,87.132684,2,0
0,0,5,5,12,17,29,33,27,60,0.000333,0.09716,6,1748.873158,97.15962,291.47886,112.506418,2,0
0,0,40,40,23,39,62,247,177,424,0.000333,0.841526,44,111081.4864,6171.193687,2524.579236,310.172612,8,0
0,0,13,13,23,27,50,110,70,180,0.000333,0.338631,22,22349.67051,1241.648362,1015.894114,232.423888,8,0
0,0,15,15,23,27,50,113,74,187,0.000333,0.3518,22,23218.82437,1289.934687,1055.401107,232.423888,9,0
0,0,14,14,23,27,50,126,78,204,0.000333,0.383782,22,25329.62658,1407.201477,1151.346663,232.423888,8,0
0,0,16,16,23,27,50,129,82,211,0.000333,0.396951,33,39298.17065,2183.231703,1190.853656,232.423888,9,0
0,0,19,19,19,42,61,125,80,205,0.000333,0.405267,9,10942.21039,607.900577,1215.801154,307.187955,11,0
0,0,28,28,22,62,84,185,116,301,0.000333,0.641363,11,21164.96299,1175.831277,1924.087544,467.267667,14,0
0,0,15,15,18,27,45,79,48,127,0.000333,0.232488,9,6277.188089,348.732672,697.465343,203.440613,6,0
0,0,15,15,17,29,46,81,49,130,0.000333,0.239354,8,5744.504434,319.139135,718.063054,210.368317,5,0
0,0,18,18,19,31,50,109,64,173,0.000333,0.325462,18,17574.96818,976.387121,976.387121,234.290708,6,0
0,0,18,18,18,33,51,111,65,176,0.000333,0.332782,9,8985.121742,499.17343,998.34686,241.523656,5,0
0,0,18,18,19,31,50,109,64,173,0.000333,0.325462,18,17574.96818,976.387121,976.387121,234.290708,6,0
0,0,18,18,18,33,51,111,65,176,0.000333,0.332782,9,8985.121742,499.17343,998.34686,241.523656,5,0
0,0,28,28,24,40,64,172,104,276,0.000333,0.552,24,39744,2208,1656,322.916224,9,0
0,0,26,26,24,39,63,144,92,236,0.000333,0.470213,24,33855.31349,1880.850749,1410.638062,316.169787,9,0
0,0,2,2,6,5,11,6,7,13,0.000333,0.014991,3,134.917833,7.495435,44.972611,27.119415,1,0
0,0,2,2,6,5,11,6,7,13,0.000333,0.014991,3,134.917833,7.495435,44.972611,27.119415,1,0
0,0,2,2,6,5,11,6,7,13,0.000333,0.014991,3,134.917833,7.495435,44.972611,27.119415,1,0
0,0,2,2,8,5,13,8,7,15,0.000333,0.018502,4,222.026383,12.334799,55.506596,35.60964,1,0
0,0,33,33,27,37,64,170,124,294,0.000333,0.588,39,68796,3822,1764,321.131737,9,0
0,0,70,70,29,47,76,320,227,547,0.000333,1.139205,56,191386.5156,10632.5842,3417.61635,401.947125,21,0
0,0,61,61,29,47,76,290,206,496,0.000333,1.032991,56,173542.4346,9641.246367,3098.972047,401.947125,23,0
0,0,15,15,16,29,45,82,50,132,0.000333,0.241642,8,5799.39687,322.188715,724.924609,204.881449,6,0
0,0,15,15,16,31,47,84,51,135,0.000333,0.249956,8,5998.95596,333.275331,749.869495,217.580086,5,0
0,0,18,18,17,33,50,112,66,178,0.000333,0.334869,16,16073.70243,892.983468,1004.606402,235.951874,6,0
0,0,18,18,17,35,52,114,67,181,0.000333,0.343927,8,8254.236712,458.568706,1031.779589,249.011774,5,0
0,0,18,18,17,33,50,112,66,178,0.000333,0.334869,16,16073.70243,892.983468,1004.606402,235.951874,6,0
0,0,18,18,17,35,52,114,67,181,0.000333,0.343927,8,8254.236712,458.568706,1031.779589,249.011774,5,0
0,0,44,44,22,43,65,283,179,462,0.000333,0.927445,44,122422.6929,6801.260717,2782.33393,331.43688,17,0
0,0,42,42,22,40,62,275,173,448,0.000333,0.88916,44,117369.1177,6520.506537,2667.479947,310.984619,17,0
0,0,55,55,28,49,77,354,228,582,0.000333,1.215757,56,204247.1069,11347.0615,3647.269767,409.72672,20,0
0,0,41,41,22,40,62,274,172,446,0.000333,0.885191,44,116845.1484,6491.397133,2655.571554,310.984619,16,0
0,0,60,60,28,50,78,401,253,654,0.000333,1.370218,70,287745.7136,15985.87298,4110.653051,416.798747,23,0
0,0,72,72,29,52,81,493,313,806,0.000333,1.703306,84,429233.2046,23846.28914,5109.919102,437.304314,26,0
0,0,37,37,21,37,58,243,156,399,0.000333,0.779111,40,93493.37668,5194.076482,2337.334417,284.98844,15,0
0,0,17,17,22,25,47,89,67,156,0.000333,0.288839,22,19063.34894,1059.074941,866.515861,214.2039,6,0
0,0,30,30,21,31,52,156,105,261,0.000333,0.495938,30,44634.44299,2479.691277,1487.814766,245.818752,15,0
0,0,16,16,21,21,42,84,62,146,0.000333,0.262426,20,15745.56688,874.753715,787.278344,184.477332,6,0
0,0,84,84,29,55,84,527,322,849,0.000333,1.809026,70,379895.4244,21105.30136,5427.077492,458.856233,34,0
0,0,10,10,13,20,33,56,40,96,0.000333,0.161421,12,5811.142026,322.841224,484.261835,134.544278,8,0
0,0,12,12,14,21,35,55,45,100,0.000333,0.170976,14,7180.996224,398.944235,512.928302,145.541635,8,0
0,0,8,8,13,17,30,40,32,72,0.000333,0.117765,6,2119.776737,117.765374,353.296123,117.592585,7,0
0,0,7,7,13,17,30,36,29,65,0.000333,0.106316,6,1913.687332,106.315963,318.947889,117.592585,6,0
0,0,6,6,14,17,31,33,26,59,0.000333,0.097433,7,2046.083076,113.671282,292.297582,122.789837,5,0
0,0,6,6,12,16,28,30,23,53,0.000333,0.08493,6,1528.738865,84.929937,254.789811,107.01955,4,0
0,0,6,6,13,16,29,31,23,54,0.000333,0.087444,6,1573.985842,87.443658,262.330974,112.105716,4,0
0,0,8,8,15,25,40,46,34,80,0.000333,0.141918,7,2980.279733,165.571096,425.754248,174.699764,4,0
0,0,21,21,26,45,71,127,100,227,0.000333,0.465331,26,36295.8075,2016.43375,1395.992596,369.344822,25,0
0,0,42,42,32,55,87,246,177,423,0.000333,0.908455,48,130817.5247,7267.640263,2725.365099,477.974784,25,0
0,0,19,19,26,44,70,117,92,209,0.000333,0.427007,26,33306.52391,1850.36244,1281.020151,362.426424,24,0
0,0,40,40,32,55,87,236,169,405,0.000333,0.869797,48,125250.8216,6958.378976,2609.392116,477.974784,24,0
0,0,20,20,26,45,71,128,100,228,0.000333,0.467381,26,36455.70092,2025.316718,1402.142343,369.344822,24,0
0,0,41,41,32,56,88,247,177,424,0.000333,0.912933,48,131462.3523,7303.464017,2738.799006,485.211876,24,0
0,0,20,20,26,45,71,132,102,234,0.000333,0.47968,26,37415.06148,2078.614526,1439.040826,369.344822,25,0
0,0,41,41,32,56,88,251,179,430,0.000333,0.925852,48,133322.6686,7406.814923,2777.555596,485.211876,25,0
0,0,63,63,34,77,111,504,346,850,0.000333,1.925084,68,392717.2371,21817.62428,5775.253486,655.5163,24,0
0,0,11,11,18,20,38,68,45,113,0.000333,0.197672,18,10674.28456,593.015809,593.015809,161.497212,5,0
0,0,57,57,37,56,93,489,323,812,0.000333,1.769932,90,477881.7259,26548.98477,5309.796955,517.96165,26,0
0,0,53,53,35,73,108,443,297,740,0.000333,1.666206,68,339905.9391,18883.66328,4998.616752,631.382098,20,0
0,0,56,56,30,50,80,359,202,561,0.000333,1.182201,60,212796.0997,11822.00554,3546.601661,429.399527,21,0
0,0,54,54,30,47,77,326,185,511,0.000333,1.067443,45,144104.7565,8005.819806,3202.327922,408.272394,21,0
0,0,48,48,30,42,72,277,155,432,0.000333,0.888469,45,119943.342,6663.519002,2665.407601,373.68405,19,0
0,0,14,14,15,19,34,54,44,98,0.000333,0.16619,14,6979.999018,387.777723,498.571358,139.313982,3,0
0,0,14,14,15,19,34,54,44,98,0.000333,0.16619,14,6979.999018,387.777723,498.571358,139.313982,3,0
0,0,13,13,15,18,33,51,43,94,0.000333,0.158058,14,6638.422661,368.801259,474.173047,133.662009,2,0
0,0,12,12,15,20,35,60,41,101,0.000333,0.172686,14,7252.806186,402.933677,518.057585,145.041921,3,0
0,0,12,12,15,20,35,60,41,101,0.000333,0.172686,14,7252.806186,402.933677,518.057585,145.041921,3,0
0,0,9,9,14,17,31,39,34,73,0.000333,0.120552,14,5063.188629,281.288257,361.656331,122.789837,2,0
0,0,16,16,17,23,40,73,59,132,0.000333,0.234165,16,11239.91214,624.439563,702.494509,173.528793,2,0
0,0,10,10,14,19,33,39,39,78,0.000333,0.131154,14,5508.478378,306.026577,393.462741,134.013592,2,0
0,0,7,7,7,14,21,22,24,46,0.000333,0.067349,3,606.139804,33.674434,202.046601,72.954453,1,0
0,0,7,7,9,16,25,27,24,51,0.000333,0.078946,4,947.346663,52.63037,236.836666,92.529325,1,0
0,0,17,17,16,24,40,73,62,135,0.000333,0.239487,16,11495.36469,638.631371,718.460293,174.0391,2,0
0,0,14,14,11,23,34,58,51,109,0.000333,0.184844,10,5545.334497,308.074139,554.53345,142.095673,1,0
0,0,12,12,13,14,27,39,33,72,0.000333,0.114117,12,4108.222802,228.2346,342.3519,101.408685,3,0
0,0,4,4,10,12,22,18,21,39,0.000333,0.057973,5,869.589166,48.310509,173.917833,76.238831,1,0
0,0,16,16,16,24,40,54,53,107,0.000333,0.189815,16,9111.140898,506.174494,569.446306,174.0391,2,0
0,0,11,11,15,17,32,39,33,72,0.000333,0.12,7,2520,140,360,128.090227,2,0
0,0,15,15,16,18,34,55,47,102,0.000333,0.172974,16,8302.739357,461.263298,518.92121,139.05865,2,0
0,0,10,10,14,15,29,35,28,63,0.000333,0.102018,7,2142.369619,119.020534,306.052803,111.906328,2,0
0,0,9,9,14,18,32,40,33,73,0.000333,0.121667,7,2555,141.944444,365,128.361619,2,0
0,0,13,13,15,16,31,50,41,91,0.000333,0.150277,14,6311.646099,350.647006,450.831864,122.603359,3,0
0,0,10,10,13,15,28,35,30,65,0.000333,0.104159,12,3749.736839,208.318713,312.47807,106.709075,2,0
0,0,14,14,16,25,41,63,56,119,0.000333,0.212516,16,10200.77902,566.709945,637.548689,180.096405,2,0
0,0,12,12,16,15,31,44,35,79,0.000333,0.130461,16,6262.104136,347.894674,391.381509,122.603359,3,0
0,0,9,9,11,14,25,29,24,53,0.000333,0.082041,5,1230.62189,68.367883,246.124378,91.356717,2,0
0,0,12,12,16,15,31,44,35,79,0.000333,0.130461,16,6262.104136,347.894674,391.381509,122.603359,3,0
0,0,9,9,11,14,25,29,24,53,0.000333,0.082041,5,1230.62189,68.367883,246.124378,91.356717,2,0
0,0,12,12,17,16,33,45,36,81,0.000333,0.136199,16,6537.534779,363.196377,408.595924,133.486868,3,0
0,0,9,9,12,15,27,30,25,55,0.000333,0.087173,6,1569.112876,87.172938,261.518813,101.622909,2,0
0,0,12,12,16,16,32,44,36,80,0.000333,0.133333,16,6400,355.555556,400,128,3,0
0,0,9,9,11,15,26,29,25,54,0.000333,0.084608,5,1269.118724,70.506596,253.823745,96.657107,2,0
0,0,16,16,14,19,33,61,57,118,0.000333,0.198413,21,12500.00863,694.444924,595.238506,134.013592,2,0
0,0,15,15,14,19,33,59,55,114,0.000333,0.191687,14,8050.853014,447.269612,575.06093,134.013592,2,0
0,0,16,16,15,20,35,61,59,120,0.000333,0.205171,14,8617.195468,478.733082,615.513962,145.041921,2,0
0,0,15,15,15,20,35,59,57,116,0.000333,0.198332,14,8329.95562,462.775312,594.99683,145.041921,2,0
0,0,19,19,15,20,35,75,69,144,0.000333,0.246206,21,15510.95184,861.719547,738.616754,145.041921,2,0
0,0,10,10,14,16,30,47,35,82,0.000333,0.134122,14,5633.110404,312.950578,402.365029,117.302969,2,0
0,0,18,18,14,20,34,67,67,134,0.000333,0.22724,21,14316.12044,795.340024,681.720021,139.741531,2,0
0,0,17,17,14,20,34,65,65,130,0.000333,0.220457,21,13888.77356,771.598531,661.370169,139.741531,2,0
0,0,18,18,15,21,36,67,71,138,0.000333,0.237817,21,14982.44265,832.357925,713.44965,150.842025,2,0
0,0,17,17,15,21,36,65,69,134,0.000333,0.230923,21,14548.16895,808.231609,692.76995,150.842025,2,0
0,0,21,21,15,21,36,81,81,162,0.000333,0.279176,21,17588.08486,977.115825,837.52785,150.842025,2,0
0,0,10,10,14,16,30,47,35,82,0.000333,0.134122,14,5633.110404,312.950578,402.365029,117.302969,2,0
0,0,10,10,13,15,28,32,27,59,0.000333,0.094545,6,1701.803642,94.544647,283.63394,106.709075,3,0
0,0,10,10,13,15,28,32,27,59,0.000333,0.094545,6,1701.803642,94.544647,283.63394,106.709075,3,0
0,0,10,10,13,15,28,32,27,59,0.000333,0.094545,6,1701.803642,94.544647,283.63394,106.709075,3,0
0,0,10,10,13,15,28,32,27,59,0.000333,0.094545,6,1701.803642,94.544647,283.63394,106.709075,3,0
0,0,11,11,16,18,34,38,33,71,0.000333,0.120403,8,2889.678894,160.537716,361.209862,139.05865,3,0
0,0,9,9,13,14,27,29,26,55,0.000333,0.087173,6,1569.112876,87.172938,261.518813,101.408685,2,0
0,0,7,7,8,16,24,27,33,60,0.000333,0.091699,8,2200.782,122.265667,275.09775,88,1,0
0,0,7,7,9,18,27,28,31,59,0.000333,0.093513,4,1122.153451,62.341858,280.538363,103.587975,1,0
0,0,14,14,13,24,37,65,67,132,0.000333,0.229216,12,8251.774131,458.431896,687.647844,158.144816,1,0
0,0,13,13,11,24,35,59,62,121,0.000333,0.206881,10,6206.432451,344.801803,620.643245,148.092848,1,0
0,0,10,10,14,16,30,47,39,86,0.000333,0.140664,14,5907.896277,328.21646,421.992591,117.302969,2,0
0,0,10,10,14,16,30,47,39,86,0.000333,0.140664,14,5907.896277,328.21646,421.992591,117.302969,2,0
0,0,12,12,12,20,32,48,82,130,0.000333,0.216667,24,15600,866.666667,650,129.458112,1,0
0,0,11,11,14,18,32,50,38,88,0.000333,0.146667,14,6160,342.222222,440,128.361619,2,0
0,0,11,11,15,19,34,52,39,91,0.000333,0.15432,14,6481.42766,360.079314,462.959119,139.313982,2,0
0,0,10,10,15,16,31,47,32,79,0.000333,0.130461,14,5479.341119,304.40784,391.381509,122.603359,2,0
0,0,10,10,14,16,30,46,32,78,0.000333,0.127579,14,5358.32453,297.684696,382.737466,117.302969,2,0
0,0,10,10,14,14,28,46,31,77,0.000333,0.123389,14,5182.328606,287.907145,370.166329,106.605938,2,0
0,0,10,10,14,15,29,46,31,77,0.000333,0.124688,14,5236.903513,290.939084,374.064537,111.906328,2,0
0,0,10,10,15,15,30,47,32,79,0.000333,0.129215,14,5427.020999,301.501167,387.644357,117.206718,2,0
0,0,10,10,14,15,29,46,32,78,0.000333,0.126308,14,5304.915247,294.717514,378.922518,111.906328,2,0
0,0,10,10,14,15,29,46,31,77,0.000333,0.124688,14,5236.903513,290.939084,374.064537,111.906328,2,0
0,0,10,10,14,15,29,46,31,77,0.000333,0.124688,14,5236.903513,290.939084,374.064537,111.906328,2,0
0,0,10,10,10,18,28,40,38,78,0.000333,0.124991,10,3749.736839,208.318713,374.973684,108.277931,1,0
0,0,10,10,11,19,30,44,35,79,0.000333,0.129215,5,1938.221785,107.678988,387.644357,118.764371,1,0
0,0,10,10,11,20,31,41,37,78,0.000333,0.128809,5,1932.136561,107.34092,386.427312,124.49231,1,0
0,0,20,20,16,29,45,101,77,178,0.000333,0.32585,16,15640.79762,868.933201,977.549851,204.881449,2,0
0,0,20,20,16,30,46,104,81,185,0.000333,0.34062,16,16349.74339,908.319077,1021.858962,211.206718,2,0
0,0,12,12,15,18,33,51,36,87,0.000333,0.146287,14,6144.072037,341.337335,438.862288,133.662009,3,0
0,0,11,11,15,17,32,46,31,77,0.000333,0.128333,7,2695,149.722222,385,128.090227,3,0
0,0,12,12,15,18,33,51,36,87,0.000333,0.146287,14,6144.072037,341.337335,438.862288,133.662009,3,0
0,0,11,11,15,17,32,46,31,77,0.000333,0.128333,7,2695,149.722222,385,128.090227,3,0
0,0,11,11,15,17,32,48,35,83,0.000333,0.138333,14,5810,322.777778,415,128.090227,2,0
0,0,10,10,15,16,31,43,30,73,0.000333,0.120552,7,2531.594315,140.644129,361.656331,122.603359,2,0
0,0,13,13,18,19,37,57,42,99,0.000333,0.171912,18,9283.245898,515.735883,515.735883,155.769273,3,0
0,0,12,12,18,18,36,52,37,89,0.000333,0.153374,18,8282.219852,460.123325,460.123325,150.1173,3,0
0,0,10,10,13,12,25,36,29,65,0.000333,0.100617,12,3622.207828,201.233768,301.850652,91.125266,3,0
0,0,7,7,9,11,20,21,20,41,0.000333,0.059066,4,708.796208,39.377567,177.199052,66.583073,1,0
0,0,3,3,8,10,18,11,13,24,0.000333,0.033359,4,400.3128,22.2396,100.0782,57.219281,1,0
0,0,9,9,13,12,25,31,25,56,0.000333,0.086685,12,3120.67136,173.370631,260.055947,91.125266,3,0
0,0,9,9,11,11,22,28,26,54,0.000333,0.08027,10,2408.093074,133.782949,240.809307,76.107496,2,0
0,0,5,5,5,9,14,9,15,24,0.000333,0.030459,2,182.753036,10.152946,91.376518,40.138965,1,0
0,0,5,5,6,11,17,10,15,25,0.000333,0.034062,3,306.559713,17.031095,102.186571,53.563523,1,0
0,0,10,10,13,15,28,33,26,59,0.000333,0.094545,6,1701.803642,94.544647,283.63394,106.709075,3,0
0,0,20,20,14,24,38,81,83,164,0.000333,0.286887,21,18073.86236,1004.103464,860.660112,163.342069,6,0
0,0,14,14,13,19,32,44,61,105,0.000333,0.175,18,9450,525,525,128.816339,3,0
0,0,16,16,15,21,36,63,51,114,0.000333,0.196457,14,8251.200302,458.400017,589.37145,150.842025,2,0
0,0,10,10,13,17,30,40,32,72,0.000333,0.117765,6,2119.776737,117.765374,353.296123,117.592585,2,0
0,0,10,10,14,15,29,41,30,71,0.000333,0.114972,14,4828.833109,268.268506,344.916651,111.906328,2,0
0,0,14,14,15,19,34,53,43,96,0.000333,0.162799,14,6837.550059,379.863892,488.396433,139.313982,3,0
0,0,14,14,15,19,34,53,43,96,0.000333,0.162799,14,6837.550059,379.863892,488.396433,139.313982,3,0
0,0,14,14,15,19,34,59,40,99,0.000333,0.167886,14,7051.223498,391.734639,503.658821,139.313982,3,0
0,0,14,14,15,19,34,58,40,98,0.000333,0.16619,14,6979.999018,387.777723,498.571358,139.313982,3,0
0,0,4,4,11,14,25,21,20,41,0.000333,0.063466,5,951.990519,52.888362,190.398104,91.356717,1,0
0,0,15,15,15,19,34,66,45,111,0.000333,0.188236,14,7905.917255,439.217625,564.708375,139.313982,3,0
0,0,10,10,14,14,28,42,31,73,0.000333,0.116979,14,4913.11673,272.950929,350.936909,106.605938,2,0
0,0,15,15,15,19,34,65,45,110,0.000333,0.18654,14,7834.692776,435.26071,559.620913,139.313982,3,0
0,0,10,10,14,14,28,42,31,73,0.000333,0.116979,14,4913.11673,272.950929,350.936909,106.605938,2,0
0,0,9,9,10,16,26,38,33,71,0.000333,0.111244,10,3337.3122,185.406233,333.73122,97.219281,1,0
0,0,9,9,11,19,30,39,32,71,0.000333,0.11613,5,1741.946161,96.774787,348.389232,118.764371,1,0
0,0,14,14,11,22,33,65,55,120,0.000333,0.201776,10,6053.272943,336.292941,605.327294,136.161243,1,0
0,0,17,17,15,26,41,77,62,139,0.000333,0.248233,14,10425.7962,579.2109,744.699729,180.814792,2,0
0,0,5,5,9,15,24,19,24,43,0.000333,0.065718,4,788.61355,43.811864,197.153388,87.132684,1,0
0,0,12,12,14,21,35,55,53,108,0.000333,0.184654,14,7755.475922,430.859773,553.962566,145.541635,1,0
0,0,17,17,16,18,34,63,44,107,0.000333,0.181453,16,8709.736384,483.874244,544.358524,139.05865,3,0
0,0,14,14,16,17,33,49,34,83,0.000333,0.139562,16,6698.955391,372.164188,418.684712,133.486868,3,0
0,0,17,17,16,18,34,63,44,107,0.000333,0.181453,16,8709.736384,483.874244,544.358524,139.05865,3,0
0,0,14,14,16,17,33,49,34,83,0.000333,0.139562,16,6698.955391,372.164188,418.684712,133.486868,3,0
0,0,18,18,16,20,36,70,47,117,0.000333,0.201627,16,9678.099603,537.6722,604.881225,150.438562,3,0
0,0,14,14,16,19,35,54,35,89,0.000333,0.152169,8,3652.049508,202.891639,456.506189,144.710623,3,0
0,0,14,14,16,19,35,54,35,89,0.000333,0.152169,8,3652.049508,202.891639,456.506189,144.710623,3,0
0,0,15,15,15,18,33,60,42,102,0.000333,0.171509,14,7203.394802,400.1886,514.5282,133.662009,3,0
0,0,12,12,15,17,32,46,32,78,0.000333,0.13,7,2730,151.666667,390,128.090227,3,0
0,0,15,15,15,18,33,59,42,101,0.000333,0.169828,14,7132.773285,396.265182,509.483806,133.662009,3,0
0,0,12,12,15,17,32,45,32,77,0.000333,0.128333,7,2695,149.722222,385,128.090227,3,0
0,0,8,8,14,18,32,36,36,72,0.000333,0.12,14,5040,280,360,128.361619,2,0
0,0,18,18,18,22,40,83,67,150,0.000333,0.266096,27,21553.80878,1197.433821,798.289214,173.166146,2,0
0,0,8,8,13,12,25,26,19,45,0.000333,0.069658,6,1253.841171,69.657843,208.973529,91.125266,3,0
0,0,13,13,17,16,33,47,46,93,0.000333,0.156376,16,7506.05845,417.003247,469.128653,133.486868,4,0
0,0,13,13,17,18,35,45,45,90,0.000333,0.153878,16,7386.167544,410.342641,461.635472,144.545518,3,0
0,0,7,7,7,13,20,16,22,38,0.000333,0.054744,3,492.699803,27.372211,164.233268,67.757201,1,0
0,0,7,7,8,15,23,17,21,38,0.000333,0.057298,4,687.581417,38.198968,171.895354,82.603359,1,0
0,0,7,7,8,15,23,17,21,38,0.000333,0.057298,4,687.581417,38.198968,171.895354,82.603359,1,0
0,0,15,15,15,20,35,53,52,105,0.000333,0.179525,14,7540.046035,418.891446,538.574717,145.041921,3,0
0,0,15,15,14,22,36,51,51,102,0.000333,0.175777,14,7382.652902,410.147383,527.33235,151.410465,2,0
0,0,15,15,16,19,35,57,54,111,0.000333,0.189783,16,9109.606638,506.089258,569.350415,144.710623,4,0
0,0,15,15,16,21,37,55,53,108,0.000333,0.18754,16,9001.935416,500.107523,562.620963,156.238666,3,0
0,0,14,14,12,21,33,45,47,92,0.000333,0.154695,12,5569.011108,309.389506,464.084259,135.258216,2,0
0,0,14,14,14,21,35,49,49,98,0.000333,0.167557,14,7037.376299,390.96535,502.669736,145.541635,3,0
0,0,8,8,13,11,24,33,25,58,0.000333,0.088643,12,3191.133901,177.285217,265.927825,86.159464,3,0
0,0,11,11,11,18,29,35,34,69,0.000333,0.111734,5,1676.003443,93.111302,335.200689,113.112398,1,0
0,0,13,13,15,19,34,46,37,83,0.000333,0.140753,7,2955.815911,164.211995,422.259416,139.313982,2,0
0,0,14,14,15,18,33,50,65,115,0.000333,0.193368,21,12182.2118,676.789544,580.105324,133.662009,1,0
0,0,10,10,13,12,25,32,26,58,0.000333,0.089781,12,3232.123908,179.562439,269.343659,91.125266,3,0
0,0,10,10,13,12,25,32,26,58,0.000333,0.089781,12,3232.123908,179.562439,269.343659,91.125266,3,0
0,0,11,11,13,18,31,33,36,69,0.000333,0.113947,12,4102.074545,227.89303,341.839545,123.164366,2,0
0,0,14,14,15,18,33,46,43,89,0.000333,0.14965,14,6285.315073,349.184171,448.951077,133.662009,2,0
0,0,5,5,7,9,16,10,13,23,0.000333,0.030667,3,276,15.333333,92,48.180809,1,0
0,0,5,5,8,8,16,11,12,23,0.000333,0.030667,4,368,20.444444,92,48,1,0
0,0,12,12,12,15,27,45,40,85,0.000333,0.134722,12,4849.985252,269.443625,404.165438,101.622909,1,0
0,0,14,14,15,17,32,57,39,96,0.000333,0.16,14,6720,373.333333,480,128.090227,2,0
0,0,10,10,14,15,29,38,28,66,0.000333,0.106876,7,2244.38722,124.688179,320.626746,111.906328,2,0
0,0,14,14,15,19,34,49,45,94,0.000333,0.159407,14,6695.101099,371.950061,478.221507,139.313982,2,0
0,0,5,5,7,10,17,10,14,24,0.000333,0.0327,3,294.297325,16.349851,98.099108,52.870765,1,0
0,0,12,12,12,20,32,43,42,85,0.000333,0.141667,12,5100,283.333333,425,129.458112,1,0
0,0,11,11,11,15,26,41,37,78,0.000333,0.122211,10,3666.34298,203.685721,366.634298,96.657107,1,0
0,0,13,13,16,18,34,49,52,101,0.000333,0.171278,16,8221.339951,456.741108,513.833747,139.05865,5,0
0,0,13,13,16,20,36,47,51,98,0.000333,0.168884,16,8106.442402,450.357911,506.65265,150.438562,4,0
0,0,13,13,16,18,34,49,52,101,0.000333,0.171278,16,8221.339951,456.741108,513.833747,139.05865,5,0
0,0,13,13,16,20,36,47,51,98,0.000333,0.168884,16,8106.442402,450.357911,506.65265,150.438562,4,0
0,0,13,13,14,18,32,43,47,90,0.000333,0.15,14,6300,350,450,128.361619,4,0
0,0,13,13,14,20,34,41,46,87,0.000333,0.147536,14,6196.529741,344.251652,442.609267,139.741531,3,0
0,0,14,14,13,18,31,57,45,102,0.000333,0.168443,12,6063.936284,336.885349,505.328024,123.164366,3,0
0,0,14,14,17,19,36,58,42,100,0.000333,0.172331,16,8271.880002,459.548889,516.9925,150.197491,3,0
0,0,13,13,14,17,31,51,39,90,0.000333,0.148626,14,6242.287351,346.793742,445.877668,122.789837,3,0
0,0,14,14,17,19,36,58,42,100,0.000333,0.172331,16,8271.880002,459.548889,516.9925,150.197491,3,0
0,0,13,13,14,17,31,51,39,90,0.000333,0.148626,14,6242.287351,346.793742,445.877668,122.789837,3,0
0,0,14,14,17,19,36,58,42,100,0.000333,0.172331,16,8271.880002,459.548889,516.9925,150.197491,3,0
0,0,13,13,15,18,33,52,40,92,0.000333,0.154695,14,6497.179626,360.954424,464.084259,133.662009,3,0
0,0,13,13,14,18,32,51,40,91,0.000333,0.151667,14,6370,353.888889,455,128.361619,3,0
0,0,15,15,15,18,33,55,42,97,0.000333,0.163102,14,6850.287214,380.571512,489.30623,133.662009,3,0
0,0,15,15,15,18,33,55,42,97,0.000333,0.163102,14,6850.287214,380.571512,489.30623,133.662009,3,0
0,0,15,15,15,16,31,72,48,120,0.000333,0.198168,21,12484.5747,693.587483,594.503557,122.603359,2,0
0,0,10,10,15,14,29,45,31,76,0.000333,0.123069,14,5168.891779,287.160654,369.206556,111.906328,2,0
0,0,12,12,14,19,33,40,35,75,0.000333,0.12611,7,2648.306913,147.128162,378.329559,134.013592,3,0
0,0,10,10,14,17,31,32,27,59,0.000333,0.097433,7,2046.083076,113.671282,292.297582,122.789837,3,0
0,0,12,12,14,19,33,39,35,74,0.000333,0.124428,7,2612.996154,145.166453,373.285165,134.013592,3,0
0,0,10,10,14,17,31,31,27,58,0.000333,0.095781,7,2011.403702,111.74465,287.343386,122.789837,3,0
0,0,16,16,15,21,36,53,43,96,0.000333,0.165438,14,6948.379202,386.021067,496.3128,150.842025,3,0
0,0,12,12,15,19,34,40,30,70,0.000333,0.118707,7,2492.856792,138.492044,356.122399,139.313982,3,0
0,0,12,12,15,19,34,40,30,70,0.000333,0.118707,7,2492.856792,138.492044,356.122399,139.313982,3,0
0,0,10,10,15,17,32,50,35,85,0.000333,0.141667,14,5950,330.555556,425,128.090227,2,0
0,0,15,15,15,21,36,62,51,113,0.000333,0.194734,14,8178.821352,454.378964,584.201525,150.842025,2,0
0,0,15,15,16,22,38,63,51,114,0.000333,0.199421,16,9572.219785,531.789988,598.263737,162.107496,2,0
0,0,18,18,16,23,39,77,61,138,0.000333,0.243129,16,11670.1681,648.342672,729.385506,168.041925,2,0
0,0,10,10,14,18,32,47,36,83,0.000333,0.138333,14,5810,322.777778,415,128.361619,2,0
0,0,6,6,5,11,16,13,19,32,0.000333,0.042667,2,256,14.222222,128,49.663388,1,0
0,0,6,6,6,13,19,14,18,32,0.000333,0.045311,3,407.801041,22.655613,135.93368,63.615491,1,0
0,0,11,11,14,19,33,47,41,88,0.000333,0.147969,14,6214.693555,345.260753,443.906683,134.013592,2,0
0,0,10,10,14,17,31,44,34,78,0.000333,0.128809,14,5409.982371,300.554576,386.427312,122.789837,2,0
0,0,15,15,14,21,35,58,51,109,0.000333,0.186364,14,7827.285884,434.849216,559.091849,145.541635,2,0
0,0,8,8,7,14,21,22,25,47,0.000333,0.068813,3,619.316757,34.406486,206.438919,72.954453,1,0
0,0,15,15,15,22,37,59,51,110,0.000333,0.191013,14,8022.558183,445.697677,573.03987,156.710855,2,0
0,0,8,8,8,16,24,23,24,47,0.000333,0.071831,4,861.97295,47.887386,215.493238,88,1,0
0,0,19,19,15,24,39,77,64,141,0.000333,0.248414,14,10433.38398,579.632443,745.241713,168.642459,2,0
0,0,10,10,14,18,32,49,36,85,0.000333,0.141667,14,5950,330.555556,425,128.361619,2,0
0,0,16,16,15,23,38,63,54,117,0.000333,0.204669,14,8596.105267,477.561404,614.007519,162.645284,2,0
0,0,15,15,15,22,37,53,54,107,0.000333,0.185804,14,7803.761142,433.542286,557.41151,156.710855,2,0
0,0,15,15,16,23,39,54,54,108,0.000333,0.190274,16,9133.175034,507.398613,570.82344,168.041925,2,0
0,0,19,19,16,24,40,69,69,138,0.000333,0.244809,16,11750.81723,652.82318,734.426077,174.0391,2,0
0,0,10,10,14,19,33,46,39,85,0.000333,0.142925,14,6002.829002,333.4905,428.7735,134.013592,2,0
0,0,14,14,14,21,35,56,49,105,0.000333,0.179525,14,7540.046035,418.891446,538.574717,145.541635,2,0
0,0,14,14,15,23,38,58,50,108,0.000333,0.188925,14,7934.8664,440.825911,566.776171,162.645284,2,0
0,0,15,15,15,24,39,63,55,118,0.000333,0.207892,14,8731.484466,485.08247,623.677462,168.642459,2,0
0,0,14,14,14,22,36,47,52,99,0.000333,0.170608,14,7165.516052,398.084225,511.822575,151.410465,2,0
0,0,14,14,15,24,39,49,53,102,0.000333,0.179704,14,7547.554369,419.308576,539.111026,168.642459,2,0
0,0,16,16,15,25,40,55,63,118,0.000333,0.209329,14,8791.825213,488.434734,627.987515,174.699764,2,0
0,0,13,13,11,23,34,46,54,100,0.000333,0.169582,10,5087.462841,282.636825,508.746284,142.095673,3,0
0,0,14,14,11,23,34,47,56,103,0.000333,0.17467,10,5240.086726,291.115929,524.008673,142.095673,3,0
0,0,13,13,14,26,40,51,58,109,0.000333,0.193363,14,8121.262273,451.181237,580.090162,175.514402,4,0
0,0,14,14,14,26,40,52,60,112,0.000333,0.198685,14,8344.783253,463.59907,596.055947,175.514402,4,0
0,0,14,14,15,18,33,45,56,101,0.000333,0.169828,21,10699.15993,594.397774,509.483806,133.662009,3,0
0,0,14,14,14,20,34,43,55,98,0.000333,0.16619,14,6979.999018,387.777723,498.571358,139.741531,2,0
0,0,16,16,18,24,42,63,67,130,0.000333,0.233667,18,12618.02277,701.001265,701.001265,185.09775,5,0
0,0,16,16,17,26,43,61,66,127,0.000333,0.229712,16,11026.16998,612.564999,689.135624,191.698301,4,0
0,0,5,5,9,14,23,19,18,37,0.000333,0.055791,4,669.487169,37.193732,167.371792,81.832294,2,0
0,0,6,6,9,15,24,20,20,40,0.000333,0.061133,4,733.594,40.755222,183.3985,87.132684,2,0
0,0,7,7,14,11,25,31,24,55,0.000333,0.085137,14,3575.769266,198.653848,255.41209,91.356717,3,0
0,0,7,7,13,13,26,29,23,52,0.000333,0.081474,6,1466.537192,81.474288,244.422865,96.211433,2,0
0,0,7,7,15,11,26,35,26,61,0.000333,0.095576,14,4014.175519,223.009751,286.726823,96.657107,4,0
0,0,7,7,15,13,28,33,25,58,0.000333,0.092942,7,1951.786098,108.432561,278.826585,106.709075,3,0
0,0,5,5,10,12,22,20,16,36,0.000333,0.053513,5,802.697691,44.594316,160.539538,76.238831,2,0
0,0,6,6,10,13,23,21,18,39,0.000333,0.058806,5,882.094581,49.005255,176.418916,81.324997,2,0
0,0,7,7,8,14,22,26,25,51,0.000333,0.07581,4,909.72405,50.540225,227.431013,77.302969,1,0
0,0,7,7,10,17,27,30,25,55,0.000333,0.087173,5,1307.594063,72.644115,261.518813,102.706149,1,0
0,0,16,16,15,24,39,68,57,125,0.000333,0.220225,14,9249.453883,513.858549,660.675277,168.642459,2,0
0,0,15,15,15,23,38,63,52,115,0.000333,0.201171,14,8449.163297,469.397961,603.511664,162.645284,2,0
0,0,15,15,16,20,36,70,53,123,0.000333,0.211967,16,10174.4124,565.245133,635.900775,150.438562,3,0
0,0,15,15,16,20,36,70,53,123,0.000333,0.211967,16,10174.4124,565.245133,635.900775,150.438562,3,0
0,0,17,17,16,18,34,73,50,123,0.000333,0.208586,16,10012.12687,556.229271,625.757929,139.05865,2,0
0,0,11,11,14,15,29,45,33,78,0.000333,0.126308,14,5304.915247,294.717514,378.922518,111.906328,2,0
0,0,15,15,16,22,38,82,49,131,0.000333,0.22916,16,10999.65607,611.092004,687.478504,162.107496,3,0
0,0,12,12,15,20,35,60,40,100,0.000333,0.170976,14,7180.996224,398.944235,512.928302,145.041921,3,0
0,0,12,12,15,20,35,59,40,99,0.000333,0.169266,14,7109.186261,394.954792,507.799019,145.041921,3,0
0,0,11,11,15,18,33,56,38,94,0.000333,0.158058,14,6638.422661,368.801259,474.173047,133.662009,2,0
0,0,13,13,18,21,39,65,45,110,0.000333,0.193798,18,10465.09639,581.394244,581.394244,167.297316,3,0
0,0,13,13,17,13,30,59,43,102,0.000333,0.166834,24,12012.06818,667.337121,500.502841,117.592585,6,0
0,0,13,13,18,15,33,57,42,99,0.000333,0.166465,18,8989.110321,499.395018,499.395018,133.662009,5,0
0,0,12,12,17,12,29,47,32,79,0.000333,0.127927,16,6140.487978,341.138221,383.780499,112.506418,6,0
0,0,12,12,17,14,31,45,31,76,0.000333,0.125506,16,6024.302713,334.683484,376.51892,122.789837,5,0
0,0,15,15,15,19,34,66,45,111,0.000333,0.188236,14,7905.917255,439.217625,564.708375,139.313982,3,0
0,0,15,15,15,19,34,65,45,110,0.000333,0.18654,14,7834.692776,435.26071,559.620913,139.313982,3,0
0,0,10,10,13,13,26,36,29,65,0.000333,0.101843,12,3666.34298,203.685721,305.528582,96.211433,3,0
0,0,9,9,13,12,25,31,25,56,0.000333,0.086685,12,3120.67136,173.370631,260.055947,91.125266,3,0
0,0,18,18,16,19,35,79,52,131,0.000333,0.223979,16,10750.9772,597.276511,671.936075,144.710623,3,0
0,0,18,18,16,18,34,79,52,131,0.000333,0.222153,16,10663.32212,592.406784,666.457632,139.05865,3,0
0,0,16,16,15,18,33,76,50,126,0.000333,0.211865,14,8898.311227,494.350624,635.593659,133.662009,3,0
0,0,16,16,15,18,33,75,50,125,0.000333,0.210183,14,8827.689709,490.427206,630.549265,133.662009,3,0
0,0,17,17,18,19,37,81,55,136,0.000333,0.236162,18,12752.74184,708.485658,708.485658,155.769273,3,0
0,0,10,10,15,14,29,45,31,76,0.000333,0.123069,14,5168.891779,287.160654,369.206556,111.906328,2,0
0,0,10,10,16,12,28,41,30,71,0.000333,0.113774,16,5461.155191,303.397511,341.322199,107.01955,4,0
0,0,10,10,16,14,30,39,29,68,0.000333,0.111223,16,5338.696968,296.594276,333.668561,117.302969,3,0
0,0,13,13,19,18,37,59,46,105,0.000333,0.182331,18,9845.866861,546.992603,546.992603,155.769273,2,0
0,0,8,8,15,16,31,37,28,65,0.000333,0.107341,7,2254.159321,125.231073,322.02276,122.603359,1,0
0,0,14,14,21,19,40,63,48,111,0.000333,0.196911,20,11814.68037,656.371132,590.734019,172.949289,3,0
0,0,9,9,17,17,34,41,30,71,0.000333,0.120403,8,2889.678894,160.537716,361.209862,138.973737,2,0
0,0,14,14,20,19,39,62,48,110,0.000333,0.193798,20,11627.88488,645.993605,581.394244,167.149185,3,0
0,0,9,9,16,17,33,40,30,70,0.000333,0.117703,8,2824.860707,156.936706,353.107588,133.486868,2,0
0,0,10,10,10,16,26,41,62,103,0.000333,0.161382,15,7262.179365,403.454409,484.145291,97.219281,1,0
0,0,15,15,13,20,33,51,65,116,0.000333,0.19505,18,10532.69492,585.149718,585.149718,134.544278,2,0
0,0,15,15,14,22,36,52,69,121,0.000333,0.20852,21,13136.77943,729.821079,625.560925,151.410465,2,0
0,0,23,23,17,46,63,104,83,187,0.000333,0.372584,8,8942.010766,496.778376,1117.751346,323.570718,9,0
0,0,22,22,17,46,63,103,81,184,0.000333,0.366607,8,8798.556047,488.808669,1099.819506,323.570718,9,0
0,0,8,8,14,16,30,31,29,60,0.000333,0.098138,7,2060.89405,114.494114,294.413436,117.302969,3,0
0,0,8,8,13,18,31,29,28,57,0.000333,0.09413,6,1694.335138,94.12973,282.38919,123.164366,2,0
0,0,8,8,15,16,31,35,31,66,0.000333,0.108992,7,2288.838695,127.157705,326.976956,122.603359,4,0
0,0,8,8,15,18,33,33,30,63,0.000333,0.105932,7,2224.577807,123.587656,317.79683,133.662009,3,0
0,0,23,23,18,48,66,105,82,187,0.000333,0.376767,9,10172.7153,565.15085,1130.3017,343.13685,9,0
0,0,22,22,18,48,66,104,80,184,0.000333,0.370723,9,10009.51666,556.084259,1112.168518,343.13685,9,0
0,0,23,23,17,46,63,105,80,185,0.000333,0.368599,8,8846.374287,491.465238,1105.796786,323.570718,9,0
0,0,22,22,17,46,63,104,78,182,0.000333,0.362622,8,8702.919569,483.495532,1087.864946,323.570718,9,0
0,0,7,7,14,11,25,31,24,55,0.000333,0.085137,14,3575.769266,198.653848,255.41209,91.356717,3,0
0,0,7,7,13,13,26,29,23,52,0.000333,0.081474,6,1466.537192,81.474288,244.422865,96.211433,2,0
0,0,7,7,15,11,26,35,26,61,0.000333,0.095576,14,4014.175519,223.009751,286.726823,96.657107,4,0
0,0,7,7,15,13,28,33,25,58,0.000333,0.092942,7,1951.786098,108.432561,278.826585,106.709075,3,0
0,0,23,23,18,44,62,106,78,184,0.000333,0.365191,9,9860.14909,547.786061,1095.572121,315.273641,9,0
0,0,22,22,18,44,62,105,76,181,0.000333,0.359237,9,9699.38579,538.854766,1077.709532,315.273641,9,0
0,0,15,15,15,23,38,61,58,119,0.000333,0.208168,14,8743.047237,485.724847,624.503374,162.645284,2,0
0,0,13,13,16,19,35,42,40,82,0.000333,0.1402,16,6729.619318,373.86774,420.601207,144.710623,3,0
0,0,13,13,15,21,36,40,39,79,0.000333,0.136141,7,2858.968526,158.831585,408.424075,150.842025,2,0
0,0,32,32,25,54,79,145,111,256,0.000333,0.537923,24,38730.42892,2151.690495,1613.767872,426.86033,12,0
0,0,32,32,24,56,80,143,110,253,0.000333,0.533149,12,19193.3737,1066.298539,1599.447808,435.250976,11,0
0,0,10,10,15,20,35,39,38,77,0.000333,0.131652,7,2764.683546,153.59353,394.954792,145.041921,2,0
0,0,16,16,16,25,41,63,56,119,0.000333,0.212516,16,10200.77902,566.709945,637.548689,180.096405,2,0
0,0,6,6,7,10,17,14,15,29,0.000333,0.039512,3,355.609267,19.75607,118.536422,52.870765,1,0
0,0,9,9,13,16,29,37,30,67,0.000333,0.108495,6,1952.90836,108.494909,325.484727,112.105716,2,0
0,0,18,18,12,19,31,55,66,121,0.000333,0.199819,18,10790.23956,599.457754,599.457754,123.730173,2,0
0,0,18,18,13,21,34,56,73,129,0.000333,0.218761,18,11813.08872,656.282707,656.282707,140.344382,2,0
0,0,15,15,13,19,32,55,66,121,0.000333,0.201667,18,10890,605,605,128.816339,2,0
0,0,9,9,13,16,29,37,30,67,0.000333,0.108495,6,1952.90836,108.494909,325.484727,112.105716,2,0
0,0,11,11,15,18,33,50,40,90,0.000333,0.151332,14,6355.93659,353.107588,453.995471,133.662009,2,0
0,0,11,11,14,18,32,49,40,89,0.000333,0.148333,14,6230,346.111111,445,128.361619,2,0
0,0,9,9,12,12,24,32,29,61,0.000333,0.093228,12,3356.192551,186.455142,279.682713,86.0391,2,0
0,0,12,12,16,18,34,60,38,98,0.000333,0.16619,16,7977.141735,443.174541,498.571358,139.05865,3,0
0,0,12,12,16,18,34,60,38,98,0.000333,0.16619,16,7977.141735,443.174541,498.571358,139.05865,3,0
0,0,12,12,15,19,34,61,39,100,0.000333,0.169582,14,7122.447978,395.691554,508.746284,139.313982,3,0
0,0,12,12,15,19,34,60,39,99,0.000333,0.167886,14,7051.223498,391.734639,503.658821,139.313982,3,0
0,0,13,13,18,20,38,66,44,110,0.000333,0.192424,18,10390.89648,577.272026,577.272026,161.497212,3,0
0,0,12,12,14,15,29,48,32,80,0.000333,0.129546,14,5440.938715,302.274373,388.63848,111.906328,2,0
0,0,12,12,14,15,29,48,32,80,0.000333,0.129546,14,5440.938715,302.274373,388.63848,111.906328,2,0
0,0,10,10,13,14,27,44,29,73,0.000333,0.115702,12,4165.281452,231.404525,347.106788,101.408685,2,0
0,0,10,10,13,14,27,44,29,73,0.000333,0.115702,12,4165.281452,231.404525,347.106788,101.408685,2,0
0,0,19,19,16,26,42,67,74,141,0.000333,0.253439,16,12165.06811,675.837117,760.316757,186.211433,2,0
0,0,12,12,17,16,33,53,38,91,0.000333,0.153013,16,7344.637838,408.035435,459.039865,133.486868,3,0
0,0,12,12,17,16,33,53,38,91,0.000333,0.153013,16,7344.637838,408.035435,459.039865,133.486868,3,0
0,0,12,12,13,13,26,39,33,72,0.000333,0.112811,12,4061.179916,225.621106,338.43166,96.211433,3,0
0,0,12,12,13,14,27,39,33,72,0.000333,0.114117,12,4108.222802,228.2346,342.3519,101.408685,3,0
0,0,14,14,13,14,27,38,34,72,0.000333,0.114117,12,4108.222802,228.2346,342.3519,101.408685,3,0
0,0,13,13,13,13,26,37,33,70,0.000333,0.109677,12,3948.369363,219.353854,329.03078,96.211433,3,0
0,0,15,15,12,20,32,47,64,111,0.000333,0.185,18,9990,555,555,129.458112,2,0
0,0,15,15,13,22,35,48,68,116,0.000333,0.198332,18,10709.94294,594.99683,594.99683,146.213212,2,0
0,0,13,13,12,19,31,41,52,93,0.000333,0.15358,12,5528.883082,307.160171,460.740257,123.730173,2,0
0,0,13,13,13,21,34,42,54,96,0.000333,0.162799,12,5860.757193,325.597622,488.396433,140.344382,2,0
0,0,13,13,14,21,35,58,49,107,0.000333,0.182944,14,7683.665959,426.870331,548.833283,145.541635,1,0
0,0,13,13,14,20,34,56,48,104,0.000333,0.176365,14,7407.345897,411.519216,529.096135,139.741531,1,0
0,0,14,14,15,18,33,58,45,103,0.000333,0.173191,14,7274.01632,404.112018,519.572594,133.662009,3,0
0,0,14,14,15,18,33,58,45,103,0.000333,0.173191,14,7274.01632,404.112018,519.572594,133.662009,3,0
0,0,14,14,15,20,35,59,46,105,0.000333,0.179525,14,7540.046035,418.891446,538.574717,145.041921,3,0
0,0,14,14,15,20,35,58,46,104,0.000333,0.177815,14,7468.236073,414.902004,533.445434,145.041921,3,0
0,0,14,14,15,19,34,59,46,105,0.000333,0.178061,14,7478.570377,415.476132,534.183598,139.313982,3,0
0,0,14,14,15,19,34,58,46,104,0.000333,0.176365,14,7407.345897,411.519216,529.096135,139.313982,3,0
0,0,10,10,15,16,31,48,33,81,0.000333,0.133763,14,5618.058616,312.114368,401.289901,122.603359,2,0
0,0,10,10,14,16,30,47,33,80,0.000333,0.13085,14,5495.717467,305.317637,392.551248,117.302969,2,0
0,0,10,10,14,15,29,47,32,79,0.000333,0.127927,14,5372.926981,298.495943,383.780499,111.906328,2,0
0,0,10,10,14,15,29,47,32,79,0.000333,0.127927,14,5372.926981,298.495943,383.780499,111.906328,2,0
0,0,10,10,14,15,29,47,32,79,0.000333,0.127927,14,5372.926981,298.495943,383.780499,111.906328,2,0
0,0,12,12,15,15,30,51,35,86,0.000333,0.140664,14,5907.896277,328.21646,421.992591,117.206718,2,0
0,0,12,12,15,16,31,51,35,86,0.000333,0.14202,14,5964.852358,331.380687,426.060883,122.603359,2,0
0,0,10,10,12,14,26,39,30,69,0.000333,0.10811,12,3891.964087,216.220227,324.330341,96.322519,2,0
0,0,10,10,11,14,25,38,30,68,0.000333,0.105261,10,3157.822209,175.434567,315.782221,91.356717,2,0
0,0,12,12,11,22,33,40,57,97,0.000333,0.163102,10,4893.062296,271.836794,489.30623,136.161243,1,0
0,0,12,12,12,23,35,41,56,97,0.000333,0.165847,12,5970.485432,331.693635,497.540453,147.061475,1,0
0,0,14,14,14,23,37,48,67,115,0.000333,0.199696,14,8387.219919,465.956662,599.087137,157.344894,1,0
0,0,16,16,10,22,32,52,91,143,0.000333,0.238333,20,14300,794.444444,715,131.326777,1,0
0,0,16,16,11,23,34,53,96,149,0.000333,0.252677,20,15160.63927,842.257737,758.031963,142.095673,1,0
0,0,12,12,12,20,32,48,82,130,0.000333,0.216667,24,15600,866.666667,650,129.458112,1,0
0,0,12,12,10,20,30,46,53,99,0.000333,0.161927,10,4857.82169,269.878983,485.782169,119.657843,1,0
0,0,12,12,11,22,33,47,52,99,0.000333,0.166465,10,4993.950178,277.441677,499.395018,136.161243,1,0
0,0,15,15,16,23,39,62,64,126,0.000333,0.221987,16,10655.37087,591.965049,665.96068,168.041925,2,0
0,0,13,13,15,19,34,60,68,128,0.000333,0.217065,21,13675.10012,759.727784,651.195244,139.313982,1,0
0,0,4,4,12,12,24,22,22,44,0.000333,0.067246,6,1210.4301,67.246117,201.73835,86.0391,1,0
0,0,28,28,19,48,67,124,101,225,0.000333,0.454957,18,24567.66122,1364.870068,1364.870068,348.788823,8,0
0,0,27,27,19,48,67,123,99,222,0.000333,0.448891,18,24240.09241,1346.6718,1346.6718,348.788823,8,0
0,0,23,23,17,44,61,102,81,183,0.000333,0.361775,8,8682.599462,482.366637,1085.324933,309.70186,7,0
0,0,7,7,8,15,23,17,21,38,0.000333,0.057298,4,687.581417,38.198968,171.895354,82.603359,1,0
0,0,28,28,22,51,73,129,103,232,0.000333,0.47868,22,31592.86455,1755.159142,1436.039298,387.401188,9,0
0,0,27,27,22,51,73,128,101,229,0.000333,0.47249,11,15592.16806,866.231559,1417.469824,387.401188,9,0
0,0,23,23,18,46,64,103,80,183,0.000333,0.366,9,9882,549,1098,329.1425,7,0
0,0,15,15,15,20,35,53,52,105,0.000333,0.179525,14,7540.046035,418.891446,538.574717,145.041921,3,0
0,0,15,15,14,22,36,51,51,102,0.000333,0.175777,14,7382.652902,410.147383,527.33235,151.410465,2,0
0,0,31,31,25,50,75,143,113,256,0.000333,0.531526,24,38269.86203,2126.103446,1594.577585,398.289214,10,0
0,0,31,31,24,52,76,141,112,253,0.000333,0.526909,24,37937.41586,2107.634215,1580.725661,406.461965,9,0
0,0,14,14,12,21,33,45,47,92,0.000333,0.154695,12,5569.011108,309.389506,464.084259,135.258216,2,0
0,0,30,30,22,52,74,135,108,243,0.000333,0.502966,22,33195.73769,1844.20765,1508.897168,394.530361,9,0
0,0,13,13,15,22,37,55,48,103,0.000333,0.178858,14,7512.031753,417.335097,536.573697,156.710855,2,0
0,0,13,13,16,18,34,58,40,98,0.000333,0.16619,16,7977.141735,443.174541,498.571358,139.05865,2,0
0,0,13,13,15,18,33,55,40,95,0.000333,0.159739,14,6709.044179,372.724677,479.217441,133.662009,2,0
0,0,13,13,18,19,37,58,41,99,0.000333,0.171912,18,9283.245898,515.735883,515.735883,155.769273,3,0
0,0,4,4,12,14,26,25,21,46,0.000333,0.072073,6,1297.321362,72.073409,216.220227,96.322519,1,0
0,0,7,7,16,13,29,34,31,65,0.000333,0.105256,16,5052.300235,280.683346,315.768765,112.105716,4,0
0,0,7,7,16,16,32,32,30,62,0.000333,0.103333,8,2480,137.777778,310,128,3,0
0,0,7,7,14,13,27,30,29,59,0.000333,0.093513,14,3927.537077,218.196504,280.538363,101.408685,3,0
0,0,7,7,14,16,30,28,28,56,0.000333,0.091595,7,1923.501113,106.861173,274.785873,117.302969,2,0
0,0,7,7,12,17,29,30,31,61,0.000333,0.098779,6,1778.021044,98.778947,296.336841,112.506418,1,0
0,0,6,6,14,16,30,32,27,59,0.000333,0.096502,7,2026.545816,112.585879,289.506545,117.302969,1,0
0,0,9,9,13,15,28,30,26,56,0.000333,0.089737,6,1615.271254,89.737292,269.211876,106.709075,2,0
0,0,11,11,17,17,34,49,39,88,0.000333,0.149232,16,7163.14768,397.952649,447.69673,138.973737,2,0
0,0,20,20,19,21,40,76,80,156,0.000333,0.27674,27,22415.96114,1245.331174,830.220783,172.949289,2,0
0,0,20,20,19,23,42,90,69,159,0.000333,0.285793,27,23149.2187,1286.067705,857.37847,184.752548,3,0
0,0,10,10,13,17,30,45,34,79,0.000333,0.129215,12,4651.732285,258.429571,387.644357,117.592585,2,0
0,0,18,18,19,27,46,91,71,162,0.000333,0.298272,18,16106.70666,894.817037,894.817037,209.092585,2,0
0,0,11,11,18,22,40,57,46,103,0.000333,0.18272,18,9866.854688,548.158594,548.158594,173.166146,2,0
0,0,10,10,13,12,25,36,29,65,0.000333,0.100617,12,3622.207828,201.233768,301.850652,91.125266,3,0
0,0,17,17,18,24,42,75,88,163,0.000333,0.292983,27,23731.58898,1318.42161,878.94774,185.09775,2,0
0,0,11,11,18,21,39,57,46,103,0.000333,0.181465,18,9799.135714,544.396429,544.396429,167.297316,2,0
0,0,12,12,13,12,25,35,30,65,0.000333,0.100617,12,3622.207828,201.233768,301.850652,91.125266,3,0
0,0,10,10,13,13,26,36,29,65,0.000333,0.101843,12,3666.34298,203.685721,305.528582,96.211433,3,0
0,0,32,32,28,54,82,148,121,269,0.000333,0.57006,28,47885.0817,2660.282317,1710.181489,445.369863,12,0
0,0,32,32,27,56,83,146,120,266,0.000333,0.565253,26,44089.77271,2449.431817,1695.760489,453.593838,11,0
0,0,13,13,19,19,38,45,50,95,0.000333,0.166184,18,8973.956048,498.553114,498.553114,161.421246,3,0
0,0,13,13,18,21,39,43,49,92,0.000333,0.162086,18,8752.626074,486.257004,486.257004,167.297316,2,0
0,0,29,29,21,53,74,129,100,229,0.000333,0.473988,10,14219.64821,789.980456,1421.964821,395.81845,10,0
0,0,28,28,21,53,74,128,98,226,0.000333,0.467779,10,14033.36461,779.631367,1403.336461,395.81845,10,0
0,0,29,29,24,55,79,134,104,238,0.000333,0.5001,12,18003.59782,1000.199879,1500.299818,428.013884,11,0
0,0,28,28,24,55,79,133,102,235,0.000333,0.493796,12,17776.66171,987.592317,1481.388476,428.013884,11,0
0,0,9,9,14,15,29,34,27,61,0.000333,0.098779,7,2074.357885,115.242105,296.336841,111.906328,2,0
0,0,9,9,14,15,29,34,27,61,0.000333,0.098779,7,2074.357885,115.242105,296.336841,111.906328,2,0
0,0,3,3,8,10,18,11,13,24,0.000333,0.033359,4,400.3128,22.2396,100.0782,57.219281,1,0
0,0,9,9,14,15,29,34,27,61,0.000333,0.098779,7,2074.357885,115.242105,296.336841,111.906328,2,0
0,0,9,9,14,15,29,34,27,61,0.000333,0.098779,7,2074.357885,115.242105,296.336841,111.906328,2,0
0,0,10,10,11,17,28,42,38,80,0.000333,0.128196,10,3845.883938,213.660219,384.588394,107.540616,1,0
0,0,27,27,22,47,69,123,92,215,0.000333,0.437778,11,14446.66034,802.592241,1313.332758,359.173172,9,0
0,0,26,26,22,47,69,122,90,212,0.000333,0.431669,11,14245.07903,791.39328,1295.007185,359.173172,9,0
0,0,27,27,22,49,71,123,91,214,0.000333,0.438682,11,14476.50472,804.250262,1316.045884,373.228278,9,0
0,0,26,26,22,49,71,122,89,211,0.000333,0.432532,11,14273.56306,792.975726,1297.596642,373.228278,9,0
0,0,14,14,15,18,33,69,42,111,0.000333,0.186643,14,7838.988461,435.499359,559.927747,133.662009,2,0
0,0,11,11,14,16,30,49,33,82,0.000333,0.134122,14,5633.110404,312.950578,402.365029,117.302969,2,0
0,0,11,11,14,16,30,49,33,82,0.000333,0.134122,14,5633.110404,312.950578,402.365029,117.302969,2,0
0,0,11,11,14,16,30,49,33,82,0.000333,0.134122,14,5633.110404,312.950578,402.365029,117.302969,2,0
0,0,11,11,14,16,30,49,33,82,0.000333,0.134122,14,5633.110404,312.950578,402.365029,117.302969,2,0
0,0,11,11,15,17,32,50,34,84,0.000333,0.14,14,5880,326.666667,420,128.090227,2,0
0,0,11,11,14,17,31,49,34,83,0.000333,0.137066,14,5756.776113,319.820895,411.198294,122.789837,2,0
0,0,17,17,18,25,43,68,67,135,0.000333,0.244182,18,13185.82335,732.545742,732.545742,191.155055,2,0
0,0,16,16,9,19,28,49,73,122,0.000333,0.195499,12,7037.967606,390.9982,586.4973,109.239948,1,0
0,0,16,16,10,21,31,50,79,129,0.000333,0.21303,15,9586.369861,532.576103,639.091324,125.457947,1,0
0,0,14,14,14,19,33,54,74,128,0.000333,0.215227,21,13559.33139,753.296188,645.682447,134.013592,2,0
0,0,26,26,22,47,69,120,85,205,0.000333,0.417416,11,13774.72265,765.262369,1252.247514,359.173172,10,0
0,0,25,25,22,47,69,119,83,202,0.000333,0.411307,11,13573.14134,754.063408,1233.92194,359.173172,10,0
0,0,26,26,22,47,69,120,85,205,0.000333,0.417416,11,13774.72265,765.262369,1252.247514,359.173172,10,0
0,0,25,25,22,47,69,119,83,202,0.000333,0.411307,11,13573.14134,754.063408,1233.92194,359.173172,10,0
0,0,11,11,10,17,27,37,40,77,0.000333,0.122042,10,3661.263377,203.403521,366.126338,102.706149,1,0
0,0,11,11,11,19,30,38,40,78,0.000333,0.127579,10,3827.374665,212.631926,382.737466,118.764371,1,0
0,0,14,14,16,20,36,53,51,104,0.000333,0.179224,16,8602.755202,477.930845,537.6722,150.438562,2,0
0,0,14,14,19,20,39,70,50,120,0.000333,0.211416,18,11416.46879,634.248266,634.248266,167.149185,2,0
0,0,11,11,19,18,37,55,41,96,0.000333,0.166703,18,9001.935416,500.107523,500.107523,155.769273,2,0
0,0,10,10,13,15,28,33,26,59,0.000333,0.094545,6,1701.803642,94.544647,283.63394,106.709075,3,0
0,0,10,10,11,11,22,25,24,49,0.000333,0.072837,10,2185.121493,121.395639,218.512149,76.107496,2,0
0,0,14,14,18,25,43,70,60,130,0.000333,0.235138,18,12697.45953,705.414418,705.414418,191.155055,2,0
0,0,12,12,15,19,34,56,38,94,0.000333,0.159407,14,6695.101099,371.950061,478.221507,139.313982,3,0
0,0,12,12,15,19,34,56,38,94,0.000333,0.159407,14,6695.101099,371.950061,478.221507,139.313982,3,0
0,0,16,16,15,18,33,54,39,93,0.000333,0.156376,14,6567.801143,364.877841,469.128653,133.662009,3,0
0,0,13,13,14,16,30,40,29,69,0.000333,0.112858,7,2370.028158,131.668231,338.575451,117.302969,3,0
0,0,16,16,15,18,33,54,39,93,0.000333,0.156376,14,6567.801143,364.877841,469.128653,133.662009,3,0
0,0,13,13,14,17,31,40,29,69,0.000333,0.113947,7,2392.876818,132.937601,341.839545,122.789837,3,0
0,0,14,14,14,17,31,49,36,85,0.000333,0.140369,14,5895.493609,327.527423,421.106686,122.789837,3,0
0,0,11,11,13,15,28,35,26,61,0.000333,0.09775,6,1759.491901,97.74955,293.24865,106.709075,3,0
0,0,14,14,14,17,31,49,36,85,0.000333,0.140369,14,5895.493609,327.527423,421.106686,122.789837,3,0
0,0,11,11,13,15,28,35,26,61,0.000333,0.09775,6,1759.491901,97.74955,293.24865,106.709075,3,0
0,0,14,14,14,18,32,50,37,87,0.000333,0.145,14,6090,338.333333,435,128.361619,3,0
0,0,11,11,13,16,29,36,27,63,0.000333,0.102018,6,1836.316816,102.017601,306.052803,112.105716,3,0
0,0,14,14,14,18,32,49,37,86,0.000333,0.143333,14,6020,334.444444,430,128.361619,3,0
0,0,11,11,13,16,29,35,27,62,0.000333,0.100398,6,1807.16893,100.398274,301.194822,112.105716,3,0
0,0,14,14,14,18,32,50,37,87,0.000333,0.145,14,6090,338.333333,435,128.361619,3,0
0,0,11,11,13,16,29,36,27,63,0.000333,0.102018,6,1836.316816,102.017601,306.052803,112.105716,3,0
0,0,14,14,14,18,32,49,37,86,0.000333,0.143333,14,6020,334.444444,430,128.361619,3,0
0,0,11,11,13,16,29,35,27,62,0.000333,0.100398,6,1807.16893,100.398274,301.194822,112.105716,3,0
0,0,12,12,16,14,30,42,32,74,0.000333,0.121037,16,5809.758465,322.764359,363.109904,117.302969,5,0
0,0,12,12,15,16,31,40,31,71,0.000333,0.117249,7,2462.235566,136.790865,351.747938,122.603359,4,0
0,0,12,12,15,14,29,41,32,73,0.000333,0.118211,14,4964.856577,275.825365,354.632613,111.906328,5,0
0,0,12,12,14,16,30,39,31,70,0.000333,0.114494,7,2404.376392,133.576466,343.482342,117.302969,4,0
0,0,14,14,18,20,38,60,43,103,0.000333,0.180179,18,9729.65761,540.536534,540.536534,161.497212,7,0
0,0,14,14,17,22,39,58,42,100,0.000333,0.17618,8,4228.321775,234.906765,528.540222,167.594364,6,0
0,0,10,10,14,22,36,44,32,76,0.000333,0.130971,7,2750.400101,152.800006,392.9143,151.410465,5,0
0,0,11,11,14,22,36,45,34,79,0.000333,0.136141,7,2858.968526,158.831585,408.424075,151.410465,5,0
0,0,14,14,18,20,38,59,43,102,0.000333,0.17843,18,9635.194915,535.288606,535.288606,161.497212,7,0
0,0,14,14,17,22,39,57,42,99,0.000333,0.174418,8,4186.038557,232.557698,523.25482,167.594364,6,0
0,0,10,10,14,22,36,44,32,76,0.000333,0.130971,7,2750.400101,152.800006,392.9143,151.410465,5,0
0,0,11,11,14,22,36,45,34,79,0.000333,0.136141,7,2858.968526,158.831585,408.424075,151.410465,5,0
0,0,12,12,16,14,30,42,32,74,0.000333,0.121037,16,5809.758465,322.764359,363.109904,117.302969,5,0
0,0,12,12,15,16,31,40,31,71,0.000333,0.117249,7,2462.235566,136.790865,351.747938,122.603359,4,0
0,0,12,12,15,14,29,41,32,73,0.000333,0.118211,14,4964.856577,275.825365,354.632613,111.906328,5,0
0,0,12,12,14,16,30,39,31,70,0.000333,0.114494,7,2404.376392,133.576466,343.482342,117.302969,4,0
0,0,15,15,16,26,42,78,61,139,0.000333,0.249844,16,11992.51395,666.250775,749.532122,186.211433,2,0
0,0,8,8,12,11,23,25,19,44,0.000333,0.066346,6,1194.220356,66.345575,199.036726,81.073298,3,0
0,0,7,7,12,10,22,24,18,42,0.000333,0.062432,6,1123.776768,62.432043,187.296128,76.238831,3,0
0,0,8,8,12,11,23,25,19,44,0.000333,0.066346,6,1194.220356,66.345575,199.036726,81.073298,3,0
0,0,31,31,25,49,74,144,101,245,0.000333,0.507105,24,36511.58579,2028.421433,1521.316075,391.217187,14,0
0,0,31,31,24,51,75,142,100,242,0.000333,0.502458,12,18088.48948,1004.916082,1507.374123,399.332792,13,0
0,0,28,28,22,50,72,130,93,223,0.000333,0.458631,11,15134.82603,840.823668,1375.893275,380.300305,12,0
0,0,27,27,22,50,72,129,91,220,0.000333,0.452461,11,14931.2185,829.512139,1357.3835,380.300305,12,0
0,0,31,31,25,48,73,144,101,245,0.000333,0.505502,24,36396.16841,2022.009356,1516.507017,384.174605,14,0
0,0,31,31,24,50,74,142,100,242,0.000333,0.500896,24,36064.50515,2003.583619,1502.687714,392.23191,13,0
0,0,28,28,22,50,72,130,93,223,0.000333,0.458631,11,15134.82603,840.823668,1375.893275,380.300305,12,0
0,0,27,27,22,50,72,129,91,220,0.000333,0.452461,11,14931.2185,829.512139,1357.3835,380.300305,12,0
0,0,12,12,15,14,29,41,30,71,0.000333,0.114972,14,4828.833109,268.268506,344.916651,111.906328,5,0
0,0,12,12,14,16,30,39,29,68,0.000333,0.111223,7,2335.679924,129.759996,333.668561,117.302969,4,0
0,0,12,12,15,13,28,41,30,71,0.000333,0.113774,14,4778.510793,265.472822,341.322199,106.709075,5,0
0,0,12,12,14,15,29,39,29,68,0.000333,0.110114,7,2312.398954,128.466609,330.342708,111.906328,4,0
0,0,10,10,12,15,27,47,32,79,0.000333,0.125212,12,4507.633352,250.424075,375.636113,101.622909,2,0
0,0,10,10,12,15,27,47,32,79,0.000333,0.125212,12,4507.633352,250.424075,375.636113,101.622909,2,0
0,0,10,10,12,15,27,47,32,79,0.000333,0.125212,12,4507.633352,250.424075,375.636113,101.622909,2,0
0,0,10,10,12,14,26,47,32,79,0.000333,0.123778,12,4456.016853,247.556492,371.334738,96.322519,2,0
0,0,10,10,13,16,29,48,33,81,0.000333,0.131165,12,4721.957527,262.330974,393.496461,112.105716,2,0
0,0,10,10,12,16,28,47,33,80,0.000333,0.128196,12,4615.060725,256.392263,384.588394,107.01955,2,0
0,0,15,15,20,21,41,73,51,124,0.000333,0.221445,20,13286.72897,738.15161,664.336449,178.677228,3,0
0,0,15,15,20,21,41,73,51,124,0.000333,0.221445,20,13286.72897,738.15161,664.336449,178.677228,3,0
0,0,9,9,10,16,26,35,33,68,0.000333,0.106543,10,3196.299008,177.572167,319.629901,97.219281,1,0
0,0,9,9,11,19,30,36,33,69,0.000333,0.112858,5,1692.877255,94.048736,338.575451,118.764371,1,0
0,0,16,16,15,25,40,65,58,123,0.000333,0.218199,14,9164.360179,509.131121,654.597156,174.699764,2,0
0,0,14,14,18,25,43,67,60,127,0.000333,0.229712,18,12404.44123,689.135624,689.135624,191.155055,2,0
0,0,8,8,15,21,36,42,34,76,0.000333,0.130971,7,2750.400101,152.800006,392.9143,150.842025,2,0
0,0,10,10,15,15,30,39,30,69,0.000333,0.112858,14,4740.056315,263.336462,338.575451,117.206718,2,0
0,0,9,9,13,15,28,33,26,59,0.000333,0.094545,6,1701.803642,94.544647,283.63394,106.709075,2,0
0,0,10,10,14,15,29,38,30,68,0.000333,0.110114,14,4624.797907,256.933217,330.342708,111.906328,2,0
0,0,9,9,12,15,27,32,26,58,0.000333,0.091928,6,1654.700851,91.927825,275.783475,101.622909,2,0
0,0,8,8,9,13,22,31,26,57,0.000333,0.084729,8,2033.500818,112.972268,254.187602,76.635041,1,0
0,0,5,5,9,12,21,24,19,43,0.000333,0.062957,4,755.478597,41.971033,188.869649,71.548875,1,0
0,0,16,16,15,19,34,60,51,111,0.000333,0.188236,14,7905.917255,439.217625,564.708375,139.313982,2,0
0,0,9,9,12,13,25,32,29,61,0.000333,0.094425,12,3399.302731,188.850152,283.275228,91.125266,2,0
0,0,13,13,13,14,27,37,33,70,0.000333,0.110947,12,3994.105502,221.89475,332.842125,101.408685,3,0
0,0,10,10,11,13,24,29,29,58,0.000333,0.088643,10,2659.27825,147.737681,265.927825,86.159464,2,0
0,0,10,10,13,15,28,30,25,55,0.000333,0.088135,6,1586.427124,88.13484,264.404521,106.709075,3,0
0,0,10,10,11,13,24,29,29,58,0.000333,0.088643,10,2659.27825,147.737681,265.927825,86.159464,2,0
0,0,10,10,13,15,28,30,25,55,0.000333,0.088135,6,1586.427124,88.13484,264.404521,106.709075,3,0
0,0,11,11,12,11,23,30,26,56,0.000333,0.08444,12,3039.833634,168.879646,253.31947,81.073298,3,0
0,0,12,12,16,18,34,53,41,94,0.000333,0.159407,16,7651.544113,425.085784,478.221507,139.05865,3,0
0,0,10,10,13,16,29,44,34,78,0.000333,0.126308,12,4547.070211,252.615012,378.922518,112.105716,2,0
0,0,14,14,15,18,33,60,41,101,0.000333,0.169828,14,7132.773285,396.265182,509.483806,133.662009,3,0
0,0,14,14,15,18,33,59,41,100,0.000333,0.168146,14,7062.151767,392.341765,504.439412,133.662009,3,0
0,0,14,14,15,17,32,59,40,99,0.000333,0.165,14,6930,385,495,128.090227,3,0
0,0,14,14,15,17,32,59,40,99,0.000333,0.165,14,6930,385,495,128.090227,3,0
0,0,10,10,13,14,27,43,31,74,0.000333,0.117287,12,4222.340102,234.57445,351.861675,101.408685,2,0
0,0,10,10,12,14,26,42,31,73,0.000333,0.114377,12,4117.585193,228.754733,343.132099,96.322519,2,0
0,0,4,4,10,14,24,17,18,35,0.000333,0.053491,5,802.368438,44.576024,160.473688,86.52225,1,0
0,0,17,17,17,19,36,66,48,114,0.000333,0.196457,16,9429.943203,523.885733,589.37145,150.197491,4,0
0,0,10,10,14,14,28,42,30,72,0.000333,0.115377,14,4845.813761,269.211876,346.129554,106.605938,2,0
0,0,12,12,14,17,31,43,31,74,0.000333,0.122204,7,2566.273689,142.57076,366.610527,122.789837,3,0
0,0,17,17,17,19,36,65,48,113,0.000333,0.194734,16,9347.224403,519.290245,584.201525,150.197491,4,0
0,0,10,10,14,14,28,42,30,72,0.000333,0.115377,14,4845.813761,269.211876,346.129554,106.605938,2,0
0,0,12,12,14,17,31,42,31,73,0.000333,0.120552,7,2531.594315,140.644129,361.656331,122.789837,3,0
0,0,17,17,17,17,34,65,47,112,0.000333,0.189932,16,9116.733412,506.48519,569.795838,138.973737,4,0
0,0,12,12,14,15,29,42,30,72,0.000333,0.116592,14,4896.844843,272.046936,349.774632,111.906328,3,0
0,0,17,17,17,17,34,65,47,112,0.000333,0.189932,16,9116.733412,506.48519,569.795838,138.973737,4,0
0,0,12,12,14,15,29,42,30,72,0.000333,0.116592,14,4896.844843,272.046936,349.774632,111.906328,3,0
0,0,5,5,11,15,26,20,22,42,0.000333,0.065806,5,987.092341,54.838463,197.418468,96.657107,2,0
0,0,15,15,18,23,41,68,51,119,0.000333,0.212516,18,11475.87639,637.548689,637.548689,179.100575,4,0
0,0,15,15,18,23,41,67,51,118,0.000333,0.21073,18,11379.44046,632.191137,632.191137,179.100575,4,0
0,0,18,18,18,23,41,63,74,137,0.000333,0.244662,27,19817.58487,1100.976937,733.984625,179.100575,2,0
0,0,18,18,19,24,43,64,83,147,0.000333,0.265887,27,21536.84481,1196.491378,797.660919,190.749723,2,0
0,0,14,14,13,23,36,58,72,130,0.000333,0.22403,18,12097.6245,672.09025,672.09025,152.147641,1,0
0,0,8,8,14,19,33,41,32,73,0.000333,0.122747,7,2577.685395,143.204744,368.240771,134.013592,2,0
0,0,8,8,13,20,33,32,34,66,0.000333,0.110977,6,1997.580071,110.976671,332.930012,134.544278,2,0
0,0,15,15,16,25,41,74,58,132,0.000333,0.235732,16,11315.14983,628.619435,707.196865,180.096405,2,0
0,0,13,13,13,21,34,50,71,121,0.000333,0.205194,18,11080.49407,615.583004,615.583004,140.344382,2,0
0,0,15,15,15,23,38,57,57,114,0.000333,0.199421,14,8375.692311,465.31624,598.263737,162.645284,2,0
0,0,16,16,16,25,41,59,55,114,0.000333,0.203587,16,9772.174856,542.898603,610.760929,180.096405,2,0
0,0,14,14,16,26,42,59,51,110,0.000333,0.197718,8,4745.239332,263.624407,593.154917,186.211433,2,0
0,0,12,12,18,17,35,54,39,93,0.000333,0.159008,18,8586.41977,477.023321,477.023321,144.545518,3,0
0,0,12,12,17,17,34,53,39,92,0.000333,0.156016,16,7488.745302,416.041406,468.046581,138.973737,3,0
0,0,14,14,14,22,36,59,74,133,0.000333,0.2292,21,14439.60053,802.200029,687.600025,151.410465,2,0
0,0,9,9,15,21,36,42,34,76,0.000333,0.130971,7,2750.400101,152.800006,392.9143,150.842025,2,0
0,0,14,14,15,18,33,49,42,91,0.000333,0.153013,14,6426.558108,357.031006,459.039865,133.662009,3,0
0,0,10,10,14,15,29,35,27,62,0.000333,0.100398,7,2108.363752,117.13132,301.194822,111.906328,3,0
0,0,14,14,15,18,33,49,42,91,0.000333,0.153013,14,6426.558108,357.031006,459.039865,133.662009,3,0
0,0,10,10,14,15,29,35,27,62,0.000333,0.100398,7,2108.363752,117.13132,301.194822,111.906328,3,0
0,0,14,14,15,19,34,50,43,93,0.000333,0.157711,14,6623.876619,367.993146,473.134044,139.313982,3,0
0,0,10,10,14,16,30,36,28,64,0.000333,0.10468,7,2198.286987,122.127055,314.040998,117.302969,3,0
0,0,14,14,15,19,34,49,43,92,0.000333,0.156016,14,6552.65214,364.03623,468.046581,139.313982,3,0
0,0,10,10,14,16,30,35,28,63,0.000333,0.103045,7,2163.938753,120.21882,309.134108,117.302969,3,0
0,0,16,16,16,19,35,54,45,99,0.000333,0.169266,16,8124.784299,451.376905,507.799019,144.710623,3,0
0,0,12,12,15,17,32,40,30,70,0.000333,0.116667,7,2450,136.111111,350,128.090227,3,0
0,0,16,16,16,19,35,54,45,99,0.000333,0.169266,16,8124.784299,451.376905,507.799019,144.710623,3,0
0,0,12,12,15,17,32,40,30,70,0.000333,0.116667,7,2450,136.111111,350,128.090227,3,0
0,0,11,11,11,19,30,50,45,95,0.000333,0.155385,10,4661.546066,258.974781,466.154607,118.764371,1,0
0,0,10,10,14,16,30,47,39,86,0.000333,0.140664,14,5907.896277,328.21646,421.992591,117.302969,2,0
0,0,10,10,14,16,30,47,39,86,0.000333,0.140664,14,5907.896277,328.21646,421.992591,117.302969,2,0
0,0,10,10,15,17,32,48,40,88,0.000333,0.146667,14,6160,342.222222,440,128.090227,2,0
0,0,10,10,14,17,31,47,40,87,0.000333,0.143672,14,6034.211106,335.23395,431.015079,122.789837,2,0
0,0,16,16,16,19,35,62,50,112,0.000333,0.191493,16,9191.675166,510.64862,574.479698,144.710623,2,0
0,0,16,16,15,19,34,59,50,109,0.000333,0.184844,14,7763.468296,431.303794,554.53345,139.313982,2,0
0,0,7,7,12,16,28,34,26,60,0.000333,0.096147,6,1730.647772,96.147098,288.441295,107.01955,2,0
0,0,3,3,9,8,17,15,11,26,0.000333,0.035425,4,425.096135,23.616452,106.274034,52.529325,2,0
0,0,6,6,10,12,22,27,22,49,0.000333,0.072837,5,1092.560747,60.697819,218.512149,76.238831,2,0
0,0,5,5,10,12,22,24,19,43,0.000333,0.063919,5,958.777798,53.265433,191.75556,76.238831,2,0
0,0,17,17,18,19,37,76,51,127,0.000333,0.220534,18,11908.81039,661.600577,661.600577,155.769273,3,0
0,0,18,18,16,19,35,74,48,122,0.000333,0.208591,16,10012.36045,556.242247,625.772528,144.710623,3,0
0,0,18,18,16,19,35,74,48,122,0.000333,0.208591,16,10012.36045,556.242247,625.772528,144.710623,3,0
0,0,28,28,23,47,70,124,88,212,0.000333,0.433136,11,14293.488,794.082666,1299.408,365.107601,10,0
0,0,27,27,23,47,70,123,86,209,0.000333,0.427007,11,14091.22166,782.845648,1281.020151,365.107601,10,0
0,0,28,28,23,47,70,124,88,212,0.000333,0.433136,11,14293.488,794.082666,1299.408,365.107601,10,0
0,0,27,27,23,47,70,123,86,209,0.000333,0.427007,11,14091.22166,782.845648,1281.020151,365.107601,10,0
0,0,26,26,22,48,70,120,86,206,0.000333,0.420877,11,13888.95532,771.608629,1262.632301,366.185696,10,0
0,0,25,25,22,48,70,119,84,203,0.000333,0.414748,11,13686.68898,760.37161,1244.244452,366.185696,10,0
0,0,26,26,22,48,70,120,86,206,0.000333,0.420877,11,13888.95532,771.608629,1262.632301,366.185696,10,0
0,0,25,25,22,48,70,119,84,203,0.000333,0.414748,11,13686.68898,760.37161,1244.244452,366.185696,10,0
0,0,14,14,14,21,35,58,50,108,0.000333,0.184654,14,7755.475922,430.859773,553.962566,145.541635,2,0
0,0,8,8,7,14,21,22,25,47,0.000333,0.068813,3,619.316757,34.406486,206.438919,72.954453,1,0
0,0,14,14,15,23,38,60,51,111,0.000333,0.194173,14,8155.279356,453.071075,582.519954,162.645284,2,0
0,0,8,8,9,17,26,24,25,49,0.000333,0.076774,4,921.286185,51.182566,230.321546,98.016193,1,0
0,0,16,16,15,25,40,69,59,128,0.000333,0.227069,14,9536.895146,529.827508,681.206796,174.699764,2,0
0,0,15,15,15,24,39,64,54,118,0.000333,0.207892,14,8731.484466,485.08247,623.677462,168.642459,2,0
0,0,19,19,15,25,40,73,86,159,0.000333,0.282062,21,17769.91791,987.217662,846.186567,174.699764,2,0
0,0,16,16,16,25,41,63,56,119,0.000333,0.212516,16,10200.77902,566.709945,637.548689,180.096405,2,0
0,0,11,11,12,14,26,35,33,68,0.000333,0.106543,12,3835.55881,213.086601,319.629901,96.322519,2,0
0,0,19,19,16,24,40,85,65,150,0.000333,0.266096,16,12772.62743,709.590413,798.289214,174.0391,2,0
0,0,11,11,13,19,32,47,38,85,0.000333,0.141667,12,5100,283.333333,425,128.816339,2,0
0,0,9,9,12,18,30,44,39,83,0.000333,0.135757,12,4887.263033,271.514613,407.271919,118.0782,1,0
0,0,8,8,13,20,33,34,35,69,0.000333,0.116021,6,2088.379165,116.021065,348.063194,134.544278,1,0
0,0,13,13,14,17,31,42,40,82,0.000333,0.135415,14,5687.417364,315.967631,406.244097,122.789837,2,0
0,0,9,9,13,14,27,28,25,53,0.000333,0.084003,6,1512.054226,84.003013,252.009038,101.408685,2,0
0,0,10,10,15,14,29,39,30,69,0.000333,0.111734,14,4692.809641,260.711647,335.200689,111.906328,2,0
0,0,9,9,13,14,27,33,26,59,0.000333,0.093513,6,1683.230176,93.512788,280.538363,101.408685,2,0
0,0,10,10,14,14,28,38,30,68,0.000333,0.108967,14,4576.601886,254.25566,326.900135,106.605938,2,0
0,0,9,9,12,14,26,32,26,58,0.000333,0.090875,6,1635.753022,90.875168,272.625504,96.322519,2,0
0,0,5,5,9,10,19,17,16,33,0.000333,0.046727,4,560.726432,31.151468,140.181608,61.748606,1,0
0,0,5,5,8,11,19,22,18,40,0.000333,0.056639,4,679.668402,37.759356,169.917101,62.053748,1,0
0,0,4,4,8,10,18,19,15,34,0.000333,0.047259,4,567.1098,31.5061,141.77745,57.219281,1,0
0,0,5,5,9,10,19,19,17,36,0.000333,0.050975,4,611.701562,33.98342,152.92539,61.748606,1,0
0,0,19,19,17,27,44,87,60,147,0.000333,0.267512,16,12840.58317,713.365732,802.536448,197.868831,6,0
0,0,10,10,15,18,33,34,31,65,0.000333,0.109295,7,2295.199324,127.511074,327.885618,133.662009,3,0
0,0,14,14,15,17,32,57,39,96,0.000333,0.16,14,6720,373.333333,480,128.090227,2,0
0,0,10,10,14,15,29,38,28,66,0.000333,0.106876,7,2244.38722,124.688179,320.626746,111.906328,2,0
0,0,9,9,12,11,23,27,22,49,0.000333,0.073885,12,2659.85443,147.769691,221.654536,81.073298,3,0
0,0,16,16,15,22,37,54,46,100,0.000333,0.173648,14,7293.234712,405.179706,520.945337,156.710855,2,0
0,0,12,12,14,17,31,39,32,71,0.000333,0.117249,7,2462.235566,136.790865,351.747938,122.789837,2,0
0,0,10,10,14,18,32,38,32,70,0.000333,0.116667,7,2450,136.111111,350,128.361619,2,0
0,0,6,6,6,12,18,14,17,31,0.000333,0.043089,3,387.803025,21.544613,129.267675,58.529325,1,0
0,0,14,14,16,25,41,69,57,126,0.000333,0.225017,16,10800.82484,600.045825,675.051553,180.096405,2,0
0,0,10,10,12,11,23,28,23,51,0.000333,0.076901,12,2768.419917,153.801107,230.70166,81.073298,3,0
0,0,10,10,12,12,24,28,23,51,0.000333,0.077944,6,1402.998525,77.944363,233.833088,86.0391,3,0
0,0,16,16,20,18,38,69,54,123,0.000333,0.215165,30,19364.85253,1075.82514,645.495084,161.497212,4,0
0,0,9,9,16,17,33,38,29,67,0.000333,0.112658,8,2703.795248,150.210847,337.974406,133.486868,2,0
0,0,16,16,19,18,37,68,54,122,0.000333,0.211851,27,17159.93939,953.329966,635.553311,155.769273,4,0
0,0,9,9,15,17,32,37,29,66,0.000333,0.11,7,2310,128.333333,330,128.090227,2,0
0,0,15,15,18,17,35,65,52,117,0.000333,0.200042,27,16203.40505,900.189169,600.126113,144.545518,3,0
0,0,11,11,18,16,34,57,43,100,0.000333,0.169582,18,9157.433114,508.746284,508.746284,139.05865,3,0
0,0,8,8,14,16,30,34,27,61,0.000333,0.099773,7,2095.242284,116.402349,299.320326,117.302969,1,0
0,0,16,16,20,19,39,69,54,123,0.000333,0.216701,20,13002.08946,722.338303,650.104473,167.149185,4,0
0,0,11,11,18,16,34,57,43,100,0.000333,0.169582,18,9157.433114,508.746284,508.746284,139.05865,3,0
0,0,9,9,16,18,34,38,29,67,0.000333,0.11362,8,2726.880083,151.493338,340.86001,139.05865,2,0
0,0,16,16,19,19,38,68,54,122,0.000333,0.213416,18,11524.44882,640.247157,640.247157,161.421246,4,0
0,0,11,11,18,16,34,57,43,100,0.000333,0.169582,18,9157.433114,508.746284,508.746284,139.05865,3,0
0,0,9,9,15,18,33,37,29,66,0.000333,0.110977,7,2330.510083,129.472782,332.930012,133.662009,2,0
0,0,15,15,13,19,32,55,66,121,0.000333,0.201667,18,10890,605,605,128.816339,2,0
0,0,9,9,13,16,29,37,30,67,0.000333,0.108495,6,1952.90836,108.494909,325.484727,112.105716,2,0
0,0,4,4,10,14,24,19,21,40,0.000333,0.061133,5,916.9925,50.944028,183.3985,86.52225,2,0
0,0,4,4,10,15,25,19,23,42,0.000333,0.065014,5,975.2098,54.178322,195.04196,91.82264,2,0
0,0,13,13,16,20,36,44,57,101,0.000333,0.174054,16,8354.598802,464.144378,522.162425,150.438562,2,0
0,0,19,19,21,25,46,70,83,153,0.000333,0.281702,30,25353.14938,1408.508299,845.104979,208.335071,3,0
0,0,13,13,17,21,38,46,67,113,0.000333,0.197672,24,14232.37942,790.687745,593.015809,161.725534,2,0
0,0,9,9,12,13,25,32,29,61,0.000333,0.094425,12,3399.302731,188.850152,283.275228,91.125266,2,0
0,0,36,36,19,55,74,145,142,287,0.000333,0.594038,18,32078.03609,1782.113116,1782.113116,398.685407,10,0
0,0,35,35,19,55,74,144,140,284,0.000333,0.587828,18,31742.72561,1763.484756,1763.484756,398.685407,10,0
0,0,36,36,22,58,80,150,150,300,0.000333,0.632193,22,41724.72543,2318.040301,1896.578428,437.870393,11,0
0,0,35,35,22,58,80,149,148,297,0.000333,0.625871,22,41307.47817,2294.859898,1877.612644,437.870393,11,0
0,0,31,31,19,53,72,135,109,244,0.000333,0.501821,18,27098.31061,1505.4617,1505.4617,384.290407,10,0
0,0,30,30,19,53,72,134,107,241,0.000333,0.495651,18,26765.13466,1486.951925,1486.951925,384.290407,10,0
0,0,31,31,22,56,78,140,111,251,0.000333,0.525879,11,17353.99553,964.110863,1577.635957,423.319371,11,0
0,0,30,30,22,56,78,139,109,248,0.000333,0.519593,11,17146.57725,952.587625,1558.77975,423.319371,11,0
0,0,32,32,19,54,73,143,113,256,0.000333,0.528198,18,28522.71157,1584.595087,1584.595087,391.474548,10,0
0,0,31,31,19,54,73,142,111,253,0.000333,0.522009,18,28188.46104,1566.025613,1566.025613,391.474548,10,0
0,0,32,32,22,57,79,148,115,263,0.000333,0.552631,22,36473.67541,2026.3153,1657.894337,430.582226,11,0
0,0,31,31,22,57,79,147,113,260,0.000333,0.546328,11,18028.81294,1001.600719,1638.982995,430.582226,11,0
0,0,18,18,19,20,39,82,62,144,0.000333,0.253699,27,20549.64383,1141.646879,761.09792,167.149185,3,0
0,0,12,12,18,17,35,60,45,105,0.000333,0.179525,18,9694.344902,538.574717,538.574717,144.545518,3,0
0,0,20,20,21,25,46,89,80,169,0.000333,0.311161,30,28004.45912,1555.803284,933.481971,208.335071,4,0
0,0,12,12,18,17,35,60,45,105,0.000333,0.179525,18,9694.344902,538.574717,538.574717,144.545518,3,0
0,0,20,20,21,25,46,89,80,169,0.000333,0.311161,30,28004.45912,1555.803284,933.481971,208.335071,4,0
0,0,12,12,18,17,35,60,45,105,0.000333,0.179525,18,9694.344902,538.574717,538.574717,144.545518,3,0
0,0,15,15,21,18,39,54,69,123,0.000333,0.216701,30,19503.13419,1083.507455,650.104473,167.297316,4,0
0,0,15,15,21,20,41,52,68,120,0.000333,0.214302,30,19287.18722,1071.510401,642.906241,178.677228,3,0
0,0,15,15,19,18,37,49,67,116,0.000333,0.201432,27,16316.00794,906.444886,604.29659,155.769273,3,0
0,0,15,15,19,20,39,47,66,113,0.000333,0.199083,27,16125.76217,895.875676,597.250451,167.149185,2,0
0,0,7,7,7,12,19,17,22,39,0.000333,0.055223,3,497.007519,27.611529,165.669173,62.671034,1,0
0,0,7,7,8,15,23,17,21,38,0.000333,0.057298,4,687.581417,38.198968,171.895354,82.603359,1,0
0,0,7,7,8,14,22,18,21,39,0.000333,0.057973,4,695.671333,38.648407,173.917833,77.302969,1,0
0,0,15,15,14,20,34,53,52,105,0.000333,0.178061,14,7478.570377,415.476132,534.183598,139.741531,3,0
0,0,15,15,14,22,36,51,51,102,0.000333,0.175777,14,7382.652902,410.147383,527.33235,151.410465,2,0
0,0,15,15,16,19,35,58,54,112,0.000333,0.191493,16,9191.675166,510.64862,574.479698,144.710623,4,0
0,0,15,15,16,21,37,56,53,109,0.000333,0.189277,16,9085.28667,504.738148,567.830417,156.238666,3,0
0,0,14,14,12,21,33,45,47,92,0.000333,0.154695,12,5569.011108,309.389506,464.084259,135.258216,2,0
0,0,14,14,14,21,35,50,49,99,0.000333,0.169266,14,7109.186261,394.954792,507.799019,145.541635,3,0
0,0,10,10,12,14,26,42,30,72,0.000333,0.112811,12,4061.179916,225.621106,338.43166,96.322519,2,0
0,0,10,10,12,13,25,42,30,72,0.000333,0.111453,12,4012.291748,222.905097,334.357646,91.125266,2,0
0,0,28,28,19,49,68,127,101,228,0.000333,0.462647,18,24982.9475,1387.941528,1387.941528,355.831405,8,0
0,0,27,27,19,49,68,126,99,225,0.000333,0.45656,18,24654.22451,1369.679139,1369.679139,355.831405,8,0
0,0,28,28,22,52,74,132,103,235,0.000333,0.486407,11,16051.43695,891.746497,1459.221541,394.530361,9,0
0,0,27,27,22,52,74,131,101,232,0.000333,0.480198,11,15846.52499,880.362499,1440.593181,394.530361,9,0
0,0,14,14,17,19,36,53,49,102,0.000333,0.175777,16,8437.317602,468.739867,527.33235,150.197491,3,0
0,0,14,14,16,21,37,51,48,99,0.000333,0.171912,16,8251.774131,458.431896,515.735883,156.238666,2,0
0,0,30,30,25,50,75,143,110,253,0.000333,0.525297,24,37821.38709,2101.188172,1575.891129,398.289214,10,0
0,0,30,30,24,52,76,141,109,250,0.000333,0.520661,24,37487.56508,2082.642504,1561.981878,406.461965,9,0
0,0,11,11,14,21,35,47,33,80,0.000333,0.136781,7,2872.398489,159.577694,410.342641,145.541635,5,0
0,0,12,12,14,21,35,48,35,83,0.000333,0.14191,7,2980.113433,165.561857,425.73049,145.541635,5,0
0,0,11,11,14,21,35,47,33,80,0.000333,0.136781,7,2872.398489,159.577694,410.342641,145.541635,5,0
0,0,12,12,14,21,35,48,35,83,0.000333,0.14191,7,2980.113433,165.561857,425.73049,145.541635,5,0
0,0,13,13,14,20,34,56,48,104,0.000333,0.176365,14,7407.345897,411.519216,529.096135,139.741531,1,0
0,0,17,17,15,23,38,68,67,135,0.000333,0.236157,14,9918.583,551.032389,708.470214,162.645284,2,0
0,0,9,9,13,17,30,38,32,70,0.000333,0.114494,6,2060.89405,114.494114,343.482342,117.592585,2,0
0,0,19,19,15,24,39,74,81,155,0.000333,0.273079,21,17203.98422,955.776901,819.237344,168.642459,2,0
0,0,9,9,13,17,30,38,32,70,0.000333,0.114494,6,2060.89405,114.494114,343.482342,117.592585,2,0
0,0,9,9,12,14,26,31,25,56,0.000333,0.087742,6,1579.347745,87.741541,263.224624,96.322519,2,0
0,0,9,9,11,14,25,30,25,55,0.000333,0.085137,5,1277.060452,70.947803,255.41209,91.356717,2,0
0,0,12,12,12,15,27,55,41,96,0.000333,0.152156,12,5477.630402,304.3128,456.4692,101.622909,1,0
0,0,13,13,13,23,36,43,52,95,0.000333,0.163714,12,5893.714502,327.428583,491.142875,152.147641,2,0
0,0,12,12,13,20,33,38,43,81,0.000333,0.136199,12,4903.151084,272.397282,408.595924,134.544278,3,0
0,0,9,9,11,14,25,44,31,75,0.000333,0.116096,10,3482.892142,193.494008,348.289214,91.356717,1,0
0,0,11,11,14,17,31,53,38,91,0.000333,0.150277,14,6311.646099,350.647006,450.831864,122.789837,2,0
0,0,11,11,11,15,26,50,37,87,0.000333,0.136313,10,4089.382555,227.18792,408.938255,96.657107,1,0
0,0,10,10,12,13,25,33,29,62,0.000333,0.095973,12,3455.029005,191.946056,287.919084,91.125266,2,0
0,0,10,10,12,12,24,33,29,62,0.000333,0.094756,12,3411.212101,189.511783,284.267675,86.0391,2,0
0,0,11,11,12,13,25,32,29,61,0.000333,0.094425,12,3399.302731,188.850152,283.275228,91.125266,2,0
0,0,11,11,12,13,25,32,29,61,0.000333,0.094425,12,3399.302731,188.850152,283.275228,91.125266,2,0
0,0,11,11,12,13,25,32,29,61,0.000333,0.094425,12,3399.302731,188.850152,283.275228,91.125266,2,0
0,0,10,10,11,14,25,42,32,74,0.000333,0.114548,10,3436.45358,190.914088,343.645358,91.356717,1,0
0,0,11,11,12,12,24,32,29,61,0.000333,0.093228,12,3356.192551,186.455142,279.682713,86.0391,2,0
0,0,11,11,12,13,25,32,29,61,0.000333,0.094425,12,3399.302731,188.850152,283.275228,91.125266,2,0
0,0,15,15,15,18,33,62,45,107,0.000333,0.179917,14,7556.502391,419.805688,539.750171,133.662009,2,0
0,0,9,9,14,14,28,36,27,63,0.000333,0.100954,7,2120.043521,117.780196,302.86336,106.605938,2,0
0,0,12,12,12,19,31,46,45,91,0.000333,0.150277,12,5409.982371,300.554576,450.831864,123.730173,1,0
0,0,13,13,13,20,33,50,47,97,0.000333,0.163102,12,5871.674755,326.204153,489.30623,134.544278,2,0
0,0,13,13,14,22,36,51,47,98,0.000333,0.168884,14,7093.137102,394.063172,506.65265,151.410465,2,0
0,0,12,12,13,19,32,41,43,84,0.000333,0.14,12,5040,280,420,128.816339,2,0
0,0,12,12,14,21,35,42,43,85,0.000333,0.14533,14,6103.84679,339.102599,435.989056,145.541635,2,0
0,0,16,16,16,26,42,69,67,136,0.000333,0.244452,16,11733.68271,651.871262,733.355169,186.211433,2,0
0,0,10,10,12,14,26,42,30,72,0.000333,0.112811,12,4061.179916,225.621106,338.43166,96.322519,2,0
0,0,10,10,12,14,26,42,30,72,0.000333,0.112811,12,4061.179916,225.621106,338.43166,96.322519,2,0
0,0,12,12,13,20,33,47,43,90,0.000333,0.151332,12,5447.945649,302.663647,453.995471,134.544278,2,0
0,0,11,11,13,18,31,44,36,80,0.000333,0.132112,12,4756.028458,264.223803,396.335705,123.164366,2,0
0,0,9,9,11,13,24,39,29,68,0.000333,0.103926,10,3117.7745,173.209694,311.77745,86.159464,1,0
0,0,12,12,15,17,32,51,36,87,0.000333,0.145,14,6090,338.333333,435,128.090227,2,0
0,0,4,4,12,12,24,22,22,44,0.000333,0.067246,6,1210.4301,67.246117,201.73835,86.0391,1,0
0,0,4,4,12,14,26,25,21,46,0.000333,0.072073,6,1297.321362,72.073409,216.220227,96.322519,1,0
0,0,17,17,15,20,35,78,60,138,0.000333,0.235947,21,14864.66218,825.814566,707.841056,145.041921,2,0
0,0,10,10,14,16,30,47,35,82,0.000333,0.134122,14,5633.110404,312.950578,402.365029,117.302969,2,0
0,0,9,9,14,15,29,34,27,61,0.000333,0.098779,7,2074.357885,115.242105,296.336841,111.906328,2,0
0,0,9,9,11,16,27,39,35,74,0.000333,0.117287,10,3518.616752,195.478708,351.861675,102.053748,1,0
0,0,12,12,16,13,29,47,38,85,0.000333,0.137643,16,6606.854153,367.047453,412.928385,112.105716,4,0
0,0,12,12,16,15,31,45,37,82,0.000333,0.135415,16,6499.905559,361.105864,406.244097,122.603359,3,0
0,0,9,9,11,16,27,39,35,74,0.000333,0.117287,10,3518.616752,195.478708,351.861675,102.053748,1,0
0,0,9,9,12,14,26,31,25,56,0.000333,0.087742,6,1579.347745,87.741541,263.224624,96.322519,2,0
0,0,9,9,11,14,25,30,25,55,0.000333,0.085137,5,1277.060452,70.947803,255.41209,91.356717,2,0
0,0,4,4,12,12,24,22,22,44,0.000333,0.067246,6,1210.4301,67.246117,201.73835,86.0391,1,0
0,0,12,12,12,17,29,40,44,84,0.000333,0.136023,12,4896.844843,272.046936,408.070404,112.506418,2,0
0,0,14,14,15,20,35,49,46,95,0.000333,0.162427,14,6821.946413,378.997023,487.281887,145.041921,2,0
0,0,12,12,12,17,29,40,44,84,0.000333,0.136023,12,4896.844843,272.046936,408.070404,112.506418,2,0
0,0,14,14,15,20,35,49,46,95,0.000333,0.162427,14,6821.946413,378.997023,487.281887,145.041921,2,0
0,0,12,12,12,20,32,47,41,88,0.000333,0.146667,12,5280,293.333333,440,129.458112,1,0
0,0,14,14,16,20,36,58,43,101,0.000333,0.174054,16,8354.598802,464.144378,522.162425,150.438562,2,0
0,0,12,12,12,14,26,50,39,89,0.000333,0.139446,12,5020.069619,278.892757,418.339135,96.322519,1,0
0,0,15,15,16,18,34,62,46,108,0.000333,0.183149,16,8791.13579,488.396433,549.445987,139.05865,2,0
0,0,10,10,12,13,25,33,29,62,0.000333,0.095973,12,3455.029005,191.946056,287.919084,91.125266,2,0
0,0,10,10,12,12,24,29,27,56,0.000333,0.085586,12,3081.0948,171.171933,256.7579,86.0391,2,0
0,0,10,10,12,13,25,33,29,62,0.000333,0.095973,12,3455.029005,191.946056,287.919084,91.125266,2,0
0,0,16,16,15,17,32,67,47,114,0.000333,0.19,14,7980,443.333333,570,128.090227,3,0
0,0,13,13,15,17,32,53,37,90,0.000333,0.15,14,6300,350,450,128.090227,3,0
0,0,11,11,15,15,30,47,33,80,0.000333,0.13085,14,5495.717467,305.317637,392.551248,117.206718,2,0
0,0,16,16,15,17,32,66,47,113,0.000333,0.188333,14,7910,439.444444,565,128.090227,3,0
0,0,13,13,15,17,32,52,37,89,0.000333,0.148333,14,6230,346.111111,445,128.090227,3,0
0,0,11,11,15,15,30,47,33,80,0.000333,0.13085,14,5495.717467,305.317637,392.551248,117.206718,2,0
0,0,10,10,13,15,28,32,27,59,0.000333,0.094545,6,1701.803642,94.544647,283.63394,106.709075,3,0
0,0,10,10,13,15,28,32,27,59,0.000333,0.094545,6,1701.803642,94.544647,283.63394,106.709075,3,0
0,0,10,10,13,16,29,33,28,61,0.000333,0.098779,6,1778.021044,98.778947,296.336841,112.105716,3,0
0,0,10,10,13,16,29,32,28,60,0.000333,0.09716,6,1748.873158,97.15962,291.47886,112.105716,3,0
0,0,10,10,13,15,28,32,27,59,0.000333,0.094545,6,1701.803642,94.544647,283.63394,106.709075,3,0
0,0,10,10,13,15,28,32,27,59,0.000333,0.094545,6,1701.803642,94.544647,283.63394,106.709075,3,0
0,0,16,16,15,18,33,71,49,120,0.000333,0.201776,14,8474.582121,470.810118,605.327294,133.662009,2,0
0,0,11,11,15,19,34,48,38,86,0.000333,0.145841,14,6125.305261,340.294737,437.521804,139.313982,2,0
0,0,16,16,15,22,37,71,57,128,0.000333,0.22227,14,9335.340431,518.630024,666.810031,156.710855,2,0
0,0,10,10,14,17,31,47,36,83,0.000333,0.137066,14,5756.776113,319.820895,411.198294,122.789837,2,0
0,0,16,16,15,22,37,71,57,128,0.000333,0.22227,14,9335.340431,518.630024,666.810031,156.710855,2,0
0,0,10,10,14,17,31,47,36,83,0.000333,0.137066,14,5756.776113,319.820895,411.198294,122.789837,2,0
0,0,12,12,16,13,29,42,32,74,0.000333,0.11983,16,5751.849498,319.547194,359.490594,112.105716,5,0
0,0,12,12,15,15,30,40,31,71,0.000333,0.11613,14,4877.449252,270.969403,348.389232,117.206718,4,0
0,0,12,12,15,13,28,41,32,73,0.000333,0.116979,14,4913.11673,272.950929,350.936909,106.709075,5,0
0,0,12,12,14,15,29,39,31,70,0.000333,0.113353,14,4760.821375,264.490076,340.05867,111.906328,4,0
0,0,13,13,12,19,31,54,57,111,0.000333,0.183305,18,9898.484228,549.91579,549.91579,123.730173,1,0
0,0,5,5,10,13,23,24,22,46,0.000333,0.069361,5,1040.41925,57.801069,208.08385,81.324997,1,0
0,0,15,15,12,20,32,60,71,131,0.000333,0.218333,18,11790,655,655,129.458112,1,0
0,0,5,5,10,13,23,24,22,46,0.000333,0.069361,5,1040.41925,57.801069,208.08385,81.324997,1,0
0,0,5,5,11,10,21,25,19,44,0.000333,0.064421,5,966.309833,53.68388,193.261967,71.273029,1,0
0,0,13,13,12,20,32,46,47,93,0.000333,0.155,12,5580,310,465,129.458112,2,0
0,0,9,9,9,16,25,26,32,58,0.000333,0.089781,8,2154.749272,119.708293,269.343659,92.529325,1,0
0,0,13,13,13,22,35,47,47,94,0.000333,0.160718,12,5785.831243,321.435069,482.152604,146.213212,2,0
0,0,9,9,10,19,29,27,31,58,0.000333,0.093921,5,1408.814489,78.267472,281.762898,113.929904,1,0
0,0,16,16,14,26,40,59,59,118,0.000333,0.209329,14,8791.825213,488.434734,627.987515,175.514402,2,0
0,0,12,12,13,19,32,41,43,84,0.000333,0.14,12,5040,280,420,128.816339,2,0
0,0,12,12,14,21,35,42,43,85,0.000333,0.14533,14,6103.84679,339.102599,435.989056,145.541635,2,0
0,0,12,12,15,19,34,50,37,87,0.000333,0.147536,7,3098.26487,172.125826,442.609267,139.313982,3,0
0,0,12,12,15,19,34,50,37,87,0.000333,0.147536,7,3098.26487,172.125826,442.609267,139.313982,3,0
0,0,8,8,13,14,27,41,26,67,0.000333,0.106192,6,1911.464776,106.192488,318.577463,101.408685,2,0
0,0,8,8,13,14,27,41,26,67,0.000333,0.106192,6,1911.464776,106.192488,318.577463,101.408685,2,0
0,0,3,3,8,10,18,11,13,24,0.000333,0.033359,4,400.3128,22.2396,100.0782,57.219281,1,0
0,0,5,5,12,16,28,23,24,47,0.000333,0.075315,6,1355.674088,75.315227,225.945681,107.01955,2,0
0,0,16,16,18,25,43,70,60,130,0.000333,0.235138,18,12697.45953,705.414418,705.414418,191.155055,3,0
0,0,5,5,12,17,29,23,25,48,0.000333,0.077728,6,1399.098527,77.727696,233.183088,112.506418,2,0
0,0,5,5,11,15,26,20,22,42,0.000333,0.065806,5,987.092341,54.838463,197.418468,96.657107,2,0
0,0,18,18,19,22,41,78,61,139,0.000333,0.248233,18,13404.59512,744.699729,744.699729,178.818118,4,0
0,0,5,5,12,13,25,21,20,41,0.000333,0.063466,6,1142.388623,63.466035,190.398104,91.125266,2,0
0,0,18,18,19,22,41,78,61,139,0.000333,0.248233,18,13404.59512,744.699729,744.699729,178.818118,4,0
0,0,5,5,12,13,25,21,20,41,0.000333,0.063466,6,1142.388623,63.466035,190.398104,91.125266,2,0
0,0,13,13,18,20,38,62,44,106,0.000333,0.185427,18,10013.0457,556.280316,556.280316,161.497212,3,0
0,0,12,12,15,20,35,57,39,96,0.000333,0.164137,7,3446.878187,191.493233,492.41117,145.041921,3,0
0,0,12,12,15,20,35,56,39,95,0.000333,0.162427,7,3410.973206,189.498511,487.281887,145.041921,3,0
0,0,12,12,16,18,34,56,38,94,0.000333,0.159407,16,7651.544113,425.085784,478.221507,139.05865,3,0
0,0,9,9,10,13,23,35,28,63,0.000333,0.094995,10,2849.844032,158.324668,284.984403,81.324997,1,0
0,0,12,12,14,17,31,47,35,82,0.000333,0.135415,14,5687.417364,315.967631,406.244097,122.789837,2,0
0,0,12,12,14,20,34,50,51,101,0.000333,0.171278,14,7193.672458,399.64847,513.833747,139.741531,1,0
0,0,14,14,16,22,38,58,46,104,0.000333,0.181928,16,8732.551382,485.141743,545.784461,162.107496,2,0
0,0,14,14,17,23,40,59,48,107,0.000333,0.189815,16,9111.140898,506.174494,569.446306,173.528793,2,0
0,0,14,14,15,19,34,54,68,122,0.000333,0.20689,21,13034.0798,724.115544,620.670467,139.313982,1,0
0,0,18,18,18,22,40,69,69,138,0.000333,0.244809,27,19829.50408,1101.639116,734.426077,173.166146,2,0
0,0,18,18,19,23,42,70,78,148,0.000333,0.266021,27,21547.70042,1197.094468,798.062979,184.752548,2,0
0,0,3,3,8,8,16,14,11,25,0.000333,0.033333,4,400,22.222222,100,48,1,0
0,0,9,9,13,14,27,27,24,51,0.000333,0.080833,6,1454.995576,80.833088,242.499263,101.408685,2,0
0,0,11,11,12,13,25,32,29,61,0.000333,0.094425,12,3399.302731,188.850152,283.275228,91.125266,2,0
0,0,10,10,12,13,25,29,27,56,0.000333,0.086685,12,3120.67136,173.370631,260.055947,91.125266,2,0
0,0,10,10,16,12,28,40,29,69,0.000333,0.110569,16,5307.319834,294.851102,331.70749,107.01955,5,0
0,0,10,10,16,14,30,38,28,66,0.000333,0.107952,16,5181.676469,287.870915,323.854779,117.302969,4,0
0,0,10,10,16,12,28,40,29,69,0.000333,0.110569,16,5307.319834,294.851102,331.70749,107.01955,5,0
0,0,10,10,16,14,30,38,28,66,0.000333,0.107952,16,5181.676469,287.870915,323.854779,117.302969,4,0
0,0,7,7,15,20,35,39,32,71,0.000333,0.121393,7,2549.253659,141.625203,364.179094,145.041921,2,0
0,0,12,12,14,19,33,43,37,80,0.000333,0.134517,7,2824.860707,156.936706,403.55153,134.013592,3,0
0,0,10,10,14,17,31,35,29,64,0.000333,0.10569,7,2219.479947,123.304442,317.068564,122.789837,3,0
0,0,12,12,14,19,33,43,37,80,0.000333,0.134517,7,2824.860707,156.936706,403.55153,134.013592,3,0
0,0,10,10,14,17,31,35,29,64,0.000333,0.10569,7,2219.479947,123.304442,317.068564,122.789837,3,0
0,0,12,12,14,19,33,44,38,82,0.000333,0.13788,14,5790.964449,321.720247,413.640318,134.013592,3,0
0,0,10,10,14,17,31,36,30,66,0.000333,0.108992,7,2288.838695,127.157705,326.976956,122.789837,3,0
0,0,12,12,14,19,33,43,38,81,0.000333,0.136199,14,5720.342931,317.79683,408.595924,134.013592,3,0
0,0,10,10,14,17,31,35,30,65,0.000333,0.107341,7,2254.159321,125.231073,322.02276,122.789837,3,0
0,0,10,10,13,17,30,40,32,72,0.000333,0.117765,6,2119.776737,117.765374,353.296123,117.592585,2,0
0,0,9,9,13,15,28,45,30,75,0.000333,0.120184,12,4326.61943,240.367746,360.551619,106.709075,2,0
0,0,9,9,12,15,27,44,30,74,0.000333,0.117287,12,4222.340102,234.57445,351.861675,101.622909,2,0
0,0,12,12,13,19,32,54,52,106,0.000333,0.176667,12,6360,353.333333,530,128.816339,2,0
0,0,12,12,13,19,32,54,52,106,0.000333,0.176667,12,6360,353.333333,530,128.816339,2,0
0,0,12,12,13,15,28,55,43,98,0.000333,0.15704,12,5653.449388,314.080522,471.120782,106.709075,2,0
0,0,12,12,13,15,28,55,43,98,0.000333,0.15704,12,5653.449388,314.080522,471.120782,106.709075,2,0
0,0,13,13,15,24,39,63,54,117,0.000333,0.206131,14,8657.488834,480.971602,618.39206,168.642459,2,0
0,0,17,17,15,26,41,75,82,157,0.000333,0.280379,21,17663.84896,981.324942,841.135665,180.814792,2,0
0,0,3,3,6,8,14,9,9,18,0.000333,0.022844,3,205.597166,11.422065,68.532389,39.509775,1,0
0,0,7,7,9,10,19,32,24,56,0.000333,0.079295,8,1903.071526,105.726196,237.883941,61.748606,1,0
0,0,9,9,11,15,26,32,23,55,0.000333,0.086175,5,1292.620922,71.812273,258.524184,96.657107,5,0
0,0,3,3,7,7,14,11,9,20,0.000333,0.025382,3,228.441295,12.691183,76.147098,39.302969,1,0
0,0,10,10,11,17,28,42,38,80,0.000333,0.128196,10,3845.883938,213.660219,384.588394,107.540616,1,0
0,0,11,11,14,16,30,49,33,82,0.000333,0.134122,14,5633.110404,312.950578,402.365029,117.302969,2,0
0,0,11,11,14,16,30,49,33,82,0.000333,0.134122,14,5633.110404,312.950578,402.365029,117.302969,2,0
0,0,19,19,17,18,35,75,57,132,0.000333,0.225688,24,16249.5686,902.753811,677.065358,144.545518,3,0
0,0,14,14,14,16,30,52,40,92,0.000333,0.150478,14,6320.075087,351.115283,451.433935,117.302969,2,0
0,0,13,13,14,16,30,50,38,88,0.000333,0.143935,14,6045.289214,335.849401,431.806372,117.302969,2,0
0,0,13,13,18,18,36,56,45,101,0.000333,0.174054,18,9398.923653,522.162425,522.162425,150.1173,3,0
0,0,13,13,17,18,35,55,45,100,0.000333,0.170976,16,8206.852827,455.936268,512.928302,144.545518,3,0
0,0,13,13,17,18,35,55,44,99,0.000333,0.169266,16,8124.784299,451.376905,507.799019,144.545518,3,0
0,0,13,13,17,18,35,55,44,99,0.000333,0.169266,16,8124.784299,451.376905,507.799019,144.545518,3,0
0,0,7,7,15,17,32,32,34,66,0.000333,0.11,14,4620,256.666667,330,128.090227,1,0
0,0,14,14,14,22,36,57,51,108,0.000333,0.186117,14,7816.926602,434.2737,558.3519,151.410465,4,0
0,0,11,11,14,18,32,38,36,74,0.000333,0.123333,14,5180,287.777778,370,128.361619,3,0
0,0,10,10,14,15,29,47,32,79,0.000333,0.127927,14,5372.926981,298.495943,383.780499,111.906328,2,0
0,0,10,10,14,15,29,47,32,79,0.000333,0.127927,14,5372.926981,298.495943,383.780499,111.906328,2,0
0,0,9,9,13,14,27,44,31,75,0.000333,0.118872,12,4279.398752,237.744375,356.616563,101.408685,1,0
0,0,13,13,14,17,31,41,39,80,0.000333,0.132112,14,5548.699868,308.261104,396.335705,122.789837,2,0
0,0,9,9,13,14,27,27,24,51,0.000333,0.080833,6,1454.995576,80.833088,242.499263,101.408685,2,0
0,0,18,18,18,24,42,73,64,137,0.000333,0.246249,18,13297.45477,738.747487,738.747487,185.09775,3,0
0,0,10,10,15,19,34,41,34,75,0.000333,0.127187,7,2670.917992,148.384333,381.559713,139.313982,1,0
0,0,17,17,18,18,36,71,58,129,0.000333,0.222307,27,18006.84878,1000.380488,666.920325,150.1173,3,0
0,0,10,10,14,17,31,40,33,73,0.000333,0.120552,7,2531.594315,140.644129,361.656331,122.789837,1,0
0,0,10,10,13,19,32,39,41,80,0.000333,0.133333,12,4800,266.666667,400,128.816339,1,0
0,0,10,10,14,21,35,40,41,81,0.000333,0.138491,7,2908.303471,161.572415,415.471924,145.541635,1,0
0,0,17,17,18,22,40,71,66,137,0.000333,0.243035,27,19685.81202,1093.656223,729.104149,173.166146,3,0
0,0,11,11,17,19,36,59,48,107,0.000333,0.184394,16,8850.911602,491.717311,553.181975,150.197491,3,0
0,0,10,10,14,20,34,40,39,79,0.000333,0.13397,7,2813.366951,156.298164,401.909564,139.741531,2,0
0,0,11,11,13,16,29,36,32,68,0.000333,0.110114,12,3964.112492,220.228472,330.342708,112.105716,2,0
0,0,11,11,13,17,30,44,30,74,0.000333,0.121037,6,2178.659424,121.036635,363.109904,117.592585,2,0
0,0,13,13,14,17,31,55,39,94,0.000333,0.155231,14,6519.722344,362.206797,465.694453,122.789837,2,0
0,0,10,10,12,13,25,29,27,56,0.000333,0.086685,12,3120.67136,173.370631,260.055947,91.125266,2,0
0,0,14,14,19,18,37,59,41,100,0.000333,0.173648,18,9377.016058,520.945337,520.945337,155.769273,7,0
0,0,14,14,18,20,38,57,40,97,0.000333,0.169683,18,9162.881438,509.048969,509.048969,161.497212,6,0
0,0,10,10,15,20,35,44,31,75,0.000333,0.128232,7,2692.873584,149.604088,384.696226,145.041921,5,0
0,0,11,11,15,20,35,45,33,78,0.000333,0.133361,7,2800.588527,155.588252,400.084075,145.041921,5,0
0,0,12,12,15,12,27,41,30,71,0.000333,0.112532,14,4726.358177,262.575454,337.597013,101.622909,5,0
0,0,12,12,15,14,29,39,29,68,0.000333,0.110114,14,4624.797907,256.933217,330.342708,111.906328,4,0
0,0,30,30,19,52,71,130,106,236,0.000333,0.48378,18,26124.12576,1451.34032,1451.34032,377.133488,10,0
0,0,29,29,19,52,71,129,104,233,0.000333,0.47763,18,25792.03942,1432.891079,1432.891079,377.133488,10,0
0,0,30,30,22,55,77,135,110,245,0.000333,0.511788,22,33777.97945,1876.554414,1535.362702,416.08228,11,0
0,0,29,29,22,55,77,134,108,242,0.000333,0.505521,11,16682.18577,926.788098,1516.562343,416.08228,11,0
0,0,30,30,22,55,77,135,110,245,0.000333,0.511788,22,33777.97945,1876.554414,1535.362702,416.08228,11,0
0,0,29,29,22,55,77,134,108,242,0.000333,0.505521,11,16682.18577,926.788098,1516.562343,416.08228,11,0
0,0,28,28,22,50,72,130,94,224,0.000333,0.460688,11,15202.6952,844.594178,1382.0632,380.300305,11,0
0,0,27,27,22,50,72,129,92,221,0.000333,0.454518,11,14999.08768,833.282649,1363.553425,380.300305,11,0
0,0,21,21,23,25,48,91,95,186,0.000333,0.346268,33,34280.49983,1904.472213,1038.803025,220.13833,3,0
0,0,20,20,23,25,48,90,93,183,0.000333,0.340683,33,33727.58854,1873.754919,1022.048138,220.13833,3,0
0,0,17,17,16,16,32,72,51,123,0.000333,0.205,24,14760,820,615,128,2,0
0,0,13,13,15,16,31,52,37,89,0.000333,0.146974,14,6172.928603,342.940478,440.923472,122.603359,2,0
0,0,12,12,15,16,31,50,35,85,0.000333,0.140369,14,5895.493609,327.527423,421.106686,122.603359,2,0
0,0,17,17,15,22,37,73,58,131,0.000333,0.227479,14,9554.137473,530.785415,682.438391,156.710855,2,0
0,0,11,11,14,18,32,50,38,88,0.000333,0.146667,14,6160,342.222222,440,128.361619,2,0
0,0,7,7,7,14,21,22,24,46,0.000333,0.067349,3,606.139804,33.674434,202.046601,72.954453,1,0
0,0,7,7,9,16,25,27,24,51,0.000333,0.078946,4,947.346663,52.63037,236.836666,92.529325,1,0
0,0,17,17,15,20,35,75,60,135,0.000333,0.230818,21,14541.51735,807.862075,692.453207,145.041921,2,0
0,0,10,10,13,16,29,44,35,79,0.000333,0.127927,12,4605.365983,255.853666,383.780499,112.105716,2,0
0,0,11,11,14,18,32,45,37,82,0.000333,0.136667,14,5740,318.888889,410,128.361619,2,0
0,0,10,10,14,14,28,42,31,73,0.000333,0.116979,14,4913.11673,272.950929,350.936909,106.605938,2,0
0,0,11,11,14,16,30,49,33,82,0.000333,0.134122,14,5633.110404,312.950578,402.365029,117.302969,2,0
0,0,11,11,14,16,30,49,33,82,0.000333,0.134122,14,5633.110404,312.950578,402.365029,117.302969,2,0
0,0,11,11,15,17,32,50,34,84,0.000333,0.14,14,5880,326.666667,420,128.090227,2,0
0,0,11,11,14,17,31,49,34,83,0.000333,0.137066,14,5756.776113,319.820895,411.198294,122.789837,2,0
0,0,13,13,16,22,38,57,54,111,0.000333,0.194173,16,9320.319264,517.795515,582.519954,162.107496,1,0
0,0,11,11,14,16,30,49,33,82,0.000333,0.134122,14,5633.110404,312.950578,402.365029,117.302969,2,0
0,0,11,11,14,16,30,49,33,82,0.000333,0.134122,14,5633.110404,312.950578,402.365029,117.302969,2,0
0,0,10,10,13,15,28,46,32,78,0.000333,0.124991,12,4499.684207,249.982456,374.973684,106.709075,1,0
0,0,11,11,14,15,29,49,33,82,0.000333,0.132785,14,5576.962182,309.831232,398.354442,111.906328,2,0
0,0,11,11,14,16,30,49,33,82,0.000333,0.134122,14,5633.110404,312.950578,402.365029,117.302969,2,0
0,0,9,9,13,12,25,32,21,53,0.000333,0.082041,6,1476.746268,82.041459,246.124378,91.125266,4,0
0,0,9,9,13,14,27,40,28,68,0.000333,0.107777,12,3879.988202,215.5549,323.33235,101.408685,2,0
0,0,9,9,12,14,26,39,28,67,0.000333,0.104976,12,3779.153533,209.952974,314.929461,96.322519,2,0
0,0,9,9,12,14,26,39,27,66,0.000333,0.10341,6,1861.374128,103.409674,310.229021,96.322519,2,0
0,0,9,9,12,14,26,39,27,66,0.000333,0.10341,6,1861.374128,103.409674,310.229021,96.322519,2,0
0,0,9,9,13,15,28,40,28,68,0.000333,0.108967,6,1961.400808,108.966712,326.900135,106.709075,2,0
0,0,9,9,12,15,27,39,28,67,0.000333,0.106192,6,1911.464776,106.192488,318.577463,101.622909,2,0
0,0,3,3,9,9,18,10,14,24,0.000333,0.033359,4,400.3128,22.2396,100.0782,57.05865,1,0
0,0,8,8,11,13,24,36,26,62,0.000333,0.094756,10,2842.67675,157.926486,284.267675,86.159464,1,0
0,0,18,18,17,23,40,59,73,132,0.000333,0.234165,24,16859.86821,936.659345,702.494509,173.528793,2,0
0,0,18,18,18,24,42,60,82,142,0.000333,0.255236,27,20674.145,1148.563611,765.709074,185.09775,2,0
0,0,17,17,16,25,41,73,65,138,0.000333,0.246447,16,11829.47483,657.193046,739.342177,180.096405,2,0
0,0,12,12,13,13,26,35,30,65,0.000333,0.101843,12,3666.34298,203.685721,305.528582,96.211433,3,0
0,0,11,11,13,13,26,34,29,63,0.000333,0.098709,12,3553.532427,197.418468,296.127702,96.211433,3,0
0,0,12,12,13,12,25,35,30,65,0.000333,0.100617,12,3622.207828,201.233768,301.850652,91.125266,3,0
0,0,11,11,13,13,26,34,29,63,0.000333,0.098709,12,3553.532427,197.418468,296.127702,96.211433,3,0
0,0,11,11,13,12,25,34,29,63,0.000333,0.097521,12,3510.755279,195.04196,292.56294,91.125266,3,0
0,0,12,12,13,12,25,35,30,65,0.000333,0.100617,12,3622.207828,201.233768,301.850652,91.125266,3,0
0,0,7,7,13,15,28,31,31,62,0.000333,0.099352,12,3576.672062,198.704003,298.056005,106.709075,2,0
0,0,14,14,14,22,36,54,66,120,0.000333,0.206797,21,13028.211,723.7895,620.391,151.410465,1,0
0,0,14,14,15,23,38,55,70,125,0.000333,0.218664,21,13775.80972,765.322762,655.990939,162.645284,1,0
0,0,19,19,19,25,44,77,88,165,0.000333,0.300269,27,24321.76786,1351.209326,900.806217,196.807027,2,0
0,0,10,10,18,20,38,54,44,98,0.000333,0.171432,18,9257.344134,514.296896,514.296896,161.497212,2,0
0,0,12,12,14,21,35,48,54,102,0.000333,0.174396,14,7324.616148,406.923119,523.186868,145.541635,1,0
0,0,12,12,15,22,37,49,56,105,0.000333,0.182331,14,7657.896447,425.438692,546.992603,156.710855,1,0
0,0,17,17,19,24,43,71,74,145,0.000333,0.262269,27,21243.82652,1180.212584,786.808389,190.749723,2,0
0,0,10,10,18,20,38,54,44,98,0.000333,0.171432,18,9257.344134,514.296896,514.296896,161.497212,2,0
0,0,13,13,14,17,31,60,44,104,0.000333,0.171745,14,7213.309828,400.739435,515.236416,122.789837,2,0
0,0,13,13,14,18,32,63,45,108,0.000333,0.18,14,7560,420,540,128.361619,3,0
0,0,14,14,15,19,34,58,45,103,0.000333,0.17467,14,7336.121417,407.562301,524.008673,139.313982,3,0
0,0,14,14,15,19,34,58,45,103,0.000333,0.17467,14,7336.121417,407.562301,524.008673,139.313982,3,0
0,0,14,14,14,18,32,51,38,89,0.000333,0.148333,14,6230,346.111111,445,128.361619,3,0
0,0,11,11,13,16,29,37,28,65,0.000333,0.105256,6,1894.612588,105.256255,315.768765,112.105716,3,0
0,0,14,14,14,18,32,50,38,88,0.000333,0.146667,14,6160,342.222222,440,128.361619,3,0
0,0,11,11,13,16,29,36,28,64,0.000333,0.103637,6,1865.464702,103.636928,310.910784,112.105716,3,0
0,0,14,14,14,17,31,50,37,87,0.000333,0.143672,14,6034.211106,335.23395,431.015079,122.789837,3,0
0,0,11,11,13,15,28,36,27,63,0.000333,0.100954,6,1817.180161,100.954453,302.86336,106.709075,3,0
0,0,14,14,14,17,31,50,37,87,0.000333,0.143672,14,6034.211106,335.23395,431.015079,122.789837,3,0
0,0,11,11,13,15,28,36,27,63,0.000333,0.100954,6,1817.180161,100.954453,302.86336,106.709075,3,0
0,0,14,14,14,17,31,50,37,87,0.000333,0.143672,14,6034.211106,335.23395,431.015079,122.789837,3,0
0,0,11,11,13,15,28,36,27,63,0.000333,0.100954,6,1817.180161,100.954453,302.86336,106.709075,3,0
0,0,14,14,14,17,31,50,37,87,0.000333,0.143672,14,6034.211106,335.23395,431.015079,122.789837,3,0
0,0,11,11,13,15,28,36,27,63,0.000333,0.100954,6,1817.180161,100.954453,302.86336,106.709075,3,0
0,0,13,13,14,16,30,47,36,83,0.000333,0.135757,14,5701.806872,316.767048,407.271919,117.302969,2,0
0,0,10,10,13,14,27,33,26,59,0.000333,0.093513,6,1683.230176,93.512788,280.538363,101.408685,2,0
0,0,14,14,14,18,32,50,37,87,0.000333,0.145,14,6090,338.333333,435,128.361619,3,0
0,0,11,11,13,16,29,36,27,63,0.000333,0.102018,6,1836.316816,102.017601,306.052803,112.105716,3,0
0,0,14,14,14,18,32,49,37,86,0.000333,0.143333,14,6020,334.444444,430,128.361619,3,0
0,0,11,11,13,16,29,35,27,62,0.000333,0.100398,6,1807.16893,100.398274,301.194822,112.105716,3,0
0,0,14,14,14,18,32,50,37,87,0.000333,0.145,14,6090,338.333333,435,128.361619,3,0
0,0,11,11,13,16,29,36,27,63,0.000333,0.102018,6,1836.316816,102.017601,306.052803,112.105716,3,0
0,0,14,14,14,18,32,49,37,86,0.000333,0.143333,14,6020,334.444444,430,128.361619,3,0
0,0,11,11,13,16,29,35,27,62,0.000333,0.100398,6,1807.16893,100.398274,301.194822,112.105716,3,0
0,0,14,14,14,17,31,49,36,85,0.000333,0.140369,14,5895.493609,327.527423,421.106686,122.789837,3,0
0,0,11,11,13,15,28,35,26,61,0.000333,0.09775,6,1759.491901,97.74955,293.24865,106.709075,3,0
0,0,14,14,14,17,31,49,36,85,0.000333,0.140369,14,5895.493609,327.527423,421.106686,122.789837,3,0
0,0,11,11,13,15,28,35,26,61,0.000333,0.09775,6,1759.491901,97.74955,293.24865,106.709075,3,0
0,0,15,15,16,19,35,61,50,111,0.000333,0.189783,16,9109.606638,506.089258,569.350415,144.710623,2,0
0,0,15,15,15,23,38,58,58,116,0.000333,0.20292,14,8522.634282,473.479682,608.759592,162.645284,2,0
0,0,15,15,15,23,38,58,58,116,0.000333,0.20292,14,8522.634282,473.479682,608.759592,162.645284,2,0
0,0,5,5,13,11,24,23,19,42,0.000333,0.064189,6,1155.41055,64.189475,192.568425,86.159464,1,0
0,0,6,6,9,10,19,19,16,35,0.000333,0.049559,4,594.709852,33.039436,148.677463,61.748606,2,0
0,0,8,8,12,13,25,36,24,60,0.000333,0.092877,6,1671.788228,92.877124,278.631371,91.125266,2,0
0,0,8,8,12,13,25,36,24,60,0.000333,0.092877,6,1671.788228,92.877124,278.631371,91.125266,2,0
0,0,12,12,16,13,29,42,34,76,0.000333,0.123069,16,5907.30489,328.183605,369.206556,112.105716,3,0
0,0,12,12,16,15,31,40,33,73,0.000333,0.120552,16,5786.501291,321.472294,361.656331,122.603359,2,0
0,0,12,12,12,14,26,36,33,69,0.000333,0.10811,12,3891.964087,216.220227,324.330341,96.322519,2,0
0,0,13,13,12,20,32,49,51,100,0.000333,0.166667,12,6000,333.333333,500,129.458112,1,0
0,0,11,11,11,12,23,28,26,54,0.000333,0.081424,10,2442.723456,135.706859,244.272346,81.073298,2,0
0,0,14,14,15,20,35,69,50,119,0.000333,0.203462,14,8545.385506,474.743639,610.384679,145.041921,2,0
0,0,25,25,22,46,68,117,84,201,0.000333,0.40786,11,13459.38034,747.743352,1223.580031,352.191346,9,0
0,0,24,24,22,46,68,116,82,198,0.000333,0.401773,11,13258.49407,736.583004,1205.317643,352.191346,9,0
0,0,12,12,14,18,32,43,37,80,0.000333,0.133333,14,5600,311.111111,400,128.361619,3,0
0,0,10,10,14,17,31,35,29,64,0.000333,0.10569,7,2219.479947,123.304442,317.068564,122.789837,3,0
0,0,12,12,14,18,32,43,37,80,0.000333,0.133333,14,5600,311.111111,400,128.361619,3,0
0,0,10,10,14,16,30,35,29,64,0.000333,0.10468,7,2198.286987,122.127055,314.040998,117.302969,3,0
0,0,17,17,16,25,41,62,57,119,0.000333,0.212516,16,10200.77902,566.709945,637.548689,180.096405,2,0
0,0,16,16,19,22,41,62,72,134,0.000333,0.239304,27,19383.62315,1076.867953,717.911969,178.818118,2,0
0,0,17,17,15,19,34,69,57,126,0.000333,0.213673,21,13461.42668,747.857038,641.020318,139.313982,2,0
0,0,10,10,14,16,30,47,35,82,0.000333,0.134122,14,5633.110404,312.950578,402.365029,117.302969,2,0
0,0,14,14,15,19,34,55,47,102,0.000333,0.172974,14,7264.896937,403.605385,518.92121,139.313982,2,0
0,0,13,13,15,19,34,53,45,98,0.000333,0.16619,14,6979.999018,387.777723,498.571358,139.313982,2,0
0,0,15,15,21,22,43,74,52,126,0.000333,0.227903,20,13674.18718,759.677066,683.709359,190.346161,3,0
0,0,11,11,19,18,37,55,41,96,0.000333,0.166703,18,9001.935416,500.107523,500.107523,155.769273,2,0
0,0,15,15,20,22,42,73,52,125,0.000333,0.22468,20,13480.79356,748.932975,674.039678,184.546058,3,0
0,0,11,11,19,18,37,55,41,96,0.000333,0.166703,18,9001.935416,500.107523,500.107523,155.769273,2,0
0,0,14,14,15,17,32,65,43,108,0.000333,0.18,14,7560,420,540,128.090227,2,0
0,0,15,15,15,19,34,69,45,114,0.000333,0.193324,14,8119.590695,451.088372,579.970764,139.313982,3,0
0,0,15,15,15,19,34,68,45,113,0.000333,0.191628,14,8048.366215,447.131456,574.883301,139.313982,3,0
0,0,18,18,14,20,34,67,67,134,0.000333,0.22724,21,14316.12044,795.340024,681.720021,139.741531,2,0
0,0,17,17,14,20,34,65,65,130,0.000333,0.220457,21,13888.77356,771.598531,661.370169,139.741531,2,0
0,0,18,18,15,21,36,67,71,138,0.000333,0.237817,21,14982.44265,832.357925,713.44965,150.842025,2,0
0,0,17,17,15,21,36,65,69,134,0.000333,0.230923,21,14548.16895,808.231609,692.76995,150.842025,2,0
0,0,21,21,15,21,36,81,81,162,0.000333,0.279176,21,17588.08486,977.115825,837.52785,150.842025,2,0
0,0,10,10,14,16,30,47,35,82,0.000333,0.134122,14,5633.110404,312.950578,402.365029,117.302969,2,0
0,0,10,10,13,16,29,39,33,72,0.000333,0.116592,12,4197.29558,233.183088,349.774632,112.105716,2,0
0,0,10,10,12,16,28,38,33,71,0.000333,0.113774,12,4095.866394,227.548133,341.322199,107.01955,2,0
0,0,5,5,11,15,26,20,22,42,0.000333,0.065806,5,987.092341,54.838463,197.418468,96.657107,2,0
0,0,15,15,18,20,38,69,48,117,0.000333,0.204669,18,11052.13534,614.007519,614.007519,161.497212,4,0
0,0,15,15,18,20,38,69,48,117,0.000333,0.204669,18,11052.13534,614.007519,614.007519,161.497212,4,0
0,0,12,12,12,14,26,32,31,63,0.000333,0.098709,12,3553.532427,197.418468,296.127702,96.322519,2,0
0,0,14,14,14,18,32,44,40,84,0.000333,0.14,14,5880,326.666667,420,128.361619,3,0
0,0,10,10,13,15,28,30,25,55,0.000333,0.088135,6,1586.427124,88.13484,264.404521,106.709075,3,0
0,0,14,14,14,18,32,44,40,84,0.000333,0.14,14,5880,326.666667,420,128.361619,3,0
0,0,10,10,13,15,28,30,25,55,0.000333,0.088135,6,1586.427124,88.13484,264.404521,106.709075,3,0
0,0,11,11,14,21,35,39,40,79,0.000333,0.135071,7,2836.493508,157.582973,405.213358,145.541635,2,0
0,0,8,8,12,18,30,32,34,66,0.000333,0.107952,6,1943.128676,107.951593,323.854779,118.0782,2,0
0,0,11,11,14,17,31,49,39,88,0.000333,0.145323,14,6103.569854,339.087214,435.969275,122.789837,2,0
0,0,11,11,14,15,29,49,33,82,0.000333,0.132785,14,5576.962182,309.831232,398.354442,111.906328,2,0
0,0,11,11,14,16,30,49,33,82,0.000333,0.134122,14,5633.110404,312.950578,402.365029,117.302969,2,0
0,0,5,5,14,17,31,25,25,50,0.000333,0.08257,7,1733.968709,96.331595,247.709816,122.789837,2,0
0,0,11,11,17,23,40,50,42,92,0.000333,0.163206,8,3916.939078,217.607727,489.617385,173.528793,3,0
0,0,5,5,14,18,32,25,26,51,0.000333,0.085,7,1785,99.166667,255,128.361619,2,0
0,0,13,13,15,16,31,54,36,90,0.000333,0.148626,14,6242.287351,346.793742,445.877668,122.603359,2,0
0,0,13,13,15,17,32,54,36,90,0.000333,0.15,14,6300,350,450,128.090227,2,0
0,0,17,17,15,25,40,68,79,147,0.000333,0.260774,21,16428.79203,912.710668,782.32343,174.699764,2,0
0,0,18,18,12,20,32,55,75,130,0.000333,0.216667,18,11700,650,650,129.458112,2,0
0,0,18,18,14,23,37,57,82,139,0.000333,0.241371,21,15206.39437,844.799687,724.114018,157.344894,2,0
0,0,13,13,13,20,33,46,68,114,0.000333,0.191687,18,10351.09673,575.06093,575.06093,134.544278,2,0
0,0,7,7,13,14,27,30,27,57,0.000333,0.090343,6,1626.171526,90.342863,271.028588,101.408685,3,0
0,0,7,7,12,16,28,28,26,54,0.000333,0.086532,6,1557.582995,86.532389,259.597166,107.01955,2,0
0,0,7,7,14,14,28,34,29,63,0.000333,0.100954,14,4240.087041,235.560391,302.86336,106.605938,4,0
0,0,7,7,14,16,30,32,28,60,0.000333,0.098138,7,2060.89405,114.494114,294.413436,117.302969,3,0
0,0,14,14,13,14,27,38,34,72,0.000333,0.114117,12,4108.222802,228.2346,342.3519,101.408685,3,0
0,0,15,15,15,20,35,61,47,108,0.000333,0.184654,14,7755.475922,430.859773,553.962566,145.041921,3,0
0,0,15,15,15,20,35,60,47,107,0.000333,0.182944,14,7683.665959,426.870331,548.833283,145.041921,3,0
0,0,15,15,15,20,35,61,47,108,0.000333,0.184654,14,7755.475922,430.859773,553.962566,145.041921,3,0
0,0,15,15,15,20,35,60,47,107,0.000333,0.182944,14,7683.665959,426.870331,548.833283,145.041921,3,0
0,0,17,17,16,20,36,64,49,113,0.000333,0.194734,16,9347.224403,519.290245,584.201525,150.438562,3,0
0,0,17,17,16,20,36,64,49,113,0.000333,0.194734,16,9347.224403,519.290245,584.201525,150.438562,3,0
0,0,16,16,19,23,42,79,57,136,0.000333,0.244452,18,13200.39305,733.355169,733.355169,184.752548,3,0
0,0,3,3,5,6,11,6,7,13,0.000333,0.014991,2,89.945222,4.996957,44.972611,27.119415,1,0
0,0,11,11,14,19,33,49,39,88,0.000333,0.147969,14,6214.693555,345.260753,443.906683,134.013592,2,0
0,0,15,15,15,20,35,57,46,103,0.000333,0.176105,14,7396.42611,410.912562,528.316151,145.041921,3,0
0,0,15,15,15,20,35,56,46,102,0.000333,0.174396,14,7324.616148,406.923119,523.186868,145.041921,3,0
0,0,33,33,19,36,55,123,107,230,0.000333,0.443238,18,23934.82921,1329.712734,1329.712734,266.827923,8,0
0,0,22,22,19,27,46,74,83,157,0.000333,0.289066,27,23414.37913,1300.798841,867.199227,209.092585,5,0
0,0,8,8,13,12,25,26,19,45,0.000333,0.069658,6,1253.841171,69.657843,208.973529,91.125266,3,0
0,0,15,15,15,18,33,60,40,100,0.000333,0.168146,14,7062.151767,392.341765,504.439412,133.662009,3,0
0,0,10,10,14,15,29,38,28,66,0.000333,0.106876,7,2244.38722,124.688179,320.626746,111.906328,2,0
0,0,15,15,15,18,33,60,40,100,0.000333,0.168146,14,7062.151767,392.341765,504.439412,133.662009,3,0
0,0,10,10,14,15,29,38,28,66,0.000333,0.106876,7,2244.38722,124.688179,320.626746,111.906328,2,0
0,0,8,8,13,12,25,26,19,45,0.000333,0.069658,6,1253.841171,69.657843,208.973529,91.125266,3,0
0,0,8,8,13,12,25,26,19,45,0.000333,0.069658,6,1253.841171,69.657843,208.973529,91.125266,3,0
0,0,10,10,14,19,33,34,35,69,0.000333,0.116021,7,2436.44236,135.357909,348.063194,134.013592,2,0
0,0,5,5,6,11,17,10,15,25,0.000333,0.034062,3,306.559713,17.031095,102.186571,53.563523,1,0
0,0,15,15,14,21,35,47,51,98,0.000333,0.167557,14,7037.376299,390.96535,502.669736,145.541635,2,0
0,0,11,11,13,18,31,33,36,69,0.000333,0.113947,12,4102.074545,227.89303,341.839545,123.164366,2,0
0,0,11,11,17,21,38,46,43,89,0.000333,0.155689,16,7473.048779,415.169377,467.065549,161.725534,3,0
0,0,11,11,14,16,30,49,33,82,0.000333,0.134122,14,5633.110404,312.950578,402.365029,117.302969,2,0
0,0,11,11,14,16,30,49,33,82,0.000333,0.134122,14,5633.110404,312.950578,402.365029,117.302969,2,0
0,0,14,14,16,19,35,53,49,102,0.000333,0.174396,16,8370.989884,465.054994,523.186868,144.710623,3,0
0,0,14,14,16,21,37,51,48,99,0.000333,0.171912,16,8251.774131,458.431896,515.735883,156.238666,2,0
0,0,13,13,18,18,36,55,49,104,0.000333,0.179224,18,9678.099603,537.6722,537.6722,150.1173,4,0
0,0,13,13,18,20,38,53,48,101,0.000333,0.17668,18,9540.732219,530.040679,530.040679,161.497212,3,0
0,0,8,8,13,16,29,31,29,60,0.000333,0.09716,6,1748.873158,97.15962,291.47886,112.105716,3,0
0,0,8,8,13,18,31,29,28,57,0.000333,0.09413,6,1694.335138,94.12973,282.38919,123.164366,2,0
0,0,8,8,15,16,31,35,31,66,0.000333,0.108992,7,2288.838695,127.157705,326.976956,122.603359,4,0
0,0,8,8,15,18,33,33,30,63,0.000333,0.105932,7,2224.577807,123.587656,317.79683,133.662009,3,0
0,0,12,12,14,17,31,40,42,82,0.000333,0.135415,14,5687.417364,315.967631,406.244097,122.789837,3,0
0,0,12,12,14,19,33,38,41,79,0.000333,0.132836,14,5579.099896,309.949994,398.507135,134.013592,2,0
0,0,11,11,16,16,32,42,42,84,0.000333,0.14,16,6720,373.333333,420,128,4,0
0,0,11,11,16,18,34,40,41,81,0.000333,0.137361,16,6593.351842,366.297325,412.08449,139.05865,3,0
0,0,16,16,14,19,33,50,70,120,0.000333,0.201776,21,12711.87318,706.215177,605.327294,134.013592,3,0
0,0,16,16,14,21,35,48,69,117,0.000333,0.200042,21,12602.64837,700.147132,600.126113,145.541635,2,0
0,0,15,15,16,18,34,52,70,122,0.000333,0.20689,24,14896.0912,827.560622,620.670467,139.05865,4,0
0,0,15,15,16,20,36,50,69,119,0.000333,0.205074,24,14765.3058,820.294767,615.221075,150.438562,3,0
0,0,7,7,13,11,24,31,24,55,0.000333,0.084058,12,3026.07525,168.115292,252.172938,86.159464,3,0
0,0,7,7,13,13,26,29,23,52,0.000333,0.081474,6,1466.537192,81.474288,244.422865,96.211433,2,0
0,0,12,12,17,16,33,45,44,89,0.000333,0.14965,16,7183.217226,399.067624,448.951077,133.486868,4,0
0,0,12,12,17,18,35,43,43,86,0.000333,0.147039,16,7057.893431,392.105191,441.118339,144.545518,3,0
0,0,4,4,9,14,23,16,21,37,0.000333,0.055791,4,669.487169,37.193732,167.371792,81.832294,1,0
0,0,12,12,13,21,34,51,54,105,0.000333,0.178061,12,6410.20318,356.122399,534.183598,140.344382,1,0
0,0,8,8,10,15,25,35,30,65,0.000333,0.100617,10,3018.506523,167.694807,301.850652,91.82264,1,0
0,0,8,8,11,18,29,36,29,65,0.000333,0.105256,5,1578.843823,87.713546,315.768765,113.112398,1,0
0,0,12,12,12,21,33,59,49,108,0.000333,0.181598,12,6537.534779,363.196377,544.794565,135.258216,1,0
0,0,16,16,15,26,41,74,58,132,0.000333,0.235732,14,9900.756105,550.042006,707.196865,180.814792,2,0
0,0,3,3,9,11,20,16,13,29,0.000333,0.041779,4,501.343659,27.852426,125.335915,66.583073,1,0
0,0,3,3,9,11,20,16,13,29,0.000333,0.041779,4,501.343659,27.852426,125.335915,66.583073,1,0
0,0,3,3,8,10,18,13,13,26,0.000333,0.036139,4,433.6722,24.0929,108.41805,57.219281,1,0
0,0,5,5,11,15,26,20,22,42,0.000333,0.065806,5,987.092341,54.838463,197.418468,96.657107,2,0
0,0,14,14,18,20,38,66,47,113,0.000333,0.197672,18,10674.28456,593.015809,593.015809,161.497212,3,0
0,0,5,5,12,13,25,21,20,41,0.000333,0.063466,6,1142.388623,63.466035,190.398104,91.125266,2,0
0,0,16,16,16,19,35,71,56,127,0.000333,0.21714,16,10422.70309,579.039061,651.418943,144.710623,3,0
0,0,16,16,16,19,35,71,56,127,0.000333,0.21714,16,10422.70309,579.039061,651.418943,144.710623,3,0
0,0,16,16,16,23,39,70,65,135,0.000333,0.237843,16,11416.46879,634.248266,713.5293,168.041925,3,0
0,0,16,16,16,23,39,70,65,135,0.000333,0.237843,16,11416.46879,634.248266,713.5293,168.041925,3,0
0,0,8,8,15,18,33,30,30,60,0.000333,0.100888,7,2118.64553,117.702529,302.663647,133.662009,2,0
0,0,13,13,16,23,39,47,49,96,0.000333,0.169133,16,8118.377808,451.020989,507.398613,168.041925,3,0
0,0,11,11,13,19,32,40,36,76,0.000333,0.126667,6,2280,126.666667,380,128.816339,2,0
0,0,10,10,13,17,30,37,30,67,0.000333,0.109587,6,1972.570019,109.587223,328.76167,117.592585,2,0
0,0,11,11,16,17,33,44,40,84,0.000333,0.141243,16,6779.665696,376.648094,423.729106,133.486868,2,0
0,0,10,10,14,17,31,38,35,73,0.000333,0.120552,14,5063.188629,281.288257,361.656331,122.789837,2,0
0,0,13,13,15,18,33,49,40,89,0.000333,0.14965,14,6285.315073,349.184171,448.951077,133.662009,2,0
0,0,11,11,13,18,31,41,33,74,0.000333,0.122204,6,2199.663162,122.203509,366.610527,123.164366,2,0
0,0,11,11,13,18,31,41,33,74,0.000333,0.122204,6,2199.663162,122.203509,366.610527,123.164366,2,0
0,0,10,10,14,15,29,38,34,72,0.000333,0.116592,14,4896.844843,272.046936,349.774632,111.906328,2,0
0,0,9,9,12,15,27,32,29,61,0.000333,0.096683,6,1740.288826,96.682713,290.048138,101.622909,2,0
0,0,10,10,14,15,29,38,34,72,0.000333,0.116592,14,4896.844843,272.046936,349.774632,111.906328,2,0
0,0,9,9,12,15,27,32,29,61,0.000333,0.096683,6,1740.288826,96.682713,290.048138,101.622909,2,0
0,0,14,14,20,19,39,62,47,109,0.000333,0.192036,20,11522.17684,640.120935,576.108842,167.149185,3,0
0,0,9,9,16,17,33,40,29,69,0.000333,0.116021,8,2784.505554,154.694753,348.063194,133.486868,2,0
0,0,14,14,20,19,39,62,47,109,0.000333,0.192036,20,11522.17684,640.120935,576.108842,167.149185,3,0
0,0,9,9,16,17,33,40,29,69,0.000333,0.116021,8,2784.505554,154.694753,348.063194,133.486868,2,0
0,0,10,10,15,16,31,39,35,74,0.000333,0.122204,14,5132.547378,285.141521,366.610527,122.603359,2,0
0,0,9,9,13,16,29,33,30,63,0.000333,0.102018,6,1836.316816,102.017601,306.052803,112.105716,2,0
0,0,10,10,14,16,30,38,35,73,0.000333,0.119401,14,5014.842189,278.602344,358.203013,117.302969,2,0
0,0,9,9,12,16,28,32,30,62,0.000333,0.099352,6,1788.336031,99.352002,298.056005,107.01955,2,0
0,0,12,12,13,19,32,39,47,86,0.000333,0.143333,12,5160,286.666667,430,128.816339,1,0
0,0,14,14,17,17,34,61,44,105,0.000333,0.178061,16,8546.937573,474.829865,534.183598,138.973737,2,0
0,0,14,14,16,17,33,58,44,102,0.000333,0.171509,16,8232.451203,457.3584,514.5282,133.486868,2,0
0,0,10,10,15,17,32,49,36,85,0.000333,0.141667,14,5950,330.555556,425,128.090227,2,0
0,0,12,12,16,17,33,55,39,94,0.000333,0.158058,16,7586.768756,421.487153,474.173047,133.486868,2,0
0,0,16,16,15,17,32,67,47,114,0.000333,0.19,14,7980,443.333333,570,128.090227,3,0
0,0,13,13,15,17,32,53,37,90,0.000333,0.15,14,6300,350,450,128.090227,3,0
0,0,11,11,15,15,30,47,33,80,0.000333,0.13085,14,5495.717467,305.317637,392.551248,117.206718,2,0
0,0,16,16,15,17,32,66,47,113,0.000333,0.188333,14,7910,439.444444,565,128.090227,3,0
0,0,13,13,15,17,32,52,37,89,0.000333,0.148333,14,6230,346.111111,445,128.090227,3,0
0,0,11,11,15,15,30,47,33,80,0.000333,0.13085,14,5495.717467,305.317637,392.551248,117.206718,2,0
0,0,15,15,14,17,31,57,42,99,0.000333,0.163488,14,6866.516086,381.473116,490.465435,122.789837,3,0
0,0,9,9,14,14,28,35,26,61,0.000333,0.09775,7,2052.740552,114.041142,293.24865,106.605938,2,0
0,0,12,12,14,17,31,43,32,75,0.000333,0.123855,7,2600.953063,144.497392,371.564723,122.789837,3,0
0,0,10,10,14,15,29,37,28,65,0.000333,0.105256,7,2210.381353,122.798964,315.768765,111.906328,2,0
0,0,15,15,14,17,31,56,42,98,0.000333,0.161837,14,6797.157338,377.619852,485.511238,122.789837,3,0
0,0,9,9,14,14,28,35,26,61,0.000333,0.09775,7,2052.740552,114.041142,293.24865,106.605938,2,0
0,0,12,12,14,17,31,42,32,74,0.000333,0.122204,7,2566.273689,142.57076,366.610527,122.789837,3,0
0,0,10,10,14,15,29,37,28,65,0.000333,0.105256,7,2210.381353,122.798964,315.768765,111.906328,2,0
0,0,15,15,14,16,30,57,42,99,0.000333,0.161927,14,6800.950366,377.830576,485.782169,117.302969,3,0
0,0,12,12,14,16,30,43,32,75,0.000333,0.122672,14,5152.235125,286.235285,368.016795,117.302969,3,0
0,0,15,15,14,16,30,56,42,98,0.000333,0.160292,14,6732.253897,374.014105,480.875278,117.302969,3,0
0,0,12,12,14,16,30,42,32,74,0.000333,0.121037,14,5083.538657,282.418814,363.109904,117.302969,3,0
0,0,13,13,18,18,36,56,40,96,0.000333,0.165438,18,8933.630402,496.3128,496.3128,150.1173,3,0
0,0,13,13,17,18,35,55,40,95,0.000333,0.162427,16,7796.510186,433.139455,487.281887,144.545518,3,0
0,0,8,8,14,16,30,31,26,57,0.000333,0.093231,7,1957.849348,108.769408,279.692764,117.302969,2,0
0,0,13,13,12,25,37,47,52,99,0.000333,0.171912,12,6188.830598,343.823922,515.735883,159.115955,3,0
0,0,14,14,12,25,37,48,54,102,0.000333,0.177121,12,6376.37092,354.242829,531.364243,159.115955,3,0
0,0,13,13,15,28,43,52,54,106,0.000333,0.191728,7,4026.288448,223.682692,575.184064,193.209297,4,0
0,0,14,14,15,28,43,53,56,109,0.000333,0.197154,14,8280.480016,460.026668,591.462858,193.209297,4,0
0,0,15,15,16,20,36,47,57,104,0.000333,0.179224,16,8602.755202,477.930845,537.6722,150.438562,3,0
0,0,15,15,15,22,37,45,56,101,0.000333,0.175385,14,7366.167059,409.231503,526.15479,156.710855,2,0
0,0,17,17,19,26,45,65,68,133,0.000333,0.243472,18,13147.49631,730.416462,730.416462,202.922055,5,0
0,0,17,17,18,28,46,63,67,130,0.000333,0.239354,18,12925.13498,718.063054,718.063054,209.664588,4,0
0,0,5,5,9,14,23,19,18,37,0.000333,0.055791,4,669.487169,37.193732,167.371792,81.832294,2,0
0,0,6,6,9,15,24,20,20,40,0.000333,0.061133,4,733.594,40.755222,183.3985,87.132684,2,0
0,0,7,7,13,14,27,30,27,57,0.000333,0.090343,6,1626.171526,90.342863,271.028588,101.408685,3,0
0,0,7,7,12,16,28,28,26,54,0.000333,0.086532,6,1557.582995,86.532389,259.597166,107.01955,2,0
0,0,7,7,14,14,28,34,29,63,0.000333,0.100954,14,4240.087041,235.560391,302.86336,106.605938,4,0
0,0,7,7,14,16,30,32,28,60,0.000333,0.098138,7,2060.89405,114.494114,294.413436,117.302969,3,0
0,0,15,15,16,21,37,83,48,131,0.000333,0.227479,16,10919.01425,606.611903,682.438391,156.238666,3,0
0,0,15,15,22,25,47,63,61,124,0.000333,0.22959,22,15152.91839,841.828799,688.769018,214.2039,5,0
0,0,15,15,21,27,48,61,60,121,0.000333,0.22526,20,13515.60925,750.867181,675.780463,220.620628,4,0
0,0,13,13,19,19,38,45,50,95,0.000333,0.166184,18,8973.956048,498.553114,498.553114,161.421246,3,0
0,0,13,13,18,21,39,43,49,92,0.000333,0.162086,18,8752.626074,486.257004,486.257004,167.297316,2,0
0,0,11,11,13,24,37,43,38,81,0.000333,0.140655,6,2531.794336,140.655241,421.965723,158.144816,3,0
0,0,12,12,13,24,37,44,40,84,0.000333,0.145865,6,2625.564496,145.864694,437.594083,158.144816,3,0
0,0,11,11,16,26,42,48,42,90,0.000333,0.16177,8,3882.468544,215.692697,485.308568,186.211433,4,0
0,0,12,12,16,26,42,49,44,93,0.000333,0.167162,8,4011.884163,222.882453,501.48552,186.211433,4,0
0,0,11,11,13,16,29,43,30,73,0.000333,0.118211,6,2127.795676,118.210871,354.632613,112.105716,2,0
0,0,11,11,13,15,28,43,30,73,0.000333,0.116979,12,4211.242912,233.95794,350.936909,106.709075,2,0
0,0,12,12,14,18,32,60,37,97,0.000333,0.161667,14,6790,377.222222,485,128.361619,2,0
0,0,11,11,14,17,31,57,39,96,0.000333,0.158534,14,6658.439841,369.913325,475.602846,122.789837,2,0
0,0,9,9,11,14,25,48,32,80,0.000333,0.123836,10,3715.084952,206.393608,371.508495,91.356717,1,0
0,0,11,11,16,17,33,41,33,74,0.000333,0.124428,8,2986.281319,165.904518,373.285165,133.486868,3,0
0,0,11,11,12,16,28,32,35,67,0.000333,0.107364,12,3865.113357,214.72852,322.09278,107.01955,2,0
0,0,11,11,13,18,31,33,36,69,0.000333,0.113947,12,4102.074545,227.89303,341.839545,123.164366,2,0
0,0,15,15,12,18,30,44,55,99,0.000333,0.161927,18,8744.079041,485.782169,485.782169,118.0782,2,0
0,0,15,15,13,20,33,45,60,105,0.000333,0.176554,18,9533.904886,529.661383,529.661383,134.544278,2,0
0,0,14,14,21,20,41,63,48,111,0.000333,0.198229,20,11893.76545,660.764747,594.688273,178.677228,3,0
0,0,9,9,17,18,35,41,30,71,0.000333,0.121393,8,2913.432754,161.857375,364.179094,144.545518,2,0
0,0,14,14,20,20,40,62,48,110,0.000333,0.195137,20,11708.24181,650.457878,585.41209,172.877124,3,0
0,0,9,9,16,18,34,40,30,70,0.000333,0.118707,8,2848.979191,158.276622,356.122399,139.05865,2,0
0,0,14,14,20,19,39,62,47,109,0.000333,0.192036,20,11522.17684,640.120935,576.108842,167.149185,3,0
0,0,9,9,16,17,33,40,29,69,0.000333,0.116021,8,2784.505554,154.694753,348.063194,133.486868,2,0
0,0,14,14,20,19,39,62,47,109,0.000333,0.192036,20,11522.17684,640.120935,576.108842,167.149185,3,0
0,0,9,9,16,17,33,40,29,69,0.000333,0.116021,8,2784.505554,154.694753,348.063194,133.486868,2,0
0,0,16,16,21,25,46,70,68,138,0.000333,0.254084,20,15245.031,846.946167,762.25155,208.335071,2,0
0,0,10,10,15,22,37,44,38,82,0.000333,0.142392,7,2990.226232,166.12368,427.175176,156.710855,1,0
0,0,10,10,16,22,38,45,40,85,0.000333,0.148691,8,3568.590709,198.255039,446.073839,162.107496,1,0
0,0,10,10,16,19,35,43,38,81,0.000333,0.138491,16,6647.55079,369.308377,415.471924,144.710623,2,0
0,0,7,7,12,10,22,24,18,42,0.000333,0.062432,6,1123.776768,62.432043,187.296128,76.238831,3,0
0,0,7,7,12,9,21,24,18,42,0.000333,0.061492,12,2213.727981,122.984888,184.477332,71.548875,3,0
0,0,8,8,12,11,23,25,19,44,0.000333,0.066346,6,1194.220356,66.345575,199.036726,81.073298,3,0
0,0,14,14,14,18,32,51,38,89,0.000333,0.148333,14,6230,346.111111,445,128.361619,3,0
0,0,9,9,14,14,28,36,27,63,0.000333,0.100954,7,2120.043521,117.780196,302.86336,106.605938,2,0
0,0,11,11,13,16,29,37,28,65,0.000333,0.105256,6,1894.612588,105.256255,315.768765,112.105716,3,0
0,0,14,14,14,18,32,50,38,88,0.000333,0.146667,14,6160,342.222222,440,128.361619,3,0
0,0,9,9,14,14,28,36,27,63,0.000333,0.100954,7,2120.043521,117.780196,302.86336,106.605938,2,0
0,0,11,11,13,16,29,36,28,64,0.000333,0.103637,6,1865.464702,103.636928,310.910784,112.105716,3,0
0,0,14,14,14,17,31,50,37,87,0.000333,0.143672,14,6034.211106,335.23395,431.015079,122.789837,3,0
0,0,9,9,14,14,28,36,27,63,0.000333,0.100954,7,2120.043521,117.780196,302.86336,106.605938,2,0
0,0,11,11,13,15,28,36,27,63,0.000333,0.100954,6,1817.180161,100.954453,302.86336,106.709075,3,0
0,0,14,14,14,17,31,50,37,87,0.000333,0.143672,14,6034.211106,335.23395,431.015079,122.789837,3,0
0,0,9,9,14,14,28,36,27,63,0.000333,0.100954,7,2120.043521,117.780196,302.86336,106.605938,2,0
0,0,11,11,13,15,28,36,27,63,0.000333,0.100954,6,1817.180161,100.954453,302.86336,106.709075,3,0
0,0,17,17,18,23,41,67,62,129,0.000333,0.230375,18,12440.23576,691.124209,691.124209,179.100575,2,0
0,0,13,13,16,21,37,49,40,89,0.000333,0.154547,8,3709.130796,206.062822,463.64135,156.238666,2,0
0,0,13,13,17,21,38,50,42,92,0.000333,0.160936,16,7724.9493,429.16385,482.809331,161.725534,2,0
0,0,13,13,14,16,30,47,36,83,0.000333,0.135757,14,5701.806872,316.767048,407.271919,117.302969,2,0
0,0,9,9,14,14,28,36,27,63,0.000333,0.100954,7,2120.043521,117.780196,302.86336,106.605938,2,0
0,0,10,10,13,14,27,33,26,59,0.000333,0.093513,6,1683.230176,93.512788,280.538363,101.408685,2,0
0,0,14,14,14,18,32,51,38,89,0.000333,0.148333,14,6230,346.111111,445,128.361619,3,0
0,0,9,9,14,14,28,36,27,63,0.000333,0.100954,7,2120.043521,117.780196,302.86336,106.605938,2,0
0,0,11,11,13,16,29,37,28,65,0.000333,0.105256,6,1894.612588,105.256255,315.768765,112.105716,3,0
0,0,14,14,14,18,32,50,38,88,0.000333,0.146667,14,6160,342.222222,440,128.361619,3,0
0,0,9,9,14,14,28,36,27,63,0.000333,0.100954,7,2120.043521,117.780196,302.86336,106.605938,2,0
0,0,11,11,13,16,29,36,28,64,0.000333,0.103637,6,1865.464702,103.636928,310.910784,112.105716,3,0
0,0,14,14,13,14,27,38,34,72,0.000333,0.114117,12,4108.222802,228.2346,342.3519,101.408685,3,0
0,0,14,14,13,20,33,53,47,100,0.000333,0.168146,12,6053.272943,336.292941,504.439412,134.544278,2,0
0,0,14,14,14,21,35,54,47,101,0.000333,0.172686,14,7252.806186,402.933677,518.057585,145.541635,2,0
0,0,17,17,15,23,38,68,57,125,0.000333,0.218664,14,9183.873149,510.215175,655.990939,162.645284,2,0
0,0,9,9,13,18,31,38,32,70,0.000333,0.115598,6,2080.76245,115.597914,346.793742,123.164366,2,0
0,0,7,7,16,13,29,34,31,65,0.000333,0.105256,16,5052.300235,280.683346,315.768765,112.105716,4,0
0,0,7,7,16,16,32,32,30,62,0.000333,0.103333,8,2480,137.777778,310,128,3,0
0,0,7,7,14,13,27,30,29,59,0.000333,0.093513,14,3927.537077,218.196504,280.538363,101.408685,3,0
0,0,7,7,14,16,30,28,28,56,0.000333,0.091595,7,1923.501113,106.861173,274.785873,117.302969,2,0
0,0,8,8,13,18,31,34,30,64,0.000333,0.10569,6,1902.411383,105.689521,317.068564,123.164366,1,0
0,0,13,13,17,17,34,55,39,94,0.000333,0.159407,16,7651.544113,425.085784,478.221507,138.973737,3,0
0,0,13,13,17,17,34,55,39,94,0.000333,0.159407,16,7651.544113,425.085784,478.221507,138.973737,3,0
0,0,17,17,17,21,38,64,59,123,0.000333,0.215165,16,10327.92135,573.773408,645.495084,161.725534,2,0
0,0,13,13,15,20,35,47,40,87,0.000333,0.148749,14,6247.466715,347.081484,446.247622,145.041921,2,0
0,0,12,12,15,20,35,45,38,83,0.000333,0.14191,7,2980.113433,165.561857,425.73049,145.041921,2,0
0,0,13,13,16,20,36,47,41,88,0.000333,0.151651,16,7279.254402,404.403022,454.9534,150.438562,2,0
0,0,12,12,16,20,36,45,39,84,0.000333,0.144758,8,3474.189601,193.010533,434.2737,150.438562,2,0
0,0,7,7,9,12,21,20,24,44,0.000333,0.064421,8,1546.095733,85.894207,193.261967,71.548875,1,0
0,0,7,7,10,15,25,21,23,44,0.000333,0.06811,5,1021.648362,56.758242,204.329672,91.82264,1,0
0,0,5,5,9,15,24,19,24,43,0.000333,0.065718,4,788.61355,43.811864,197.153388,87.132684,1,0
0,0,4,4,11,14,25,21,20,41,0.000333,0.063466,5,951.990519,52.888362,190.398104,91.356717,1,0
0,0,14,14,14,19,33,50,67,117,0.000333,0.196731,21,12394.07635,688.559797,590.194112,134.013592,1,0
0,0,18,18,17,22,39,65,68,133,0.000333,0.234319,24,16871.00388,937.277993,702.958495,167.594364,2,0
0,0,18,18,18,23,41,66,77,143,0.000333,0.255377,27,20685.50829,1149.194905,766.129937,179.100575,2,0
0,0,5,5,10,15,25,23,25,48,0.000333,0.074302,5,1114.525486,61.918083,222.905097,91.82264,1,0
0,0,12,12,16,18,34,62,39,101,0.000333,0.171278,16,8221.339951,456.741108,513.833747,139.05865,3,0
0,0,12,12,15,19,34,62,39,101,0.000333,0.171278,14,7193.672458,399.64847,513.833747,139.313982,3,0
0,0,12,12,15,19,34,62,39,101,0.000333,0.171278,14,7193.672458,399.64847,513.833747,139.313982,3,0
0,0,13,13,18,20,38,68,45,113,0.000333,0.197672,18,10674.28456,593.015809,593.015809,161.497212,3,0
0,0,19,19,19,19,38,82,56,138,0.000333,0.241405,18,13035.85194,724.213997,724.213997,161.421246,3,0
0,0,11,11,14,15,29,45,32,77,0.000333,0.124688,14,5236.903513,290.939084,374.064537,111.906328,2,0
0,0,17,17,18,18,36,73,50,123,0.000333,0.211967,18,11446.21395,635.900775,635.900775,150.1173,3,0
0,0,11,11,14,15,29,45,32,77,0.000333,0.124688,14,5236.903513,290.939084,374.064537,111.906328,2,0
0,0,3,3,9,7,16,12,9,21,0.000333,0.028,4,336,18.666667,84,48.180809,1,0
0,0,8,8,11,15,26,31,28,59,0.000333,0.092442,5,1386.629717,77.034984,277.325943,96.657107,2,0
0,0,15,15,15,23,38,58,62,120,0.000333,0.209917,14,8816.518223,489.806568,629.751302,162.645284,2,0
0,0,15,15,16,19,35,60,46,106,0.000333,0.181235,16,8699.263997,483.292444,543.704,144.710623,3,0
0,0,15,15,16,19,35,60,46,106,0.000333,0.181235,16,8699.263997,483.292444,543.704,144.710623,3,0
0,0,15,15,16,18,34,60,46,106,0.000333,0.179757,16,8628.336979,479.352054,539.271061,139.05865,3,0
0,0,14,14,15,18,33,57,45,102,0.000333,0.171509,14,7203.394802,400.1886,514.5282,133.662009,2,0
0,0,18,18,18,19,37,81,55,136,0.000333,0.236162,18,12752.74184,708.485658,708.485658,155.769273,4,0
0,0,10,10,14,14,28,42,30,72,0.000333,0.115377,14,4845.813761,269.211876,346.129554,106.605938,2,0
0,0,18,18,18,19,37,81,55,136,0.000333,0.236162,18,12752.74184,708.485658,708.485658,155.769273,4,0
0,0,10,10,14,14,28,42,30,72,0.000333,0.115377,14,4845.813761,269.211876,346.129554,106.605938,2,0
0,0,12,12,16,18,34,58,40,98,0.000333,0.16619,16,7977.141735,443.174541,498.571358,139.05865,3,0
0,0,12,12,15,18,33,57,40,97,0.000333,0.163102,14,6850.287214,380.571512,489.30623,133.662009,3,0
0,0,12,12,16,13,29,42,34,76,0.000333,0.123069,16,5907.30489,328.183605,369.206556,112.105716,3,0
0,0,12,12,16,15,31,40,33,73,0.000333,0.120552,16,5786.501291,321.472294,361.656331,122.603359,2,0
0,0,28,28,25,44,69,132,95,227,0.000333,0.462212,24,33279.24124,1848.846736,1386.635052,356.311396,10,0
0,0,28,28,24,46,70,130,94,224,0.000333,0.457653,24,32951.0255,1830.612528,1372.959396,364.12295,9,0
0,0,25,25,22,46,68,117,84,201,0.000333,0.40786,11,13459.38034,747.743352,1223.580031,352.191346,9,0
0,0,24,24,22,46,68,116,82,198,0.000333,0.401773,11,13258.49407,736.583004,1205.317643,352.191346,9,0
0,0,12,12,14,13,27,41,36,77,0.000333,0.122042,14,5125.768727,284.764929,366.126338,101.408685,3,0
0,0,12,12,14,15,29,39,35,74,0.000333,0.11983,14,5032.868311,279.603795,359.490594,111.906328,2,0
0,0,9,9,14,15,29,34,27,61,0.000333,0.098779,7,2074.357885,115.242105,296.336841,111.906328,2,0
0,0,4,4,10,12,22,18,21,39,0.000333,0.057973,5,869.589166,48.310509,173.917833,76.238831,1,0
0,0,9,9,14,15,29,34,27,61,0.000333,0.098779,7,2074.357885,115.242105,296.336841,111.906328,2,0
0,0,19,19,19,26,45,71,63,134,0.000333,0.245303,18,13246.34967,735.908315,735.908315,202.922055,3,0
0,0,10,10,14,14,28,38,29,67,0.000333,0.107364,14,4509.298917,250.516606,322.09278,106.605938,2,0
0,0,9,9,12,14,26,32,25,57,0.000333,0.089308,6,1607.550384,89.308355,267.925064,96.322519,2,0
0,0,10,10,15,15,30,39,30,69,0.000333,0.112858,14,4740.056315,263.336462,338.575451,117.206718,2,0
0,0,9,9,13,15,28,33,26,59,0.000333,0.094545,6,1701.803642,94.544647,283.63394,106.709075,2,0
0,0,10,10,14,15,29,38,30,68,0.000333,0.110114,14,4624.797907,256.933217,330.342708,111.906328,2,0
0,0,9,9,12,15,27,32,26,58,0.000333,0.091928,6,1654.700851,91.927825,275.783475,101.622909,2,0
0,0,10,10,14,16,30,45,28,73,0.000333,0.119401,7,2507.421094,139.301172,358.203013,117.302969,2,0
0,0,13,13,13,19,32,52,53,105,0.000333,0.175,12,6300,350,525,128.816339,2,0
0,0,15,15,16,22,38,61,54,115,0.000333,0.201171,16,9656.186625,536.454812,603.511664,162.107496,2,0
0,0,13,13,13,19,32,52,53,105,0.000333,0.175,12,6300,350,525,128.816339,2,0
0,0,15,15,16,22,38,61,54,115,0.000333,0.201171,16,9656.186625,536.454812,603.511664,162.107496,2,0
0,0,10,10,12,13,25,42,30,72,0.000333,0.111453,12,4012.291748,222.905097,334.357646,91.125266,2,0
0,0,12,12,15,17,32,51,36,87,0.000333,0.145,14,6090,338.333333,435,128.090227,2,0
0,0,5,5,5,12,17,9,21,30,0.000333,0.040875,2,245.24777,13.624876,122.623885,54.62919,1,0
0,0,5,5,6,14,20,10,19,29,0.000333,0.041779,3,376.007744,20.889319,125.335915,68.812744,1,0
0,0,7,7,12,19,31,30,37,67,0.000333,0.110644,6,1991.586917,110.643718,331.931153,123.730173,1,0
0,0,5,5,7,10,17,10,14,24,0.000333,0.0327,3,294.297325,16.349851,98.099108,52.870765,1,0
0,0,9,9,14,15,29,42,30,72,0.000333,0.116592,14,4896.844843,272.046936,349.774632,111.906328,2,0
0,0,10,10,11,12,23,25,24,49,0.000333,0.073885,10,2216.545358,123.141409,221.654536,81.073298,2,0
0,0,10,10,12,15,27,51,33,84,0.000333,0.133137,12,4792.926602,266.2737,399.41055,101.622909,2,0
0,0,10,10,12,15,27,51,33,84,0.000333,0.133137,12,4792.926602,266.2737,399.41055,101.622909,2,0
0,0,12,12,15,18,33,49,38,87,0.000333,0.146287,14,6144.072037,341.337335,438.862288,133.662009,3,0
0,0,10,10,15,17,32,41,30,71,0.000333,0.118333,7,2485,138.055556,355,128.090227,3,0
0,0,12,12,15,18,33,49,38,87,0.000333,0.146287,14,6144.072037,341.337335,438.862288,133.662009,3,0
0,0,10,10,15,16,31,41,30,71,0.000333,0.117249,7,2462.235566,136.790865,351.747938,122.603359,3,0
0,0,10,10,12,14,26,51,33,84,0.000333,0.131612,12,4738.043236,263.224624,394.836936,96.322519,2,0
0,0,10,10,16,16,32,39,32,71,0.000333,0.118333,16,5680,315.555556,355,128,2,0
0,0,15,15,13,21,34,60,53,113,0.000333,0.191628,12,6898.599613,383.255534,574.883301,140.344382,2,0
0,0,9,9,9,15,24,29,30,59,0.000333,0.090171,8,2164.1023,120.227906,270.512788,87.132684,1,0
0,0,15,15,14,24,38,61,53,114,0.000333,0.199421,14,8375.692311,465.31624,598.263737,163.342069,2,0
0,0,9,9,10,18,28,30,29,59,0.000333,0.094545,5,1418.169702,78.787206,283.63394,108.277931,1,0
0,0,13,13,11,21,32,53,49,102,0.000333,0.17,10,5100,283.333333,510,130.292414,1,0
0,0,16,16,14,25,39,65,56,121,0.000333,0.213178,14,8953.471359,497.415075,639.533668,169.399374,2,0
0,0,5,5,11,15,26,20,22,42,0.000333,0.065806,5,987.092341,54.838463,197.418468,96.657107,2,0
0,0,15,15,17,21,38,59,46,105,0.000333,0.183677,16,8816.518223,489.806568,551.032389,161.725534,4,0
0,0,11,11,14,17,31,39,29,68,0.000333,0.112295,7,2358.197444,131.010969,336.885349,122.789837,3,0
0,0,15,15,17,21,38,58,46,104,0.000333,0.181928,16,8732.551382,485.141743,545.784461,161.725534,4,0
0,0,11,11,14,17,31,38,29,67,0.000333,0.110644,7,2323.51807,129.084337,331.931153,122.789837,3,0
0,0,5,5,11,15,26,20,22,42,0.000333,0.065806,5,987.092341,54.838463,197.418468,96.657107,2,0
0,0,15,15,17,20,37,58,45,103,0.000333,0.178858,16,8585.179147,476.954397,536.573697,155.92543,4,0
0,0,11,11,14,16,30,38,28,66,0.000333,0.107952,7,2266.983455,125.943525,323.854779,117.302969,3,0
0,0,15,15,17,20,37,58,45,103,0.000333,0.178858,16,8585.179147,476.954397,536.573697,155.92543,4,0
0,0,11,11,14,16,30,38,28,66,0.000333,0.107952,7,2266.983455,125.943525,323.854779,117.302969,3,0
0,0,5,5,11,15,26,20,22,42,0.000333,0.065806,5,987.092341,54.838463,197.418468,96.657107,2,0
0,0,15,15,17,20,37,58,45,103,0.000333,0.178858,16,8585.179147,476.954397,536.573697,155.92543,4,0
0,0,11,11,14,16,30,38,28,66,0.000333,0.107952,7,2266.983455,125.943525,323.854779,117.302969,3,0
0,0,15,15,17,20,37,58,45,103,0.000333,0.178858,16,8585.179147,476.954397,536.573697,155.92543,4,0
0,0,11,11,14,16,30,38,28,66,0.000333,0.107952,7,2266.983455,125.943525,323.854779,117.302969,3,0
0,0,13,13,16,18,34,45,45,90,0.000333,0.152624,16,7325.946491,406.997027,457.871656,139.05865,3,0
0,0,13,13,16,20,36,43,44,87,0.000333,0.149928,16,7196.535602,399.807533,449.783475,150.438562,2,0
0,0,13,13,18,18,36,50,47,97,0.000333,0.167161,18,9026.689053,501.482725,501.482725,150.1173,4,0
0,0,13,13,18,20,38,48,46,94,0.000333,0.164435,18,8879.493353,493.305186,493.305186,161.497212,3,0
0,0,13,13,15,24,39,63,54,117,0.000333,0.206131,14,8657.488834,480.971602,618.39206,168.642459,2,0
0,0,6,6,11,10,21,23,18,41,0.000333,0.060028,5,900.425072,50.023615,180.085014,71.273029,2,0
0,0,6,6,11,10,21,23,18,41,0.000333,0.060028,5,900.425072,50.023615,180.085014,71.273029,2,0
0,0,6,6,11,10,21,23,18,41,0.000333,0.060028,5,900.425072,50.023615,180.085014,71.273029,2,0
0,0,9,9,14,17,31,39,34,73,0.000333,0.120552,14,5063.188629,281.288257,361.656331,122.789837,2,0
0,0,14,14,14,18,32,45,56,101,0.000333,0.168333,21,10605,589.166667,505,128.361619,3,0
0,0,14,14,14,20,34,43,55,98,0.000333,0.16619,14,6979.999018,387.777723,498.571358,139.741531,2,0
0,0,14,14,16,18,34,50,58,108,0.000333,0.183149,24,13186.70369,732.594649,549.445987,139.05865,4,0
0,0,14,14,16,20,36,48,57,105,0.000333,0.180947,16,8685.474002,482.526333,542.842125,150.438562,3,0
0,0,9,9,17,19,36,41,38,79,0.000333,0.136141,16,6534.785202,363.043622,408.424075,150.197491,2,0
0,0,12,12,15,18,33,60,38,98,0.000333,0.164784,14,6920.908732,384.49493,494.350624,133.662009,3,0
0,0,12,12,15,18,33,60,38,98,0.000333,0.164784,14,6920.908732,384.49493,494.350624,133.662009,3,0
0,0,14,14,16,20,36,65,41,106,0.000333,0.182671,16,8768.192802,487.121822,548.01205,150.438562,3,0
0,0,14,14,16,19,35,65,41,106,0.000333,0.181235,16,8699.263997,483.292444,543.704,144.710623,3,0
0,0,12,12,15,18,33,60,38,98,0.000333,0.164784,14,6920.908732,384.49493,494.350624,133.662009,3,0
0,0,12,12,15,18,33,60,38,98,0.000333,0.164784,14,6920.908732,384.49493,494.350624,133.662009,3,0
0,0,7,7,8,14,22,26,25,51,0.000333,0.07581,4,909.72405,50.540225,227.431013,77.302969,1,0
0,0,7,7,10,17,27,30,25,55,0.000333,0.087173,5,1307.594063,72.644115,261.518813,102.706149,1,0
0,0,5,5,12,16,28,25,24,49,0.000333,0.07852,6,1413.362347,78.52013,235.560391,107.01955,2,0
0,0,19,19,18,29,47,84,71,155,0.000333,0.286987,18,15497.3029,860.961272,860.961272,215.940099,3,0
0,0,5,5,12,17,29,25,25,50,0.000333,0.080966,6,1457.394299,80.96635,242.89905,112.506418,2,0
0,0,15,15,15,24,39,64,54,118,0.000333,0.207892,14,8731.484466,485.08247,623.677462,168.642459,2,0
0,0,5,5,14,17,31,25,25,50,0.000333,0.08257,7,1733.968709,96.331595,247.709816,122.789837,2,0
0,0,11,11,17,24,41,49,43,92,0.000333,0.164298,8,3943.158275,219.064349,492.894784,179.525968,3,0
0,0,5,5,14,18,32,25,26,51,0.000333,0.085,7,1785,99.166667,255,128.361619,2,0
0,0,11,11,14,13,27,37,29,66,0.000333,0.104608,14,4393.516052,244.084225,313.822575,101.408685,3,0
0,0,10,10,13,17,30,32,33,65,0.000333,0.106316,6,1913.687332,106.315963,318.947889,117.592585,3,0
0,0,10,10,13,15,28,33,26,59,0.000333,0.094545,6,1701.803642,94.544647,283.63394,106.709075,3,0
0,0,15,15,14,21,35,71,47,118,0.000333,0.201752,14,8473.575544,470.754197,605.255396,145.541635,5,0
0,0,6,6,11,9,20,18,14,32,0.000333,0.046101,5,691.508495,38.417139,138.301699,66.583073,2,0
0,0,14,14,16,18,34,58,39,97,0.000333,0.164495,16,7895.74233,438.652352,493.483896,139.05865,3,0
0,0,9,9,14,14,28,35,26,61,0.000333,0.09775,7,2052.740552,114.041142,293.24865,106.605938,2,0
0,0,14,14,16,18,34,58,39,97,0.000333,0.164495,16,7895.74233,438.652352,493.483896,139.05865,3,0
0,0,9,9,14,14,28,35,26,61,0.000333,0.09775,7,2052.740552,114.041142,293.24865,106.605938,2,0
0,0,15,15,13,21,34,55,51,106,0.000333,0.179757,12,6471.252734,359.514041,539.271061,140.344382,2,0
0,0,8,8,7,14,21,22,25,47,0.000333,0.068813,3,619.316757,34.406486,206.438919,72.954453,1,0
0,0,15,15,14,22,36,56,51,107,0.000333,0.184394,14,7744.547652,430.252647,553.181975,151.410465,2,0
0,0,8,8,8,16,24,23,24,47,0.000333,0.071831,4,861.97295,47.887386,215.493238,88,1,0
0,0,19,19,14,24,38,74,64,138,0.000333,0.241405,14,10138.99596,563.277553,724.213997,163.342069,2,0
0,0,10,10,13,18,31,46,36,82,0.000333,0.135415,12,4874.929169,270.829398,406.244097,123.164366,2,0
0,0,16,16,14,23,37,60,54,114,0.000333,0.197959,14,8314.287572,461.904865,593.877684,157.344894,2,0
0,0,11,11,13,18,31,38,42,80,0.000333,0.132112,12,4756.028458,264.223803,396.335705,123.164366,1,0
0,0,13,13,15,19,34,46,39,85,0.000333,0.144145,14,6054.080781,336.337821,432.434342,139.313982,2,0
0,0,13,13,16,21,37,47,41,88,0.000333,0.152811,8,3667.455169,203.747509,458.431896,156.238666,2,0
0,0,21,21,18,45,63,104,81,185,0.000333,0.368599,9,9952.171073,552.898393,1105.796786,322.192039,9,0
0,0,21,21,18,46,64,104,83,187,0.000333,0.374,9,10098,561,1122,329.1425,9,0
1,0,3,4,9,6,15,12,8,20,0.000333,0.026046,4,312.551248,17.363958,78.137812,44.0391,1,0
2,0,8,10,11,13,24,30,25,55,0.000333,0.084058,5,1260.864688,70.048038,252.172938,86.159464,2,0
0,0,8,8,13,15,28,33,26,59,0.000333,0.094545,6,1701.803642,94.544647,283.63394,106.709075,2,0
0,0,24,24,16,37,53,102,77,179,0.000333,0.341766,16,16404.76418,911.375788,1025.297761,256.749775,3,0
0,0,28,28,16,36,52,117,84,201,0.000333,0.381929,16,18332.61413,1018.478563,1145.788383,250.1173,3,0
0,0,31,31,16,38,54,125,91,216,0.000333,0.414352,16,19888.89121,1104.9384,1243.0557,263.421246,3,0
0,0,31,31,16,37,53,124,89,213,0.000333,0.406682,16,19520.75291,1084.486273,1220.047057,256.749775,3,0
0,0,6,6,11,12,23,22,20,42,0.000333,0.06333,5,949.948011,52.774889,189.989602,81.073298,2,0
0,0,35,35,15,20,35,144,76,220,0.000333,0.376147,21,23697.28754,1316.515974,1128.442264,145.041921,6,0
0,0,11,11,10,18,28,41,42,83,0.000333,0.133003,10,3990.104585,221.672477,399.010459,108.277931,1,0
0,0,14,14,14,22,36,53,49,102,0.000333,0.175777,14,7382.652902,410.147383,527.33235,151.410465,2,0
0,0,11,11,15,22,37,47,34,81,0.000333,0.140655,7,2953.760058,164.097781,421.965723,156.710855,4,0
0,0,12,12,15,22,37,48,36,84,0.000333,0.145865,7,3063.158579,170.175477,437.594083,156.710855,4,0
0,0,14,14,15,18,33,58,39,97,0.000333,0.163102,14,6850.287214,380.571512,489.30623,133.662009,3,0
0,0,14,14,15,18,33,58,39,97,0.000333,0.163102,14,6850.287214,380.571512,489.30623,133.662009,3,0
0,0,4,4,9,11,20,19,15,34,0.000333,0.048982,4,587.782221,32.654568,146.945555,66.583073,2,0
0,0,4,4,9,12,21,19,15,34,0.000333,0.04978,4,597.355169,33.186398,149.338792,71.548875,2,0
0,0,4,4,11,15,26,27,19,46,0.000333,0.072073,5,1081.101135,60.061174,216.220227,96.657107,2,0
0,0,8,8,11,18,29,43,33,76,0.000333,0.123069,5,1846.032778,102.557377,369.206556,113.112398,2,0
0,0,4,4,11,11,22,19,15,34,0.000333,0.05054,5,758.103375,42.116854,151.620675,76.107496,2,0
0,0,6,6,9,17,26,36,28,64,0.000333,0.100276,4,1203.312568,66.850698,300.828142,98.016193,1,0
0,0,7,7,11,17,28,40,30,70,0.000333,0.112172,5,1682.574223,93.476346,336.514845,107.540616,2,0
0,0,16,16,15,16,31,62,46,108,0.000333,0.178351,14,7490.744821,416.15249,535.053202,122.603359,2,0
0,0,12,12,14,16,30,42,32,74,0.000333,0.121037,14,5083.538657,282.418814,363.109904,117.302969,2,0
0,0,11,11,14,16,30,40,30,70,0.000333,0.114494,7,2404.376392,133.576466,343.482342,117.302969,2,0
0,0,16,16,14,19,33,59,52,111,0.000333,0.186643,14,7838.988461,435.499359,559.927747,134.013592,2,0
0,0,9,9,13,16,29,37,30,67,0.000333,0.108495,6,1952.90836,108.494909,325.484727,112.105716,2,0
0,0,13,13,14,19,33,45,42,87,0.000333,0.146287,14,6144.072037,341.337335,438.862288,134.013592,2,0
0,0,12,12,14,19,33,43,40,83,0.000333,0.139562,14,5861.585967,325.643665,418.684712,134.013592,2,0
0,0,7,7,9,12,21,21,23,44,0.000333,0.064421,4,773.047866,42.947104,193.261967,71.548875,1,0
0,0,6,6,8,12,20,19,21,40,0.000333,0.057626,4,691.508495,38.417139,172.877124,67.01955,1,0
0,0,10,10,14,18,32,38,32,70,0.000333,0.116667,7,2450,136.111111,350,128.361619,2,0
0,0,9,9,14,14,28,35,26,61,0.000333,0.09775,7,2052.740552,114.041142,293.24865,106.605938,2,0
0,0,7,7,10,13,23,21,22,43,0.000333,0.064838,5,972.565821,54.031434,194.513164,81.324997,1,0
0,0,6,6,9,13,22,19,20,39,0.000333,0.057973,4,695.671333,38.648407,173.917833,76.635041,1,0
0,0,13,13,13,18,31,45,42,87,0.000333,0.143672,12,5172.180948,287.343386,431.015079,123.164366,2,0
0,0,12,12,13,18,31,43,40,83,0.000333,0.137066,12,4934.379525,274.132196,411.198294,123.164366,2,0
0,0,13,13,14,19,33,45,42,87,0.000333,0.146287,14,6144.072037,341.337335,438.862288,134.013592,2,0
0,0,12,12,14,19,33,43,40,83,0.000333,0.139562,14,5861.585967,325.643665,418.684712,134.013592,2,0
0,0,16,16,14,19,33,59,52,111,0.000333,0.186643,14,7838.988461,435.499359,559.927747,134.013592,2,0
0,0,9,9,13,16,29,37,30,67,0.000333,0.108495,6,1952.90836,108.494909,325.484727,112.105716,2,0
0,0,17,17,13,20,33,57,62,119,0.000333,0.200094,18,10805.0922,600.2829,600.2829,134.544278,2,0
0,0,16,16,13,20,33,55,60,115,0.000333,0.193368,18,10441.89583,580.105324,580.105324,134.544278,2,0
0,0,17,17,14,21,35,57,66,123,0.000333,0.210301,21,13248.93803,736.052113,630.901811,145.541635,2,0
0,0,16,16,14,21,35,55,64,119,0.000333,0.203462,21,12818.07826,712.115459,610.384679,145.541635,2,0
0,0,20,20,14,21,35,71,76,147,0.000333,0.251335,21,15834.09667,879.672037,754.004603,145.541635,2,0
0,0,9,9,13,16,29,37,30,67,0.000333,0.108495,6,1952.90836,108.494909,325.484727,112.105716,2,0
0,0,16,16,14,19,33,50,70,120,0.000333,0.201776,21,12711.87318,706.215177,605.327294,134.013592,3,0
0,0,16,16,14,21,35,48,69,117,0.000333,0.200042,21,12602.64837,700.147132,600.126113,145.541635,2,0
0,0,16,16,16,19,35,55,72,127,0.000333,0.21714,24,15634.05464,868.558591,651.418943,144.710623,4,0
0,0,16,16,16,21,37,53,71,124,0.000333,0.215324,24,15503.33322,861.29629,645.972217,156.238666,3,0
0,0,12,12,16,19,35,55,45,100,0.000333,0.170976,16,8206.852827,455.936268,512.928302,144.710623,2,0
0,0,17,17,15,22,37,67,62,129,0.000333,0.224006,14,9408.272778,522.681821,672.019484,156.710855,2,0
0,0,9,9,13,16,29,37,30,67,0.000333,0.108495,6,1952.90836,108.494909,325.484727,112.105716,2,0
0,0,18,18,15,24,39,69,73,142,0.000333,0.250176,21,15761.06942,875.614968,750.527115,168.642459,2,0
0,0,18,18,16,24,40,68,63,131,0.000333,0.232391,16,11154.76129,619.70896,697.17258,174.0391,2,0
0,0,9,9,13,18,31,36,32,68,0.000333,0.112295,6,2021.312095,112.295116,336.885349,123.164366,2,0
0,0,8,8,12,18,30,33,33,66,0.000333,0.107952,6,1943.128676,107.951593,323.854779,118.0782,1,0
0,0,14,14,14,22,36,67,53,120,0.000333,0.206797,14,8685.474002,482.526333,620.391,151.410465,1,0
0,0,11,11,14,18,32,47,39,86,0.000333,0.143333,14,6020,334.444444,430,128.361619,2,0
0,0,10,10,14,16,30,44,33,77,0.000333,0.125944,14,5289.628062,293.868226,377.830576,117.302969,2,0
0,0,11,11,13,19,32,51,44,95,0.000333,0.158333,12,5700,316.666667,475,128.816339,1,0
0,0,8,8,11,11,22,26,22,48,0.000333,0.071351,10,2140.527177,118.918176,214.052718,76.107496,2,0
0,0,9,9,11,11,22,25,22,47,0.000333,0.069864,10,2095.932861,116.440714,209.593286,76.107496,2,0
0,0,9,9,11,10,21,25,22,47,0.000333,0.068813,10,2064.389189,114.688288,206.438919,71.273029,2,0
0,0,9,9,11,11,22,25,22,47,0.000333,0.069864,10,2095.932861,116.440714,209.593286,76.107496,2,0
0,0,8,8,11,9,20,22,20,42,0.000333,0.060507,10,1815.2098,100.844989,181.52098,66.583073,2,0
0,0,11,11,12,12,24,30,26,56,0.000333,0.085586,12,3081.0948,171.171933,256.7579,86.0391,3,0
0,0,9,9,12,13,25,32,29,61,0.000333,0.094425,12,3399.302731,188.850152,283.275228,91.125266,2,0
0,0,12,12,17,16,33,52,37,89,0.000333,0.14965,16,7183.217226,399.067624,448.951077,133.486868,3,0
0,0,15,15,18,18,36,72,46,118,0.000333,0.20335,18,10980.9207,610.05115,610.05115,150.1173,3,0
0,0,14,14,14,16,30,53,40,93,0.000333,0.152114,14,6388.771555,354.931753,456.340825,117.302969,2,0
0,0,10,10,14,14,28,42,31,73,0.000333,0.116979,14,4913.11673,272.950929,350.936909,106.605938,2,0
0,0,11,11,14,15,29,39,30,69,0.000333,0.111734,14,4692.809641,260.711647,335.200689,111.906328,2,0
0,0,15,15,14,18,32,57,42,99,0.000333,0.165,14,6930,385,495,128.361619,3,0
0,0,12,12,14,17,31,43,32,75,0.000333,0.123855,7,2600.953063,144.497392,371.564723,122.789837,3,0
0,0,15,15,14,18,32,56,42,98,0.000333,0.163333,14,6860,381.111111,490,128.361619,3,0
0,0,12,12,14,17,31,42,32,74,0.000333,0.122204,7,2566.273689,142.57076,366.610527,122.789837,3,0
0,0,15,15,15,16,31,56,41,97,0.000333,0.160186,14,6727.79859,373.766588,480.557042,122.603359,3,0
0,0,10,10,14,14,28,42,31,73,0.000333,0.116979,14,4913.11673,272.950929,350.936909,106.605938,2,0
0,0,12,12,15,15,30,42,31,73,0.000333,0.119401,14,5014.842189,278.602344,358.203013,117.206718,3,0
0,0,15,15,15,17,32,56,41,97,0.000333,0.161667,14,6790,377.222222,485,128.090227,3,0
0,0,10,10,14,14,28,42,31,73,0.000333,0.116979,14,4913.11673,272.950929,350.936909,106.605938,2,0
0,0,12,12,15,16,31,42,31,73,0.000333,0.120552,7,2531.594315,140.644129,361.656331,122.603359,3,0
0,0,15,15,15,17,32,56,41,97,0.000333,0.161667,14,6790,377.222222,485,128.090227,3,0
0,0,10,10,14,14,28,42,31,73,0.000333,0.116979,14,4913.11673,272.950929,350.936909,106.605938,2,0
0,0,12,12,15,16,31,42,31,73,0.000333,0.120552,7,2531.594315,140.644129,361.656331,122.603359,3,0
0,0,12,12,12,17,29,39,42,81,0.000333,0.131165,12,4721.957527,262.330974,393.496461,112.506418,2,0
0,0,9,9,9,16,25,26,32,58,0.000333,0.089781,8,2154.749272,119.708293,269.343659,92.529325,1,0
0,0,12,12,13,19,32,40,42,82,0.000333,0.136667,12,4920,273.333333,410,128.816339,2,0
0,0,9,9,10,19,29,27,31,58,0.000333,0.093921,5,1408.814489,78.267472,281.762898,113.929904,1,0
0,0,15,15,14,23,37,52,54,106,0.000333,0.184067,14,7730.828795,429.490489,552.202057,157.344894,2,0
0,0,19,19,13,22,35,67,82,149,0.000333,0.254754,18,13756.73705,764.26317,764.26317,146.213212,2,0
0,0,19,19,14,25,39,68,88,156,0.000333,0.274841,21,17314.97767,961.943204,824.522746,169.399374,2,0
0,0,9,9,9,15,24,34,58,92,0.000333,0.140606,12,5061.798601,281.211033,421.81655,87.132684,1,0
0,0,12,12,18,17,35,54,39,93,0.000333,0.159008,18,8586.41977,477.023321,477.023321,144.545518,3,0
0,0,12,12,17,17,34,53,39,92,0.000333,0.156016,16,7488.745302,416.041406,468.046581,138.973737,3,0
0,0,12,12,15,14,29,42,32,74,0.000333,0.11983,14,5032.868311,279.603795,359.490594,111.906328,5,0
0,0,12,12,15,16,31,40,31,71,0.000333,0.117249,7,2462.235566,136.790865,351.747938,122.603359,4,0
0,0,12,12,14,14,28,41,32,73,0.000333,0.116979,14,4913.11673,272.950929,350.936909,106.605938,5,0
0,0,12,12,14,16,30,39,31,70,0.000333,0.114494,7,2404.376392,133.576466,343.482342,117.302969,4,0
0,0,28,28,25,43,68,131,91,222,0.000333,0.450472,24,32434.00202,1801.889001,1351.416751,349.425789,12,0
0,0,28,28,24,45,69,129,90,219,0.000333,0.445922,24,32106.40455,1783.689141,1337.766856,357.172489,11,0
0,0,25,25,22,45,67,117,83,200,0.000333,0.404406,11,13345.39622,741.410901,1213.217838,345.240885,10,0
0,0,24,24,22,45,67,116,81,197,0.000333,0.39834,11,13145.21528,730.289738,1195.019571,345.240885,10,0
0,0,28,28,25,43,68,131,91,222,0.000333,0.450472,24,32434.00202,1801.889001,1351.416751,349.425789,12,0
0,0,28,28,24,45,69,129,90,219,0.000333,0.445922,24,32106.40455,1783.689141,1337.766856,357.172489,11,0
0,0,25,25,22,45,67,117,83,200,0.000333,0.404406,11,13345.39622,741.410901,1213.217838,345.240885,10,0
0,0,24,24,22,45,67,116,81,197,0.000333,0.39834,11,13145.21528,730.289738,1195.019571,345.240885,10,0
0,0,12,12,14,12,26,41,30,71,0.000333,0.111244,14,4672.23708,259.568727,333.73122,96.322519,5,0
0,0,12,12,14,14,28,39,29,68,0.000333,0.108967,14,4576.601886,254.25566,326.900135,106.605938,4,0
0,0,12,12,14,12,26,41,30,71,0.000333,0.111244,14,4672.23708,259.568727,333.73122,96.322519,5,0
0,0,12,12,14,14,28,39,29,68,0.000333,0.108967,14,4576.601886,254.25566,326.900135,106.605938,4,0
0,0,10,10,14,12,26,35,28,63,0.000333,0.098709,14,4145.787831,230.321546,296.127702,96.322519,3,0
0,0,10,10,14,14,28,33,27,60,0.000333,0.096147,7,2019.089067,112.171615,288.441295,106.605938,2,0
0,0,26,26,25,43,68,125,89,214,0.000333,0.434239,24,31265.20915,1736.956064,1302.717048,349.425789,10,0
0,0,26,26,24,45,69,123,88,211,0.000333,0.429633,12,15466.78393,859.265774,1288.89866,357.172489,9,0
0,0,24,24,22,45,67,114,82,196,0.000333,0.396318,11,13078.4883,726.582683,1188.953481,345.240885,9,0
0,0,23,23,22,45,67,113,80,193,0.000333,0.390252,11,12878.30735,715.46152,1170.755214,345.240885,9,0
0,0,28,28,25,44,69,132,93,225,0.000333,0.458139,24,32986.03207,1832.557337,1374.418003,356.311396,12,0
0,0,28,28,24,46,70,130,92,222,0.000333,0.453567,24,32656.81991,1814.267773,1360.70083,364.12295,11,0
0,0,25,25,22,46,68,117,84,201,0.000333,0.40786,11,13459.38034,747.743352,1223.580031,352.191346,10,0
0,0,24,24,22,46,68,116,82,198,0.000333,0.401773,11,13258.49407,736.583004,1205.317643,352.191346,10,0
0,0,28,28,25,44,69,131,93,224,0.000333,0.456103,24,32839.42748,1824.412638,1368.309478,356.311396,12,0
0,0,28,28,24,46,70,129,92,221,0.000333,0.451524,24,32509.71712,1806.095396,1354.571547,364.12295,11,0
0,0,25,25,22,46,68,117,84,201,0.000333,0.40786,11,13459.38034,747.743352,1223.580031,352.191346,10,0
0,0,24,24,22,46,68,116,82,198,0.000333,0.401773,11,13258.49407,736.583004,1205.317643,352.191346,10,0
0,0,12,12,15,13,28,42,32,74,0.000333,0.118581,14,4980.419699,276.689983,355.744264,106.709075,5,0
0,0,12,12,15,15,30,40,31,71,0.000333,0.11613,14,4877.449252,270.969403,348.389232,117.206718,4,0
0,0,12,12,14,13,27,41,32,73,0.000333,0.115702,14,4859.495027,269.971946,347.106788,101.408685,5,0
0,0,12,12,14,15,29,39,31,70,0.000333,0.113353,14,4760.821375,264.490076,340.05867,111.906328,4,0
0,0,5,5,7,10,17,10,14,24,0.000333,0.0327,3,294.297325,16.349851,98.099108,52.870765,1,0
0,0,5,5,8,8,16,11,12,23,0.000333,0.030667,4,368,20.444444,92,48,1,0
0,0,7,7,11,12,23,33,23,56,0.000333,0.08444,5,1266.597348,70.366519,253.31947,81.073298,1,0
0,0,16,16,15,16,31,66,46,112,0.000333,0.184957,14,7768.179815,431.565545,554.869987,122.603359,3,0
0,0,13,13,15,16,31,52,36,88,0.000333,0.145323,14,6103.569854,339.087214,435.969275,122.603359,3,0
0,0,11,11,15,15,30,47,33,80,0.000333,0.13085,14,5495.717467,305.317637,392.551248,117.206718,2,0
0,0,16,16,15,16,31,66,46,112,0.000333,0.184957,14,7768.179815,431.565545,554.869987,122.603359,3,0
0,0,13,13,15,16,31,52,36,88,0.000333,0.145323,14,6103.569854,339.087214,435.969275,122.603359,3,0
0,0,11,11,15,15,30,47,33,80,0.000333,0.13085,14,5495.717467,305.317637,392.551248,117.206718,2,0
0,0,7,7,14,18,32,38,30,68,0.000333,0.113333,7,2380,132.222222,340,128.361619,2,0
0,0,15,15,16,25,41,80,59,139,0.000333,0.248233,16,11915.19566,661.955314,744.699729,180.096405,2,0
0,0,14,14,16,24,40,71,55,126,0.000333,0.223521,16,10729.00704,596.055947,670.56294,174.0391,2,0
0,0,13,13,14,21,35,56,72,128,0.000333,0.218849,21,13787.51275,765.972931,656.548226,145.541635,2,0
0,0,13,13,17,17,34,48,46,94,0.000333,0.159407,16,7651.544113,425.085784,478.221507,138.973737,4,0
0,0,13,13,17,19,36,46,45,91,0.000333,0.156821,16,7527.410802,418.189489,470.463175,150.197491,3,0
0,0,16,16,16,26,42,72,67,139,0.000333,0.249844,16,11992.51395,666.250775,749.532122,186.211433,2,0
0,0,5,5,5,10,15,9,17,26,0.000333,0.03386,2,203.158311,11.286573,101.579155,44.828921,1,0
0,0,5,5,6,12,18,10,16,26,0.000333,0.036139,3,325.25415,18.069675,108.41805,58.529325,1,0
0,0,7,7,12,17,29,30,31,61,0.000333,0.098779,6,1778.021044,98.778947,296.336841,112.506418,1,0
0,0,10,10,10,16,26,41,62,103,0.000333,0.161382,15,7262.179365,403.454409,484.145291,97.219281,1,0
0,0,11,11,13,16,29,34,38,72,0.000333,0.116592,12,4197.29558,233.183088,349.774632,112.105716,2,0
0,0,11,11,14,18,32,35,38,73,0.000333,0.121667,14,5110,283.888889,365,128.361619,2,0
0,0,13,13,12,19,31,48,52,100,0.000333,0.16514,12,5945.035572,330.279754,495.419631,123.730173,2,0
0,0,15,15,15,22,37,57,53,110,0.000333,0.191013,14,8022.558183,445.697677,573.03987,156.710855,2,0
0,0,13,13,12,19,31,48,52,100,0.000333,0.16514,12,5945.035572,330.279754,495.419631,123.730173,2,0
0,0,15,15,15,22,37,57,53,110,0.000333,0.191013,14,8022.558183,445.697677,573.03987,156.710855,2,0
0,0,13,13,12,15,27,49,43,92,0.000333,0.145817,12,5249.395802,291.6331,437.44965,101.622909,2,0
0,0,15,15,15,18,33,58,47,105,0.000333,0.176554,14,7415.259355,411.958853,529.661383,133.662009,2,0
0,0,13,13,12,15,27,49,43,92,0.000333,0.145817,12,5249.395802,291.6331,437.44965,101.622909,2,0
0,0,15,15,15,18,33,58,47,105,0.000333,0.176554,14,7415.259355,411.958853,529.661383,133.662009,2,0
0,0,12,12,15,18,33,60,38,98,0.000333,0.164784,14,6920.908732,384.49493,494.350624,133.662009,3,0
0,0,12,12,15,17,32,60,38,98,0.000333,0.163333,14,6860,381.111111,490,128.090227,3,0
0,0,12,12,13,21,34,62,49,111,0.000333,0.188236,12,6776.500505,376.47225,564.708375,140.344382,1,0
0,0,4,4,10,14,24,17,18,35,0.000333,0.053491,5,802.368438,44.576024,160.473688,86.52225,1,0
0,0,7,7,15,16,31,35,28,63,0.000333,0.104038,7,2184.800573,121.37781,312.114368,122.603359,1,0
0,0,13,13,12,19,31,42,53,95,0.000333,0.156883,12,5647.783794,313.765766,470.648649,123.730173,2,0
0,0,13,13,13,21,34,43,55,98,0.000333,0.16619,12,5982.856301,332.380906,498.571358,140.344382,2,0
0,0,8,8,8,16,24,29,28,57,0.000333,0.087114,4,1045.37145,58.076192,261.342863,88,1,0
0,0,8,8,9,18,27,30,27,57,0.000333,0.090343,4,1084.11435,60.228575,271.028588,103.587975,1,0
0,0,19,19,15,26,41,78,69,147,0.000333,0.26252,14,11025.84203,612.546779,787.560145,180.814792,2,0
0,0,16,16,14,24,38,67,57,124,0.000333,0.216914,14,9110.402163,506.133454,650.743012,163.342069,2,0
0,0,18,18,18,22,40,69,63,132,0.000333,0.234165,18,12644.90115,702.494509,702.494509,173.166146,2,0
0,0,11,11,11,11,22,28,26,54,0.000333,0.08027,10,2408.093074,133.782949,240.809307,76.107496,2,0
0,0,9,9,13,16,29,37,30,67,0.000333,0.108495,6,1952.90836,108.494909,325.484727,112.105716,2,0
0,0,10,10,14,16,30,37,33,70,0.000333,0.114494,14,4808.752784,267.152932,343.482342,117.302969,2,0
0,0,16,16,18,18,36,66,53,119,0.000333,0.205074,18,11073.97935,615.221075,615.221075,150.1173,3,0
0,0,16,16,18,18,36,66,53,119,0.000333,0.205074,18,11073.97935,615.221075,615.221075,150.1173,3,0
0,0,6,6,9,12,21,27,22,49,0.000333,0.071741,4,860.894215,47.827456,215.223554,71.548875,1,0
0,0,5,5,9,11,20,24,19,43,0.000333,0.061948,4,743.371632,41.298424,185.842908,66.583073,1,0
0,0,6,6,9,12,21,27,22,49,0.000333,0.071741,4,860.894215,47.827456,215.223554,71.548875,1,0
0,0,5,5,9,11,20,24,19,43,0.000333,0.061948,4,743.371632,41.298424,185.842908,66.583073,1,0
0,0,6,6,9,11,20,27,22,49,0.000333,0.070591,8,1694.195813,94.12199,211.774477,66.583073,1,0
0,0,5,5,9,11,20,24,19,43,0.000333,0.061948,4,743.371632,41.298424,185.842908,66.583073,1,0
0,0,8,8,9,14,23,30,26,56,0.000333,0.08444,4,1013.277878,56.293215,253.31947,81.832294,1,0
0,0,5,5,9,12,21,24,19,43,0.000333,0.062957,4,755.478597,41.971033,188.869649,71.548875,1,0
0,0,12,12,15,21,36,61,42,103,0.000333,0.177501,14,7455.031852,414.168436,532.502275,150.842025,3,0
0,0,12,12,15,21,36,60,42,102,0.000333,0.175777,14,7382.652902,410.147383,527.33235,150.842025,3,0
0,0,14,14,16,21,37,65,44,109,0.000333,0.189277,16,9085.28667,504.738148,567.830417,156.238666,3,0
0,0,14,14,16,21,37,65,44,109,0.000333,0.189277,16,9085.28667,504.738148,567.830417,156.238666,3,0
0,0,11,11,19,22,41,55,46,101,0.000333,0.180371,18,9740.029544,541.112752,541.112752,178.818118,2,0
0,0,5,5,6,12,18,10,16,26,0.000333,0.036139,3,325.25415,18.069675,108.41805,58.529325,1,0
0,0,12,12,15,20,35,60,41,101,0.000333,0.172686,14,7252.806186,402.933677,518.057585,145.041921,3,0
0,0,12,12,15,20,35,60,41,101,0.000333,0.172686,14,7252.806186,402.933677,518.057585,145.041921,3,0
0,0,3,3,7,9,16,13,12,25,0.000333,0.033333,3,300,16.666667,100,48.180809,1,0
0,0,3,3,7,9,16,13,12,25,0.000333,0.033333,3,300,16.666667,100,48.180809,1,0
0,0,5,5,8,12,20,21,17,38,0.000333,0.054744,4,656.93307,36.496282,164.233268,67.01955,1,0
0,0,5,5,11,9,20,22,18,40,0.000333,0.057626,10,1728.771238,96.042847,172.877124,66.583073,2,0
0,0,6,6,5,11,16,13,19,32,0.000333,0.042667,2,256,14.222222,128,49.663388,1,0
0,0,6,6,6,13,19,14,18,32,0.000333,0.045311,3,407.801041,22.655613,135.93368,63.615491,1,0
0,0,11,11,13,19,32,44,41,85,0.000333,0.141667,12,5100,283.333333,425,128.816339,2,0
0,0,10,10,13,17,30,41,34,75,0.000333,0.122672,12,4416.201536,245.34453,368.016795,117.592585,2,0
0,0,14,14,16,24,40,59,48,107,0.000333,0.189815,16,9111.140898,506.174494,569.446306,174.0391,2,0
0,0,20,20,19,21,40,77,66,143,0.000333,0.253679,27,20547.96437,1141.553576,761.035718,172.949289,4,0
0,0,20,20,19,21,40,77,66,143,0.000333,0.253679,27,20547.96437,1141.553576,761.035718,172.949289,4,0
0,0,7,7,9,12,21,20,24,44,0.000333,0.064421,8,1546.095733,85.894207,193.261967,71.548875,1,0
0,0,5,5,11,15,26,24,22,46,0.000333,0.072073,5,1081.101135,60.061174,216.220227,96.657107,1,0
0,0,7,7,10,15,25,21,23,44,0.000333,0.06811,5,1021.648362,56.758242,204.329672,91.82264,1,0
0,0,7,7,9,12,21,21,21,42,0.000333,0.061492,4,737.909327,40.994963,184.477332,71.548875,1,0
0,0,4,4,11,10,21,24,17,41,0.000333,0.060028,5,900.425072,50.023615,180.085014,71.273029,1,0
0,0,7,7,10,11,21,22,19,41,0.000333,0.060028,5,900.425072,50.023615,180.085014,71.273029,1,0
0,0,19,19,16,23,39,75,68,143,0.000333,0.251938,16,12093.00028,671.833349,755.812517,168.041925,2,0
0,0,9,9,13,18,31,36,32,68,0.000333,0.112295,6,2021.312095,112.295116,336.885349,123.164366,2,0
0,0,9,9,10,16,26,39,32,71,0.000333,0.111244,10,3337.3122,185.406233,333.73122,97.219281,1,0
0,0,9,9,11,17,28,39,31,70,0.000333,0.112172,5,1682.574223,93.476346,336.514845,107.540616,1,0
0,0,19,19,15,23,38,83,65,148,0.000333,0.258898,14,10873.70581,604.094767,776.693272,162.645284,2,0
0,0,9,9,13,17,30,39,30,69,0.000333,0.112858,6,2031.452707,112.858484,338.575451,117.592585,2,0
0,0,16,16,15,23,38,69,55,124,0.000333,0.216914,14,9110.402163,506.133454,650.743012,162.645284,2,0
0,0,5,5,11,15,26,20,22,42,0.000333,0.065806,5,987.092341,54.838463,197.418468,96.657107,2,0
0,0,16,16,18,23,41,72,54,126,0.000333,0.225017,18,12150.92795,675.051553,675.051553,179.100575,4,0
0,0,5,5,12,13,25,21,20,41,0.000333,0.063466,6,1142.388623,63.466035,190.398104,91.125266,2,0
0,0,5,5,12,16,28,23,24,47,0.000333,0.075315,6,1355.674088,75.315227,225.945681,107.01955,2,0
0,0,16,16,18,26,44,69,61,130,0.000333,0.236575,18,12775.06999,709.72611,709.72611,197.270083,3,0
0,0,5,5,12,17,29,23,25,48,0.000333,0.077728,6,1399.098527,77.727696,233.183088,112.506418,2,0
1,0,3,4,8,9,17,12,12,24,0.000333,0.0327,4,392.396433,21.799802,98.099108,52.529325,1,0
0,0,63,63,26,68,94,247,180,427,0.000333,0.932936,26,72769.04543,4042.724746,2798.80944,536.158906,17,0
0,0,22,22,19,27,46,74,83,157,0.000333,0.289066,27,23414.37913,1300.798841,867.199227,209.092585,5,0
0,0,21,21,16,28,44,91,74,165,0.000333,0.300269,16,14412.89947,800.716637,900.806217,198.605938,6,0
0,0,12,12,13,20,33,38,43,81,0.000333,0.136199,12,4903.151084,272.397282,408.595924,134.544278,3,0
0,0,6,6,11,10,21,19,15,34,0.000333,0.04978,5,746.693962,41.482998,149.338792,71.273029,2,0
0,0,12,12,17,16,33,53,38,91,0.000333,0.153013,16,7344.637838,408.035435,459.039865,133.486868,3,0
0,0,12,12,17,16,33,53,38,91,0.000333,0.153013,16,7344.637838,408.035435,459.039865,133.486868,3,0
0,0,11,11,14,19,33,42,42,84,0.000333,0.141243,14,5932.207484,329.567082,423.729106,134.013592,2,0
0,0,11,11,15,21,36,44,43,87,0.000333,0.149928,14,6296.968652,349.831592,449.783475,150.842025,2,0
0,0,13,13,15,23,38,52,51,103,0.000333,0.180179,14,7567.511474,420.417304,540.536534,162.645284,2,0
0,0,14,14,16,25,41,54,49,103,0.000333,0.183943,8,4414.622852,245.256825,551.827856,180.096405,2,0
0,0,11,11,16,19,35,45,36,81,0.000333,0.138491,8,3323.775395,184.654189,415.471924,144.710623,2,0
0,0,14,14,14,18,32,46,42,88,0.000333,0.146667,14,6160,342.222222,440,128.361619,3,0
0,0,10,10,14,16,30,32,27,59,0.000333,0.096502,7,2026.545816,112.585879,289.506545,117.302969,3,0
0,0,14,14,14,18,32,46,42,88,0.000333,0.146667,14,6160,342.222222,440,128.361619,3,0
0,0,10,10,14,16,30,32,27,59,0.000333,0.096502,7,2026.545816,112.585879,289.506545,117.302969,3,0
0,0,14,14,14,18,32,46,42,88,0.000333,0.146667,14,6160,342.222222,440,128.361619,3,0
0,0,10,10,14,16,30,32,27,59,0.000333,0.096502,7,2026.545816,112.585879,289.506545,117.302969,3,0
0,0,14,14,14,18,32,46,42,88,0.000333,0.146667,14,6160,342.222222,440,128.361619,3,0
0,0,10,10,14,16,30,32,27,59,0.000333,0.096502,7,2026.545816,112.585879,289.506545,117.302969,3,0
0,0,9,9,14,19,33,36,36,72,0.000333,0.121065,7,2542.374636,141.243035,363.196377,134.013592,2,0
0,0,5,5,8,8,16,11,12,23,0.000333,0.030667,4,368,20.444444,92,48,1,0
0,0,5,5,9,9,18,12,13,25,0.000333,0.034749,4,416.9925,23.16625,104.248125,57.05865,1,0
0,0,13,13,14,17,31,43,41,84,0.000333,0.138717,14,5826.134861,323.674159,416.15249,122.789837,2,0
0,0,9,9,14,15,29,29,26,55,0.000333,0.089063,7,1870.322683,103.906816,267.188955,111.906328,2,0
0,0,16,16,15,19,34,51,45,96,0.000333,0.162799,14,6837.550059,379.863892,488.396433,139.313982,3,0
0,0,12,12,15,18,33,37,30,67,0.000333,0.112658,7,2365.820842,131.434491,337.974406,133.662009,3,0
0,0,16,16,15,19,34,51,45,96,0.000333,0.162799,14,6837.550059,379.863892,488.396433,139.313982,3,0
0,0,12,12,15,17,32,37,30,67,0.000333,0.111667,7,2345,130.277778,335,128.090227,3,0
0,0,14,14,14,19,33,47,43,90,0.000333,0.151332,14,6355.93659,353.107588,453.995471,134.013592,3,0
0,0,10,10,14,17,31,33,28,61,0.000333,0.100735,7,2115.441825,117.524546,302.205975,122.789837,3,0
0,0,14,14,14,19,33,46,43,89,0.000333,0.14965,14,6285.315073,349.184171,448.951077,134.013592,3,0
0,0,10,10,14,17,31,32,28,60,0.000333,0.099084,7,2080.76245,115.597914,297.251779,122.789837,3,0
0,0,8,8,13,12,25,26,19,45,0.000333,0.069658,6,1253.841171,69.657843,208.973529,91.125266,3,0
0,0,8,8,13,12,25,26,19,45,0.000333,0.069658,6,1253.841171,69.657843,208.973529,91.125266,3,0
0,0,9,9,13,12,25,32,21,53,0.000333,0.082041,6,1476.746268,82.041459,246.124378,91.125266,4,0
0,0,10,10,14,15,29,38,34,72,0.000333,0.116592,14,4896.844843,272.046936,349.774632,111.906328,2,0
0,0,9,9,12,15,27,32,29,61,0.000333,0.096683,6,1740.288826,96.682713,290.048138,101.622909,2,0
0,0,10,10,14,15,29,38,34,72,0.000333,0.116592,14,4896.844843,272.046936,349.774632,111.906328,2,0
0,0,9,9,12,15,27,32,29,61,0.000333,0.096683,6,1740.288826,96.682713,290.048138,101.622909,2,0
0,0,13,13,15,18,33,49,40,89,0.000333,0.14965,14,6285.315073,349.184171,448.951077,133.662009,2,0
0,0,11,11,13,18,31,41,33,74,0.000333,0.122204,6,2199.663162,122.203509,366.610527,123.164366,2,0
0,0,11,11,13,18,31,41,33,74,0.000333,0.122204,6,2199.663162,122.203509,366.610527,123.164366,2,0
0,0,10,10,15,16,31,39,35,74,0.000333,0.122204,14,5132.547378,285.141521,366.610527,122.603359,2,0
0,0,9,9,13,16,29,33,30,63,0.000333,0.102018,6,1836.316816,102.017601,306.052803,112.105716,2,0
0,0,10,10,14,16,30,38,35,73,0.000333,0.119401,14,5014.842189,278.602344,358.203013,117.302969,2,0
0,0,9,9,12,16,28,32,30,62,0.000333,0.099352,6,1788.336031,99.352002,298.056005,107.01955,2,0
0,0,10,10,14,15,29,38,34,72,0.000333,0.116592,14,4896.844843,272.046936,349.774632,111.906328,2,0
0,0,9,9,12,15,27,32,29,61,0.000333,0.096683,6,1740.288826,96.682713,290.048138,101.622909,2,0
0,0,10,10,14,15,29,38,34,72,0.000333,0.116592,14,4896.844843,272.046936,349.774632,111.906328,2,0
0,0,9,9,12,15,27,32,29,61,0.000333,0.096683,6,1740.288826,96.682713,290.048138,101.622909,2,0
0,0,14,14,15,18,33,46,45,91,0.000333,0.153013,14,6426.558108,357.031006,459.039865,133.662009,2,0
0,0,14,14,15,18,33,46,45,91,0.000333,0.153013,14,6426.558108,357.031006,459.039865,133.662009,2,0
0,0,12,12,15,18,33,43,37,80,0.000333,0.134517,14,5649.721414,313.873412,403.55153,133.662009,3,0
0,0,10,10,15,16,31,35,29,64,0.000333,0.10569,7,2219.479947,123.304442,317.068564,122.603359,3,0
0,0,12,12,14,19,33,43,37,80,0.000333,0.134517,7,2824.860707,156.936706,403.55153,134.013592,3,0
0,0,10,10,14,17,31,35,29,64,0.000333,0.10569,7,2219.479947,123.304442,317.068564,122.789837,3,0
0,0,12,12,14,19,33,43,37,80,0.000333,0.134517,7,2824.860707,156.936706,403.55153,134.013592,3,0
0,0,10,10,14,17,31,35,29,64,0.000333,0.10569,7,2219.479947,123.304442,317.068564,122.789837,3,0
0,0,14,14,16,21,37,65,44,109,0.000333,0.189277,16,9085.28667,504.738148,567.830417,156.238666,3,0
0,0,14,14,16,21,37,65,44,109,0.000333,0.189277,16,9085.28667,504.738148,567.830417,156.238666,3,0
0,0,13,13,17,20,37,49,43,92,0.000333,0.159757,16,7668.315354,426.01752,479.26971,155.92543,3,0
0,0,11,11,17,19,36,41,35,76,0.000333,0.130971,8,3143.314401,174.628578,392.9143,150.197491,3,0
0,0,8,8,12,10,22,29,22,51,0.000333,0.07581,12,2729.172151,151.620675,227.431013,76.238831,3,0
0,0,5,5,7,10,17,10,14,24,0.000333,0.0327,3,294.297325,16.349851,98.099108,52.870765,1,0
0,0,7,7,15,16,31,38,28,66,0.000333,0.108992,7,2288.838695,127.157705,326.976956,122.603359,2,0
0,0,5,5,9,14,23,18,21,39,0.000333,0.058806,4,705.675665,39.204204,176.418916,81.832294,2,0
0,0,6,6,9,15,24,19,23,42,0.000333,0.064189,4,770.2737,42.792983,192.568425,87.132684,2,0
0,0,5,5,10,16,26,19,20,39,0.000333,0.061106,5,916.585745,50.92143,183.317149,97.219281,2,0
0,0,6,6,10,17,27,20,22,42,0.000333,0.066568,5,998.526375,55.473688,199.705275,102.706149,2,0
0,0,17,17,11,25,36,56,78,134,0.000333,0.230923,15,10391.54925,577.308292,692.76995,154.150153,3,0
0,0,18,18,11,25,36,57,80,137,0.000333,0.236093,15,10624.19588,590.233104,708.279725,154.150153,3,0
0,0,17,17,14,28,42,61,86,147,0.000333,0.264224,21,16646.08388,924.782438,792.670661,187.908907,4,0
0,0,18,18,14,28,42,62,88,150,0.000333,0.269616,21,16985.79988,943.655549,808.847613,187.908907,4,0
0,0,13,13,12,17,29,45,69,114,0.000333,0.184603,24,13291.436,738.413111,553.809833,112.506418,3,0
0,0,13,13,12,19,31,43,68,111,0.000333,0.183305,18,9898.484228,549.91579,549.91579,123.730173,2,0
0,0,13,13,14,17,31,49,71,120,0.000333,0.198168,28,16646.0996,924.783311,594.503557,122.789837,4,0
0,0,13,13,14,19,33,47,70,117,0.000333,0.196731,21,12394.07635,688.559797,590.194112,134.013592,3,0
0,0,13,13,13,24,37,54,49,103,0.000333,0.178858,12,6438.88436,357.715798,536.573697,158.144816,3,0
0,0,14,14,13,24,37,55,51,106,0.000333,0.184067,12,6626.424681,368.134705,552.202057,158.144816,3,0
0,0,13,13,16,27,43,59,51,110,0.000333,0.198963,8,4775.112984,265.284055,596.889123,192.381963,4,0
0,0,14,14,16,27,43,60,53,113,0.000333,0.204389,8,4905.343338,272.519074,613.167917,192.381963,4,0
0,0,14,14,16,19,35,53,49,102,0.000333,0.174396,16,8370.989884,465.054994,523.186868,144.710623,3,0
0,0,14,14,16,21,37,51,48,99,0.000333,0.171912,16,8251.774131,458.431896,515.735883,156.238666,2,0
0,0,16,16,20,25,45,71,60,131,0.000333,0.239811,20,14388.65511,799.369728,719.432756,202.534967,5,0
0,0,16,16,19,27,46,69,59,128,0.000333,0.235672,18,12726.28675,707.01593,707.01593,209.092585,4,0
0,0,11,11,14,17,31,53,33,86,0.000333,0.14202,7,2982.426179,165.690343,426.060883,122.789837,2,0
0,0,9,9,12,14,26,44,29,73,0.000333,0.114377,12,4117.585193,228.754733,343.132099,96.322519,2,0
0,0,9,9,12,14,26,44,29,73,0.000333,0.114377,12,4117.585193,228.754733,343.132099,96.322519,2,0
0,0,9,9,13,15,28,45,30,75,0.000333,0.120184,12,4326.61943,240.367746,360.551619,106.709075,2,0
0,0,9,9,12,15,27,44,30,74,0.000333,0.117287,12,4222.340102,234.57445,351.861675,101.622909,2,0
0,0,7,7,8,10,18,19,19,38,0.000333,0.052819,4,633.8286,35.2127,158.45715,57.219281,1,0
0,0,3,3,10,11,21,13,14,27,0.000333,0.039531,5,592.962852,32.942381,118.59257,71.273029,1,0
0,0,5,5,11,14,25,20,23,43,0.000333,0.066562,5,998.429081,55.468282,199.685816,91.356717,1,0
0,0,15,15,18,18,36,66,47,113,0.000333,0.194734,18,10515.62745,584.201525,584.201525,150.1173,3,0
0,0,9,9,16,14,30,42,33,75,0.000333,0.122672,16,5888.268715,327.12604,368.016795,117.302969,2,0
0,0,16,16,21,22,43,76,53,129,0.000333,0.233329,20,13999.76307,777.764615,699.988153,190.346161,3,0
0,0,10,10,19,17,36,52,39,91,0.000333,0.156821,18,8468.337152,470.463175,470.463175,150.197491,2,0
0,0,13,13,14,20,34,48,54,102,0.000333,0.172974,14,7264.896937,403.605385,518.92121,139.741531,2,0
0,0,13,13,15,22,37,50,57,107,0.000333,0.185804,14,7803.761142,433.542286,557.41151,156.710855,2,0
0,0,15,15,15,24,39,58,65,123,0.000333,0.216701,14,9101.462621,505.636812,650.104473,168.642459,2,0
0,0,14,14,16,25,41,54,49,103,0.000333,0.183943,8,4414.622852,245.256825,551.827856,180.096405,2,0
0,0,11,11,16,19,35,45,36,81,0.000333,0.138491,8,3323.775395,184.654189,415.471924,144.710623,2,0
0,0,11,11,14,19,33,42,42,84,0.000333,0.141243,14,5932.207484,329.567082,423.729106,134.013592,2,0
0,0,11,11,15,21,36,44,43,87,0.000333,0.149928,14,6296.968652,349.831592,449.783475,150.842025,2,0
0,0,13,13,15,23,38,52,51,103,0.000333,0.180179,14,7567.511474,420.417304,540.536534,162.645284,2,0
0,0,12,12,14,17,31,37,30,67,0.000333,0.110644,7,2323.51807,129.084337,331.931153,122.789837,3,0
0,0,12,12,14,17,31,37,30,67,0.000333,0.110644,7,2323.51807,129.084337,331.931153,122.789837,3,0
0,0,8,8,13,12,25,26,19,45,0.000333,0.069658,6,1253.841171,69.657843,208.973529,91.125266,3,0
0,0,8,8,13,12,25,26,19,45,0.000333,0.069658,6,1253.841171,69.657843,208.973529,91.125266,3,0
0,0,10,10,19,21,40,56,45,101,0.000333,0.179172,18,9675.265277,537.514738,537.514738,172.949289,2,0
0,0,5,5,8,8,16,11,12,23,0.000333,0.030667,4,368,20.444444,92,48,1,0
0,0,5,5,9,9,18,12,13,25,0.000333,0.034749,4,416.9925,23.16625,104.248125,57.05865,1,0
0,0,15,15,15,17,32,59,41,100,0.000333,0.166667,14,7000,388.888889,500,128.090227,3,0
0,0,12,12,15,16,31,45,31,76,0.000333,0.125506,7,2635.632437,146.424024,376.51892,122.603359,3,0
0,0,15,15,15,17,32,59,41,100,0.000333,0.166667,14,7000,388.888889,500,128.090227,3,0
0,0,12,12,15,16,31,45,31,76,0.000333,0.125506,7,2635.632437,146.424024,376.51892,122.603359,3,0
0,0,13,13,18,17,35,56,40,96,0.000333,0.164137,18,8863.401053,492.41117,492.41117,144.545518,3,0
0,0,13,13,17,17,34,55,40,95,0.000333,0.161103,16,7732.943519,429.607973,483.30897,138.973737,3,0
0,0,17,17,18,19,37,74,50,124,0.000333,0.215324,18,11627.49991,645.972217,645.972217,155.769273,4,0
0,0,17,17,18,19,37,74,50,124,0.000333,0.215324,18,11627.49991,645.972217,645.972217,155.769273,4,0
0,0,15,15,15,19,34,61,41,102,0.000333,0.172974,14,7264.896937,403.605385,518.92121,139.313982,3,0
0,0,15,15,15,19,34,60,41,101,0.000333,0.171278,14,7193.672458,399.64847,513.833747,139.313982,3,0
0,0,12,12,16,18,34,50,37,87,0.000333,0.147536,16,7081.748275,393.43046,442.609267,139.05865,3,0
0,0,12,12,15,20,35,60,41,101,0.000333,0.172686,14,7252.806186,402.933677,518.057585,145.041921,3,0
0,0,12,12,15,20,35,60,41,101,0.000333,0.172686,14,7252.806186,402.933677,518.057585,145.041921,3,0
0,0,7,7,7,14,21,22,24,46,0.000333,0.067349,3,606.139804,33.674434,202.046601,72.954453,1,0
0,0,7,7,9,16,25,27,24,51,0.000333,0.078946,4,947.346663,52.63037,236.836666,92.529325,1,0
0,0,15,15,14,23,37,59,61,120,0.000333,0.208378,14,8751.881654,486.215647,625.134404,157.344894,1,0
0,0,7,7,14,17,31,35,29,64,0.000333,0.10569,7,2219.479947,123.304442,317.068564,122.789837,1,0
0,0,13,13,16,22,38,57,54,111,0.000333,0.194173,16,9320.319264,517.795515,582.519954,162.107496,1,0
0,0,15,15,17,21,38,61,71,132,0.000333,0.230909,24,16625.43436,923.635242,692.726432,161.725534,1,0
0,0,12,12,15,20,35,54,40,94,0.000333,0.160718,14,6750.13645,375.007581,482.152604,145.041921,3,0
0,0,12,12,15,20,35,54,40,94,0.000333,0.160718,14,6750.13645,375.007581,482.152604,145.041921,3,0
0,0,12,12,15,21,36,55,41,96,0.000333,0.165438,7,3474.189601,193.010533,496.3128,150.842025,3,0
0,0,12,12,15,21,36,54,41,95,0.000333,0.163714,7,3438.000126,191.000007,491.142875,150.842025,3,0
0,0,14,14,18,26,44,68,62,130,0.000333,0.236575,18,12775.06999,709.72611,709.72611,197.270083,2,0
0,0,14,14,16,21,37,59,43,102,0.000333,0.177121,16,8501.827893,472.323772,531.364243,156.238666,3,0
0,0,14,14,16,21,37,59,43,102,0.000333,0.177121,16,8501.827893,472.323772,531.364243,156.238666,3,0
0,0,13,13,13,17,30,45,69,114,0.000333,0.186462,24,13425.25267,745.847371,559.385528,117.592585,3,0
0,0,13,13,12,19,31,43,68,111,0.000333,0.183305,18,9898.484228,549.91579,549.91579,123.730173,2,0
0,0,13,13,14,17,31,49,71,120,0.000333,0.198168,28,16646.0996,924.783311,594.503557,122.789837,4,0
0,0,13,13,14,19,33,47,70,117,0.000333,0.196731,21,12394.07635,688.559797,590.194112,134.013592,3,0
0,0,16,16,15,19,34,50,70,120,0.000333,0.203499,21,12820.40636,712.244798,610.495541,139.313982,3,0
0,0,16,16,14,21,35,48,69,117,0.000333,0.200042,21,12602.64837,700.147132,600.126113,145.541635,2,0
0,0,15,15,16,18,34,52,70,122,0.000333,0.20689,24,14896.0912,827.560622,620.670467,139.05865,4,0
0,0,15,15,16,20,36,50,69,119,0.000333,0.205074,24,14765.3058,820.294767,615.221075,150.438562,3,0
0,0,15,15,14,16,30,56,41,97,0.000333,0.158656,14,6663.557429,370.197635,475.968388,117.302969,3,0
0,0,12,12,14,16,30,42,31,73,0.000333,0.119401,7,2507.421094,139.301172,358.203013,117.302969,3,0
0,0,10,10,14,15,29,37,28,65,0.000333,0.105256,7,2210.381353,122.798964,315.768765,111.906328,2,0
0,0,15,15,14,15,29,56,41,97,0.000333,0.157075,14,6597.138191,366.507677,471.224157,111.906328,3,0
0,0,12,12,14,15,29,42,31,73,0.000333,0.118211,14,4964.856577,275.825365,354.632613,111.906328,3,0
0,0,10,10,14,15,29,37,28,65,0.000333,0.105256,7,2210.381353,122.798964,315.768765,111.906328,2,0
0,0,12,12,13,17,30,52,46,98,0.000333,0.160292,12,5770.50334,320.583519,480.875278,117.592585,1,0
0,0,13,13,14,17,31,57,50,107,0.000333,0.1767,14,7421.386073,412.299226,530.099005,122.789837,1,0
0,0,7,7,13,14,27,34,29,63,0.000333,0.099853,12,3594.694952,199.705275,299.557913,101.408685,1,0
0,0,7,7,9,12,21,22,21,43,0.000333,0.062957,4,755.478597,41.971033,188.869649,71.548875,1,0
0,0,6,6,8,12,20,20,19,39,0.000333,0.056185,4,674.220783,37.45671,168.555196,67.01955,1,0
0,0,10,10,13,16,29,44,35,79,0.000333,0.127927,12,4605.365983,255.853666,383.780499,112.105716,2,0
0,0,12,12,13,22,35,52,55,107,0.000333,0.182944,12,6585.999394,365.888855,548.833283,146.213212,1,0
0,0,22,22,19,26,45,86,79,165,0.000333,0.302052,27,24466.20554,1359.233641,906.155761,202.922055,3,0
0,0,11,11,13,20,33,46,40,86,0.000333,0.144606,12,5205.814731,289.21193,433.817894,134.544278,2,0
0,0,12,12,15,19,34,55,38,93,0.000333,0.157711,14,6623.876619,367.993146,473.134044,139.313982,3,0
0,0,12,12,15,19,34,54,38,92,0.000333,0.156016,14,6552.65214,364.03623,468.046581,139.313982,3,0
0,0,12,12,15,18,33,55,38,93,0.000333,0.156376,14,6567.801143,364.877841,469.128653,133.662009,3,0
0,0,12,12,15,18,33,54,38,92,0.000333,0.154695,14,6497.179626,360.954424,464.084259,133.662009,3,0
0,0,16,16,14,21,35,58,56,114,0.000333,0.194913,14,8186.335695,454.796428,584.738264,145.541635,2,0
0,0,15,15,14,21,35,56,54,110,0.000333,0.188074,14,7899.095846,438.838658,564.221132,145.541635,2,0
0,0,16,16,15,22,37,58,56,114,0.000333,0.197959,14,8314.287572,461.904865,593.877684,156.710855,2,0
0,0,15,15,15,22,37,56,54,110,0.000333,0.191013,14,8022.558183,445.697677,573.03987,156.710855,2,0
0,0,20,20,15,22,37,73,70,143,0.000333,0.248317,21,15643.98846,869.11047,744.951831,156.710855,2,0
0,0,10,10,13,18,31,43,37,80,0.000333,0.132112,12,4756.028458,264.223803,396.335705,123.164366,2,0
0,0,5,5,5,10,15,9,17,26,0.000333,0.03386,2,203.158311,11.286573,101.579155,44.828921,1,0
0,0,5,5,7,13,20,11,17,28,0.000333,0.040338,3,363.04196,20.168998,121.013987,67.757201,1,0
0,0,8,8,13,21,34,31,35,66,0.000333,0.111924,6,2014.635285,111.924183,335.772548,140.344382,2,0
0,0,13,13,14,21,35,51,48,99,0.000333,0.169266,14,7109.186261,394.954792,507.799019,145.541635,2,0
0,0,13,13,15,23,38,53,49,102,0.000333,0.17843,14,7494.040489,416.335583,535.288606,162.645284,2,0
0,0,15,15,15,25,40,61,57,118,0.000333,0.209329,14,8791.825213,488.434734,627.987515,174.699764,2,0
0,0,18,18,16,24,40,70,69,139,0.000333,0.246583,16,11835.96808,657.553782,739.748005,174.0391,3,0
0,0,18,18,16,24,40,70,69,139,0.000333,0.246583,16,11835.96808,657.553782,739.748005,174.0391,3,0
0,0,14,14,13,21,34,55,58,113,0.000333,0.191628,12,6898.599613,383.255534,574.883301,140.344382,1,0
0,0,5,5,9,15,24,23,25,48,0.000333,0.073359,4,880.3128,48.906267,220.0782,87.132684,1,0
0,0,7,7,11,10,21,22,18,40,0.000333,0.058564,5,878.463485,48.803527,175.692697,71.273029,2,0
0,0,5,5,11,10,21,22,18,40,0.000333,0.058564,5,878.463485,48.803527,175.692697,71.273029,2,0
0,0,7,7,11,9,20,22,18,40,0.000333,0.057626,10,1728.771238,96.042847,172.877124,66.583073,2,0
0,0,15,15,14,19,33,59,48,107,0.000333,0.179917,14,7556.502391,419.805688,539.750171,134.013592,2,0
0,0,15,15,15,22,37,60,49,109,0.000333,0.189277,14,7949.625836,441.64588,567.830417,156.710855,2,0
0,0,12,12,11,18,29,48,42,90,0.000333,0.145739,10,4372.182896,242.89905,437.21829,113.112398,1,0
0,0,15,15,16,17,33,65,44,109,0.000333,0.18328,16,8797.423344,488.745741,549.838959,133.486868,3,0
0,0,9,9,14,14,28,35,26,61,0.000333,0.09775,7,2052.740552,114.041142,293.24865,106.605938,2,0
0,0,15,15,16,17,33,65,44,109,0.000333,0.18328,16,8797.423344,488.745741,549.838959,133.486868,3,0
0,0,9,9,14,14,28,35,26,61,0.000333,0.09775,7,2052.740552,114.041142,293.24865,106.605938,2,0
0,0,13,13,18,20,38,68,45,113,0.000333,0.197672,18,10674.28456,593.015809,593.015809,161.497212,3,0
0,0,18,18,16,19,35,75,48,123,0.000333,0.210301,16,10094.42898,560.80161,630.901811,144.710623,3,0
0,0,11,11,15,15,30,48,33,81,0.000333,0.132486,14,5564.413935,309.134108,397.458138,117.206718,2,0
0,0,18,18,16,19,35,75,48,123,0.000333,0.210301,16,10094.42898,560.80161,630.901811,144.710623,3,0
0,0,11,11,15,15,30,48,33,81,0.000333,0.132486,14,5564.413935,309.134108,397.458138,117.206718,2,0
0,0,12,12,15,20,35,63,40,103,0.000333,0.176105,14,7396.42611,410.912562,528.316151,145.041921,3,0
0,0,12,12,15,20,35,62,40,102,0.000333,0.174396,14,7324.616148,406.923119,523.186868,145.041921,3,0
0,0,12,12,16,19,35,62,39,101,0.000333,0.172686,16,8288.921355,460.495631,518.057585,144.710623,3,0
0,0,12,12,16,19,35,62,39,101,0.000333,0.172686,16,8288.921355,460.495631,518.057585,144.710623,3,0
0,0,17,17,16,22,38,67,78,145,0.000333,0.25365,24,18262.78775,1014.599319,760.949489,162.107496,2,0
0,0,8,8,15,13,28,37,29,66,0.000333,0.105762,14,4441.995948,246.777553,317.285425,106.709075,2,0
0,0,13,13,12,21,33,69,53,122,0.000333,0.205139,12,7384.992991,410.277388,615.416083,135.258216,1,0
0,0,12,12,16,23,39,55,64,119,0.000333,0.209654,16,10063.40583,559.078101,628.962864,168.041925,1,0
0,0,14,14,18,22,40,49,53,102,0.000333,0.180946,18,9771.059982,542.836666,542.836666,173.166146,2,0
0,0,8,8,12,12,24,30,25,55,0.000333,0.084058,12,3026.07525,168.115292,252.172938,86.0391,2,0
0,0,11,11,11,16,27,37,37,74,0.000333,0.117287,10,3518.616752,195.478708,351.861675,102.053748,1,0
0,0,14,14,15,20,35,49,44,93,0.000333,0.159008,14,6678.326488,371.018138,477.023321,145.041921,2,0
0,0,11,11,15,22,37,47,33,80,0.000333,0.138919,7,2917.293885,162.071882,416.756269,156.710855,5,0
0,0,12,12,15,22,37,48,35,83,0.000333,0.144128,7,3026.692405,168.149578,432.384629,156.710855,5,0
0,0,11,11,15,22,37,47,33,80,0.000333,0.138919,7,2917.293885,162.071882,416.756269,156.710855,5,0
0,0,12,12,15,22,37,48,35,83,0.000333,0.144128,7,3026.692405,168.149578,432.384629,156.710855,5,0
0,0,8,8,8,15,23,30,27,57,0.000333,0.085948,4,1031.372126,57.298451,257.843031,82.603359,1,0
0,0,8,8,9,17,26,31,26,57,0.000333,0.089308,4,1071.700256,59.538903,267.925064,98.016193,1,0
0,0,14,14,12,21,33,62,52,114,0.000333,0.191687,12,6900.731155,383.373953,575.06093,135.258216,1,0
0,0,5,5,10,14,24,26,22,48,0.000333,0.073359,5,1100.391,61.132833,220.0782,86.52225,1,0
0,0,16,16,14,23,37,67,54,121,0.000333,0.210115,14,8824.814001,490.267445,630.343857,157.344894,2,0
0,0,14,14,13,21,34,54,57,111,0.000333,0.188236,12,6776.500505,376.47225,564.708375,140.344382,1,0
0,0,5,5,9,15,24,23,25,48,0.000333,0.073359,4,880.3128,48.906267,220.0782,87.132684,1,0
0,0,4,4,9,14,23,16,21,37,0.000333,0.055791,4,669.487169,37.193732,167.371792,81.832294,1,0
0,0,10,10,14,21,35,44,32,76,0.000333,0.129942,7,2728.778565,151.598809,389.825509,145.541635,4,0
0,0,11,11,14,21,35,45,34,79,0.000333,0.135071,7,2836.493508,157.582973,405.213358,145.541635,4,0
0,0,29,29,19,52,71,127,104,231,0.000333,0.473531,18,25570.64852,1420.591585,1420.591585,377.133488,10,0
0,0,28,28,19,52,71,126,102,228,0.000333,0.467381,9,12619.28109,701.071172,1402.142343,377.133488,10,0
0,0,29,29,22,54,76,132,108,240,0.000333,0.499834,22,32989.05727,1832.725404,1499.502603,408.871421,11,0
0,0,28,28,22,54,76,131,106,237,0.000333,0.493586,11,16288.34703,904.908168,1480.758821,408.871421,11,0
0,0,29,29,22,54,76,132,108,240,0.000333,0.499834,22,32989.05727,1832.725404,1499.502603,408.871421,11,0
0,0,28,28,22,54,76,131,106,237,0.000333,0.493586,11,16288.34703,904.908168,1480.758821,408.871421,11,0
0,0,32,32,25,53,78,146,121,267,0.000333,0.559401,24,40276.85742,2237.60319,1678.202392,419.676189,13,0
0,0,32,32,24,55,79,144,120,264,0.000333,0.554733,24,39940.75482,2218.930823,1664.198118,428.013884,12,0
0,0,32,32,25,53,78,146,121,267,0.000333,0.559401,24,40276.85742,2237.60319,1678.202392,419.676189,13,0
0,0,32,32,24,55,79,144,120,264,0.000333,0.554733,24,39940.75482,2218.930823,1664.198118,428.013884,12,0
0,0,13,13,14,18,32,43,47,90,0.000333,0.15,14,6300,350,450,128.361619,4,0
0,0,13,13,14,20,34,41,46,87,0.000333,0.147536,14,6196.529741,344.251652,442.609267,139.741531,3,0
0,0,14,14,15,18,33,57,45,102,0.000333,0.171509,14,7203.394802,400.1886,514.5282,133.662009,2,0
0,0,14,14,15,16,31,62,43,105,0.000333,0.173397,14,7282.668576,404.592699,520.190613,122.603359,2,0
0,0,9,9,14,14,28,35,26,61,0.000333,0.09775,7,2052.740552,114.041142,293.24865,106.605938,2,0
0,0,5,5,5,10,15,9,17,26,0.000333,0.03386,2,203.158311,11.286573,101.579155,44.828921,1,0
0,0,11,11,17,24,41,45,42,87,0.000333,0.155369,8,3728.856195,207.158678,466.107024,179.525968,3,0
0,0,5,5,7,13,20,11,17,28,0.000333,0.040338,3,363.04196,20.168998,121.013987,67.757201,1,0
0,0,5,5,11,15,26,20,22,42,0.000333,0.065806,5,987.092341,54.838463,197.418468,96.657107,2,0
0,0,16,16,18,21,39,62,52,114,0.000333,0.200845,18,10845.64535,602.535853,602.535853,167.297316,3,0
0,0,10,10,14,16,30,33,28,61,0.000333,0.099773,7,2095.242284,116.402349,299.320326,117.302969,2,0
0,0,5,5,11,15,26,20,22,42,0.000333,0.065806,5,987.092341,54.838463,197.418468,96.657107,2,0
0,0,16,16,17,21,38,59,52,111,0.000333,0.194173,16,9320.319264,517.795515,582.519954,161.725534,3,0
0,0,11,11,14,16,30,36,32,68,0.000333,0.111223,14,4671.359847,259.519992,333.668561,117.302969,2,0
0,0,15,15,12,19,31,46,63,109,0.000333,0.180002,18,9720.133161,540.007398,540.007398,123.730173,2,0
0,0,15,15,14,22,36,48,68,116,0.000333,0.199904,21,12593.9373,699.663184,599.7113,151.410465,2,0
0,0,5,5,12,16,28,23,24,47,0.000333,0.075315,6,1355.674088,75.315227,225.945681,107.01955,2,0
0,0,20,20,17,27,44,71,88,159,0.000333,0.28935,24,20833.19106,1157.399503,868.049627,197.868831,3,0
0,0,5,5,12,17,29,23,25,48,0.000333,0.077728,6,1399.098527,77.727696,233.183088,112.506418,2,0
0,0,13,13,12,18,30,40,51,91,0.000333,0.148842,12,5358.32453,297.684696,446.527044,118.0782,2,0
0,0,13,13,14,21,35,42,54,96,0.000333,0.164137,14,6893.756375,382.986465,492.41117,145.541635,2,0
0,0,5,5,12,16,28,23,24,47,0.000333,0.075315,6,1355.674088,75.315227,225.945681,107.01955,2,0
0,0,18,18,17,26,43,65,74,139,0.000333,0.251417,16,12068.01281,670.445156,754.250801,191.698301,3,0
0,0,5,5,12,17,29,23,25,48,0.000333,0.077728,6,1399.098527,77.727696,233.183088,112.506418,2,0
0,0,12,12,12,13,25,31,27,58,0.000333,0.089781,12,3232.123908,179.562439,269.343659,91.125266,3,0
0,0,7,7,7,13,20,18,22,40,0.000333,0.057626,3,518.631371,28.812854,172.877124,67.757201,1,0
0,0,7,7,8,15,23,17,21,38,0.000333,0.057298,4,687.581417,38.198968,171.895354,82.603359,1,0
0,0,7,7,8,15,23,19,21,40,0.000333,0.060314,4,723.769913,40.20944,180.942478,82.603359,1,0
0,0,15,15,12,22,34,48,49,97,0.000333,0.164495,12,5921.806747,328.989264,493.483896,141.127046,2,0
0,0,15,15,14,23,37,54,51,105,0.000333,0.182331,14,7657.896447,425.438692,546.992603,157.344894,3,0
0,0,5,5,5,10,15,9,17,26,0.000333,0.03386,2,203.158311,11.286573,101.579155,44.828921,1,0
0,0,8,8,15,21,36,38,33,71,0.000333,0.122355,7,2569.452726,142.747374,367.064675,150.842025,2,0
0,0,5,5,7,13,20,11,17,28,0.000333,0.040338,3,363.04196,20.168998,121.013987,67.757201,1,0
0,0,5,5,11,15,26,20,22,42,0.000333,0.065806,5,987.092341,54.838463,197.418468,96.657107,2,0
0,0,15,15,18,22,40,67,50,117,0.000333,0.207555,18,11207.98057,622.665587,622.665587,173.166146,4,0
0,0,15,15,18,22,40,67,50,117,0.000333,0.207555,18,11207.98057,622.665587,622.665587,173.166146,4,0
0,0,5,5,11,15,26,20,22,42,0.000333,0.065806,5,987.092341,54.838463,197.418468,96.657107,2,0
0,0,17,17,19,23,42,72,53,125,0.000333,0.22468,18,12132.7142,674.039678,674.039678,184.752548,4,0
0,0,17,17,19,23,42,72,53,125,0.000333,0.22468,18,12132.7142,674.039678,674.039678,184.752548,4,0
0,0,11,11,14,17,31,49,39,88,0.000333,0.145323,14,6103.569854,339.087214,435.969275,122.789837,2,0
0,0,11,11,14,17,31,49,39,88,0.000333,0.145323,14,6103.569854,339.087214,435.969275,122.789837,2,0
0,0,13,13,15,16,31,57,45,102,0.000333,0.168443,14,7074.592331,393.032907,505.328024,122.603359,2,0
0,0,13,13,15,16,31,57,45,102,0.000333,0.168443,14,7074.592331,393.032907,505.328024,122.603359,2,0
2,0,6,8,12,13,25,28,19,47,0.000333,0.072754,6,1309.567446,72.753747,218.261241,91.125266,1,0
2,0,6,8,12,13,25,28,19,47,0.000333,0.072754,6,1309.567446,72.753747,218.261241,91.125266,1,0
0,0,8,8,8,15,23,30,27,57,0.000333,0.085948,4,1031.372126,57.298451,257.843031,82.603359,1,0
0,0,8,8,9,17,26,31,26,57,0.000333,0.089308,4,1071.700256,59.538903,267.925064,98.016193,1,0
0,0,22,22,18,26,44,94,74,168,0.000333,0.305728,18,16509.32122,917.184512,917.184512,197.270083,3,0
0,0,11,11,13,19,32,49,37,86,0.000333,0.143333,6,2580,143.333333,430,128.816339,2,0
0,0,17,17,15,24,39,71,57,128,0.000333,0.22551,14,9471.440776,526.191154,676.531484,168.642459,2,0
2,0,12,14,15,14,29,39,30,69,0.000333,0.111734,14,4692.809641,260.711647,335.200689,111.906328,3,0
0,0,5,5,9,13,22,26,20,46,0.000333,0.068378,4,820.535418,45.585301,205.133854,76.635041,1,0
0,0,8,8,9,14,23,36,29,65,0.000333,0.098011,8,2352.252217,130.680679,294.031527,81.832294,1,0
0,0,4,4,8,12,20,20,17,37,0.000333,0.053304,4,639.645358,35.535853,159.91134,67.01955,1,0
0,0,3,3,7,8,15,12,11,23,0.000333,0.029953,3,269.575451,14.976414,89.858484,43.651484,1,0
0,0,9,9,12,12,24,29,25,54,0.000333,0.082529,12,2971.0557,165.05865,247.587975,86.0391,2,0
0,0,15,15,13,19,32,55,48,103,0.000333,0.171667,12,6180,343.333333,515,128.816339,2,0
0,0,9,9,9,14,23,29,28,57,0.000333,0.085948,8,2062.744252,114.596903,257.843031,81.832294,1,0
0,0,15,15,14,22,36,56,49,105,0.000333,0.180947,14,7599.789752,422.210542,542.842125,151.410465,2,0
0,0,9,9,10,17,27,30,28,58,0.000333,0.091928,5,1378.917376,76.606521,275.783475,102.706149,1,0
0,0,13,13,10,19,29,48,45,93,0.000333,0.150597,10,4517.922325,250.995685,451.792233,113.929904,1,0
0,0,16,16,14,23,37,60,52,112,0.000333,0.194486,14,8168.422877,453.801271,583.458777,157.344894,2,0
0,0,15,15,19,20,39,74,55,129,0.000333,0.227272,18,12272.70395,681.816886,681.816886,167.149185,2,0
0,0,10,10,19,17,36,52,39,91,0.000333,0.156821,18,8468.337152,470.463175,470.463175,150.197491,2,0
0,0,15,15,19,20,39,77,55,132,0.000333,0.232558,18,12558.11567,697.673093,697.673093,167.149185,2,0
0,0,10,10,19,17,36,52,39,91,0.000333,0.156821,18,8468.337152,470.463175,470.463175,150.197491,2,0
0,0,10,10,11,14,25,38,29,67,0.000333,0.103713,10,3111.383647,172.854647,311.138365,91.356717,2,0
0,0,12,12,14,17,31,47,35,82,0.000333,0.135415,14,5687.417364,315.967631,406.244097,122.789837,2,0
0,0,10,10,11,14,25,38,29,67,0.000333,0.103713,10,3111.383647,172.854647,311.138365,91.356717,2,0
0,0,12,12,14,17,31,47,35,82,0.000333,0.135415,14,5687.417364,315.967631,406.244097,122.789837,2,0
0,0,16,16,15,24,39,50,52,102,0.000333,0.179704,14,7547.554369,419.308576,539.111026,168.642459,2,0
0,0,11,11,14,17,31,35,32,67,0.000333,0.110644,7,2323.51807,129.084337,331.931153,122.789837,2,0
0,0,15,15,12,20,32,45,63,108,0.000333,0.18,18,9720,540,540,129.458112,2,0
0,0,15,15,13,21,34,46,67,113,0.000333,0.191628,18,10347.89942,574.883301,574.883301,140.344382,2,0
0,0,19,19,14,24,38,60,82,142,0.000333,0.248402,21,15649.31985,869.406658,745.205707,163.342069,2,0
0,0,9,9,12,11,23,27,22,49,0.000333,0.073885,12,2659.85443,147.769691,221.654536,81.073298,3,0
0,0,9,9,12,10,22,27,22,49,0.000333,0.072837,12,2622.145792,145.674766,218.512149,76.238831,3,0
0,0,10,10,12,12,24,28,23,51,0.000333,0.077944,6,1402.998525,77.944363,233.833088,86.0391,3,0
0,0,12,12,17,16,33,54,39,93,0.000333,0.156376,16,7506.05845,417.003247,469.128653,133.486868,3,0
0,0,10,10,14,14,28,45,32,77,0.000333,0.123389,14,5182.328606,287.907145,370.166329,106.605938,2,0
0,0,6,6,8,9,17,15,14,29,0.000333,0.039512,4,474.14569,26.341427,118.536422,52.529325,1,0
0,0,13,13,13,19,32,44,43,87,0.000333,0.145,12,5220,290,435,128.816339,2,0
0,0,13,13,14,20,34,45,43,88,0.000333,0.149232,14,6267.75422,348.208568,447.69673,139.741531,2,0
0,0,18,18,17,22,39,68,60,128,0.000333,0.22551,16,10824.50374,601.361319,676.531484,167.594364,3,0
0,0,10,10,13,17,30,44,35,79,0.000333,0.129215,12,4651.732285,258.429571,387.644357,117.592585,2,0
0,0,13,13,15,20,35,46,47,93,0.000333,0.159008,14,6678.326488,371.018138,477.023321,145.041921,3,0
0,0,13,13,16,22,38,47,47,94,0.000333,0.164435,16,7892.88298,438.493499,493.305186,162.107496,3,0
0,0,5,5,7,10,17,10,14,24,0.000333,0.0327,3,294.297325,16.349851,98.099108,52.870765,1,0
0,0,5,5,8,8,16,11,12,23,0.000333,0.030667,4,368,20.444444,92,48,1,0
0,0,26,26,19,46,65,114,88,202,0.000333,0.405506,9,10948.66468,608.259149,1216.518298,334.794473,9,0
0,0,13,13,15,13,28,44,38,82,0.000333,0.131401,14,5518.843451,306.602414,394.203104,106.709075,3,0
0,0,13,13,15,15,30,42,37,79,0.000333,0.129215,14,5427.020999,301.501167,387.644357,117.206718,2,0
0,0,26,26,19,44,63,115,88,203,0.000333,0.404463,18,21840.98084,1213.387824,1213.387824,320.925614,9,0
0,0,22,22,19,42,61,106,77,183,0.000333,0.361775,9,9767.924395,542.662466,1085.324933,307.187955,9,0
0,0,32,32,26,48,74,147,109,256,0.000333,0.529873,26,41330.1216,2296.117867,1589.620062,390.289633,12,0
0,0,32,32,25,50,75,145,108,253,0.000333,0.525297,24,37821.38709,2101.188172,1575.891129,398.289214,11,0
0,0,12,12,14,13,27,41,36,77,0.000333,0.122042,14,5125.768727,284.764929,366.126338,101.408685,3,0
0,0,12,12,14,15,29,39,35,74,0.000333,0.11983,14,5032.868311,279.603795,359.490594,111.906328,2,0
0,0,31,31,25,48,73,144,107,251,0.000333,0.517882,24,37287.50314,2071.527952,1553.645964,384.174605,12,0
0,0,31,31,24,50,74,142,106,248,0.000333,0.513315,24,36958.66643,2053.259246,1539.944435,392.23191,11,0
0,0,29,29,22,50,72,133,100,233,0.000333,0.479198,22,31627.03556,1757.057531,1437.592525,380.300305,11,0
0,0,28,28,22,50,72,132,98,230,0.000333,0.473028,11,15609.91025,867.217236,1419.08275,380.300305,11,0
0,0,12,12,14,22,36,50,42,92,0.000333,0.158544,7,3329.431701,184.968428,475.6331,151.410465,4,0
0,0,13,13,14,22,36,51,44,95,0.000333,0.163714,14,6876.000252,382.000014,491.142875,151.410465,4,0
0,0,12,12,14,22,36,50,42,92,0.000333,0.158544,7,3329.431701,184.968428,475.6331,151.410465,4,0
0,0,13,13,14,22,36,51,44,95,0.000333,0.163714,14,6876.000252,382.000014,491.142875,151.410465,4,0
0,0,19,19,16,25,41,71,69,140,0.000333,0.250019,16,12000.91649,666.717583,750.057281,180.096405,2,0
0,0,10,10,13,20,33,40,37,77,0.000333,0.129473,6,2330.510083,129.472782,388.418347,134.544278,2,0
0,0,8,8,8,15,23,30,27,57,0.000333,0.085948,4,1031.372126,57.298451,257.843031,82.603359,1,0
0,0,8,8,9,17,26,31,26,57,0.000333,0.089308,4,1071.700256,59.538903,267.925064,98.016193,1,0
0,0,19,19,15,25,40,79,64,143,0.000333,0.253679,14,10654.50005,591.916669,761.035718,174.699764,2,0
0,0,10,10,13,19,32,43,34,77,0.000333,0.128333,6,2310,128.333333,385,128.816339,2,0
0,0,16,16,14,23,37,65,54,119,0.000333,0.206642,14,8678.949307,482.16385,619.924951,157.344894,2,0
0,0,10,10,14,15,29,39,29,68,0.000333,0.110114,7,2312.398954,128.466609,330.342708,111.906328,2,0
0,0,17,17,16,23,39,70,57,127,0.000333,0.223749,16,10739.93731,596.663184,671.246082,168.041925,2,0
0,0,10,10,13,19,32,42,34,76,0.000333,0.126667,6,2280,126.666667,380,128.816339,2,0
0,0,18,18,16,24,40,79,61,140,0.000333,0.248357,16,11921.11893,662.284385,745.069933,174.0391,2,0
0,0,10,10,13,19,32,41,34,75,0.000333,0.125,6,2250,125,375,128.816339,2,0
0,0,12,12,13,20,33,46,50,96,0.000333,0.161421,12,5811.142026,322.841224,484.261835,134.544278,1,0
0,0,14,14,15,22,37,54,45,99,0.000333,0.171912,14,7220.302365,401.127909,515.735883,156.710855,2,0
0,0,14,14,16,23,39,55,47,102,0.000333,0.179704,16,8625.776421,479.209801,539.111026,168.041925,2,0
0,0,8,8,10,15,25,35,30,65,0.000333,0.100617,10,3018.506523,167.694807,301.850652,91.82264,1,0
0,0,8,8,11,18,29,36,29,65,0.000333,0.105256,5,1578.843823,87.713546,315.768765,113.112398,1,0
0,0,13,13,11,21,32,62,52,114,0.000333,0.19,10,5700,316.666667,570,130.292414,1,0
0,0,17,17,15,26,41,77,61,138,0.000333,0.246447,14,10350.79047,575.043915,739.342177,180.814792,2,0
0,0,7,7,9,12,21,20,24,44,0.000333,0.064421,8,1546.095733,85.894207,193.261967,71.548875,1,0
0,0,7,7,10,15,25,21,23,44,0.000333,0.06811,5,1021.648362,56.758242,204.329672,91.82264,1,0
0,0,5,5,9,15,24,19,24,43,0.000333,0.065718,4,788.61355,43.811864,197.153388,87.132684,1,0
0,0,5,5,10,12,22,20,16,36,0.000333,0.053513,5,802.697691,44.594316,160.539538,76.238831,2,0
0,0,3,3,8,7,15,13,11,24,0.000333,0.031255,4,375.061497,20.83675,93.765374,43.651484,1,0
0,0,3,3,11,13,24,18,17,35,0.000333,0.053491,5,802.368438,44.576024,160.473688,86.159464,1,0
0,0,12,12,16,13,29,45,32,77,0.000333,0.124688,16,5985.032586,332.50181,374.064537,112.105716,6,0
0,0,12,12,16,15,31,43,31,74,0.000333,0.122204,16,5865.768431,325.876024,366.610527,122.603359,5,0
0,0,12,12,16,12,28,45,32,77,0.000333,0.123389,16,5922.661264,329.036737,370.166329,107.01955,6,0
0,0,12,12,16,14,30,43,31,74,0.000333,0.121037,16,5809.758465,322.764359,363.109904,117.302969,5,0
0,0,10,10,15,12,27,35,28,63,0.000333,0.099853,14,4193.810777,232.989488,299.557913,101.622909,3,0
0,0,10,10,14,14,28,33,27,60,0.000333,0.096147,7,2019.089067,112.171615,288.441295,106.605938,2,0
0,0,10,10,16,11,27,39,30,69,0.000333,0.109362,16,5249.395802,291.6331,328.087238,102.053748,4,0
0,0,10,10,16,13,29,37,29,66,0.000333,0.106876,16,5130.027931,285.001552,320.626746,112.105716,3,0
0,0,15,15,19,24,43,74,63,137,0.000333,0.247799,18,13381.16889,743.398271,743.398271,190.749723,2,0
0,0,10,10,18,20,38,54,44,98,0.000333,0.171432,18,9257.344134,514.296896,514.296896,161.497212,2,0
0,0,19,19,19,26,45,86,91,177,0.000333,0.324019,27,26245.56595,1458.086997,972.057998,202.922055,2,0
0,0,10,10,18,20,38,54,44,98,0.000333,0.171432,18,9257.344134,514.296896,514.296896,161.497212,2,0
0,0,15,15,14,18,32,49,47,96,0.000333,0.16,14,6720,373.333333,480,128.361619,2,0
0,0,11,11,14,16,30,35,32,67,0.000333,0.109587,14,4602.663379,255.703521,328.76167,117.302969,2,0
0,0,13,13,15,17,32,46,41,87,0.000333,0.145,14,6090,338.333333,435,128.090227,2,0
0,0,9,9,14,14,28,32,26,58,0.000333,0.092942,7,1951.786098,108.432561,278.826585,106.605938,2,0
0,0,15,15,18,19,37,55,48,103,0.000333,0.178858,18,9658.32654,536.573697,536.573697,155.769273,3,0
0,0,11,11,17,18,35,41,33,74,0.000333,0.126522,8,3036.535546,168.696419,379.566943,144.545518,3,0
0,0,16,16,13,21,34,50,68,118,0.000333,0.200107,18,10805.77108,600.320615,600.320615,140.344382,2,0
0,0,16,16,14,22,36,51,72,123,0.000333,0.211967,21,13353.91628,741.884238,635.900775,151.410465,2,0
0,0,19,19,14,24,38,61,83,144,0.000333,0.251901,21,15869.7328,881.651822,755.701562,163.342069,2,0
0,0,15,15,13,21,34,52,77,129,0.000333,0.218761,18,11813.08872,656.282707,656.282707,140.344382,2,0
0,0,18,18,16,26,42,64,72,136,0.000333,0.244452,16,11733.68271,651.871262,733.355169,186.211433,2,0
0,0,5,5,11,15,26,20,22,42,0.000333,0.065806,5,987.092341,54.838463,197.418468,96.657107,2,0
0,0,15,15,18,22,40,66,48,114,0.000333,0.202233,18,10920.59645,606.699803,606.699803,173.166146,4,0
0,0,15,15,18,22,40,66,48,114,0.000333,0.202233,18,10920.59645,606.699803,606.699803,173.166146,4,0
0,0,5,5,11,15,26,20,22,42,0.000333,0.065806,5,987.092341,54.838463,197.418468,96.657107,2,0
0,0,15,15,18,22,40,67,49,116,0.000333,0.205781,18,11112.18586,617.343659,617.343659,173.166146,4,0
0,0,15,15,18,22,40,66,49,115,0.000333,0.204007,18,11016.39116,612.021731,612.021731,173.166146,4,0
0,0,5,5,11,15,26,20,22,42,0.000333,0.065806,5,987.092341,54.838463,197.418468,96.657107,2,0
0,0,15,15,18,21,39,66,48,114,0.000333,0.200845,18,10845.64535,602.535853,602.535853,167.297316,4,0
0,0,5,5,12,13,25,21,20,41,0.000333,0.063466,6,1142.388623,63.466035,190.398104,91.125266,2,0
0,0,15,15,18,21,39,66,48,114,0.000333,0.200845,18,10845.64535,602.535853,602.535853,167.297316,4,0
0,0,5,5,12,13,25,21,20,41,0.000333,0.063466,6,1142.388623,63.466035,190.398104,91.125266,2,0
0,0,5,5,11,15,26,20,22,42,0.000333,0.065806,5,987.092341,54.838463,197.418468,96.657107,2,0
0,0,14,14,18,21,39,63,47,110,0.000333,0.193798,18,10465.09639,581.394244,581.394244,167.297316,3,0
0,0,5,5,12,13,25,21,20,41,0.000333,0.063466,6,1142.388623,63.466035,190.398104,91.125266,2,0
0,0,31,31,19,54,73,140,111,251,0.000333,0.517882,18,27965.62736,1553.645964,1553.645964,391.474548,10,0
0,0,30,30,19,54,73,139,109,248,0.000333,0.511692,18,27631.37683,1535.076491,1535.076491,391.474548,10,0
0,0,31,31,22,56,78,145,113,258,0.000333,0.540545,22,35675.94299,1981.996833,1621.633772,423.319371,11,0
0,0,30,30,22,56,78,144,111,255,0.000333,0.534259,11,17630.55322,979.475179,1602.777566,423.319371,11,0
0,0,14,14,16,19,35,53,49,102,0.000333,0.174396,16,8370.989884,465.054994,523.186868,144.710623,3,0
0,0,14,14,16,21,37,51,48,99,0.000333,0.171912,16,8251.774131,458.431896,515.735883,156.238666,2,0
0,0,33,33,25,54,79,156,120,276,0.000333,0.579948,24,41756.24368,2319.791315,1739.843486,426.86033,12,0
0,0,33,33,24,56,80,154,119,273,0.000333,0.575295,24,41421.27288,2301.181827,1725.88637,435.250976,11,0
0,0,8,8,11,10,21,26,22,48,0.000333,0.070277,10,2108.312363,117.128465,210.831236,71.273029,2,0
0,0,9,9,11,10,21,25,22,47,0.000333,0.068813,10,2064.389189,114.688288,206.438919,71.273029,2,0
0,0,9,9,11,11,22,25,22,47,0.000333,0.069864,10,2095.932861,116.440714,209.593286,76.107496,2,0
0,0,9,9,13,15,28,31,27,58,0.000333,0.092942,6,1672.959513,92.942195,278.826585,106.709075,2,0
0,0,9,9,13,15,28,31,27,58,0.000333,0.092942,6,1672.959513,92.942195,278.826585,106.709075,2,0
0,0,9,9,13,15,28,31,27,58,0.000333,0.092942,6,1672.959513,92.942195,278.826585,106.709075,2,0
0,0,16,16,15,18,33,76,50,126,0.000333,0.211865,14,8898.311227,494.350624,635.593659,133.662009,3,0
0,0,10,10,15,14,29,45,31,76,0.000333,0.123069,14,5168.891779,287.160654,369.206556,111.906328,2,0
0,0,16,16,15,18,33,75,50,125,0.000333,0.210183,14,8827.689709,490.427206,630.549265,133.662009,3,0
0,0,10,10,15,14,29,45,31,76,0.000333,0.123069,14,5168.891779,287.160654,369.206556,111.906328,2,0
0,0,14,14,15,19,34,50,48,98,0.000333,0.16619,14,6979.999018,387.777723,498.571358,139.313982,2,0
0,0,14,14,15,19,34,50,48,98,0.000333,0.16619,14,6979.999018,387.777723,498.571358,139.313982,2,0
0,0,15,15,18,20,38,64,50,114,0.000333,0.199421,18,10768.74726,598.263737,598.263737,161.497212,3,0
0,0,12,12,17,17,34,53,44,97,0.000333,0.164495,16,7895.74233,438.652352,493.483896,138.973737,3,0
0,0,12,12,17,17,34,53,44,97,0.000333,0.164495,16,7895.74233,438.652352,493.483896,138.973737,3,0
0,0,11,11,16,16,32,50,43,93,0.000333,0.155,16,7440,413.333333,465,128,2,0
0,0,18,18,16,22,38,71,84,155,0.000333,0.271143,24,19522.29035,1084.571686,813.428765,162.107496,3,0
0,0,10,10,13,17,30,44,35,79,0.000333,0.129215,12,4651.732285,258.429571,387.644357,117.592585,2,0
0,0,20,20,19,25,44,92,70,162,0.000333,0.294809,18,15919.7026,884.427922,884.427922,196.807027,3,0
0,0,10,10,13,18,31,44,35,79,0.000333,0.130461,6,2348.289051,130.460503,391.381509,123.164366,2,0
0,0,8,8,8,15,23,31,28,59,0.000333,0.088963,4,1067.560622,59.308923,266.890155,82.603359,1,0
0,0,8,8,9,17,26,32,27,59,0.000333,0.092442,4,1109.303773,61.627987,277.325943,98.016193,1,0
0,0,21,21,18,26,44,92,73,165,0.000333,0.300269,18,16214.51191,900.806217,900.806217,197.270083,3,0
0,0,10,10,13,18,31,46,35,81,0.000333,0.133763,6,2407.739407,133.7633,401.289901,123.164366,2,0
0,0,16,16,15,24,39,69,56,125,0.000333,0.220225,14,9249.453883,513.858549,660.675277,168.642459,2,0
0,0,13,13,16,21,37,53,47,100,0.000333,0.173648,16,8335.125385,463.062521,520.945337,156.238666,3,0
0,0,10,10,13,17,30,41,33,74,0.000333,0.121037,6,2178.659424,121.036635,363.109904,117.592585,2,0
0,0,9,9,11,13,24,30,24,54,0.000333,0.082529,5,1237.939875,68.774438,247.587975,86.159464,2,0
0,0,11,11,14,16,30,39,30,69,0.000333,0.112858,7,2370.028158,131.668231,338.575451,117.302969,2,0
0,0,9,9,11,12,23,30,24,54,0.000333,0.081424,10,2442.723456,135.706859,244.272346,81.073298,2,0
0,0,11,11,14,16,30,39,30,69,0.000333,0.112858,7,2370.028158,131.668231,338.575451,117.302969,2,0
0,0,11,11,14,17,31,49,39,88,0.000333,0.145323,14,6103.569854,339.087214,435.969275,122.789837,2,0
0,0,11,11,14,17,31,49,39,88,0.000333,0.145323,14,6103.569854,339.087214,435.969275,122.789837,2,0
0,0,13,13,15,18,33,54,42,96,0.000333,0.161421,14,6779.665696,376.648094,484.261835,133.662009,2,0
0,0,13,13,15,19,34,54,42,96,0.000333,0.162799,14,6837.550059,379.863892,488.396433,139.313982,2,0
0,0,11,11,15,19,34,52,39,91,0.000333,0.15432,14,6481.42766,360.079314,462.959119,139.313982,2,0
0,0,20,20,16,25,41,80,73,153,0.000333,0.273235,16,13115.28731,728.627073,819.705457,180.096405,2,0
0,0,11,11,14,20,34,49,41,90,0.000333,0.152624,14,6410.20318,356.122399,457.871656,139.741531,2,0
0,0,8,8,8,15,23,30,27,57,0.000333,0.085948,4,1031.372126,57.298451,257.843031,82.603359,1,0
0,0,8,8,9,17,26,31,26,57,0.000333,0.089308,4,1071.700256,59.538903,267.925064,98.016193,1,0
0,0,20,20,15,25,40,88,68,156,0.000333,0.27674,14,11623.09096,645.727276,830.220783,174.699764,2,0
0,0,11,11,14,19,33,52,38,90,0.000333,0.151332,14,6355.93659,353.107588,453.995471,134.013592,2,0
0,0,17,17,15,24,39,74,58,132,0.000333,0.232558,14,9767.4233,542.634628,697.673093,168.642459,2,0
0,0,11,11,14,16,30,49,39,88,0.000333,0.143935,14,6045.289214,335.849401,431.806372,117.302969,2,0
0,0,11,11,14,17,31,49,39,88,0.000333,0.145323,14,6103.569854,339.087214,435.969275,122.789837,2,0
0,0,12,12,15,18,33,51,36,87,0.000333,0.146287,14,6144.072037,341.337335,438.862288,133.662009,3,0
0,0,11,11,15,17,32,46,31,77,0.000333,0.128333,7,2695,149.722222,385,128.090227,3,0
0,0,12,12,15,18,33,51,36,87,0.000333,0.146287,14,6144.072037,341.337335,438.862288,133.662009,3,0
0,0,11,11,15,17,32,46,31,77,0.000333,0.128333,7,2695,149.722222,385,128.090227,3,0
0,0,18,18,16,21,37,63,51,114,0.000333,0.197959,16,9502.042939,527.891274,593.877684,156.238666,3,0
0,0,12,12,15,18,33,44,31,75,0.000333,0.12611,7,2648.306913,147.128162,378.329559,133.662009,3,0
0,0,12,12,15,18,33,44,31,75,0.000333,0.12611,7,2648.306913,147.128162,378.329559,133.662009,3,0
0,0,9,9,11,14,25,48,32,80,0.000333,0.123836,10,3715.084952,206.393608,371.508495,91.356717,1,0
0,0,10,10,13,16,29,52,34,86,0.000333,0.139262,12,5013.436387,278.524244,417.786366,112.105716,2,0
0,0,10,10,12,16,28,51,34,85,0.000333,0.136208,12,4903.50202,272.416779,408.625168,107.01955,2,0
0,0,10,10,13,16,29,52,34,86,0.000333,0.139262,12,5013.436387,278.524244,417.786366,112.105716,2,0
0,0,10,10,12,16,28,51,34,85,0.000333,0.136208,12,4903.50202,272.416779,408.625168,107.01955,2,0
0,0,5,5,10,11,21,22,17,39,0.000333,0.0571,5,856.501897,47.583439,171.300379,71.273029,1,0
0,0,13,13,12,16,28,66,44,110,0.000333,0.17627,12,6345.708497,352.539361,528.809041,107.01955,1,0
0,0,13,13,17,13,30,58,43,101,0.000333,0.165199,24,11894.3028,660.7946,495.59595,117.592585,6,0
0,0,13,13,18,15,33,56,42,98,0.000333,0.164784,18,8898.311227,494.350624,494.350624,133.662009,5,0
0,0,13,13,15,14,29,53,41,94,0.000333,0.152217,14,6393.10299,355.172388,456.650214,111.906328,5,0
0,0,13,13,16,16,32,51,40,91,0.000333,0.151667,16,7280,404.444444,455,128,4,0
0,0,10,10,16,12,28,40,30,70,0.000333,0.112172,16,5384.237513,299.124306,336.514845,107.01955,4,0
0,0,10,10,16,14,30,38,29,67,0.000333,0.109587,16,5260.186718,292.232595,328.76167,117.302969,3,0
0,0,10,10,14,12,26,35,28,63,0.000333,0.098709,14,4145.787831,230.321546,296.127702,96.322519,3,0
0,0,10,10,14,14,28,33,27,60,0.000333,0.096147,7,2019.089067,112.171615,288.441295,106.605938,2,0
0,0,12,12,17,14,31,46,32,78,0.000333,0.128809,16,6182.836995,343.490944,386.427312,122.789837,6,0
0,0,12,12,17,16,33,44,31,75,0.000333,0.12611,8,3026.636472,168.146471,378.329559,133.486868,5,0
0,0,12,12,17,14,31,46,32,78,0.000333,0.128809,16,6182.836995,343.490944,386.427312,122.789837,6,0
0,0,12,12,17,16,33,44,31,75,0.000333,0.12611,8,3026.636472,168.146471,378.329559,133.486868,5,0
0,0,12,12,15,13,28,41,30,71,0.000333,0.113774,14,4778.510793,265.472822,341.322199,106.709075,5,0
0,0,12,12,15,15,30,39,29,68,0.000333,0.111223,7,2335.679924,129.759996,333.668561,117.206718,4,0
0,0,12,12,15,13,28,41,30,71,0.000333,0.113774,14,4778.510793,265.472822,341.322199,106.709075,5,0
0,0,12,12,15,15,30,39,29,68,0.000333,0.111223,7,2335.679924,129.759996,333.668561,117.206718,4,0
0,0,9,9,13,14,27,27,24,51,0.000333,0.080833,6,1454.995576,80.833088,242.499263,101.408685,2,0
0,0,10,10,12,12,24,36,27,63,0.000333,0.096284,12,3466.231651,192.568425,288.852638,86.0391,2,0
0,0,11,11,14,15,29,38,27,65,0.000333,0.105256,7,2210.381353,122.798964,315.768765,111.906328,3,0
0,0,10,10,12,13,25,36,27,63,0.000333,0.097521,12,3510.755279,195.04196,292.56294,91.125266,2,0
0,0,11,11,13,15,28,38,27,65,0.000333,0.104159,6,1874.86842,104.159357,312.47807,106.709075,3,0
0,0,10,10,12,13,25,36,27,63,0.000333,0.097521,12,3510.755279,195.04196,292.56294,91.125266,2,0
0,0,11,11,13,15,28,38,27,65,0.000333,0.104159,6,1874.86842,104.159357,312.47807,106.709075,3,0
0,0,8,8,16,19,35,43,32,75,0.000333,0.128232,8,3077.56981,170.976101,384.696226,144.710623,2,0
0,0,16,16,13,21,34,58,61,119,0.000333,0.201803,12,7264.896937,403.605385,605.408078,140.344382,2,0
0,0,16,16,14,23,37,59,63,122,0.000333,0.211851,14,8897.746348,494.319242,635.553311,157.344894,2,0
0,0,13,13,10,19,29,47,56,103,0.000333,0.166791,10,5003.720425,277.984468,500.372042,113.929904,1,0
0,0,12,12,12,17,29,39,40,79,0.000333,0.127927,12,4605.365983,255.853666,383.780499,112.506418,2,0
0,0,12,12,14,20,34,41,41,82,0.000333,0.139057,14,5840.407342,324.467075,417.171953,139.741531,2,0
0,0,5,5,12,16,28,23,24,47,0.000333,0.075315,6,1355.674088,75.315227,225.945681,107.01955,2,0
0,0,16,16,17,24,41,61,58,119,0.000333,0.212516,16,10200.77902,566.709945,637.548689,179.525968,3,0
0,0,5,5,12,17,29,23,25,48,0.000333,0.077728,6,1399.098527,77.727696,233.183088,112.506418,2,0
0,0,6,6,11,8,19,19,16,35,0.000333,0.049559,10,1486.77463,82.598591,148.677463,62.053748,2,0
0,0,6,6,11,10,21,23,18,41,0.000333,0.060028,5,900.425072,50.023615,180.085014,71.273029,2,0
0,0,7,7,11,10,21,22,18,40,0.000333,0.058564,5,878.463485,48.803527,175.692697,71.273029,2,0
0,0,13,13,15,19,34,53,42,95,0.000333,0.161103,14,6766.325579,375.906977,483.30897,139.313982,2,0
0,0,5,5,12,16,28,23,24,47,0.000333,0.075315,6,1355.674088,75.315227,225.945681,107.01955,2,0
0,0,16,16,16,24,40,63,81,144,0.000333,0.255453,24,18392.5835,1021.810194,766.357646,174.0391,3,0
0,0,5,5,12,17,29,23,25,48,0.000333,0.077728,6,1399.098527,77.727696,233.183088,112.506418,2,0
0,0,17,17,15,25,40,65,78,143,0.000333,0.253679,21,15981.75007,887.875004,761.035718,174.699764,2,0
0,0,15,15,15,17,32,59,41,100,0.000333,0.166667,14,7000,388.888889,500,128.090227,3,0
0,0,10,10,15,14,29,45,31,76,0.000333,0.123069,14,5168.891779,287.160654,369.206556,111.906328,2,0
0,0,12,12,15,16,31,45,31,76,0.000333,0.125506,7,2635.632437,146.424024,376.51892,122.603359,3,0
0,0,15,15,15,17,32,59,41,100,0.000333,0.166667,14,7000,388.888889,500,128.090227,3,0
0,0,10,10,15,14,29,45,31,76,0.000333,0.123069,14,5168.891779,287.160654,369.206556,111.906328,2,0
0,0,12,12,15,16,31,45,31,76,0.000333,0.125506,7,2635.632437,146.424024,376.51892,122.603359,3,0
0,0,10,10,15,15,30,47,32,79,0.000333,0.129215,14,5427.020999,301.501167,387.644357,117.206718,2,0
0,0,10,10,14,15,29,46,32,78,0.000333,0.126308,14,5304.915247,294.717514,378.922518,111.906328,2,0
0,0,5,5,11,10,21,22,18,40,0.000333,0.058564,5,878.463485,48.803527,175.692697,71.273029,2,0
0,0,12,12,14,20,34,45,49,94,0.000333,0.159407,14,6695.101099,371.950061,478.221507,139.741531,1,0
0,0,10,10,13,16,29,48,33,81,0.000333,0.131165,12,4721.957527,262.330974,393.496461,112.105716,2,0
0,0,10,10,12,16,28,47,33,80,0.000333,0.128196,12,4615.060725,256.392263,384.588394,107.01955,2,0
0,0,10,10,12,15,27,47,32,79,0.000333,0.125212,12,4507.633352,250.424075,375.636113,101.622909,2,0
0,0,10,10,12,15,27,47,32,79,0.000333,0.125212,12,4507.633352,250.424075,375.636113,101.622909,2,0
0,0,12,12,14,18,32,56,36,92,0.000333,0.153333,14,6440,357.777778,460,128.361619,2,0
0,0,9,9,12,12,24,29,25,54,0.000333,0.082529,12,2971.0557,165.05865,247.587975,86.0391,2,0
0,0,9,9,12,11,23,29,25,54,0.000333,0.081424,12,2931.268148,162.84823,244.272346,81.073298,2,0
0,0,17,17,16,23,39,64,52,116,0.000333,0.204369,16,9809.706518,544.983695,613.106657,168.041925,2,0
0,0,10,10,15,14,29,45,31,76,0.000333,0.123069,14,5168.891779,287.160654,369.206556,111.906328,2,0
0,0,13,13,16,18,34,49,37,86,0.000333,0.145841,16,7000.34887,388.908271,437.521804,139.05865,2,0
0,0,11,11,15,19,34,48,38,86,0.000333,0.145841,14,6125.305261,340.294737,437.521804,139.313982,2,0
0,0,10,10,15,14,29,45,31,76,0.000333,0.123069,14,5168.891779,287.160654,369.206556,111.906328,2,0
0,0,6,6,6,13,19,14,18,32,0.000333,0.045311,3,407.801041,22.655613,135.93368,63.615491,1,0
0,0,16,16,15,17,32,75,49,124,0.000333,0.206667,14,8680,482.222222,620,128.090227,3,0
0,0,10,10,15,14,29,45,31,76,0.000333,0.123069,14,5168.891779,287.160654,369.206556,111.906328,2,0
0,0,16,16,15,17,32,75,49,124,0.000333,0.206667,14,8680,482.222222,620,128.090227,3,0
0,0,10,10,15,14,29,45,31,76,0.000333,0.123069,14,5168.891779,287.160654,369.206556,111.906328,2,0
0,0,8,8,8,16,24,32,29,61,0.000333,0.093228,4,1118.73085,62.151714,279.682713,88,1,0
0,0,8,8,10,19,29,34,29,63,0.000333,0.102018,5,1530.264013,85.014667,306.052803,113.929904,1,0
0,0,16,16,15,27,42,78,64,142,0.000333,0.255236,14,10719.92704,595.551502,765.709074,186.985321,2,0
0,0,15,15,15,26,41,73,59,132,0.000333,0.235732,14,9900.756105,550.042006,707.196865,180.814792,2,0
0,0,10,10,13,13,26,36,29,65,0.000333,0.101843,12,3666.34298,203.685721,305.528582,96.211433,3,0
0,0,10,10,13,13,26,36,29,65,0.000333,0.101843,12,3666.34298,203.685721,305.528582,96.211433,3,0
0,0,11,11,12,13,25,32,29,61,0.000333,0.094425,12,3399.302731,188.850152,283.275228,91.125266,2,0
0,0,11,11,10,14,24,32,34,66,0.000333,0.100869,10,3026.07525,168.115292,302.607525,86.52225,1,0
0,0,11,11,13,15,28,33,30,63,0.000333,0.100954,12,3634.360321,201.908907,302.86336,106.709075,2,0
0,0,11,11,11,14,25,35,34,69,0.000333,0.106809,10,3204.260771,178.014487,320.426077,91.356717,1,0
0,0,10,10,13,15,28,30,26,56,0.000333,0.089737,6,1615.271254,89.737292,269.211876,106.709075,2,0
0,0,12,12,11,19,30,34,39,73,0.000333,0.119401,10,3582.030135,199.001674,358.203013,118.764371,1,0
0,0,11,11,14,17,31,34,31,65,0.000333,0.107341,7,2254.159321,125.231073,322.02276,122.789837,2,0
0,0,12,12,13,16,29,43,35,78,0.000333,0.126308,12,4547.070211,252.615012,378.922518,112.105716,2,0
0,0,12,12,13,16,29,43,35,78,0.000333,0.126308,12,4547.070211,252.615012,378.922518,112.105716,2,0
0,0,14,14,20,18,38,62,47,109,0.000333,0.190675,20,11440.48198,635.582332,572.024099,161.497212,3,0
0,0,9,9,16,16,32,40,29,69,0.000333,0.115,8,2760,153.333333,345,128,2,0
0,0,14,14,20,19,39,62,47,109,0.000333,0.192036,20,11522.17684,640.120935,576.108842,167.149185,3,0
0,0,9,9,16,17,33,40,29,69,0.000333,0.116021,8,2784.505554,154.694753,348.063194,133.486868,2,0
0,0,10,10,12,15,27,38,32,70,0.000333,0.110947,12,3994.105502,221.89475,332.842125,101.622909,2,0
0,0,10,10,12,15,27,38,32,70,0.000333,0.110947,12,3994.105502,221.89475,332.842125,101.622909,2,0
0,0,7,7,16,15,31,36,30,66,0.000333,0.108992,16,5231.631304,290.646184,326.976956,122.603359,4,0
0,0,7,7,16,17,33,34,29,63,0.000333,0.105932,8,2542.374636,141.243035,317.79683,133.486868,3,0
0,0,7,7,14,15,29,32,28,60,0.000333,0.09716,7,2040.352018,113.35289,291.47886,111.906328,3,0
0,0,7,7,14,17,31,30,27,57,0.000333,0.09413,7,1976.724328,109.818018,282.38919,122.789837,2,0
0,0,10,10,14,16,30,47,39,86,0.000333,0.140664,14,5907.896277,328.21646,421.992591,117.302969,2,0
0,0,10,10,14,16,30,47,39,86,0.000333,0.140664,14,5907.896277,328.21646,421.992591,117.302969,2,0
0,0,23,23,17,46,63,105,80,185,0.000333,0.368599,8,8846.374287,491.465238,1105.796786,323.570718,9,0
0,0,22,22,17,46,63,104,78,182,0.000333,0.362622,8,8702.919569,483.495532,1087.864946,323.570718,9,0
0,0,23,23,18,44,62,106,78,184,0.000333,0.365191,9,9860.14909,547.786061,1095.572121,315.273641,9,0
0,0,22,22,18,44,62,105,76,181,0.000333,0.359237,9,9699.38579,538.854766,1077.709532,315.273641,9,0
0,0,7,7,12,14,26,30,27,57,0.000333,0.089308,6,1607.550384,89.308355,267.925064,96.322519,3,0
0,0,7,7,12,16,28,28,26,54,0.000333,0.086532,6,1557.582995,86.532389,259.597166,107.01955,2,0
0,0,7,7,14,14,28,34,29,63,0.000333,0.100954,14,4240.087041,235.560391,302.86336,106.605938,4,0
0,0,7,7,14,16,30,32,28,60,0.000333,0.098138,7,2060.89405,114.494114,294.413436,117.302969,3,0
0,0,14,14,15,18,33,52,43,95,0.000333,0.159739,14,6709.044179,372.724677,479.217441,133.662009,2,0
0,0,31,31,19,53,72,137,111,248,0.000333,0.510047,18,27542.54521,1530.1414,1530.1414,384.290407,10,0
0,0,30,30,19,53,72,136,109,245,0.000333,0.503877,18,27209.36926,1511.631625,1511.631625,384.290407,10,0
0,0,26,26,17,48,65,115,91,206,0.000333,0.413536,8,9924.862156,551.381231,1240.607769,337.565068,9,0
0,0,7,7,8,15,23,17,21,38,0.000333,0.057298,4,687.581417,38.198968,171.895354,82.603359,1,0
0,0,31,31,22,55,77,142,113,255,0.000333,0.532677,22,35156.67249,1953.148472,1598.030568,416.08228,11,0
0,0,30,30,22,55,77,141,111,252,0.000333,0.52641,22,34743.06458,1930.170255,1579.230208,416.08228,11,0
0,0,26,26,18,50,68,116,90,206,0.000333,0.418006,9,11286.15611,627.008673,1254.017345,357.25146,9,0
0,0,15,15,14,20,34,53,52,105,0.000333,0.178061,14,7478.570377,415.476132,534.183598,139.741531,3,0
0,0,15,15,14,22,36,51,51,102,0.000333,0.175777,14,7382.652902,410.147383,527.33235,151.410465,2,0
0,0,34,34,25,54,79,156,123,279,0.000333,0.586252,24,42210.11589,2345.006438,1758.754829,426.86033,12,0
0,0,34,34,24,56,80,154,122,276,0.000333,0.581617,24,41876.4517,2326.469539,1744.852154,435.250976,11,0
0,0,14,14,12,21,33,45,47,92,0.000333,0.154695,12,5569.011108,309.389506,464.084259,135.258216,2,0
0,0,33,33,22,56,78,148,118,266,0.000333,0.557306,22,36782.17379,2043.454099,1671.91699,423.319371,11,0
0,0,18,18,16,22,38,80,59,139,0.000333,0.243154,16,11671.39079,648.410599,729.461924,162.107496,2,0
0,0,10,10,15,14,29,45,31,76,0.000333,0.123069,14,5168.891779,287.160654,369.206556,111.906328,2,0
0,0,23,23,17,46,63,104,83,187,0.000333,0.372584,8,8942.010766,496.778376,1117.751346,323.570718,9,0
0,0,22,22,17,46,63,103,81,184,0.000333,0.366607,8,8798.556047,488.808669,1099.819506,323.570718,9,0
0,0,23,23,18,48,66,105,82,187,0.000333,0.376767,9,10172.7153,565.15085,1130.3017,343.13685,9,0
0,0,22,22,18,48,66,104,80,184,0.000333,0.370723,9,10009.51666,556.084259,1112.168518,343.13685,9,0
0,0,8,8,12,16,28,30,32,62,0.000333,0.099352,12,3576.672062,198.704003,298.056005,107.01955,3,0
0,0,8,8,12,18,30,28,31,59,0.000333,0.096502,6,1737.039271,96.502182,289.506545,118.0782,2,0
0,0,8,8,14,16,30,34,34,68,0.000333,0.111223,14,4671.359847,259.519992,333.668561,117.302969,4,0
0,0,8,8,14,18,32,32,33,65,0.000333,0.108333,7,2275,126.388889,325,128.361619,3,0
0,0,17,17,15,17,32,78,54,132,0.000333,0.22,21,13860,770,660,128.090227,2,0
0,0,10,10,15,14,29,45,31,76,0.000333,0.123069,14,5168.891779,287.160654,369.206556,111.906328,2,0
0,0,12,12,15,17,32,50,34,84,0.000333,0.14,14,5880,326.666667,420,128.090227,3,0
0,0,12,12,15,17,32,50,34,84,0.000333,0.14,14,5880,326.666667,420,128.090227,3,0
0,0,15,15,16,20,36,73,44,117,0.000333,0.201627,16,9678.099603,537.6722,604.881225,150.438562,3,0
0,0,12,12,15,18,33,51,35,86,0.000333,0.144606,7,3036.72526,168.706959,433.817894,133.662009,3,0
0,0,12,12,15,18,33,50,35,85,0.000333,0.142925,7,3001.414501,166.74525,428.7735,133.662009,3,0
0,0,16,16,15,21,36,63,51,114,0.000333,0.196457,14,8251.200302,458.400017,589.37145,150.842025,2,0
0,0,10,10,13,17,30,40,32,72,0.000333,0.117765,6,2119.776737,117.765374,353.296123,117.592585,2,0
0,0,8,8,8,15,23,31,28,59,0.000333,0.088963,4,1067.560622,59.308923,266.890155,82.603359,1,0
0,0,8,8,9,17,26,32,27,59,0.000333,0.092442,4,1109.303773,61.627987,277.325943,98.016193,1,0
0,0,18,18,15,25,40,77,63,140,0.000333,0.248357,14,10430.97907,579.498837,745.069933,174.699764,2,0
0,0,9,9,13,18,31,40,32,72,0.000333,0.118901,6,2140.212806,118.900711,356.702134,123.164366,2,0
0,0,15,15,14,23,37,63,53,116,0.000333,0.201432,14,8460.152266,470.008459,604.29659,157.344894,2,0
0,0,11,11,13,21,34,49,40,89,0.000333,0.150928,6,2716.705157,150.928064,452.784193,140.344382,1,0
0,0,12,12,14,16,30,55,43,98,0.000333,0.160292,14,6732.253897,374.014105,480.875278,117.302969,2,0
0,0,12,12,14,16,30,55,43,98,0.000333,0.160292,14,6732.253897,374.014105,480.875278,117.302969,2,0
0,0,3,3,10,9,19,17,13,30,0.000333,0.042479,5,637.189127,35.399396,127.437825,61.748606,1,0
0,0,8,8,11,11,22,26,22,48,0.000333,0.071351,10,2140.527177,118.918176,214.052718,76.107496,2,0
0,0,8,8,11,10,21,26,22,48,0.000333,0.070277,10,2108.312363,117.128465,210.831236,71.273029,2,0
0,0,8,8,11,10,21,22,20,42,0.000333,0.061492,10,1844.773318,102.487407,184.477332,71.273029,2,0
0,0,13,13,14,19,33,47,44,91,0.000333,0.153013,14,6426.558108,357.031006,459.039865,134.013592,2,0
0,0,13,13,15,20,35,48,44,92,0.000333,0.157298,14,6606.516526,367.028696,471.894038,145.041921,2,0
0,0,16,16,15,21,36,62,54,116,0.000333,0.199904,14,8395.958202,466.442122,599.7113,150.842025,2,0
0,0,10,10,14,17,31,47,36,83,0.000333,0.137066,14,5756.776113,319.820895,411.198294,122.789837,2,0
0,0,10,10,15,14,29,48,33,81,0.000333,0.131165,14,5508.950448,306.052803,393.496461,111.906328,2,0
0,0,6,6,8,9,17,15,14,29,0.000333,0.039512,4,474.14569,26.341427,118.536422,52.529325,1,0
0,0,8,8,11,11,22,26,22,48,0.000333,0.071351,10,2140.527177,118.918176,214.052718,76.107496,2,0
0,0,16,16,16,17,33,65,46,111,0.000333,0.186643,16,8958.843956,497.713553,559.927747,133.486868,2,0
0,0,10,10,15,14,29,45,31,76,0.000333,0.123069,14,5168.891779,287.160654,369.206556,111.906328,2,0
0,0,12,12,15,16,31,45,32,77,0.000333,0.127158,14,5340.623623,296.701312,381.473116,122.603359,2,0
0,0,16,16,15,17,32,62,46,108,0.000333,0.18,14,7560,420,540,128.090227,2,0
0,0,10,10,15,14,29,45,31,76,0.000333,0.123069,14,5168.891779,287.160654,369.206556,111.906328,2,0
0,0,13,13,15,16,31,48,36,84,0.000333,0.138717,14,5826.134861,323.674159,416.15249,122.603359,2,0
0,0,12,12,12,14,26,36,33,69,0.000333,0.10811,12,3891.964087,216.220227,324.330341,96.322519,2,0
0,0,21,21,15,22,37,90,84,174,0.000333,0.302148,21,19035.3426,1057.519033,906.444886,156.710855,2,0
0,0,10,10,14,16,30,47,35,82,0.000333,0.134122,14,5633.110404,312.950578,402.365029,117.302969,2,0
0,0,17,17,16,17,33,81,54,135,0.000333,0.226998,24,16343.83695,907.990941,680.993206,133.486868,2,0
0,0,10,10,15,14,29,45,31,76,0.000333,0.123069,14,5168.891779,287.160654,369.206556,111.906328,2,0
0,0,17,17,15,20,35,78,60,138,0.000333,0.235947,21,14864.66218,825.814566,707.841056,145.041921,2,0
0,0,10,10,14,16,30,47,35,82,0.000333,0.134122,14,5633.110404,312.950578,402.365029,117.302969,2,0
0,0,12,12,18,18,36,53,39,92,0.000333,0.158544,18,8561.395802,475.6331,475.6331,150.1173,5,0
0,0,12,12,17,20,37,51,38,89,0.000333,0.154547,8,3709.130796,206.062822,463.64135,155.92543,4,0
0,0,9,9,14,20,34,41,30,71,0.000333,0.120403,7,2528.469032,140.470502,361.209862,139.741531,4,0
0,0,10,10,14,20,34,42,32,74,0.000333,0.125491,7,2635.305752,146.405875,376.47225,139.741531,4,0
0,0,10,10,15,12,27,35,28,63,0.000333,0.099853,14,4193.810777,232.989488,299.557913,101.622909,3,0
0,0,10,10,14,14,28,33,27,60,0.000333,0.096147,7,2019.089067,112.171615,288.441295,106.605938,2,0
0,0,12,12,17,13,30,42,34,76,0.000333,0.124308,16,5966.778964,331.48772,372.923685,117.592585,3,0
0,0,12,12,16,15,31,40,33,73,0.000333,0.120552,16,5786.501291,321.472294,361.656331,122.603359,2,0
0,0,14,14,20,19,39,60,45,105,0.000333,0.184989,20,11099.34466,616.630259,554.967233,167.149185,5,0
0,0,14,14,19,21,40,58,44,102,0.000333,0.180946,18,9771.059982,542.836666,542.836666,172.949289,4,0
0,0,10,10,15,21,36,44,32,76,0.000333,0.130971,7,2750.400101,152.800006,392.9143,150.842025,4,0
0,0,11,11,15,21,36,45,34,79,0.000333,0.136141,7,2858.968526,158.831585,408.424075,150.842025,4,0
0,0,13,13,16,19,35,42,40,82,0.000333,0.1402,16,6729.619318,373.86774,420.601207,144.710623,3,0
0,0,13,13,15,21,36,40,39,79,0.000333,0.136141,7,2858.968526,158.831585,408.424075,150.842025,2,0
0,0,15,15,19,25,44,60,51,111,0.000333,0.201999,18,10907.94437,605.99691,605.99691,196.807027,5,0
0,0,15,15,18,27,45,58,50,108,0.000333,0.197707,9,5338.08121,296.560067,593.120134,203.440613,4,0
0,0,11,11,15,23,38,47,37,84,0.000333,0.146942,7,3085.781378,171.432299,440.825911,162.645284,4,0
0,0,12,12,15,23,38,48,39,87,0.000333,0.15219,7,3195.987856,177.554881,456.569694,162.645284,4,0
0,0,7,7,12,13,25,38,25,63,0.000333,0.097521,6,1755.37764,97.52098,292.56294,91.125266,1,0
0,0,20,20,17,42,59,91,73,164,0.000333,0.321584,8,7718.027681,428.779316,964.75346,295.9642,7,0
0,0,19,19,17,42,59,90,71,161,0.000333,0.315702,8,7576.844248,420.935792,947.105531,295.9642,7,0
0,0,20,20,18,44,62,92,72,164,0.000333,0.325496,9,8788.393754,488.244097,976.488195,315.273641,7,0
0,0,19,19,18,44,62,91,70,161,0.000333,0.319542,9,8627.630454,479.312803,958.625606,315.273641,7,0
0,0,8,8,12,16,28,30,32,62,0.000333,0.099352,12,3576.672062,198.704003,298.056005,107.01955,3,0
0,0,8,8,12,18,30,28,31,59,0.000333,0.096502,6,1737.039271,96.502182,289.506545,118.0782,2,0
0,0,8,8,14,16,30,34,34,68,0.000333,0.111223,14,4671.359847,259.519992,333.668561,117.302969,4,0
0,0,8,8,14,18,32,32,33,65,0.000333,0.108333,7,2275,126.388889,325,128.361619,3,0
0,0,7,7,16,15,31,36,30,66,0.000333,0.108992,16,5231.631304,290.646184,326.976956,122.603359,4,0
0,0,7,7,16,17,33,34,29,63,0.000333,0.105932,8,2542.374636,141.243035,317.79683,133.486868,3,0
0,0,7,7,14,15,29,32,28,60,0.000333,0.09716,7,2040.352018,113.35289,291.47886,111.906328,3,0
0,0,7,7,14,17,31,30,27,57,0.000333,0.09413,7,1976.724328,109.818018,282.38919,122.789837,2,0
0,0,12,12,15,19,34,59,39,98,0.000333,0.16619,14,6979.999018,387.777723,498.571358,139.313982,3,0
0,0,12,12,15,19,34,59,39,98,0.000333,0.16619,14,6979.999018,387.777723,498.571358,139.313982,3,0
0,0,14,14,16,21,37,64,42,106,0.000333,0.184067,16,8835.232908,490.846273,552.202057,156.238666,3,0
0,0,14,14,16,20,36,64,42,106,0.000333,0.182671,16,8768.192802,487.121822,548.01205,150.438562,3,0
0,0,16,16,17,14,31,55,38,93,0.000333,0.15358,16,7371.84411,409.546895,460.740257,122.789837,6,0
0,0,16,16,17,16,33,53,37,90,0.000333,0.151332,16,7263.927532,403.55153,453.995471,133.486868,5,0
0,0,16,16,17,13,30,55,38,93,0.000333,0.152114,16,7301.453206,405.636289,456.340825,117.592585,6,0
0,0,16,16,17,15,32,53,37,90,0.000333,0.15,16,7200,400,450,128.090227,5,0
0,0,12,12,16,14,30,42,32,74,0.000333,0.121037,16,5809.758465,322.764359,363.109904,117.302969,5,0
0,0,12,12,15,16,31,40,31,71,0.000333,0.117249,7,2462.235566,136.790865,351.747938,122.603359,4,0
0,0,12,12,15,14,29,41,32,73,0.000333,0.118211,14,4964.856577,275.825365,354.632613,111.906328,5,0
0,0,12,12,14,16,30,39,31,70,0.000333,0.114494,7,2404.376392,133.576466,343.482342,117.302969,4,0
0,0,12,12,18,20,38,62,51,113,0.000333,0.197672,18,10674.28456,593.015809,593.015809,161.497212,3,0
0,0,11,11,18,20,38,61,49,110,0.000333,0.192424,18,10390.89648,577.272026,577.272026,161.497212,3,0
0,0,14,14,20,20,40,71,50,121,0.000333,0.214651,20,12879.06599,715.503666,643.953299,172.877124,3,0
0,0,14,14,20,20,40,71,50,121,0.000333,0.214651,20,12879.06599,715.503666,643.953299,172.877124,3,0
0,0,14,14,21,20,41,72,51,123,0.000333,0.21966,20,13179.57793,732.198774,658.978897,178.677228,3,0
0,0,10,10,19,17,36,52,39,91,0.000333,0.156821,18,8468.337152,470.463175,470.463175,150.197491,2,0
0,0,14,14,20,20,40,71,51,122,0.000333,0.216425,20,12985.50455,721.41692,649.275228,172.877124,3,0
0,0,10,10,19,17,36,52,39,91,0.000333,0.156821,18,8468.337152,470.463175,470.463175,150.197491,2,0
0,0,16,16,17,25,42,73,69,142,0.000333,0.255236,16,12251.34519,680.630288,765.709074,185.583273,2,0
0,0,17,17,17,26,43,65,77,142,0.000333,0.256843,16,12328.47352,684.915196,770.529595,191.698301,2,0
0,0,11,11,15,18,33,47,36,83,0.000333,0.139562,14,5861.585967,325.643665,418.684712,133.662009,2,0
0,0,14,14,17,24,41,53,56,109,0.000333,0.194658,16,9343.570696,519.087261,583.973169,179.525968,2,0
0,0,12,12,15,21,36,43,38,81,0.000333,0.139588,7,2931.347476,162.852638,418.763925,150.842025,2,0
0,0,12,12,16,22,38,45,41,86,0.000333,0.150441,8,3610.574129,200.587452,451.321766,162.107496,2,0
0,0,7,7,14,19,33,34,30,64,0.000333,0.107614,7,2259.888565,125.549365,322.841224,134.013592,2,0
0,0,11,11,14,15,29,48,35,83,0.000333,0.134404,14,5644.973916,313.609662,403.212423,111.906328,2,0
0,0,12,12,14,20,34,48,40,88,0.000333,0.149232,14,6267.75422,348.208568,447.69673,139.741531,2,0
0,0,11,11,14,15,29,45,33,78,0.000333,0.126308,14,5304.915247,294.717514,378.922518,111.906328,2,0
0,0,18,18,16,24,40,72,56,128,0.000333,0.227069,16,10899.30874,605.517152,681.206796,174.0391,2,0
0,0,11,11,14,15,29,45,33,78,0.000333,0.126308,14,5304.915247,294.717514,378.922518,111.906328,2,0
0,0,17,17,15,22,37,70,58,128,0.000333,0.22227,14,9335.340431,518.630024,666.810031,156.710855,2,0
0,0,11,11,13,18,31,47,38,85,0.000333,0.140369,12,5053.280237,280.737791,421.106686,123.164366,2,0
0,0,9,9,12,11,23,29,25,54,0.000333,0.081424,12,2931.268148,162.84823,244.272346,81.073298,2,0
0,0,10,10,12,15,27,30,30,60,0.000333,0.095098,12,3423.519002,190.1955,285.29325,101.622909,2,0
0,0,10,10,13,16,29,31,26,57,0.000333,0.092302,6,1661.4295,92.301639,276.904917,112.105716,3,0
0,0,10,10,11,15,26,29,30,59,0.000333,0.092442,10,2773.259434,154.069969,277.325943,96.657107,2,0
0,0,10,10,13,16,29,30,26,56,0.000333,0.090682,6,1632.281614,90.682312,272.046936,112.105716,3,0
0,0,12,12,12,15,27,34,32,66,0.000333,0.104608,12,3765.870902,209.21505,313.822575,101.622909,2,0
0,0,12,12,14,17,31,35,28,63,0.000333,0.104038,7,2184.800573,121.37781,312.114368,122.789837,3,0
0,0,12,12,12,15,27,34,32,66,0.000333,0.104608,12,3765.870902,209.21505,313.822575,101.622909,2,0
0,0,12,12,14,17,31,35,28,63,0.000333,0.104038,7,2184.800573,121.37781,312.114368,122.789837,3,0
0,0,12,12,14,17,31,52,41,93,0.000333,0.15358,14,6450.363596,358.353533,460.740257,122.789837,4,0
0,0,10,10,12,16,28,39,33,72,0.000333,0.115377,12,4153.554653,230.753036,346.129554,107.01955,3,0
0,0,14,14,14,21,35,63,49,112,0.000333,0.191493,14,8042.715771,446.817543,574.479698,145.541635,3,0
0,0,15,15,15,18,33,60,42,102,0.000333,0.171509,14,7203.394802,400.1886,514.5282,133.662009,3,0
0,0,10,10,15,14,29,45,31,76,0.000333,0.123069,14,5168.891779,287.160654,369.206556,111.906328,2,0
0,0,12,12,15,17,32,46,32,78,0.000333,0.13,7,2730,151.666667,390,128.090227,3,0
0,0,15,15,15,18,33,59,42,101,0.000333,0.169828,14,7132.773285,396.265182,509.483806,133.662009,3,0
0,0,10,10,15,14,29,45,31,76,0.000333,0.123069,14,5168.891779,287.160654,369.206556,111.906328,2,0
0,0,12,12,15,17,32,45,32,77,0.000333,0.128333,7,2695,149.722222,385,128.090227,3,0
0,0,15,15,15,20,35,56,45,101,0.000333,0.172686,14,7252.806186,402.933677,518.057585,145.041921,3,0
0,0,15,15,15,20,35,55,45,100,0.000333,0.170976,14,7180.996224,398.944235,512.928302,145.041921,3,0
0,0,19,19,16,22,38,78,56,134,0.000333,0.234407,16,11251.55659,625.086477,703.222287,162.107496,3,0
0,0,15,15,16,18,34,68,44,112,0.000333,0.189932,16,9116.733412,506.48519,569.795838,139.05865,3,0
0,0,10,10,15,14,29,45,31,76,0.000333,0.123069,14,5168.891779,287.160654,369.206556,111.906328,2,0
0,0,15,15,16,18,34,68,44,112,0.000333,0.189932,16,9116.733412,506.48519,569.795838,139.05865,3,0
0,0,10,10,15,14,29,45,31,76,0.000333,0.123069,14,5168.891779,287.160654,369.206556,111.906328,2,0
0,0,17,17,16,19,35,72,47,119,0.000333,0.203462,16,9766.154864,542.564159,610.384679,144.710623,3,0
0,0,17,17,16,19,35,72,47,119,0.000333,0.203462,16,9766.154864,542.564159,610.384679,144.710623,3,0
0,0,12,12,15,17,32,40,42,82,0.000333,0.136667,14,5740,318.888889,410,128.090227,3,0
0,0,12,12,14,19,33,38,41,79,0.000333,0.132836,14,5579.099896,309.949994,398.507135,134.013592,2,0
0,0,12,12,16,16,32,44,44,88,0.000333,0.146667,16,7040,391.111111,440,128,4,0
0,0,12,12,16,18,34,42,43,85,0.000333,0.144145,16,6918.949464,384.386081,432.434342,139.05865,3,0
0,0,8,8,14,16,30,31,29,60,0.000333,0.098138,7,2060.89405,114.494114,294.413436,117.302969,3,0
0,0,8,8,13,18,31,29,28,57,0.000333,0.09413,6,1694.335138,94.12973,282.38919,123.164366,2,0
0,0,8,8,15,16,31,35,31,66,0.000333,0.108992,7,2288.838695,127.157705,326.976956,122.603359,4,0
0,0,8,8,15,18,33,33,30,63,0.000333,0.105932,7,2224.577807,123.587656,317.79683,133.662009,3,0
0,0,12,12,15,13,28,39,34,73,0.000333,0.116979,14,4913.11673,272.950929,350.936909,106.709075,3,0
0,0,12,12,14,15,29,37,33,70,0.000333,0.113353,14,4760.821375,264.490076,340.05867,111.906328,2,0
0,0,12,12,16,12,28,43,36,79,0.000333,0.126594,24,9114.744932,506.374718,379.781039,107.01955,4,0
0,0,12,12,16,14,30,41,35,76,0.000333,0.124308,16,5966.778964,331.48772,372.923685,117.302969,3,0
0,0,14,14,16,19,35,54,44,98,0.000333,0.167557,16,8042.715771,446.817543,502.669736,144.710623,3,0
0,0,14,14,16,19,35,54,44,98,0.000333,0.167557,16,8042.715771,446.817543,502.669736,144.710623,3,0
0,0,15,15,17,21,38,62,54,116,0.000333,0.20292,16,9740.153465,541.119637,608.759592,161.725534,2,0
0,0,15,15,15,19,34,62,42,104,0.000333,0.176365,14,7407.345897,411.519216,529.096135,139.313982,3,0
0,0,15,15,15,19,34,61,42,103,0.000333,0.17467,14,7336.121417,407.562301,524.008673,139.313982,3,0
0,0,17,17,16,21,37,79,48,127,0.000333,0.220534,16,10585.60924,588.089402,661.600577,156.238666,3,0
0,0,10,10,14,15,29,39,29,68,0.000333,0.110114,7,2312.398954,128.466609,330.342708,111.906328,2,0
0,0,16,16,18,19,37,67,47,114,0.000333,0.197959,18,10689.79831,593.877684,593.877684,155.769273,3,0
0,0,12,12,15,18,33,50,36,86,0.000333,0.144606,14,6073.45052,337.413918,433.817894,133.662009,3,0
0,0,12,12,15,18,33,49,36,85,0.000333,0.142925,14,6002.829002,333.4905,428.7735,133.662009,3,0
0,0,12,12,15,18,33,49,35,84,0.000333,0.141243,7,2966.103742,164.783541,423.729106,133.662009,3,0
0,0,12,12,15,18,33,49,35,84,0.000333,0.141243,7,2966.103742,164.783541,423.729106,133.662009,3,0
0,0,8,8,14,20,34,37,32,69,0.000333,0.117012,7,2457.244552,136.513586,351.034936,139.741531,2,0
0,0,14,14,18,24,42,62,58,120,0.000333,0.215693,18,11647.40563,647.078091,647.078091,185.09775,2,0
0,0,12,12,15,18,33,49,35,84,0.000333,0.141243,7,2966.103742,164.783541,423.729106,133.662009,3,0
0,0,12,12,15,17,32,49,35,84,0.000333,0.14,14,5880,326.666667,420,128.090227,3,0
0,0,12,12,15,19,34,59,39,98,0.000333,0.16619,14,6979.999018,387.777723,498.571358,139.313982,3,0
0,0,12,12,15,19,34,59,39,98,0.000333,0.16619,14,6979.999018,387.777723,498.571358,139.313982,3,0
0,0,13,13,15,22,37,54,49,103,0.000333,0.178858,14,7512.031753,417.335097,536.573697,156.710855,2,0
0,0,12,12,15,21,36,49,44,93,0.000333,0.160268,14,6731.242352,373.957908,480.803025,150.842025,2,0
0,0,6,6,5,11,16,13,19,32,0.000333,0.042667,2,256,14.222222,128,49.663388,1,0
0,0,8,8,15,20,35,39,32,71,0.000333,0.121393,7,2549.253659,141.625203,364.179094,145.041921,2,0
0,0,6,6,7,14,21,15,19,34,0.000333,0.04978,3,448.016377,24.889799,149.338792,72.954453,1,0
0,0,11,11,12,14,26,39,32,71,0.000333,0.111244,12,4004.77464,222.48748,333.73122,96.322519,2,0
0,0,5,5,9,12,21,24,19,43,0.000333,0.062957,4,755.478597,41.971033,188.869649,71.548875,1,0
0,0,10,10,9,16,25,31,37,68,0.000333,0.105261,8,2526.257767,140.347654,315.782221,92.529325,1,0
0,0,10,10,10,18,28,32,37,69,0.000333,0.110569,10,3317.074896,184.281939,331.70749,108.277931,1,0
0,0,13,13,15,19,34,47,48,95,0.000333,0.161103,14,6766.325579,375.906977,483.30897,139.313982,2,0
0,0,8,8,15,13,28,37,29,66,0.000333,0.105762,14,4441.995948,246.777553,317.285425,106.709075,2,0
0,0,5,5,8,8,16,11,12,23,0.000333,0.030667,4,368,20.444444,92,48,1,0
0,0,15,15,20,20,40,73,51,124,0.000333,0.219973,20,13198.38168,733.243426,659.919084,172.877124,3,0
0,0,11,11,19,18,37,55,41,96,0.000333,0.166703,18,9001.935416,500.107523,500.107523,155.769273,2,0
0,0,15,15,20,21,41,73,51,124,0.000333,0.221445,20,13286.72897,738.15161,664.336449,178.677228,3,0
0,0,11,11,19,18,37,55,41,96,0.000333,0.166703,18,9001.935416,500.107523,500.107523,155.769273,2,0
0,0,11,11,19,22,41,59,47,106,0.000333,0.1893,18,10222.20923,567.900512,567.900512,178.818118,2,0
0,0,19,19,23,26,49,85,89,174,0.000333,0.325653,33,32239.66393,1791.09244,976.959513,226.253358,2,0
0,0,12,12,14,19,33,43,43,86,0.000333,0.144606,14,6073.45052,337.413918,433.817894,134.013592,2,0
0,0,12,12,15,20,35,44,43,87,0.000333,0.148749,14,6247.466715,347.081484,446.247622,145.041921,2,0
0,0,16,16,16,23,39,58,58,116,0.000333,0.204369,16,9809.706518,544.983695,613.106657,168.041925,2,0
0,0,7,7,12,12,24,29,25,54,0.000333,0.082529,12,2971.0557,165.05865,247.587975,86.0391,2,0
0,0,7,7,12,12,24,29,25,54,0.000333,0.082529,12,2971.0557,165.05865,247.587975,86.0391,2,0
0,0,9,9,12,11,23,27,22,49,0.000333,0.073885,12,2659.85443,147.769691,221.654536,81.073298,3,0
0,0,17,17,12,19,31,50,65,115,0.000333,0.189911,18,10255.18636,569.732576,569.732576,123.730173,2,0
0,0,17,17,13,21,34,51,72,123,0.000333,0.208586,18,11263.64273,625.757929,625.757929,140.344382,2,0
0,0,12,12,16,23,39,55,64,119,0.000333,0.209654,16,10063.40583,559.078101,628.962864,168.041925,1,0
0,0,14,14,17,17,34,49,42,91,0.000333,0.15432,16,7407.345897,411.519216,462.959119,138.973737,3,0
0,0,11,11,12,16,28,34,30,64,0.000333,0.102557,6,1846.02429,102.556905,307.670715,107.01955,2,0
0,0,14,14,17,18,35,49,42,91,0.000333,0.155588,16,7468.236073,414.902004,466.764755,144.545518,3,0
0,0,11,11,12,17,29,34,30,64,0.000333,0.103637,6,1865.464702,103.636928,310.910784,112.506418,2,0
0,0,19,19,18,21,39,61,73,134,0.000333,0.236081,27,19122.58523,1062.365846,708.243897,167.297316,2,0
0,0,10,10,15,18,33,38,35,73,0.000333,0.122747,7,2577.685395,143.204744,368.240771,133.662009,2,0
0,0,15,15,15,19,34,61,41,102,0.000333,0.172974,14,7264.896937,403.605385,518.92121,139.313982,3,0
0,0,10,10,14,15,29,38,28,66,0.000333,0.106876,7,2244.38722,124.688179,320.626746,111.906328,2,0
0,0,15,15,15,19,34,60,41,101,0.000333,0.171278,14,7193.672458,399.64847,513.833747,139.313982,3,0
0,0,10,10,14,15,29,38,28,66,0.000333,0.106876,7,2244.38722,124.688179,320.626746,111.906328,2,0
0,0,19,19,16,23,39,80,68,148,0.000333,0.260747,16,12515.83245,695.324025,782.239528,168.041925,3,0
0,0,11,11,15,15,30,48,33,81,0.000333,0.132486,14,5564.413935,309.134108,397.458138,117.206718,2,0
0,0,19,19,16,23,39,80,68,148,0.000333,0.260747,16,12515.83245,695.324025,782.239528,168.041925,3,0
0,0,11,11,15,15,30,48,33,81,0.000333,0.132486,14,5564.413935,309.134108,397.458138,117.206718,2,0
0,0,14,14,14,18,32,46,42,88,0.000333,0.146667,14,6160,342.222222,440,128.361619,3,0
0,0,10,10,14,16,30,32,27,59,0.000333,0.096502,7,2026.545816,112.585879,289.506545,117.302969,3,0
0,0,14,14,14,18,32,46,42,88,0.000333,0.146667,14,6160,342.222222,440,128.361619,3,0
0,0,10,10,14,16,30,32,27,59,0.000333,0.096502,7,2026.545816,112.585879,289.506545,117.302969,3,0
0,0,13,13,15,22,37,54,49,103,0.000333,0.178858,14,7512.031753,417.335097,536.573697,156.710855,2,0
0,0,12,12,15,21,36,49,44,93,0.000333,0.160268,14,6731.242352,373.957908,480.803025,150.842025,2,0
0,0,16,16,14,21,35,59,67,126,0.000333,0.21543,21,13572.08286,754.004603,646.28966,145.541635,2,0
0,0,16,16,15,23,38,61,72,133,0.000333,0.232658,21,14657.46155,814.303419,697.974359,162.645284,2,0
0,0,17,17,15,24,39,66,77,143,0.000333,0.251938,21,15872.06286,881.78127,755.812517,168.642459,2,0
0,0,14,14,15,17,32,46,42,88,0.000333,0.146667,14,6160,342.222222,440,128.090227,3,0
0,0,10,10,15,15,30,32,27,59,0.000333,0.096502,7,2026.545816,112.585879,289.506545,117.206718,3,0
0,0,7,7,9,12,21,20,24,44,0.000333,0.064421,8,1546.095733,85.894207,193.261967,71.548875,1,0
0,0,8,8,13,18,31,33,31,64,0.000333,0.10569,6,1902.411383,105.689521,317.068564,123.164366,2,0
0,0,7,7,10,15,25,21,23,44,0.000333,0.06811,5,1021.648362,56.758242,204.329672,91.82264,1,0
0,0,16,16,16,22,38,63,56,119,0.000333,0.208168,16,9992.053986,555.11411,624.503374,162.107496,3,0
0,0,16,16,17,24,41,64,56,120,0.000333,0.214302,16,10286.49985,571.472214,642.906241,179.525968,3,0
0,0,14,14,13,21,34,54,52,106,0.000333,0.179757,12,6471.252734,359.514041,539.271061,140.344382,2,0
0,0,14,14,13,17,30,54,44,98,0.000333,0.160292,12,5770.50334,320.583519,480.875278,117.592585,2,0
0,0,16,16,17,20,37,64,48,112,0.000333,0.194486,16,9335.340431,518.630024,583.458777,155.92543,3,0
0,0,16,16,14,18,32,66,50,116,0.000333,0.193333,14,8120,451.111111,580,128.361619,2,0
0,0,15,15,17,20,37,61,44,105,0.000333,0.182331,16,8751.881654,486.215647,546.992603,155.92543,3,0
0,0,13,13,12,14,26,35,33,68,0.000333,0.106543,12,3835.55881,213.086601,319.629901,96.322519,2,0
0,0,13,13,12,14,26,35,33,68,0.000333,0.106543,12,3835.55881,213.086601,319.629901,96.322519,2,0
0,0,8,8,13,12,25,33,25,58,0.000333,0.089781,12,3232.123908,179.562439,269.343659,91.125266,3,0
0,0,8,8,13,11,24,33,25,58,0.000333,0.088643,12,3191.133901,177.285217,265.927825,86.159464,3,0
0,0,15,15,18,19,37,55,48,103,0.000333,0.178858,18,9658.32654,536.573697,536.573697,155.769273,3,0
0,0,11,11,17,18,35,41,33,74,0.000333,0.126522,8,3036.535546,168.696419,379.566943,144.545518,3,0
0,0,14,14,15,24,39,44,45,89,0.000333,0.1568,7,3292.805582,182.933643,470.400797,168.642459,2,0
0,0,11,11,15,18,33,35,32,67,0.000333,0.112658,7,2365.820842,131.434491,337.974406,133.662009,2,0
0,0,13,13,14,18,32,42,39,81,0.000333,0.135,14,5670,315,405,128.361619,2,0
0,0,11,11,14,16,30,34,31,65,0.000333,0.106316,7,2232.635221,124.03529,318.947889,117.302969,2,0
0,0,5,5,7,10,17,10,14,24,0.000333,0.0327,3,294.297325,16.349851,98.099108,52.870765,1,0
0,0,7,7,14,15,29,28,24,52,0.000333,0.084205,7,1768.305082,98.239171,252.615012,111.906328,2,0
0,0,5,5,9,9,18,12,13,25,0.000333,0.034749,4,416.9925,23.16625,104.248125,57.05865,1,0
0,0,11,11,14,17,31,36,35,71,0.000333,0.117249,14,4924.471133,273.58173,351.747938,122.789837,3,0
0,0,18,18,14,24,38,80,66,146,0.000333,0.255399,14,10726.76384,595.931324,766.197417,163.342069,6,0
0,0,11,11,13,21,34,46,40,86,0.000333,0.145841,6,2625.130826,145.840601,437.521804,140.344382,3,0
0,0,12,12,13,19,32,43,40,83,0.000333,0.138333,12,4980,276.666667,415,128.816339,3,0
0,0,8,8,11,16,27,26,24,50,0.000333,0.079248,5,1188.721876,66.040104,237.744375,102.053748,2,0
0,0,13,13,13,20,33,47,43,90,0.000333,0.151332,12,5447.945649,302.663647,453.995471,134.544278,3,0
0,0,12,12,14,19,33,55,42,97,0.000333,0.163102,14,6850.287214,380.571512,489.30623,134.013592,5,0
0,0,6,6,11,9,20,18,14,32,0.000333,0.046101,5,691.508495,38.417139,138.301699,66.583073,2,0
0,0,18,18,15,24,39,84,66,150,0.000333,0.26427,14,11099.34466,616.630259,792.810333,168.642459,6,0
0,0,12,12,14,19,33,47,40,87,0.000333,0.146287,14,6144.072037,341.337335,438.862288,134.013592,3,0
0,0,15,15,15,17,32,59,41,100,0.000333,0.166667,14,7000,388.888889,500,128.090227,3,0
0,0,10,10,15,14,29,45,31,76,0.000333,0.123069,14,5168.891779,287.160654,369.206556,111.906328,2,0
0,0,12,12,15,16,31,45,31,76,0.000333,0.125506,7,2635.632437,146.424024,376.51892,122.603359,3,0
0,0,15,15,15,17,32,59,41,100,0.000333,0.166667,14,7000,388.888889,500,128.090227,3,0
0,0,10,10,15,14,29,45,31,76,0.000333,0.123069,14,5168.891779,287.160654,369.206556,111.906328,2,0
0,0,12,12,15,16,31,45,31,76,0.000333,0.125506,7,2635.632437,146.424024,376.51892,122.603359,3,0
0,0,12,12,15,19,34,51,38,89,0.000333,0.150928,14,6338.9787,352.165483,452.784193,139.313982,3,0
0,0,12,12,15,19,34,50,38,88,0.000333,0.149232,14,6267.75422,348.208568,447.69673,139.313982,3,0
0,0,16,16,16,20,36,58,46,104,0.000333,0.179224,16,8602.755202,477.930845,537.6722,150.438562,3,0
0,0,16,16,16,20,36,58,46,104,0.000333,0.179224,16,8602.755202,477.930845,537.6722,150.438562,3,0
0,0,14,14,16,18,34,53,43,96,0.000333,0.162799,16,7814.342924,434.130162,488.396433,139.05865,3,0
0,0,3,3,9,8,17,14,11,25,0.000333,0.034062,4,408.746284,22.708127,102.186571,52.529325,1,0
0,0,14,14,13,21,34,49,70,119,0.000333,0.201803,18,10897.34541,605.408078,605.408078,140.344382,2,0
0,0,9,9,14,20,34,32,30,62,0.000333,0.105141,7,2207.958873,122.664382,315.422696,139.741531,2,0
0,0,14,14,16,17,33,58,43,101,0.000333,0.169828,16,8151.740897,452.874494,509.483806,133.486868,2,0
0,0,13,13,15,21,36,53,47,100,0.000333,0.172331,14,7237.895002,402.105278,516.9925,150.842025,2,0
0,0,18,18,16,21,37,85,52,137,0.000333,0.237898,16,11419.12178,634.395654,713.695111,156.238666,3,0
0,0,11,11,14,15,29,45,33,78,0.000333,0.126308,14,5304.915247,294.717514,378.922518,111.906328,2,0
0,0,6,6,9,11,20,16,16,32,0.000333,0.046101,4,553.206796,30.733711,138.301699,66.583073,1,0
0,0,6,6,11,9,20,18,14,32,0.000333,0.046101,5,691.508495,38.417139,138.301699,66.583073,2,0
0,0,12,12,11,17,28,41,40,81,0.000333,0.129799,10,3893.957487,216.330971,389.395749,107.540616,2,0
0,0,8,8,9,14,23,24,25,49,0.000333,0.073885,4,886.618143,49.256564,221.654536,81.832294,1,0
0,0,12,12,13,19,32,43,40,83,0.000333,0.138333,12,4980,276.666667,415,128.816339,3,0
0,0,8,8,11,16,27,26,24,50,0.000333,0.079248,5,1188.721876,66.040104,237.744375,102.053748,2,0
0,0,13,13,13,20,33,47,43,90,0.000333,0.151332,12,5447.945649,302.663647,453.995471,134.544278,3,0
0,0,12,12,11,18,29,36,43,79,0.000333,0.127927,10,3837.804986,213.211388,383.780499,113.112398,2,0
0,0,12,12,13,20,33,38,43,81,0.000333,0.136199,12,4903.151084,272.397282,408.595924,134.544278,3,0
0,0,13,13,14,21,35,56,72,128,0.000333,0.218849,21,13787.51275,765.972931,656.548226,145.541635,2,0
0,0,8,8,15,17,32,41,30,71,0.000333,0.118333,7,2485,138.055556,355,128.090227,2,0
0,0,15,15,14,20,34,53,56,109,0.000333,0.184844,14,7763.468296,431.303794,554.53345,139.741531,2,0
0,0,15,15,15,21,36,54,58,112,0.000333,0.193011,14,8106.442402,450.357911,579.0316,150.842025,2,0
0,0,18,18,15,22,37,68,68,136,0.000333,0.236162,21,14878.19881,826.566601,708.485658,156.710855,2,0
0,0,10,10,14,17,31,47,36,83,0.000333,0.137066,14,5756.776113,319.820895,411.198294,122.789837,2,0
0,0,7,7,11,12,23,33,23,56,0.000333,0.08444,5,1266.597348,70.366519,253.31947,81.073298,1,0
0,0,19,19,19,23,42,67,76,143,0.000333,0.257034,27,20819.73757,1156.652087,771.101391,184.752548,2,0
0,0,8,8,13,14,27,37,25,62,0.000333,0.098268,6,1768.818151,98.267675,294.803025,101.408685,2,0
0,0,8,8,12,14,26,36,25,61,0.000333,0.095576,6,1720.360937,95.575608,286.726823,96.322519,2,0
0,0,18,18,21,24,45,93,60,153,0.000333,0.280085,20,16805.07048,933.615026,840.253524,202.277766,3,0
0,0,11,11,19,18,37,55,41,96,0.000333,0.166703,18,9001.935416,500.107523,500.107523,155.769273,2,0
0,0,15,15,20,21,41,73,51,124,0.000333,0.221445,20,13286.72897,738.15161,664.336449,178.677228,3,0
0,0,11,11,19,18,37,55,41,96,0.000333,0.166703,18,9001.935416,500.107523,500.107523,155.769273,2,0
0,0,15,15,20,21,41,73,51,124,0.000333,0.221445,20,13286.72897,738.15161,664.336449,178.677228,3,0
0,0,11,11,19,18,37,55,41,96,0.000333,0.166703,18,9001.935416,500.107523,500.107523,155.769273,2,0
0,0,7,7,11,10,21,25,22,47,0.000333,0.068813,10,2064.389189,114.688288,206.438919,71.273029,2,0
0,0,9,9,12,11,23,27,22,49,0.000333,0.073885,12,2659.85443,147.769691,221.654536,81.073298,3,0
0,0,11,11,12,14,26,35,33,68,0.000333,0.106543,12,3835.55881,213.086601,319.629901,96.322519,2,0
0,0,11,11,13,13,26,34,29,63,0.000333,0.098709,12,3553.532427,197.418468,296.127702,96.211433,3,0
0,0,10,10,11,11,22,29,26,55,0.000333,0.081756,10,2452.68739,136.260411,245.268739,76.107496,2,0
0,0,11,11,11,12,23,28,26,54,0.000333,0.081424,10,2442.723456,135.706859,244.272346,81.073298,2,0
0,0,11,11,15,20,35,41,37,78,0.000333,0.133361,7,2800.588527,155.588252,400.084075,145.041921,2,0
0,0,11,11,16,21,37,42,39,81,0.000333,0.140655,8,3375.725781,187.540321,421.965723,156.238666,2,0
0,0,5,5,7,10,17,10,14,24,0.000333,0.0327,3,294.297325,16.349851,98.099108,52.870765,1,0
0,0,5,5,8,8,16,11,12,23,0.000333,0.030667,4,368,20.444444,92,48,1,0
0,0,13,13,14,20,34,54,48,102,0.000333,0.172974,14,7264.896937,403.605385,518.92121,139.741531,2,0
0,0,13,13,15,22,37,55,48,103,0.000333,0.178858,14,7512.031753,417.335097,536.573697,156.710855,2,0
0,0,8,8,11,13,24,45,29,74,0.000333,0.113096,10,3392.872251,188.492903,339.287225,86.159464,1,0
0,0,9,9,13,15,28,49,31,80,0.000333,0.128196,12,4615.060725,256.392263,384.588394,106.709075,2,0
0,0,9,9,12,15,27,48,31,79,0.000333,0.125212,12,4507.633352,250.424075,375.636113,101.622909,2,0
0,0,11,11,14,17,31,57,34,91,0.000333,0.150277,14,6311.646099,350.647006,450.831864,122.789837,2,0
0,0,13,13,16,19,35,42,40,82,0.000333,0.1402,16,6729.619318,373.86774,420.601207,144.710623,3,0
0,0,13,13,15,21,36,40,39,79,0.000333,0.136141,7,2858.968526,158.831585,408.424075,150.842025,2,0
0,0,13,13,17,18,35,46,42,88,0.000333,0.150459,16,7222.030488,401.223916,451.376905,144.545518,4,0
0,0,13,13,17,20,37,44,41,85,0.000333,0.147601,16,7084.856577,393.603143,442.803536,155.92543,3,0
0,0,14,14,16,19,35,53,46,99,0.000333,0.169266,16,8124.784299,451.376905,507.799019,144.710623,2,0
0,0,14,14,15,19,34,54,44,98,0.000333,0.16619,14,6979.999018,387.777723,498.571358,139.313982,3,0
0,0,14,14,15,19,34,54,44,98,0.000333,0.16619,14,6979.999018,387.777723,498.571358,139.313982,3,0
0,0,14,14,15,19,34,54,44,98,0.000333,0.16619,14,6979.999018,387.777723,498.571358,139.313982,3,0
0,0,14,14,15,19,34,54,44,98,0.000333,0.16619,14,6979.999018,387.777723,498.571358,139.313982,3,0
0,0,16,16,16,24,40,67,61,128,0.000333,0.227069,16,10899.30874,605.517152,681.206796,174.0391,2,0
0,0,9,9,15,17,32,38,36,74,0.000333,0.123333,14,5180,287.777778,370,128.090227,2,0
0,0,14,14,16,21,37,58,52,110,0.000333,0.191013,16,9168.637924,509.368774,573.03987,156.238666,2,0
0,0,15,15,17,17,34,63,48,111,0.000333,0.188236,16,9035.334006,501.963,564.708375,138.973737,2,0
0,0,10,10,12,15,27,47,32,79,0.000333,0.125212,12,4507.633352,250.424075,375.636113,101.622909,2,0
0,0,10,10,12,15,27,47,32,79,0.000333,0.125212,12,4507.633352,250.424075,375.636113,101.622909,2,0
0,0,13,13,12,19,31,40,52,92,0.000333,0.151929,12,5469.432727,303.857374,455.786061,123.730173,2,0
0,0,13,13,13,20,33,41,54,95,0.000333,0.159739,12,5750.609296,319.478294,479.217441,134.544278,2,0
0,0,16,16,16,19,35,53,45,98,0.000333,0.167557,16,8042.715771,446.817543,502.669736,144.710623,3,0
0,0,12,12,15,17,32,39,30,69,0.000333,0.115,7,2415,134.166667,345,128.090227,3,0
0,0,16,16,16,19,35,53,45,98,0.000333,0.167557,16,8042.715771,446.817543,502.669736,144.710623,3,0
0,0,12,12,15,17,32,39,30,69,0.000333,0.115,7,2415,134.166667,345,128.090227,3,0
0,0,16,16,18,18,36,66,53,119,0.000333,0.205074,18,11073.97935,615.221075,615.221075,150.1173,3,0
0,0,16,16,18,18,36,66,53,119,0.000333,0.205074,18,11073.97935,615.221075,615.221075,150.1173,3,0
0,0,16,16,18,22,40,65,62,127,0.000333,0.225295,18,12165.92763,675.884868,675.884868,173.166146,3,0
0,0,16,16,18,22,40,65,62,127,0.000333,0.225295,18,12165.92763,675.884868,675.884868,173.166146,3,0
0,0,15,15,17,23,40,60,50,110,0.000333,0.195137,16,9366.593447,520.366303,585.41209,173.528793,2,0
0,0,11,11,15,17,32,48,35,83,0.000333,0.138333,14,5810,322.777778,415,128.090227,2,0
0,0,10,10,15,16,31,43,30,73,0.000333,0.120552,7,2531.594315,140.644129,361.656331,122.603359,2,0
0,0,16,16,15,18,33,70,45,115,0.000333,0.193368,14,8121.474532,451.19303,580.105324,133.662009,3,0
0,0,11,11,15,15,30,48,33,81,0.000333,0.132486,14,5564.413935,309.134108,397.458138,117.206718,2,0
0,0,16,16,15,18,33,70,45,115,0.000333,0.193368,14,8121.474532,451.19303,580.105324,133.662009,3,0
0,0,11,11,15,15,30,48,33,81,0.000333,0.132486,14,5564.413935,309.134108,397.458138,117.206718,2,0
0,0,14,14,15,18,33,46,42,88,0.000333,0.147969,14,6214.693555,345.260753,443.906683,133.662009,3,0
0,0,10,10,15,16,31,32,27,59,0.000333,0.097433,7,2046.083076,113.671282,292.297582,122.603359,3,0
0,0,14,14,15,18,33,46,42,88,0.000333,0.147969,14,6214.693555,345.260753,443.906683,133.662009,3,0
0,0,10,10,15,16,31,32,27,59,0.000333,0.097433,7,2046.083076,113.671282,292.297582,122.603359,3,0
0,0,16,16,14,20,34,66,54,120,0.000333,0.203499,14,8546.937573,474.829865,610.495541,139.741531,2,0
0,0,15,15,14,20,34,64,52,116,0.000333,0.196715,14,8262.039654,459.002203,590.14569,139.741531,2,0
0,0,9,9,9,15,24,30,29,59,0.000333,0.090171,4,1082.05115,60.113953,270.512788,87.132684,1,0
0,0,16,16,15,21,36,66,54,120,0.000333,0.206797,14,8685.474002,482.526333,620.391,150.842025,2,0
0,0,15,15,15,21,36,64,52,116,0.000333,0.199904,14,8395.958202,466.442122,599.7113,150.842025,2,0
0,0,9,9,10,16,26,30,28,58,0.000333,0.090875,5,1363.127518,75.729307,272.625504,97.219281,1,0
0,0,20,20,15,22,37,84,67,151,0.000333,0.262209,21,16519.17662,917.732035,786.627458,156.710855,2,0
0,0,10,10,14,17,31,49,35,84,0.000333,0.138717,14,5826.134861,323.674159,416.15249,122.789837,2,0
0,0,17,17,15,22,37,70,57,127,0.000333,0.220534,14,9262.408084,514.578227,661.600577,156.710855,2,0
0,0,11,11,11,22,33,41,42,83,0.000333,0.139562,5,2093.42356,116.301309,418.684712,136.161243,3,0
0,0,12,12,11,22,33,42,44,86,0.000333,0.144606,10,4338.178943,241.009941,433.817894,136.161243,3,0
0,0,11,11,14,25,39,46,46,92,0.000333,0.162086,7,3403.799029,189.099946,486.257004,169.399374,4,0
0,0,12,12,14,25,39,47,48,95,0.000333,0.167371,7,3514.792476,195.266249,502.113211,169.399374,4,0
0,0,11,11,14,25,39,46,46,92,0.000333,0.162086,7,3403.799029,189.099946,486.257004,169.399374,4,0
0,0,12,12,14,25,39,47,48,95,0.000333,0.167371,7,3514.792476,195.266249,502.113211,169.399374,4,0
0,0,15,15,18,24,42,61,61,122,0.000333,0.219288,18,11841.52906,657.862726,657.862726,185.09775,6,0
0,0,15,15,17,26,43,59,60,119,0.000333,0.215242,16,10331.60809,573.978227,645.725506,191.698301,5,0
0,0,15,15,18,24,42,61,61,122,0.000333,0.219288,18,11841.52906,657.862726,657.862726,185.09775,6,0
0,0,15,15,17,26,43,59,60,119,0.000333,0.215242,16,10331.60809,573.978227,645.725506,191.698301,5,0
0,0,13,13,15,18,33,43,47,90,0.000333,0.151332,14,6355.93659,353.107588,453.995471,133.662009,4,0
0,0,13,13,14,20,34,41,46,87,0.000333,0.147536,14,6196.529741,344.251652,442.609267,139.741531,3,0
0,0,10,10,15,16,31,47,32,79,0.000333,0.130461,14,5479.341119,304.40784,391.381509,122.603359,2,0
0,0,10,10,14,16,30,46,32,78,0.000333,0.127579,14,5358.32453,297.684696,382.737466,117.302969,2,0
0,0,9,9,12,16,28,29,28,57,0.000333,0.09134,6,1644.115383,91.339744,274.019231,107.01955,2,0
0,0,13,13,16,13,29,44,38,82,0.000333,0.132785,16,6373.671066,354.092837,398.354442,112.105716,3,0
0,0,13,13,15,15,30,42,37,79,0.000333,0.129215,14,5427.020999,301.501167,387.644357,117.206718,2,0
0,0,5,5,11,11,22,21,17,38,0.000333,0.056486,5,847.292008,47.071778,169.458402,76.107496,2,0
0,0,9,9,12,14,26,30,28,58,0.000333,0.090875,12,3271.506044,181.750336,272.625504,96.322519,2,0
0,0,15,15,19,19,38,62,49,111,0.000333,0.194173,18,10485.35917,582.519954,582.519954,161.421246,5,0
0,0,15,15,18,21,39,60,48,108,0.000333,0.190274,18,10274.82191,570.82344,570.82344,167.297316,4,0
0,0,10,10,14,16,30,47,39,86,0.000333,0.140664,14,5907.896277,328.21646,421.992591,117.302969,2,0
0,0,10,10,14,16,30,47,39,86,0.000333,0.140664,14,5907.896277,328.21646,421.992591,117.302969,2,0
0,0,3,3,10,9,19,17,12,29,0.000333,0.041063,5,615.949489,34.219416,123.189898,61.748606,1,0
0,0,16,16,16,17,33,75,49,124,0.000333,0.208502,16,10008.07793,556.00433,625.504871,133.486868,3,0
0,0,10,10,15,14,29,45,31,76,0.000333,0.123069,14,5168.891779,287.160654,369.206556,111.906328,2,0
0,0,16,16,16,17,33,75,49,124,0.000333,0.208502,16,10008.07793,556.00433,625.504871,133.486868,3,0
0,0,10,10,15,14,29,45,31,76,0.000333,0.123069,14,5168.891779,287.160654,369.206556,111.906328,2,0
0,0,8,8,13,14,27,41,26,67,0.000333,0.106192,6,1911.464776,106.192488,318.577463,101.408685,2,0
0,0,8,8,13,14,27,41,26,67,0.000333,0.106192,6,1911.464776,106.192488,318.577463,101.408685,2,0
0,0,15,15,15,17,32,67,44,111,0.000333,0.185,14,7770,431.666667,555,128.090227,2,0
0,0,11,11,15,15,30,48,33,81,0.000333,0.132486,14,5564.413935,309.134108,397.458138,117.206718,2,0
0,0,16,16,15,18,33,70,45,115,0.000333,0.193368,14,8121.474532,451.19303,580.105324,133.662009,3,0
0,0,11,11,15,15,30,48,33,81,0.000333,0.132486,14,5564.413935,309.134108,397.458138,117.206718,2,0
0,0,16,16,15,18,33,70,45,115,0.000333,0.193368,14,8121.474532,451.19303,580.105324,133.662009,3,0
0,0,11,11,15,15,30,48,33,81,0.000333,0.132486,14,5564.413935,309.134108,397.458138,117.206718,2,0
0,0,17,17,15,24,39,69,78,147,0.000333,0.258985,21,16316.03665,906.446481,776.954126,168.642459,2,0
0,0,12,12,15,18,33,52,37,89,0.000333,0.14965,14,6285.315073,349.184171,448.951077,133.662009,3,0
0,0,11,11,15,17,32,47,32,79,0.000333,0.131667,7,2765,153.611111,395,128.090227,3,0
0,0,12,12,15,18,33,51,37,88,0.000333,0.147969,14,6214.693555,345.260753,443.906683,133.662009,3,0
0,0,11,11,15,17,32,46,32,78,0.000333,0.13,7,2730,151.666667,390,128.090227,3,0
0,0,12,12,13,19,32,41,42,83,0.000333,0.138333,12,4980,276.666667,415,128.816339,2,0
0,0,12,12,14,21,35,43,43,86,0.000333,0.147039,14,6175.656752,343.092042,441.118339,145.541635,2,0
0,0,13,13,14,22,36,48,48,96,0.000333,0.165438,14,6948.379202,386.021067,496.3128,151.410465,2,0
0,0,11,11,13,13,26,34,29,63,0.000333,0.098709,12,3553.532427,197.418468,296.127702,96.211433,3,0
0,0,12,12,13,12,25,35,30,65,0.000333,0.100617,12,3622.207828,201.233768,301.850652,91.125266,3,0
0,0,12,12,17,16,33,52,37,89,0.000333,0.14965,16,7183.217226,399.067624,448.951077,133.486868,3,0
0,0,12,12,17,16,33,52,37,89,0.000333,0.14965,16,7183.217226,399.067624,448.951077,133.486868,3,0
0,0,19,19,15,19,34,74,52,126,0.000333,0.213673,14,8974.284452,498.571358,641.020318,139.313982,3,0
0,0,10,10,14,14,28,42,31,73,0.000333,0.116979,14,4913.11673,272.950929,350.936909,106.605938,2,0
0,0,15,15,15,19,34,58,40,98,0.000333,0.16619,14,6979.999018,387.777723,498.571358,139.313982,3,0
0,0,15,15,15,19,34,58,40,98,0.000333,0.16619,14,6979.999018,387.777723,498.571358,139.313982,3,0
0,0,12,12,14,15,29,46,35,81,0.000333,0.131165,14,5508.950448,306.052803,393.496461,111.906328,2,0
0,0,16,16,14,17,31,64,47,111,0.000333,0.183305,14,7698.821066,427.712281,549.91579,122.789837,3,0
0,0,13,13,14,17,31,50,37,87,0.000333,0.143672,14,6034.211106,335.23395,431.015079,122.789837,3,0
0,0,16,16,14,17,31,63,47,110,0.000333,0.181654,14,7629.462318,423.859018,544.961594,122.789837,3,0
0,0,13,13,14,17,31,49,37,86,0.000333,0.14202,14,5964.852358,331.380687,426.060883,122.789837,3,0
0,0,7,7,11,11,22,25,22,47,0.000333,0.069864,10,2095.932861,116.440714,209.593286,76.107496,2,0
0,0,15,15,14,15,29,60,45,105,0.000333,0.170029,21,10711.84809,595.102672,510.088004,111.906328,2,0
0,0,10,10,14,14,28,42,31,73,0.000333,0.116979,14,4913.11673,272.950929,350.936909,106.605938,2,0
0,0,12,12,14,15,29,46,35,81,0.000333,0.131165,14,5508.950448,306.052803,393.496461,111.906328,2,0
0,0,11,11,14,15,29,44,33,77,0.000333,0.124688,14,5236.903513,290.939084,374.064537,111.906328,2,0
0,0,10,10,14,15,29,46,31,77,0.000333,0.124688,14,5236.903513,290.939084,374.064537,111.906328,2,0
0,0,10,10,14,15,29,46,31,77,0.000333,0.124688,14,5236.903513,290.939084,374.064537,111.906328,2,0
0,0,9,9,12,12,24,29,25,54,0.000333,0.082529,12,2971.0557,165.05865,247.587975,86.0391,2,0
0,0,8,8,12,12,24,30,25,55,0.000333,0.084058,12,3026.07525,168.115292,252.172938,86.0391,2,0
0,0,5,5,11,15,26,20,22,42,0.000333,0.065806,5,987.092341,54.838463,197.418468,96.657107,2,0
0,0,15,15,17,21,38,57,48,105,0.000333,0.183677,16,8816.518223,489.806568,551.032389,161.725534,4,0
0,0,10,10,14,16,30,34,28,62,0.000333,0.101409,7,2129.590518,118.310584,304.227217,117.302969,3,0
0,0,15,15,17,21,38,56,48,104,0.000333,0.181928,16,8732.551382,485.141743,545.784461,161.725534,4,0
0,0,10,10,14,16,30,33,28,61,0.000333,0.099773,7,2095.242284,116.402349,299.320326,117.302969,3,0
0,0,5,5,11,15,26,20,22,42,0.000333,0.065806,5,987.092341,54.838463,197.418468,96.657107,2,0
0,0,15,15,17,20,37,56,47,103,0.000333,0.178858,16,8585.179147,476.954397,536.573697,155.92543,4,0
0,0,5,5,12,13,25,21,20,41,0.000333,0.063466,6,1142.388623,63.466035,190.398104,91.125266,2,0
0,0,10,10,14,16,30,33,27,60,0.000333,0.098138,7,2060.89405,114.494114,294.413436,117.302969,3,0
0,0,15,15,17,20,37,56,47,103,0.000333,0.178858,16,8585.179147,476.954397,536.573697,155.92543,4,0
0,0,5,5,12,13,25,21,20,41,0.000333,0.063466,6,1142.388623,63.466035,190.398104,91.125266,2,0
0,0,10,10,14,15,29,33,27,60,0.000333,0.09716,7,2040.352018,113.35289,291.47886,111.906328,3,0
0,0,8,8,13,12,25,26,19,45,0.000333,0.069658,6,1253.841171,69.657843,208.973529,91.125266,3,0
0,0,8,8,13,12,25,26,19,45,0.000333,0.069658,6,1253.841171,69.657843,208.973529,91.125266,3,0
0,0,8,8,13,12,25,26,19,45,0.000333,0.069658,6,1253.841171,69.657843,208.973529,91.125266,3,0
0,0,9,9,13,13,26,29,21,50,0.000333,0.078341,6,1410.131915,78.340662,235.021986,96.211433,3,0
0,0,10,10,14,16,30,47,39,86,0.000333,0.140664,14,5907.896277,328.21646,421.992591,117.302969,2,0
0,0,17,17,16,22,38,69,54,123,0.000333,0.215165,16,10327.92135,573.773408,645.495084,162.107496,2,0
0,0,10,10,13,18,31,41,32,73,0.000333,0.120552,6,2169.937984,120.55211,361.656331,123.164366,2,0
0,0,11,11,15,18,33,56,38,94,0.000333,0.158058,14,6638.422661,368.801259,474.173047,133.662009,2,0
0,0,16,16,13,21,34,53,66,119,0.000333,0.201803,18,10897.34541,605.408078,605.408078,140.344382,2,0
0,0,16,16,14,23,37,55,71,126,0.000333,0.218797,21,13784.21361,765.789645,656.391124,157.344894,2,0
0,0,17,17,14,24,38,60,76,136,0.000333,0.237906,21,14988.08098,832.671165,713.718142,163.342069,2,0
0,0,14,14,13,20,33,47,54,101,0.000333,0.169828,12,6113.805673,339.655871,509.483806,134.544278,2,0
0,0,14,14,14,22,36,49,57,106,0.000333,0.182671,14,7672.168702,426.231595,548.01205,151.410465,2,0
0,0,15,15,14,23,37,54,62,116,0.000333,0.201432,14,8460.152266,470.008459,604.29659,157.344894,2,0
0,0,9,9,13,15,28,30,26,56,0.000333,0.089737,6,1615.271254,89.737292,269.211876,106.709075,2,0
0,0,9,9,13,15,28,30,26,56,0.000333,0.089737,6,1615.271254,89.737292,269.211876,106.709075,2,0
0,0,11,11,15,23,38,58,41,99,0.000333,0.173182,7,3636.813767,202.045209,519.544824,162.645284,5,0
0,0,10,10,15,21,36,56,37,93,0.000333,0.160268,7,3365.621176,186.978954,480.803025,150.842025,5,0
0,0,8,8,10,13,23,36,29,65,0.000333,0.098011,10,2940.315271,163.350848,294.031527,81.324997,2,0
0,0,12,12,15,15,30,57,36,93,0.000333,0.152114,14,6388.771555,354.931753,456.340825,117.206718,4,0
0,0,9,9,12,15,27,41,27,68,0.000333,0.107777,6,1939.994101,107.77745,323.33235,101.622909,4,0
0,0,5,5,10,11,21,24,18,42,0.000333,0.061492,5,922.386659,51.243703,184.477332,71.273029,2,0
0,0,18,18,18,27,45,93,57,150,0.000333,0.274593,18,14828.00336,823.777964,823.777964,203.440613,7,0
0,0,21,21,18,44,62,104,79,183,0.000333,0.363206,9,9806.561323,544.808962,1089.617925,315.273641,9,0
0,0,17,17,15,24,39,74,49,123,0.000333,0.216701,14,9101.462621,505.636812,650.104473,168.642459,8,0
0,0,12,12,14,19,33,55,42,97,0.000333,0.163102,14,6850.287214,380.571512,489.30623,134.013592,5,0
0,0,6,6,10,9,19,19,14,33,0.000333,0.046727,5,700.90804,38.939336,140.181608,61.748606,1,0
0,0,12,12,14,19,33,46,36,82,0.000333,0.13788,7,2895.482225,160.860124,413.640318,134.013592,3,0
0,0,11,11,14,18,32,41,31,72,0.000333,0.12,7,2520,140,360,128.361619,3,0
0,0,12,12,14,19,33,45,36,81,0.000333,0.136199,7,2860.171466,158.898415,408.595924,134.013592,3,0
0,0,11,11,14,18,32,40,31,71,0.000333,0.118333,7,2485,138.055556,355,128.361619,3,0
0,0,11,11,14,17,31,42,34,76,0.000333,0.125506,14,5271.264874,292.848049,376.51892,122.789837,2,0
0,0,10,10,14,16,30,37,29,66,0.000333,0.107952,7,2266.983455,125.943525,323.854779,117.302969,2,0
0,0,12,12,14,17,31,45,35,80,0.000333,0.132112,14,5548.699868,308.261104,396.335705,122.789837,3,0
0,0,11,11,14,16,30,40,30,70,0.000333,0.114494,7,2404.376392,133.576466,343.482342,117.302969,3,0
0,0,12,12,14,17,31,45,35,80,0.000333,0.132112,14,5548.699868,308.261104,396.335705,122.789837,3,0
0,0,11,11,14,16,30,40,30,70,0.000333,0.114494,7,2404.376392,133.576466,343.482342,117.302969,3,0
0,0,14,14,18,24,42,59,57,116,0.000333,0.208503,18,11259.15878,625.508821,625.508821,185.09775,2,0
0,0,12,12,16,21,37,49,39,88,0.000333,0.152811,8,3667.455169,203.747509,458.431896,156.238666,2,0
0,0,12,12,17,22,39,51,42,93,0.000333,0.163847,8,3932.339251,218.463292,491.542406,167.594364,2,0
0,0,9,9,12,13,25,32,29,61,0.000333,0.094425,12,3399.302731,188.850152,283.275228,91.125266,2,0
0,0,9,9,12,13,25,32,29,61,0.000333,0.094425,12,3399.302731,188.850152,283.275228,91.125266,2,0
0,0,11,11,13,13,26,34,29,63,0.000333,0.098709,12,3553.532427,197.418468,296.127702,96.211433,3,0
0,0,17,17,19,27,46,78,62,140,0.000333,0.257766,18,13919.37613,773.298674,773.298674,209.092585,2,0
0,0,11,11,19,18,37,55,41,96,0.000333,0.166703,18,9001.935416,500.107523,500.107523,155.769273,2,0
0,0,11,11,19,18,37,58,43,101,0.000333,0.175385,18,9470.786219,526.15479,526.15479,155.769273,2,0
0,0,16,16,19,25,44,76,64,140,0.000333,0.254773,18,13757.76768,764.320427,764.320427,196.807027,2,0
0,0,11,11,18,21,39,57,46,103,0.000333,0.181465,18,9799.135714,544.396429,544.396429,167.297316,2,0
0,0,11,11,11,11,22,28,26,54,0.000333,0.08027,10,2408.093074,133.782949,240.809307,76.107496,2,0
0,0,11,11,11,12,23,28,26,54,0.000333,0.081424,10,2442.723456,135.706859,244.272346,81.073298,2,0
0,0,11,11,11,12,23,28,26,54,0.000333,0.081424,10,2442.723456,135.706859,244.272346,81.073298,2,0
0,0,11,11,11,11,22,28,26,54,0.000333,0.08027,10,2408.093074,133.782949,240.809307,76.107496,2,0
0,0,11,11,11,12,23,28,26,54,0.000333,0.081424,10,2442.723456,135.706859,244.272346,81.073298,2,0
0,0,13,13,16,18,34,55,40,95,0.000333,0.161103,16,7732.943519,429.607973,483.30897,139.05865,2,0
0,0,14,14,15,21,36,59,56,115,0.000333,0.19818,14,8323.579252,462.42107,594.541375,150.842025,2,0
0,0,14,14,15,21,36,59,56,115,0.000333,0.19818,14,8323.579252,462.42107,594.541375,150.842025,2,0
0,0,14,14,15,17,32,60,47,107,0.000333,0.178333,14,7490,416.111111,535,128.090227,2,0
0,0,14,14,15,17,32,60,47,107,0.000333,0.178333,14,7490,416.111111,535,128.090227,2,0
0,0,12,12,14,16,30,55,38,93,0.000333,0.152114,14,6388.771555,354.931753,456.340825,117.302969,1,0
0,0,35,35,20,57,77,150,133,283,0.000333,0.591167,20,35470.01182,1970.556212,1773.500591,418.913293,9,0
0,0,34,34,20,57,77,149,131,280,0.000333,0.5849,20,35094.00463,1949.666924,1754.700231,418.913293,9,0
0,0,35,35,23,60,83,153,142,295,0.000333,0.626879,22,41374.00591,2298.555884,1880.636632,458.455361,10,0
0,0,34,34,23,60,83,152,140,292,0.000333,0.620504,22,40953.25331,2275.180739,1861.511514,458.455361,10,0
0,0,8,8,13,12,25,26,19,45,0.000333,0.069658,6,1253.841171,69.657843,208.973529,91.125266,3,0
0,0,8,8,13,12,25,26,19,45,0.000333,0.069658,6,1253.841171,69.657843,208.973529,91.125266,3,0
0,0,8,8,13,12,25,26,19,45,0.000333,0.069658,6,1253.841171,69.657843,208.973529,91.125266,3,0
0,0,8,8,13,12,25,26,19,45,0.000333,0.069658,6,1253.841171,69.657843,208.973529,91.125266,3,0
0,0,8,8,13,12,25,26,19,45,0.000333,0.069658,6,1253.841171,69.657843,208.973529,91.125266,3,0
0,0,8,8,13,12,25,26,19,45,0.000333,0.069658,6,1253.841171,69.657843,208.973529,91.125266,3,0
0,0,14,14,14,19,33,68,44,112,0.000333,0.188324,14,7909.609979,439.422777,564.972141,134.013592,5,0
0,0,3,3,12,15,27,18,21,39,0.000333,0.061814,6,1112.643676,61.813538,185.440613,101.622909,1,0
0,0,14,14,12,18,30,48,43,91,0.000333,0.148842,12,5358.32453,297.684696,446.527044,118.0782,2,0
0,0,8,8,7,13,20,22,23,45,0.000333,0.064829,3,583.460293,32.414461,194.486764,67.757201,1,0
0,0,14,14,13,20,33,49,44,93,0.000333,0.156376,12,5629.543837,312.752435,469.128653,134.544278,2,0
0,0,8,8,8,15,23,23,23,46,0.000333,0.069361,4,832.3354,46.240856,208.08385,82.603359,1,0
0,0,18,18,14,23,37,67,57,124,0.000333,0.215324,14,9043.611043,502.422836,645.972217,157.344894,2,0
0,0,9,9,13,17,30,39,30,69,0.000333,0.112858,6,2031.452707,112.858484,338.575451,117.592585,2,0
0,0,15,15,13,21,34,53,47,100,0.000333,0.169582,12,6104.95541,339.164189,508.746284,140.344382,2,0
0,0,16,16,18,19,37,66,46,112,0.000333,0.194486,18,10502.25799,583.458777,583.458777,155.769273,3,0
0,0,15,15,16,18,34,60,40,100,0.000333,0.169582,16,8139.940546,452.218919,508.746284,139.05865,3,0
0,0,10,10,14,15,29,38,28,66,0.000333,0.106876,7,2244.38722,124.688179,320.626746,111.906328,2,0
0,0,15,15,16,18,34,60,40,100,0.000333,0.169582,16,8139.940546,452.218919,508.746284,139.05865,3,0
0,0,10,10,14,15,29,38,28,66,0.000333,0.106876,7,2244.38722,124.688179,320.626746,111.906328,2,0
0,0,15,15,18,19,37,64,45,109,0.000333,0.189277,18,10220.9475,567.830417,567.830417,155.769273,3,0
0,0,9,9,14,14,28,35,26,61,0.000333,0.09775,7,2052.740552,114.041142,293.24865,106.605938,2,0
0,0,13,13,15,17,32,55,38,93,0.000333,0.155,14,6510,361.666667,465,128.090227,2,0
0,0,9,9,14,14,28,35,26,61,0.000333,0.09775,7,2052.740552,114.041142,293.24865,106.605938,2,0
0,0,15,15,16,18,34,64,44,108,0.000333,0.183149,16,8791.13579,488.396433,549.445987,139.05865,2,0
0,0,9,9,14,14,28,35,26,61,0.000333,0.09775,7,2052.740552,114.041142,293.24865,106.605938,2,0
0,0,8,8,10,16,26,32,32,64,0.000333,0.100276,10,3008.28142,167.126746,300.828142,97.219281,1,0
0,0,8,8,11,19,30,33,31,64,0.000333,0.10468,5,1570.204991,87.233611,314.040998,118.764371,1,0
0,0,16,16,15,27,42,68,61,129,0.000333,0.23187,14,9738.525266,541.029181,695.608948,186.985321,2,0
0,0,10,10,16,12,28,41,30,71,0.000333,0.113774,16,5461.155191,303.397511,341.322199,107.01955,4,0
0,0,10,10,16,14,30,39,29,68,0.000333,0.111223,16,5338.696968,296.594276,333.668561,117.302969,3,0
0,0,12,12,16,14,30,47,32,79,0.000333,0.129215,16,6202.309713,344.572762,387.644357,117.302969,6,0
0,0,12,12,16,16,32,45,31,76,0.000333,0.126667,8,3040,168.888889,380,128,5,0
0,0,12,12,16,13,29,47,32,79,0.000333,0.127927,16,6140.487978,341.138221,383.780499,112.105716,6,0
0,0,12,12,16,15,31,45,31,76,0.000333,0.125506,16,6024.302713,334.683484,376.51892,122.603359,5,0
0,0,12,12,16,14,30,47,32,79,0.000333,0.129215,16,6202.309713,344.572762,387.644357,117.302969,6,0
0,0,12,12,16,16,32,45,31,76,0.000333,0.126667,8,3040,168.888889,380,128,5,0
0,0,12,12,16,13,29,47,32,79,0.000333,0.127927,16,6140.487978,341.138221,383.780499,112.105716,6,0
0,0,12,12,16,15,31,45,31,76,0.000333,0.125506,16,6024.302713,334.683484,376.51892,122.603359,5,0
0,0,12,12,14,14,28,41,30,71,0.000333,0.113774,14,4778.510793,265.472822,341.322199,106.605938,5,0
0,0,12,12,14,16,30,39,29,68,0.000333,0.111223,7,2335.679924,129.759996,333.668561,117.302969,4,0
0,0,12,12,14,13,27,41,30,71,0.000333,0.112532,14,4726.358177,262.575454,337.597013,101.408685,5,0
0,0,12,12,14,15,29,39,29,68,0.000333,0.110114,7,2312.398954,128.466609,330.342708,111.906328,4,0
0,0,16,16,17,14,31,57,38,95,0.000333,0.156883,16,7530.378392,418.354355,470.648649,122.789837,6,0
0,0,16,16,17,16,33,55,37,92,0.000333,0.154695,16,7425.348144,412.519341,464.084259,133.486868,5,0
0,0,16,16,17,13,30,57,38,95,0.000333,0.155385,16,7458.473705,414.35965,466.154607,117.592585,6,0
0,0,16,16,17,15,32,55,37,92,0.000333,0.153333,16,7360,408.888889,460,128.090227,5,0
0,0,16,16,15,14,29,51,36,87,0.000333,0.140881,14,5917.020852,328.723381,422.644347,111.906328,5,0
0,0,16,16,15,16,31,49,35,84,0.000333,0.138717,14,5826.134861,323.674159,416.15249,122.603359,4,0
0,0,16,16,15,13,28,51,36,87,0.000333,0.139413,14,5855.358295,325.297683,418.239878,106.709075,5,0
0,0,16,16,15,15,30,49,35,84,0.000333,0.137393,14,5770.50334,320.583519,412.17881,117.206718,4,0
0,0,17,17,16,23,39,77,60,137,0.000333,0.241367,16,11585.60166,643.644537,724.100104,168.041925,2,0
0,0,10,10,14,18,32,48,36,84,0.000333,0.14,14,5880,326.666667,420,128.361619,2,0
0,0,11,11,14,19,33,47,41,88,0.000333,0.147969,14,6214.693555,345.260753,443.906683,134.013592,2,0
0,0,10,10,14,17,31,44,34,78,0.000333,0.128809,14,5409.982371,300.554576,386.427312,122.789837,2,0
0,0,19,19,16,25,41,78,72,150,0.000333,0.267878,16,12858.12481,714.340267,803.632801,180.096405,2,0
0,0,10,10,14,19,33,46,39,85,0.000333,0.142925,14,6002.829002,333.4905,428.7735,134.013592,2,0
0,0,11,11,11,19,30,50,45,95,0.000333,0.155385,10,4661.546066,258.974781,466.154607,118.764371,1,0
0,0,10,10,9,16,25,37,61,98,0.000333,0.151699,12,5461.174879,303.398604,455.097907,92.529325,1,0
0,0,15,15,11,21,32,62,73,135,0.000333,0.225,15,10125,562.5,675,130.292414,1,0
0,0,14,14,18,18,36,59,41,100,0.000333,0.172331,18,9305.865003,516.9925,516.9925,150.1173,7,0
0,0,14,14,17,20,37,57,40,97,0.000333,0.168439,16,8085.071623,449.170646,505.316976,155.92543,6,0
0,0,10,10,14,20,34,44,31,75,0.000333,0.127187,7,2670.917992,148.384333,381.559713,139.741531,5,0
0,0,11,11,14,20,34,45,33,78,0.000333,0.132274,7,2777.754711,154.319706,396.822102,139.741531,5,0
0,0,14,14,18,18,36,59,41,100,0.000333,0.172331,18,9305.865003,516.9925,516.9925,150.1173,7,0
0,0,14,14,17,20,37,57,40,97,0.000333,0.168439,16,8085.071623,449.170646,505.316976,155.92543,6,0
0,0,10,10,14,20,34,44,31,75,0.000333,0.127187,7,2670.917992,148.384333,381.559713,139.741531,5,0
0,0,11,11,14,20,34,45,33,78,0.000333,0.132274,7,2777.754711,154.319706,396.822102,139.741531,5,0
0,0,12,12,15,12,27,41,30,71,0.000333,0.112532,14,4726.358177,262.575454,337.597013,101.622909,5,0
0,0,12,12,14,14,28,39,29,68,0.000333,0.108967,14,4576.601886,254.25566,326.900135,106.605938,4,0
0,0,12,12,15,12,27,41,30,71,0.000333,0.112532,14,4726.358177,262.575454,337.597013,101.622909,5,0
0,0,12,12,14,14,28,39,29,68,0.000333,0.108967,14,4576.601886,254.25566,326.900135,106.605938,4,0
0,0,22,22,19,44,63,101,87,188,0.000333,0.374576,9,10113.55763,561.864313,1123.728626,320.925614,7,0
0,0,22,22,20,45,65,102,93,195,0.000333,0.391454,20,23487.23447,1304.846359,1174.361724,333.571951,7,0
0,0,42,42,30,53,83,166,142,308,0.000333,0.654504,30,58905.36435,3272.520241,1963.512145,450.786502,12,0
0,0,42,42,29,55,84,164,141,305,0.000333,0.649886,28,54590.39079,3032.799488,1949.656814,458.856233,11,0
0,0,15,15,20,18,38,49,67,116,0.000333,0.20292,30,18262.78775,1014.599319,608.759592,161.497212,3,0
0,0,15,15,19,20,39,47,66,113,0.000333,0.199083,27,16125.76217,895.875676,597.250451,167.149185,2,0
0,0,17,17,15,21,36,78,59,137,0.000333,0.236093,14,9915.916153,550.884231,708.279725,150.842025,5,0
0,0,8,8,11,13,24,26,30,56,0.000333,0.085586,10,2567.579,142.643278,256.7579,86.159464,1,0
0,0,8,8,11,13,24,26,30,56,0.000333,0.085586,10,2567.579,142.643278,256.7579,86.159464,1,0
0,0,16,16,15,18,33,68,49,117,0.000333,0.196731,14,8262.717568,459.039865,590.194112,133.662009,2,0
0,0,10,10,14,14,28,42,31,73,0.000333,0.116979,14,4913.11673,272.950929,350.936909,106.605938,2,0
0,0,10,10,14,14,28,45,33,78,0.000333,0.124991,14,5249.631575,291.646199,374.973684,106.605938,2,0
0,0,28,28,19,48,67,119,106,225,0.000333,0.454957,18,24567.66122,1364.870068,1364.870068,348.788823,8,0
0,0,27,27,19,48,67,118,104,222,0.000333,0.448891,18,24240.09241,1346.6718,1346.6718,348.788823,8,0
0,0,28,28,22,51,73,124,110,234,0.000333,0.482806,22,31865.21683,1770.289824,1448.418947,387.401188,9,0
0,0,27,27,22,51,73,123,108,231,0.000333,0.476616,22,31456.68841,1747.5938,1429.849473,387.401188,9,0
0,0,14,14,15,18,33,45,56,101,0.000333,0.169828,21,10699.15993,594.397774,509.483806,133.662009,3,0
0,0,14,14,14,20,34,43,55,98,0.000333,0.16619,14,6979.999018,387.777723,498.571358,139.741531,2,0
0,0,30,30,25,49,74,135,117,252,0.000333,0.521594,24,37554.77396,2086.376331,1564.782248,391.217187,10,0
0,0,30,30,24,51,75,133,116,249,0.000333,0.516992,24,37223.42049,2067.967805,1550.975854,399.332792,9,0
0,0,12,12,15,13,28,41,36,77,0.000333,0.123389,14,5182.328606,287.907145,370.166329,106.709075,3,0
0,0,12,12,14,15,29,39,35,74,0.000333,0.11983,14,5032.868311,279.603795,359.490594,111.906328,2,0
0,0,28,28,25,44,69,131,97,228,0.000333,0.464248,24,33425.84583,1856.991435,1392.743576,356.311396,10,0
0,0,28,28,24,46,70,129,96,225,0.000333,0.459696,24,33098.12829,1838.784905,1379.088679,364.12295,9,0
0,0,26,26,22,46,68,120,90,210,0.000333,0.426122,11,14062.03916,781.224398,1278.367197,352.191346,9,0
0,0,25,25,22,46,68,119,88,207,0.000333,0.420035,11,13861.15289,770.064049,1260.104808,352.191346,9,0
0,0,23,23,19,42,61,101,78,179,0.000333,0.353867,9,9554.417851,530.800992,1061.601983,307.187955,7,0
0,0,13,13,16,13,29,44,38,82,0.000333,0.132785,16,6373.671066,354.092837,398.354442,112.105716,3,0
0,0,13,13,15,15,30,42,37,79,0.000333,0.129215,14,5427.020999,301.501167,387.644357,117.206718,2,0
0,0,23,23,19,40,59,102,78,180,0.000333,0.352959,9,9529.88174,529.437874,1058.875749,293.587747,7,0
0,0,19,19,19,38,57,93,67,160,0.000333,0.311087,9,8399.36162,466.631201,933.262402,280.131868,7,0
0,0,29,29,26,44,70,134,99,233,0.000333,0.476041,26,37131.19652,2062.844251,1428.122943,362.426424,10,0
0,0,29,29,25,46,71,132,98,230,0.000333,0.471481,24,33946.6041,1885.92245,1414.441837,370.180255,9,0
0,0,20,20,17,42,59,92,70,162,0.000333,0.317663,8,7623.905392,423.5503,952.988174,295.9642,7,0
0,0,19,19,17,42,59,91,68,159,0.000333,0.31178,8,7482.721959,415.706775,935.340245,295.9642,7,0
0,0,7,7,14,11,25,31,24,55,0.000333,0.085137,14,3575.769266,198.653848,255.41209,91.356717,3,0
0,0,7,7,13,13,26,29,23,52,0.000333,0.081474,6,1466.537192,81.474288,244.422865,96.211433,2,0
0,0,7,7,15,11,26,35,26,61,0.000333,0.095576,14,4014.175519,223.009751,286.726823,96.657107,4,0
0,0,7,7,15,13,28,33,25,58,0.000333,0.092942,7,1951.786098,108.432561,278.826585,106.709075,3,0
0,0,20,20,18,40,58,93,68,161,0.000333,0.314378,9,8488.214462,471.56747,943.13494,287.935774,7,0
0,0,19,19,18,40,58,92,66,158,0.000333,0.30852,9,8330.048975,462.780499,925.560997,287.935774,7,0
0,0,3,3,8,9,17,13,12,25,0.000333,0.034062,4,408.746284,22.708127,102.186571,52.529325,1,0
0,0,3,3,8,10,18,13,12,25,0.000333,0.034749,4,416.9925,23.16625,104.248125,57.219281,1,0
0,0,6,6,10,15,25,24,27,51,0.000333,0.078946,5,1184.183328,65.787963,236.836666,91.82264,1,0
0,0,5,5,9,13,22,21,20,41,0.000333,0.060946,4,731.346785,40.630377,182.836696,76.635041,1,0
0,0,11,11,10,16,26,42,64,106,0.000333,0.166082,20,9964.932202,553.607345,498.24661,97.219281,1,0
0,0,5,5,10,13,23,24,22,46,0.000333,0.069361,5,1040.41925,57.801069,208.08385,81.324997,1,0
0,0,5,5,11,15,26,20,22,42,0.000333,0.065806,5,987.092341,54.838463,197.418468,96.657107,2,0
0,0,17,17,19,28,47,72,61,133,0.000333,0.246253,18,13297.68571,738.760317,738.760317,215.316561,3,0
0,0,5,5,12,13,25,21,20,41,0.000333,0.063466,6,1142.388623,63.466035,190.398104,91.125266,2,0
0,0,5,5,12,16,28,23,24,47,0.000333,0.075315,6,1355.674088,75.315227,225.945681,107.01955,2,0
0,0,16,16,18,26,44,70,63,133,0.000333,0.242035,18,13069.8793,726.104405,726.104405,197.270083,3,0
0,0,5,5,12,17,29,23,25,48,0.000333,0.077728,6,1399.098527,77.727696,233.183088,112.506418,2,0
0,0,5,5,12,12,24,21,19,40,0.000333,0.061133,6,1100.391,61.132833,183.3985,86.0391,2,0
0,0,11,11,17,24,41,45,42,87,0.000333,0.155369,8,3728.856195,207.158678,466.107024,179.525968,3,0
0,0,5,5,12,13,25,21,20,41,0.000333,0.063466,6,1142.388623,63.466035,190.398104,91.125266,2,0
0,0,31,31,25,49,74,145,103,248,0.000333,0.513315,24,36958.66643,2053.259246,1539.944435,391.217187,14,0
0,0,31,31,24,51,75,143,102,245,0.000333,0.508687,24,36625.4539,2034.747439,1526.060579,399.332792,13,0
0,0,28,28,22,51,73,130,94,224,0.000333,0.462174,11,15251.72771,847.318206,1386.520701,387.401188,12,0
0,0,27,27,22,51,73,129,92,221,0.000333,0.455984,11,15047.4635,835.970195,1367.951228,387.401188,12,0
0,0,31,31,25,49,74,144,103,247,0.000333,0.511245,24,36809.63955,2044.979975,1533.734981,391.217187,14,0
0,0,31,31,24,51,75,142,102,244,0.000333,0.506611,24,36475.96225,2026.442347,1519.83176,399.332792,13,0
0,0,28,28,22,51,73,130,94,224,0.000333,0.462174,11,15251.72771,847.318206,1386.520701,387.401188,12,0
0,0,27,27,22,51,73,129,92,221,0.000333,0.455984,11,15047.4635,835.970195,1367.951228,387.401188,12,0
0,0,12,12,16,14,30,42,32,74,0.000333,0.121037,16,5809.758465,322.764359,363.109904,117.302969,5,0
0,0,12,12,15,16,31,40,31,71,0.000333,0.117249,7,2462.235566,136.790865,351.747938,122.603359,4,0
0,0,12,12,15,14,29,41,32,73,0.000333,0.118211,14,4964.856577,275.825365,354.632613,111.906328,5,0
0,0,12,12,14,16,30,39,31,70,0.000333,0.114494,7,2404.376392,133.576466,343.482342,117.302969,4,0
0,0,32,32,25,49,74,147,112,259,0.000333,0.536083,24,38597.96212,2144.331229,1608.248422,391.217187,13,0
0,0,32,32,24,51,75,145,111,256,0.000333,0.531526,24,38269.86203,2126.103446,1594.577585,399.332792,12,0
0,0,29,29,22,50,72,133,102,235,0.000333,0.483311,22,31898.51226,1772.13957,1449.932375,380.300305,11,0
0,0,28,28,22,50,72,132,100,232,0.000333,0.477141,22,31491.29721,1749.516512,1431.4226,380.300305,11,0
0,0,32,32,25,49,74,147,112,259,0.000333,0.536083,24,38597.96212,2144.331229,1608.248422,391.217187,13,0
0,0,32,32,24,51,75,145,111,256,0.000333,0.531526,24,38269.86203,2126.103446,1594.577585,399.332792,12,0
0,0,29,29,22,50,72,133,102,235,0.000333,0.483311,22,31898.51226,1772.13957,1449.932375,380.300305,11,0
0,0,28,28,22,50,72,132,100,232,0.000333,0.477141,22,31491.29721,1749.516512,1431.4226,380.300305,11,0
0,0,13,13,15,14,29,44,38,82,0.000333,0.132785,14,5576.962182,309.831232,398.354442,111.906328,4,0
0,0,13,13,14,16,30,42,37,79,0.000333,0.129215,14,5427.020999,301.501167,387.644357,117.302969,3,0
0,0,13,13,16,17,33,56,39,95,0.000333,0.159739,16,7667.479061,425.971059,479.217441,133.486868,2,0
0,0,19,19,19,23,42,73,79,152,0.000333,0.273211,27,22130.0707,1229.448372,819.632248,184.752548,2,0
0,0,8,8,15,20,35,43,33,76,0.000333,0.129942,7,2728.778565,151.598809,389.825509,145.041921,2,0
0,0,12,12,14,17,31,41,32,73,0.000333,0.120552,7,2531.594315,140.644129,361.656331,122.789837,3,0
0,0,11,11,14,16,30,36,27,63,0.000333,0.103045,7,2163.938753,120.21882,309.134108,117.302969,3,0
0,0,12,12,14,17,31,41,32,73,0.000333,0.120552,7,2531.594315,140.644129,361.656331,122.789837,3,0
0,0,11,11,14,16,30,36,27,63,0.000333,0.103045,7,2163.938753,120.21882,309.134108,117.302969,3,0
0,0,12,12,14,17,31,42,33,75,0.000333,0.123855,7,2600.953063,144.497392,371.564723,122.789837,3,0
0,0,11,11,14,16,30,37,28,65,0.000333,0.106316,7,2232.635221,124.03529,318.947889,117.302969,3,0
0,0,12,12,14,17,31,41,33,74,0.000333,0.122204,7,2566.273689,142.57076,366.610527,122.789837,3,0
0,0,11,11,14,16,30,36,28,64,0.000333,0.10468,7,2198.286987,122.127055,314.040998,117.302969,3,0
0,0,12,12,14,18,32,42,33,75,0.000333,0.125,7,2625,145.833333,375,128.361619,3,0
0,0,11,11,14,17,31,37,28,65,0.000333,0.107341,7,2254.159321,125.231073,322.02276,122.789837,3,0
0,0,12,12,14,18,32,41,33,74,0.000333,0.123333,7,2590,143.888889,370,128.361619,3,0
0,0,11,11,14,17,31,36,28,64,0.000333,0.10569,7,2219.479947,123.304442,317.068564,122.789837,3,0
0,0,12,12,14,17,31,41,32,73,0.000333,0.120552,7,2531.594315,140.644129,361.656331,122.789837,3,0
0,0,11,11,14,16,30,36,27,63,0.000333,0.103045,7,2163.938753,120.21882,309.134108,117.302969,3,0
0,0,12,12,14,17,31,41,32,73,0.000333,0.120552,7,2531.594315,140.644129,361.656331,122.789837,3,0
0,0,11,11,14,16,30,36,27,63,0.000333,0.103045,7,2163.938753,120.21882,309.134108,117.302969,3,0
0,0,14,14,18,25,43,64,59,123,0.000333,0.222477,18,12013.75017,667.430565,667.430565,191.155055,2,0
0,0,7,7,14,19,33,34,30,64,0.000333,0.107614,7,2259.888565,125.549365,322.841224,134.013592,2,0
0,0,11,11,15,18,33,56,38,94,0.000333,0.158058,14,6638.422661,368.801259,474.173047,133.662009,2,0
0,0,12,12,14,18,32,42,33,75,0.000333,0.125,7,2625,145.833333,375,128.361619,3,0
0,0,11,11,14,17,31,37,28,65,0.000333,0.107341,7,2254.159321,125.231073,322.02276,122.789837,3,0
0,0,12,12,14,18,32,41,33,74,0.000333,0.123333,7,2590,143.888889,370,128.361619,3,0
0,0,11,11,14,17,31,36,28,64,0.000333,0.10569,7,2219.479947,123.304442,317.068564,122.789837,3,0
0,0,10,10,13,14,27,44,29,73,0.000333,0.115702,12,4165.281452,231.404525,347.106788,101.408685,2,0
0,0,5,5,10,10,20,22,17,39,0.000333,0.056185,5,842.775979,46.820888,168.555196,66.438562,1,0
0,0,10,10,13,14,27,44,29,73,0.000333,0.115702,12,4165.281452,231.404525,347.106788,101.408685,2,0
0,0,5,5,10,10,20,22,17,39,0.000333,0.056185,5,842.775979,46.820888,168.555196,66.438562,1,0
0,0,11,11,12,14,26,47,34,81,0.000333,0.126912,12,4568.827406,253.823745,380.735617,96.322519,1,0
0,0,5,5,10,10,20,22,17,39,0.000333,0.056185,5,842.775979,46.820888,168.555196,66.438562,1,0
0,0,7,7,10,12,22,22,20,42,0.000333,0.062432,5,936.48064,52.026702,187.296128,76.238831,1,0
0,0,7,7,11,14,25,23,20,43,0.000333,0.066562,5,998.429081,55.468282,199.685816,91.356717,1,0
0,0,11,11,13,15,28,40,35,75,0.000333,0.120184,12,4326.61943,240.367746,360.551619,106.709075,2,0
0,0,12,12,16,14,30,47,32,79,0.000333,0.129215,16,6202.309713,344.572762,387.644357,117.302969,6,0
0,0,12,12,16,16,32,45,31,76,0.000333,0.126667,8,3040,168.888889,380,128,5,0
0,0,12,12,16,13,29,47,32,79,0.000333,0.127927,16,6140.487978,341.138221,383.780499,112.105716,6,0
0,0,12,12,16,15,31,45,31,76,0.000333,0.125506,16,6024.302713,334.683484,376.51892,122.603359,5,0
0,0,12,12,14,14,28,41,30,71,0.000333,0.113774,14,4778.510793,265.472822,341.322199,106.605938,5,0
0,0,12,12,14,16,30,39,29,68,0.000333,0.111223,7,2335.679924,129.759996,333.668561,117.302969,4,0
0,0,12,12,14,13,27,41,30,71,0.000333,0.112532,14,4726.358177,262.575454,337.597013,101.408685,5,0
0,0,12,12,14,15,29,39,29,68,0.000333,0.110114,7,2312.398954,128.466609,330.342708,111.906328,4,0
0,0,15,15,15,21,36,61,50,111,0.000333,0.191287,14,8034.063452,446.336858,573.861675,150.842025,2,0
0,0,9,9,13,16,29,37,30,67,0.000333,0.108495,6,1952.90836,108.494909,325.484727,112.105716,2,0
0,0,10,10,13,15,28,46,32,78,0.000333,0.124991,12,4499.684207,249.982456,374.973684,106.709075,1,0
0,0,14,14,15,21,36,59,56,115,0.000333,0.19818,14,8323.579252,462.42107,594.541375,150.842025,2,0
0,0,14,14,15,21,36,59,56,115,0.000333,0.19818,14,8323.579252,462.42107,594.541375,150.842025,2,0
0,0,12,12,11,19,30,57,57,114,0.000333,0.186462,15,8390.782918,466.154607,559.385528,118.764371,1,0
0,0,11,11,12,19,31,57,46,103,0.000333,0.170094,12,6123.38664,340.188147,510.28222,123.730173,1,0
0,0,13,13,12,21,33,58,58,116,0.000333,0.19505,12,7021.796614,390.099812,585.149718,135.258216,1,0
0,0,30,30,20,55,75,140,106,246,0.000333,0.510763,10,15322.89398,851.271888,1532.289398,404.413346,9,0
0,0,29,29,20,55,75,139,104,243,0.000333,0.504534,10,15136.02942,840.890523,1513.602942,404.413346,9,0
0,0,30,30,23,58,81,143,109,252,0.000333,0.532547,11,17574.06421,976.3369,1597.642201,443.804823,10,0
0,0,29,29,23,58,81,142,107,249,0.000333,0.526208,11,17364.84916,964.713842,1578.622651,443.804823,10,0
0,0,14,14,16,19,35,58,45,103,0.000333,0.176105,16,8453.058412,469.614356,528.316151,144.710623,3,0
0,0,14,14,16,19,35,58,45,103,0.000333,0.176105,16,8453.058412,469.614356,528.316151,144.710623,3,0
0,0,14,14,15,19,34,58,45,103,0.000333,0.17467,14,7336.121417,407.562301,524.008673,139.313982,3,0
0,0,14,14,15,19,34,58,45,103,0.000333,0.17467,14,7336.121417,407.562301,524.008673,139.313982,3,0
0,0,5,5,12,16,28,23,24,47,0.000333,0.075315,6,1355.674088,75.315227,225.945681,107.01955,2,0
0,0,18,18,19,28,47,84,68,152,0.000333,0.281433,18,15197.3551,844.297505,844.297505,215.316561,3,0
0,0,5,5,12,17,29,23,25,48,0.000333,0.077728,6,1399.098527,77.727696,233.183088,112.506418,2,0
0,0,9,9,12,18,30,34,26,60,0.000333,0.098138,6,1766.480614,98.137812,294.413436,118.0782,2,0
0,0,14,14,16,16,32,59,40,99,0.000333,0.165,16,7920,440,495,128,4,0
0,0,17,17,18,14,32,76,51,127,0.000333,0.211667,27,17145,952.5,635,128.361619,8,0
0,0,15,15,17,16,33,65,43,108,0.000333,0.181598,16,8716.713038,484.261835,544.794565,133.486868,6,0
0,0,12,12,18,14,32,49,33,82,0.000333,0.136667,18,7380,410,410,128.361619,5,0
0,0,17,17,17,16,33,71,48,119,0.000333,0.200094,24,14406.78961,800.3772,600.2829,133.486868,6,0
0,0,9,9,13,16,29,35,24,59,0.000333,0.09554,6,1719.725272,95.540293,286.620879,112.105716,2,0
0,0,14,14,14,16,30,55,38,93,0.000333,0.152114,14,6388.771555,354.931753,456.340825,117.302969,3,0
0,0,22,22,17,15,32,84,56,140,0.000333,0.233333,24,16800,933.333333,700,128.090227,7,0
0,0,20,20,15,17,32,73,48,121,0.000333,0.201667,14,8470,470.555556,605,128.090227,5,0
0,0,17,17,17,15,32,61,40,101,0.000333,0.168333,16,8080,448.888889,505,128.090227,5,0
0,0,22,22,15,17,32,79,53,132,0.000333,0.22,21,13860,770,660,128.090227,5,0
0,0,9,9,13,16,29,35,24,59,0.000333,0.09554,6,1719.725272,95.540293,286.620879,112.105716,2,0
0,0,10,10,15,16,31,39,35,74,0.000333,0.122204,14,5132.547378,285.141521,366.610527,122.603359,2,0
0,0,9,9,13,16,29,33,30,63,0.000333,0.102018,6,1836.316816,102.017601,306.052803,112.105716,2,0
0,0,10,10,14,16,30,38,35,73,0.000333,0.119401,14,5014.842189,278.602344,358.203013,117.302969,2,0
0,0,9,9,12,16,28,32,30,62,0.000333,0.099352,6,1788.336031,99.352002,298.056005,107.01955,2,0
0,0,9,9,13,14,27,35,33,68,0.000333,0.107777,12,3879.988202,215.5549,323.33235,101.408685,1,0
0,0,8,8,11,14,25,29,28,57,0.000333,0.088233,10,2646.998028,147.055446,264.699803,91.356717,1,0
0,0,14,14,18,23,41,52,64,116,0.000333,0.207159,18,11186.56859,621.476033,621.476033,179.100575,2,0
0,0,10,10,11,20,31,33,38,71,0.000333,0.117249,5,1758.73969,97.707761,351.747938,124.49231,1,0
0,0,10,10,12,21,33,34,40,74,0.000333,0.124428,6,2239.710989,124.428388,373.285165,135.258216,1,0
0,0,21,21,15,26,41,91,76,167,0.000333,0.298237,14,12525.95659,695.886477,894.711185,180.814792,6,0
0,0,12,12,13,18,31,38,47,85,0.000333,0.140369,12,5053.280237,280.737791,421.106686,123.164366,3,0
0,0,8,8,12,10,22,29,22,51,0.000333,0.07581,12,2729.172151,151.620675,227.431013,76.238831,3,0
0,0,10,10,12,12,24,28,23,51,0.000333,0.077944,6,1402.998525,77.944363,233.833088,86.0391,3,0
0,0,10,10,12,11,23,28,23,51,0.000333,0.076901,12,2768.419917,153.801107,230.70166,81.073298,3,0
0,0,10,10,12,12,24,28,23,51,0.000333,0.077944,6,1402.998525,77.944363,233.833088,86.0391,3,0
0,0,12,12,15,19,34,53,36,89,0.000333,0.150928,7,3169.48935,176.082742,452.784193,139.313982,3,0
0,0,12,12,15,19,34,52,36,88,0.000333,0.149232,7,3133.87711,174.104284,447.69673,139.313982,3,0
0,0,14,14,16,19,35,56,38,94,0.000333,0.160718,16,7714.441657,428.580092,482.152604,144.710623,3,0
0,0,14,14,16,19,35,56,38,94,0.000333,0.160718,16,7714.441657,428.580092,482.152604,144.710623,3,0
0,0,15,15,16,21,37,63,41,104,0.000333,0.180594,8,4334.2652,240.792511,541.78315,156.238666,3,0
0,0,12,12,15,19,34,53,36,89,0.000333,0.150928,7,3169.48935,176.082742,452.784193,139.313982,3,0
0,0,12,12,15,19,34,52,36,88,0.000333,0.149232,7,3133.87711,174.104284,447.69673,139.313982,3,0
0,0,7,7,8,16,24,27,33,60,0.000333,0.091699,8,2200.782,122.265667,275.09775,88,1,0
0,0,7,7,9,18,27,28,31,59,0.000333,0.093513,4,1122.153451,62.341858,280.538363,103.587975,1,0
0,0,14,14,13,24,37,65,67,132,0.000333,0.229216,12,8251.774131,458.431896,687.647844,158.144816,1,0
0,0,13,13,11,24,35,59,62,121,0.000333,0.206881,10,6206.432451,344.801803,620.643245,148.092848,1,0
0,0,14,14,14,24,38,57,72,129,0.000333,0.225661,21,14216.63563,789.813091,676.982649,163.342069,1,0
0,0,12,12,12,20,32,48,82,130,0.000333,0.216667,24,15600,866.666667,650,129.458112,1,0
0,0,13,13,14,23,37,65,64,129,0.000333,0.224006,14,9408.272778,522.681821,672.019484,157.344894,1,0
0,0,12,12,13,13,26,39,33,72,0.000333,0.112811,12,4061.179916,225.621106,338.43166,96.211433,3,0
0,0,17,17,16,19,35,63,53,116,0.000333,0.198332,16,9519.949279,528.886071,594.99683,144.710623,2,0
0,0,14,14,15,18,33,59,40,99,0.000333,0.166465,14,6991.530249,388.418347,499.395018,133.662009,3,0
0,0,14,14,15,18,33,58,40,98,0.000333,0.164784,14,6920.908732,384.49493,494.350624,133.662009,3,0
0,0,14,14,15,17,32,58,39,97,0.000333,0.161667,14,6790,377.222222,485,128.090227,3,0
0,0,9,9,14,14,28,35,26,61,0.000333,0.09775,7,2052.740552,114.041142,293.24865,106.605938,2,0
0,0,14,14,15,17,32,58,39,97,0.000333,0.161667,14,6790,377.222222,485,128.090227,3,0
0,0,9,9,14,14,28,35,26,61,0.000333,0.09775,7,2052.740552,114.041142,293.24865,106.605938,2,0
0,0,16,16,18,23,41,66,57,123,0.000333,0.21966,18,11861.62014,658.978897,658.978897,179.100575,2,0
0,0,9,9,12,18,30,34,26,60,0.000333,0.098138,6,1766.480614,98.137812,294.413436,118.0782,2,0
0,0,14,14,14,16,30,55,38,93,0.000333,0.152114,14,6388.771555,354.931753,456.340825,117.302969,3,0
0,0,22,22,16,15,31,84,56,140,0.000333,0.231196,24,16646.0996,924.783311,693.587483,122.603359,7,0
0,0,20,20,15,17,32,73,48,121,0.000333,0.201667,14,8470,470.555556,605,128.090227,5,0
0,0,17,17,16,15,31,61,40,101,0.000333,0.166791,16,8005.981238,444.776735,500.373827,122.603359,5,0
0,0,22,22,15,17,32,79,53,132,0.000333,0.22,21,13860,770,660,128.090227,5,0
0,0,14,14,15,19,34,59,40,99,0.000333,0.167886,14,7051.223498,391.734639,503.658821,139.313982,3,0
0,0,9,9,14,14,28,35,26,61,0.000333,0.09775,7,2052.740552,114.041142,293.24865,106.605938,2,0
0,0,14,14,15,19,34,58,40,98,0.000333,0.16619,14,6979.999018,387.777723,498.571358,139.313982,3,0
0,0,9,9,14,14,28,35,26,61,0.000333,0.09775,7,2052.740552,114.041142,293.24865,106.605938,2,0
0,0,7,7,9,12,21,22,21,43,0.000333,0.062957,4,755.478597,41.971033,188.869649,71.548875,1,0
0,0,6,6,8,12,20,20,19,39,0.000333,0.056185,4,674.220783,37.45671,168.555196,67.01955,1,0
0,0,9,9,14,14,28,38,28,66,0.000333,0.105762,14,4441.995948,246.777553,317.285425,106.605938,2,0
0,0,7,7,10,10,20,22,19,41,0.000333,0.059066,5,885.995259,49.221959,177.199052,66.438562,1,0
0,0,6,6,9,10,19,20,17,37,0.000333,0.052391,4,628.693272,34.927404,157.173318,61.748606,1,0
0,0,13,13,19,18,37,59,46,105,0.000333,0.182331,18,9845.866861,546.992603,546.992603,155.769273,2,0
0,0,10,10,19,17,36,52,39,91,0.000333,0.156821,18,8468.337152,470.463175,470.463175,150.197491,2,0
0,0,8,8,15,16,31,37,28,65,0.000333,0.107341,7,2254.159321,125.231073,322.02276,122.603359,1,0
0,0,8,8,13,12,25,26,19,45,0.000333,0.069658,6,1253.841171,69.657843,208.973529,91.125266,3,0
0,0,8,8,13,12,25,26,19,45,0.000333,0.069658,6,1253.841171,69.657843,208.973529,91.125266,3,0
0,0,8,8,13,12,25,26,19,45,0.000333,0.069658,6,1253.841171,69.657843,208.973529,91.125266,3,0
0,0,8,8,13,12,25,26,19,45,0.000333,0.069658,6,1253.841171,69.657843,208.973529,91.125266,3,0
0,0,26,26,22,48,70,120,86,206,0.000333,0.420877,11,13888.95532,771.608629,1262.632301,366.185696,10,0
0,0,25,25,22,48,70,119,84,203,0.000333,0.414748,11,13686.68898,760.37161,1244.244452,366.185696,10,0
0,0,26,26,22,48,70,120,86,206,0.000333,0.420877,11,13888.95532,771.608629,1262.632301,366.185696,10,0
0,0,25,25,22,48,70,119,84,203,0.000333,0.414748,11,13686.68898,760.37161,1244.244452,366.185696,10,0
0,0,15,15,15,25,40,63,67,130,0.000333,0.230617,14,9685.909133,538.106063,691.850652,174.699764,2,0
0,0,9,9,13,15,28,44,29,73,0.000333,0.116979,6,2105.621456,116.97897,350.936909,106.709075,2,0
0,0,9,9,13,14,27,44,29,73,0.000333,0.115702,12,4165.281452,231.404525,347.106788,101.408685,2,0
0,0,14,14,14,17,31,49,36,85,0.000333,0.140369,14,5895.493609,327.527423,421.106686,122.789837,3,0
0,0,11,11,13,15,28,35,26,61,0.000333,0.09775,6,1759.491901,97.74955,293.24865,106.709075,3,0
0,0,14,14,14,17,31,49,36,85,0.000333,0.140369,14,5895.493609,327.527423,421.106686,122.789837,3,0
0,0,11,11,13,15,28,35,26,61,0.000333,0.09775,6,1759.491901,97.74955,293.24865,106.709075,3,0
0,0,10,10,12,13,25,33,29,62,0.000333,0.095973,12,3455.029005,191.946056,287.919084,91.125266,2,0
0,0,9,9,12,13,25,39,27,66,0.000333,0.102165,12,3677.934102,204.329672,306.494509,91.125266,2,0
0,0,9,9,12,14,26,39,27,66,0.000333,0.10341,6,1861.374128,103.409674,310.229021,96.322519,2,0
0,0,9,9,12,14,26,39,27,66,0.000333,0.10341,6,1861.374128,103.409674,310.229021,96.322519,2,0
0,0,9,9,12,14,26,39,27,66,0.000333,0.10341,6,1861.374128,103.409674,310.229021,96.322519,2,0
0,0,9,9,12,14,26,39,27,66,0.000333,0.10341,6,1861.374128,103.409674,310.229021,96.322519,2,0
0,0,11,11,14,17,31,48,31,79,0.000333,0.130461,7,2739.67056,152.20392,391.381509,122.789837,2,0
0,0,15,15,13,23,36,62,89,151,0.000333,0.26022,18,14051.85615,780.658675,780.658675,152.147641,1,0
0,0,6,6,12,11,23,22,16,38,0.000333,0.057298,6,1031.372126,57.298451,171.895354,81.073298,2,0
0,0,6,6,12,11,23,22,16,38,0.000333,0.057298,6,1031.372126,57.298451,171.895354,81.073298,2,0
0,0,6,6,12,11,23,22,16,38,0.000333,0.057298,6,1031.372126,57.298451,171.895354,81.073298,2,0
0,0,6,6,12,11,23,22,16,38,0.000333,0.057298,6,1031.372126,57.298451,171.895354,81.073298,2,0
0,0,17,17,15,24,39,74,49,123,0.000333,0.216701,14,9101.462621,505.636812,650.104473,168.642459,8,0
0,0,14,14,14,16,30,49,36,85,0.000333,0.139029,14,5839.199809,324.399989,417.085701,117.302969,3,0
0,0,11,11,13,14,27,35,26,61,0.000333,0.096683,6,1740.288826,96.682713,290.048138,101.408685,3,0
0,0,14,14,14,16,30,49,36,85,0.000333,0.139029,14,5839.199809,324.399989,417.085701,117.302969,3,0
0,0,11,11,13,15,28,35,26,61,0.000333,0.09775,6,1759.491901,97.74955,293.24865,106.709075,3,0
0,0,6,6,12,10,22,26,18,44,0.000333,0.065405,6,1177.289947,65.404997,196.214991,76.238831,3,0
0,0,11,11,14,19,33,50,49,99,0.000333,0.166465,14,6991.530249,388.418347,499.395018,134.013592,1,0
0,0,4,4,12,12,24,22,22,44,0.000333,0.067246,6,1210.4301,67.246117,201.73835,86.0391,1,0
0,0,12,12,13,17,30,52,35,87,0.000333,0.1423,12,5122.793782,284.599655,426.899482,117.592585,2,0
0,0,12,12,13,16,29,52,35,87,0.000333,0.140881,12,5071.732159,281.762898,422.644347,112.105716,2,0
0,0,10,10,12,15,27,47,32,79,0.000333,0.125212,12,4507.633352,250.424075,375.636113,101.622909,2,0
0,0,10,10,12,15,27,47,32,79,0.000333,0.125212,12,4507.633352,250.424075,375.636113,101.622909,2,0
0,0,8,8,15,16,31,42,29,71,0.000333,0.117249,7,2462.235566,136.790865,351.747938,122.603359,2,0
0,0,15,15,18,19,37,65,46,111,0.000333,0.19275,18,10408.48783,578.249324,578.249324,155.769273,3,0
0,0,9,9,14,14,28,36,27,63,0.000333,0.100954,7,2120.043521,117.780196,302.86336,106.605938,2,0
0,0,11,11,14,19,33,50,49,99,0.000333,0.166465,14,6991.530249,388.418347,499.395018,134.013592,1,0
0,0,17,17,15,25,40,74,80,154,0.000333,0.273192,21,17211.11546,956.173081,819.576927,174.699764,2,0
0,0,14,14,16,24,40,68,55,123,0.000333,0.218199,16,10473.55449,581.864138,654.597156,174.0391,2,0
0,0,10,10,14,14,28,45,30,75,0.000333,0.120184,14,5047.722668,280.429037,360.551619,106.605938,2,0
0,0,5,5,10,10,20,22,17,39,0.000333,0.056185,5,842.775979,46.820888,168.555196,66.438562,1,0
0,0,10,10,13,14,27,44,30,74,0.000333,0.117287,12,4222.340102,234.57445,351.861675,101.408685,2,0
0,0,5,5,10,10,20,22,17,39,0.000333,0.056185,5,842.775979,46.820888,168.555196,66.438562,1,0
0,0,10,10,12,13,25,33,29,62,0.000333,0.095973,12,3455.029005,191.946056,287.919084,91.125266,2,0
0,0,10,10,12,13,25,33,29,62,0.000333,0.095973,12,3455.029005,191.946056,287.919084,91.125266,2,0
0,0,5,5,8,11,19,22,18,40,0.000333,0.056639,4,679.668402,37.759356,169.917101,62.053748,1,0
0,0,4,4,8,10,18,19,15,34,0.000333,0.047259,4,567.1098,31.5061,141.77745,57.219281,1,0
0,0,15,15,15,18,33,68,44,112,0.000333,0.188324,14,7909.609979,439.422777,564.972141,133.662009,3,0
0,0,15,15,15,18,33,68,44,112,0.000333,0.188324,14,7909.609979,439.422777,564.972141,133.662009,3,0
0,0,8,8,12,18,30,33,33,66,0.000333,0.107952,6,1943.128676,107.951593,323.854779,118.0782,1,0
0,0,9,9,12,14,26,44,29,73,0.000333,0.114377,12,4117.585193,228.754733,343.132099,96.322519,2,0
0,0,9,9,12,14,26,44,29,73,0.000333,0.114377,12,4117.585193,228.754733,343.132099,96.322519,2,0
0,0,9,9,12,14,26,44,29,73,0.000333,0.114377,12,4117.585193,228.754733,343.132099,96.322519,2,0
0,0,9,9,12,14,26,44,29,73,0.000333,0.114377,12,4117.585193,228.754733,343.132099,96.322519,2,0
0,0,9,9,13,15,28,45,30,75,0.000333,0.120184,12,4326.61943,240.367746,360.551619,106.709075,2,0
0,0,9,9,12,15,27,44,30,74,0.000333,0.117287,12,4222.340102,234.57445,351.861675,101.622909,2,0
0,0,3,3,8,8,16,13,11,24,0.000333,0.032,4,384,21.333333,96,48,1,0
0,0,12,12,14,15,29,49,33,82,0.000333,0.132785,14,5576.962182,309.831232,398.354442,111.906328,2,0
0,0,12,12,14,15,29,49,33,82,0.000333,0.132785,14,5576.962182,309.831232,398.354442,111.906328,2,0
0,0,3,3,8,7,15,13,11,24,0.000333,0.031255,4,375.061497,20.83675,93.765374,43.651484,1,0
0,0,10,10,13,14,27,45,30,75,0.000333,0.118872,12,4279.398752,237.744375,356.616563,101.408685,2,0
0,0,5,5,10,10,20,22,17,39,0.000333,0.056185,5,842.775979,46.820888,168.555196,66.438562,1,0
0,0,10,10,13,14,27,45,30,75,0.000333,0.118872,12,4279.398752,237.744375,356.616563,101.408685,2,0
0,0,5,5,10,10,20,22,17,39,0.000333,0.056185,5,842.775979,46.820888,168.555196,66.438562,1,0
0,0,12,12,16,16,32,44,39,83,0.000333,0.138333,16,6640,368.888889,415,128,3,0
0,0,9,9,11,15,26,29,27,56,0.000333,0.087742,5,1316.123121,73.117951,263.224624,96.657107,2,0
0,0,12,12,16,16,32,44,39,83,0.000333,0.138333,16,6640,368.888889,415,128,3,0
0,0,9,9,11,15,26,29,27,56,0.000333,0.087742,5,1316.123121,73.117951,263.224624,96.657107,2,0
0,0,14,14,13,14,27,38,34,72,0.000333,0.114117,12,4108.222802,228.2346,342.3519,101.408685,3,0
0,0,13,13,13,14,27,37,33,70,0.000333,0.110947,12,3994.105502,221.89475,332.842125,101.408685,3,0
0,0,7,7,8,14,22,26,25,51,0.000333,0.07581,4,909.72405,50.540225,227.431013,77.302969,1,0
0,0,7,7,9,16,25,27,24,51,0.000333,0.078946,4,947.346663,52.63037,236.836666,92.529325,1,0
0,0,16,16,18,19,37,74,50,124,0.000333,0.215324,18,11627.49991,645.972217,645.972217,155.769273,3,0
0,0,10,10,15,14,29,45,31,76,0.000333,0.123069,14,5168.891779,287.160654,369.206556,111.906328,2,0
0,0,8,8,12,16,28,30,32,62,0.000333,0.099352,12,3576.672062,198.704003,298.056005,107.01955,3,0
0,0,8,8,12,18,30,28,31,59,0.000333,0.096502,6,1737.039271,96.502182,289.506545,118.0782,2,0
0,0,8,8,14,16,30,34,34,68,0.000333,0.111223,14,4671.359847,259.519992,333.668561,117.302969,4,0
0,0,8,8,14,18,32,32,33,65,0.000333,0.108333,7,2275,126.388889,325,128.361619,3,0
0,0,9,9,12,14,26,44,31,75,0.000333,0.117511,12,4230.395746,235.021986,352.532979,96.322519,1,0
0,0,11,11,13,15,28,56,37,93,0.000333,0.149028,12,5365.008093,298.056005,447.084008,106.709075,1,0
0,0,15,15,15,20,35,58,47,105,0.000333,0.179525,14,7540.046035,418.891446,538.574717,145.041921,3,0
0,0,15,15,15,20,35,57,47,104,0.000333,0.177815,14,7468.236073,414.902004,533.445434,145.041921,3,0
0,0,32,32,26,45,71,139,97,236,0.000333,0.48378,26,37734.84833,2096.380463,1451.34032,369.344822,12,0
0,0,32,32,25,47,72,137,96,233,0.000333,0.479198,24,34502.22061,1916.790034,1437.592525,377.162081,11,0
0,0,27,27,23,46,69,121,86,207,0.000333,0.421488,11,13909.11019,772.728344,1264.464563,358.125775,10,0
0,0,26,26,23,46,69,120,84,204,0.000333,0.41538,11,13707.52888,761.529382,1246.138989,358.125775,10,0
0,0,32,32,26,44,70,139,97,236,0.000333,0.48217,26,37609.28059,2089.404477,1446.510792,362.426424,12,0
0,0,32,32,25,46,71,137,96,233,0.000333,0.47763,24,34389.38589,1910.521438,1432.891079,370.180255,11,0
0,0,27,27,23,46,69,121,86,207,0.000333,0.421488,11,13909.11019,772.728344,1264.464563,358.125775,10,0
0,0,26,26,23,46,69,120,84,204,0.000333,0.41538,11,13707.52888,761.529382,1246.138989,358.125775,10,0
0,0,16,16,16,14,30,49,36,85,0.000333,0.139029,16,6673.37121,370.742845,417.085701,117.302969,5,0
0,0,16,16,15,16,31,47,35,82,0.000333,0.135415,14,5687.417364,315.967631,406.244097,122.603359,4,0
0,0,16,16,16,13,29,49,36,85,0.000333,0.137643,16,6606.854153,367.047453,412.928385,112.105716,5,0
0,0,16,16,15,15,30,47,35,82,0.000333,0.134122,14,5633.110404,312.950578,402.365029,117.206718,4,0
0,0,5,5,12,12,24,21,19,40,0.000333,0.061133,6,1100.391,61.132833,183.3985,86.0391,2,0
0,0,12,12,17,24,41,49,43,92,0.000333,0.164298,8,3943.158275,219.064349,492.894784,179.525968,3,0
0,0,5,5,12,13,25,21,20,41,0.000333,0.063466,6,1142.388623,63.466035,190.398104,91.125266,2,0
0,0,5,5,11,15,26,20,22,42,0.000333,0.065806,5,987.092341,54.838463,197.418468,96.657107,2,0
0,0,5,5,12,13,25,21,20,41,0.000333,0.063466,6,1142.388623,63.466035,190.398104,91.125266,2,0
0,0,5,5,12,16,28,23,24,47,0.000333,0.075315,6,1355.674088,75.315227,225.945681,107.01955,2,0
0,0,17,17,16,25,41,66,83,149,0.000333,0.266092,24,19158.60597,1064.366998,798.275249,180.096405,3,0
0,0,5,5,12,17,29,23,25,48,0.000333,0.077728,6,1399.098527,77.727696,233.183088,112.506418,2,0
0,0,13,13,15,23,38,59,51,110,0.000333,0.192424,14,8081.808371,448.989354,577.272026,162.645284,2,0
0,0,16,16,15,18,33,73,50,123,0.000333,0.20682,14,8686.446674,482.580371,620.460477,133.662009,3,0
0,0,10,10,14,14,28,42,31,73,0.000333,0.116979,14,4913.11673,272.950929,350.936909,106.605938,2,0
0,0,16,16,15,18,33,72,50,122,0.000333,0.205139,14,8615.825156,478.656953,615.416083,133.662009,3,0
0,0,10,10,14,14,28,42,31,73,0.000333,0.116979,14,4913.11673,272.950929,350.936909,106.605938,2,0
0,0,18,18,16,26,42,68,73,141,0.000333,0.253439,16,12165.06811,675.837117,760.316757,186.211433,2,0
0,0,8,8,8,16,24,30,29,59,0.000333,0.090171,4,1082.05115,60.113953,270.512788,88,1,0
0,0,8,8,9,18,27,31,28,59,0.000333,0.093513,4,1122.153451,62.341858,280.538363,103.587975,1,0
0,0,18,18,15,26,41,76,68,144,0.000333,0.257162,14,10800.82484,600.045825,771.487489,180.814792,2,0
0,0,15,15,14,24,38,65,56,121,0.000333,0.211666,14,8889.989208,493.888289,634.999229,163.342069,2,0
0,0,3,3,9,8,17,12,11,23,0.000333,0.031337,4,376.046581,20.891477,94.011645,52.529325,1,0
0,0,18,18,19,22,41,85,63,148,0.000333,0.264306,18,14272.51854,792.917697,792.917697,178.818118,4,0
0,0,12,12,18,17,35,60,45,105,0.000333,0.179525,18,9694.344902,538.574717,538.574717,144.545518,3,0
0,0,9,9,13,14,27,27,24,51,0.000333,0.080833,6,1454.995576,80.833088,242.499263,101.408685,2,0
0,0,9,9,13,14,27,27,24,51,0.000333,0.080833,6,1454.995576,80.833088,242.499263,101.408685,2,0
0,0,6,6,13,13,26,31,27,58,0.000333,0.090875,12,3271.506044,181.750336,272.625504,96.211433,1,0
0,0,7,7,13,19,32,31,33,64,0.000333,0.106667,6,1920,106.666667,320,128.816339,1,0
0,0,9,9,13,14,27,27,24,51,0.000333,0.080833,6,1454.995576,80.833088,242.499263,101.408685,2,0
0,0,9,9,13,14,27,27,24,51,0.000333,0.080833,6,1454.995576,80.833088,242.499263,101.408685,2,0
0,0,16,16,13,22,35,55,79,134,0.000333,0.229108,18,12371.83064,687.323924,687.323924,146.213212,2,0
0,0,10,10,13,19,32,37,37,74,0.000333,0.123333,6,2220,123.333333,370,128.816339,2,0
0,0,4,4,10,14,24,19,21,40,0.000333,0.061133,5,916.9925,50.944028,183.3985,86.52225,2,0
0,0,4,4,10,15,25,19,23,42,0.000333,0.065014,5,975.2098,54.178322,195.04196,91.82264,2,0
0,0,7,7,16,13,29,34,31,65,0.000333,0.105256,16,5052.300235,280.683346,315.768765,112.105716,4,0
0,0,7,7,16,16,32,32,30,62,0.000333,0.103333,8,2480,137.777778,310,128,3,0
0,0,7,7,14,13,27,30,29,59,0.000333,0.093513,14,3927.537077,218.196504,280.538363,101.408685,3,0
0,0,7,7,14,16,30,28,28,56,0.000333,0.091595,7,1923.501113,106.861173,274.785873,117.302969,2,0
0,0,15,15,22,25,47,63,61,124,0.000333,0.22959,22,15152.91839,841.828799,688.769018,214.2039,5,0
0,0,15,15,21,27,48,61,60,121,0.000333,0.22526,20,13515.60925,750.867181,675.780463,220.620628,4,0
0,0,13,13,18,19,37,45,50,95,0.000333,0.164966,18,8908.165255,494.89807,494.89807,155.769273,3,0
0,0,13,13,18,21,39,43,49,92,0.000333,0.162086,18,8752.626074,486.257004,486.257004,167.297316,2,0
0,0,11,11,13,24,37,43,38,81,0.000333,0.140655,6,2531.794336,140.655241,421.965723,158.144816,3,0
0,0,12,12,13,24,37,44,40,84,0.000333,0.145865,6,2625.564496,145.864694,437.594083,158.144816,3,0
0,0,11,11,16,26,42,48,42,90,0.000333,0.16177,8,3882.468544,215.692697,485.308568,186.211433,4,0
0,0,12,12,16,26,42,49,44,93,0.000333,0.167162,8,4011.884163,222.882453,501.48552,186.211433,4,0
0,0,7,7,16,15,31,36,30,66,0.000333,0.108992,16,5231.631304,290.646184,326.976956,122.603359,4,0
0,0,7,7,16,17,33,34,29,63,0.000333,0.105932,8,2542.374636,141.243035,317.79683,133.486868,3,0
0,0,7,7,14,15,29,32,28,60,0.000333,0.09716,7,2040.352018,113.35289,291.47886,111.906328,3,0
0,0,7,7,14,17,31,30,27,57,0.000333,0.09413,7,1976.724328,109.818018,282.38919,122.789837,2,0
0,0,5,5,11,13,24,21,17,38,0.000333,0.058076,5,871.142875,48.396826,174.228575,86.159464,2,0
0,0,6,6,11,14,25,22,19,41,0.000333,0.063466,5,951.990519,52.888362,190.398104,91.356717,2,0
0,0,12,12,15,20,35,60,40,100,0.000333,0.170976,14,7180.996224,398.944235,512.928302,145.041921,3,0
0,0,12,12,15,20,35,59,40,99,0.000333,0.169266,14,7109.186261,394.954792,507.799019,145.041921,3,0
0,0,12,12,15,20,35,60,40,100,0.000333,0.170976,14,7180.996224,398.944235,512.928302,145.041921,3,0
0,0,12,12,15,20,35,59,40,99,0.000333,0.169266,14,7109.186261,394.954792,507.799019,145.041921,3,0
0,0,3,3,12,14,26,18,21,39,0.000333,0.061106,6,1099.902894,61.105716,183.317149,96.322519,1,0
0,0,14,14,14,19,33,68,44,112,0.000333,0.188324,14,7909.609979,439.422777,564.972141,134.013592,5,0
0,0,14,14,14,19,33,68,44,112,0.000333,0.188324,14,7909.609979,439.422777,564.972141,134.013592,5,0
0,0,6,6,10,13,23,19,22,41,0.000333,0.061822,5,927.330201,51.518344,185.46604,81.324997,1,0
0,0,5,5,5,9,14,9,15,24,0.000333,0.030459,2,182.753036,10.152946,91.376518,40.138965,1,0
0,0,6,6,10,15,25,19,24,43,0.000333,0.066562,5,998.429081,55.468282,199.685816,91.82264,1,0
0,0,5,5,6,11,17,10,15,25,0.000333,0.034062,3,306.559713,17.031095,102.186571,53.563523,1,0
0,0,18,18,14,23,37,76,67,143,0.000333,0.248317,14,10429.32564,579.40698,744.951831,157.344894,6,0
0,0,12,12,12,18,30,40,44,84,0.000333,0.137393,12,4946.14572,274.785873,412.17881,118.0782,2,0
0,0,16,16,14,22,36,70,57,127,0.000333,0.21886,14,9192.126653,510.673703,656.580475,151.410465,6,0
0,0,10,10,12,17,29,34,32,66,0.000333,0.106876,6,1923.760474,106.875582,320.626746,112.506418,2,0
0,0,12,12,14,19,33,54,44,98,0.000333,0.164784,14,6920.908732,384.49493,494.350624,134.013592,5,0
0,0,6,6,10,13,23,18,18,36,0.000333,0.054283,5,814.241152,45.23562,162.84823,81.324997,1,0
0,0,12,12,14,19,33,55,42,97,0.000333,0.163102,14,6850.287214,380.571512,489.30623,134.013592,5,0
0,0,6,6,10,10,20,19,15,34,0.000333,0.048982,5,734.727776,40.81821,146.945555,66.438562,1,0
0,0,7,7,10,16,26,23,25,48,0.000333,0.075207,5,1128.105532,62.67253,225.621106,97.219281,1,0
0,0,3,3,11,13,24,20,16,36,0.000333,0.05502,5,825.29325,45.849625,165.05865,86.159464,1,0
0,0,6,6,10,11,21,18,14,32,0.000333,0.046851,5,702.770788,39.042822,140.554158,71.273029,2,0
0,0,9,9,13,14,27,31,22,53,0.000333,0.084003,6,1512.054226,84.003013,252.009038,101.408685,3,0
0,0,6,6,10,11,21,18,14,32,0.000333,0.046851,5,702.770788,39.042822,140.554158,71.273029,2,0
0,0,9,9,13,14,27,31,22,53,0.000333,0.084003,6,1512.054226,84.003013,252.009038,101.408685,3,0
0,0,14,14,14,26,40,62,51,113,0.000333,0.200459,7,4209.645123,233.869174,601.377875,175.514402,4,0
0,0,15,15,14,26,40,63,53,116,0.000333,0.205781,14,8642.811226,480.156179,617.343659,175.514402,4,0
0,0,14,14,17,29,46,65,56,121,0.000333,0.222784,8,5346.807973,297.044887,668.350997,210.368317,5,0
0,0,15,15,17,29,46,66,58,124,0.000333,0.228307,16,10958.74692,608.819273,684.921683,210.368317,5,0
0,0,14,14,17,29,46,65,56,121,0.000333,0.222784,8,5346.807973,297.044887,668.350997,210.368317,5,0
0,0,15,15,17,29,46,66,58,124,0.000333,0.228307,16,10958.74692,608.819273,684.921683,210.368317,5,0
0,0,14,14,17,26,43,64,48,112,0.000333,0.202581,8,4861.93322,270.107401,607.741653,191.698301,5,0
0,0,15,15,17,26,43,65,50,115,0.000333,0.208007,8,4992.163574,277.342421,624.020447,191.698301,5,0
0,0,14,14,18,28,46,66,49,115,0.000333,0.211737,9,5716.886625,317.604812,635.209625,209.664588,5,0
0,0,15,15,18,28,46,67,51,118,0.000333,0.21726,9,5866.022797,325.890155,651.780311,209.664588,5,0
0,0,10,10,13,20,33,41,36,77,0.000333,0.129473,6,2330.510083,129.472782,388.418347,134.544278,3,0
0,0,3,3,11,12,23,17,14,31,0.000333,0.046743,5,701.152103,38.952895,140.230421,81.073298,1,0
0,0,8,8,12,17,29,34,29,63,0.000333,0.102018,6,1836.316816,102.017601,306.052803,112.506418,3,0
0,0,3,3,11,13,24,17,14,31,0.000333,0.047378,5,710.669188,39.481622,142.133838,86.159464,1,0
0,0,3,3,11,13,24,17,14,31,0.000333,0.047378,5,710.669188,39.481622,142.133838,86.159464,1,0
0,0,5,5,10,8,18,16,12,28,0.000333,0.038919,5,583.7895,32.43275,116.7579,57.219281,1,0
0,0,8,8,12,18,30,28,31,59,0.000333,0.096502,6,1737.039271,96.502182,289.506545,118.0782,1,0
0,0,7,7,12,14,26,24,24,48,0.000333,0.075207,6,1353.726639,75.207035,225.621106,96.322519,1,0
0,0,14,14,14,20,34,68,45,113,0.000333,0.191628,14,8048.366215,447.131456,574.883301,139.741531,5,0
0,0,33,33,16,26,42,150,94,244,0.000333,0.438575,24,31577.41083,1754.300602,1315.725451,186.211433,13,0
0,0,19,19,16,26,42,83,53,136,0.000333,0.244452,16,11733.68271,651.871262,733.355169,186.211433,8,0
0,0,9,9,13,18,31,41,31,72,0.000333,0.118901,6,2140.212806,118.900711,356.702134,123.164366,3,0
0,0,6,6,12,11,23,22,16,38,0.000333,0.057298,6,1031.372126,57.298451,171.895354,81.073298,2,0
0,0,13,13,14,15,29,52,43,95,0.000333,0.153836,14,6461.114724,358.950818,461.508195,111.906328,2,0
0,0,13,13,14,15,29,52,43,95,0.000333,0.153836,14,6461.114724,358.950818,461.508195,111.906328,2,0
0,0,14,14,14,24,38,63,50,113,0.000333,0.197672,14,8302.221326,461.234518,593.015809,163.342069,4,0
0,0,15,15,14,24,38,64,52,116,0.000333,0.20292,14,8522.634282,473.479682,608.759592,163.342069,4,0
0,0,14,14,17,27,44,66,53,119,0.000333,0.216557,8,5197.378901,288.743272,649.672363,197.868831,5,0
0,0,15,15,17,27,44,67,55,122,0.000333,0.222017,16,10656.81052,592.045029,666.050657,197.868831,5,0
0,0,5,5,10,13,23,22,20,42,0.000333,0.06333,5,949.948011,52.774889,189.989602,81.324997,2,0
0,0,9,9,10,15,25,29,33,62,0.000333,0.095973,10,2879.190838,159.955047,287.919084,91.82264,2,0
0,0,5,5,10,14,24,22,21,43,0.000333,0.065718,5,985.766938,54.76483,197.153388,86.52225,2,0
0,0,9,9,11,17,28,30,34,64,0.000333,0.102557,10,3076.70715,170.928175,307.670715,107.540616,2,0
0,0,3,3,11,12,23,16,13,29,0.000333,0.043728,5,655.916484,36.439805,131.183297,81.073298,1,0
0,0,3,3,11,12,23,16,13,29,0.000333,0.043728,5,655.916484,36.439805,131.183297,81.073298,1,0
0,0,5,5,10,11,21,19,14,33,0.000333,0.048315,5,724.732375,40.26291,144.946475,71.273029,2,0
0,0,8,8,12,14,26,32,22,54,0.000333,0.084608,6,1522.942469,84.607915,253.823745,96.322519,3,0
0,0,5,5,9,11,20,18,14,32,0.000333,0.046101,4,553.206796,30.733711,138.301699,66.583073,2,0
0,0,8,8,12,14,26,31,22,53,0.000333,0.083041,6,1494.73983,83.041102,249.123305,96.322519,3,0
0,0,8,8,12,16,28,36,25,61,0.000333,0.09775,6,1759.491901,97.74955,293.24865,107.01955,6,0
0,0,10,10,14,18,32,45,32,77,0.000333,0.128333,7,2695,149.722222,385,128.361619,7,0
0,0,4,4,8,9,17,15,12,27,0.000333,0.036787,4,441.445987,24.524777,110.361497,52.529325,1,0
0,0,7,7,12,12,24,28,20,48,0.000333,0.073359,6,1320.4692,73.3594,220.0782,86.0391,2,0
0,0,5,5,9,10,19,18,13,31,0.000333,0.043895,4,526.743012,29.263501,131.685753,61.748606,2,0
0,0,8,8,12,13,25,31,21,52,0.000333,0.080494,6,1448.883131,80.493507,241.480522,91.125266,3,0
0,0,5,5,9,10,19,18,13,31,0.000333,0.043895,4,526.743012,29.263501,131.685753,61.748606,2,0
0,0,8,8,12,13,25,31,21,52,0.000333,0.080494,6,1448.883131,80.493507,241.480522,91.125266,3,0
0,0,5,5,9,10,19,18,13,31,0.000333,0.043895,4,526.743012,29.263501,131.685753,61.748606,2,0
0,0,8,8,12,13,25,31,21,52,0.000333,0.080494,6,1448.883131,80.493507,241.480522,91.125266,3,0
0,0,5,5,9,10,19,18,13,31,0.000333,0.043895,4,526.743012,29.263501,131.685753,61.748606,2,0
0,0,8,8,12,13,25,31,21,52,0.000333,0.080494,6,1448.883131,80.493507,241.480522,91.125266,3,0
0,0,9,9,12,17,29,36,32,68,0.000333,0.110114,6,1982.056246,110.114236,330.342708,112.506418,3,0
0,0,6,6,10,12,22,18,17,35,0.000333,0.052027,5,780.400533,43.355585,156.080107,76.238831,1,0
0,0,10,10,13,19,32,41,35,76,0.000333,0.126667,6,2280,126.666667,380,128.816339,3,0
0,0,7,7,10,11,21,23,19,42,0.000333,0.061492,5,922.386659,51.243703,184.477332,71.273029,1,0
0,0,10,10,12,17,29,40,38,78,0.000333,0.126308,12,4547.070211,252.615012,378.922518,112.506418,3,0
0,0,7,7,10,12,22,22,24,46,0.000333,0.068378,10,2051.338545,113.963252,205.133854,76.238831,1,0
0,0,8,8,11,18,29,27,30,57,0.000333,0.092302,5,1384.524584,76.918032,276.904917,113.112398,1,0
0,0,3,3,11,13,24,17,14,31,0.000333,0.047378,5,710.669188,39.481622,142.133838,86.159464,1,0
0,0,12,12,10,18,28,38,59,97,0.000333,0.155438,15,6994.701412,388.594523,466.313427,108.277931,1,0
0,0,11,11,10,15,25,34,54,88,0.000333,0.13622,15,6129.890171,340.549454,408.659345,91.82264,1,0
0,0,3,3,10,17,27,19,19,38,0.000333,0.060229,5,903.428625,50.190479,180.685725,102.706149,1,0
0,0,8,8,11,16,27,23,28,51,0.000333,0.080833,5,1212.496313,67.360906,242.499263,102.053748,2,0
0,0,8,8,12,18,30,28,31,59,0.000333,0.096502,6,1737.039271,96.502182,289.506545,118.0782,1,0
0,0,7,7,12,14,26,24,24,48,0.000333,0.075207,6,1353.726639,75.207035,225.621106,96.322519,1,0
0,0,7,7,10,16,26,23,25,48,0.000333,0.075207,5,1128.105532,62.67253,225.621106,97.219281,1,0
0,0,6,6,10,9,19,19,14,33,0.000333,0.046727,5,700.90804,38.939336,140.181608,61.748606,1,0
0,0,14,14,14,20,34,68,45,113,0.000333,0.191628,14,8048.366215,447.131456,574.883301,139.741531,5,0
0,0,14,14,14,20,34,68,45,113,0.000333,0.191628,14,8048.366215,447.131456,574.883301,139.741531,5,0
0,0,18,18,14,23,37,85,64,149,0.000333,0.258736,14,10866.91972,603.717762,776.208551,157.344894,5,0
0,0,23,23,19,46,65,122,88,210,0.000333,0.421566,9,11382.27517,632.34862,1264.697241,334.794473,7,0
0,0,9,9,10,15,25,33,33,66,0.000333,0.102165,10,3064.945085,170.274727,306.494509,91.82264,1,0
0,0,8,8,10,16,26,27,24,51,0.000333,0.079907,5,1198.612128,66.589563,239.722426,97.219281,1,0
0,0,3,3,10,17,27,21,19,40,0.000333,0.063399,5,950.9775,52.832083,190.1955,102.706149,1,0
0,0,25,25,19,46,65,132,99,231,0.000333,0.463722,18,25041.00537,1391.166965,1391.166965,334.794473,7,0
0,0,10,10,10,16,26,37,36,73,0.000333,0.114377,10,3431.320994,190.628944,343.132099,97.219281,1,0
0,0,15,15,14,21,35,70,50,120,0.000333,0.205171,14,8617.195468,478.733082,615.513962,145.541635,5,0
0,0,6,6,10,13,23,18,18,36,0.000333,0.054283,5,814.241152,45.23562,162.84823,81.324997,1,0
0,0,3,3,10,16,26,16,17,33,0.000333,0.051705,5,775.572553,43.087364,155.114511,97.219281,1,0
0,0,8,8,9,13,22,22,26,48,0.000333,0.071351,8,1712.421742,95.134541,214.052718,76.635041,1,0
0,0,9,9,12,15,27,26,25,51,0.000333,0.080833,6,1454.995576,80.833088,242.499263,101.622909,2,0
0,0,10,10,11,14,25,29,29,58,0.000333,0.089781,10,2693.43659,149.635366,269.343659,91.356717,2,0
0,0,10,10,11,14,25,29,29,58,0.000333,0.089781,10,2693.43659,149.635366,269.343659,91.356717,2,0
0,0,8,8,9,13,22,22,26,48,0.000333,0.071351,8,1712.421742,95.134541,214.052718,76.635041,1,0
0,0,9,9,12,15,27,26,25,51,0.000333,0.080833,6,1454.995576,80.833088,242.499263,101.622909,2,0
0,0,12,12,12,15,27,33,32,65,0.000333,0.103023,12,3708.812252,206.045125,309.067688,101.622909,2,0
0,0,12,12,12,15,27,33,32,65,0.000333,0.103023,12,3708.812252,206.045125,309.067688,101.622909,2,0
0,0,10,10,14,20,34,46,38,84,0.000333,0.142449,7,2991.428151,166.190453,427.346879,139.741531,5,0
0,0,6,6,10,11,21,18,16,34,0.000333,0.04978,5,746.693962,41.482998,149.338792,71.273029,1,0
0,0,20,20,14,23,37,86,81,167,0.000333,0.289993,21,18269.55295,1014.975164,869.978712,157.344894,5,0
0,0,11,11,10,15,25,34,54,88,0.000333,0.13622,15,6129.890171,340.549454,408.659345,91.82264,1,0
0,0,3,3,10,16,26,18,18,36,0.000333,0.056405,5,846.079149,47.004397,169.21583,97.219281,1,0
0,0,6,6,10,14,24,20,22,42,0.000333,0.064189,5,962.842125,53.491229,192.568425,86.52225,1,0
0,0,9,9,13,18,31,41,31,72,0.000333,0.118901,6,2140.212806,118.900711,356.702134,123.164366,3,0
0,0,12,12,13,25,38,50,41,91,0.000333,0.159187,6,2865.368422,159.187135,477.561404,164.202121,7,0
0,0,12,12,14,22,36,52,38,90,0.000333,0.155098,7,3257.052751,180.947375,465.29325,151.410465,7,0
0,0,9,9,13,21,34,45,32,77,0.000333,0.130578,6,2350.407833,130.578213,391.734639,140.344382,6,0
0,0,12,12,14,22,36,51,38,89,0.000333,0.153374,7,3220.863276,178.936849,460.123325,151.410465,7,0
0,0,9,9,13,21,34,44,32,76,0.000333,0.128882,6,2319.883056,128.882392,386.647176,140.344382,6,0
0,0,12,12,13,24,37,50,40,90,0.000333,0.156284,6,2813.104817,156.283601,468.850803,158.144816,7,0
0,0,12,12,14,21,35,51,37,88,0.000333,0.150459,7,3159.638338,175.535463,451.376905,145.541635,7,0
0,0,9,9,13,20,33,44,31,75,0.000333,0.12611,6,2269.977354,126.109853,378.329559,134.544278,6,0
0,0,12,12,14,21,35,51,37,88,0.000333,0.150459,7,3159.638338,175.535463,451.376905,145.541635,7,0
0,0,9,9,13,20,33,44,31,75,0.000333,0.12611,6,2269.977354,126.109853,378.329559,134.544278,6,0
0,0,10,10,11,17,28,41,39,80,0.000333,0.128196,10,3845.883938,213.660219,384.588394,107.540616,1,0
0,0,9,9,11,14,25,37,31,68,0.000333,0.105261,10,3157.822209,175.434567,315.782221,91.356717,1,0
0,0,9,9,11,16,27,32,35,67,0.000333,0.106192,10,3185.774626,176.987479,318.577463,102.053748,1,0
0,0,8,8,11,13,24,28,27,55,0.000333,0.084058,10,2521.729375,140.096076,252.172938,86.159464,1,0
0,0,12,12,10,17,27,38,52,90,0.000333,0.142647,15,6419.098128,356.616563,427.939875,102.706149,1,0
0,0,11,11,10,14,24,34,48,82,0.000333,0.125322,15,5639.503876,313.305771,375.966925,86.52225,1,0
0,0,14,14,16,24,40,61,58,119,0.000333,0.211103,16,10132.95109,562.941727,633.309443,174.0391,6,0
0,0,10,10,12,19,31,33,38,71,0.000333,0.117249,12,4220.975256,234.498625,351.747938,123.730173,2,0
0,0,9,9,12,15,27,30,28,58,0.000333,0.091928,6,1654.700851,91.927825,275.783475,101.622909,2,0
0,0,8,8,11,15,26,28,26,54,0.000333,0.084608,5,1269.118724,70.506596,253.823745,96.657107,2,0
0,0,10,10,14,15,29,34,27,61,0.000333,0.098779,7,2074.357885,115.242105,296.336841,111.906328,2,0
0,0,10,10,13,15,28,33,27,60,0.000333,0.096147,6,1730.647772,96.147098,288.441295,106.709075,2,0
0,0,12,12,14,17,31,37,29,66,0.000333,0.108992,7,2288.838695,127.157705,326.976956,122.789837,2,0
0,0,12,12,14,17,31,37,29,66,0.000333,0.108992,7,2288.838695,127.157705,326.976956,122.789837,2,0
0,0,11,11,14,18,32,45,37,82,0.000333,0.136667,14,5740,318.888889,410,128.361619,3,0
0,0,3,3,11,13,24,17,14,31,0.000333,0.047378,5,710.669188,39.481622,142.133838,86.159464,1,0
0,0,18,18,15,24,39,80,67,147,0.000333,0.258985,14,10877.35777,604.297654,776.954126,168.642459,5,0
0,0,9,9,10,16,26,28,36,64,0.000333,0.100276,10,3008.28142,167.126746,300.828142,97.219281,1,0
0,0,3,3,10,17,27,17,21,38,0.000333,0.060229,5,903.428625,50.190479,180.685725,102.706149,1,0
0,0,15,15,14,21,35,71,47,118,0.000333,0.201752,14,8473.575544,470.754197,605.255396,145.541635,5,0
0,0,6,6,10,9,19,19,14,33,0.000333,0.046727,5,700.90804,38.939336,140.181608,61.748606,1,0
0,0,3,3,10,16,26,18,18,36,0.000333,0.056405,5,846.079149,47.004397,169.21583,97.219281,1,0
0,0,3,3,12,17,29,20,19,39,0.000333,0.063154,6,1136.767553,63.153753,189.461259,112.506418,1,0
0,0,3,3,12,14,26,17,20,37,0.000333,0.057972,6,1043.497617,57.97209,173.91627,96.322519,1,0
0,0,24,24,20,28,48,97,81,178,0.000333,0.331374,20,19882.4665,1104.581472,994.123325,221.0445,7,0
0,0,14,14,16,19,35,45,55,100,0.000333,0.170976,16,8206.852827,455.936268,512.928302,144.710623,2,0
0,0,15,15,14,20,34,64,64,128,0.000333,0.217065,21,13675.10012,759.727784,651.195244,139.741531,5,0
0,0,9,9,10,14,24,28,40,68,0.000333,0.103926,10,3117.7745,173.209694,311.77745,86.52225,1,0
0,0,3,3,10,16,26,18,18,36,0.000333,0.056405,5,846.079149,47.004397,169.21583,97.219281,1,0
0,0,13,13,14,19,33,58,52,110,0.000333,0.184961,14,7768.366944,431.575941,554.883353,134.013592,5,0
0,0,7,7,10,13,23,22,26,48,0.000333,0.072377,10,2171.309739,120.628319,217.130974,81.324997,1,0
0,0,3,3,10,16,26,18,18,36,0.000333,0.056405,5,846.079149,47.004397,169.21583,97.219281,1,0
0,0,19,19,14,22,36,76,88,164,0.000333,0.282623,28,23740.29561,1318.905311,847.8677,151.410465,5,0
0,0,13,13,10,16,26,40,68,108,0.000333,0.169216,20,10152.94979,564.052766,507.64749,97.219281,1,0
0,0,3,3,10,16,26,18,18,36,0.000333,0.056405,5,846.079149,47.004397,169.21583,97.219281,1,0
0,0,17,17,14,21,35,70,76,146,0.000333,0.249625,21,15726.38173,873.687874,748.87532,145.541635,5,0
0,0,11,11,10,15,25,34,54,88,0.000333,0.13622,15,6129.890171,340.549454,408.659345,91.82264,1,0
0,0,3,3,10,16,26,18,18,36,0.000333,0.056405,5,846.079149,47.004397,169.21583,97.219281,1,0
0,0,23,23,17,45,62,104,81,185,0.000333,0.367175,8,8812.210539,489.567252,1101.526317,316.620258,9,0
0,0,22,22,17,45,62,103,79,182,0.000333,0.361221,8,8669.309828,481.628324,1083.663728,316.620258,9,0
0,0,23,23,18,41,59,100,81,181,0.000333,0.354919,9,9582.825527,532.379196,1064.758392,294.718282,7,0
0,0,19,19,18,39,57,92,68,160,0.000333,0.311087,9,8399.36162,466.631201,933.262402,281.189337,7,0
0,0,23,23,18,44,62,103,83,186,0.000333,0.36916,9,9967.324624,553.740257,1107.480514,315.273641,7,0
0,0,22,22,18,44,62,102,81,183,0.000333,0.363206,9,9806.561323,544.808962,1089.617925,315.273641,7,0
0,0,20,20,17,41,58,92,69,161,0.000333,0.314378,8,7545.079522,419.171085,943.13494,289.1465,7,0
0,0,19,19,17,41,58,91,67,158,0.000333,0.30852,8,7404.487978,411.360443,925.560997,289.1465,7,0
0,0,25,25,18,47,65,111,90,201,0.000333,0.403499,9,10894.46337,605.247965,1210.49593,336.124326,9,0
0,0,24,24,18,47,65,110,88,198,0.000333,0.397476,9,10731.85944,596.214413,1192.428827,336.124326,9,0
0,0,14,14,14,20,34,68,45,113,0.000333,0.191628,14,8048.366215,447.131456,574.883301,139.741531,5,0
0,0,17,17,15,25,40,74,50,124,0.000333,0.219973,14,9238.867173,513.270398,659.919084,174.699764,8,0
0,0,5,5,9,10,19,15,13,28,0.000333,0.039647,4,475.767882,26.431549,118.94197,61.748606,1,0
0,0,8,8,13,13,26,28,21,49,0.000333,0.076774,6,1381.929277,76.773849,230.321546,96.211433,2,0
0,0,6,6,11,11,22,19,15,34,0.000333,0.05054,5,758.103375,42.116854,151.620675,76.107496,2,0
0,0,9,9,13,14,27,32,23,55,0.000333,0.087173,6,1569.112876,87.172938,261.518813,101.408685,3,0
0,0,6,6,10,11,21,18,15,33,0.000333,0.048315,5,724.732375,40.26291,144.946475,71.273029,2,0
0,0,9,9,13,14,27,31,23,54,0.000333,0.085588,6,1540.583551,85.587975,256.763925,101.408685,3,0
0,0,3,3,12,17,29,20,19,39,0.000333,0.063154,6,1136.767553,63.153753,189.461259,112.506418,1,0
0,0,11,11,14,18,32,52,40,92,0.000333,0.153333,14,6440,357.777778,460,128.361619,5,0
0,0,3,3,11,12,23,17,14,31,0.000333,0.046743,5,701.152103,38.952895,140.230421,81.073298,1,0
0,0,11,11,14,18,32,52,40,92,0.000333,0.153333,14,6440,357.777778,460,128.361619,5,0
0,0,3,3,11,12,23,17,14,31,0.000333,0.046743,5,701.152103,38.952895,140.230421,81.073298,1,0
0,0,13,13,14,19,33,58,46,104,0.000333,0.174872,14,7344.637838,408.035435,524.616988,134.013592,5,0
0,0,3,3,11,12,23,17,14,31,0.000333,0.046743,5,701.152103,38.952895,140.230421,81.073298,1,0
0,0,22,22,14,24,38,92,93,185,0.000333,0.323622,21,20388.19839,1132.677688,970.86659,163.342069,5,0
0,0,13,13,10,16,26,40,68,108,0.000333,0.169216,20,10152.94979,564.052766,507.64749,97.219281,1,0
0,0,3,3,10,15,25,18,18,36,0.000333,0.055726,5,835.894114,46.438562,167.178823,91.82264,1,0
0,0,3,3,10,17,27,17,21,38,0.000333,0.060229,5,903.428625,50.190479,180.685725,102.706149,1,0
0,0,15,15,14,21,35,70,50,120,0.000333,0.205171,14,8617.195468,478.733082,615.513962,145.541635,5,0
0,0,3,3,11,12,23,17,14,31,0.000333,0.046743,5,701.152103,38.952895,140.230421,81.073298,1,0
0,0,6,6,10,13,23,18,18,36,0.000333,0.054283,5,814.241152,45.23562,162.84823,81.324997,1,0
0,0,12,12,14,19,33,55,42,97,0.000333,0.163102,14,6850.287214,380.571512,489.30623,134.013592,5,0
0,0,6,6,10,9,19,19,14,33,0.000333,0.046727,5,700.90804,38.939336,140.181608,61.748606,1,0
0,0,14,14,15,19,34,62,54,116,0.000333,0.196715,14,8262.039654,459.002203,590.14569,139.313982,5,0
0,0,8,8,11,13,24,26,30,56,0.000333,0.085586,10,2567.579,142.643278,256.7579,86.159464,1,0
0,0,8,8,11,13,24,26,30,56,0.000333,0.085586,10,2567.579,142.643278,256.7579,86.159464,1,0
0,0,18,18,14,22,36,80,69,149,0.000333,0.256773,21,16176.69533,898.705296,770.318825,151.410465,5,0
0,0,9,9,10,14,24,28,40,68,0.000333,0.103926,10,3117.7745,173.209694,311.77745,86.52225,1,0
0,0,15,15,14,21,35,70,50,120,0.000333,0.205171,14,8617.195468,478.733082,615.513962,145.541635,5,0
0,0,6,6,10,13,23,18,18,36,0.000333,0.054283,5,814.241152,45.23562,162.84823,81.324997,1,0
0,0,15,15,14,21,35,71,47,118,0.000333,0.201752,14,8473.575544,470.754197,605.255396,145.541635,5,0
0,0,14,14,14,20,34,68,45,113,0.000333,0.191628,14,8048.366215,447.131456,574.883301,139.741531,5,0
0,0,16,16,14,21,35,74,51,125,0.000333,0.21372,14,8976.24528,498.680293,641.160377,145.541635,5,0
0,0,3,3,11,13,24,17,14,31,0.000333,0.047378,5,710.669188,39.481622,142.133838,86.159464,1,0
0,0,32,32,23,57,80,153,110,263,0.000333,0.554222,11,18289.33798,1016.074332,1662.667089,436.516656,12,0
0,0,31,31,23,57,80,152,108,260,0.000333,0.5479,11,18080.71435,1004.484131,1643.701305,436.516656,12,0
0,0,33,33,16,26,42,150,94,244,0.000333,0.438575,24,31577.41083,1754.300602,1315.725451,186.211433,13,0
0,0,19,19,16,26,42,83,53,136,0.000333,0.244452,16,11733.68271,651.871262,733.355169,186.211433,8,0
0,0,17,17,15,25,40,74,50,124,0.000333,0.219973,14,9238.867173,513.270398,659.919084,174.699764,8,0
0,0,3,3,11,12,23,16,13,29,0.000333,0.043728,5,655.916484,36.439805,131.183297,81.073298,1,0
0,0,3,3,11,12,23,16,13,29,0.000333,0.043728,5,655.916484,36.439805,131.183297,81.073298,1,0
0,0,16,16,14,15,29,70,56,126,0.000333,0.204035,21,12854.21771,714.123206,612.105605,111.906328,3,0
0,0,13,13,14,15,29,52,43,95,0.000333,0.153836,14,6461.114724,358.950818,461.508195,111.906328,2,0
0,0,7,7,13,16,29,29,26,55,0.000333,0.089063,6,1603.133728,89.062985,267.188955,112.105716,2,0
0,0,7,7,13,16,29,29,26,55,0.000333,0.089063,6,1603.133728,89.062985,267.188955,112.105716,2,0
0,0,11,11,14,18,32,45,37,82,0.000333,0.136667,14,5740,318.888889,410,128.361619,3,0
0,0,8,8,11,9,20,27,24,51,0.000333,0.073473,10,2204.183328,122.454629,220.418333,66.583073,1,0
0,0,19,19,17,27,44,88,60,148,0.000333,0.269332,16,12927.93407,718.21856,807.99588,197.868831,6,0
0,0,10,10,14,18,32,36,31,67,0.000333,0.111667,7,2345,130.277778,335,128.361619,2,0
0,0,19,19,14,21,35,76,79,155,0.000333,0.265013,21,16695.81622,927.545346,795.038868,145.541635,5,0
0,0,13,13,10,15,25,40,60,100,0.000333,0.154795,20,9287.71238,515.984021,464.385619,91.82264,1,0
0,0,14,14,14,20,34,68,45,113,0.000333,0.191628,14,8048.366215,447.131456,574.883301,139.741531,5,0
0,0,3,3,11,12,23,17,14,31,0.000333,0.046743,5,701.152103,38.952895,140.230421,81.073298,1,0
0,0,5,5,10,8,18,16,12,28,0.000333,0.038919,5,583.7895,32.43275,116.7579,57.219281,1,0
0,0,16,16,14,21,35,74,51,125,0.000333,0.21372,14,8976.24528,498.680293,641.160377,145.541635,5,0
0,0,3,3,11,12,23,17,14,31,0.000333,0.046743,5,701.152103,38.952895,140.230421,81.073298,1,0
0,0,7,7,10,9,19,22,18,40,0.000333,0.056639,10,1699.171005,94.398389,169.917101,61.748606,1,0
0,0,17,17,15,21,36,78,59,137,0.000333,0.236093,14,9915.916153,550.884231,708.279725,150.842025,5,0
0,0,8,8,11,13,24,26,30,56,0.000333,0.085586,10,2567.579,142.643278,256.7579,86.159464,1,0
0,0,8,8,11,13,24,26,30,56,0.000333,0.085586,10,2567.579,142.643278,256.7579,86.159464,1,0
0,0,13,13,15,28,43,52,42,94,0.000333,0.170023,7,3570.482209,198.360123,510.068887,193.209297,6,0
0,0,21,21,16,25,41,90,68,158,0.000333,0.282164,16,13543.89147,752.438415,846.493217,180.096405,8,0
0,0,21,21,15,26,41,88,70,158,0.000333,0.282164,14,11850.90503,658.383613,846.493217,180.814792,8,0
0,0,13,13,16,25,41,53,39,92,0.000333,0.164298,8,3943.158275,219.064349,492.894784,180.096405,5,0
0,0,19,19,12,23,35,68,60,128,0.000333,0.218849,12,7878.578714,437.698817,656.548226,147.061475,4,0
0,0,12,12,11,18,29,39,31,70,0.000333,0.113353,5,1700.293348,94.460742,340.05867,113.112398,4,0
0,0,13,13,15,26,41,52,40,92,0.000333,0.164298,7,3450.263491,191.681305,492.894784,180.814792,5,0
0,0,9,9,10,16,26,28,26,54,0.000333,0.084608,5,1269.118724,70.506596,253.823745,97.219281,3,0
0,0,9,9,9,16,25,27,26,53,0.000333,0.082041,4,984.497512,54.694306,246.124378,92.529325,3,0
0,0,9,9,10,15,25,27,25,52,0.000333,0.080494,5,1207.402609,67.077923,241.480522,91.82264,3,0
0,0,9,9,10,15,25,27,25,52,0.000333,0.080494,5,1207.402609,67.077923,241.480522,91.82264,3,0
0,0,9,9,10,15,25,27,25,52,0.000333,0.080494,5,1207.402609,67.077923,241.480522,91.82264,3,0
0,0,8,8,14,16,30,34,26,60,0.000333,0.098138,7,2060.89405,114.494114,294.413436,117.302969,8,0
0,0,18,18,17,22,39,87,60,147,0.000333,0.258985,16,12431.26602,690.62589,776.954126,167.594364,6,0
0,0,9,9,13,15,28,32,30,62,0.000333,0.099352,12,3576.672062,198.704003,298.056005,106.709075,2,0
0,0,18,18,18,24,42,88,61,149,0.000333,0.267818,18,14462.19533,803.455296,803.455296,185.09775,6,0
0,0,19,19,16,23,39,89,68,157,0.000333,0.276603,16,13276.93037,737.607243,829.808148,168.041925,6,0
0,0,10,10,12,16,28,34,40,74,0.000333,0.118581,12,4268.931171,237.162843,355.744264,107.01955,2,0
0,0,19,19,17,25,42,90,71,161,0.000333,0.289388,16,13890.60968,771.700538,868.163105,185.583273,6,0
0,0,21,21,16,24,40,95,78,173,0.000333,0.306898,24,22096.64545,1227.591414,920.69356,174.0391,6,0
0,0,12,12,12,17,29,40,52,92,0.000333,0.148978,18,8044.816528,446.934252,446.934252,112.506418,2,0
0,0,21,21,17,26,43,96,83,179,0.000333,0.323767,24,23311.23339,1295.068521,971.301391,191.698301,6,0
0,0,8,8,12,17,29,34,29,63,0.000333,0.102018,6,1836.316816,102.017601,306.052803,112.506418,3,0
0,0,5,5,10,8,18,16,12,28,0.000333,0.038919,5,583.7895,32.43275,116.7579,57.219281,1,0
0,0,14,14,14,20,34,68,45,113,0.000333,0.191628,14,8048.366215,447.131456,574.883301,139.741531,5,0
0,0,3,3,11,12,23,17,14,31,0.000333,0.046743,5,701.152103,38.952895,140.230421,81.073298,1,0
0,0,14,14,14,20,34,68,45,113,0.000333,0.191628,14,8048.366215,447.131456,574.883301,139.741531,5,0
0,0,15,15,15,21,36,75,47,122,0.000333,0.210244,14,8830.231902,490.568439,630.73085,150.842025,5,0
0,0,3,3,11,12,23,17,14,31,0.000333,0.046743,5,701.152103,38.952895,140.230421,81.073298,1,0
0,0,6,6,10,8,18,23,14,37,0.000333,0.051429,5,771.436125,42.857563,154.287225,57.219281,1,0
0,0,11,11,13,19,32,46,44,90,0.000333,0.15,12,5400,300,450,128.816339,3,0
0,0,8,8,11,14,25,28,29,57,0.000333,0.088233,10,2646.998028,147.055446,264.699803,91.356717,1,0
0,0,11,11,13,18,31,44,43,87,0.000333,0.143672,12,5172.180948,287.343386,431.015079,123.164366,3,0
0,0,8,8,11,13,24,26,28,54,0.000333,0.082529,10,2475.87975,137.548875,247.587975,86.159464,1,0
0,0,16,16,12,21,33,58,77,135,0.000333,0.226998,18,12257.87771,680.993206,680.993206,135.258216,3,0
0,0,13,13,10,16,26,40,68,108,0.000333,0.169216,20,10152.94979,564.052766,507.64749,97.219281,1,0
0,0,3,3,11,13,24,17,14,31,0.000333,0.047378,5,710.669188,39.481622,142.133838,86.159464,1,0
0,0,13,13,16,21,37,43,46,89,0.000333,0.154547,16,7418.261593,412.125644,463.64135,156.238666,2,0
0,0,17,17,15,21,36,78,59,137,0.000333,0.236093,14,9915.916153,550.884231,708.279725,150.842025,5,0
0,0,8,8,11,13,24,26,28,54,0.000333,0.082529,10,2475.87975,137.548875,247.587975,86.159464,1,0
0,0,7,7,9,12,21,22,27,49,0.000333,0.071741,8,1721.78843,95.654913,215.223554,71.548875,1,0
0,0,7,7,10,13,23,23,33,56,0.000333,0.08444,10,2533.194695,140.733039,253.31947,81.324997,1,0
0,0,3,3,12,17,29,21,20,41,0.000333,0.066392,6,1195.063325,66.392407,199.177221,112.506418,1,0
0,0,3,3,11,12,23,16,13,29,0.000333,0.043728,5,655.916484,36.439805,131.183297,81.073298,1,0
0,0,3,3,11,12,23,16,13,29,0.000333,0.043728,5,655.916484,36.439805,131.183297,81.073298,1,0
0,0,15,15,14,20,34,64,64,128,0.000333,0.217065,21,13675.10012,759.727784,651.195244,139.741531,5,0
0,0,9,9,10,14,24,28,40,68,0.000333,0.103926,10,3117.7745,173.209694,311.77745,86.52225,1,0
0,0,17,17,14,21,35,70,76,146,0.000333,0.249625,21,15726.38173,873.687874,748.87532,145.541635,5,0
0,0,11,11,10,15,25,34,54,88,0.000333,0.13622,15,6129.890171,340.549454,408.659345,91.82264,1,0
0,0,19,19,14,22,36,76,88,164,0.000333,0.282623,28,23740.29561,1318.905311,847.8677,151.410465,5,0
0,0,13,13,10,16,26,40,68,108,0.000333,0.169216,20,10152.94979,564.052766,507.64749,97.219281,1,0
0,0,12,12,14,19,33,54,45,99,0.000333,0.166465,14,6991.530249,388.418347,499.395018,134.013592,5,0
0,0,6,6,10,13,23,18,18,36,0.000333,0.054283,5,814.241152,45.23562,162.84823,81.324997,1,0
0,0,13,13,15,19,34,44,40,84,0.000333,0.142449,14,5982.856301,332.380906,427.346879,139.313982,2,0
0,0,12,12,15,19,34,42,38,80,0.000333,0.135666,14,5697.958382,316.553243,406.997027,139.313982,2,0
0,0,17,17,15,25,40,74,50,124,0.000333,0.219973,14,9238.867173,513.270398,659.919084,174.699764,8,0
0,0,8,8,9,13,22,22,26,48,0.000333,0.071351,8,1712.421742,95.134541,214.052718,76.635041,1,0
0,0,9,9,12,15,27,26,25,51,0.000333,0.080833,6,1454.995576,80.833088,242.499263,101.622909,2,0
0,0,12,12,12,15,27,34,32,66,0.000333,0.104608,12,3765.870902,209.21505,313.822575,101.622909,2,0
0,0,9,9,13,14,27,27,24,51,0.000333,0.080833,6,1454.995576,80.833088,242.499263,101.408685,2,0
0,0,12,12,12,15,27,34,32,66,0.000333,0.104608,12,3765.870902,209.21505,313.822575,101.622909,2,0
0,0,9,9,13,14,27,27,24,51,0.000333,0.080833,6,1454.995576,80.833088,242.499263,101.408685,2,0
0,0,18,18,18,24,42,80,55,135,0.000333,0.242654,18,13103.33134,727.962852,727.962852,185.09775,8,0
0,0,11,11,10,16,26,32,28,60,0.000333,0.094009,5,1410.131915,78.340662,282.026383,97.219281,3,0
0,0,11,11,10,17,27,32,28,60,0.000333,0.095098,5,1426.466251,79.248125,285.29325,102.706149,3,0
0,0,11,11,14,18,32,52,40,92,0.000333,0.153333,14,6440,357.777778,460,128.361619,5,0
0,0,11,11,14,18,32,52,40,92,0.000333,0.153333,14,6440,357.777778,460,128.361619,5,0
0,0,6,6,12,11,23,22,16,38,0.000333,0.057298,6,1031.372126,57.298451,171.895354,81.073298,2,0
0,0,12,12,14,18,32,55,41,96,0.000333,0.16,14,6720,373.333333,480,128.361619,5,0
0,0,6,6,9,9,18,16,14,30,0.000333,0.041699,4,500.391,27.7995,125.09775,57.05865,1,0
0,0,12,12,15,17,32,56,40,96,0.000333,0.16,14,6720,373.333333,480,128.090227,5,0
0,0,9,9,11,16,27,30,37,67,0.000333,0.106192,10,3185.774626,176.987479,318.577463,102.053748,1,0
0,0,8,8,11,13,24,26,28,54,0.000333,0.082529,10,2475.87975,137.548875,247.587975,86.159464,1,0
0,0,16,16,16,23,39,76,53,129,0.000333,0.227272,16,10909.07018,606.059454,681.816886,168.041925,5,0
0,0,7,7,12,14,26,24,24,48,0.000333,0.075207,6,1353.726639,75.207035,225.621106,96.322519,1,0
0,0,31,31,23,56,79,150,105,255,0.000333,0.535821,11,17682.105,982.339167,1607.464091,429.253801,13,0
0,0,30,30,23,55,78,149,103,252,0.000333,0.527974,11,17423.13495,967.951942,1583.921359,422.016709,13,0
0,0,31,31,23,56,79,150,105,255,0.000333,0.535821,11,17682.105,982.339167,1607.464091,429.253801,13,0
0,0,30,30,23,55,78,149,103,252,0.000333,0.527974,11,17423.13495,967.951942,1583.921359,422.016709,13,0
0,0,31,31,23,56,79,150,105,255,0.000333,0.535821,11,17682.105,982.339167,1607.464091,429.253801,13,0
0,0,30,30,23,55,78,149,103,252,0.000333,0.527974,11,17423.13495,967.951942,1583.921359,422.016709,13,0
0,0,31,31,23,56,79,150,105,255,0.000333,0.535821,11,17682.105,982.339167,1607.464091,429.253801,13,0
0,0,30,30,23,55,78,149,103,252,0.000333,0.527974,11,17423.13495,967.951942,1583.921359,422.016709,13,0
0,0,33,33,24,55,79,155,107,262,0.000333,0.55053,12,19819.08667,1101.060371,1651.590556,428.013884,13,0
0,0,32,32,24,54,78,154,105,259,0.000333,0.54264,12,19535.0301,1085.27945,1627.919175,420.803025,13,0
0,0,33,33,24,55,79,155,107,262,0.000333,0.55053,12,19819.08667,1101.060371,1651.590556,428.013884,13,0
0,0,32,32,24,54,78,154,105,259,0.000333,0.54264,12,19535.0301,1085.27945,1627.919175,420.803025,13,0
0,0,7,7,10,12,22,22,20,42,0.000333,0.062432,5,936.48064,52.026702,187.296128,76.238831,1,0
0,0,7,7,11,14,25,23,20,43,0.000333,0.066562,5,998.429081,55.468282,199.685816,91.356717,1,0
0,0,9,9,10,12,22,32,30,62,0.000333,0.092162,10,2764.847604,153.602645,276.48476,76.238831,1,0
0,0,11,11,13,15,28,40,35,75,0.000333,0.120184,12,4326.61943,240.367746,360.551619,106.709075,2,0
0,0,17,17,12,18,30,51,64,115,0.000333,0.188097,18,10157.26353,564.292418,564.292418,118.0782,2,0
0,0,18,18,13,21,34,56,73,129,0.000333,0.218761,18,11813.08872,656.282707,656.282707,140.344382,2,0
0,0,15,15,13,18,31,55,59,114,0.000333,0.188259,18,10166.01083,564.778379,564.778379,123.164366,2,0
0,0,9,9,13,15,28,37,29,66,0.000333,0.105762,6,1903.712549,105.761808,317.285425,106.709075,2,0
0,0,15,15,13,19,32,55,66,121,0.000333,0.201667,18,10890,605,605,128.816339,2,0
0,0,9,9,13,16,29,37,30,67,0.000333,0.108495,6,1952.90836,108.494909,325.484727,112.105716,2,0
0,0,3,3,10,15,25,18,18,36,0.000333,0.055726,5,835.894114,46.438562,167.178823,91.82264,1,0
0,0,3,3,11,11,22,16,13,29,0.000333,0.043108,5,646.617585,35.923199,129.323517,76.107496,1,0
0,0,19,19,16,24,40,94,65,159,0.000333,0.282062,16,13538.98507,752.165837,846.186567,174.0391,6,0
0,0,23,23,19,45,64,122,86,208,0.000333,0.416,9,11232,624,1248,327.844012,7,0
0,0,10,10,12,17,29,39,35,74,0.000333,0.11983,12,4313.887124,239.660396,359.490594,112.506418,2,0
0,0,8,8,9,15,24,24,23,47,0.000333,0.071831,4,861.97295,47.887386,215.493238,87.132684,1,0
0,0,19,19,17,26,43,95,66,161,0.000333,0.29121,16,13978.05801,776.558778,873.628626,191.698301,6,0
0,0,23,23,20,47,67,123,86,209,0.000333,0.422604,10,12678.12641,704.340356,1267.812641,347.504238,7,0
0,0,26,26,20,47,67,141,100,241,0.000333,0.487309,20,29238.5499,1624.363883,1461.927495,347.504238,8,0
0,0,11,11,12,18,30,43,38,81,0.000333,0.132486,12,4769.497659,264.972092,397.458138,118.0782,2,0
0,0,26,26,21,49,70,142,101,243,0.000333,0.496472,20,29788.31546,1654.906415,1489.415773,367.359448,8,0
0,0,15,15,14,20,34,71,46,117,0.000333,0.198411,14,8333.264134,462.959119,595.233152,139.741531,5,0
0,0,6,6,9,9,18,16,14,30,0.000333,0.041699,4,500.391,27.7995,125.09775,57.05865,1,0
0,0,15,15,15,19,34,72,45,117,0.000333,0.198411,14,8333.264134,462.959119,595.233152,139.313982,5,0
0,0,12,12,16,19,35,61,43,104,0.000333,0.177815,16,8535.12694,474.173719,533.445434,144.710623,6,0
0,0,12,12,17,18,35,62,42,104,0.000333,0.177815,16,8535.12694,474.173719,533.445434,144.545518,6,0
0,0,12,12,17,18,35,62,42,104,0.000333,0.177815,16,8535.12694,474.173719,533.445434,144.545518,6,0
0,0,6,6,12,11,23,22,16,38,0.000333,0.057298,6,1031.372126,57.298451,171.895354,81.073298,2,0
0,0,6,6,12,11,23,22,16,38,0.000333,0.057298,6,1031.372126,57.298451,171.895354,81.073298,2,0
0,0,12,12,16,19,35,61,43,104,0.000333,0.177815,16,8535.12694,474.173719,533.445434,144.710623,6,0
0,0,12,12,16,19,35,61,43,104,0.000333,0.177815,16,8535.12694,474.173719,533.445434,144.710623,6,0
0,0,12,12,16,19,35,61,43,104,0.000333,0.177815,16,8535.12694,474.173719,533.445434,144.710623,6,0
0,0,13,13,15,22,37,43,47,90,0.000333,0.156284,14,6563.911241,364.661736,468.850803,156.710855,2,0
0,0,12,12,13,21,34,46,51,97,0.000333,0.164495,12,5921.806747,328.989264,493.483896,140.344382,3,0
0,0,9,9,10,16,26,28,36,64,0.000333,0.100276,10,3008.28142,167.126746,300.828142,97.219281,1,0
0,0,3,3,10,17,27,17,21,38,0.000333,0.060229,5,903.428625,50.190479,180.685725,102.706149,1,0
0,0,19,19,15,25,40,86,62,148,0.000333,0.262548,14,11027.03501,612.613056,787.645358,174.699764,6,0
0,0,10,10,12,17,29,34,32,66,0.000333,0.106876,6,1923.760474,106.875582,320.626746,112.506418,2,0
0,0,11,11,13,19,32,46,44,90,0.000333,0.15,12,5400,300,450,128.816339,3,0
0,0,8,8,11,14,25,28,29,57,0.000333,0.088233,10,2646.998028,147.055446,264.699803,91.356717,1,0
0,0,3,3,10,16,26,19,18,37,0.000333,0.057972,5,869.581348,48.310075,173.91627,97.219281,1,0
0,0,12,12,13,20,33,55,48,103,0.000333,0.173191,12,6234.871132,346.38173,519.572594,134.544278,3,0
0,0,9,9,11,15,26,37,33,70,0.000333,0.109677,10,3290.307803,182.794878,329.03078,96.657107,1,0
0,0,3,3,10,16,26,18,18,36,0.000333,0.056405,5,846.079149,47.004397,169.21583,97.219281,1,0
0,0,21,21,15,26,41,92,72,164,0.000333,0.29288,14,12300.9394,683.385522,878.638529,180.814792,6,0
0,0,12,12,12,18,30,40,44,84,0.000333,0.137393,12,4946.14572,274.785873,412.17881,118.0782,2,0
0,0,3,3,12,17,29,20,19,39,0.000333,0.063154,6,1136.767553,63.153753,189.461259,112.506418,1,0
0,0,35,35,21,55,76,157,132,289,0.000333,0.601884,20,36113.02103,2006.278946,1805.651051,410.21345,10,0
0,0,34,34,21,55,76,156,130,286,0.000333,0.595636,20,35738.14538,1985.452521,1786.907269,410.21345,10,0
0,0,8,8,12,17,29,34,29,63,0.000333,0.102018,6,1836.316816,102.017601,306.052803,112.506418,3,0
0,0,3,3,11,12,23,16,13,29,0.000333,0.043728,5,655.916484,36.439805,131.183297,81.073298,1,0
0,0,9,9,13,18,31,41,31,72,0.000333,0.118901,6,2140.212806,118.900711,356.702134,123.164366,3,0
0,0,8,8,12,17,29,34,29,63,0.000333,0.102018,6,1836.316816,102.017601,306.052803,112.506418,3,0
0,0,8,8,12,17,29,34,29,63,0.000333,0.102018,6,1836.316816,102.017601,306.052803,112.506418,3,0
0,0,3,3,11,12,23,17,14,31,0.000333,0.046743,5,701.152103,38.952895,140.230421,81.073298,1,0
0,0,3,3,11,12,23,17,14,31,0.000333,0.046743,5,701.152103,38.952895,140.230421,81.073298,1,0
0,0,8,8,12,17,29,34,29,63,0.000333,0.102018,6,1836.316816,102.017601,306.052803,112.506418,3,0
0,0,8,8,12,13,25,28,20,48,0.000333,0.074302,6,1337.430583,74.301699,222.905097,91.125266,2,0
0,0,8,8,12,13,25,28,20,48,0.000333,0.074302,6,1337.430583,74.301699,222.905097,91.125266,2,0
0,0,10,10,12,14,26,34,26,60,0.000333,0.094009,6,1692.158299,94.008794,282.026383,96.322519,2,0
0,0,12,12,13,16,29,41,34,75,0.000333,0.12145,12,4372.182896,242.89905,364.348575,112.105716,2,0
0,0,9,9,13,15,28,34,27,61,0.000333,0.09775,6,1759.491901,97.74955,293.24865,106.709075,2,0
0,0,9,9,12,14,26,27,24,51,0.000333,0.079907,6,1438.334554,79.907475,239.722426,96.322519,2,0
0,0,13,13,14,16,30,46,35,81,0.000333,0.132486,14,5564.413935,309.134108,397.458138,117.302969,2,0
0,0,9,9,14,14,28,35,26,61,0.000333,0.09775,7,2052.740552,114.041142,293.24865,106.605938,2,0
0,0,10,10,13,14,27,32,25,57,0.000333,0.090343,6,1626.171526,90.342863,271.028588,101.408685,2,0
0,0,12,12,13,16,29,41,34,75,0.000333,0.12145,12,4372.182896,242.89905,364.348575,112.105716,2,0
0,0,9,9,13,15,28,34,27,61,0.000333,0.09775,6,1759.491901,97.74955,293.24865,106.709075,2,0
0,0,9,9,12,14,26,27,24,51,0.000333,0.079907,6,1438.334554,79.907475,239.722426,96.322519,2,0
0,0,15,15,17,18,35,55,42,97,0.000333,0.165847,16,7960.647242,442.25818,497.540453,144.545518,3,0
0,0,10,10,13,14,27,32,25,57,0.000333,0.090343,6,1626.171526,90.342863,271.028588,101.408685,2,0
0,0,12,12,13,16,29,41,34,75,0.000333,0.12145,12,4372.182896,242.89905,364.348575,112.105716,2,0
0,0,9,9,13,15,28,34,27,61,0.000333,0.09775,6,1759.491901,97.74955,293.24865,106.709075,2,0
0,0,9,9,12,14,26,27,24,51,0.000333,0.079907,6,1438.334554,79.907475,239.722426,96.322519,2,0
0,0,14,14,15,16,31,49,36,85,0.000333,0.140369,14,5895.493609,327.527423,421.106686,122.603359,3,0
0,0,9,9,14,14,28,35,26,61,0.000333,0.09775,7,2052.740552,114.041142,293.24865,106.605938,2,0
0,0,10,10,13,14,27,32,25,57,0.000333,0.090343,6,1626.171526,90.342863,271.028588,101.408685,2,0
0,0,12,12,13,16,29,41,34,75,0.000333,0.12145,12,4372.182896,242.89905,364.348575,112.105716,2,0
0,0,9,9,13,15,28,34,27,61,0.000333,0.09775,6,1759.491901,97.74955,293.24865,106.709075,2,0
0,0,9,9,12,14,26,27,24,51,0.000333,0.079907,6,1438.334554,79.907475,239.722426,96.322519,2,0
0,0,14,14,14,17,31,49,36,85,0.000333,0.140369,14,5895.493609,327.527423,421.106686,122.789837,3,0
0,0,14,14,14,17,31,49,36,85,0.000333,0.140369,14,5895.493609,327.527423,421.106686,122.789837,3,0
0,0,8,8,12,16,28,34,28,62,0.000333,0.099352,6,1788.336031,99.352002,298.056005,107.01955,3,0
0,0,7,7,8,13,21,26,23,49,0.000333,0.071741,4,860.894215,47.827456,215.223554,72.105716,1,0
0,0,7,7,9,15,24,27,23,50,0.000333,0.076416,4,916.9925,50.944028,229.248125,87.132684,1,0
0,0,12,12,13,20,33,55,48,103,0.000333,0.173191,12,6234.871132,346.38173,519.572594,134.544278,3,0
0,0,9,9,11,15,26,37,33,70,0.000333,0.109677,10,3290.307803,182.794878,329.03078,96.657107,1,0
0,0,8,8,12,17,29,34,29,63,0.000333,0.102018,6,1836.316816,102.017601,306.052803,112.506418,3,0
0,0,9,9,13,18,31,41,31,72,0.000333,0.118901,6,2140.212806,118.900711,356.702134,123.164366,3,0
0,0,6,6,10,8,18,23,14,37,0.000333,0.051429,5,771.436125,42.857563,154.287225,57.219281,1,0
0,0,8,8,12,17,29,34,29,63,0.000333,0.102018,6,1836.316816,102.017601,306.052803,112.506418,3,0
0,0,5,5,10,8,18,16,12,28,0.000333,0.038919,5,583.7895,32.43275,116.7579,57.219281,1,0
0,0,6,6,12,12,24,21,17,38,0.000333,0.058076,6,1045.37145,58.076192,174.228575,86.0391,2,0
0,0,6,6,12,12,24,21,17,38,0.000333,0.058076,6,1045.37145,58.076192,174.228575,86.0391,2,0
0,0,6,6,12,12,24,21,17,38,0.000333,0.058076,6,1045.37145,58.076192,174.228575,86.0391,2,0
0,0,6,6,12,12,24,21,17,38,0.000333,0.058076,6,1045.37145,58.076192,174.228575,86.0391,2,0
0,0,28,28,23,52,75,137,95,232,0.000333,0.481695,11,15895.9453,883.108072,1445.085936,400.46479,11,0
0,0,27,27,23,51,74,136,93,229,0.000333,0.473988,11,15641.61303,868.978502,1421.964821,393.335617,11,0
0,0,28,28,23,52,75,137,95,232,0.000333,0.481695,11,15895.9453,883.108072,1445.085936,400.46479,11,0
0,0,27,27,23,51,74,136,93,229,0.000333,0.473988,11,15641.61303,868.978502,1421.964821,393.335617,11,0
0,0,4,4,6,10,16,9,11,20,0.000333,0.026667,3,240,13.333333,80,48.729056,2,0
0,0,4,4,6,11,17,11,12,23,0.000333,0.031337,3,282.034936,15.668608,94.011645,53.563523,2,0
0,0,6,6,11,13,24,17,19,36,0.000333,0.05502,5,825.29325,45.849625,165.05865,86.159464,4,0
0,0,4,4,7,7,14,10,8,18,0.000333,0.022844,3,205.597166,11.422065,68.532389,39.302969,2,0
0,0,4,4,10,7,17,14,8,22,0.000333,0.029975,5,449.620913,24.97894,89.924183,52.870765,3,0
0,0,6,6,12,10,22,18,16,34,0.000333,0.05054,6,909.72405,50.540225,151.620675,76.238831,4,0
0,0,10,10,12,17,29,34,32,66,0.000333,0.106876,6,1923.760474,106.875582,320.626746,112.506418,2,0
0,0,3,3,10,17,27,19,19,38,0.000333,0.060229,5,903.428625,50.190479,180.685725,102.706149,1,0
0,0,3,3,11,13,24,17,14,31,0.000333,0.047378,5,710.669188,39.481622,142.133838,86.159464,1,0
0,0,3,3,10,17,27,19,19,38,0.000333,0.060229,5,903.428625,50.190479,180.685725,102.706149,1,0
0,0,8,8,15,20,35,39,32,71,0.000333,0.121393,7,2549.253659,141.625203,364.179094,145.041921,2,0
0,0,8,8,14,20,34,38,32,70,0.000333,0.118707,7,2492.856792,138.492044,356.122399,139.741531,2,0
0,0,19,19,15,24,39,91,65,156,0.000333,0.274841,14,11543.31845,641.295469,824.522746,168.642459,6,0
0,0,23,23,19,46,65,122,87,209,0.000333,0.419558,9,11328.07386,629.337436,1258.674873,334.794473,7,0
0,0,10,10,12,17,29,39,35,74,0.000333,0.11983,12,4313.887124,239.660396,359.490594,112.506418,2,0
0,0,8,8,10,16,26,27,24,51,0.000333,0.079907,5,1198.612128,66.589563,239.722426,97.219281,1,0
0,0,11,11,12,18,30,43,38,81,0.000333,0.132486,12,4769.497659,264.972092,397.458138,118.0782,2,0
0,0,18,18,16,23,39,86,61,147,0.000333,0.258985,16,12431.26602,690.62589,776.954126,168.041925,6,0
0,0,9,9,13,16,29,34,31,65,0.000333,0.105256,6,1894.612588,105.256255,315.768765,112.105716,2,0
0,0,21,21,15,27,42,97,69,166,0.000333,0.298375,14,12531.74569,696.208094,895.124692,186.985321,6,0
0,0,26,26,19,50,69,135,97,232,0.000333,0.472393,9,12754.59907,708.588837,1417.177674,362.903432,9,0
0,0,12,12,12,19,31,45,39,84,0.000333,0.138717,12,4993.829881,277.434993,416.15249,123.730173,2,0
0,0,8,8,10,16,26,27,24,51,0.000333,0.079907,5,1198.612128,66.589563,239.722426,97.219281,1,0
0,0,13,13,12,20,32,49,42,91,0.000333,0.151667,12,5460,303.333333,455,129.458112,2,0
0,0,20,20,14,22,36,86,74,160,0.000333,0.275729,21,17370.94801,965.052667,827.188,151.410465,5,0
0,0,11,11,10,14,24,34,48,82,0.000333,0.125322,15,5639.503876,313.305771,375.966925,86.52225,1,0
0,0,12,12,16,22,38,46,61,107,0.000333,0.187176,16,8984.451903,499.136217,561.528244,162.107496,1,0
0,0,6,6,10,14,24,20,22,42,0.000333,0.064189,5,962.842125,53.491229,192.568425,86.52225,1,0
0,0,21,21,16,27,43,101,69,170,0.000333,0.307488,16,14759.44013,819.968896,922.465008,192.381963,6,0
0,0,12,12,13,19,32,49,39,88,0.000333,0.146667,12,5280,293.333333,440,128.816339,2,0
0,0,3,3,11,12,23,17,14,31,0.000333,0.046743,5,701.152103,38.952895,140.230421,81.073298,1,0
0,0,34,34,20,58,78,158,120,278,0.000333,0.582447,20,34946.83634,1941.490908,1747.341817,426.20146,11,0
0,0,33,33,20,58,78,157,118,275,0.000333,0.576162,20,34569.7122,1920.539567,1728.48561,426.20146,11,0
0,0,26,26,17,48,65,116,91,207,0.000333,0.415543,8,9973.041098,554.057839,1246.630137,337.565068,9,0
0,0,7,7,7,14,21,16,20,36,0.000333,0.052708,3,474.370282,26.353905,158.123427,72.954453,1,0
0,0,34,34,23,61,84,161,123,284,0.000333,0.605139,22,39939.19926,2218.844403,1815.418148,465.816903,12,0
0,0,33,33,23,61,84,160,121,281,0.000333,0.598747,11,19758.65315,1097.702953,1796.241196,465.816903,12,0
0,0,26,26,18,50,68,117,91,208,0.000333,0.422064,9,11395.73044,633.096135,1266.192271,357.25146,9,0
0,0,17,17,15,26,41,63,55,118,0.000333,0.21073,14,8850.675912,491.704217,632.191137,180.814792,3,0
0,0,36,36,23,62,85,166,128,294,0.000333,0.62812,22,41455.94058,2303.10781,1884.360935,473.202096,12,0
0,0,15,15,14,21,35,71,47,118,0.000333,0.201752,14,8473.575544,470.754197,605.255396,145.541635,5,0
0,0,6,6,10,10,20,19,15,34,0.000333,0.048982,5,734.727776,40.81821,146.945555,66.438562,1,0
0,0,3,3,11,12,23,17,14,31,0.000333,0.046743,5,701.152103,38.952895,140.230421,81.073298,1,0
0,0,6,6,12,11,23,22,16,38,0.000333,0.057298,6,1031.372126,57.298451,171.895354,81.073298,2,0
0,0,8,8,12,17,29,34,29,63,0.000333,0.102018,6,1836.316816,102.017601,306.052803,112.506418,3,0
0,0,8,8,12,17,29,34,29,63,0.000333,0.102018,6,1836.316816,102.017601,306.052803,112.506418,3,0
0,0,22,22,19,33,52,88,83,171,0.000333,0.324925,18,17545.95345,974.775192,974.775192,247.175629,5,0
0,0,11,11,14,21,35,40,59,99,0.000333,0.169266,14,7109.186261,394.954792,507.799019,145.541635,1,0
0,0,7,7,7,12,19,18,20,38,0.000333,0.053807,3,484.263737,26.903541,161.421246,62.671034,1,0
0,0,7,7,8,14,22,17,20,37,0.000333,0.055,4,659.99588,36.666438,164.99897,77.302969,1,0
0,0,16,16,15,23,38,65,56,121,0.000333,0.211666,14,8889.989208,493.888289,634.999229,162.645284,2,0
0,0,10,10,15,22,37,42,44,86,0.000333,0.149338,14,6272.181852,348.454547,448.012989,156.710855,1,0
0,0,10,10,14,20,34,42,37,79,0.000333,0.13397,7,2813.366951,156.298164,401.909564,139.741531,3,0
0,0,7,7,12,14,26,24,24,48,0.000333,0.075207,6,1353.726639,75.207035,225.621106,96.322519,1,0
0,0,11,11,14,18,32,52,40,92,0.000333,0.153333,14,6440,357.777778,460,128.361619,5,0
0,0,3,3,11,11,22,16,13,29,0.000333,0.043108,5,646.617585,35.923199,129.323517,76.107496,1,0
0,0,5,5,10,8,18,16,12,28,0.000333,0.038919,5,583.7895,32.43275,116.7579,57.219281,1,0
0,0,17,17,16,24,40,71,48,119,0.000333,0.211103,16,10132.95109,562.941727,633.309443,174.0391,7,0
0,0,23,23,20,45,65,115,80,195,0.000333,0.391454,10,11743.61724,652.42318,1174.361724,333.571951,10,0
0,0,26,26,20,46,66,125,85,210,0.000333,0.423108,10,12693.22765,705.179314,1269.322765,340.522412,11,0
0,0,28,28,20,46,66,131,87,218,0.000333,0.439226,10,13176.77918,732.043288,1317.677918,340.522412,12,0
0,0,32,32,22,49,71,150,98,248,0.000333,0.508379,22,33553.02028,1864.056682,1525.137286,373.228278,13,0
0,0,17,17,17,22,39,72,46,118,0.000333,0.207892,16,9978.839389,554.379966,623.677462,167.594364,7,0
0,0,23,23,20,45,65,115,80,195,0.000333,0.391454,10,11743.61724,652.42318,1174.361724,333.571951,10,0
0,0,26,26,20,46,66,125,85,210,0.000333,0.423108,10,12693.22765,705.179314,1269.322765,340.522412,11,0
0,0,28,28,20,46,66,131,87,218,0.000333,0.439226,10,13176.77918,732.043288,1317.677918,340.522412,12,0
0,0,32,32,22,49,71,150,98,248,0.000333,0.508379,22,33553.02028,1864.056682,1525.137286,373.228278,13,0
0,0,17,17,17,22,39,72,46,118,0.000333,0.207892,16,9978.839389,554.379966,623.677462,167.594364,7,0
0,0,16,16,15,23,38,68,47,115,0.000333,0.201171,14,8449.163297,469.397961,603.511664,162.645284,6,0
0,0,22,22,19,44,63,112,79,191,0.000333,0.380553,9,10274.94419,570.830233,1141.660465,320.925614,9,0
0,0,25,25,19,45,64,122,84,206,0.000333,0.412,9,11124,618,1236,327.844012,10,0
0,0,27,27,19,45,64,128,86,214,0.000333,0.428,9,11556,642,1284,327.844012,11,0
0,0,31,31,21,48,69,147,97,244,0.000333,0.496827,20,29809.59935,1656.088853,1490.479967,360.316866,12,0
0,0,16,16,16,21,37,69,45,114,0.000333,0.197959,16,9502.042939,527.891274,593.877684,156.238666,6,0
0,0,7,7,12,18,30,27,26,53,0.000333,0.086688,6,1560.391209,86.688401,260.065202,118.0782,2,0
0,0,8,8,12,18,30,28,28,56,0.000333,0.091595,6,1648.71524,91.595291,274.785873,118.0782,2,0
0,0,8,8,13,17,30,29,33,62,0.000333,0.101409,6,1825.363302,101.409072,304.227217,117.592585,2,0
0,0,11,11,13,15,28,37,34,71,0.000333,0.113774,12,4095.866394,227.548133,341.322199,106.709075,2,0
0,0,11,11,13,15,28,37,34,71,0.000333,0.113774,12,4095.866394,227.548133,341.322199,106.709075,2,0
0,0,23,23,19,41,60,101,77,178,0.000333,0.350476,9,9462.838734,525.713263,1051.426526,300.370255,7,0
0,0,8,8,16,16,32,47,30,77,0.000333,0.128333,8,3080,171.111111,385,128,2,0
0,0,8,8,15,16,31,46,30,76,0.000333,0.125506,7,2635.632437,146.424024,376.51892,122.603359,2,0
0,0,8,8,10,15,25,26,32,58,0.000333,0.089781,10,2693.43659,149.635366,269.343659,91.82264,1,0
0,0,7,7,10,12,22,22,24,46,0.000333,0.068378,10,2051.338545,113.963252,205.133854,76.238831,1,0
0,0,7,7,10,15,25,23,24,47,0.000333,0.072754,5,1091.306205,60.628122,218.261241,91.82264,1,0
0,0,8,8,10,15,25,26,28,54,0.000333,0.083589,5,1253.841171,69.657843,250.768234,91.82264,1,0
0,0,8,8,12,17,29,34,29,63,0.000333,0.102018,6,1836.316816,102.017601,306.052803,112.506418,3,0
0,0,3,3,11,11,22,16,13,29,0.000333,0.043108,5,646.617585,35.923199,129.323517,76.107496,1,0
0,0,3,3,11,11,22,16,13,29,0.000333,0.043108,5,646.617585,35.923199,129.323517,76.107496,1,0
0,0,5,5,10,13,23,22,20,42,0.000333,0.06333,5,949.948011,52.774889,189.989602,81.324997,2,0
0,0,9,9,10,15,25,29,33,62,0.000333,0.095973,10,2879.190838,159.955047,287.919084,91.82264,2,0
0,0,5,5,10,14,24,22,21,43,0.000333,0.065718,5,985.766938,54.76483,197.153388,86.52225,2,0
0,0,9,9,11,17,28,30,34,64,0.000333,0.102557,10,3076.70715,170.928175,307.670715,107.540616,2,0
0,0,13,13,15,20,35,59,46,105,0.000333,0.179525,14,7540.046035,418.891446,538.574717,145.041921,5,0
0,0,10,10,13,14,27,34,25,59,0.000333,0.093513,6,1683.230176,93.512788,280.538363,101.408685,2,0
0,0,10,10,13,15,28,36,25,61,0.000333,0.09775,6,1759.491901,97.74955,293.24865,106.709075,3,0
0,0,10,10,13,14,27,34,25,59,0.000333,0.093513,6,1683.230176,93.512788,280.538363,101.408685,2,0
0,0,10,10,13,15,28,36,25,61,0.000333,0.09775,6,1759.491901,97.74955,293.24865,106.709075,3,0
0,0,10,10,13,14,27,34,25,59,0.000333,0.093513,6,1683.230176,93.512788,280.538363,101.408685,2,0
0,0,10,10,13,15,28,36,25,61,0.000333,0.09775,6,1759.491901,97.74955,293.24865,106.709075,3,0
0,0,10,10,13,14,27,34,25,59,0.000333,0.093513,6,1683.230176,93.512788,280.538363,101.408685,2,0
0,0,10,10,13,15,28,36,25,61,0.000333,0.09775,6,1759.491901,97.74955,293.24865,106.709075,3,0
0,0,3,3,11,11,22,16,13,29,0.000333,0.043108,5,646.617585,35.923199,129.323517,76.107496,1,0
0,0,3,3,10,15,25,18,18,36,0.000333,0.055726,5,835.894114,46.438562,167.178823,91.82264,1,0
0,0,3,3,10,15,25,18,18,36,0.000333,0.055726,5,835.894114,46.438562,167.178823,91.82264,1,0
0,0,3,3,11,11,22,16,13,29,0.000333,0.043108,5,646.617585,35.923199,129.323517,76.107496,1,0
0,0,7,7,10,16,26,23,25,48,0.000333,0.075207,5,1128.105532,62.67253,225.621106,97.219281,1,0
0,0,6,6,10,10,20,19,15,34,0.000333,0.048982,5,734.727776,40.81821,146.945555,66.438562,1,0
0,0,15,15,15,20,35,75,46,121,0.000333,0.206881,14,8689.005431,482.722524,620.643245,145.041921,5,0
0,0,6,6,10,8,18,23,14,37,0.000333,0.051429,5,771.436125,42.857563,154.287225,57.219281,1,0
0,0,9,9,12,18,30,37,31,68,0.000333,0.111223,6,2002.011363,111.222854,333.668561,118.0782,3,0
0,0,3,3,11,14,25,20,16,36,0.000333,0.055726,5,835.894114,46.438562,167.178823,91.356717,1,0
0,0,6,6,10,9,19,19,14,33,0.000333,0.046727,5,700.90804,38.939336,140.181608,61.748606,1,0
0,0,11,11,13,18,31,44,43,87,0.000333,0.143672,12,5172.180948,287.343386,431.015079,123.164366,3,0
0,0,3,3,11,13,24,17,14,31,0.000333,0.047378,5,710.669188,39.481622,142.133838,86.159464,1,0
0,0,8,8,11,13,24,26,28,54,0.000333,0.082529,10,2475.87975,137.548875,247.587975,86.159464,1,0
0,0,17,17,15,25,40,74,50,124,0.000333,0.219973,14,9238.867173,513.270398,659.919084,174.699764,8,0
0,0,17,17,15,25,40,74,50,124,0.000333,0.219973,14,9238.867173,513.270398,659.919084,174.699764,8,0
0,0,17,17,15,24,39,74,49,123,0.000333,0.216701,14,9101.462621,505.636812,650.104473,168.642459,8,0
0,0,7,7,13,16,29,29,26,55,0.000333,0.089063,6,1603.133728,89.062985,267.188955,112.105716,2,0
0,0,7,7,14,15,29,30,25,55,0.000333,0.089063,7,1870.322683,103.906816,267.188955,111.906328,2,0
0,0,6,6,12,11,23,22,16,38,0.000333,0.057298,6,1031.372126,57.298451,171.895354,81.073298,2,0
0,0,7,7,13,16,29,29,26,55,0.000333,0.089063,6,1603.133728,89.062985,267.188955,112.105716,2,0
0,0,7,7,14,15,29,30,25,55,0.000333,0.089063,7,1870.322683,103.906816,267.188955,111.906328,2,0
0,0,6,6,12,11,23,22,16,38,0.000333,0.057298,6,1031.372126,57.298451,171.895354,81.073298,2,0
0,0,8,8,13,17,30,32,28,60,0.000333,0.098138,6,1766.480614,98.137812,294.413436,117.592585,2,0
0,0,7,7,12,12,24,25,18,43,0.000333,0.065718,6,1182.920325,65.717796,197.153388,86.0391,2,0
0,0,8,8,14,16,30,33,27,60,0.000333,0.098138,7,2060.89405,114.494114,294.413436,117.302969,2,0
0,0,14,14,14,20,34,68,45,113,0.000333,0.191628,14,8048.366215,447.131456,574.883301,139.741531,5,0
0,0,3,3,11,11,22,16,13,29,0.000333,0.043108,5,646.617585,35.923199,129.323517,76.107496,1,0
0,0,3,3,11,11,22,16,13,29,0.000333,0.043108,5,646.617585,35.923199,129.323517,76.107496,1,0
0,0,11,11,13,20,33,47,43,90,0.000333,0.151332,12,5447.945649,302.663647,453.995471,134.544278,2,0
0,0,10,10,13,17,30,43,35,78,0.000333,0.127579,12,4592.849597,255.158311,382.737466,117.592585,2,0
0,0,14,14,14,20,34,68,45,113,0.000333,0.191628,14,8048.366215,447.131456,574.883301,139.741531,5,0
0,0,3,3,11,11,22,16,13,29,0.000333,0.043108,5,646.617585,35.923199,129.323517,76.107496,1,0
0,0,3,3,11,11,22,16,13,29,0.000333,0.043108,5,646.617585,35.923199,129.323517,76.107496,1,0
0,0,15,15,15,21,36,75,47,122,0.000333,0.210244,14,8830.231902,490.568439,630.73085,150.842025,5,0
0,0,15,15,13,22,35,58,56,114,0.000333,0.194913,12,7016.859167,389.825509,584.738264,146.213212,4,0
0,0,12,12,12,18,30,40,44,84,0.000333,0.137393,12,4946.14572,274.785873,412.17881,118.0782,2,0
0,0,11,11,13,14,27,39,30,69,0.000333,0.109362,12,3937.046852,218.724825,328.087238,101.408685,2,0
0,0,18,18,15,24,39,80,67,147,0.000333,0.258985,14,10877.35777,604.297654,776.954126,168.642459,5,0
0,0,9,9,10,16,26,28,36,64,0.000333,0.100276,10,3008.28142,167.126746,300.828142,97.219281,1,0
0,0,3,3,10,17,27,18,22,40,0.000333,0.063399,5,950.9775,52.832083,190.1955,102.706149,1,0
0,0,17,17,15,21,36,78,59,137,0.000333,0.236093,14,9915.916153,550.884231,708.279725,150.842025,5,0
0,0,8,8,11,13,24,26,28,54,0.000333,0.082529,10,2475.87975,137.548875,247.587975,86.159464,1,0
0,0,18,18,15,23,38,89,64,153,0.000333,0.267644,14,11241.06073,624.503374,802.93291,162.645284,5,0
0,0,9,9,11,15,26,37,33,70,0.000333,0.109677,10,3290.307803,182.794878,329.03078,96.657107,1,0
0,0,3,3,10,16,26,19,19,38,0.000333,0.059539,5,893.083546,49.615753,178.616709,97.219281,1,0
0,0,17,17,16,20,36,79,52,131,0.000333,0.225753,16,10836.1628,602.009045,677.260175,150.438562,5,0
0,0,8,8,11,9,20,27,24,51,0.000333,0.073473,10,2204.183328,122.454629,220.418333,66.583073,1,0
0,0,8,8,11,9,20,27,24,51,0.000333,0.073473,10,2204.183328,122.454629,220.418333,66.583073,1,0
0,0,3,3,11,12,23,16,13,29,0.000333,0.043728,5,655.916484,36.439805,131.183297,81.073298,1,0
0,0,12,12,14,19,33,54,45,99,0.000333,0.166465,14,6991.530249,388.418347,499.395018,134.013592,5,0
0,0,6,6,10,13,23,18,18,36,0.000333,0.054283,5,814.241152,45.23562,162.84823,81.324997,1,0
0,0,3,3,10,15,25,16,17,33,0.000333,0.051082,5,766.236271,42.568682,153.247254,91.82264,1,0
0,0,3,3,11,12,23,16,13,29,0.000333,0.043728,5,655.916484,36.439805,131.183297,81.073298,1,0
0,0,19,19,14,22,36,76,88,164,0.000333,0.282623,28,23740.29561,1318.905311,847.8677,151.410465,5,0
0,0,13,13,10,16,26,40,68,108,0.000333,0.169216,20,10152.94979,564.052766,507.64749,97.219281,1,0
0,0,3,3,10,16,26,19,19,38,0.000333,0.059539,5,893.083546,49.615753,178.616709,97.219281,1,0
0,0,12,12,14,19,33,39,39,78,0.000333,0.131154,14,5508.478378,306.026577,393.462741,134.013592,2,0
0,0,11,11,10,15,25,34,39,73,0.000333,0.113001,10,3390.015019,188.334168,339.001502,91.82264,1,0
0,0,12,12,11,18,29,38,43,81,0.000333,0.131165,10,3934.964606,218.609145,393.496461,113.112398,1,0
0,0,11,11,10,14,24,32,38,70,0.000333,0.106982,10,3209.473751,178.304097,320.947375,86.52225,1,0
0,0,12,12,13,16,29,36,37,73,0.000333,0.118211,12,4255.591352,236.421742,354.632613,112.105716,2,0
0,0,12,12,11,17,28,36,42,78,0.000333,0.124991,10,3749.736839,208.318713,374.973684,107.540616,1,0
0,0,13,13,14,19,33,40,41,81,0.000333,0.136199,14,5720.342931,317.79683,408.595924,134.013592,2,0
0,0,17,17,12,19,31,50,65,115,0.000333,0.189911,18,10255.18636,569.732576,569.732576,123.730173,2,0
0,0,17,17,13,21,34,51,72,123,0.000333,0.208586,18,11263.64273,625.757929,625.757929,140.344382,2,0
0,0,11,11,9,15,24,36,51,87,0.000333,0.132964,12,4786.700851,265.927825,398.891738,87.132684,1,0
0,0,11,11,9,16,25,36,58,94,0.000333,0.145507,12,5238.269782,291.014988,436.522482,92.529325,1,0
0,0,9,9,14,18,32,43,32,75,0.000333,0.125,7,2625,145.833333,375,128.361619,4,0
0,0,9,9,14,18,32,43,32,75,0.000333,0.125,7,2625,145.833333,375,128.361619,4,0
0,0,6,6,10,15,25,20,23,43,0.000333,0.066562,5,998.429081,55.468282,199.685816,91.82264,1,0
0,0,3,3,11,12,23,16,13,29,0.000333,0.043728,5,655.916484,36.439805,131.183297,81.073298,1,0
0,0,3,3,11,12,23,16,13,29,0.000333,0.043728,5,655.916484,36.439805,131.183297,81.073298,1,0
0,0,5,5,10,8,18,16,12,28,0.000333,0.038919,5,583.7895,32.43275,116.7579,57.219281,1,0
0,0,6,6,10,15,25,20,23,43,0.000333,0.066562,5,998.429081,55.468282,199.685816,91.82264,1,0
0,0,6,6,10,15,25,20,23,43,0.000333,0.066562,5,998.429081,55.468282,199.685816,91.82264,1,0
0,0,9,9,12,14,26,32,25,57,0.000333,0.089308,6,1607.550384,89.308355,267.925064,96.322519,2,0
0,0,21,21,20,30,50,92,85,177,0.000333,0.332988,20,19979.25091,1109.958384,998.962546,233.64528,6,0
0,0,11,11,14,21,35,40,59,99,0.000333,0.169266,14,7109.186261,394.954792,507.799019,145.541635,1,0
0,0,23,23,19,48,67,120,90,210,0.000333,0.424626,9,11464.90857,636.939365,1273.87873,348.788823,7,0
0,0,7,7,8,16,24,19,23,42,0.000333,0.064189,4,770.2737,42.792983,192.568425,88,1,0
0,0,3,3,10,16,26,21,19,40,0.000333,0.062673,5,940.087944,52.227108,188.017589,97.219281,1,0
0,0,9,9,8,16,24,29,35,64,0.000333,0.097813,8,2347.5008,130.416711,293.4376,88,1,0
0,0,3,3,10,16,26,19,19,38,0.000333,0.059539,5,893.083546,49.615753,178.616709,97.219281,1,0
0,0,17,17,14,21,35,70,76,146,0.000333,0.249625,21,15726.38173,873.687874,748.87532,145.541635,5,0
0,0,11,11,10,15,25,34,54,88,0.000333,0.13622,15,6129.890171,340.549454,408.659345,91.82264,1,0
0,0,3,3,10,16,26,19,19,38,0.000333,0.059539,5,893.083546,49.615753,178.616709,97.219281,1,0
0,0,9,9,13,15,28,32,32,64,0.000333,0.102557,12,3692.04858,205.11381,307.670715,106.709075,2,0
0,0,9,9,13,15,28,32,32,64,0.000333,0.102557,12,3692.04858,205.11381,307.670715,106.709075,2,0
0,0,8,8,12,12,24,28,22,50,0.000333,0.076416,6,1375.48875,76.416042,229.248125,86.0391,2,0
0,0,17,17,16,20,36,79,52,131,0.000333,0.225753,16,10836.1628,602.009045,677.260175,150.438562,5,0
0,0,8,8,11,9,20,27,22,49,0.000333,0.070591,10,2117.744766,117.652487,211.774477,66.583073,1,0
0,0,17,17,15,21,36,80,57,137,0.000333,0.236093,14,9915.916153,550.884231,708.279725,150.842025,5,0
0,0,8,8,11,13,24,28,27,55,0.000333,0.084058,10,2521.729375,140.096076,252.172938,86.159464,1,0
0,0,9,9,12,18,30,37,31,68,0.000333,0.111223,6,2002.011363,111.222854,333.668561,118.0782,3,0
0,0,3,3,11,12,23,19,15,34,0.000333,0.051267,5,769.005533,42.72253,153.801107,81.073298,1,0
0,0,6,6,10,9,19,19,14,33,0.000333,0.046727,5,700.90804,38.939336,140.181608,61.748606,1,0
0,0,9,9,12,18,30,37,31,68,0.000333,0.111223,6,2002.011363,111.222854,333.668561,118.0782,3,0
0,0,8,8,11,17,28,30,27,57,0.000333,0.09134,5,1370.096153,76.116453,274.019231,107.540616,1,0
0,0,12,12,14,26,40,55,51,106,0.000333,0.188041,7,3948.870646,219.381703,564.124378,175.514402,3,0
0,0,5,5,9,13,22,19,17,36,0.000333,0.053513,4,642.158153,35.675453,160.539538,76.635041,2,0
0,0,6,6,9,14,23,20,19,39,0.000333,0.058806,4,705.675665,39.204204,176.418916,81.832294,2,0
0,0,7,7,10,16,26,25,28,53,0.000333,0.083041,5,1245.616525,69.200918,249.123305,97.219281,2,0
0,0,8,8,10,16,26,26,30,56,0.000333,0.087742,5,1316.123121,73.117951,263.224624,97.219281,2,0
0,0,6,6,10,15,25,20,23,43,0.000333,0.066562,5,998.429081,55.468282,199.685816,91.82264,1,0
0,0,8,8,10,16,26,26,29,55,0.000333,0.086175,5,1292.620922,71.812273,258.524184,97.219281,1,0
0,0,3,3,11,13,24,17,14,31,0.000333,0.047378,5,710.669188,39.481622,142.133838,86.159464,1,0
0,0,8,8,10,16,26,22,28,50,0.000333,0.078341,5,1175.10993,65.283885,235.021986,97.219281,2,0
0,0,15,15,14,21,35,70,50,120,0.000333,0.205171,14,8617.195468,478.733082,615.513962,145.541635,5,0
0,0,3,3,11,11,22,16,13,29,0.000333,0.043108,5,646.617585,35.923199,129.323517,76.107496,1,0
0,0,6,6,10,13,23,18,18,36,0.000333,0.054283,5,814.241152,45.23562,162.84823,81.324997,1,0
0,0,17,17,16,21,37,79,53,132,0.000333,0.229216,16,11002.36551,611.242528,687.647844,156.238666,5,0
0,0,3,3,11,11,22,16,13,29,0.000333,0.043108,5,646.617585,35.923199,129.323517,76.107496,1,0
0,0,7,7,12,13,25,24,19,43,0.000333,0.066562,6,1198.114897,66.561939,199.685816,91.125266,2,0
0,0,6,6,12,12,24,21,17,38,0.000333,0.058076,6,1045.37145,58.076192,174.228575,86.0391,2,0
0,0,31,31,23,56,79,149,105,254,0.000333,0.53372,11,17612.76341,978.486856,1601.16031,429.253801,13,0
0,0,30,30,23,55,78,148,103,251,0.000333,0.525879,11,17353.99553,964.110863,1577.635957,422.016709,13,0
0,0,31,31,23,56,79,149,105,254,0.000333,0.53372,11,17612.76341,978.486856,1601.16031,429.253801,13,0
0,0,30,30,23,55,78,148,103,251,0.000333,0.525879,11,17353.99553,964.110863,1577.635957,422.016709,13,0
0,0,8,8,12,13,25,28,20,48,0.000333,0.074302,6,1337.430583,74.301699,222.905097,91.125266,2,0
0,0,8,8,12,13,25,28,20,48,0.000333,0.074302,6,1337.430583,74.301699,222.905097,91.125266,2,0
0,0,8,8,12,13,25,28,20,48,0.000333,0.074302,6,1337.430583,74.301699,222.905097,91.125266,2,0
0,0,8,8,12,13,25,28,20,48,0.000333,0.074302,6,1337.430583,74.301699,222.905097,91.125266,2,0
0,0,8,8,12,13,25,28,20,48,0.000333,0.074302,6,1337.430583,74.301699,222.905097,91.125266,2,0
0,0,14,14,14,19,33,68,44,112,0.000333,0.188324,14,7909.609979,439.422777,564.972141,134.013592,5,0
0,0,10,10,15,24,39,39,46,85,0.000333,0.149753,7,3144.81432,174.711907,449.259189,168.642459,1,0
0,0,3,3,10,16,26,18,18,36,0.000333,0.056405,5,846.079149,47.004397,169.21583,97.219281,1,0
0,0,14,14,14,19,33,68,44,112,0.000333,0.188324,14,7909.609979,439.422777,564.972141,134.013592,5,0
0,0,14,14,14,19,33,68,44,112,0.000333,0.188324,14,7909.609979,439.422777,564.972141,134.013592,5,0
0,0,14,14,14,19,33,68,44,112,0.000333,0.188324,14,7909.609979,439.422777,564.972141,134.013592,5,0
0,0,16,16,14,15,29,70,56,126,0.000333,0.204035,21,12854.21771,714.123206,612.105605,111.906328,3,0
0,0,16,16,14,15,29,70,56,126,0.000333,0.204035,21,12854.21771,714.123206,612.105605,111.906328,3,0
0,0,13,13,14,15,29,52,43,95,0.000333,0.153836,14,6461.114724,358.950818,461.508195,111.906328,2,0
0,0,13,13,14,15,29,52,43,95,0.000333,0.153836,14,6461.114724,358.950818,461.508195,111.906328,2,0
0,0,9,9,11,16,27,30,37,67,0.000333,0.106192,10,3185.774626,176.987479,318.577463,102.053748,1,0
0,0,3,3,11,12,23,16,13,29,0.000333,0.043728,5,655.916484,36.439805,131.183297,81.073298,1,0
0,0,8,8,11,13,24,26,28,54,0.000333,0.082529,10,2475.87975,137.548875,247.587975,86.159464,1,0
0,0,12,12,10,18,28,38,59,97,0.000333,0.155438,15,6994.701412,388.594523,466.313427,108.277931,1,0
0,0,11,11,10,15,25,34,54,88,0.000333,0.13622,15,6129.890171,340.549454,408.659345,91.82264,1,0
0,0,3,3,10,16,26,18,18,36,0.000333,0.056405,5,846.079149,47.004397,169.21583,97.219281,1,0
0,0,15,15,12,21,33,50,66,116,0.000333,0.19505,18,10532.69492,585.149718,585.149718,135.258216,2,0
0,0,14,14,12,18,30,46,64,110,0.000333,0.179919,18,9715.643379,539.757966,539.757966,118.0782,2,0
0,0,13,13,8,18,26,35,32,67,0.000333,0.104976,4,1259.717844,69.984325,314.929461,99.05865,1,0
0,0,16,16,14,21,35,48,40,88,0.000333,0.150459,7,3159.638338,175.535463,451.376905,145.541635,2,0
0,0,10,10,13,15,28,36,25,61,0.000333,0.09775,6,1759.491901,97.74955,293.24865,106.709075,2,0
0,0,12,12,7,13,20,32,27,59,0.000333,0.084998,6,1529.962546,84.997919,254.993758,67.757201,1,0
0,0,15,15,13,16,29,45,35,80,0.000333,0.129546,12,4663.661755,259.09232,388.63848,112.105716,2,0
0,0,10,10,13,15,28,36,25,61,0.000333,0.09775,6,1759.491901,97.74955,293.24865,106.709075,2,0
0,0,15,15,14,21,35,70,50,120,0.000333,0.205171,14,8617.195468,478.733082,615.513962,145.541635,5,0
0,0,6,6,10,13,23,18,18,36,0.000333,0.054283,5,814.241152,45.23562,162.84823,81.324997,1,0
0,0,8,8,12,13,25,28,20,48,0.000333,0.074302,6,1337.430583,74.301699,222.905097,91.125266,2,0
0,0,8,8,12,13,25,28,20,48,0.000333,0.074302,6,1337.430583,74.301699,222.905097,91.125266,2,0
0,0,16,16,15,23,38,67,69,136,0.000333,0.237906,21,14988.08098,832.671165,713.718142,162.645284,6,0
0,0,12,12,12,18,30,39,53,92,0.000333,0.150478,12,5417.207218,300.955957,451.433935,118.0782,2,0
0,0,10,10,14,20,34,45,40,85,0.000333,0.144145,14,6054.080781,336.337821,432.434342,139.741531,5,0
0,0,6,6,10,14,24,17,19,36,0.000333,0.05502,5,825.29325,45.849625,165.05865,86.52225,1,0
0,0,8,8,12,16,28,27,29,56,0.000333,0.089737,6,1615.271254,89.737292,269.211876,107.01955,2,0
0,0,9,9,13,13,26,32,27,59,0.000333,0.092442,12,3327.91132,184.883962,277.325943,96.211433,2,0
0,0,10,10,10,17,27,32,47,79,0.000333,0.125212,10,3756.361127,208.686729,375.636113,102.706149,1,0
0,0,9,9,10,14,24,28,40,68,0.000333,0.103926,10,3117.7745,173.209694,311.77745,86.52225,1,0
0,0,3,3,10,15,25,18,18,36,0.000333,0.055726,5,835.894114,46.438562,167.178823,91.82264,1,0
0,0,17,17,15,21,36,78,59,137,0.000333,0.236093,14,9915.916153,550.884231,708.279725,150.842025,5,0
0,0,3,3,11,12,23,16,13,29,0.000333,0.043728,5,655.916484,36.439805,131.183297,81.073298,1,0
0,0,8,8,11,13,24,26,28,54,0.000333,0.082529,10,2475.87975,137.548875,247.587975,86.159464,1,0
0,0,15,15,14,21,35,70,50,120,0.000333,0.205171,14,8617.195468,478.733082,615.513962,145.541635,5,0
0,0,3,3,11,12,23,16,13,29,0.000333,0.043728,5,655.916484,36.439805,131.183297,81.073298,1,0
0,0,6,6,10,13,23,18,18,36,0.000333,0.054283,5,814.241152,45.23562,162.84823,81.324997,1,0
0,0,7,7,10,16,26,23,25,48,0.000333,0.075207,5,1128.105532,62.67253,225.621106,97.219281,1,0
0,0,7,7,10,16,26,22,28,50,0.000333,0.078341,5,1175.10993,65.283885,235.021986,97.219281,1,0
0,0,6,6,10,13,23,18,18,36,0.000333,0.054283,5,814.241152,45.23562,162.84823,81.324997,1,0
0,0,10,10,10,17,27,32,47,79,0.000333,0.125212,10,3756.361127,208.686729,375.636113,102.706149,1,0
0,0,9,9,10,14,24,28,40,68,0.000333,0.103926,10,3117.7745,173.209694,311.77745,86.52225,1,0
0,0,15,15,13,21,34,47,52,99,0.000333,0.167886,12,6043.905855,335.772548,503.658821,140.344382,2,0
0,0,14,14,13,21,34,45,50,95,0.000333,0.161103,12,5799.707639,322.20598,483.30897,140.344382,2,0
0,0,13,13,12,16,28,39,44,83,0.000333,0.133003,12,4788.125502,266.006972,399.010459,107.01955,2,0
0,0,14,14,13,19,32,44,49,93,0.000333,0.155,12,5580,310,465,128.816339,2,0
0,0,16,16,13,18,31,53,54,107,0.000333,0.1767,18,9541.782094,530.099005,530.099005,123.164366,2,0
0,0,9,9,13,15,28,37,29,66,0.000333,0.105762,6,1903.712549,105.761808,317.285425,106.709075,2,0
0,0,17,17,14,21,35,58,59,117,0.000333,0.200042,14,8401.765582,466.764755,600.126113,145.541635,2,0
0,0,9,9,13,16,29,37,30,67,0.000333,0.108495,6,1952.90836,108.494909,325.484727,112.105716,2,0
0,0,15,15,13,12,25,64,49,113,0.000333,0.174919,24,12594.13799,699.674333,524.755749,91.125266,4,0
0,0,14,14,13,12,25,56,44,100,0.000333,0.154795,18,8358.941142,464.385619,464.385619,91.125266,3,0
0,0,15,15,14,21,35,70,50,120,0.000333,0.205171,14,8617.195468,478.733082,615.513962,145.541635,5,0
0,0,3,3,11,11,22,16,13,29,0.000333,0.043108,5,646.617585,35.923199,129.323517,76.107496,1,0
0,0,6,6,10,13,23,18,18,36,0.000333,0.054283,5,814.241152,45.23562,162.84823,81.324997,1,0
0,0,6,6,12,12,24,21,17,38,0.000333,0.058076,6,1045.37145,58.076192,174.228575,86.0391,2,0
0,0,6,6,12,12,24,21,17,38,0.000333,0.058076,6,1045.37145,58.076192,174.228575,86.0391,2,0
0,0,6,6,12,12,24,21,17,38,0.000333,0.058076,6,1045.37145,58.076192,174.228575,86.0391,2,0
0,0,6,6,12,12,24,21,17,38,0.000333,0.058076,6,1045.37145,58.076192,174.228575,86.0391,2,0
0,0,7,7,12,12,24,27,20,47,0.000333,0.071831,6,1292.959425,71.831079,215.493238,86.0391,2,0
0,0,7,7,10,15,25,23,24,47,0.000333,0.072754,5,1091.306205,60.628122,218.261241,91.82264,1,0
0,0,6,6,10,9,19,19,14,33,0.000333,0.046727,5,700.90804,38.939336,140.181608,61.748606,1,0
0,0,7,7,10,15,25,22,26,48,0.000333,0.074302,5,1114.525486,61.918083,222.905097,91.82264,1,0
0,0,6,6,10,12,22,18,17,35,0.000333,0.052027,5,780.400533,43.355585,156.080107,76.238831,1,0
0,0,3,3,11,13,24,17,14,31,0.000333,0.047378,5,710.669188,39.481622,142.133838,86.159464,1,0
0,0,3,3,10,17,27,19,19,38,0.000333,0.060229,5,903.428625,50.190479,180.685725,102.706149,1,0
0,0,17,17,16,21,37,79,53,132,0.000333,0.229216,16,11002.36551,611.242528,687.647844,156.238666,5,0
0,0,3,3,11,13,24,17,14,31,0.000333,0.047378,5,710.669188,39.481622,142.133838,86.159464,1,0
0,0,8,8,11,9,20,27,22,49,0.000333,0.070591,10,2117.744766,117.652487,211.774477,66.583073,1,0
0,0,3,3,11,13,24,17,14,31,0.000333,0.047378,5,710.669188,39.481622,142.133838,86.159464,1,0
0,0,31,31,23,56,79,149,105,254,0.000333,0.53372,11,17612.76341,978.486856,1601.16031,429.253801,13,0
0,0,30,30,23,55,78,148,103,251,0.000333,0.525879,11,17353.99553,964.110863,1577.635957,422.016709,13,0
0,0,17,17,14,21,35,70,76,146,0.000333,0.249625,21,15726.38173,873.687874,748.87532,145.541635,5,0
0,0,11,11,10,15,25,34,54,88,0.000333,0.13622,15,6129.890171,340.549454,408.659345,91.82264,1,0
0,0,3,3,10,15,25,18,18,36,0.000333,0.055726,5,835.894114,46.438562,167.178823,91.82264,1,0
0,0,15,15,14,20,34,64,64,128,0.000333,0.217065,21,13675.10012,759.727784,651.195244,139.741531,5,0
0,0,9,9,10,14,24,28,40,68,0.000333,0.103926,10,3117.7745,173.209694,311.77745,86.52225,1,0
0,0,3,3,10,15,25,18,18,36,0.000333,0.055726,5,835.894114,46.438562,167.178823,91.82264,1,0
0,0,14,14,16,19,35,63,48,111,0.000333,0.189783,16,9109.606638,506.089258,569.350415,144.710623,5,0
0,0,3,3,11,11,22,16,13,29,0.000333,0.043108,5,646.617585,35.923199,129.323517,76.107496,1,0
0,0,13,13,12,17,29,38,45,83,0.000333,0.134404,12,4838.549071,268.808282,403.212423,112.506418,2,0
0,0,13,13,13,19,32,39,48,87,0.000333,0.145,12,5220,290,435,128.816339,2,0
0,0,12,12,9,15,24,34,46,80,0.000333,0.122266,12,4401.564001,244.531333,366.797,87.132684,1,0
0,0,13,13,10,18,28,38,52,90,0.000333,0.144221,10,4326.61943,240.367746,432.661943,108.277931,1,0
0,0,14,14,14,20,34,68,45,113,0.000333,0.191628,14,8048.366215,447.131456,574.883301,139.741531,5,0
0,0,14,14,14,20,34,68,45,113,0.000333,0.191628,14,8048.366215,447.131456,574.883301,139.741531,5,0
0,0,14,14,14,20,34,68,45,113,0.000333,0.191628,14,8048.366215,447.131456,574.883301,139.741531,5,0
0,0,14,14,14,20,34,68,45,113,0.000333,0.191628,14,8048.366215,447.131456,574.883301,139.741531,5,0
0,0,5,5,10,8,18,16,12,28,0.000333,0.038919,5,583.7895,32.43275,116.7579,57.219281,1,0
0,0,14,14,14,20,34,68,45,113,0.000333,0.191628,14,8048.366215,447.131456,574.883301,139.741531,5,0
0,0,14,14,14,20,34,68,45,113,0.000333,0.191628,14,8048.366215,447.131456,574.883301,139.741531,5,0
0,0,13,13,15,18,33,45,38,83,0.000333,0.139562,14,5861.585967,325.643665,418.684712,133.662009,2,0
0,0,12,12,15,18,33,43,36,79,0.000333,0.132836,14,5579.099896,309.949994,398.507135,133.662009,2,0
0,0,7,7,9,11,20,20,22,42,0.000333,0.060507,8,1452.16784,80.675991,181.52098,66.583073,1,0
0,0,6,6,8,11,19,18,20,38,0.000333,0.053807,4,645.684982,35.871388,161.421246,62.053748,1,0
0,0,3,3,8,8,16,12,13,25,0.000333,0.033333,4,400,22.222222,100,48,1,0
0,0,3,3,8,9,17,12,15,27,0.000333,0.036787,4,441.445987,24.524777,110.361497,52.529325,1,0
0,0,11,11,14,18,32,52,40,92,0.000333,0.153333,14,6440,357.777778,460,128.361619,5,0
0,0,3,3,11,12,23,17,14,31,0.000333,0.046743,5,701.152103,38.952895,140.230421,81.073298,1,0
0,0,3,3,11,12,23,17,14,31,0.000333,0.046743,5,701.152103,38.952895,140.230421,81.073298,1,0
0,0,13,13,9,14,23,36,25,61,0.000333,0.091979,4,1103.749117,61.319395,275.937279,81.832294,2,0
0,0,16,16,14,17,31,49,33,82,0.000333,0.135415,7,2843.708682,157.983816,406.244097,122.789837,3,0
0,0,10,10,13,15,28,36,25,61,0.000333,0.09775,6,1759.491901,97.74955,293.24865,106.709075,2,0
0,0,13,13,9,14,23,36,25,61,0.000333,0.091979,4,1103.749117,61.319395,275.937279,81.832294,2,0
0,0,16,16,14,17,31,49,33,82,0.000333,0.135415,7,2843.708682,157.983816,406.244097,122.789837,3,0
0,0,10,10,13,15,28,36,25,61,0.000333,0.09775,6,1759.491901,97.74955,293.24865,106.709075,2,0
0,0,11,11,9,14,23,32,23,55,0.000333,0.082932,4,995.18363,55.287979,248.795908,81.832294,2,0
0,0,14,14,13,17,30,45,31,76,0.000333,0.124308,6,2237.542112,124.307895,372.923685,117.592585,3,0
0,0,10,10,13,15,28,36,25,61,0.000333,0.09775,6,1759.491901,97.74955,293.24865,106.709075,2,0
0,0,11,11,8,14,22,31,23,54,0.000333,0.08027,4,963.23723,53.513179,240.809307,77.302969,2,0
0,0,14,14,13,17,30,44,31,75,0.000333,0.122672,6,2208.100768,122.672265,368.016795,117.592585,3,0
0,0,10,10,13,15,28,36,25,61,0.000333,0.09775,6,1759.491901,97.74955,293.24865,106.709075,2,0
0,0,11,11,9,14,23,32,23,55,0.000333,0.082932,4,995.18363,55.287979,248.795908,81.832294,2,0
0,0,14,14,13,17,30,45,31,76,0.000333,0.124308,6,2237.542112,124.307895,372.923685,117.592585,3,0
0,0,10,10,13,15,28,36,25,61,0.000333,0.09775,6,1759.491901,97.74955,293.24865,106.709075,2,0
0,0,11,11,8,14,22,31,23,54,0.000333,0.08027,4,963.23723,53.513179,240.809307,77.302969,2,0
0,0,14,14,13,17,30,44,31,75,0.000333,0.122672,6,2208.100768,122.672265,368.016795,117.592585,3,0
0,0,10,10,13,15,28,36,25,61,0.000333,0.09775,6,1759.491901,97.74955,293.24865,106.709075,2,0
0,0,11,11,9,13,22,32,23,55,0.000333,0.081756,4,981.074956,54.504164,245.268739,76.635041,2,0
0,0,14,14,13,16,29,45,31,76,0.000333,0.123069,6,2215.239334,123.068852,369.206556,112.105716,3,0
0,0,11,11,8,13,21,31,23,54,0.000333,0.079062,4,948.740563,52.707809,237.185141,72.105716,2,0
0,0,14,14,13,16,29,44,31,75,0.000333,0.12145,6,2186.091448,121.449525,364.348575,112.105716,3,0
0,0,14,14,14,19,33,68,44,112,0.000333,0.188324,14,7909.609979,439.422777,564.972141,134.013592,5,0
0,0,5,5,10,8,18,16,12,28,0.000333,0.038919,5,583.7895,32.43275,116.7579,57.219281,1,0
0,0,5,5,10,8,18,16,12,28,0.000333,0.038919,5,583.7895,32.43275,116.7579,57.219281,1,0
0,0,6,6,10,15,25,20,23,43,0.000333,0.066562,5,998.429081,55.468282,199.685816,91.82264,1,0
0,0,5,5,10,8,18,16,12,28,0.000333,0.038919,5,583.7895,32.43275,116.7579,57.219281,1,0
0,0,6,6,10,15,25,20,23,43,0.000333,0.066562,5,998.429081,55.468282,199.685816,91.82264,1,0
0,0,6,6,10,15,25,20,23,43,0.000333,0.066562,5,998.429081,55.468282,199.685816,91.82264,1,0
0,0,6,6,10,15,25,20,23,43,0.000333,0.066562,5,998.429081,55.468282,199.685816,91.82264,1,0
0,0,8,8,12,17,29,34,29,63,0.000333,0.102018,6,1836.316816,102.017601,306.052803,112.506418,3,0
0,0,8,8,12,17,29,34,29,63,0.000333,0.102018,6,1836.316816,102.017601,306.052803,112.506418,3,0
0,0,22,22,19,43,62,101,83,184,0.000333,0.365191,9,9860.14909,547.786061,1095.572121,314.040007,7,0
0,0,29,29,25,50,75,139,101,240,0.000333,0.498305,24,35877.99566,1993.221981,1494.916486,398.289214,8,0
0,0,28,28,25,50,75,138,99,237,0.000333,0.492077,12,17714.76036,984.153353,1476.23003,398.289214,8,0
0,0,12,12,16,23,39,47,62,109,0.000333,0.192036,16,9217.74147,512.096748,576.108842,168.041925,1,0
0,0,11,11,14,17,31,52,39,91,0.000333,0.150277,14,6311.646099,350.647006,450.831864,122.789837,5,0
0,0,12,12,15,18,33,59,41,100,0.000333,0.168146,14,7062.151767,392.341765,504.439412,133.662009,5,0
0,0,11,11,14,17,31,52,39,91,0.000333,0.150277,14,6311.646099,350.647006,450.831864,122.789837,5,0
0,0,15,15,15,25,40,71,57,128,0.000333,0.227069,14,9536.895146,529.827508,681.206796,174.699764,3,0
0,0,16,16,15,25,40,72,59,131,0.000333,0.232391,14,9760.416126,542.24534,697.17258,174.699764,3,0
0,0,9,9,10,18,28,30,29,59,0.000333,0.094545,5,1418.169702,78.787206,283.63394,108.277931,2,0
0,0,7,7,8,14,22,17,20,37,0.000333,0.055,4,659.99588,36.666438,164.99897,77.302969,1,0
0,0,16,16,15,23,38,65,56,121,0.000333,0.211666,14,8889.989208,493.888289,634.999229,162.645284,2,0
0,0,5,5,10,12,22,20,18,38,0.000333,0.056486,5,847.292008,47.071778,169.458402,76.238831,2,0
0,0,9,9,11,15,26,28,31,59,0.000333,0.092442,10,2773.259434,154.069969,277.325943,96.657107,2,0
0,0,9,9,12,17,29,37,30,67,0.000333,0.108495,6,1952.90836,108.494909,325.484727,112.506418,3,0
0,0,6,6,9,9,18,16,14,30,0.000333,0.041699,4,500.391,27.7995,125.09775,57.05865,1,0
0,0,9,9,13,16,29,38,29,67,0.000333,0.108495,6,1952.90836,108.494909,325.484727,112.105716,3,0
0,0,15,15,14,20,34,45,52,97,0.000333,0.164495,14,6908.774538,383.820808,493.483896,139.741531,2,0
0,0,30,30,20,53,73,141,105,246,0.000333,0.507566,10,15226.96842,845.94269,1522.696841,390.018346,9,0
0,0,29,29,20,53,73,140,103,243,0.000333,0.501376,10,15041.27368,835.626315,1504.127368,390.018346,9,0
0,0,30,30,23,56,79,144,108,252,0.000333,0.529518,11,17474.08023,970.782235,1588.552749,429.253801,10,0
0,0,29,29,23,56,79,143,106,249,0.000333,0.523214,11,17266.05547,959.225304,1569.641406,429.253801,10,0
0,0,23,23,18,43,61,101,83,184,0.000333,0.363752,9,9821.301031,545.627835,1091.25567,308.388034,7,0
0,0,19,19,18,41,59,94,70,164,0.000333,0.321584,9,8682.781141,482.37673,964.75346,294.718282,7,0
0,0,23,23,19,45,64,102,84,186,0.000333,0.372,9,10044,558,1116,327.844012,7,0
0,0,19,19,18,42,60,94,71,165,0.000333,0.324879,9,8771.732534,487.318474,974.636948,301.535982,7,0
0,0,33,33,20,54,74,146,122,268,0.000333,0.554711,20,33282.67004,1849.037224,1664.133502,397.202487,9,0
0,0,32,32,20,54,74,145,120,265,0.000333,0.548502,20,32910.10284,1828.339047,1645.505142,397.202487,9,0
0,0,33,33,23,57,80,149,129,278,0.000333,0.585832,22,38664.91223,2148.050679,1757.49601,436.516656,10,0
0,0,32,32,23,57,80,148,127,275,0.000333,0.57951,22,38247.66497,2124.870276,1738.530226,436.516656,10,0
0,0,35,35,20,55,75,151,132,283,0.000333,0.587585,20,35255.11379,1958.617433,1762.755689,404.413346,9,0
0,0,34,34,20,55,75,150,130,280,0.000333,0.581356,20,34881.38467,1937.854704,1744.069233,404.413346,9,0
0,0,35,35,23,58,81,154,141,295,0.000333,0.623419,22,41145.62652,2285.86814,1870.255751,443.804823,10,0
0,0,34,34,23,58,81,153,139,292,0.000333,0.617079,22,40727.19642,2262.622023,1851.236201,443.804823,10,0
0,0,20,20,17,43,60,94,71,165,0.000333,0.324879,8,7797.095586,433.171977,974.636948,302.816253,7,0
0,0,19,19,17,42,59,93,69,162,0.000333,0.317663,8,7623.905392,423.5503,952.988174,295.9642,7,0
0,0,20,20,18,42,60,95,70,165,0.000333,0.324879,9,8771.732534,487.318474,974.636948,301.535982,7,0
0,0,19,19,18,41,59,94,68,162,0.000333,0.317663,9,8576.893566,476.494087,952.988174,294.718282,7,0
0,0,12,12,14,19,33,54,45,99,0.000333,0.166465,14,6991.530249,388.418347,499.395018,134.013592,5,0
0,0,6,6,10,13,23,18,18,36,0.000333,0.054283,5,814.241152,45.23562,162.84823,81.324997,1,0
0,0,3,3,10,14,24,15,16,31,0.000333,0.047378,5,710.669188,39.481622,142.133838,86.52225,1,0
0,0,13,13,16,18,34,44,39,83,0.000333,0.140753,16,6756.150653,375.341703,422.259416,139.05865,2,0
0,0,12,12,16,18,34,42,37,79,0.000333,0.13397,16,6430.553031,357.252946,401.909564,139.05865,2,0
0,0,4,4,10,13,23,19,19,38,0.000333,0.057298,5,859.476772,47.74871,171.895354,81.324997,2,0
0,0,15,15,14,21,35,69,59,128,0.000333,0.218849,14,9191.675166,510.64862,656.548226,145.541635,5,0
0,0,11,11,13,21,34,46,40,86,0.000333,0.145841,6,2625.130826,145.840601,437.521804,140.344382,3,0
0,0,9,9,10,15,25,33,33,66,0.000333,0.102165,10,3064.945085,170.274727,306.494509,91.82264,1,0
0,0,8,8,10,16,26,27,24,51,0.000333,0.079907,5,1198.612128,66.589563,239.722426,97.219281,1,0
0,0,3,3,10,15,25,20,18,38,0.000333,0.058822,5,882.332676,49.018482,176.466535,91.82264,1,0
0,0,10,10,10,16,26,37,36,73,0.000333,0.114377,10,3431.320994,190.628944,343.132099,97.219281,1,0
0,0,7,7,10,16,26,25,23,48,0.000333,0.075207,5,1128.105532,62.67253,225.621106,97.219281,3,0
0,0,5,5,11,11,22,19,15,34,0.000333,0.05054,5,758.103375,42.116854,151.620675,76.107496,2,0
0,0,8,8,15,19,34,45,30,75,0.000333,0.127187,7,2670.917992,148.384333,381.559713,139.313982,4,0
0,0,7,7,15,18,33,41,26,67,0.000333,0.112658,7,2365.820842,131.434491,337.974406,133.662009,4,0
0,0,7,7,11,13,24,26,20,46,0.000333,0.070303,5,1054.541375,58.585632,210.908275,86.159464,3,0
0,0,8,8,14,19,33,44,30,74,0.000333,0.124428,7,2612.996154,145.166453,373.285165,134.013592,4,0
0,0,11,11,19,27,46,67,46,113,0.000333,0.208054,9,5617.462509,312.081251,624.162501,209.092585,5,0
0,0,7,7,10,16,26,25,22,47,0.000333,0.07364,5,1104.603334,61.366852,220.920667,97.219281,3,0
0,0,5,5,10,11,21,18,14,32,0.000333,0.046851,5,702.770788,39.042822,140.554158,71.273029,2,0
0,0,6,6,14,14,28,35,21,56,0.000333,0.089737,7,1884.483129,104.693507,269.211876,106.605938,4,0
0,0,6,6,10,11,21,19,15,34,0.000333,0.04978,5,746.693962,41.482998,149.338792,71.273029,3,0
0,0,7,7,11,13,24,26,19,45,0.000333,0.068774,5,1031.616563,57.312031,206.323313,86.159464,3,0
0,0,8,8,14,18,32,44,29,73,0.000333,0.121667,7,2555,141.944444,365,128.361619,4,0
0,0,11,11,19,26,45,67,45,112,0.000333,0.205029,9,5535.787921,307.543773,615.087547,202.922055,5,0
0,0,16,16,14,21,35,74,57,131,0.000333,0.223979,14,9407.105053,522.616947,671.936075,145.541635,5,0
0,0,7,7,10,13,23,22,26,48,0.000333,0.072377,10,2171.309739,120.628319,217.130974,81.324997,1,0
0,0,3,3,10,17,27,19,19,38,0.000333,0.060229,5,903.428625,50.190479,180.685725,102.706149,1,0
0,0,6,6,9,15,24,22,21,43,0.000333,0.065718,4,788.61355,43.811864,197.153388,87.132684,2,0
0,0,6,6,10,12,22,23,18,41,0.000333,0.060946,5,914.183482,50.787971,182.836696,76.238831,2,0
0,0,7,7,14,18,32,41,28,69,0.000333,0.115,7,2415,134.166667,345,128.361619,3,0
0,0,10,10,19,26,45,64,44,108,0.000333,0.197707,9,5338.08121,296.560067,593.120134,202.922055,4,0
0,0,14,14,14,19,33,68,44,112,0.000333,0.188324,14,7909.609979,439.422777,564.972141,134.013592,5,0
0,0,14,14,14,20,34,68,45,113,0.000333,0.191628,14,8048.366215,447.131456,574.883301,139.741531,5,0
0,0,3,3,11,12,23,17,14,31,0.000333,0.046743,5,701.152103,38.952895,140.230421,81.073298,1,0
0,0,5,5,10,8,18,16,12,28,0.000333,0.038919,5,583.7895,32.43275,116.7579,57.219281,1,0
0,0,11,11,14,17,31,52,39,91,0.000333,0.150277,14,6311.646099,350.647006,450.831864,122.789837,5,0
0,0,6,6,10,13,23,23,21,44,0.000333,0.066346,5,995.18363,55.287979,199.036726,81.324997,3,0
0,0,10,10,11,16,27,31,34,65,0.000333,0.103023,10,3090.676876,171.704271,309.067688,102.053748,3,0
0,0,14,14,14,20,34,68,45,113,0.000333,0.191628,14,8048.366215,447.131456,574.883301,139.741531,5,0
0,0,14,14,13,19,32,47,40,87,0.000333,0.145,12,5220,290,435,128.816339,2,0
0,0,11,11,13,18,31,40,33,73,0.000333,0.120552,6,2169.937984,120.55211,361.656331,123.164366,2,0
0,0,10,10,13,17,30,39,31,70,0.000333,0.114494,6,2060.89405,114.494114,343.482342,117.592585,2,0
0,0,9,9,12,15,27,28,25,53,0.000333,0.084003,6,1512.054226,84.003013,252.009038,101.622909,2,0
0,0,16,16,14,19,33,55,42,97,0.000333,0.163102,14,6850.287214,380.571512,489.30623,134.013592,3,0
0,0,16,16,14,19,33,55,42,97,0.000333,0.163102,14,6850.287214,380.571512,489.30623,134.013592,3,0
0,0,27,27,19,46,65,117,88,205,0.000333,0.411528,9,11111.26862,617.292701,1234.585402,334.794473,10,0
0,0,23,23,19,42,61,109,77,186,0.000333,0.367706,9,9928.054303,551.558572,1103.117145,307.187955,10,0
0,0,23,23,19,48,67,120,90,210,0.000333,0.424626,9,11464.90857,636.939365,1273.87873,348.788823,7,0
0,0,7,7,8,16,24,19,23,42,0.000333,0.064189,4,770.2737,42.792983,192.568425,88,1,0
0,0,9,9,8,16,24,29,35,64,0.000333,0.097813,8,2347.5008,130.416711,293.4376,88,1,0
0,0,17,17,15,21,36,78,59,137,0.000333,0.236093,14,9915.916153,550.884231,708.279725,150.842025,5,0
0,0,8,8,11,13,24,26,30,56,0.000333,0.085586,10,2567.579,142.643278,256.7579,86.159464,1,0
0,0,8,8,11,13,24,26,30,56,0.000333,0.085586,10,2567.579,142.643278,256.7579,86.159464,1,0
0,0,17,17,15,20,35,78,56,134,0.000333,0.229108,14,9622.53494,534.585274,687.323924,145.041921,5,0
0,0,8,8,11,12,23,26,26,52,0.000333,0.078408,10,2352.252217,130.680679,235.225222,81.073298,1,0
0,0,15,15,14,21,35,71,47,118,0.000333,0.201752,14,8473.575544,470.754197,605.255396,145.541635,5,0
0,0,8,8,12,14,26,26,22,48,0.000333,0.075207,6,1353.726639,75.207035,225.621106,96.322519,2,0
0,0,10,10,10,18,28,37,42,79,0.000333,0.126594,10,3797.810388,210.989466,379.781039,108.277931,1,0
0,0,11,11,12,22,34,40,40,80,0.000333,0.135666,6,2441.982164,135.665676,406.997027,141.127046,2,0
0,0,9,9,10,15,25,33,33,66,0.000333,0.102165,10,3064.945085,170.274727,306.494509,91.82264,1,0
0,0,8,8,10,16,26,27,24,51,0.000333,0.079907,5,1198.612128,66.589563,239.722426,97.219281,1,0
0,0,3,3,10,15,25,20,18,38,0.000333,0.058822,5,882.332676,49.018482,176.466535,91.82264,1,0
0,0,10,10,10,16,26,37,36,73,0.000333,0.114377,10,3431.320994,190.628944,343.132099,97.219281,1,0
0,0,10,10,11,18,29,41,42,83,0.000333,0.134404,10,4032.124226,224.006901,403.212423,113.112398,1,0
0,0,9,9,11,15,26,37,33,70,0.000333,0.109677,10,3290.307803,182.794878,329.03078,96.657107,1,0
0,0,3,3,10,15,25,18,18,36,0.000333,0.055726,5,835.894114,46.438562,167.178823,91.82264,1,0
0,0,10,10,11,19,30,32,45,77,0.000333,0.125944,10,3778.305759,209.905875,377.830576,118.764371,1,0
0,0,9,9,10,16,26,28,36,64,0.000333,0.100276,10,3008.28142,167.126746,300.828142,97.219281,1,0
0,0,3,3,10,16,26,17,21,38,0.000333,0.059539,5,893.083546,49.615753,178.616709,97.219281,1,0
0,0,14,14,14,19,33,68,44,112,0.000333,0.188324,14,7909.609979,439.422777,564.972141,134.013592,5,0
0,0,5,5,10,8,18,16,12,28,0.000333,0.038919,5,583.7895,32.43275,116.7579,57.219281,1,0
0,0,14,14,14,19,33,68,44,112,0.000333,0.188324,14,7909.609979,439.422777,564.972141,134.013592,5,0
0,0,16,16,15,23,38,75,52,127,0.000333,0.222162,14,9330.815119,518.378618,666.486794,162.645284,5,0
0,0,7,7,10,11,21,23,19,42,0.000333,0.061492,5,922.386659,51.243703,184.477332,71.273029,1,0
0,0,28,28,23,54,77,136,96,232,0.000333,0.484631,11,15992.83925,888.49107,1453.894477,414.80585,11,0
0,0,27,27,23,53,76,135,94,229,0.000333,0.476925,11,15738.52941,874.362745,1430.775401,407.621709,11,0
0,0,28,28,23,54,77,136,96,232,0.000333,0.484631,11,15992.83925,888.49107,1453.894477,414.80585,11,0
0,0,27,27,23,53,76,135,94,229,0.000333,0.476925,11,15738.52941,874.362745,1430.775401,407.621709,11,0
0,0,11,11,14,18,32,52,40,92,0.000333,0.153333,14,6440,357.777778,460,128.361619,5,0
0,0,3,3,11,12,23,16,13,29,0.000333,0.043728,5,655.916484,36.439805,131.183297,81.073298,1,0
0,0,3,3,11,12,23,16,13,29,0.000333,0.043728,5,655.916484,36.439805,131.183297,81.073298,1,0
0,0,11,11,14,18,32,52,40,92,0.000333,0.153333,14,6440,357.777778,460,128.361619,5,0
0,0,12,12,14,19,33,55,42,97,0.000333,0.163102,14,6850.287214,380.571512,489.30623,134.013592,5,0
0,0,6,6,10,9,19,19,14,33,0.000333,0.046727,5,700.90804,38.939336,140.181608,61.748606,1,0
0,0,11,11,14,18,32,52,40,92,0.000333,0.153333,14,6440,357.777778,460,128.361619,5,0
0,0,5,5,10,8,18,16,12,28,0.000333,0.038919,5,583.7895,32.43275,116.7579,57.219281,1,0
0,0,14,14,14,20,34,68,45,113,0.000333,0.191628,14,8048.366215,447.131456,574.883301,139.741531,5,0
0,0,14,14,14,20,34,68,45,113,0.000333,0.191628,14,8048.366215,447.131456,574.883301,139.741531,5,0
0,0,3,3,11,12,23,16,13,29,0.000333,0.043728,5,655.916484,36.439805,131.183297,81.073298,1,0
0,0,5,5,10,8,18,16,12,28,0.000333,0.038919,5,583.7895,32.43275,116.7579,57.219281,1,0
0,0,15,15,16,21,37,77,48,125,0.000333,0.217061,16,10418.90673,578.828152,651.181671,156.238666,6,0
0,0,15,15,16,21,37,77,48,125,0.000333,0.217061,16,10418.90673,578.828152,651.181671,156.238666,6,0
0,0,15,15,17,20,37,78,47,125,0.000333,0.217061,16,10418.90673,578.828152,651.181671,155.92543,6,0
0,0,15,15,17,20,37,78,47,125,0.000333,0.217061,16,10418.90673,578.828152,651.181671,155.92543,6,0
0,0,6,6,12,11,23,22,16,38,0.000333,0.057298,6,1031.372126,57.298451,171.895354,81.073298,2,0
0,0,6,6,12,11,23,22,16,38,0.000333,0.057298,6,1031.372126,57.298451,171.895354,81.073298,2,0
0,0,29,29,23,33,56,113,93,206,0.000333,0.398772,22,26318.93251,1462.162917,1196.315114,270.506931,7,0
0,0,18,18,19,23,42,62,69,131,0.000333,0.235465,27,19072.62672,1059.590374,706.393582,184.752548,3,0
0,0,30,30,24,35,59,118,104,222,0.000333,0.435316,24,31342.72217,1741.262343,1305.946757,289.564006,8,0
0,0,15,15,16,21,37,77,48,125,0.000333,0.217061,16,10418.90673,578.828152,651.181671,156.238666,6,0
0,0,15,15,17,20,37,78,47,125,0.000333,0.217061,16,10418.90673,578.828152,651.181671,155.92543,6,0
0,0,15,15,17,20,37,78,47,125,0.000333,0.217061,16,10418.90673,578.828152,651.181671,155.92543,6,0
0,0,6,6,12,11,23,22,16,38,0.000333,0.057298,6,1031.372126,57.298451,171.895354,81.073298,2,0
0,0,6,6,12,11,23,22,16,38,0.000333,0.057298,6,1031.372126,57.298451,171.895354,81.073298,2,0
0,0,49,49,28,60,88,203,142,345,0.000333,0.742835,28,62398.10944,3466.561635,2228.503908,489.019374,13,0
0,0,16,16,20,24,44,57,62,119,0.000333,0.216557,20,12993.44725,721.858181,649.672363,196.477662,3,0
0,0,7,7,10,17,27,25,23,48,0.000333,0.076078,5,1141.173001,63.3985,228.2346,102.706149,3,0
0,0,5,5,11,12,23,19,15,34,0.000333,0.051267,5,769.005533,42.72253,153.801107,81.073298,2,0
0,0,6,6,15,16,31,36,22,58,0.000333,0.095781,7,2011.403702,111.74465,287.343386,122.603359,4,0
0,0,6,6,11,13,24,20,16,36,0.000333,0.05502,5,825.29325,45.849625,165.05865,86.159464,3,0
0,0,7,7,11,14,25,26,20,46,0.000333,0.071206,5,1068.086924,59.338162,213.617385,91.356717,3,0
0,0,8,8,14,20,34,44,30,74,0.000333,0.125491,7,2635.305752,146.405875,376.47225,139.741531,4,0
0,0,11,11,19,28,47,67,46,113,0.000333,0.209223,9,5649.016862,313.83427,627.66854,215.316561,5,0
0,0,6,6,9,15,24,22,21,43,0.000333,0.065718,4,788.61355,43.811864,197.153388,87.132684,2,0
0,0,6,6,10,12,22,23,18,41,0.000333,0.060946,5,914.183482,50.787971,182.836696,76.238831,2,0
0,0,7,7,14,18,32,41,28,69,0.000333,0.115,7,2415,134.166667,345,128.361619,3,0
0,0,10,10,19,26,45,64,44,108,0.000333,0.197707,9,5338.08121,296.560067,593.120134,202.922055,4,0
0,0,31,31,24,57,81,149,105,254,0.000333,0.536774,12,19323.86281,1073.547934,1610.321901,442.513831,13,0
0,0,30,30,24,56,80,148,103,251,0.000333,0.528935,12,19041.64742,1057.869301,1586.803952,435.250976,13,0
0,0,31,31,24,57,81,149,105,254,0.000333,0.536774,12,19323.86281,1073.547934,1610.321901,442.513831,13,0
0,0,30,30,24,56,80,148,103,251,0.000333,0.528935,12,19041.64742,1057.869301,1586.803952,435.250976,13,0
0,0,3,3,11,13,24,17,14,31,0.000333,0.047378,5,710.669188,39.481622,142.133838,86.159464,1,0
0,0,31,31,23,57,80,149,106,255,0.000333,0.537364,11,17733.00831,985.167128,1612.091664,436.516656,12,0
0,0,30,30,23,56,79,148,104,252,0.000333,0.529518,11,17474.08023,970.782235,1588.552749,429.253801,12,0
0,0,15,15,13,19,32,48,53,101,0.000333,0.168333,12,6060,336.666667,505,128.816339,2,0
0,0,14,14,13,19,32,46,51,97,0.000333,0.161667,12,5820,323.333333,485,128.816339,2,0
0,0,17,17,13,20,33,54,63,117,0.000333,0.196731,18,10623.49402,590.194112,590.194112,134.544278,2,0
0,0,16,16,13,20,33,52,61,113,0.000333,0.190006,18,10260.29764,570.016535,570.016535,134.544278,2,0
0,0,8,8,11,14,25,24,24,48,0.000333,0.074302,5,1114.525486,61.918083,222.905097,91.356717,2,0
0,0,7,7,10,14,24,22,22,44,0.000333,0.067246,5,1008.69175,56.038431,201.73835,86.52225,2,0
0,0,8,8,12,13,25,28,20,48,0.000333,0.074302,6,1337.430583,74.301699,222.905097,91.125266,2,0
0,0,11,11,13,17,30,38,36,74,0.000333,0.121037,12,4357.318849,242.073269,363.109904,117.592585,2,0
0,0,11,11,13,17,30,38,36,74,0.000333,0.121037,12,4357.318849,242.073269,363.109904,117.592585,2,0
0,0,15,15,15,25,40,69,57,126,0.000333,0.223521,14,9387.881159,521.548953,670.56294,174.699764,6,0
0,0,9,9,13,17,30,33,32,65,0.000333,0.106316,6,1913.687332,106.315963,318.947889,117.592585,2,0
0,0,10,10,15,24,39,43,45,88,0.000333,0.155038,7,3255.807767,180.878209,465.115395,168.642459,1,0
0,0,13,13,16,21,37,60,48,108,0.000333,0.18754,16,9001.935416,500.107523,562.620963,156.238666,5,0
0,0,7,7,12,14,26,24,24,48,0.000333,0.075207,6,1353.726639,75.207035,225.621106,96.322519,1,0
0,0,15,15,14,20,34,70,48,118,0.000333,0.200107,14,8404.488614,466.916034,600.320615,139.741531,5,0
0,0,6,6,9,12,21,15,17,32,0.000333,0.046851,4,562.21663,31.234257,140.554158,71.548875,1,0
0,0,15,15,15,22,37,71,48,119,0.000333,0.206642,14,8678.949307,482.16385,619.924951,156.710855,5,0
0,0,6,6,10,14,24,20,22,42,0.000333,0.064189,5,962.842125,53.491229,192.568425,86.52225,1,0
0,0,13,13,17,24,41,64,43,107,0.000333,0.191086,8,4586.064516,254.781362,573.258064,179.525968,6,0
0,0,14,14,17,25,42,65,45,110,0.000333,0.197718,8,4745.239332,263.624407,593.154917,185.583273,6,0
0,0,13,13,17,24,41,64,43,107,0.000333,0.191086,8,4586.064516,254.781362,573.258064,179.525968,6,0
0,0,14,14,17,25,42,65,45,110,0.000333,0.197718,8,4745.239332,263.624407,593.154917,185.583273,6,0
0,0,13,13,17,24,41,64,43,107,0.000333,0.191086,8,4586.064516,254.781362,573.258064,179.525968,6,0
0,0,14,14,17,25,42,65,45,110,0.000333,0.197718,8,4745.239332,263.624407,593.154917,185.583273,6,0
0,0,13,13,17,24,41,64,43,107,0.000333,0.191086,8,4586.064516,254.781362,573.258064,179.525968,6,0
0,0,14,14,17,25,42,65,45,110,0.000333,0.197718,8,4745.239332,263.624407,593.154917,185.583273,6,0
0,0,9,9,12,18,30,32,36,68,0.000333,0.111223,12,4004.022726,222.445707,333.668561,118.0782,2,0
0,0,8,8,12,15,27,28,28,56,0.000333,0.088758,6,1597.642201,88.7579,266.2737,101.622909,2,0
0,0,13,13,14,22,36,56,42,98,0.000333,0.168884,7,3546.568551,197.031586,506.65265,151.410465,11,0
0,0,11,11,14,22,36,45,34,79,0.000333,0.136141,7,2858.968526,158.831585,408.424075,151.410465,10,0
0,0,13,13,15,19,34,57,39,96,0.000333,0.162799,14,6837.550059,379.863892,488.396433,139.313982,10,0
0,0,15,15,15,19,34,64,44,108,0.000333,0.183149,14,7692.243816,427.346879,549.445987,139.313982,14,0
0,0,17,17,15,19,34,76,52,128,0.000333,0.217065,14,9116.733412,506.48519,651.195244,139.313982,16,0
0,0,11,11,15,19,34,46,31,77,0.000333,0.130578,7,2742.142471,152.341248,391.734639,139.313982,9,0
0,0,9,9,14,17,31,37,27,64,0.000333,0.10569,7,2219.479947,123.304442,317.068564,122.789837,9,0
0,0,9,9,14,17,31,37,27,64,0.000333,0.10569,7,2219.479947,123.304442,317.068564,122.789837,9,0
0,0,11,11,15,18,33,42,30,72,0.000333,0.121065,7,2542.374636,141.243035,363.196377,133.662009,9,0
0,0,11,11,15,18,33,42,30,72,0.000333,0.121065,7,2542.374636,141.243035,363.196377,133.662009,9,0
0,0,14,14,14,20,34,68,45,113,0.000333,0.191628,14,8048.366215,447.131456,574.883301,139.741531,5,0
0,0,9,9,14,18,32,38,28,66,0.000333,0.11,7,2310,128.333333,330,128.361619,9,0
0,0,9,9,14,18,32,37,28,65,0.000333,0.108333,7,2275,126.388889,325,128.361619,9,0
0,0,15,15,14,20,34,70,48,118,0.000333,0.200107,14,8404.488614,466.916034,600.320615,139.741531,5,0
0,0,6,6,10,12,22,18,17,35,0.000333,0.052027,5,780.400533,43.355585,156.080107,76.238831,1,0
0,0,15,15,14,20,34,71,46,117,0.000333,0.198411,14,8333.264134,462.959119,595.233152,139.741531,5,0
0,0,6,6,10,9,19,19,14,33,0.000333,0.046727,5,700.90804,38.939336,140.181608,61.748606,1,0
0,0,7,7,8,12,20,17,24,41,0.000333,0.059066,8,1417.592415,78.755134,177.199052,67.01955,1,0
0,0,19,19,13,20,33,57,73,130,0.000333,0.21859,18,11803.88224,655.771236,655.771236,134.544278,2,0
0,0,15,15,14,19,33,54,50,104,0.000333,0.174872,14,7344.637838,408.035435,524.616988,134.013592,2,0
0,0,8,8,10,16,26,26,35,61,0.000333,0.095576,10,2867.268228,159.292679,286.726823,97.219281,1,0
0,0,3,3,10,15,25,18,18,36,0.000333,0.055726,5,835.894114,46.438562,167.178823,91.82264,1,0
0,0,7,7,10,13,23,22,26,48,0.000333,0.072377,10,2171.309739,120.628319,217.130974,81.324997,1,0
0,0,3,3,10,16,26,18,18,36,0.000333,0.056405,5,846.079149,47.004397,169.21583,97.219281,1,0
0,0,3,3,10,16,26,18,18,36,0.000333,0.056405,5,846.079149,47.004397,169.21583,97.219281,1,0
0,0,3,3,11,12,23,16,13,29,0.000333,0.043728,5,655.916484,36.439805,131.183297,81.073298,1,0
0,0,3,3,10,16,26,19,18,37,0.000333,0.057972,5,869.581348,48.310075,173.91627,97.219281,1,0
0,0,4,4,8,9,17,15,12,27,0.000333,0.036787,4,441.445987,24.524777,110.361497,52.529325,1,0
0,0,7,7,12,12,24,28,20,48,0.000333,0.073359,6,1320.4692,73.3594,220.0782,86.0391,2,0
0,0,12,12,13,19,32,55,45,100,0.000333,0.166667,12,6000,333.333333,500,128.816339,3,0
0,0,9,9,11,14,25,37,31,68,0.000333,0.105261,10,3157.822209,175.434567,315.782221,91.356717,1,0
0,0,12,12,12,19,31,51,45,96,0.000333,0.158534,12,5707.23415,317.068564,475.602846,123.730173,3,0
0,0,14,14,13,23,36,56,45,101,0.000333,0.174054,6,3132.974551,174.054142,522.162425,152.147641,4,0
0,0,9,9,10,14,24,33,31,64,0.000333,0.097813,10,2934.376,163.020889,293.4376,86.52225,1,0
0,0,8,8,10,15,25,27,23,50,0.000333,0.077398,5,1160.964047,64.498003,232.192809,91.82264,1,0
0,0,10,10,10,15,25,37,34,71,0.000333,0.109905,10,3297.137895,183.174327,329.713789,91.82264,1,0
0,0,15,15,14,21,35,70,49,119,0.000333,0.203462,14,8545.385506,474.743639,610.384679,145.541635,5,0
0,0,6,6,10,13,23,18,18,36,0.000333,0.054283,5,814.241152,45.23562,162.84823,81.324997,1,0
0,0,14,14,13,19,32,47,40,87,0.000333,0.145,12,5220,290,435,128.816339,2,0
0,0,11,11,13,18,31,40,33,73,0.000333,0.120552,6,2169.937984,120.55211,361.656331,123.164366,2,0
0,0,10,10,13,17,30,39,31,70,0.000333,0.114494,6,2060.89405,114.494114,343.482342,117.592585,2,0
0,0,9,9,12,15,27,28,25,53,0.000333,0.084003,6,1512.054226,84.003013,252.009038,101.622909,2,0
0,0,16,16,14,20,34,55,42,97,0.000333,0.164495,14,6908.774538,383.820808,493.483896,139.741531,3,0
0,0,16,16,14,20,34,55,42,97,0.000333,0.164495,14,6908.774538,383.820808,493.483896,139.741531,3,0
0,0,3,3,11,13,24,17,14,31,0.000333,0.047378,5,710.669188,39.481622,142.133838,86.159464,1,0
0,0,3,3,11,13,24,17,14,31,0.000333,0.047378,5,710.669188,39.481622,142.133838,86.159464,1,0
0,0,14,14,14,19,33,68,44,112,0.000333,0.188324,14,7909.609979,439.422777,564.972141,134.013592,5,0
0,0,14,14,14,20,34,68,45,113,0.000333,0.191628,14,8048.366215,447.131456,574.883301,139.741531,5,0
0,0,3,3,11,13,24,17,14,31,0.000333,0.047378,5,710.669188,39.481622,142.133838,86.159464,1,0
0,0,3,3,11,13,24,17,14,31,0.000333,0.047378,5,710.669188,39.481622,142.133838,86.159464,1,0
0,0,5,5,10,8,18,16,12,28,0.000333,0.038919,5,583.7895,32.43275,116.7579,57.219281,1,0
0,0,3,3,11,12,23,16,13,29,0.000333,0.043728,5,655.916484,36.439805,131.183297,81.073298,1,0
0,0,6,6,10,15,25,20,23,43,0.000333,0.066562,5,998.429081,55.468282,199.685816,91.82264,1,0
0,0,5,5,10,8,18,16,12,28,0.000333,0.038919,5,583.7895,32.43275,116.7579,57.219281,1,0
0,0,12,12,16,22,38,46,61,107,0.000333,0.187176,16,8984.451903,499.136217,561.528244,162.107496,1,0
0,0,6,6,10,15,25,20,23,43,0.000333,0.066562,5,998.429081,55.468282,199.685816,91.82264,1,0
0,0,12,12,14,19,33,54,45,99,0.000333,0.166465,14,6991.530249,388.418347,499.395018,134.013592,5,0
0,0,3,3,11,13,24,17,14,31,0.000333,0.047378,5,710.669188,39.481622,142.133838,86.159464,1,0
0,0,6,6,10,13,23,18,18,36,0.000333,0.054283,5,814.241152,45.23562,162.84823,81.324997,1,0
0,0,23,23,19,47,66,120,88,208,0.000333,0.419078,9,11315.10579,628.616988,1257.233977,341.776299,7,0
0,0,7,7,8,15,23,19,22,41,0.000333,0.061822,4,741.864161,41.214676,185.46604,82.603359,1,0
0,0,9,9,8,15,23,29,33,62,0.000333,0.093487,8,2243.68673,124.649263,280.460841,82.603359,1,0
0,0,8,8,12,17,29,30,35,65,0.000333,0.105256,12,3789.225176,210.51251,315.768765,112.506418,2,0
0,0,8,8,13,18,31,31,41,72,0.000333,0.118901,12,4280.425612,237.801423,356.702134,123.164366,2,0
0,0,14,14,19,26,45,71,49,120,0.000333,0.219674,9,5931.201344,329.511186,659.022372,202.922055,6,0
0,0,15,15,19,27,46,72,51,123,0.000333,0.226466,9,6114.583085,339.69906,679.398121,209.092585,6,0
0,0,4,4,10,14,24,21,21,42,0.000333,0.064189,5,962.842125,53.491229,192.568425,86.52225,2,0
0,0,4,4,10,15,25,21,23,44,0.000333,0.06811,5,1021.648362,56.758242,204.329672,91.82264,2,0
0,0,9,9,13,14,27,29,23,52,0.000333,0.082418,6,1483.524901,82.41805,247.25415,101.408685,2,0
0,0,10,10,13,16,29,33,27,60,0.000333,0.09716,6,1748.873158,97.15962,291.47886,112.105716,2,0
0,0,16,16,14,21,35,74,57,131,0.000333,0.223979,14,9407.105053,522.616947,671.936075,145.541635,5,0
0,0,7,7,10,13,23,22,26,48,0.000333,0.072377,10,2171.309739,120.628319,217.130974,81.324997,1,0
0,0,3,3,10,16,26,18,18,36,0.000333,0.056405,5,846.079149,47.004397,169.21583,97.219281,1,0
0,0,9,9,12,18,30,37,31,68,0.000333,0.111223,6,2002.011363,111.222854,333.668561,118.0782,3,0
0,0,3,3,10,17,27,19,19,38,0.000333,0.060229,5,903.428625,50.190479,180.685725,102.706149,1,0
0,0,12,12,13,21,34,46,51,97,0.000333,0.164495,12,5921.806747,328.989264,493.483896,140.344382,3,0
0,0,9,9,10,16,26,28,36,64,0.000333,0.100276,10,3008.28142,167.126746,300.828142,97.219281,1,0
0,0,3,3,10,18,28,18,22,40,0.000333,0.064098,5,961.470984,53.415055,192.294197,108.277931,1,0
0,0,17,17,15,22,37,80,60,140,0.000333,0.243108,14,10210.5286,567.251589,729.323471,156.710855,5,0
0,0,8,8,11,14,25,28,29,57,0.000333,0.088233,10,2646.998028,147.055446,264.699803,91.356717,1,0
0,0,3,3,10,16,26,19,18,37,0.000333,0.057972,5,869.581348,48.310075,173.91627,97.219281,1,0
0,0,3,3,11,11,22,16,13,29,0.000333,0.043108,5,646.617585,35.923199,129.323517,76.107496,1,0
0,0,3,3,11,11,22,16,13,29,0.000333,0.043108,5,646.617585,35.923199,129.323517,76.107496,1,0
0,0,11,11,12,19,31,38,46,84,0.000333,0.138717,12,4993.829881,277.434993,416.15249,123.730173,2,0
0,0,10,10,12,16,28,34,40,74,0.000333,0.118581,12,4268.931171,237.162843,355.744264,107.01955,2,0
0,0,7,7,10,16,26,23,25,48,0.000333,0.075207,5,1128.105532,62.67253,225.621106,97.219281,1,0
0,0,6,6,10,10,20,19,15,34,0.000333,0.048982,5,734.727776,40.81821,146.945555,66.438562,1,0
0,0,5,5,11,11,22,23,18,41,0.000333,0.060946,5,914.183482,50.787971,182.836696,76.107496,2,0
0,0,9,9,11,15,26,30,29,59,0.000333,0.092442,5,1386.629717,77.034984,277.325943,96.657107,2,0
0,0,5,5,11,12,23,23,19,42,0.000333,0.06333,5,949.948011,52.774889,189.989602,81.073298,2,0
0,0,9,9,11,14,25,31,30,61,0.000333,0.094425,10,2832.752276,157.375126,283.275228,91.356717,2,0
0,0,14,14,18,26,44,67,48,115,0.000333,0.209278,9,5650.511725,313.917318,627.834636,197.270083,5,0
0,0,15,15,18,26,44,68,50,118,0.000333,0.214738,9,5797.916379,322.106465,644.212931,197.270083,5,0
0,0,5,5,9,14,23,21,19,40,0.000333,0.060314,4,723.769913,40.20944,180.942478,81.832294,2,0
0,0,6,6,9,15,24,22,21,43,0.000333,0.065718,4,788.61355,43.811864,197.153388,87.132684,2,0
0,0,5,5,10,13,23,22,18,40,0.000333,0.060314,5,904.712391,50.2618,180.942478,81.324997,2,0
0,0,6,6,10,14,24,23,20,43,0.000333,0.065718,5,985.766938,54.76483,197.153388,86.52225,2,0
0,0,9,9,12,18,30,40,27,67,0.000333,0.109587,6,1972.570019,109.587223,328.76167,118.0782,7,0
0,0,9,9,12,18,30,39,27,66,0.000333,0.107952,6,1943.128676,107.951593,323.854779,118.0782,7,0
0,0,12,12,15,19,34,59,42,101,0.000333,0.171278,14,7193.672458,399.64847,513.833747,139.313982,5,0
0,0,3,3,11,13,24,17,14,31,0.000333,0.047378,5,710.669188,39.481622,142.133838,86.159464,1,0
0,0,11,11,14,17,31,45,36,81,0.000333,0.133763,14,5618.058616,312.114368,401.289901,122.789837,3,0
0,0,17,17,15,25,40,74,50,124,0.000333,0.219973,14,9238.867173,513.270398,659.919084,174.699764,8,0
0,0,15,15,12,22,34,50,60,110,0.000333,0.18654,12,6715.45095,373.080608,559.620913,141.127046,2,0
0,0,14,14,12,19,31,46,56,102,0.000333,0.168443,12,6063.936284,336.885349,505.328024,123.730173,2,0
0,0,3,3,11,12,23,17,14,31,0.000333,0.046743,5,701.152103,38.952895,140.230421,81.073298,1,0
0,0,13,13,14,15,29,52,43,95,0.000333,0.153836,14,6461.114724,358.950818,461.508195,111.906328,2,0
0,0,13,13,14,15,29,52,43,95,0.000333,0.153836,14,6461.114724,358.950818,461.508195,111.906328,2,0
0,0,13,13,14,15,29,52,43,95,0.000333,0.153836,14,6461.114724,358.950818,461.508195,111.906328,2,0
0,0,13,13,14,15,29,52,43,95,0.000333,0.153836,14,6461.114724,358.950818,461.508195,111.906328,2,0
0,0,10,10,12,17,29,37,25,62,0.000333,0.100398,6,1807.16893,100.398274,301.194822,112.506418,3,0
0,0,15,15,13,15,28,60,36,96,0.000333,0.153835,12,5538.07287,307.670715,461.506073,106.709075,4,0
0,0,11,11,11,13,24,38,27,65,0.000333,0.099341,10,2980.225625,165.56809,298.022563,86.159464,2,0
0,0,14,14,14,16,30,51,35,86,0.000333,0.140664,14,5907.896277,328.21646,421.992591,117.302969,3,0
0,0,8,8,11,13,24,27,18,45,0.000333,0.068774,5,1031.616563,57.312031,206.323313,86.159464,2,0
0,0,16,16,14,16,30,62,39,101,0.000333,0.165199,14,6938.343302,385.463517,495.59595,117.302969,4,0
0,0,10,10,13,15,28,38,23,61,0.000333,0.09775,6,1759.491901,97.74955,293.24865,106.709075,3,0
0,0,6,6,11,11,22,19,15,34,0.000333,0.05054,5,758.103375,42.116854,151.620675,76.107496,2,0
0,0,9,9,13,14,27,32,23,55,0.000333,0.087173,6,1569.112876,87.172938,261.518813,101.408685,3,0
0,0,6,6,10,11,21,18,15,33,0.000333,0.048315,5,724.732375,40.26291,144.946475,71.273029,2,0
0,0,9,9,13,14,27,31,23,54,0.000333,0.085588,6,1540.583551,85.587975,256.763925,101.408685,3,0
0,0,6,6,10,14,24,20,22,42,0.000333,0.064189,5,962.842125,53.491229,192.568425,86.52225,1,0
0,0,5,5,10,8,18,16,12,28,0.000333,0.038919,5,583.7895,32.43275,116.7579,57.219281,1,0
0,0,11,11,12,16,28,34,35,69,0.000333,0.110569,12,3980.489875,221.138326,331.70749,107.01955,2,0
0,0,12,12,13,19,32,39,38,77,0.000333,0.128333,12,4620,256.666667,385,128.816339,2,0
0,0,16,16,13,20,33,53,50,103,0.000333,0.173191,12,6234.871132,346.38173,519.572594,134.544278,2,0
0,0,11,11,13,18,31,43,35,78,0.000333,0.128809,6,2318.563873,128.809104,386.427312,123.164366,2,0
0,0,10,10,13,17,30,42,33,75,0.000333,0.122672,6,2208.100768,122.672265,368.016795,117.592585,2,0
0,0,17,17,14,23,37,58,53,111,0.000333,0.19275,14,8095.49053,449.749474,578.249324,157.344894,2,0
0,0,11,11,13,19,32,43,36,79,0.000333,0.131667,6,2370,131.666667,395,128.816339,2,0
0,0,10,10,13,18,31,42,34,76,0.000333,0.125506,6,2259.113518,125.506307,376.51892,123.164366,2,0
0,0,9,9,13,17,30,41,30,71,0.000333,0.11613,6,2090.335394,116.129744,348.389232,117.592585,3,0
0,0,6,6,10,8,18,23,14,37,0.000333,0.051429,5,771.436125,42.857563,154.287225,57.219281,1,0
0,0,8,8,12,16,28,34,28,62,0.000333,0.099352,6,1788.336031,99.352002,298.056005,107.01955,3,0
0,0,15,15,14,21,35,71,47,118,0.000333,0.201752,14,8473.575544,470.754197,605.255396,145.541635,5,0
0,0,3,3,10,17,27,19,19,38,0.000333,0.060229,5,903.428625,50.190479,180.685725,102.706149,1,0
0,0,8,8,9,13,22,22,26,48,0.000333,0.071351,8,1712.421742,95.134541,214.052718,76.635041,1,0
0,0,9,9,12,15,27,26,25,51,0.000333,0.080833,6,1454.995576,80.833088,242.499263,101.622909,2,0
0,0,10,10,12,15,27,30,30,60,0.000333,0.095098,12,3423.519002,190.1955,285.29325,101.622909,2,0
0,0,10,10,11,15,26,29,30,59,0.000333,0.092442,10,2773.259434,154.069969,277.325943,96.657107,2,0
0,0,6,6,10,15,25,20,23,43,0.000333,0.066562,5,998.429081,55.468282,199.685816,91.82264,1,0
0,0,6,6,10,15,25,20,23,43,0.000333,0.066562,5,998.429081,55.468282,199.685816,91.82264,1,0
0,0,3,3,11,12,23,17,14,31,0.000333,0.046743,5,701.152103,38.952895,140.230421,81.073298,1,0
0,0,3,3,11,12,23,17,14,31,0.000333,0.046743,5,701.152103,38.952895,140.230421,81.073298,1,0
0,0,8,8,12,16,28,34,28,62,0.000333,0.099352,6,1788.336031,99.352002,298.056005,107.01955,3,0
0,0,14,14,14,19,33,68,44,112,0.000333,0.188324,14,7909.609979,439.422777,564.972141,134.013592,5,0
0,0,14,14,14,19,33,68,44,112,0.000333,0.188324,14,7909.609979,439.422777,564.972141,134.013592,5,0
0,0,5,5,10,8,18,16,12,28,0.000333,0.038919,5,583.7895,32.43275,116.7579,57.219281,1,0
0,0,5,5,10,8,18,16,12,28,0.000333,0.038919,5,583.7895,32.43275,116.7579,57.219281,1,0
0,0,14,14,14,19,33,68,44,112,0.000333,0.188324,14,7909.609979,439.422777,564.972141,134.013592,5,0
0,0,5,5,10,8,18,16,12,28,0.000333,0.038919,5,583.7895,32.43275,116.7579,57.219281,1,0
0,0,14,14,14,19,33,68,44,112,0.000333,0.188324,14,7909.609979,439.422777,564.972141,134.013592,5,0
0,0,15,15,14,21,35,71,47,118,0.000333,0.201752,14,8473.575544,470.754197,605.255396,145.541635,5,0
0,0,3,3,10,16,26,19,19,38,0.000333,0.059539,5,893.083546,49.615753,178.616709,97.219281,1,0
0,0,33,33,16,26,42,150,94,244,0.000333,0.438575,24,31577.41083,1754.300602,1315.725451,186.211433,13,0
0,0,19,19,16,26,42,83,53,136,0.000333,0.244452,16,11733.68271,651.871262,733.355169,186.211433,8,0
0,0,45,45,21,46,67,238,161,399,0.000333,0.80679,30,72611.08761,4033.949312,2420.369587,346.322516,18,0
0,0,49,49,21,47,68,250,168,418,0.000333,0.848186,30,76336.78403,4240.932446,2544.559468,353.304342,19,0
0,0,51,51,21,47,68,256,170,426,0.000333,0.86442,30,77797.77511,4322.098617,2593.25917,353.304342,20,0
0,0,54,54,22,50,72,273,179,452,0.000333,0.929602,33,92030.60132,5112.811185,2788.806101,380.300305,21,0
0,0,39,39,22,50,72,195,127,322,0.000333,0.662239,22,43707.74871,2428.208262,1986.71585,380.300305,15,0
0,0,25,25,21,46,67,127,85,212,0.000333,0.42867,10,12860.10908,714.450505,1286.010908,346.322516,10,0
0,0,32,32,21,47,68,149,94,243,0.000333,0.493084,20,29585.06941,1643.614967,1479.25347,353.304342,13,0
0,0,34,34,21,47,68,155,96,251,0.000333,0.509318,20,30559.06346,1697.725748,1527.953173,353.304342,14,0
0,0,48,48,22,50,72,229,144,373,0.000333,0.767127,22,50630.40456,2812.800253,2301.382026,380.300305,18,0
0,0,33,33,17,24,41,151,92,243,0.000333,0.433962,24,31245.24329,1735.846849,1301.885137,179.525968,12,0
0,0,19,19,17,24,41,84,51,135,0.000333,0.24109,16,11572.31233,642.906241,723.269521,179.525968,7,0
0,0,16,16,15,23,38,71,48,119,0.000333,0.208168,14,8743.047237,485.724847,624.503374,162.645284,7,0
0,0,18,18,15,22,37,76,73,149,0.000333,0.258736,21,16300.37958,905.576643,776.208551,156.710855,6,0
0,0,12,12,12,17,29,40,52,92,0.000333,0.148978,18,8044.816528,446.934252,446.934252,112.506418,2,0
0,0,33,33,21,54,75,157,119,276,0.000333,0.573051,20,34383.07917,1910.171065,1719.153959,403.002591,10,0
0,0,32,32,21,54,75,156,117,273,0.000333,0.566823,20,34009.35005,1889.408336,1700.467503,403.002591,10,0
0,0,26,26,17,47,64,115,89,204,0.000333,0.408,8,9792,544,1224,330.552544,9,0
0,0,7,7,8,14,22,17,20,37,0.000333,0.055,4,659.99588,36.666438,164.99897,77.302969,1,0
0,0,16,16,15,23,38,65,56,121,0.000333,0.211666,14,8889.989208,493.888289,634.999229,162.645284,2,0
0,0,14,14,15,20,35,64,53,117,0.000333,0.200042,14,8401.765582,466.764755,600.126113,145.041921,6,0
0,0,8,8,12,15,27,28,28,56,0.000333,0.088758,6,1597.642201,88.7579,266.2737,101.622909,2,0
0,0,17,17,15,23,38,74,49,123,0.000333,0.215165,14,9036.931178,502.051732,645.495084,162.645284,8,0
0,0,12,12,15,19,34,59,42,101,0.000333,0.171278,14,7193.672458,399.64847,513.833747,139.313982,5,0
0,0,3,3,11,11,22,16,13,29,0.000333,0.043108,5,646.617585,35.923199,129.323517,76.107496,1,0
0,0,6,6,10,8,18,23,14,37,0.000333,0.051429,5,771.436125,42.857563,154.287225,57.219281,1,0
0,0,11,11,14,18,32,52,40,92,0.000333,0.153333,14,6440,357.777778,460,128.361619,5,0
0,0,15,15,15,21,36,75,47,122,0.000333,0.210244,14,8830.231902,490.568439,630.73085,150.842025,5,0
0,0,3,3,11,12,23,16,13,29,0.000333,0.043728,5,655.916484,36.439805,131.183297,81.073298,1,0
0,0,14,14,14,20,34,68,45,113,0.000333,0.191628,14,8048.366215,447.131456,574.883301,139.741531,5,0
0,0,3,3,11,12,23,16,13,29,0.000333,0.043728,5,655.916484,36.439805,131.183297,81.073298,1,0
0,0,14,14,14,20,34,68,45,113,0.000333,0.191628,14,8048.366215,447.131456,574.883301,139.741531,5,0
0,0,3,3,11,12,23,16,13,29,0.000333,0.043728,5,655.916484,36.439805,131.183297,81.073298,1,0
0,0,3,3,11,12,23,16,13,29,0.000333,0.043728,5,655.916484,36.439805,131.183297,81.073298,1,0
0,0,5,5,10,8,18,16,12,28,0.000333,0.038919,5,583.7895,32.43275,116.7579,57.219281,1,0
0,0,11,11,14,18,32,52,40,92,0.000333,0.153333,14,6440,357.777778,460,128.361619,5,0
0,0,3,3,11,13,24,17,14,31,0.000333,0.047378,5,710.669188,39.481622,142.133838,86.159464,1,0
0,0,3,3,11,13,24,17,14,31,0.000333,0.047378,5,710.669188,39.481622,142.133838,86.159464,1,0
0,0,11,11,14,18,32,52,40,92,0.000333,0.153333,14,6440,357.777778,460,128.361619,5,0
0,0,13,13,14,22,36,42,47,89,0.000333,0.153374,14,6441.726552,357.873697,460.123325,151.410465,2,0
0,0,11,11,14,18,32,52,40,92,0.000333,0.153333,14,6440,357.777778,460,128.361619,5,0
0,0,3,3,11,13,24,17,14,31,0.000333,0.047378,5,710.669188,39.481622,142.133838,86.159464,1,0
0,0,3,3,11,13,24,17,14,31,0.000333,0.047378,5,710.669188,39.481622,142.133838,86.159464,1,0
0,0,11,11,14,18,32,52,40,92,0.000333,0.153333,14,6440,357.777778,460,128.361619,5,0
0,0,19,19,13,20,33,60,72,132,0.000333,0.221953,18,11985.48043,665.860024,665.860024,134.544278,2,0
0,0,18,18,13,20,33,58,70,128,0.000333,0.215227,18,11622.28405,645.682447,645.682447,134.544278,2,0
0,0,8,8,11,13,24,24,23,47,0.000333,0.071831,5,1077.466188,59.859233,215.493238,86.159464,2,0
0,0,7,7,10,13,23,22,21,43,0.000333,0.064838,5,972.565821,54.031434,194.513164,81.324997,2,0
0,0,8,8,11,13,24,23,25,48,0.000333,0.073359,5,1100.391,61.132833,220.0782,86.159464,2,0
0,0,7,7,10,13,23,21,23,44,0.000333,0.066346,5,995.18363,55.287979,199.036726,81.324997,2,0
0,0,15,15,13,18,31,48,52,100,0.000333,0.16514,12,5945.035572,330.279754,495.419631,123.164366,2,0
0,0,14,14,13,18,31,46,50,96,0.000333,0.158534,12,5707.23415,317.068564,475.602846,123.164366,2,0
0,0,15,15,13,19,32,53,49,102,0.000333,0.17,12,6120,340,510,128.816339,2,0
0,0,14,14,13,19,32,51,47,98,0.000333,0.163333,12,5880,326.666667,490,128.816339,2,0
0,0,11,11,11,16,27,34,33,67,0.000333,0.106192,10,3185.774626,176.987479,318.577463,102.053748,2,0
0,0,11,11,12,19,31,43,36,79,0.000333,0.130461,6,2348.289051,130.460503,391.381509,123.730173,2,0
0,0,17,17,14,23,37,68,58,126,0.000333,0.218797,14,9189.475737,510.52643,656.391124,157.344894,2,0
0,0,15,15,15,20,35,75,46,121,0.000333,0.206881,14,8689.005431,482.722524,620.643245,145.041921,5,0
0,0,6,6,10,8,18,23,14,37,0.000333,0.051429,5,771.436125,42.857563,154.287225,57.219281,1,0
0,0,18,18,15,25,40,76,66,142,0.000333,0.251905,14,10579.99305,587.777392,755.713789,174.699764,6,0
0,0,12,12,12,20,32,40,41,81,0.000333,0.135,12,4860,270,405,129.458112,2,0
0,0,8,8,9,13,22,22,26,48,0.000333,0.071351,8,1712.421742,95.134541,214.052718,76.635041,1,0
0,0,9,9,12,15,27,26,25,51,0.000333,0.080833,6,1454.995576,80.833088,242.499263,101.622909,2,0
0,0,10,10,11,13,24,29,29,58,0.000333,0.088643,10,2659.27825,147.737681,265.927825,86.159464,2,0
0,0,9,9,13,14,27,27,24,51,0.000333,0.080833,6,1454.995576,80.833088,242.499263,101.408685,2,0
0,0,14,14,14,19,33,68,44,112,0.000333,0.188324,14,7909.609979,439.422777,564.972141,134.013592,5,0
0,0,5,5,10,8,18,16,12,28,0.000333,0.038919,5,583.7895,32.43275,116.7579,57.219281,1,0
0,0,3,3,12,16,28,20,19,39,0.000333,0.062496,6,1124.921052,62.495614,187.486842,107.01955,1,0
0,0,15,15,15,20,35,73,56,129,0.000333,0.220559,14,9263.485129,514.638063,661.677509,145.041921,5,0
0,0,9,9,11,14,25,37,31,68,0.000333,0.105261,10,3157.822209,175.434567,315.782221,91.356717,1,0
0,0,20,20,14,24,38,82,77,159,0.000333,0.27814,21,17522.82997,973.490554,834.420475,163.342069,6,0
0,0,14,14,12,19,31,46,56,102,0.000333,0.168443,12,6063.936284,336.885349,505.328024,123.730173,2,0
0,0,10,10,12,18,30,40,41,81,0.000333,0.132486,12,4769.497659,264.972092,397.458138,118.0782,3,0
0,0,3,3,10,15,25,18,18,36,0.000333,0.055726,5,835.894114,46.438562,167.178823,91.82264,1,0
0,0,7,7,10,13,23,22,26,48,0.000333,0.072377,10,2171.309739,120.628319,217.130974,81.324997,1,0
0,0,6,6,12,11,23,22,16,38,0.000333,0.057298,6,1031.372126,57.298451,171.895354,81.073298,2,0
0,0,6,6,12,11,23,22,16,38,0.000333,0.057298,6,1031.372126,57.298451,171.895354,81.073298,2,0
0,0,16,16,12,21,33,58,77,135,0.000333,0.226998,18,12257.87771,680.993206,680.993206,135.258216,3,0
0,0,13,13,10,16,26,40,68,108,0.000333,0.169216,20,10152.94979,564.052766,507.64749,97.219281,1,0
0,0,3,3,10,16,26,18,18,36,0.000333,0.056405,5,846.079149,47.004397,169.21583,97.219281,1,0
0,0,9,9,12,18,30,37,31,68,0.000333,0.111223,6,2002.011363,111.222854,333.668561,118.0782,3,0
0,0,3,3,11,13,24,19,15,34,0.000333,0.051963,5,779.443625,43.302424,155.888725,86.159464,1,0
0,0,6,6,10,9,19,19,14,33,0.000333,0.046727,5,700.90804,38.939336,140.181608,61.748606,1,0
0,0,11,11,13,18,31,44,43,87,0.000333,0.143672,12,5172.180948,287.343386,431.015079,123.164366,3,0
0,0,3,3,11,12,23,16,13,29,0.000333,0.043728,5,655.916484,36.439805,131.183297,81.073298,1,0
0,0,8,8,11,13,24,26,28,54,0.000333,0.082529,10,2475.87975,137.548875,247.587975,86.159464,1,0
0,0,26,26,19,45,64,114,87,201,0.000333,0.402,9,10854,603,1206,327.844012,9,0
0,0,14,14,17,24,41,59,45,104,0.000333,0.185728,8,4457.483268,247.637959,557.185408,179.525968,4,0
0,0,15,15,17,24,41,60,47,107,0.000333,0.191086,8,4586.064516,254.781362,573.258064,179.525968,4,0
0,0,14,14,20,26,46,62,49,111,0.000333,0.204372,10,6131.153771,340.619654,613.115377,208.649995,5,0
0,0,15,15,20,26,46,63,51,114,0.000333,0.209895,10,6296.86063,349.825591,629.686063,208.649995,5,0
0,0,8,8,12,17,29,30,35,65,0.000333,0.105256,12,3789.225176,210.51251,315.768765,112.506418,2,0
0,0,8,8,13,18,31,31,41,72,0.000333,0.118901,12,4280.425612,237.801423,356.702134,123.164366,2,0
0,0,9,9,12,18,30,37,31,68,0.000333,0.111223,6,2002.011363,111.222854,333.668561,118.0782,3,0
0,0,11,11,14,18,32,45,37,82,0.000333,0.136667,14,5740,318.888889,410,128.361619,3,0
0,0,18,18,18,40,58,91,69,160,0.000333,0.312426,9,8435.492633,468.63848,937.276959,287.935774,7,0
0,0,27,27,18,48,66,121,97,218,0.000333,0.439226,18,23718.20252,1317.677918,1317.677918,343.13685,9,0
0,0,26,26,18,48,66,120,95,215,0.000333,0.433182,9,11695.90262,649.772368,1299.544736,343.13685,9,0
0,0,26,26,17,47,64,115,89,204,0.000333,0.408,8,9792,544,1224,330.552544,9,0
0,0,7,7,9,14,23,18,21,39,0.000333,0.058806,4,705.675665,39.204204,176.418916,81.832294,1,0
0,0,10,10,10,15,25,30,35,65,0.000333,0.100617,10,3018.506523,167.694807,301.850652,91.82264,1,0
0,0,8,8,12,13,25,28,20,48,0.000333,0.074302,6,1337.430583,74.301699,222.905097,91.125266,2,0
0,0,9,9,12,13,25,35,22,57,0.000333,0.088233,6,1588.198817,88.233268,264.699803,91.125266,2,0
0,0,8,8,12,13,25,28,20,48,0.000333,0.074302,6,1337.430583,74.301699,222.905097,91.125266,2,0
0,0,8,8,12,13,25,28,20,48,0.000333,0.074302,6,1337.430583,74.301699,222.905097,91.125266,2,0
0,0,11,11,14,18,32,52,40,92,0.000333,0.153333,14,6440,357.777778,460,128.361619,5,0
0,0,11,11,14,18,32,52,40,92,0.000333,0.153333,14,6440,357.777778,460,128.361619,5,0
0,0,3,3,11,12,23,17,14,31,0.000333,0.046743,5,701.152103,38.952895,140.230421,81.073298,1,0
0,0,3,3,11,12,23,17,14,31,0.000333,0.046743,5,701.152103,38.952895,140.230421,81.073298,1,0
0,0,16,16,13,21,34,49,53,102,0.000333,0.172974,12,6227.054518,345.947473,518.92121,140.344382,2,0
0,0,11,11,13,19,32,39,38,77,0.000333,0.128333,12,4620,256.666667,385,128.816339,2,0
0,0,11,11,12,17,29,33,36,69,0.000333,0.111734,12,4022.408264,223.467126,335.200689,112.506418,2,0
0,0,17,17,14,24,38,53,57,110,0.000333,0.192424,14,8081.808371,448.989354,577.272026,163.342069,2,0
0,0,11,11,13,20,33,39,39,78,0.000333,0.131154,6,2360.776448,131.154247,393.462741,134.544278,2,0
0,0,11,11,13,19,32,34,37,71,0.000333,0.118333,6,2130,118.333333,355,128.816339,2,0
0,0,17,17,15,21,36,54,51,105,0.000333,0.180947,14,7599.789752,422.210542,542.842125,150.842025,2,0
0,0,11,11,13,19,32,36,36,72,0.000333,0.12,6,2160,120,360,128.816339,2,0
0,0,12,12,14,17,31,38,34,72,0.000333,0.118901,14,4993.829881,277.434993,356.702134,122.789837,2,0
0,0,18,18,15,21,36,58,55,113,0.000333,0.194734,14,8178.821352,454.378964,584.201525,150.842025,2,0
0,0,11,11,14,18,32,37,35,72,0.000333,0.12,7,2520,140,360,128.361619,2,0
0,0,13,13,14,17,31,42,38,80,0.000333,0.132112,14,5548.699868,308.261104,396.335705,122.789837,2,0
0,0,3,3,12,18,30,21,20,41,0.000333,0.067061,6,1207.095087,67.060838,201.182514,118.0782,1,0
0,0,14,14,14,20,34,68,45,113,0.000333,0.191628,14,8048.366215,447.131456,574.883301,139.741531,5,0
0,0,14,14,14,21,35,47,55,102,0.000333,0.174396,14,7324.616148,406.923119,523.186868,145.541635,2,0
0,0,34,34,20,58,78,155,121,276,0.000333,0.578257,20,34695.42025,1927.523347,1734.771012,426.20146,11,0
0,0,33,33,20,58,78,154,119,273,0.000333,0.571972,20,34318.29612,1906.572006,1715.914806,426.20146,11,0
0,0,34,34,23,61,84,158,124,282,0.000333,0.600878,22,39657.93729,2203.218738,1802.633513,465.816903,12,0
0,0,33,33,23,61,84,157,122,279,0.000333,0.594486,22,39236.04434,2179.780241,1783.456561,465.816903,12,0
0,0,34,34,20,57,77,162,119,281,0.000333,0.586989,20,35219.34036,1956.63002,1760.967018,418.913293,11,0
0,0,33,33,20,57,77,161,117,278,0.000333,0.580722,20,34843.33317,1935.740731,1742.166658,418.913293,11,0
0,0,34,34,23,60,83,165,122,287,0.000333,0.609879,22,40251.99897,2236.222165,1829.636317,458.455361,12,0
0,0,33,33,23,60,83,164,120,284,0.000333,0.603504,22,39831.24637,2212.84702,1810.511199,458.455361,12,0
0,0,26,26,18,46,64,114,93,207,0.000333,0.414,18,22356,1242,1242,329.1425,9,0
0,0,22,22,18,44,62,107,80,187,0.000333,0.371145,9,10020.91239,556.717355,1113.43471,315.273641,9,0
0,0,26,26,19,48,67,115,94,209,0.000333,0.422604,9,11410.31377,633.90632,1267.812641,348.788823,9,0
0,0,22,22,18,45,63,107,81,188,0.000333,0.374576,9,10113.55763,561.864313,1123.728626,322.192039,9,0
0,0,12,12,13,25,38,50,41,91,0.000333,0.159187,6,2865.368422,159.187135,477.561404,164.202121,7,0
0,0,12,12,14,22,36,52,38,90,0.000333,0.155098,7,3257.052751,180.947375,465.29325,151.410465,7,0
0,0,9,9,13,21,34,45,32,77,0.000333,0.130578,6,2350.407833,130.578213,391.734639,140.344382,6,0
0,0,12,12,14,22,36,51,38,89,0.000333,0.153374,7,3220.863276,178.936849,460.123325,151.410465,7,0
0,0,9,9,13,21,34,44,32,76,0.000333,0.128882,6,2319.883056,128.882392,386.647176,140.344382,6,0
0,0,12,12,14,24,38,50,40,90,0.000333,0.157438,7,3306.194333,183.677463,472.313476,163.342069,7,0
0,0,12,12,15,21,36,51,37,88,0.000333,0.151651,7,3184.673801,176.926322,454.9534,150.842025,7,0
0,0,9,9,14,20,34,44,31,75,0.000333,0.127187,7,2670.917992,148.384333,381.559713,139.741531,6,0
0,0,12,12,15,21,36,51,37,88,0.000333,0.151651,7,3184.673801,176.926322,454.9534,150.842025,7,0
0,0,9,9,14,20,34,44,31,75,0.000333,0.127187,7,2670.917992,148.384333,381.559713,139.741531,6,0
0,0,12,12,14,23,37,50,40,90,0.000333,0.156284,7,3281.95562,182.330868,468.850803,157.344894,7,0
0,0,12,12,15,20,35,51,37,88,0.000333,0.150459,7,3159.638338,175.535463,451.376905,145.041921,7,0
0,0,9,9,14,19,33,44,31,75,0.000333,0.12611,7,2648.306913,147.128162,378.329559,134.013592,6,0
0,0,13,13,16,25,41,56,46,102,0.000333,0.182157,8,4371.762436,242.875691,546.470304,180.096405,7,0
0,0,13,13,17,22,39,57,43,100,0.000333,0.17618,8,4228.321775,234.906765,528.540222,167.594364,7,0
0,0,10,10,16,21,37,50,37,87,0.000333,0.151074,8,3625.779542,201.432197,453.222443,156.238666,6,0
0,0,3,3,11,11,22,16,13,29,0.000333,0.043108,5,646.617585,35.923199,129.323517,76.107496,1,0
0,0,3,3,11,11,22,16,13,29,0.000333,0.043108,5,646.617585,35.923199,129.323517,76.107496,1,0
0,0,11,11,14,18,32,52,40,92,0.000333,0.153333,14,6440,357.777778,460,128.361619,5,0
0,0,5,5,10,8,18,16,12,28,0.000333,0.038919,5,583.7895,32.43275,116.7579,57.219281,1,0
0,0,14,14,10,19,29,44,71,115,0.000333,0.186223,15,8380.017217,465.556512,558.667814,113.929904,1,0
0,0,13,13,10,16,26,40,68,108,0.000333,0.169216,20,10152.94979,564.052766,507.64749,97.219281,1,0
0,0,12,12,10,18,28,38,59,97,0.000333,0.155438,15,6994.701412,388.594523,466.313427,108.277931,1,0
0,0,11,11,10,15,25,34,54,88,0.000333,0.13622,15,6129.890171,340.549454,408.659345,91.82264,1,0
0,0,9,9,12,15,27,30,28,58,0.000333,0.091928,6,1654.700851,91.927825,275.783475,101.622909,2,0
0,0,8,8,11,15,26,28,26,54,0.000333,0.084608,5,1269.118724,70.506596,253.823745,96.657107,2,0
0,0,15,15,18,21,39,62,54,116,0.000333,0.204369,18,11035.91983,613.106657,613.106657,167.297316,2,0
0,0,14,14,18,21,39,60,52,112,0.000333,0.197322,18,10655.37087,591.965049,591.965049,167.297316,2,0
0,0,20,20,18,23,41,74,81,155,0.000333,0.276807,27,22421.35514,1245.630841,830.420561,179.100575,2,0
0,0,19,19,18,23,41,72,79,151,0.000333,0.269663,27,21842.73952,1213.485529,808.990353,179.100575,2,0
0,0,16,16,18,22,40,67,58,125,0.000333,0.221747,18,11974.33821,665.241012,665.241012,173.166146,2,0
0,0,15,15,18,22,40,65,56,121,0.000333,0.214651,18,11591.15939,643.953299,643.953299,173.166146,2,0
0,0,12,12,12,19,31,40,38,78,0.000333,0.128809,12,4637.127747,257.618208,386.427312,123.730173,2,0
0,0,12,12,13,22,35,49,41,90,0.000333,0.153878,6,2769.812829,153.878491,461.635472,146.213212,2,0
0,0,18,18,19,27,46,82,67,149,0.000333,0.274337,18,14814.19317,823.010731,823.010731,209.092585,2,0
0,0,16,16,14,21,35,74,51,125,0.000333,0.21372,14,8976.24528,498.680293,641.160377,145.541635,5,0
0,0,3,3,11,11,22,16,13,29,0.000333,0.043108,5,646.617585,35.923199,129.323517,76.107496,1,0
0,0,7,7,10,9,19,22,18,40,0.000333,0.056639,10,1699.171005,94.398389,169.917101,61.748606,1,0
0,0,14,14,14,20,34,68,45,113,0.000333,0.191628,14,8048.366215,447.131456,574.883301,139.741531,5,0
0,0,3,3,11,12,23,17,14,31,0.000333,0.046743,5,701.152103,38.952895,140.230421,81.073298,1,0
0,0,5,5,10,8,18,16,12,28,0.000333,0.038919,5,583.7895,32.43275,116.7579,57.219281,1,0
0,0,3,3,11,12,23,17,14,31,0.000333,0.046743,5,701.152103,38.952895,140.230421,81.073298,1,0
0,0,5,5,10,8,18,16,12,28,0.000333,0.038919,5,583.7895,32.43275,116.7579,57.219281,1,0
0,0,7,7,12,11,23,29,18,47,0.000333,0.070869,6,1275.644472,70.869137,212.607412,81.073298,2,0
0,0,6,6,12,11,23,22,16,38,0.000333,0.057298,6,1031.372126,57.298451,171.895354,81.073298,2,0
0,0,6,6,12,11,23,22,16,38,0.000333,0.057298,6,1031.372126,57.298451,171.895354,81.073298,2,0
0,0,12,12,13,25,38,50,41,91,0.000333,0.159187,6,2865.368422,159.187135,477.561404,164.202121,7,0
0,0,12,12,14,22,36,52,38,90,0.000333,0.155098,7,3257.052751,180.947375,465.29325,151.410465,7,0
0,0,9,9,13,21,34,45,32,77,0.000333,0.130578,6,2350.407833,130.578213,391.734639,140.344382,6,0
0,0,12,12,14,22,36,51,38,89,0.000333,0.153374,7,3220.863276,178.936849,460.123325,151.410465,7,0
0,0,9,9,13,21,34,44,32,76,0.000333,0.128882,6,2319.883056,128.882392,386.647176,140.344382,6,0
0,0,13,13,14,19,33,58,46,104,0.000333,0.174872,14,7344.637838,408.035435,524.616988,134.013592,5,0
0,0,3,3,11,12,23,16,13,29,0.000333,0.043728,5,655.916484,36.439805,131.183297,81.073298,1,0
0,0,7,7,10,9,19,22,18,40,0.000333,0.056639,10,1699.171005,94.398389,169.917101,61.748606,1,0
0,0,13,13,15,21,36,59,47,106,0.000333,0.182671,14,7672.168702,426.231595,548.01205,150.842025,5,0
0,0,3,3,11,12,23,16,13,29,0.000333,0.043728,5,655.916484,36.439805,131.183297,81.073298,1,0
0,0,7,7,10,11,21,23,19,42,0.000333,0.061492,5,922.386659,51.243703,184.477332,71.273029,1,0
0,0,13,13,14,19,33,58,52,110,0.000333,0.184961,14,7768.366944,431.575941,554.883353,134.013592,5,0
0,0,3,3,10,16,26,18,18,36,0.000333,0.056405,5,846.079149,47.004397,169.21583,97.219281,1,0
0,0,7,7,10,13,23,22,26,48,0.000333,0.072377,10,2171.309739,120.628319,217.130974,81.324997,1,0
0,0,12,12,14,19,33,55,42,97,0.000333,0.163102,14,6850.287214,380.571512,489.30623,134.013592,5,0
0,0,6,6,10,9,19,19,14,33,0.000333,0.046727,5,700.90804,38.939336,140.181608,61.748606,1,0
0,0,3,3,11,12,23,16,13,29,0.000333,0.043728,5,655.916484,36.439805,131.183297,81.073298,1,0
0,0,16,16,17,22,39,70,58,128,0.000333,0.22551,16,10824.50374,601.361319,676.531484,167.594364,2,0
0,0,15,15,17,22,39,68,56,124,0.000333,0.218463,16,10486.238,582.568778,655.389875,167.594364,2,0
0,0,16,16,17,21,38,61,61,122,0.000333,0.213416,16,10243.95451,569.108584,640.247157,161.725534,2,0
0,0,15,15,17,21,38,59,59,118,0.000333,0.206418,16,9908.087145,550.449286,619.255447,161.725534,2,0
0,0,22,22,19,45,64,102,85,187,0.000333,0.374,9,10098,561,1122,327.844012,7,0
0,0,22,22,20,46,66,103,91,194,0.000333,0.390871,10,11726.12459,651.451366,1172.612459,340.522412,7,0
0,0,13,13,17,26,43,63,44,107,0.000333,0.193537,8,4644.88263,258.049035,580.610329,191.698301,6,0
0,0,14,14,17,27,44,64,46,110,0.000333,0.200179,8,4804.299824,266.905546,600.537478,197.868831,6,0
0,0,13,13,17,26,43,63,44,107,0.000333,0.193537,8,4644.88263,258.049035,580.610329,191.698301,6,0
0,0,14,14,17,27,44,64,46,110,0.000333,0.200179,8,4804.299824,266.905546,600.537478,197.868831,6,0
0,0,13,13,17,26,43,63,44,107,0.000333,0.193537,8,4644.88263,258.049035,580.610329,191.698301,6,0
0,0,14,14,17,27,44,64,46,110,0.000333,0.200179,8,4804.299824,266.905546,600.537478,197.868831,6,0
0,0,13,13,17,26,43,63,44,107,0.000333,0.193537,8,4644.88263,258.049035,580.610329,191.698301,6,0
0,0,14,14,17,27,44,64,46,110,0.000333,0.200179,8,4804.299824,266.905546,600.537478,197.868831,6,0
0,0,23,23,18,28,46,113,73,186,0.000333,0.342461,18,18492.88543,1027.382524,1027.382524,209.664588,9,0
0,0,23,23,18,28,46,113,73,186,0.000333,0.342461,18,18492.88543,1027.382524,1027.382524,209.664588,9,0
0,0,24,24,18,29,47,114,75,189,0.000333,0.349939,18,18896.71127,1049.817293,1049.817293,215.940099,9,0
0,0,24,24,18,29,47,114,75,189,0.000333,0.349939,18,18896.71127,1049.817293,1049.817293,215.940099,9,0
0,0,15,15,14,21,35,70,50,120,0.000333,0.205171,14,8617.195468,478.733082,615.513962,145.541635,5,0
0,0,6,6,10,13,23,18,18,36,0.000333,0.054283,5,814.241152,45.23562,162.84823,81.324997,1,0
0,0,15,15,14,21,35,71,47,118,0.000333,0.201752,14,8473.575544,470.754197,605.255396,145.541635,5,0
0,0,6,6,10,9,19,19,14,33,0.000333,0.046727,5,700.90804,38.939336,140.181608,61.748606,1,0
0,0,16,16,15,23,38,75,52,127,0.000333,0.222162,14,9330.815119,518.378618,666.486794,162.645284,5,0
0,0,7,7,10,11,21,23,19,42,0.000333,0.061492,5,922.386659,51.243703,184.477332,71.273029,1,0
0,0,14,14,14,20,34,68,45,113,0.000333,0.191628,14,8048.366215,447.131456,574.883301,139.741531,5,0
0,0,14,14,14,20,34,68,45,113,0.000333,0.191628,14,8048.366215,447.131456,574.883301,139.741531,5,0
0,0,8,8,12,13,25,28,20,48,0.000333,0.074302,6,1337.430583,74.301699,222.905097,91.125266,2,0
0,0,14,14,14,19,33,68,44,112,0.000333,0.188324,14,7909.609979,439.422777,564.972141,134.013592,5,0
0,0,9,9,11,15,26,28,30,58,0.000333,0.090875,10,2726.255037,151.458613,272.625504,96.657107,2,0
0,0,8,8,10,15,25,26,28,54,0.000333,0.083589,5,1253.841171,69.657843,250.768234,91.82264,2,0
0,0,15,15,13,21,34,47,64,111,0.000333,0.188236,18,10164.75076,564.708375,564.708375,140.344382,2,0
0,0,17,17,13,22,35,53,77,130,0.000333,0.222269,18,12002.52226,666.806792,666.806792,146.213212,2,0
0,0,15,15,13,22,35,52,59,111,0.000333,0.189783,12,6832.204979,379.566943,569.350415,146.213212,2,0
0,0,11,11,11,19,30,33,40,73,0.000333,0.119401,10,3582.030135,199.001674,358.203013,118.764371,2,0
0,0,11,11,12,22,34,42,44,86,0.000333,0.145841,12,5250.261652,291.681203,437.521804,141.127046,2,0
0,0,17,17,14,26,40,67,70,137,0.000333,0.243035,14,10207.45809,567.081005,729.104149,175.514402,2,0
0,0,15,15,14,21,35,70,50,120,0.000333,0.205171,14,8617.195468,478.733082,615.513962,145.541635,5,0
0,0,6,6,10,13,23,18,18,36,0.000333,0.054283,5,814.241152,45.23562,162.84823,81.324997,1,0
0,0,12,12,14,19,33,55,42,97,0.000333,0.163102,14,6850.287214,380.571512,489.30623,134.013592,5,0
0,0,15,15,14,20,34,64,64,128,0.000333,0.217065,21,13675.10012,759.727784,651.195244,139.741531,5,0
0,0,9,9,10,14,24,28,40,68,0.000333,0.103926,10,3117.7745,173.209694,311.77745,86.52225,1,0
0,0,32,32,21,54,75,152,115,267,0.000333,0.554365,20,33261.89181,1847.882878,1663.09459,403.002591,10,0
0,0,31,31,21,54,75,151,113,264,0.000333,0.548136,20,32888.16269,1827.120149,1644.408134,403.002591,10,0
0,0,18,18,14,22,36,80,69,149,0.000333,0.256773,21,16176.69533,898.705296,770.318825,151.410465,5,0
0,0,9,9,10,14,24,28,40,68,0.000333,0.103926,10,3117.7745,173.209694,311.77745,86.52225,1,0
0,0,3,3,10,17,27,19,19,38,0.000333,0.060229,5,903.428625,50.190479,180.685725,102.706149,1,0
0,0,17,17,15,22,37,80,60,140,0.000333,0.243108,14,10210.5286,567.251589,729.323471,156.710855,5,0
0,0,8,8,11,14,25,28,29,57,0.000333,0.088233,10,2646.998028,147.055446,264.699803,91.356717,1,0
0,0,11,11,14,18,32,52,40,92,0.000333,0.153333,14,6440,357.777778,460,128.361619,5,0
0,0,20,20,14,23,37,86,81,167,0.000333,0.289993,21,18269.55295,1014.975164,869.978712,157.344894,5,0
0,0,11,11,10,15,25,34,54,88,0.000333,0.13622,15,6129.890171,340.549454,408.659345,91.82264,1,0
0,0,3,3,10,17,27,19,19,38,0.000333,0.060229,5,903.428625,50.190479,180.685725,102.706149,1,0
0,0,15,15,14,21,35,71,47,118,0.000333,0.201752,14,8473.575544,470.754197,605.255396,145.541635,5,0
0,0,3,3,11,14,25,20,16,36,0.000333,0.055726,5,835.894114,46.438562,167.178823,91.356717,1,0
0,0,16,16,15,23,38,75,52,127,0.000333,0.222162,14,9330.815119,518.378618,666.486794,162.645284,5,0
0,0,3,3,11,13,24,17,14,31,0.000333,0.047378,5,710.669188,39.481622,142.133838,86.159464,1,0
0,0,31,31,23,55,78,150,105,255,0.000333,0.534259,11,17630.55322,979.475179,1602.777566,422.016709,12,0
0,0,30,30,23,54,77,149,103,252,0.000333,0.52641,11,17371.53229,965.085127,1579.230208,414.80585,12,0
0,0,10,10,15,16,31,44,30,74,0.000333,0.122204,7,2566.273689,142.57076,366.610527,122.603359,4,0
0,0,8,8,12,17,29,34,29,63,0.000333,0.102018,6,1836.316816,102.017601,306.052803,112.506418,3,0
0,0,8,8,12,17,29,34,29,63,0.000333,0.102018,6,1836.316816,102.017601,306.052803,112.506418,3,0
0,0,3,3,11,12,23,16,13,29,0.000333,0.043728,5,655.916484,36.439805,131.183297,81.073298,1,0
0,0,26,26,22,30,52,107,91,198,0.000333,0.376229,33,37246.67312,2069.259618,1128.687064,245.314213,8,0
0,0,16,16,20,26,46,56,63,119,0.000333,0.219101,20,13146.07746,730.337636,657.303873,208.649995,3,0
0,0,11,11,16,19,35,50,35,85,0.000333,0.14533,8,3487.912452,193.772914,435.989056,144.710623,4,0
0,0,11,11,14,18,32,52,40,92,0.000333,0.153333,14,6440,357.777778,460,128.361619,5,0
0,0,5,5,10,8,18,16,12,28,0.000333,0.038919,5,583.7895,32.43275,116.7579,57.219281,1,0
0,0,15,15,14,21,35,71,47,118,0.000333,0.201752,14,8473.575544,470.754197,605.255396,145.541635,5,0
0,0,6,6,10,10,20,19,15,34,0.000333,0.048982,5,734.727776,40.81821,146.945555,66.438562,1,0
0,0,14,14,14,20,34,68,45,113,0.000333,0.191628,14,8048.366215,447.131456,574.883301,139.741531,5,0
0,0,3,3,11,13,24,17,14,31,0.000333,0.047378,5,710.669188,39.481622,142.133838,86.159464,1,0
0,0,5,5,10,8,18,16,12,28,0.000333,0.038919,5,583.7895,32.43275,116.7579,57.219281,1,0
0,0,3,3,11,13,24,17,14,31,0.000333,0.047378,5,710.669188,39.481622,142.133838,86.159464,1,0
0,0,5,5,10,8,18,16,12,28,0.000333,0.038919,5,583.7895,32.43275,116.7579,57.219281,1,0
0,0,15,15,14,21,35,70,49,119,0.000333,0.203462,14,8545.385506,474.743639,610.384679,145.541635,5,0
0,0,6,6,10,13,23,18,18,36,0.000333,0.054283,5,814.241152,45.23562,162.84823,81.324997,1,0
0,0,15,15,12,19,31,52,49,101,0.000333,0.166791,12,6004.485928,333.582552,500.373827,123.730173,2,0
0,0,14,14,12,19,31,50,47,97,0.000333,0.160186,12,5766.684505,320.371361,480.557042,123.730173,2,0
0,0,11,11,10,16,26,33,33,66,0.000333,0.10341,10,3102.290214,172.349456,310.229021,97.219281,2,0
0,0,11,11,12,19,31,43,36,79,0.000333,0.130461,6,2348.289051,130.460503,391.381509,123.730173,2,0
0,0,17,17,14,23,37,68,58,126,0.000333,0.218797,14,9189.475737,510.52643,656.391124,157.344894,2,0
0,0,19,19,12,20,32,59,72,131,0.000333,0.218333,18,11790,655,655,129.458112,2,0
0,0,18,18,12,20,32,57,70,127,0.000333,0.211667,18,11430,635,635,129.458112,2,0
0,0,8,8,10,13,23,23,23,46,0.000333,0.069361,5,1040.41925,57.801069,208.08385,81.324997,2,0
0,0,7,7,9,13,22,21,21,42,0.000333,0.062432,4,749.184512,41.621362,187.296128,76.635041,2,0
0,0,8,8,12,17,29,34,29,63,0.000333,0.102018,6,1836.316816,102.017601,306.052803,112.506418,3,0
0,0,3,3,11,13,24,17,14,31,0.000333,0.047378,5,710.669188,39.481622,142.133838,86.159464,1,0
0,0,8,8,12,17,29,34,29,63,0.000333,0.102018,6,1836.316816,102.017601,306.052803,112.506418,3,0
0,0,3,3,11,12,23,17,14,31,0.000333,0.046743,5,701.152103,38.952895,140.230421,81.073298,1,0
0,0,3,3,11,12,23,17,14,31,0.000333,0.046743,5,701.152103,38.952895,140.230421,81.073298,1,0
0,0,14,14,14,20,34,68,45,113,0.000333,0.191628,14,8048.366215,447.131456,574.883301,139.741531,5,0
0,0,14,14,14,20,34,68,45,113,0.000333,0.191628,14,8048.366215,447.131456,574.883301,139.741531,5,0
0,0,3,3,12,14,26,18,21,39,0.000333,0.061106,6,1099.902894,61.105716,183.317149,96.322519,1,0
0,0,22,22,14,24,38,92,93,185,0.000333,0.323622,21,20388.19839,1132.677688,970.86659,163.342069,5,0
0,0,13,13,10,16,26,40,68,108,0.000333,0.169216,20,10152.94979,564.052766,507.64749,97.219281,1,0
0,0,12,12,13,16,29,41,34,75,0.000333,0.12145,12,4372.182896,242.89905,364.348575,112.105716,2,0
0,0,9,9,13,15,28,34,27,61,0.000333,0.09775,6,1759.491901,97.74955,293.24865,106.709075,2,0
0,0,9,9,12,14,26,27,24,51,0.000333,0.079907,6,1438.334554,79.907475,239.722426,96.322519,2,0
0,0,14,14,14,17,31,49,36,85,0.000333,0.140369,14,5895.493609,327.527423,421.106686,122.789837,3,0
0,0,14,14,14,17,31,49,36,85,0.000333,0.140369,14,5895.493609,327.527423,421.106686,122.789837,3,0
0,0,23,23,19,47,66,120,88,208,0.000333,0.419078,9,11315.10579,628.616988,1257.233977,341.776299,7,0
0,0,8,8,9,16,25,22,25,47,0.000333,0.072754,4,873.044964,48.502498,218.261241,92.529325,1,0
0,0,23,23,20,49,69,121,88,209,0.000333,0.425561,10,12766.81612,709.267562,1276.681611,361.559344,7,0
0,0,25,25,19,47,66,130,98,228,0.000333,0.459374,18,24806.19347,1378.121859,1378.121859,341.776299,7,0
0,0,10,10,9,16,25,32,36,68,0.000333,0.105261,8,2526.257767,140.347654,315.782221,92.529325,1,0
0,0,25,25,20,49,69,131,99,230,0.000333,0.46832,20,28099.2125,1561.067361,1404.960625,361.559344,7,0
0,0,12,12,13,16,29,41,34,75,0.000333,0.12145,12,4372.182896,242.89905,364.348575,112.105716,2,0
0,0,9,9,13,15,28,34,27,61,0.000333,0.09775,6,1759.491901,97.74955,293.24865,106.709075,2,0
0,0,9,9,12,14,26,27,24,51,0.000333,0.079907,6,1438.334554,79.907475,239.722426,96.322519,2,0
0,0,16,16,15,18,33,54,39,93,0.000333,0.156376,14,6567.801143,364.877841,469.128653,133.662009,3,0
0,0,9,9,14,14,28,35,26,61,0.000333,0.09775,7,2052.740552,114.041142,293.24865,106.605938,2,0
0,0,10,10,13,14,27,32,25,57,0.000333,0.090343,6,1626.171526,90.342863,271.028588,101.408685,2,0
0,0,16,16,15,18,33,54,39,93,0.000333,0.156376,14,6567.801143,364.877841,469.128653,133.662009,3,0
0,0,9,9,14,14,28,35,26,61,0.000333,0.09775,7,2052.740552,114.041142,293.24865,106.605938,2,0
0,0,10,10,13,14,27,32,25,57,0.000333,0.090343,6,1626.171526,90.342863,271.028588,101.408685,2,0
0,0,12,12,16,19,35,61,43,104,0.000333,0.177815,16,8535.12694,474.173719,533.445434,144.710623,6,0
0,0,12,12,17,18,35,62,42,104,0.000333,0.177815,16,8535.12694,474.173719,533.445434,144.545518,6,0
0,0,6,6,12,11,23,22,16,38,0.000333,0.057298,6,1031.372126,57.298451,171.895354,81.073298,2,0
0,0,12,12,16,19,35,61,43,104,0.000333,0.177815,16,8535.12694,474.173719,533.445434,144.710623,6,0
0,0,12,12,17,18,35,62,42,104,0.000333,0.177815,16,8535.12694,474.173719,533.445434,144.545518,6,0
0,0,12,12,17,18,35,62,42,104,0.000333,0.177815,16,8535.12694,474.173719,533.445434,144.545518,6,0
0,0,6,6,12,11,23,22,16,38,0.000333,0.057298,6,1031.372126,57.298451,171.895354,81.073298,2,0
0,0,6,6,12,11,23,22,16,38,0.000333,0.057298,6,1031.372126,57.298451,171.895354,81.073298,2,0
0,0,13,13,13,19,32,47,56,103,0.000333,0.171667,12,6180,343.333333,515,128.816339,2,0
0,0,12,12,12,17,29,40,52,92,0.000333,0.148978,18,8044.816528,446.934252,446.934252,112.506418,2,0
0,0,13,13,14,21,35,48,61,109,0.000333,0.186364,14,7827.285884,434.849216,559.091849,145.541635,2,0
0,0,14,14,14,20,34,68,45,113,0.000333,0.191628,14,8048.366215,447.131456,574.883301,139.741531,5,0
0,0,3,3,11,12,23,17,14,31,0.000333,0.046743,5,701.152103,38.952895,140.230421,81.073298,1,0
0,0,3,3,11,12,23,17,14,31,0.000333,0.046743,5,701.152103,38.952895,140.230421,81.073298,1,0
0,0,5,5,10,8,18,16,12,28,0.000333,0.038919,5,583.7895,32.43275,116.7579,57.219281,1,0
0,0,14,14,14,20,34,68,45,113,0.000333,0.191628,14,8048.366215,447.131456,574.883301,139.741531,5,0
0,0,3,3,11,12,23,17,14,31,0.000333,0.046743,5,701.152103,38.952895,140.230421,81.073298,1,0
0,0,3,3,11,12,23,17,14,31,0.000333,0.046743,5,701.152103,38.952895,140.230421,81.073298,1,0
0,0,14,14,14,20,34,68,45,113,0.000333,0.191628,14,8048.366215,447.131456,574.883301,139.741531,5,0
0,0,3,3,12,16,28,20,19,39,0.000333,0.062496,6,1124.921052,62.495614,187.486842,107.01955,1,0
0,0,3,3,10,17,27,19,19,38,0.000333,0.060229,5,903.428625,50.190479,180.685725,102.706149,1,0
0,0,12,12,14,18,32,55,41,96,0.000333,0.16,14,6720,373.333333,480,128.361619,5,0
0,0,6,6,9,9,18,16,14,30,0.000333,0.041699,4,500.391,27.7995,125.09775,57.05865,1,0
0,0,12,12,15,17,32,56,40,96,0.000333,0.16,14,6720,373.333333,480,128.090227,5,0
0,0,9,9,12,18,30,36,33,69,0.000333,0.112858,6,2031.452707,112.858484,338.575451,118.0782,3,0
0,0,6,6,10,13,23,18,18,36,0.000333,0.054283,5,814.241152,45.23562,162.84823,81.324997,1,0
0,0,15,15,13,23,36,63,53,116,0.000333,0.199904,12,7196.535602,399.807533,599.7113,152.147641,4,0
0,0,14,14,13,24,37,56,46,102,0.000333,0.177121,6,3188.18546,177.121414,531.364243,158.144816,4,0
0,0,12,12,12,19,31,45,39,84,0.000333,0.138717,12,4993.829881,277.434993,416.15249,123.730173,2,0
0,0,8,8,10,16,26,27,24,51,0.000333,0.079907,5,1198.612128,66.589563,239.722426,97.219281,1,0
0,0,13,13,12,20,32,49,42,91,0.000333,0.151667,12,5460,303.333333,455,129.458112,2,0
0,0,19,19,13,24,37,70,76,146,0.000333,0.253527,18,13690.44345,760.580191,760.580191,158.144816,4,0
0,0,16,16,12,20,32,52,68,120,0.000333,0.2,18,10800,600,600,129.458112,2,0
0,0,11,11,13,17,30,38,34,72,0.000333,0.117765,12,4239.553475,235.530749,353.296123,117.592585,2,0
0,0,14,14,13,19,32,47,40,87,0.000333,0.145,12,5220,290,435,128.816339,2,0
0,0,11,11,13,18,31,40,33,73,0.000333,0.120552,6,2169.937984,120.55211,361.656331,123.164366,2,0
0,0,10,10,13,17,30,39,31,70,0.000333,0.114494,6,2060.89405,114.494114,343.482342,117.592585,2,0
0,0,9,9,12,15,27,28,25,53,0.000333,0.084003,6,1512.054226,84.003013,252.009038,101.622909,2,0
0,0,15,15,14,19,33,52,41,93,0.000333,0.156376,14,6567.801143,364.877841,469.128653,134.013592,2,0
0,0,11,11,14,17,31,41,32,73,0.000333,0.120552,7,2531.594315,140.644129,361.656331,122.789837,2,0
0,0,10,10,14,16,30,40,30,70,0.000333,0.114494,7,2404.376392,133.576466,343.482342,117.302969,2,0
0,0,10,10,13,15,28,33,26,59,0.000333,0.094545,6,1701.803642,94.544647,283.63394,106.709075,2,0
0,0,8,8,12,16,28,34,28,62,0.000333,0.099352,6,1788.336031,99.352002,298.056005,107.01955,3,0
0,0,8,8,12,16,28,34,28,62,0.000333,0.099352,6,1788.336031,99.352002,298.056005,107.01955,3,0
0,0,8,8,12,16,28,34,28,62,0.000333,0.099352,6,1788.336031,99.352002,298.056005,107.01955,3,0
0,0,5,5,10,8,18,16,12,28,0.000333,0.038919,5,583.7895,32.43275,116.7579,57.219281,1,0
0,0,5,5,10,8,18,16,12,28,0.000333,0.038919,5,583.7895,32.43275,116.7579,57.219281,1,0
0,0,14,14,12,20,32,52,65,117,0.000333,0.195,18,10530,585,585,129.458112,3,0
0,0,11,11,10,15,25,34,54,88,0.000333,0.13622,15,6129.890171,340.549454,408.659345,91.82264,1,0
0,0,3,3,10,15,25,18,18,36,0.000333,0.055726,5,835.894114,46.438562,167.178823,91.82264,1,0
0,0,16,16,16,22,38,79,60,139,0.000333,0.243154,16,11671.39079,648.410599,729.461924,162.107496,6,0
0,0,10,10,13,17,30,43,35,78,0.000333,0.127579,12,4592.849597,255.158311,382.737466,117.592585,2,0
0,0,9,9,13,15,28,32,30,62,0.000333,0.099352,12,3576.672062,198.704003,298.056005,106.709075,2,0
0,0,12,12,14,19,33,54,44,98,0.000333,0.164784,14,6920.908732,384.49493,494.350624,134.013592,5,0
0,0,6,6,10,13,23,18,18,36,0.000333,0.054283,5,814.241152,45.23562,162.84823,81.324997,1,0
0,0,16,16,15,23,38,75,52,127,0.000333,0.222162,14,9330.815119,518.378618,666.486794,162.645284,5,0
0,0,3,3,11,13,24,17,14,31,0.000333,0.047378,5,710.669188,39.481622,142.133838,86.159464,1,0
0,0,7,7,10,11,21,23,19,42,0.000333,0.061492,5,922.386659,51.243703,184.477332,71.273029,1,0
0,0,14,14,14,20,34,68,45,113,0.000333,0.191628,14,8048.366215,447.131456,574.883301,139.741531,5,0
0,0,15,15,14,21,35,71,47,118,0.000333,0.201752,14,8473.575544,470.754197,605.255396,145.541635,5,0
0,0,6,6,10,10,20,19,15,34,0.000333,0.048982,5,734.727776,40.81821,146.945555,66.438562,1,0
0,0,15,15,14,21,35,70,49,119,0.000333,0.203462,14,8545.385506,474.743639,610.384679,145.541635,5,0
0,0,6,6,10,13,23,18,18,36,0.000333,0.054283,5,814.241152,45.23562,162.84823,81.324997,1,0
0,0,8,8,12,15,27,28,28,56,0.000333,0.088758,6,1597.642201,88.7579,266.2737,101.622909,2,0
0,0,9,9,17,17,34,52,35,87,0.000333,0.147536,16,7081.748275,393.43046,442.609267,138.973737,2,0
0,0,8,8,12,14,26,26,22,48,0.000333,0.075207,6,1353.726639,75.207035,225.621106,96.322519,2,0
0,0,8,8,12,14,26,26,22,48,0.000333,0.075207,6,1353.726639,75.207035,225.621106,96.322519,2,0
0,0,10,10,16,17,33,50,32,82,0.000333,0.13788,8,3309.122542,183.840141,413.640318,133.486868,2,0
0,0,10,10,16,16,32,50,32,82,0.000333,0.136667,16,6560,364.444444,410,128,2,0
0,0,8,8,16,16,32,47,30,77,0.000333,0.128333,8,3080,171.111111,385,128,2,0
0,0,8,8,15,16,31,46,30,76,0.000333,0.125506,7,2635.632437,146.424024,376.51892,122.603359,2,0
0,0,8,8,9,16,25,31,27,58,0.000333,0.089781,4,1077.374636,59.854146,269.343659,92.529325,1,0
0,0,8,8,10,18,28,32,27,59,0.000333,0.094545,5,1418.169702,78.787206,283.63394,108.277931,1,0
0,0,13,13,14,22,36,60,49,109,0.000333,0.187841,14,7889.305552,438.294753,563.521825,151.410465,3,0
0,0,18,18,14,24,38,63,47,110,0.000333,0.192424,7,4040.904185,224.494677,577.272026,163.342069,3,0
0,0,11,11,13,18,31,40,33,73,0.000333,0.120552,6,2169.937984,120.55211,361.656331,123.164366,2,0
0,0,10,10,13,17,30,39,31,70,0.000333,0.114494,6,2060.89405,114.494114,343.482342,117.592585,2,0
0,0,10,10,12,16,28,32,27,59,0.000333,0.094545,6,1701.803642,94.544647,283.63394,107.01955,2,0
0,0,18,18,15,23,38,64,46,110,0.000333,0.192424,14,8081.808371,448.989354,577.272026,162.645284,3,0
0,0,11,11,13,15,28,37,28,65,0.000333,0.104159,6,1874.86842,104.159357,312.47807,106.709075,2,0
0,0,20,20,16,23,39,85,83,168,0.000333,0.295983,24,21310.74175,1183.930097,887.947573,168.041925,6,0
0,0,14,14,12,18,30,46,64,110,0.000333,0.179919,18,9715.643379,539.757966,539.757966,118.0782,2,0
0,0,20,20,17,25,42,86,90,176,0.000333,0.316349,24,22777.14879,1265.397155,949.047866,185.583273,6,0
0,0,16,16,15,23,38,71,48,119,0.000333,0.208168,14,8743.047237,485.724847,624.503374,162.645284,7,0
0,0,22,22,19,44,63,115,80,195,0.000333,0.388523,9,10490.12627,582.784793,1165.569585,320.925614,9,0
0,0,25,25,19,45,64,125,85,210,0.000333,0.42,9,11340,630,1260,327.844012,10,0
0,0,27,27,19,45,64,131,87,218,0.000333,0.436,9,11772,654,1308,327.844012,11,0
0,0,31,31,21,48,69,150,98,248,0.000333,0.504971,20,30298.28131,1683.23785,1514.914065,360.316866,12,0
0,0,16,16,16,21,37,72,46,118,0.000333,0.204905,16,9835.447954,546.413775,614.715497,156.238666,6,0
0,0,17,17,15,23,38,74,49,123,0.000333,0.215165,14,9036.931178,502.051732,645.495084,162.645284,8,0
0,0,17,17,15,24,39,74,49,123,0.000333,0.216701,14,9101.462621,505.636812,650.104473,168.642459,8,0
0,0,13,13,17,18,35,42,40,82,0.000333,0.1402,16,6729.619318,373.86774,420.601207,144.545518,2,0
0,0,9,9,13,17,30,42,32,74,0.000333,0.121037,6,2178.659424,121.036635,363.109904,117.592585,3,0
0,0,10,10,14,15,29,51,40,91,0.000333,0.147359,14,6189.067788,343.837099,442.076271,111.906328,3,0
0,0,8,8,12,11,23,35,22,57,0.000333,0.085948,12,3094.116378,171.895354,257.843031,81.073298,3,0
0,0,7,7,13,16,29,29,26,55,0.000333,0.089063,6,1603.133728,89.062985,267.188955,112.105716,2,0
0,0,7,7,14,15,29,30,25,55,0.000333,0.089063,7,1870.322683,103.906816,267.188955,111.906328,2,0
0,0,7,7,14,15,29,30,25,55,0.000333,0.089063,7,1870.322683,103.906816,267.188955,111.906328,2,0
0,0,6,6,12,11,23,22,16,38,0.000333,0.057298,6,1031.372126,57.298451,171.895354,81.073298,2,0
0,0,6,6,12,11,23,22,16,38,0.000333,0.057298,6,1031.372126,57.298451,171.895354,81.073298,2,0
0,0,7,7,13,16,29,29,26,55,0.000333,0.089063,6,1603.133728,89.062985,267.188955,112.105716,2,0
0,0,7,7,14,15,29,30,25,55,0.000333,0.089063,7,1870.322683,103.906816,267.188955,111.906328,2,0
0,0,7,7,14,15,29,30,25,55,0.000333,0.089063,7,1870.322683,103.906816,267.188955,111.906328,2,0
0,0,6,6,12,11,23,22,16,38,0.000333,0.057298,6,1031.372126,57.298451,171.895354,81.073298,2,0
0,0,6,6,12,11,23,22,16,38,0.000333,0.057298,6,1031.372126,57.298451,171.895354,81.073298,2,0
0,0,14,14,14,20,34,68,45,113,0.000333,0.191628,14,8048.366215,447.131456,574.883301,139.741531,5,0
0,0,3,3,11,11,22,16,13,29,0.000333,0.043108,5,646.617585,35.923199,129.323517,76.107496,1,0
0,0,17,17,16,21,37,79,53,132,0.000333,0.229216,16,11002.36551,611.242528,687.647844,156.238666,5,0
0,0,3,3,11,11,22,16,13,29,0.000333,0.043108,5,646.617585,35.923199,129.323517,76.107496,1,0
0,0,3,3,11,11,22,16,13,29,0.000333,0.043108,5,646.617585,35.923199,129.323517,76.107496,1,0
0,0,17,17,15,21,36,78,59,137,0.000333,0.236093,14,9915.916153,550.884231,708.279725,150.842025,5,0
0,0,3,3,11,11,22,16,13,29,0.000333,0.043108,5,646.617585,35.923199,129.323517,76.107496,1,0
0,0,8,8,11,13,24,26,30,56,0.000333,0.085586,10,2567.579,142.643278,256.7579,86.159464,1,0
0,0,3,3,11,11,22,16,13,29,0.000333,0.043108,5,646.617585,35.923199,129.323517,76.107496,1,0
0,0,8,8,11,13,24,26,30,56,0.000333,0.085586,10,2567.579,142.643278,256.7579,86.159464,1,0
0,0,11,11,13,14,27,39,32,71,0.000333,0.112532,12,4051.164152,225.064675,337.597013,101.408685,2,0
0,0,11,11,13,14,27,39,32,71,0.000333,0.112532,12,4051.164152,225.064675,337.597013,101.408685,2,0
0,0,17,17,15,20,35,78,56,134,0.000333,0.229108,14,9622.53494,534.585274,687.323924,145.041921,5,0
0,0,8,8,11,12,23,26,28,54,0.000333,0.081424,10,2442.723456,135.706859,244.272346,81.073298,1,0
0,0,8,8,11,12,23,26,28,54,0.000333,0.081424,10,2442.723456,135.706859,244.272346,81.073298,1,0
0,0,14,14,14,20,34,68,45,113,0.000333,0.191628,14,8048.366215,447.131456,574.883301,139.741531,5,0
0,0,3,3,11,13,24,17,14,31,0.000333,0.047378,5,710.669188,39.481622,142.133838,86.159464,1,0
0,0,5,5,10,8,18,16,12,28,0.000333,0.038919,5,583.7895,32.43275,116.7579,57.219281,1,0
0,0,3,3,11,13,24,17,14,31,0.000333,0.047378,5,710.669188,39.481622,142.133838,86.159464,1,0
0,0,5,5,10,8,18,16,12,28,0.000333,0.038919,5,583.7895,32.43275,116.7579,57.219281,1,0
0,0,14,14,14,20,34,68,45,113,0.000333,0.191628,14,8048.366215,447.131456,574.883301,139.741531,5,0
0,0,3,3,11,13,24,17,14,31,0.000333,0.047378,5,710.669188,39.481622,142.133838,86.159464,1,0
0,0,5,5,10,8,18,16,12,28,0.000333,0.038919,5,583.7895,32.43275,116.7579,57.219281,1,0
0,0,3,3,11,13,24,17,14,31,0.000333,0.047378,5,710.669188,39.481622,142.133838,86.159464,1,0
0,0,5,5,10,8,18,16,12,28,0.000333,0.038919,5,583.7895,32.43275,116.7579,57.219281,1,0
0,0,12,12,16,22,38,47,62,109,0.000333,0.190675,16,9152.385583,508.465866,572.024099,162.107496,1,0
0,0,14,14,14,20,34,68,45,113,0.000333,0.191628,14,8048.366215,447.131456,574.883301,139.741531,5,0
0,0,3,3,11,13,24,17,14,31,0.000333,0.047378,5,710.669188,39.481622,142.133838,86.159464,1,0
0,0,5,5,10,8,18,16,12,28,0.000333,0.038919,5,583.7895,32.43275,116.7579,57.219281,1,0
0,0,10,10,15,23,38,43,45,88,0.000333,0.153939,7,3232.723348,179.595742,461.817621,162.645284,1,0
0,0,16,16,16,23,39,76,53,129,0.000333,0.227272,16,10909.07018,606.059454,681.816886,168.041925,5,0
0,0,7,7,12,14,26,24,24,48,0.000333,0.075207,6,1353.726639,75.207035,225.621106,96.322519,1,0
0,0,14,14,13,17,30,47,40,87,0.000333,0.1423,12,5122.793782,284.599655,426.899482,117.592585,2,0
0,0,9,9,13,15,28,34,27,61,0.000333,0.09775,6,1759.491901,97.74955,293.24865,106.709075,2,0
0,0,11,11,12,15,27,33,30,63,0.000333,0.099853,12,3594.694952,199.705275,299.557913,101.622909,2,0
0,0,15,15,14,17,31,52,41,93,0.000333,0.15358,14,6450.363596,358.353533,460.740257,122.789837,2,0
0,0,9,9,14,14,28,35,26,61,0.000333,0.09775,7,2052.740552,114.041142,293.24865,106.605938,2,0
0,0,12,12,13,15,28,38,31,69,0.000333,0.110569,12,3980.489875,221.138326,331.70749,106.709075,2,0
0,0,14,14,13,17,30,47,44,91,0.000333,0.148842,12,5358.32453,297.684696,446.527044,117.592585,2,0
0,0,9,9,13,15,28,37,29,66,0.000333,0.105762,6,1903.712549,105.761808,317.285425,106.709075,2,0
0,0,11,11,12,15,27,33,34,67,0.000333,0.106192,12,3822.929552,212.384975,318.577463,101.622909,2,0
0,0,15,15,14,20,34,52,47,99,0.000333,0.167886,14,7051.223498,391.734639,503.658821,139.741531,2,0
0,0,9,9,13,16,29,37,30,67,0.000333,0.108495,6,1952.90836,108.494909,325.484727,112.105716,2,0
0,0,12,12,13,18,31,38,37,75,0.000333,0.123855,12,4458.776679,247.709816,371.564723,123.164366,2,0
0,0,15,15,15,17,32,52,42,94,0.000333,0.156667,14,6580,365.555556,470,128.090227,2,0
0,0,9,9,13,15,28,34,27,61,0.000333,0.09775,6,1759.491901,97.74955,293.24865,106.709075,2,0
0,0,12,12,14,15,29,38,32,70,0.000333,0.113353,14,4760.821375,264.490076,340.05867,111.906328,2,0
0,0,16,16,15,17,32,57,45,102,0.000333,0.17,14,7140,396.666667,510,128.090227,2,0
0,0,9,9,14,14,28,35,26,61,0.000333,0.09775,7,2052.740552,114.041142,293.24865,106.605938,2,0
0,0,13,13,14,15,29,43,35,78,0.000333,0.126308,14,5304.915247,294.717514,378.922518,111.906328,2,0
0,0,9,9,14,17,31,38,28,66,0.000333,0.108992,7,2288.838695,127.157705,326.976956,122.789837,9,0
0,0,9,9,14,17,31,37,28,65,0.000333,0.107341,7,2254.159321,125.231073,322.02276,122.789837,9,0
0,0,11,11,15,19,34,42,30,72,0.000333,0.122099,7,2564.081272,142.44896,366.297325,139.313982,9,0
0,0,11,11,15,19,34,42,30,72,0.000333,0.122099,7,2564.081272,142.44896,366.297325,139.313982,9,0
0,0,13,13,14,23,37,56,42,98,0.000333,0.170175,7,3573.685009,198.538056,510.52643,157.344894,11,0
0,0,11,11,14,23,37,45,34,79,0.000333,0.137182,7,2880.827711,160.045984,411.546816,157.344894,10,0
0,0,13,13,15,20,35,57,39,96,0.000333,0.164137,7,3446.878187,191.493233,492.41117,145.041921,10,0
0,0,15,15,15,20,35,64,44,108,0.000333,0.184654,14,7755.475922,430.859773,553.962566,145.041921,14,0
0,0,17,17,15,20,35,76,52,128,0.000333,0.218849,14,9191.675166,510.64862,656.548226,145.041921,16,0
0,0,11,11,15,20,35,46,31,77,0.000333,0.131652,7,2764.683546,153.59353,394.954792,145.041921,9,0
0,0,11,11,15,19,34,41,30,71,0.000333,0.120403,7,2528.469032,140.470502,361.209862,139.313982,9,0
0,0,11,11,15,19,34,41,30,71,0.000333,0.120403,7,2528.469032,140.470502,361.209862,139.313982,9,0
0,0,12,12,16,19,35,61,43,104,0.000333,0.177815,16,8535.12694,474.173719,533.445434,144.710623,6,0
0,0,12,12,17,18,35,62,42,104,0.000333,0.177815,16,8535.12694,474.173719,533.445434,144.545518,6,0
0,0,12,12,17,18,35,62,42,104,0.000333,0.177815,16,8535.12694,474.173719,533.445434,144.545518,6,0
0,0,8,8,12,14,26,26,22,48,0.000333,0.075207,6,1353.726639,75.207035,225.621106,96.322519,2,0
0,0,8,8,12,14,26,26,22,48,0.000333,0.075207,6,1353.726639,75.207035,225.621106,96.322519,2,0
0,0,8,8,12,14,26,26,22,48,0.000333,0.075207,6,1353.726639,75.207035,225.621106,96.322519,2,0
0,0,8,8,12,14,26,26,22,48,0.000333,0.075207,6,1353.726639,75.207035,225.621106,96.322519,2,0
0,0,10,10,15,23,38,42,44,86,0.000333,0.150441,7,3159.252363,175.51402,451.321766,162.645284,1,0
0,0,10,10,14,20,34,42,37,79,0.000333,0.13397,7,2813.366951,156.298164,401.909564,139.741531,3,0
0,0,7,7,12,14,26,24,24,48,0.000333,0.075207,6,1353.726639,75.207035,225.621106,96.322519,1,0
0,0,6,6,10,14,24,20,22,42,0.000333,0.064189,5,962.842125,53.491229,192.568425,86.52225,1,0
0,0,8,8,12,17,29,34,29,63,0.000333,0.102018,6,1836.316816,102.017601,306.052803,112.506418,3,0
0,0,8,8,12,17,29,34,29,63,0.000333,0.102018,6,1836.316816,102.017601,306.052803,112.506418,3,0
0,0,14,14,14,20,34,68,45,113,0.000333,0.191628,14,8048.366215,447.131456,574.883301,139.741531,5,0
0,0,3,3,11,11,22,16,13,29,0.000333,0.043108,5,646.617585,35.923199,129.323517,76.107496,1,0
0,0,5,5,10,8,18,16,12,28,0.000333,0.038919,5,583.7895,32.43275,116.7579,57.219281,1,0
0,0,3,3,11,11,22,16,13,29,0.000333,0.043108,5,646.617585,35.923199,129.323517,76.107496,1,0
0,0,5,5,10,8,18,16,12,28,0.000333,0.038919,5,583.7895,32.43275,116.7579,57.219281,1,0
0,0,30,30,24,52,76,142,97,239,0.000333,0.497752,12,17919.05611,995.503117,1493.254676,406.461965,11,0
0,0,29,29,24,51,75,141,95,236,0.000333,0.49,12,17640.01453,980.000807,1470.001211,399.332792,11,0
0,0,30,30,24,52,76,142,97,239,0.000333,0.497752,12,17919.05611,995.503117,1493.254676,406.461965,11,0
0,0,29,29,24,51,75,141,95,236,0.000333,0.49,12,17640.01453,980.000807,1470.001211,399.332792,11,0
0,0,9,9,10,15,25,28,26,54,0.000333,0.083589,5,1253.841171,69.657843,250.768234,91.82264,3,0
0,0,9,9,9,15,24,27,26,53,0.000333,0.081001,4,972.01205,54.000669,243.003013,87.132684,3,0
0,0,9,9,10,16,26,28,26,54,0.000333,0.084608,5,1269.118724,70.506596,253.823745,97.219281,3,0
0,0,9,9,9,16,25,27,26,53,0.000333,0.082041,4,984.497512,54.694306,246.124378,92.529325,3,0
0,0,9,9,13,16,29,38,29,67,0.000333,0.108495,6,1952.90836,108.494909,325.484727,112.105716,3,0
0,0,6,6,10,10,20,20,15,35,0.000333,0.050422,5,756.337417,42.018745,151.267483,66.438562,1,0
0,0,14,14,15,20,35,64,55,119,0.000333,0.203462,14,8545.385506,474.743639,610.384679,145.041921,5,0
0,0,8,8,11,14,25,28,29,57,0.000333,0.088233,10,2646.998028,147.055446,264.699803,91.356717,1,0
0,0,10,10,15,21,36,42,34,76,0.000333,0.130971,7,2750.400101,152.800006,392.9143,150.842025,2,0
0,0,10,10,15,20,35,42,34,76,0.000333,0.129942,7,2728.778565,151.598809,389.825509,145.041921,2,0
0,0,10,10,14,23,37,46,37,83,0.000333,0.144128,7,3026.692405,168.149578,432.384629,157.344894,2,0
0,0,10,10,15,21,36,47,35,82,0.000333,0.141311,7,2967.536951,164.863164,423.93385,150.842025,2,0
0,0,10,10,15,21,36,47,35,82,0.000333,0.141311,7,2967.536951,164.863164,423.93385,150.842025,2,0
0,0,8,8,14,19,33,38,31,69,0.000333,0.116021,7,2436.44236,135.357909,348.063194,134.013592,2,0
0,0,7,7,13,19,32,35,30,65,0.000333,0.108333,6,1950,108.333333,325,128.816339,1,0
0,0,9,9,12,18,30,37,31,68,0.000333,0.111223,6,2002.011363,111.222854,333.668561,118.0782,3,0
0,0,6,6,10,9,19,19,14,33,0.000333,0.046727,5,700.90804,38.939336,140.181608,61.748606,1,0
0,0,3,3,10,16,26,19,19,38,0.000333,0.059539,5,893.083546,49.615753,178.616709,97.219281,1,0
0,0,18,18,14,22,36,80,69,149,0.000333,0.256773,21,16176.69533,898.705296,770.318825,151.410465,5,0
0,0,9,9,10,14,24,28,40,68,0.000333,0.103926,10,3117.7745,173.209694,311.77745,86.52225,1,0
0,0,3,3,10,16,26,19,19,38,0.000333,0.059539,5,893.083546,49.615753,178.616709,97.219281,1,0
0,0,15,15,14,21,35,71,47,118,0.000333,0.201752,14,8473.575544,470.754197,605.255396,145.541635,5,0
0,0,6,6,10,10,20,19,15,34,0.000333,0.048982,5,734.727776,40.81821,146.945555,66.438562,1,0
0,0,8,8,12,13,25,28,20,48,0.000333,0.074302,6,1337.430583,74.301699,222.905097,91.125266,2,0
0,0,14,14,13,20,33,43,43,86,0.000333,0.144606,12,5205.814731,289.21193,433.817894,134.544278,2,0
0,0,11,11,13,19,32,36,36,72,0.000333,0.12,6,2160,120,360,128.816339,2,0
0,0,9,9,12,16,28,27,26,53,0.000333,0.08493,6,1528.738865,84.929937,254.789811,107.01955,2,0
0,0,16,16,14,21,35,50,46,96,0.000333,0.164137,14,6893.756375,382.986465,492.41117,145.541635,3,0
0,0,16,16,14,21,35,50,46,96,0.000333,0.164137,14,6893.756375,382.986465,492.41117,145.541635,3,0
0,0,14,14,13,20,33,43,43,86,0.000333,0.144606,12,5205.814731,289.21193,433.817894,134.544278,2,0
0,0,11,11,13,19,32,36,36,72,0.000333,0.12,6,2160,120,360,128.816339,2,0
0,0,9,9,12,16,28,27,26,53,0.000333,0.08493,6,1528.738865,84.929937,254.789811,107.01955,2,0
0,0,16,16,14,21,35,50,46,96,0.000333,0.164137,14,6893.756375,382.986465,492.41117,145.541635,3,0
0,0,11,11,14,18,32,37,35,72,0.000333,0.12,7,2520,140,360,128.361619,2,0
0,0,9,9,13,15,28,28,25,53,0.000333,0.08493,6,1528.738865,84.929937,254.789811,106.709075,2,0
0,0,16,16,14,21,35,50,46,96,0.000333,0.164137,14,6893.756375,382.986465,492.41117,145.541635,3,0
0,0,11,11,14,18,32,37,35,72,0.000333,0.12,7,2520,140,360,128.361619,2,0
0,0,9,9,13,15,28,28,25,53,0.000333,0.08493,6,1528.738865,84.929937,254.789811,106.709075,2,0
0,0,12,12,13,22,35,48,46,94,0.000333,0.160718,12,5785.831243,321.435069,482.152604,146.213212,3,0
0,0,7,7,8,16,24,19,23,42,0.000333,0.064189,4,770.2737,42.792983,192.568425,88,1,0
0,0,3,3,10,15,25,20,18,38,0.000333,0.058822,5,882.332676,49.018482,176.466535,91.82264,1,0
0,0,9,9,8,16,24,29,35,64,0.000333,0.097813,8,2347.5008,130.416711,293.4376,88,1,0
0,0,5,5,10,13,23,22,18,40,0.000333,0.060314,5,904.712391,50.2618,180.942478,81.324997,2,0
0,0,6,6,10,14,24,23,20,43,0.000333,0.065718,5,985.766938,54.76483,197.153388,86.52225,2,0
0,0,5,5,11,14,25,23,19,42,0.000333,0.065014,5,975.2098,54.178322,195.04196,91.356717,2,0
0,0,6,6,11,15,26,24,21,45,0.000333,0.070507,5,1057.598937,58.755496,211.519787,96.657107,2,0
0,0,3,3,12,17,29,20,19,39,0.000333,0.063154,6,1136.767553,63.153753,189.461259,112.506418,1,0
0,0,3,3,7,3,10,9,5,14,0.000333,0.015502,3,139.52098,7.751166,46.506993,24.406372,1,0
0,0,5,5,8,5,13,16,10,26,0.000333,0.03207,8,769.691461,42.760637,96.211433,35.60964,1,0
0,0,5,5,7,9,16,10,13,23,0.000333,0.030667,3,276,15.333333,92,48.180809,1,0
0,0,5,5,8,8,16,11,12,23,0.000333,0.030667,4,368,20.444444,92,48,1,0
0,0,11,11,13,19,32,39,38,77,0.000333,0.128333,12,4620,256.666667,385,128.816339,2,0
0,0,11,11,13,20,33,39,39,78,0.000333,0.131154,6,2360.776448,131.154247,393.462741,134.544278,2,0
0,0,13,13,12,19,31,44,43,87,0.000333,0.143672,12,5172.180948,287.343386,431.015079,123.730173,2,0
0,0,7,7,7,12,19,18,21,39,0.000333,0.055223,3,497.007519,27.611529,165.669173,62.671034,1,0
0,0,13,13,13,21,34,45,44,89,0.000333,0.150928,12,5433.410314,301.856129,452.784193,140.344382,2,0
0,0,8,8,8,16,24,22,24,46,0.000333,0.070303,4,843.6331,46.868506,210.908275,88,1,0
0,0,19,19,13,24,37,64,63,127,0.000333,0.220534,12,7939.206929,441.067052,661.600577,158.144816,2,0
0,0,11,11,13,20,33,41,38,79,0.000333,0.132836,6,2391.042813,132.835712,398.507135,134.544278,2,0
0,0,20,20,14,27,41,68,67,135,0.000333,0.24109,14,10125.77329,562.54296,723.269521,181.684931,2,0
0,0,11,11,13,21,34,41,39,80,0.000333,0.135666,6,2441.982164,135.665676,406.997027,140.344382,2,0
0,0,14,14,12,20,32,48,46,94,0.000333,0.156667,12,5640,313.333333,470,129.458112,2,0
0,0,15,15,13,23,36,52,50,102,0.000333,0.175777,12,6327.988202,351.5549,527.33235,152.147641,2,0
0,0,17,17,16,24,40,54,58,112,0.000333,0.198685,16,9536.895146,529.827508,596.055947,174.0391,2,0
0,0,18,18,17,26,43,58,64,122,0.000333,0.220668,16,10592.0688,588.448267,662.0043,191.698301,2,0
0,0,11,11,14,19,33,35,34,69,0.000333,0.116021,7,2436.44236,135.357909,348.063194,134.013592,2,0
0,0,11,11,15,20,35,36,36,72,0.000333,0.123103,7,2585.158641,143.619924,369.308377,145.041921,2,0
0,0,17,17,15,23,38,74,49,123,0.000333,0.215165,14,9036.931178,502.051732,645.495084,162.645284,8,0
0,0,23,23,19,44,63,118,81,199,0.000333,0.396493,9,10705.30834,594.739352,1189.478705,320.925614,10,0
0,0,26,26,19,45,64,128,86,214,0.000333,0.428,9,11556,642,1284,327.844012,11,0
0,0,28,28,19,45,64,134,88,222,0.000333,0.444,9,11988,666,1332,327.844012,12,0
0,0,32,32,21,48,69,153,99,252,0.000333,0.513116,20,30786.96326,1710.386848,1539.348163,360.316866,13,0
0,0,17,17,16,21,37,75,47,122,0.000333,0.211851,16,10168.85297,564.936276,635.553311,156.238666,7,0
0,0,23,23,19,44,63,118,81,199,0.000333,0.396493,9,10705.30834,594.739352,1189.478705,320.925614,10,0
0,0,26,26,19,45,64,128,86,214,0.000333,0.428,9,11556,642,1284,327.844012,11,0
0,0,28,28,19,45,64,134,88,222,0.000333,0.444,9,11988,666,1332,327.844012,12,0
0,0,32,32,21,48,69,153,99,252,0.000333,0.513116,20,30786.96326,1710.386848,1539.348163,360.316866,13,0
0,0,17,17,16,21,37,75,47,122,0.000333,0.211851,16,10168.85297,564.936276,635.553311,156.238666,7,0
1,0,19,20,17,23,40,58,66,124,0.000333,0.219973,16,10558.70534,586.594741,659.919084,173.528793,2,0
0,0,20,20,18,25,43,62,78,140,0.000333,0.253226,27,20511.28077,1139.515598,759.677066,191.155055,2,0
0,0,15,15,14,21,35,71,47,118,0.000333,0.201752,14,8473.575544,470.754197,605.255396,145.541635,5,0
0,0,3,3,11,13,24,20,16,36,0.000333,0.05502,5,825.29325,45.849625,165.05865,86.159464,1,0
0,0,6,6,10,9,19,19,14,33,0.000333,0.046727,5,700.90804,38.939336,140.181608,61.748606,1,0
0,0,16,16,15,23,38,75,52,127,0.000333,0.222162,14,9330.815119,518.378618,666.486794,162.645284,5,0
0,0,3,3,11,12,23,17,14,31,0.000333,0.046743,5,701.152103,38.952895,140.230421,81.073298,1,0
0,0,7,7,10,11,21,23,19,42,0.000333,0.061492,5,922.386659,51.243703,184.477332,71.273029,1,0
0,0,12,12,13,16,29,41,34,75,0.000333,0.12145,12,4372.182896,242.89905,364.348575,112.105716,2,0
0,0,9,9,13,15,28,34,27,61,0.000333,0.09775,6,1759.491901,97.74955,293.24865,106.709075,2,0
0,0,9,9,12,14,26,27,24,51,0.000333,0.079907,6,1438.334554,79.907475,239.722426,96.322519,2,0
0,0,14,14,14,16,30,49,36,85,0.000333,0.139029,14,5839.199809,324.399989,417.085701,117.302969,3,0
0,0,9,9,14,14,28,35,26,61,0.000333,0.09775,7,2052.740552,114.041142,293.24865,106.605938,2,0
0,0,10,10,13,14,27,32,25,57,0.000333,0.090343,6,1626.171526,90.342863,271.028588,101.408685,2,0
0,0,14,14,14,16,30,49,36,85,0.000333,0.139029,14,5839.199809,324.399989,417.085701,117.302969,3,0
0,0,9,9,14,14,28,35,26,61,0.000333,0.09775,7,2052.740552,114.041142,293.24865,106.605938,2,0
0,0,10,10,13,14,27,32,25,57,0.000333,0.090343,6,1626.171526,90.342863,271.028588,101.408685,2,0
0,0,7,7,10,15,25,23,24,47,0.000333,0.072754,5,1091.306205,60.628122,218.261241,91.82264,1,0
0,0,6,6,9,9,18,16,14,30,0.000333,0.041699,4,500.391,27.7995,125.09775,57.05865,1,0
0,0,7,7,11,14,25,24,23,47,0.000333,0.072754,5,1091.306205,60.628122,218.261241,91.356717,1,0
0,0,14,14,16,25,41,52,58,110,0.000333,0.196444,16,9429.291528,523.849529,589.330721,180.096405,2,0
0,0,11,11,14,19,33,39,52,91,0.000333,0.153013,14,6426.558108,357.031006,459.039865,134.013592,1,0
0,0,3,3,11,11,22,16,13,29,0.000333,0.043108,5,646.617585,35.923199,129.323517,76.107496,1,0
0,0,12,12,14,19,33,55,42,97,0.000333,0.163102,14,6850.287214,380.571512,489.30623,134.013592,5,0
0,0,3,3,11,12,23,17,14,31,0.000333,0.046743,5,701.152103,38.952895,140.230421,81.073298,1,0
0,0,6,6,10,9,19,19,14,33,0.000333,0.046727,5,700.90804,38.939336,140.181608,61.748606,1,0
0,0,14,14,16,19,35,63,48,111,0.000333,0.189783,16,9109.606638,506.089258,569.350415,144.710623,5,0
0,0,3,3,11,12,23,17,14,31,0.000333,0.046743,5,701.152103,38.952895,140.230421,81.073298,1,0
0,0,8,8,11,9,20,27,22,49,0.000333,0.070591,10,2117.744766,117.652487,211.774477,66.583073,1,0
0,0,11,11,12,17,29,33,41,74,0.000333,0.11983,12,4313.887124,239.660396,359.490594,112.506418,1,0
0,0,12,12,13,19,32,37,47,84,0.000333,0.14,12,5040,280,420,128.816339,1,0
0,0,11,11,14,18,32,34,33,67,0.000333,0.111667,7,2345,130.277778,335,128.361619,2,0
0,0,11,11,15,19,34,35,35,70,0.000333,0.118707,7,2492.856792,138.492044,356.122399,139.313982,2,0
0,0,5,5,11,13,24,20,22,42,0.000333,0.064189,5,962.842125,53.491229,192.568425,86.159464,1,0
0,0,5,5,11,14,25,20,23,43,0.000333,0.066562,5,998.429081,55.468282,199.685816,91.356717,1,0
0,0,5,5,8,8,16,11,12,23,0.000333,0.030667,4,368,20.444444,92,48,1,0
0,0,5,5,9,9,18,12,13,25,0.000333,0.034749,4,416.9925,23.16625,104.248125,57.05865,1,0
0,0,14,14,13,20,33,43,43,86,0.000333,0.144606,12,5205.814731,289.21193,433.817894,134.544278,2,0
0,0,11,11,13,19,32,36,36,72,0.000333,0.12,6,2160,120,360,128.816339,2,0
0,0,9,9,12,16,28,27,26,53,0.000333,0.08493,6,1528.738865,84.929937,254.789811,107.01955,2,0
0,0,16,16,14,20,34,50,46,96,0.000333,0.162799,14,6837.550059,379.863892,488.396433,139.741531,3,0
0,0,11,11,14,18,32,37,35,72,0.000333,0.12,7,2520,140,360,128.361619,2,0
0,0,9,9,13,15,28,28,25,53,0.000333,0.08493,6,1528.738865,84.929937,254.789811,106.709075,2,0
0,0,16,16,14,20,34,50,46,96,0.000333,0.162799,14,6837.550059,379.863892,488.396433,139.741531,3,0
0,0,11,11,14,18,32,37,35,72,0.000333,0.12,7,2520,140,360,128.361619,2,0
0,0,9,9,13,15,28,28,25,53,0.000333,0.08493,6,1528.738865,84.929937,254.789811,106.709075,2,0
0,0,16,16,14,24,38,66,64,130,0.000333,0.22741,14,9551.228074,530.623782,682.230577,163.342069,6,0
0,0,12,12,12,19,31,38,46,84,0.000333,0.138717,12,4993.829881,277.434993,416.15249,123.730173,2,0
0,0,7,7,10,16,26,23,25,48,0.000333,0.075207,5,1128.105532,62.67253,225.621106,97.219281,1,0
0,0,3,3,11,12,23,16,13,29,0.000333,0.043728,5,655.916484,36.439805,131.183297,81.073298,1,0
0,0,6,6,10,9,19,19,14,33,0.000333,0.046727,5,700.90804,38.939336,140.181608,61.748606,1,0
0,0,8,8,11,18,29,27,30,57,0.000333,0.092302,5,1384.524584,76.918032,276.904917,113.112398,1,0
0,0,3,3,11,12,23,16,13,29,0.000333,0.043728,5,655.916484,36.439805,131.183297,81.073298,1,0
0,0,7,7,10,11,21,23,19,42,0.000333,0.061492,5,922.386659,51.243703,184.477332,71.273029,1,0
0,0,3,3,10,17,27,20,19,39,0.000333,0.061814,5,927.203063,51.511281,185.440613,102.706149,1,0
0,0,15,15,14,20,34,71,46,117,0.000333,0.198411,14,8333.264134,462.959119,595.233152,139.741531,5,0
0,0,6,6,9,9,18,16,14,30,0.000333,0.041699,4,500.391,27.7995,125.09775,57.05865,1,0
0,0,15,15,15,19,34,72,45,117,0.000333,0.198411,14,8333.264134,462.959119,595.233152,139.313982,5,0
0,0,18,18,18,22,40,88,56,144,0.000333,0.255453,18,13794.43762,766.357646,766.357646,173.166146,6,0
0,0,9,9,13,12,25,33,26,59,0.000333,0.091329,12,3287.850182,182.658343,273.987515,91.125266,2,0
0,0,18,18,18,21,39,89,57,146,0.000333,0.257223,18,13890.03703,771.668724,771.668724,167.297316,6,0
0,0,16,16,16,22,38,80,50,130,0.000333,0.22741,16,10915.68923,606.427179,682.230577,162.107496,6,0
0,0,7,7,12,12,24,25,18,43,0.000333,0.065718,6,1182.920325,65.717796,197.153388,86.0391,2,0
0,0,16,16,17,21,38,81,49,130,0.000333,0.22741,16,10915.68923,606.427179,682.230577,161.725534,6,0
0,0,17,17,16,22,38,83,54,137,0.000333,0.239655,16,11503.45711,639.080951,718.966069,162.107496,6,0
0,0,8,8,12,12,24,28,22,50,0.000333,0.076416,6,1375.48875,76.416042,229.248125,86.0391,2,0
0,0,17,17,17,21,38,84,53,137,0.000333,0.239655,16,11503.45711,639.080951,718.966069,161.725534,6,0
0,0,11,11,11,18,29,42,37,79,0.000333,0.127927,10,3837.804986,213.211388,383.780499,113.112398,2,0
0,0,11,11,12,20,32,43,37,80,0.000333,0.133333,6,2400,133.333333,400,129.458112,2,0
0,0,17,17,14,24,38,68,59,127,0.000333,0.222162,14,9330.815119,518.378618,666.486794,163.342069,2,0
0,0,32,32,25,54,79,152,111,263,0.000333,0.552631,24,39789.46408,2210.525782,1657.894337,426.86033,10,0
0,0,31,31,25,54,79,151,109,260,0.000333,0.546328,24,39335.59187,2185.310659,1638.982995,426.86033,10,0
0,0,21,21,18,44,62,104,79,183,0.000333,0.363206,9,9806.561323,544.808962,1089.617925,315.273641,9,0
0,0,7,7,12,12,24,25,18,43,0.000333,0.065718,6,1182.920325,65.717796,197.153388,86.0391,2,0
0,0,8,8,12,17,29,34,29,63,0.000333,0.102018,6,1836.316816,102.017601,306.052803,112.506418,3,0
0,0,8,8,12,17,29,34,29,63,0.000333,0.102018,6,1836.316816,102.017601,306.052803,112.506418,3,0
0,0,3,3,11,11,22,16,13,29,0.000333,0.043108,5,646.617585,35.923199,129.323517,76.107496,1,0
0,0,3,3,11,11,22,16,13,29,0.000333,0.043108,5,646.617585,35.923199,129.323517,76.107496,1,0
0,0,16,16,15,23,38,75,52,127,0.000333,0.222162,14,9330.815119,518.378618,666.486794,162.645284,5,0
0,0,3,3,11,12,23,16,13,29,0.000333,0.043728,5,655.916484,36.439805,131.183297,81.073298,1,0
0,0,17,17,16,21,37,79,53,132,0.000333,0.229216,16,11002.36551,611.242528,687.647844,156.238666,5,0
0,0,3,3,11,12,23,16,13,29,0.000333,0.043728,5,655.916484,36.439805,131.183297,81.073298,1,0
0,0,3,3,11,12,23,16,13,29,0.000333,0.043728,5,655.916484,36.439805,131.183297,81.073298,1,0
0,0,8,8,11,9,20,27,24,51,0.000333,0.073473,10,2204.183328,122.454629,220.418333,66.583073,1,0
0,0,3,3,11,11,22,16,13,29,0.000333,0.043108,5,646.617585,35.923199,129.323517,76.107496,1,0
0,0,3,3,11,11,22,16,13,29,0.000333,0.043108,5,646.617585,35.923199,129.323517,76.107496,1,0
0,0,11,11,14,17,31,52,39,91,0.000333,0.150277,14,6311.646099,350.647006,450.831864,122.789837,5,0
0,0,16,16,15,23,38,75,52,127,0.000333,0.222162,14,9330.815119,518.378618,666.486794,162.645284,5,0
0,0,3,3,11,11,22,16,13,29,0.000333,0.043108,5,646.617585,35.923199,129.323517,76.107496,1,0
0,0,7,7,10,11,21,23,19,42,0.000333,0.061492,5,922.386659,51.243703,184.477332,71.273029,1,0
0,0,16,16,14,21,35,74,57,131,0.000333,0.223979,14,9407.105053,522.616947,671.936075,145.541635,5,0
0,0,3,3,10,15,25,18,18,36,0.000333,0.055726,5,835.894114,46.438562,167.178823,91.82264,1,0
0,0,7,7,10,13,23,22,26,48,0.000333,0.072377,10,2171.309739,120.628319,217.130974,81.324997,1,0
0,0,10,10,13,15,28,33,26,59,0.000333,0.094545,6,1701.803642,94.544647,283.63394,106.709075,2,0
0,0,10,10,13,15,28,33,26,59,0.000333,0.094545,6,1701.803642,94.544647,283.63394,106.709075,2,0
0,0,11,11,15,17,32,40,31,71,0.000333,0.118333,7,2485,138.055556,355,128.090227,2,0
0,0,11,11,16,18,34,42,31,73,0.000333,0.123795,8,2971.078299,165.059906,371.384787,139.05865,3,0
0,0,9,9,12,13,25,31,24,55,0.000333,0.085137,6,1532.472543,85.137363,255.41209,91.125266,1,0
0,0,9,9,13,14,27,33,24,57,0.000333,0.090343,6,1626.171526,90.342863,271.028588,101.408685,2,0
0,0,12,12,14,16,30,38,28,66,0.000333,0.107952,7,2266.983455,125.943525,323.854779,117.302969,2,0
0,0,12,12,14,17,31,40,28,68,0.000333,0.112295,7,2358.197444,131.010969,336.885349,122.789837,3,0
0,0,12,12,14,16,30,38,28,66,0.000333,0.107952,7,2266.983455,125.943525,323.854779,117.302969,2,0
0,0,12,12,14,17,31,40,28,68,0.000333,0.112295,7,2358.197444,131.010969,336.885349,122.789837,3,0
0,0,14,14,13,19,32,45,35,80,0.000333,0.133333,6,2400,133.333333,400,128.816339,2,0
0,0,13,13,13,20,33,46,33,79,0.000333,0.132836,6,2391.042813,132.835712,398.507135,134.544278,3,0
0,0,11,11,12,20,32,42,29,71,0.000333,0.118333,6,2130,118.333333,355,129.458112,3,0
0,0,16,16,13,18,31,63,41,104,0.000333,0.171745,12,6182.836995,343.490944,515.236416,123.164366,4,0
0,0,16,16,14,17,31,56,39,95,0.000333,0.156883,14,6589.081093,366.060061,470.648649,122.789837,2,0
0,0,13,13,14,18,32,47,31,78,0.000333,0.13,7,2730,151.666667,390,128.361619,3,0
0,0,15,15,14,17,31,53,37,90,0.000333,0.148626,14,6242.287351,346.793742,445.877668,122.789837,2,0
0,0,17,17,14,18,32,65,43,108,0.000333,0.18,14,7560,420,540,128.361619,4,0
0,0,11,11,13,18,31,43,27,70,0.000333,0.115598,6,2080.76245,115.597914,346.793742,123.164366,3,0
0,0,8,8,12,13,25,28,20,48,0.000333,0.074302,6,1337.430583,74.301699,222.905097,91.125266,2,0
0,0,7,7,7,12,19,18,21,39,0.000333,0.055223,3,497.007519,27.611529,165.669173,62.671034,1,0
0,0,14,14,13,20,33,49,44,93,0.000333,0.156376,12,5629.543837,312.752435,469.128653,134.544278,2,0
0,0,8,8,8,15,23,23,23,46,0.000333,0.069361,4,832.3354,46.240856,208.08385,82.603359,1,0
0,0,17,17,13,20,33,62,54,116,0.000333,0.19505,12,7021.796614,390.099812,585.149718,134.544278,2,0
0,0,9,9,13,16,29,39,29,68,0.000333,0.110114,6,1982.056246,110.114236,330.342708,112.105716,2,0
0,0,18,18,14,23,37,67,57,124,0.000333,0.215324,14,9043.611043,502.422836,645.972217,157.344894,2,0
0,0,9,9,13,17,30,39,30,69,0.000333,0.112858,6,2031.452707,112.858484,338.575451,117.592585,2,0
0,0,15,15,13,21,34,53,47,100,0.000333,0.169582,12,6104.95541,339.164189,508.746284,140.344382,2,0
0,0,8,8,13,17,30,29,33,62,0.000333,0.101409,6,1825.363302,101.409072,304.227217,117.592585,2,0
0,0,20,20,17,41,58,92,69,161,0.000333,0.314378,8,7545.079522,419.171085,943.13494,289.1465,7,0
0,0,19,19,17,41,58,91,67,158,0.000333,0.30852,8,7404.487978,411.360443,925.560997,289.1465,7,0
0,0,30,30,21,51,72,147,109,256,0.000333,0.5265,20,31590.01601,1755.000889,1579.5008,381.532358,8,0
0,0,29,29,21,51,72,146,107,253,0.000333,0.52033,20,31219.82051,1734.434473,1560.991025,381.532358,8,0
0,0,14,14,14,20,34,68,45,113,0.000333,0.191628,14,8048.366215,447.131456,574.883301,139.741531,5,0
0,0,15,15,15,21,36,75,47,122,0.000333,0.210244,14,8830.231902,490.568439,630.73085,150.842025,5,0
0,0,3,3,11,12,23,16,13,29,0.000333,0.043728,5,655.916484,36.439805,131.183297,81.073298,1,0
0,0,6,6,10,8,18,23,14,37,0.000333,0.051429,5,771.436125,42.857563,154.287225,57.219281,1,0
0,0,14,14,14,20,34,68,45,113,0.000333,0.191628,14,8048.366215,447.131456,574.883301,139.741531,5,0
0,0,3,3,11,12,23,16,13,29,0.000333,0.043728,5,655.916484,36.439805,131.183297,81.073298,1,0
0,0,3,3,11,12,23,16,13,29,0.000333,0.043728,5,655.916484,36.439805,131.183297,81.073298,1,0
0,0,15,15,16,21,37,77,48,125,0.000333,0.217061,16,10418.90673,578.828152,651.181671,156.238666,6,0
0,0,15,15,17,20,37,78,47,125,0.000333,0.217061,16,10418.90673,578.828152,651.181671,155.92543,6,0
0,0,15,15,17,20,37,78,47,125,0.000333,0.217061,16,10418.90673,578.828152,651.181671,155.92543,6,0
0,0,6,6,12,11,23,22,16,38,0.000333,0.057298,6,1031.372126,57.298451,171.895354,81.073298,2,0
0,0,6,6,12,11,23,22,16,38,0.000333,0.057298,6,1031.372126,57.298451,171.895354,81.073298,2,0
0,0,15,15,16,21,37,77,48,125,0.000333,0.217061,16,10418.90673,578.828152,651.181671,156.238666,6,0
0,0,17,17,16,22,38,90,54,144,0.000333,0.251901,16,12091.22499,671.734722,755.701562,162.107496,7,0
0,0,26,26,17,20,37,147,84,231,0.000333,0.401128,32,38508.27928,2139.348849,1203.383727,155.92543,11,0
0,0,8,8,12,11,23,35,22,57,0.000333,0.085948,12,3094.116378,171.895354,257.843031,81.073298,3,0
0,0,15,15,16,21,37,77,48,125,0.000333,0.217061,16,10418.90673,578.828152,651.181671,156.238666,6,0
0,0,11,11,14,18,32,52,40,92,0.000333,0.153333,14,6440,357.777778,460,128.361619,5,0
0,0,11,11,14,18,32,52,40,92,0.000333,0.153333,14,6440,357.777778,460,128.361619,5,0
0,0,8,8,12,16,28,27,29,56,0.000333,0.089737,6,1615.271254,89.737292,269.211876,107.01955,2,0
0,0,14,14,14,24,38,63,54,117,0.000333,0.204669,14,8596.105267,477.561404,614.007519,163.342069,6,0
0,0,8,8,12,16,28,27,29,56,0.000333,0.089737,6,1615.271254,89.737292,269.211876,107.01955,2,0
0,0,3,3,10,15,25,18,18,36,0.000333,0.055726,5,835.894114,46.438562,167.178823,91.82264,1,0
0,0,16,16,16,22,38,80,50,130,0.000333,0.22741,16,10915.68923,606.427179,682.230577,162.107496,6,0
0,0,7,7,12,12,24,25,18,43,0.000333,0.065718,6,1182.920325,65.717796,197.153388,86.0391,2,0
0,0,16,16,17,21,38,81,49,130,0.000333,0.22741,16,10915.68923,606.427179,682.230577,161.725534,6,0
0,0,10,10,15,22,37,42,44,86,0.000333,0.149338,14,6272.181852,348.454547,448.012989,156.710855,1,0
0,0,8,8,12,18,30,28,31,59,0.000333,0.096502,6,1737.039271,96.502182,289.506545,118.0782,1,0
0,0,7,7,12,14,26,24,24,48,0.000333,0.075207,6,1353.726639,75.207035,225.621106,96.322519,1,0
0,0,31,31,23,58,81,149,106,255,0.000333,0.538887,11,17783.27926,987.959959,1616.661751,443.804823,13,0
0,0,30,30,23,57,80,148,104,252,0.000333,0.531042,11,17524.38468,973.576927,1593.12588,436.516656,13,0
0,0,31,31,23,58,81,149,106,255,0.000333,0.538887,11,17783.27926,987.959959,1616.661751,443.804823,13,0
0,0,30,30,23,57,80,148,104,252,0.000333,0.531042,11,17524.38468,973.576927,1593.12588,436.516656,13,0
0,0,7,7,10,11,21,19,21,40,0.000333,0.058564,5,878.463485,48.803527,175.692697,71.273029,1,0
0,0,8,8,12,13,25,28,20,48,0.000333,0.074302,6,1337.430583,74.301699,222.905097,91.125266,2,0
0,0,8,8,12,13,25,28,20,48,0.000333,0.074302,6,1337.430583,74.301699,222.905097,91.125266,2,0
0,0,8,8,12,14,26,29,23,52,0.000333,0.081474,6,1466.537192,81.474288,244.422865,96.322519,2,0
0,0,21,21,21,29,50,78,75,153,0.000333,0.287837,20,17270.19994,959.455552,863.509997,233.120115,4,0
0,0,18,18,19,23,42,62,69,131,0.000333,0.235465,27,19072.62672,1059.590374,706.393582,184.752548,3,0
0,0,22,22,22,31,53,83,86,169,0.000333,0.322673,22,21296.40825,1183.133792,968.018557,251.687581,5,0
0,0,7,7,11,14,25,24,23,47,0.000333,0.072754,5,1091.306205,60.628122,218.261241,91.356717,1,0
0,0,6,6,10,10,20,17,15,32,0.000333,0.046101,5,691.508495,38.417139,138.301699,66.438562,1,0
0,0,7,7,12,15,27,25,24,49,0.000333,0.077663,6,1397.936926,77.663163,232.989488,101.622909,1,0
0,0,9,9,14,18,32,43,32,75,0.000333,0.125,7,2625,145.833333,375,128.361619,4,0
0,0,9,9,15,17,32,44,31,75,0.000333,0.125,7,2625,145.833333,375,128.090227,4,0
0,0,9,9,15,17,32,44,31,75,0.000333,0.125,7,2625,145.833333,375,128.090227,4,0
0,0,6,6,12,11,23,22,16,38,0.000333,0.057298,6,1031.372126,57.298451,171.895354,81.073298,2,0
0,0,6,6,12,11,23,22,16,38,0.000333,0.057298,6,1031.372126,57.298451,171.895354,81.073298,2,0
0,0,23,23,17,45,62,108,80,188,0.000333,0.37313,8,8955.111251,497.506181,1119.388906,316.620258,9,0
0,0,22,22,17,44,61,107,78,185,0.000333,0.365729,8,8777.49126,487.638403,1097.186407,309.70186,9,0
0,0,23,23,18,46,64,109,81,190,0.000333,0.38,9,10260,570,1140,329.1425,9,0
0,0,22,22,18,45,63,108,79,187,0.000333,0.372584,9,10059.76211,558.875673,1117.751346,322.192039,9,0
0,0,9,9,14,18,32,43,32,75,0.000333,0.125,7,2625,145.833333,375,128.361619,4,0
0,0,9,9,15,17,32,44,31,75,0.000333,0.125,7,2625,145.833333,375,128.090227,4,0
0,0,9,9,15,17,32,44,31,75,0.000333,0.125,7,2625,145.833333,375,128.090227,4,0
0,0,6,6,12,11,23,22,16,38,0.000333,0.057298,6,1031.372126,57.298451,171.895354,81.073298,2,0
0,0,6,6,12,11,23,22,16,38,0.000333,0.057298,6,1031.372126,57.298451,171.895354,81.073298,2,0
0,0,6,6,10,15,25,20,23,43,0.000333,0.066562,5,998.429081,55.468282,199.685816,91.82264,1,0
0,0,11,11,12,17,29,33,36,69,0.000333,0.111734,12,4022.408264,223.467126,335.200689,112.506418,2,0
0,0,11,11,13,19,32,34,37,71,0.000333,0.118333,6,2130,118.333333,355,128.816339,2,0
0,0,16,16,13,21,34,49,53,102,0.000333,0.172974,12,6227.054518,345.947473,518.92121,140.344382,2,0
0,0,11,11,13,19,32,39,38,77,0.000333,0.128333,12,4620,256.666667,385,128.816339,2,0
0,0,17,17,14,24,38,53,57,110,0.000333,0.192424,14,8081.808371,448.989354,577.272026,163.342069,2,0
0,0,11,11,13,20,33,39,39,78,0.000333,0.131154,6,2360.776448,131.154247,393.462741,134.544278,2,0
0,0,3,3,10,16,26,19,19,38,0.000333,0.059539,5,893.083546,49.615753,178.616709,97.219281,1,0
0,0,3,3,10,16,26,19,19,38,0.000333,0.059539,5,893.083546,49.615753,178.616709,97.219281,1,0
0,0,3,3,11,12,23,17,14,31,0.000333,0.046743,5,701.152103,38.952895,140.230421,81.073298,1,0
0,0,3,3,11,13,24,20,16,36,0.000333,0.05502,5,825.29325,45.849625,165.05865,86.159464,1,0
0,0,3,3,11,12,23,17,14,31,0.000333,0.046743,5,701.152103,38.952895,140.230421,81.073298,1,0
0,0,32,32,21,51,72,144,122,266,0.000333,0.547067,20,32824.00101,1823.555612,1641.20005,381.532358,8,0
0,0,31,31,21,51,72,143,120,263,0.000333,0.540897,20,32453.80551,1802.989195,1622.690275,381.532358,8,0
0,0,24,24,20,30,50,94,85,179,0.000333,0.33675,20,20205.00516,1122.500287,1010.250258,233.64528,7,0
0,0,14,14,16,20,36,43,57,100,0.000333,0.172331,16,8271.880002,459.548889,516.9925,150.438562,2,0
0,0,6,6,10,14,24,20,22,42,0.000333,0.064189,5,962.842125,53.491229,192.568425,86.52225,1,0
0,0,6,6,10,14,24,20,22,42,0.000333,0.064189,5,962.842125,53.491229,192.568425,86.52225,1,0
0,0,6,6,10,15,25,20,23,43,0.000333,0.066562,5,998.429081,55.468282,199.685816,91.82264,1,0
0,0,7,7,11,16,27,27,25,52,0.000333,0.082418,5,1236.270751,68.681708,247.25415,102.053748,1,0
0,0,3,3,11,11,22,16,13,29,0.000333,0.043108,5,646.617585,35.923199,129.323517,76.107496,1,0
0,0,6,6,10,15,25,20,23,43,0.000333,0.066562,5,998.429081,55.468282,199.685816,91.82264,1,0
0,0,6,6,10,15,25,20,23,43,0.000333,0.066562,5,998.429081,55.468282,199.685816,91.82264,1,0
0,0,15,15,16,21,37,77,48,125,0.000333,0.217061,16,10418.90673,578.828152,651.181671,156.238666,6,0
0,0,15,15,16,21,37,77,48,125,0.000333,0.217061,16,10418.90673,578.828152,651.181671,156.238666,6,0
0,0,5,5,9,13,22,18,19,37,0.000333,0.055,4,659.99588,36.666438,164.99897,76.635041,2,0
0,0,6,6,9,14,23,19,21,40,0.000333,0.060314,4,723.769913,40.20944,180.942478,81.832294,2,0
0,0,5,5,9,13,22,19,17,36,0.000333,0.053513,4,642.158153,35.675453,160.539538,76.635041,2,0
0,0,6,6,9,14,23,20,19,39,0.000333,0.058806,4,705.675665,39.204204,176.418916,81.832294,2,0
0,0,15,15,16,21,37,77,48,125,0.000333,0.217061,16,10418.90673,578.828152,651.181671,156.238666,6,0
0,0,15,15,17,20,37,78,47,125,0.000333,0.217061,16,10418.90673,578.828152,651.181671,155.92543,6,0
0,0,6,6,12,11,23,22,16,38,0.000333,0.057298,6,1031.372126,57.298451,171.895354,81.073298,2,0
0,0,6,6,10,15,25,20,23,43,0.000333,0.066562,5,998.429081,55.468282,199.685816,91.82264,1,0
0,0,5,5,10,8,18,16,12,28,0.000333,0.038919,5,583.7895,32.43275,116.7579,57.219281,1,0
0,0,3,3,12,18,30,21,20,41,0.000333,0.067061,6,1207.095087,67.060838,201.182514,118.0782,1,0
0,0,3,3,12,15,27,18,21,39,0.000333,0.061814,6,1112.643676,61.813538,185.440613,101.622909,1,0
0,0,7,7,10,11,21,21,22,43,0.000333,0.062957,10,1888.696492,104.927583,188.869649,71.273029,1,0
0,0,6,6,9,11,20,19,20,39,0.000333,0.056185,4,674.220783,37.45671,168.555196,66.583073,1,0
0,0,8,8,12,15,27,28,24,52,0.000333,0.082418,6,1483.524901,82.41805,247.25415,101.622909,2,0
0,0,9,9,11,16,27,30,37,67,0.000333,0.106192,10,3185.774626,176.987479,318.577463,102.053748,1,0
0,0,3,3,11,12,23,16,13,29,0.000333,0.043728,5,655.916484,36.439805,131.183297,81.073298,1,0
0,0,8,8,11,13,24,26,30,56,0.000333,0.085586,10,2567.579,142.643278,256.7579,86.159464,1,0
0,0,3,3,11,12,23,16,13,29,0.000333,0.043728,5,655.916484,36.439805,131.183297,81.073298,1,0
0,0,8,8,11,13,24,26,30,56,0.000333,0.085586,10,2567.579,142.643278,256.7579,86.159464,1,0
0,0,8,8,10,16,26,26,29,55,0.000333,0.086175,5,1292.620922,71.812273,258.524184,97.219281,1,0
0,0,3,3,11,12,23,16,13,29,0.000333,0.043728,5,655.916484,36.439805,131.183297,81.073298,1,0
0,0,7,7,10,9,19,22,18,40,0.000333,0.056639,10,1699.171005,94.398389,169.917101,61.748606,1,0
0,0,6,6,12,12,24,21,17,38,0.000333,0.058076,6,1045.37145,58.076192,174.228575,86.0391,2,0
0,0,6,6,12,12,24,21,17,38,0.000333,0.058076,6,1045.37145,58.076192,174.228575,86.0391,2,0
0,0,18,18,15,23,38,89,64,153,0.000333,0.267644,14,11241.06073,624.503374,802.93291,162.645284,5,0
0,0,9,9,11,15,26,37,33,70,0.000333,0.109677,10,3290.307803,182.794878,329.03078,96.657107,1,0
0,0,3,3,10,15,25,18,18,36,0.000333,0.055726,5,835.894114,46.438562,167.178823,91.82264,1,0
0,0,3,3,10,15,25,19,18,37,0.000333,0.057274,5,859.113395,47.728522,171.822679,91.82264,1,0
0,0,7,7,10,15,25,23,24,47,0.000333,0.072754,5,1091.306205,60.628122,218.261241,91.82264,1,0
0,0,15,15,16,20,36,52,49,101,0.000333,0.174054,16,8354.598802,464.144378,522.162425,150.438562,2,0
0,0,16,16,17,22,39,57,54,111,0.000333,0.19556,16,9386.874341,521.493019,586.679646,167.594364,2,0
0,0,11,11,14,17,31,35,32,67,0.000333,0.110644,7,2323.51807,129.084337,331.931153,122.789837,2,0
0,0,12,12,15,19,34,40,36,76,0.000333,0.128882,7,2706.530232,150.362791,386.647176,139.313982,2,0
0,0,4,4,10,13,23,19,19,38,0.000333,0.057298,5,859.476772,47.74871,171.895354,81.324997,2,0
0,0,20,20,14,22,36,86,74,160,0.000333,0.275729,21,17370.94801,965.052667,827.188,151.410465,5,0
0,0,11,11,10,14,24,34,48,82,0.000333,0.125322,15,5639.503876,313.305771,375.966925,86.52225,1,0
0,0,16,16,14,20,34,74,54,128,0.000333,0.217065,14,9116.733412,506.48519,651.195244,139.741531,5,0
0,0,7,7,10,12,22,22,24,46,0.000333,0.068378,10,2051.338545,113.963252,205.133854,76.238831,1,0
0,0,12,12,14,19,33,55,42,97,0.000333,0.163102,14,6850.287214,380.571512,489.30623,134.013592,5,0
0,0,6,6,10,9,19,19,14,33,0.000333,0.046727,5,700.90804,38.939336,140.181608,61.748606,1,0
0,0,3,3,10,17,27,19,19,38,0.000333,0.060229,5,903.428625,50.190479,180.685725,102.706149,1,0
0,0,3,3,11,11,22,16,13,29,0.000333,0.043108,5,646.617585,35.923199,129.323517,76.107496,1,0
0,0,3,3,11,11,22,16,13,29,0.000333,0.043108,5,646.617585,35.923199,129.323517,76.107496,1,0
0,0,13,13,15,22,37,55,51,106,0.000333,0.184067,14,7730.828795,429.490489,552.202057,156.710855,4,0
0,0,10,10,13,18,31,34,37,71,0.000333,0.117249,12,4220.975256,234.498625,351.747938,123.164366,2,0
0,0,13,13,16,24,40,56,52,108,0.000333,0.191589,16,9196.291748,510.905097,574.768234,174.0391,4,0
0,0,7,7,10,16,26,25,22,47,0.000333,0.07364,5,1104.603334,61.366852,220.920667,97.219281,3,0
0,0,5,5,10,11,21,18,14,32,0.000333,0.046851,5,702.770788,39.042822,140.554158,71.273029,2,0
0,0,6,6,14,15,29,35,21,56,0.000333,0.090682,7,1904.32855,105.796031,272.046936,111.906328,4,0
0,0,6,6,10,12,22,19,15,34,0.000333,0.05054,5,758.103375,42.116854,151.620675,76.238831,3,0
0,0,7,7,11,13,24,26,19,45,0.000333,0.068774,5,1031.616563,57.312031,206.323313,86.159464,3,0
0,0,8,8,14,19,33,44,29,73,0.000333,0.122747,7,2577.685395,143.204744,368.240771,134.013592,4,0
0,0,11,11,19,27,46,67,45,112,0.000333,0.206213,9,5567.750452,309.31947,618.638939,209.092585,5,0
0,0,7,7,10,16,26,25,22,47,0.000333,0.07364,5,1104.603334,61.366852,220.920667,97.219281,3,0
0,0,5,5,10,11,21,18,14,32,0.000333,0.046851,5,702.770788,39.042822,140.554158,71.273029,2,0
0,0,6,6,14,15,29,35,21,56,0.000333,0.090682,7,1904.32855,105.796031,272.046936,111.906328,4,0
0,0,6,6,10,12,22,19,15,34,0.000333,0.05054,5,758.103375,42.116854,151.620675,76.238831,3,0
0,0,7,7,11,13,24,26,19,45,0.000333,0.068774,5,1031.616563,57.312031,206.323313,86.159464,3,0
0,0,8,8,14,19,33,44,29,73,0.000333,0.122747,7,2577.685395,143.204744,368.240771,134.013592,4,0
0,0,11,11,19,27,46,67,45,112,0.000333,0.206213,9,5567.750452,309.31947,618.638939,209.092585,5,0
0,0,36,36,20,59,79,158,133,291,0.000333,0.611467,20,36688.00395,2038.222442,1834.400198,433.514502,11,0
0,0,35,35,20,59,79,157,131,288,0.000333,0.605163,20,36309.77711,2017.209839,1815.488855,433.514502,11,0
0,0,36,36,23,62,85,161,140,301,0.000333,0.643076,22,42442.98678,2357.94371,1929.226672,473.202096,12,0
0,0,35,35,23,62,85,160,138,298,0.000333,0.636666,22,42019.96698,2334.44261,1909.998499,473.202096,12,0
0,0,32,32,20,57,77,148,113,261,0.000333,0.54521,10,16356.31287,908.684048,1635.631287,418.913293,11,0
0,0,31,31,20,57,77,147,111,258,0.000333,0.538944,10,16168.30928,898.239404,1616.830927,418.913293,11,0
0,0,32,32,23,60,83,151,116,267,0.000333,0.567379,11,18723.49081,1040.193934,1702.135528,458.455361,12,0
0,0,31,31,23,60,83,150,114,264,0.000333,0.561003,11,18513.11451,1028.506362,1683.01041,458.455361,12,0
0,0,14,14,16,26,42,65,52,117,0.000333,0.2103,16,10094.41822,560.801012,630.901138,186.211433,6,0
0,0,7,7,12,15,27,23,25,48,0.000333,0.076078,6,1369.407601,76.0782,228.2346,101.622909,2,0
0,0,3,3,11,11,22,16,13,29,0.000333,0.043108,5,646.617585,35.923199,129.323517,76.107496,1,0
0,0,8,8,14,16,30,34,26,60,0.000333,0.098138,7,2060.89405,114.494114,294.413436,117.302969,8,0
0,0,16,16,14,21,35,74,51,125,0.000333,0.21372,14,8976.24528,498.680293,641.160377,145.541635,5,0
0,0,3,3,11,13,24,17,14,31,0.000333,0.047378,5,710.669188,39.481622,142.133838,86.159464,1,0
0,0,7,7,10,9,19,22,18,40,0.000333,0.056639,10,1699.171005,94.398389,169.917101,61.748606,1,0
0,0,12,12,13,19,32,55,45,100,0.000333,0.166667,12,6000,333.333333,500,128.816339,3,0
0,0,9,9,11,14,25,37,31,68,0.000333,0.105261,10,3157.822209,175.434567,315.782221,91.356717,1,0
0,0,14,14,12,19,31,52,58,110,0.000333,0.181654,18,9809.308695,544.961594,544.961594,123.730173,3,0
0,0,11,11,10,14,24,34,48,82,0.000333,0.125322,15,5639.503876,313.305771,375.966925,86.52225,1,0
0,0,11,11,13,17,30,44,40,84,0.000333,0.137393,12,4946.14572,274.785873,412.17881,117.592585,3,0
0,0,8,8,11,12,23,26,26,52,0.000333,0.078408,10,2352.252217,130.680679,235.225222,81.073298,1,0
0,0,8,8,9,15,24,32,26,58,0.000333,0.088643,4,1063.7113,59.095072,265.927825,87.132684,1,0
0,0,8,8,10,17,27,33,26,59,0.000333,0.093513,5,1402.691813,77.927323,280.538363,102.706149,1,0
0,0,13,13,14,21,35,61,48,109,0.000333,0.186364,14,7827.285884,434.849216,559.091849,145.541635,3,0
0,0,6,6,10,15,25,20,23,43,0.000333,0.066562,5,998.429081,55.468282,199.685816,91.82264,1,0
0,0,3,3,11,13,24,17,14,31,0.000333,0.047378,5,710.669188,39.481622,142.133838,86.159464,1,0
0,0,3,3,11,13,24,17,14,31,0.000333,0.047378,5,710.669188,39.481622,142.133838,86.159464,1,0
0,0,5,5,10,8,18,16,12,28,0.000333,0.038919,5,583.7895,32.43275,116.7579,57.219281,1,0
0,0,6,6,10,15,25,20,23,43,0.000333,0.066562,5,998.429081,55.468282,199.685816,91.82264,1,0
0,0,6,6,10,15,25,20,23,43,0.000333,0.066562,5,998.429081,55.468282,199.685816,91.82264,1,0
0,0,6,6,10,15,25,20,23,43,0.000333,0.066562,5,998.429081,55.468282,199.685816,91.82264,1,0
0,0,3,3,11,13,24,17,14,31,0.000333,0.047378,5,710.669188,39.481622,142.133838,86.159464,1,0
0,0,5,5,10,8,18,16,12,28,0.000333,0.038919,5,583.7895,32.43275,116.7579,57.219281,1,0
0,0,3,3,11,13,24,17,14,31,0.000333,0.047378,5,710.669188,39.481622,142.133838,86.159464,1,0
0,0,5,5,10,8,18,16,12,28,0.000333,0.038919,5,583.7895,32.43275,116.7579,57.219281,1,0
0,0,10,10,15,16,31,42,28,70,0.000333,0.115598,7,2427.556192,134.864233,346.793742,122.603359,3,0
0,0,10,10,15,16,31,42,28,70,0.000333,0.115598,7,2427.556192,134.864233,346.793742,122.603359,3,0
0,0,8,8,10,16,26,26,35,61,0.000333,0.095576,10,2867.268228,159.292679,286.726823,97.219281,1,0
0,0,7,7,10,13,23,22,26,48,0.000333,0.072377,10,2171.309739,120.628319,217.130974,81.324997,1,0
0,0,3,3,10,15,25,18,18,36,0.000333,0.055726,5,835.894114,46.438562,167.178823,91.82264,1,0
0,0,12,12,10,18,28,38,59,97,0.000333,0.155438,15,6994.701412,388.594523,466.313427,108.277931,1,0
0,0,11,11,10,15,25,34,54,88,0.000333,0.13622,15,6129.890171,340.549454,408.659345,91.82264,1,0
0,0,3,3,10,15,25,18,18,36,0.000333,0.055726,5,835.894114,46.438562,167.178823,91.82264,1,0
0,0,14,14,10,19,29,44,71,115,0.000333,0.186223,15,8380.017217,465.556512,558.667814,113.929904,1,0
0,0,13,13,10,16,26,40,68,108,0.000333,0.169216,20,10152.94979,564.052766,507.64749,97.219281,1,0
0,0,3,3,10,15,25,18,18,36,0.000333,0.055726,5,835.894114,46.438562,167.178823,91.82264,1,0
0,0,3,3,11,12,23,17,14,31,0.000333,0.046743,5,701.152103,38.952895,140.230421,81.073298,1,0
0,0,3,3,10,16,26,19,19,38,0.000333,0.059539,5,893.083546,49.615753,178.616709,97.219281,1,0
0,0,3,3,12,16,28,20,19,39,0.000333,0.062496,6,1124.921052,62.495614,187.486842,107.01955,1,0
0,0,12,12,15,17,32,56,40,96,0.000333,0.16,14,6720,373.333333,480,128.090227,5,0
0,0,6,6,10,10,20,20,15,35,0.000333,0.050422,5,756.337417,42.018745,151.267483,66.438562,1,0
0,0,6,6,12,11,23,22,16,38,0.000333,0.057298,6,1031.372126,57.298451,171.895354,81.073298,2,0
0,0,9,9,11,16,27,30,37,67,0.000333,0.106192,10,3185.774626,176.987479,318.577463,102.053748,1,0
0,0,3,3,11,12,23,17,14,31,0.000333,0.046743,5,701.152103,38.952895,140.230421,81.073298,1,0
0,0,8,8,11,13,24,26,30,56,0.000333,0.085586,10,2567.579,142.643278,256.7579,86.159464,1,0
0,0,3,3,11,12,23,17,14,31,0.000333,0.046743,5,701.152103,38.952895,140.230421,81.073298,1,0
0,0,8,8,11,13,24,26,30,56,0.000333,0.085586,10,2567.579,142.643278,256.7579,86.159464,1,0
0,0,7,7,11,16,27,27,25,52,0.000333,0.082418,5,1236.270751,68.681708,247.25415,102.053748,1,0
0,0,3,3,11,12,23,17,14,31,0.000333,0.046743,5,701.152103,38.952895,140.230421,81.073298,1,0
0,0,6,6,10,8,18,23,14,37,0.000333,0.051429,5,771.436125,42.857563,154.287225,57.219281,1,0
0,0,15,15,15,20,35,72,46,118,0.000333,0.201752,14,8473.575544,470.754197,605.255396,145.041921,5,0
0,0,6,6,10,11,21,20,16,36,0.000333,0.052708,5,790.617136,43.923174,158.123427,71.273029,1,0
0,0,8,8,10,16,26,22,28,50,0.000333,0.078341,5,1175.10993,65.283885,235.021986,97.219281,2,0
0,0,16,16,14,21,35,74,57,131,0.000333,0.223979,14,9407.105053,522.616947,671.936075,145.541635,5,0
0,0,7,7,10,13,23,22,26,48,0.000333,0.072377,10,2171.309739,120.628319,217.130974,81.324997,1,0
0,0,28,28,24,54,78,136,95,231,0.000333,0.483976,12,17423.13495,967.951942,1451.927913,420.803025,11,0
0,0,27,27,24,53,77,135,93,228,0.000333,0.476276,12,17145.92798,952.551554,1428.827331,413.618884,11,0
0,0,28,28,24,54,78,136,95,231,0.000333,0.483976,12,17423.13495,967.951942,1451.927913,420.803025,11,0
0,0,27,27,24,53,77,135,93,228,0.000333,0.476276,12,17145.92798,952.551554,1428.827331,413.618884,11,0
0,0,30,30,24,54,78,140,98,238,0.000333,0.498642,12,17951.10874,997.283819,1495.925728,420.803025,11,0
0,0,29,29,24,53,77,139,96,235,0.000333,0.490898,12,17672.33805,981.796558,1472.694837,413.618884,11,0
0,0,30,30,24,54,78,140,98,238,0.000333,0.498642,12,17951.10874,997.283819,1495.925728,420.803025,11,0
0,0,29,29,24,53,77,139,96,235,0.000333,0.490898,12,17672.33805,981.796558,1472.694837,413.618884,11,0
0,0,30,30,24,54,78,141,98,239,0.000333,0.500737,12,18026.53356,1001.474087,1502.21113,420.803025,11,0
0,0,29,29,24,53,77,140,96,236,0.000333,0.492987,12,17747.53948,985.974416,1478.961624,413.618884,11,0
0,0,30,30,24,54,78,141,98,239,0.000333,0.500737,12,18026.53356,1001.474087,1502.21113,420.803025,11,0
0,0,29,29,24,53,77,140,96,236,0.000333,0.492987,12,17747.53948,985.974416,1478.961624,413.618884,11,0
0,0,28,28,23,53,76,136,95,231,0.000333,0.48109,11,15875.98381,881.999101,1443.271256,407.621709,11,0
0,0,27,27,23,52,75,135,93,228,0.000333,0.47339,11,15621.87728,867.882071,1420.170661,400.46479,11,0
0,0,29,29,25,55,80,143,102,245,0.000333,0.516291,12,18586.4686,1032.581589,1548.872383,434.071189,11,0
0,0,28,28,25,54,79,142,100,242,0.000333,0.508505,12,18306.17929,1017.009961,1525.514941,426.86033,11,0
0,0,17,17,12,22,34,52,77,129,0.000333,0.218761,18,11813.08872,656.282707,656.282707,141.127046,2,0
0,0,11,11,14,18,32,52,40,92,0.000333,0.153333,14,6440,357.777778,460,128.361619,5,0
0,0,11,11,14,18,32,52,40,92,0.000333,0.153333,14,6440,357.777778,460,128.361619,5,0
0,0,5,5,10,8,18,16,12,28,0.000333,0.038919,5,583.7895,32.43275,116.7579,57.219281,1,0
0,0,5,5,10,8,18,16,12,28,0.000333,0.038919,5,583.7895,32.43275,116.7579,57.219281,1,0
0,0,9,9,12,16,28,31,31,62,0.000333,0.099352,6,1788.336031,99.352002,298.056005,107.01955,1,0
0,0,8,8,11,9,20,27,24,51,0.000333,0.073473,10,2204.183328,122.454629,220.418333,66.583073,1,0
0,0,8,8,11,9,20,27,24,51,0.000333,0.073473,10,2204.183328,122.454629,220.418333,66.583073,1,0
0,0,8,8,10,16,26,26,29,55,0.000333,0.086175,5,1292.620922,71.812273,258.524184,97.219281,1,0
0,0,7,7,10,9,19,22,18,40,0.000333,0.056639,10,1699.171005,94.398389,169.917101,61.748606,1,0
0,0,9,9,11,16,27,30,37,67,0.000333,0.106192,10,3185.774626,176.987479,318.577463,102.053748,1,0
0,0,8,8,11,13,24,26,30,56,0.000333,0.085586,10,2567.579,142.643278,256.7579,86.159464,1,0
0,0,8,8,11,13,24,26,30,56,0.000333,0.085586,10,2567.579,142.643278,256.7579,86.159464,1,0
0,0,14,14,19,21,40,57,48,105,0.000333,0.186267,18,10058.4441,558.80245,558.80245,172.949289,2,0
0,0,13,13,19,21,40,55,46,101,0.000333,0.179172,18,9675.265277,537.514738,537.514738,172.949289,2,0
0,0,8,8,12,14,26,26,22,48,0.000333,0.075207,6,1353.726639,75.207035,225.621106,96.322519,2,0
0,0,8,8,12,14,26,26,22,48,0.000333,0.075207,6,1353.726639,75.207035,225.621106,96.322519,2,0
0,0,12,12,10,15,25,44,40,84,0.000333,0.130028,10,3900.839199,216.713289,390.08392,91.82264,1,0
0,0,12,12,11,17,28,45,41,86,0.000333,0.137811,10,4134.325233,229.684735,413.432523,107.540616,1,0
0,0,14,14,14,18,32,57,49,106,0.000333,0.176667,14,7420,412.222222,530,128.361619,2,0
0,0,11,11,13,12,25,44,35,79,0.000333,0.122288,12,4402.375668,244.576426,366.864639,91.125266,3,0
0,0,9,9,13,12,25,32,27,59,0.000333,0.091329,12,3287.850182,182.658343,273.987515,91.125266,2,0
0,0,23,23,19,43,62,102,79,181,0.000333,0.359237,9,9699.38579,538.854766,1077.709532,314.040007,7,0
0,0,19,19,19,39,58,95,68,163,0.000333,0.318284,9,8593.65812,477.425451,954.850902,286.841309,7,0
0,0,23,23,19,42,61,103,80,183,0.000333,0.361775,9,9767.924395,542.662466,1085.324933,307.187955,7,0
0,0,19,19,19,40,59,95,69,164,0.000333,0.321584,9,8682.781141,482.37673,964.75346,293.587747,7,0
0,0,28,28,23,52,75,137,95,232,0.000333,0.481695,11,15895.9453,883.108072,1445.085936,400.46479,10,0
0,0,27,27,23,51,74,136,93,229,0.000333,0.473988,11,15641.61303,868.978502,1421.964821,393.335617,10,0
0,0,29,29,23,52,75,140,101,241,0.000333,0.500382,11,16512.59835,917.366575,1501.145304,400.46479,10,0
0,0,28,28,23,52,75,139,99,238,0.000333,0.494153,11,16307.04733,905.947074,1482.458848,400.46479,10,0
0,0,29,29,20,52,72,136,102,238,0.000333,0.489481,10,14684.4215,815.801195,1468.44215,382.861427,9,0
0,0,28,28,20,52,72,135,100,235,0.000333,0.483311,10,14499.32375,805.517986,1449.932375,382.861427,9,0
0,0,29,29,23,55,78,139,107,246,0.000333,0.515403,11,17008.2984,944.905467,1546.208946,422.016709,10,0
0,0,28,28,23,55,78,138,105,243,0.000333,0.509118,11,16800.88013,933.38223,1527.352739,422.016709,10,0
0,0,29,29,23,55,78,139,107,246,0.000333,0.515403,11,17008.2984,944.905467,1546.208946,422.016709,10,0
0,0,28,28,23,55,78,138,105,243,0.000333,0.509118,11,16800.88013,933.38223,1527.352739,422.016709,10,0
0,0,5,5,9,13,22,19,17,36,0.000333,0.053513,4,642.158153,35.675453,160.539538,76.635041,2,0
0,0,6,6,9,14,23,20,19,39,0.000333,0.058806,4,705.675665,39.204204,176.418916,81.832294,2,0
0,0,9,9,12,15,27,29,27,56,0.000333,0.088758,6,1597.642201,88.7579,266.2737,101.622909,2,0
0,0,15,15,14,21,35,70,50,120,0.000333,0.205171,14,8617.195468,478.733082,615.513962,145.541635,5,0
0,0,6,6,10,13,23,18,18,36,0.000333,0.054283,5,814.241152,45.23562,162.84823,81.324997,1,0
0,0,3,3,10,16,26,16,17,33,0.000333,0.051705,5,775.572553,43.087364,155.114511,97.219281,1,0
0,0,3,3,12,18,30,21,20,41,0.000333,0.067061,6,1207.095087,67.060838,201.182514,118.0782,1,0
0,0,15,15,15,19,34,72,45,117,0.000333,0.198411,14,8333.264134,462.959119,595.233152,139.313982,5,0
0,0,6,6,10,10,20,20,15,35,0.000333,0.050422,5,756.337417,42.018745,151.267483,66.438562,1,0
0,0,5,5,9,13,22,18,19,37,0.000333,0.055,4,659.99588,36.666438,164.99897,76.635041,2,0
0,0,6,6,9,14,23,19,21,40,0.000333,0.060314,4,723.769913,40.20944,180.942478,81.832294,2,0
0,0,14,14,14,19,33,68,44,112,0.000333,0.188324,14,7909.609979,439.422777,564.972141,134.013592,5,0
0,0,5,5,10,8,18,16,12,28,0.000333,0.038919,5,583.7895,32.43275,116.7579,57.219281,1,0
0,0,8,8,12,16,28,34,28,62,0.000333,0.099352,6,1788.336031,99.352002,298.056005,107.01955,3,0
0,0,5,5,10,8,18,16,12,28,0.000333,0.038919,5,583.7895,32.43275,116.7579,57.219281,1,0
0,0,8,8,12,16,28,34,28,62,0.000333,0.099352,6,1788.336031,99.352002,298.056005,107.01955,3,0
0,0,3,3,10,16,26,19,19,38,0.000333,0.059539,5,893.083546,49.615753,178.616709,97.219281,1,0
0,0,10,10,10,18,28,37,42,79,0.000333,0.126594,10,3797.810388,210.989466,379.781039,108.277931,1,0
0,0,11,11,12,22,34,40,40,80,0.000333,0.135666,6,2441.982164,135.665676,406.997027,141.127046,2,0
0,0,9,9,10,15,25,33,33,66,0.000333,0.102165,10,3064.945085,170.274727,306.494509,91.82264,1,0
0,0,8,8,10,16,26,27,24,51,0.000333,0.079907,5,1198.612128,66.589563,239.722426,97.219281,1,0
0,0,10,10,10,16,26,37,36,73,0.000333,0.114377,10,3431.320994,190.628944,343.132099,97.219281,1,0
0,0,12,12,13,22,35,48,46,94,0.000333,0.160718,12,5785.831243,321.435069,482.152604,146.213212,3,0
0,0,7,7,8,16,24,19,23,42,0.000333,0.064189,4,770.2737,42.792983,192.568425,88,1,0
0,0,3,3,10,16,26,21,19,40,0.000333,0.062673,5,940.087944,52.227108,188.017589,97.219281,1,0
0,0,9,9,8,16,24,29,35,64,0.000333,0.097813,8,2347.5008,130.416711,293.4376,88,1,0
0,0,3,3,10,15,25,16,17,33,0.000333,0.051082,5,766.236271,42.568682,153.247254,91.82264,1,0
0,0,14,14,14,20,34,68,45,113,0.000333,0.191628,14,8048.366215,447.131456,574.883301,139.741531,5,0
0,0,5,5,10,8,18,16,12,28,0.000333,0.038919,5,583.7895,32.43275,116.7579,57.219281,1,0
0,0,14,14,14,20,34,68,45,113,0.000333,0.191628,14,8048.366215,447.131456,574.883301,139.741531,5,0
0,0,14,14,14,20,34,68,45,113,0.000333,0.191628,14,8048.366215,447.131456,574.883301,139.741531,5,0
0,0,5,5,10,8,18,16,12,28,0.000333,0.038919,5,583.7895,32.43275,116.7579,57.219281,1,0
0,0,5,5,10,8,18,16,12,28,0.000333,0.038919,5,583.7895,32.43275,116.7579,57.219281,1,0
0,0,11,11,14,18,32,52,40,92,0.000333,0.153333,14,6440,357.777778,460,128.361619,5,0
0,0,11,11,14,18,32,52,40,92,0.000333,0.153333,14,6440,357.777778,460,128.361619,5,0
0,0,3,3,11,11,22,16,13,29,0.000333,0.043108,5,646.617585,35.923199,129.323517,76.107496,1,0
0,0,3,3,11,11,22,16,13,29,0.000333,0.043108,5,646.617585,35.923199,129.323517,76.107496,1,0
0,0,3,3,11,13,24,17,14,31,0.000333,0.047378,5,710.669188,39.481622,142.133838,86.159464,1,0
0,0,3,3,11,13,24,17,14,31,0.000333,0.047378,5,710.669188,39.481622,142.133838,86.159464,1,0
0,0,3,3,11,13,24,17,14,31,0.000333,0.047378,5,710.669188,39.481622,142.133838,86.159464,1,0
0,0,10,10,11,18,29,41,42,83,0.000333,0.134404,10,4032.124226,224.006901,403.212423,113.112398,1,0
0,0,9,9,11,15,26,37,33,70,0.000333,0.109677,10,3290.307803,182.794878,329.03078,96.657107,1,0
0,0,17,17,13,22,35,68,54,122,0.000333,0.208591,12,7509.270337,417.181685,625.772528,146.213212,2,0
0,0,16,16,13,22,35,67,52,119,0.000333,0.203462,12,7324.616148,406.923119,610.384679,146.213212,2,0
0,0,14,14,9,18,27,46,40,86,0.000333,0.136307,8,3271.362601,181.742367,408.920325,103.587975,1,0
0,0,17,17,14,21,35,59,48,107,0.000333,0.182944,14,7683.665959,426.870331,548.833283,145.541635,2,0
0,0,10,10,12,18,30,38,29,67,0.000333,0.109587,6,1972.570019,109.587223,328.76167,118.0782,2,0
0,0,16,16,13,21,34,60,50,110,0.000333,0.18654,12,6715.45095,373.080608,559.620913,140.344382,2,0
0,0,15,15,13,21,34,59,48,107,0.000333,0.181453,12,6532.302288,362.905683,544.358524,140.344382,2,0
0,0,13,13,9,17,26,38,36,74,0.000333,0.115944,8,2782.660313,154.59224,347.832539,98.016193,1,0
0,0,16,16,14,20,34,51,44,95,0.000333,0.161103,14,6766.325579,375.906977,483.30897,139.741531,2,0
0,0,10,10,12,18,30,38,29,67,0.000333,0.109587,6,1972.570019,109.587223,328.76167,118.0782,2,0
0,0,15,15,12,20,32,55,47,102,0.000333,0.17,12,6120,340,510,129.458112,2,0
0,0,14,14,12,20,32,54,45,99,0.000333,0.165,12,5940,330,495,129.458112,2,0
0,0,12,12,7,16,23,33,33,66,0.000333,0.099518,6,1791.330535,99.518363,298.555089,83.651484,1,0
0,0,15,15,13,19,32,46,41,87,0.000333,0.145,12,5220,290,435,128.816339,2,0
0,0,10,10,12,17,29,37,29,66,0.000333,0.106876,6,1923.760474,106.875582,320.626746,112.506418,2,0
0,0,21,21,12,23,35,70,77,147,0.000333,0.251335,18,13572.08286,754.004603,754.004603,147.061475,2,0
0,0,20,20,12,23,35,69,75,144,0.000333,0.246206,18,13295.10158,738.616754,738.616754,147.061475,2,0
0,0,13,13,6,17,23,39,57,96,0.000333,0.144754,9,3908.35753,217.130974,434.261948,84.996643,1,0
0,0,16,16,12,20,32,52,65,117,0.000333,0.195,18,10530,585,585,129.458112,2,0
0,0,10,10,12,17,29,37,29,66,0.000333,0.106876,6,1923.760474,106.875582,320.626746,112.506418,2,0
0,0,18,18,15,22,37,89,61,150,0.000333,0.260473,14,10939.85207,607.769559,781.418005,156.710855,5,0
0,0,9,9,11,14,25,37,31,68,0.000333,0.105261,10,3157.822209,175.434567,315.782221,91.356717,1,0
0,0,6,6,7,13,20,15,22,37,0.000333,0.053304,3,479.734019,26.65189,159.91134,67.757201,1,0
0,0,7,7,9,16,25,18,27,45,0.000333,0.069658,4,835.894114,46.438562,208.973529,92.529325,1,0
0,0,6,6,8,15,23,16,21,37,0.000333,0.055791,4,669.487169,37.193732,167.371792,82.603359,1,0
0,0,12,12,11,19,30,39,50,89,0.000333,0.145571,10,4367.13263,242.618479,436.713263,118.764371,1,0
0,0,12,12,12,18,30,41,46,87,0.000333,0.1423,12,5122.793782,284.599655,426.899482,118.0782,2,0
0,0,20,20,17,43,60,94,71,165,0.000333,0.324879,8,7797.095586,433.171977,974.636948,302.816253,7,0
0,0,19,19,17,42,59,93,69,162,0.000333,0.317663,8,7623.905392,423.5503,952.988174,295.9642,7,0
0,0,14,14,14,19,33,68,44,112,0.000333,0.188324,14,7909.609979,439.422777,564.972141,134.013592,5,0
0,0,5,5,10,8,18,16,12,28,0.000333,0.038919,5,583.7895,32.43275,116.7579,57.219281,1,0
0,0,3,3,12,14,26,17,20,37,0.000333,0.057972,6,1043.497617,57.97209,173.91627,96.322519,1,0
0,0,19,19,13,19,32,61,70,131,0.000333,0.218333,18,11790,655,655,128.816339,2,0
0,0,18,18,13,19,32,59,68,127,0.000333,0.211667,18,11430,635,635,128.816339,2,0
0,0,19,19,16,24,40,98,65,163,0.000333,0.289158,16,13879.58847,771.088248,867.474279,174.0391,6,0
0,0,10,10,12,17,29,43,35,78,0.000333,0.126308,12,4547.070211,252.615012,378.922518,112.506418,2,0
0,0,19,19,17,26,43,99,66,165,0.000333,0.298445,16,14325.33895,795.852164,895.333685,191.698301,6,0
0,0,10,10,11,19,30,32,45,77,0.000333,0.125944,10,3778.305759,209.905875,377.830576,118.764371,1,0
0,0,9,9,10,16,26,28,36,64,0.000333,0.100276,10,3008.28142,167.126746,300.828142,97.219281,1,0
0,0,7,7,11,14,25,24,23,47,0.000333,0.072754,5,1091.306205,60.628122,218.261241,91.356717,1,0
0,0,6,6,10,10,20,20,15,35,0.000333,0.050422,5,756.337417,42.018745,151.267483,66.438562,1,0
0,0,20,20,14,23,37,86,81,167,0.000333,0.289993,21,18269.55295,1014.975164,869.978712,157.344894,5,0
0,0,11,11,10,15,25,34,54,88,0.000333,0.13622,15,6129.890171,340.549454,408.659345,91.82264,1,0
0,0,15,15,14,18,32,58,47,105,0.000333,0.175,14,7350,408.333333,525,128.361619,2,0
0,0,14,14,14,18,32,56,45,101,0.000333,0.168333,14,7070,392.777778,505,128.361619,2,0
0,0,18,18,14,21,35,80,64,144,0.000333,0.246206,21,15510.95184,861.719547,738.616754,145.541635,5,0
0,0,9,9,10,13,23,28,36,64,0.000333,0.096503,10,2895.079652,160.837758,289.507965,81.324997,1,0
0,0,14,14,14,17,31,49,43,92,0.000333,0.151929,14,6381.004848,354.500269,455.786061,122.789837,2,0
0,0,13,13,14,17,31,47,41,88,0.000333,0.145323,14,6103.569854,339.087214,435.969275,122.789837,2,0
0,0,11,11,14,17,31,52,39,91,0.000333,0.150277,14,6311.646099,350.647006,450.831864,122.789837,5,0
0,0,5,5,10,8,18,16,12,28,0.000333,0.038919,5,583.7895,32.43275,116.7579,57.219281,1,0
0,0,5,5,10,8,18,16,12,28,0.000333,0.038919,5,583.7895,32.43275,116.7579,57.219281,1,0
0,0,11,11,10,15,25,40,37,77,0.000333,0.119192,10,3575.769266,198.653848,357.576927,91.82264,1,0
0,0,12,12,11,17,28,45,41,86,0.000333,0.137811,10,4134.325233,229.684735,413.432523,107.540616,1,0
0,0,13,13,14,18,32,53,46,99,0.000333,0.165,14,6930,385,495,128.361619,2,0
0,0,12,12,18,22,40,54,39,93,0.000333,0.16498,9,4454.453815,247.469656,494.939313,173.166146,5,0
0,0,13,13,18,23,41,55,41,96,0.000333,0.171442,9,4628.924932,257.162496,514.324992,179.100575,5,0
0,0,13,13,18,23,41,57,41,98,0.000333,0.175013,9,4725.360868,262.520048,525.040096,179.100575,5,0
0,0,14,14,18,24,42,58,43,101,0.000333,0.181541,9,4901.616537,272.31203,544.62406,185.09775,5,0
0,0,3,3,11,13,24,17,14,31,0.000333,0.047378,5,710.669188,39.481622,142.133838,86.159464,1,0
0,0,3,3,11,12,23,16,13,29,0.000333,0.043728,5,655.916484,36.439805,131.183297,81.073298,1,0
0,0,11,11,12,15,27,42,35,77,0.000333,0.122042,12,4393.516052,244.084225,366.126338,101.622909,1,0
0,0,13,13,19,21,40,58,39,97,0.000333,0.172076,9,4646.043227,258.113513,516.227025,172.949289,6,0
0,0,14,14,19,22,41,59,41,100,0.000333,0.178585,9,4821.796804,267.8776,535.7552,178.818118,6,0
0,0,13,13,18,22,40,58,40,98,0.000333,0.17385,9,4693.94058,260.774477,521.548953,173.166146,6,0
0,0,14,14,18,23,41,59,42,101,0.000333,0.180371,9,4870.014772,270.556376,541.112752,179.100575,6,0
0,0,13,13,18,22,40,58,40,98,0.000333,0.17385,9,4693.94058,260.774477,521.548953,173.166146,6,0
0,0,14,14,18,23,41,59,42,101,0.000333,0.180371,9,4870.014772,270.556376,541.112752,179.100575,6,0
0,0,23,23,19,24,43,103,65,168,0.000333,0.303871,18,16409.02462,911.612479,911.612479,190.749723,9,0
0,0,23,23,19,24,43,103,65,168,0.000333,0.303871,18,16409.02462,911.612479,911.612479,190.749723,9,0
0,0,24,24,19,25,44,104,67,171,0.000333,0.311188,18,16804.13052,933.562807,933.562807,196.807027,9,0
0,0,24,24,19,25,44,104,67,171,0.000333,0.311188,18,16804.13052,933.562807,933.562807,196.807027,9,0
0,0,15,15,19,23,42,62,42,104,0.000333,0.186934,9,5047.209108,280.400506,560.801012,184.752548,6,0
0,0,16,16,19,24,43,63,44,107,0.000333,0.193537,9,5225.492959,290.305164,580.610329,190.749723,6,0
0,0,15,15,19,23,42,62,42,104,0.000333,0.186934,9,5047.209108,280.400506,560.801012,184.752548,6,0
0,0,16,16,19,24,43,63,44,107,0.000333,0.193537,9,5225.492959,290.305164,580.610329,190.749723,6,0
0,0,3,3,11,11,22,16,13,29,0.000333,0.043108,5,646.617585,35.923199,129.323517,76.107496,1,0
0,0,10,10,13,14,27,35,28,63,0.000333,0.099853,12,3594.694952,199.705275,299.557913,101.408685,2,0
0,0,12,12,14,25,39,59,45,104,0.000333,0.183227,7,3847.772815,213.765156,549.681831,169.399374,2,0
0,0,11,11,14,23,37,54,42,96,0.000333,0.166703,7,3500.752662,194.486259,500.107523,157.344894,2,0
0,0,8,8,14,22,36,44,33,77,0.000333,0.132695,7,2786.589576,154.810532,398.084225,151.410465,2,0
0,0,10,10,13,14,27,36,28,64,0.000333,0.101438,12,3651.753602,202.8752,304.3128,101.408685,2,0
0,0,8,8,12,13,25,28,20,48,0.000333,0.074302,6,1337.430583,74.301699,222.905097,91.125266,2,0
0,0,12,12,14,25,39,59,45,104,0.000333,0.183227,7,3847.772815,213.765156,549.681831,169.399374,2,0
0,0,11,11,14,23,37,54,42,96,0.000333,0.166703,7,3500.752662,194.486259,500.107523,157.344894,2,0
0,0,8,8,14,22,36,44,33,77,0.000333,0.132695,7,2786.589576,154.810532,398.084225,151.410465,2,0
0,0,32,32,22,51,73,143,103,246,0.000333,0.507566,22,33499.33051,1861.073917,1522.696841,387.401188,11,0
0,0,31,31,22,51,73,142,101,243,0.000333,0.501376,11,16545.40105,919.188947,1504.127368,387.401188,11,0
0,0,32,32,25,53,78,146,108,254,0.000333,0.532164,24,38315.81193,2128.656218,1596.492164,419.676189,12,0
0,0,31,31,25,53,78,145,106,251,0.000333,0.525879,24,37863.26297,2103.514609,1577.635957,419.676189,12,0
0,0,34,34,22,52,74,148,109,257,0.000333,0.531943,22,35108.24933,1950.458296,1595.829515,394.530361,11,0
0,0,33,33,22,52,74,147,107,254,0.000333,0.525734,22,34698.42541,1927.6903,1577.201155,394.530361,11,0
0,0,34,34,25,54,79,151,116,267,0.000333,0.561036,24,40394.62703,2244.145946,1683.10946,426.86033,12,0
0,0,33,33,25,54,79,150,114,264,0.000333,0.554733,24,39940.75482,2218.930823,1664.198118,426.86033,12,0
0,0,31,31,22,51,73,134,100,234,0.000333,0.482806,11,15932.60842,885.144912,1448.418947,387.401188,9,0
0,0,30,30,22,51,73,133,98,231,0.000333,0.476616,11,15728.3442,873.7969,1429.849473,387.401188,9,0
0,0,31,31,25,53,78,137,107,244,0.000333,0.511213,24,36807.31539,2044.850855,1533.638141,419.676189,10,0
0,0,30,30,25,53,78,136,105,241,0.000333,0.504927,12,18177.38322,1009.854623,1514.781935,419.676189,10,0
0,0,29,29,22,50,72,129,94,223,0.000333,0.458631,11,15134.82603,840.823668,1375.893275,380.300305,9,0
0,0,28,28,22,50,72,128,92,220,0.000333,0.452461,11,14931.2185,829.512139,1357.3835,380.300305,9,0
0,0,29,29,25,52,77,132,99,231,0.000333,0.482543,12,17371.53229,965.085127,1447.627691,412.51927,10,0
0,0,28,28,25,52,77,131,97,228,0.000333,0.476276,12,17145.92798,952.551554,1428.827331,412.51927,10,0
0,0,36,36,22,53,75,153,115,268,0.000333,0.556441,22,36725.115,2040.284167,1669.323409,401.68728,11,0
0,0,35,35,22,53,75,152,113,265,0.000333,0.550212,22,36314.01297,2017.445165,1650.636953,401.68728,11,0
0,0,36,36,25,55,80,156,124,280,0.000333,0.590047,24,42483.3568,2360.186489,1770.139867,434.071189,12,0
0,0,35,35,25,55,80,155,122,277,0.000333,0.583725,24,42028.17798,2334.898776,1751.174082,434.071189,12,0
0,0,38,38,22,54,76,158,121,279,0.000333,0.581057,22,38349.77908,2130.543282,1743.171776,408.871421,11,0
0,0,37,37,22,54,76,157,119,276,0.000333,0.574809,22,37937.41586,2107.634215,1724.427994,408.871421,11,0
0,0,38,38,25,56,81,161,132,293,0.000333,0.619192,24,44581.82522,2476.768068,1857.576051,441.30828,12,0
0,0,37,37,25,56,81,160,130,290,0.000333,0.612852,24,44125.35602,2451.408668,1838.556501,441.30828,12,0
0,0,3,3,11,12,23,16,13,29,0.000333,0.043728,5,655.916484,36.439805,131.183297,81.073298,1,0
0,0,3,3,11,12,23,17,14,31,0.000333,0.046743,5,701.152103,38.952895,140.230421,81.073298,1,0
0,0,17,17,15,25,40,77,60,137,0.000333,0.243035,14,10207.45809,567.081005,729.104149,174.699764,5,0
0,0,11,11,12,17,29,41,37,78,0.000333,0.126308,12,4547.070211,252.615012,378.922518,112.506418,1,0
0,0,11,11,12,15,27,42,35,77,0.000333,0.122042,12,4393.516052,244.084225,366.126338,101.622909,1,0
0,0,12,12,14,25,39,59,45,104,0.000333,0.183227,7,3847.772815,213.765156,549.681831,169.399374,2,0
0,0,11,11,14,23,37,54,42,96,0.000333,0.166703,7,3500.752662,194.486259,500.107523,157.344894,2,0
0,0,8,8,14,22,36,44,33,77,0.000333,0.132695,7,2786.589576,154.810532,398.084225,151.410465,2,0
0,0,3,3,11,13,24,17,14,31,0.000333,0.047378,5,710.669188,39.481622,142.133838,86.159464,1,0
0,0,10,10,13,15,28,34,30,64,0.000333,0.102557,12,3692.04858,205.11381,307.670715,106.709075,2,0
0,0,8,8,13,13,26,28,25,53,0.000333,0.083041,6,1494.73983,83.041102,249.123305,96.211433,2,0
0,0,7,7,11,9,20,23,20,43,0.000333,0.061948,10,1858.429081,103.24606,185.842908,66.583073,1,0
0,0,8,8,13,12,25,30,24,54,0.000333,0.083589,12,3009.218811,167.178823,250.768234,91.125266,2,0
0,0,3,3,11,12,23,17,14,31,0.000333,0.046743,5,701.152103,38.952895,140.230421,81.073298,1,0
0,0,5,5,10,8,18,16,12,28,0.000333,0.038919,5,583.7895,32.43275,116.7579,57.219281,1,0
0,0,8,8,12,13,25,28,26,54,0.000333,0.083589,12,3009.218811,167.178823,250.768234,91.125266,1,0
0,0,3,3,11,11,22,16,13,29,0.000333,0.043108,5,646.617585,35.923199,129.323517,76.107496,1,0
0,0,7,7,11,9,20,24,20,44,0.000333,0.063388,10,1901.648362,105.647131,190.164836,66.583073,1,0
0,0,3,3,11,11,22,16,13,29,0.000333,0.043108,5,646.617585,35.923199,129.323517,76.107496,1,0
0,0,15,15,14,23,37,58,49,107,0.000333,0.185804,14,7803.761142,433.542286,557.41151,157.344894,2,0
0,0,14,14,14,20,34,54,43,97,0.000333,0.164495,14,6908.774538,383.820808,493.483896,139.741531,2,0
0,0,31,31,25,56,81,143,103,246,0.000333,0.519868,12,18715.23721,1039.7354,1559.603101,441.30828,13,0
0,0,30,30,25,55,80,142,101,243,0.000333,0.512076,12,18434.74233,1024.152351,1536.228527,434.071189,13,0
0,0,31,31,25,56,81,143,103,246,0.000333,0.519868,12,18715.23721,1039.7354,1559.603101,441.30828,13,0
0,0,30,30,25,55,80,142,101,243,0.000333,0.512076,12,18434.74233,1024.152351,1536.228527,434.071189,13,0
0,0,28,28,25,52,77,130,92,222,0.000333,0.463742,12,16694.71934,927.484408,1391.226612,412.51927,11,0
0,0,27,27,25,51,76,129,90,219,0.000333,0.456099,12,16419.55351,912.197417,1368.296125,405.390097,11,0
0,0,28,28,25,52,77,130,92,222,0.000333,0.463742,12,16694.71934,927.484408,1391.226612,412.51927,11,0
0,0,27,27,25,51,76,129,90,219,0.000333,0.456099,12,16419.55351,912.197417,1368.296125,405.390097,11,0
0,0,28,28,25,53,78,130,93,223,0.000333,0.467215,12,16819.73634,934.429797,1401.644695,419.676189,11,0
0,0,27,27,25,52,77,129,91,220,0.000333,0.459564,12,16544.31647,919.128693,1378.693039,412.51927,11,0
0,0,28,28,25,53,78,130,93,223,0.000333,0.467215,12,16819.73634,934.429797,1401.644695,419.676189,11,0
0,0,27,27,25,52,77,129,91,220,0.000333,0.459564,12,16544.31647,919.128693,1378.693039,412.51927,11,0
0,0,13,13,18,23,41,57,40,97,0.000333,0.173228,9,4677.1429,259.841272,519.682544,179.100575,6,0
0,0,14,14,18,24,42,58,42,100,0.000333,0.179744,9,4853.085681,269.615871,539.231742,185.09775,6,0
0,0,13,13,18,23,41,57,40,97,0.000333,0.173228,9,4677.1429,259.841272,519.682544,179.100575,6,0
0,0,14,14,18,24,42,58,42,100,0.000333,0.179744,9,4853.085681,269.615871,539.231742,185.09775,6,0
0,0,3,3,11,11,22,16,13,29,0.000333,0.043108,5,646.617585,35.923199,129.323517,76.107496,1,0
0,0,7,7,11,9,20,24,20,44,0.000333,0.063388,10,1901.648362,105.647131,190.164836,66.583073,1,0
0,0,6,6,6,9,15,13,14,27,0.000333,0.035162,3,316.458138,17.581008,105.486046,44.0391,1,0
0,0,6,6,7,10,17,14,16,30,0.000333,0.040875,3,367.871656,20.437314,122.623885,52.870765,1,0
0,0,17,17,16,21,37,57,48,105,0.000333,0.182331,16,8751.881654,486.215647,546.992603,156.238666,3,0
0,0,16,16,18,21,39,57,48,105,0.000333,0.184989,18,9989.410194,554.967233,554.967233,167.297316,4,0
0,0,6,6,12,11,23,22,16,38,0.000333,0.057298,6,1031.372126,57.298451,171.895354,81.073298,2,0
0,0,8,8,13,12,25,29,24,53,0.000333,0.082041,12,2953.492537,164.082919,246.124378,91.125266,2,0
0,0,18,18,16,27,43,75,57,132,0.000333,0.238756,16,11460.27116,636.681731,716.266948,192.381963,4,0
0,0,19,19,16,27,43,76,59,135,0.000333,0.244182,16,11720.73187,651.151771,732.545742,192.381963,4,0
0,0,18,18,18,29,47,78,62,140,0.000333,0.259214,18,13997.56391,777.642439,777.642439,215.940099,5,0
0,0,19,19,18,29,47,79,64,143,0.000333,0.264769,18,14297.5117,794.306206,794.306206,215.940099,5,0
0,0,33,33,22,50,72,140,105,245,0.000333,0.503877,22,33255.89576,1847.549764,1511.631625,380.300305,9,0
0,0,32,32,22,50,72,139,103,242,0.000333,0.497707,22,32848.68071,1824.926706,1493.12185,380.300305,9,0
0,0,33,33,25,52,77,143,114,257,0.000333,0.536855,24,38653.53938,2147.418855,1610.564141,412.51927,10,0
0,0,32,32,25,52,77,142,112,254,0.000333,0.530588,24,38202.33075,2122.351708,1591.763781,412.51927,10,0
0,0,34,34,22,54,76,152,111,263,0.000333,0.547735,22,36150.50859,2008.361588,1643.204936,408.871421,11,0
0,0,33,33,22,54,76,151,109,260,0.000333,0.541487,22,35738.14538,1985.452521,1624.461153,408.871421,11,0
0,0,34,34,25,56,81,155,116,271,0.000333,0.5727,24,41234.38442,2290.799134,1718.099351,441.30828,12,0
0,0,33,33,25,56,81,154,114,268,0.000333,0.56636,24,40777.91522,2265.439734,1699.079801,441.30828,12,0
0,0,17,17,16,21,37,57,48,105,0.000333,0.182331,16,8751.881654,486.215647,546.992603,156.238666,3,0
0,0,36,36,25,57,82,160,121,281,0.000333,0.595491,24,42875.33072,2381.962818,1786.472113,448.571136,12,0
0,0,30,30,22,49,71,135,96,231,0.000333,0.473531,11,15626.50743,868.139302,1420.591585,373.228278,9,0
0,0,29,29,22,49,71,134,94,228,0.000333,0.467381,11,15423.56578,856.864765,1402.142343,373.228278,9,0
0,0,30,30,25,51,76,138,101,239,0.000333,0.497752,12,17919.05611,995.503117,1493.254676,405.390097,10,0
0,0,29,29,25,51,76,137,99,236,0.000333,0.491504,12,17694.13072,983.007262,1474.510893,405.390097,10,0
0,0,13,13,14,20,34,52,45,97,0.000333,0.164495,14,6908.774538,383.820808,493.483896,139.741531,2,0
0,0,12,12,14,17,31,48,39,87,0.000333,0.143672,14,6034.211106,335.23395,431.015079,122.789837,2,0
0,0,14,14,15,20,35,57,41,98,0.000333,0.167557,14,7037.376299,390.96535,502.669736,145.041921,4,0
0,0,15,15,15,20,35,58,43,101,0.000333,0.172686,14,7252.806186,402.933677,518.057585,145.041921,4,0
0,0,14,14,18,22,40,60,48,108,0.000333,0.191589,18,10345.82822,574.768234,574.768234,173.166146,5,0
0,0,15,15,18,22,40,61,50,111,0.000333,0.196911,18,10633.21233,590.734019,590.734019,173.166146,5,0
0,0,14,14,18,22,40,60,48,108,0.000333,0.191589,18,10345.82822,574.768234,574.768234,173.166146,5,0
0,0,15,15,18,22,40,61,50,111,0.000333,0.196911,18,10633.21233,590.734019,590.734019,173.166146,5,0
0,0,27,27,23,53,76,133,94,227,0.000333,0.47276,11,15601.075,866.726389,1418.279546,407.621709,10,0
0,0,26,26,23,52,75,132,92,224,0.000333,0.465085,11,15347.80925,852.65607,1395.255387,400.46479,10,0
0,0,13,13,18,21,39,58,40,98,0.000333,0.172656,9,4661.724757,258.984709,517.969417,167.297316,5,0
0,0,14,14,18,22,40,59,42,101,0.000333,0.179172,9,4837.632638,268.757369,537.514738,173.166146,5,0
0,0,7,7,11,9,20,23,20,43,0.000333,0.061948,10,1858.429081,103.24606,185.842908,66.583073,1,0
0,0,13,13,14,20,34,52,45,97,0.000333,0.164495,14,6908.774538,383.820808,493.483896,139.741531,2,0
0,0,12,12,14,18,32,47,40,87,0.000333,0.145,14,6090,338.333333,435,128.361619,2,0
0,0,17,17,15,21,36,95,61,156,0.000333,0.268836,14,11291.1162,627.284234,806.5083,150.842025,5,0
0,0,8,8,10,13,23,43,31,74,0.000333,0.111581,10,3347.435847,185.968658,334.743585,81.324997,1,0
0,0,23,23,17,27,44,106,71,177,0.000333,0.322106,16,15461.11034,858.950575,966.319396,197.868831,6,0
0,0,14,14,14,20,34,54,43,97,0.000333,0.164495,14,6908.774538,383.820808,493.483896,139.741531,2,0
0,0,11,11,12,15,27,42,35,77,0.000333,0.122042,12,4393.516052,244.084225,366.126338,101.622909,1,0
0,0,31,31,25,52,77,144,101,245,0.000333,0.511788,12,18424.35243,1023.575135,1535.362702,412.51927,13,0
0,0,30,30,25,51,76,143,99,242,0.000333,0.503999,12,18143.9815,1007.998972,1511.998458,405.390097,13,0
0,0,32,32,25,53,78,147,110,257,0.000333,0.538449,24,38768.36089,2153.797827,1615.34837,419.676189,12,0
0,0,31,31,25,53,78,146,108,254,0.000333,0.532164,24,38315.81193,2128.656218,1596.492164,419.676189,12,0
0,0,32,32,25,53,78,147,110,257,0.000333,0.538449,24,38768.36089,2153.797827,1615.34837,419.676189,12,0
0,0,31,31,25,53,78,146,108,254,0.000333,0.532164,24,38315.81193,2128.656218,1596.492164,419.676189,12,0
0,0,32,32,25,53,78,145,106,251,0.000333,0.525879,24,37863.26297,2103.514609,1577.635957,419.676189,12,0
0,0,31,31,25,53,78,144,104,248,0.000333,0.519593,12,18705.357,1039.1865,1558.77975,419.676189,12,0
0,0,32,32,22,51,73,143,103,246,0.000333,0.507566,22,33499.33051,1861.073917,1522.696841,387.401188,11,0
0,0,31,31,22,51,73,142,101,243,0.000333,0.501376,11,16545.40105,919.188947,1504.127368,387.401188,11,0
0,0,32,32,25,53,78,146,110,256,0.000333,0.536354,24,38617.51123,2145.417291,1609.062968,419.676189,12,0
0,0,31,31,25,53,78,145,108,253,0.000333,0.530069,24,38164.96227,2120.275682,1590.206761,419.676189,12,0
0,0,32,32,25,53,78,146,110,256,0.000333,0.536354,24,38617.51123,2145.417291,1609.062968,419.676189,12,0
0,0,31,31,25,53,78,145,108,253,0.000333,0.530069,24,38164.96227,2120.275682,1590.206761,419.676189,12,0
0,0,3,3,11,13,24,17,14,31,0.000333,0.047378,5,710.669188,39.481622,142.133838,86.159464,1,0
0,0,10,10,13,15,28,33,30,63,0.000333,0.100954,12,3634.360321,201.908907,302.86336,106.709075,2,0
0,0,20,20,16,22,38,94,63,157,0.000333,0.274642,16,13182.79391,732.37744,823.92462,162.107496,5,0
0,0,13,13,18,23,41,57,40,97,0.000333,0.173228,9,4677.1429,259.841272,519.682544,179.100575,6,0
0,0,14,14,18,24,42,58,42,100,0.000333,0.179744,9,4853.085681,269.615871,539.231742,185.09775,6,0
0,0,13,13,18,23,41,57,40,97,0.000333,0.173228,9,4677.1429,259.841272,519.682544,179.100575,6,0
0,0,14,14,18,24,42,58,42,100,0.000333,0.179744,9,4853.085681,269.615871,539.231742,185.09775,6,0
0,0,13,13,18,23,41,57,41,98,0.000333,0.175013,9,4725.360868,262.520048,525.040096,179.100575,6,0
0,0,14,14,18,24,42,58,43,101,0.000333,0.181541,9,4901.616537,272.31203,544.62406,185.09775,6,0
0,0,13,13,18,23,41,57,41,98,0.000333,0.175013,9,4725.360868,262.520048,525.040096,179.100575,6,0
0,0,14,14,18,24,42,58,43,101,0.000333,0.181541,9,4901.616537,272.31203,544.62406,185.09775,6,0
0,0,25,25,21,27,48,110,73,183,0.000333,0.340683,20,20440.96275,1135.609042,1022.048138,220.620628,10,0
0,0,38,38,26,51,77,176,117,293,0.000333,0.612056,26,47740.37987,2652.243326,1836.168456,411.505125,14,0
0,0,37,37,26,50,76,175,115,290,0.000333,0.603966,26,47109.37345,2617.187414,1811.898979,404.404242,14,0
0,0,38,38,26,51,77,176,117,293,0.000333,0.612056,26,47740.37987,2652.243326,1836.168456,411.505125,14,0
0,0,37,37,26,50,76,175,115,290,0.000333,0.603966,26,47109.37345,2617.187414,1811.898979,404.404242,14,0
0,0,25,25,21,27,48,110,73,183,0.000333,0.340683,20,20440.96275,1135.609042,1022.048138,220.620628,10,0
0,0,10,10,13,15,28,33,30,63,0.000333,0.100954,12,3634.360321,201.908907,302.86336,106.709075,2,0
0,0,23,23,17,44,61,106,79,185,0.000333,0.365729,8,8777.49126,487.638403,1097.186407,309.70186,9,0
0,0,22,22,17,43,60,105,77,182,0.000333,0.358351,8,8600.432707,477.801817,1075.054088,302.816253,9,0
0,0,23,23,18,45,63,107,81,188,0.000333,0.374576,9,10113.55763,561.864313,1123.728626,322.192039,9,0
0,0,22,22,18,44,62,106,79,185,0.000333,0.367175,9,9913.736857,550.763159,1101.526317,315.273641,9,0
0,0,32,32,25,57,82,146,108,254,0.000333,0.538273,12,19377.81851,1076.545473,1614.818209,448.571136,12,0
0,0,31,31,25,57,82,145,106,251,0.000333,0.531915,12,19148.94664,1063.830369,1595.745553,448.571136,12,0
0,0,14,14,14,17,31,68,42,110,0.000333,0.181654,14,7629.462318,423.859018,544.961594,122.789837,5,0
0,0,5,5,10,8,18,16,12,28,0.000333,0.038919,5,583.7895,32.43275,116.7579,57.219281,1,0
0,0,38,38,22,56,78,157,122,279,0.000333,0.584542,22,38579.79882,2143.322157,1753.627219,423.319371,11,0
0,0,37,37,22,56,78,156,120,276,0.000333,0.578257,22,38164.96227,2120.275682,1734.771012,423.319371,11,0
0,0,38,38,25,58,83,160,133,293,0.000333,0.622629,24,44829.27728,2490.515405,1867.886553,455.859302,12,0
0,0,37,37,25,58,83,159,131,290,0.000333,0.616254,24,44370.27444,2465.015247,1848.761435,455.859302,12,0
0,0,12,12,18,20,38,55,38,93,0.000333,0.162686,9,4392.515329,244.028629,488.057259,161.497212,5,0
0,0,13,13,18,21,39,56,40,96,0.000333,0.169133,9,4566.587517,253.699307,507.398613,167.297316,5,0
0,0,10,10,13,15,28,34,30,64,0.000333,0.102557,12,3692.04858,205.11381,307.670715,106.709075,2,0
0,0,7,7,11,9,20,24,20,44,0.000333,0.063388,10,1901.648362,105.647131,190.164836,66.583073,1,0
0,0,8,8,13,12,25,30,24,54,0.000333,0.083589,12,3009.218811,167.178823,250.768234,91.125266,2,0
0,0,30,30,26,52,78,134,95,229,0.000333,0.479786,13,18711.64241,1039.535689,1439.357108,418.634298,11,0
0,0,29,29,26,51,77,133,93,226,0.000333,0.472098,13,18411.81886,1022.878825,1416.293758,411.505125,11,0
0,0,30,30,26,52,78,134,95,229,0.000333,0.479786,13,18711.64241,1039.535689,1439.357108,418.634298,11,0
0,0,29,29,26,51,77,133,93,226,0.000333,0.472098,13,18411.81886,1022.878825,1416.293758,411.505125,11,0
0,0,28,28,25,53,78,130,93,223,0.000333,0.467215,12,16819.73634,934.429797,1401.644695,419.676189,11,0
0,0,27,27,25,52,77,129,91,220,0.000333,0.459564,12,16544.31647,919.128693,1378.693039,412.51927,11,0
0,0,28,28,25,53,78,130,93,223,0.000333,0.467215,12,16819.73634,934.429797,1401.644695,419.676189,11,0
0,0,27,27,25,52,77,129,91,220,0.000333,0.459564,12,16544.31647,919.128693,1378.693039,412.51927,11,0
0,0,3,3,11,11,22,16,13,29,0.000333,0.043108,5,646.617585,35.923199,129.323517,76.107496,1,0
0,0,10,10,13,15,28,33,30,63,0.000333,0.100954,12,3634.360321,201.908907,302.86336,106.709075,2,0
0,0,14,14,14,22,36,63,48,111,0.000333,0.191287,14,8034.063452,446.336858,573.861675,151.410465,5,0
0,0,8,8,10,12,22,27,23,50,0.000333,0.074324,5,1114.857905,61.93655,222.971581,76.238831,1,0
0,0,29,29,25,50,75,134,100,234,0.000333,0.485848,24,34981.04577,1943.391431,1457.543574,398.289214,10,0
0,0,28,28,25,50,75,133,98,231,0.000333,0.479619,12,17266.28541,959.238078,1438.857118,398.289214,10,0
0,0,29,29,25,50,75,134,100,234,0.000333,0.485848,24,34981.04577,1943.391431,1457.543574,398.289214,10,0
0,0,28,28,25,50,75,133,98,231,0.000333,0.479619,12,17266.28541,959.238078,1438.857118,398.289214,10,0
0,0,29,29,25,50,75,132,96,228,0.000333,0.47339,12,17042.04794,946.780441,1420.170661,398.289214,10,0
0,0,28,28,25,50,75,131,94,225,0.000333,0.467161,12,16817.81046,934.322804,1401.484205,398.289214,10,0
0,0,29,29,25,52,77,131,97,228,0.000333,0.476276,12,17145.92798,952.551554,1428.827331,412.51927,10,0
0,0,28,28,25,52,77,130,95,225,0.000333,0.470009,12,16920.32366,940.017981,1410.026972,412.51927,10,0
0,0,3,3,11,11,22,16,13,29,0.000333,0.043108,5,646.617585,35.923199,129.323517,76.107496,1,0
0,0,34,34,22,56,78,148,111,259,0.000333,0.54264,11,17907.11092,994.839496,1627.919175,423.319371,11,0
0,0,33,33,22,56,78,147,109,256,0.000333,0.536354,11,17699.69265,983.316258,1609.062968,423.319371,11,0
0,0,34,34,25,58,83,151,116,267,0.000333,0.567379,24,40851.25268,2269.514038,1702.135528,455.859302,12,0
0,0,33,33,25,58,83,150,114,264,0.000333,0.561003,12,20196.12492,1122.00694,1683.01041,455.859302,12,0
0,0,3,3,11,11,22,16,13,29,0.000333,0.043108,5,646.617585,35.923199,129.323517,76.107496,1,0
0,0,20,20,17,41,58,93,69,162,0.000333,0.316331,8,7591.94337,421.774632,948.992921,289.1465,7,0
0,0,19,19,17,40,57,92,67,159,0.000333,0.309143,8,7419.436098,412.190894,927.429512,282.363992,7,0
0,0,20,20,18,42,60,94,71,165,0.000333,0.324879,9,8771.732534,487.318474,974.636948,301.535982,7,0
0,0,19,19,18,41,59,93,69,162,0.000333,0.317663,9,8576.893566,476.494087,952.988174,294.718282,7,0
0,0,7,7,11,9,20,23,20,43,0.000333,0.061948,10,1858.429081,103.24606,185.842908,66.583073,1,0
0,0,3,3,12,16,28,22,18,40,0.000333,0.064098,6,1153.765181,64.098066,192.294197,107.01955,1,0
0,0,17,17,15,20,35,95,60,155,0.000333,0.265013,21,16695.81622,927.545346,795.038868,145.041921,5,0
0,0,8,8,10,12,22,41,30,71,0.000333,0.10554,10,3166.196449,175.899803,316.619645,76.238831,1,0
0,0,10,10,16,26,42,56,46,102,0.000333,0.183339,8,4400.131017,244.451723,550.016377,186.211433,2,0
0,0,9,9,16,24,40,51,43,94,0.000333,0.166754,8,4002.089927,222.338329,500.261241,174.0391,2,0
0,0,28,28,25,50,75,131,91,222,0.000333,0.460933,12,16593.57299,921.865166,1382.797749,398.289214,11,0
0,0,27,27,25,49,74,130,89,219,0.000333,0.45329,12,16318.44345,906.580191,1359.870287,391.217187,11,0
0,0,28,28,25,50,75,131,91,222,0.000333,0.460933,12,16593.57299,921.865166,1382.797749,398.289214,11,0
0,0,27,27,25,49,74,130,89,219,0.000333,0.45329,12,16318.44345,906.580191,1359.870287,391.217187,11,0
0,0,16,16,16,18,34,76,48,124,0.000333,0.210282,16,10093.52628,560.75146,630.845392,139.05865,5,0
0,0,7,7,11,9,20,24,20,44,0.000333,0.063388,10,1901.648362,105.647131,190.164836,66.583073,1,0
0,0,33,33,26,53,79,149,104,253,0.000333,0.531619,13,20733.13488,1151.840827,1594.856529,425.791217,13,0
0,0,32,32,26,52,78,148,102,250,0.000333,0.523784,13,20427.55721,1134.86429,1571.350555,418.634298,13,0
0,0,33,33,26,53,79,149,104,253,0.000333,0.531619,13,20733.13488,1151.840827,1594.856529,425.791217,13,0
0,0,32,32,26,52,78,148,102,250,0.000333,0.523784,13,20427.55721,1134.86429,1571.350555,418.634298,13,0
0,0,31,31,25,53,78,144,101,245,0.000333,0.513308,12,18479.08252,1026.615696,1539.923544,419.676189,13,0
0,0,30,30,25,52,77,143,99,242,0.000333,0.505521,12,18198.74811,1011.041562,1516.562343,412.51927,13,0
0,0,31,31,25,53,78,144,101,245,0.000333,0.513308,12,18479.08252,1026.615696,1539.923544,419.676189,13,0
0,0,30,30,25,52,77,143,99,242,0.000333,0.505521,12,18198.74811,1011.041562,1516.562343,412.51927,13,0
0,0,31,31,25,53,78,144,101,245,0.000333,0.513308,12,18479.08252,1026.615696,1539.923544,419.676189,13,0
0,0,30,30,25,52,77,143,99,242,0.000333,0.505521,12,18198.74811,1011.041562,1516.562343,412.51927,13,0
0,0,31,31,25,53,78,144,101,245,0.000333,0.513308,12,18479.08252,1026.615696,1539.923544,419.676189,13,0
0,0,30,30,25,52,77,143,99,242,0.000333,0.505521,12,18198.74811,1011.041562,1516.562343,412.51927,13,0
0,0,11,11,12,15,27,42,35,77,0.000333,0.122042,12,4393.516052,244.084225,366.126338,101.622909,1,0
0,0,7,7,11,9,20,24,20,44,0.000333,0.063388,10,1901.648362,105.647131,190.164836,66.583073,1,0
0,0,3,3,12,15,27,21,17,38,0.000333,0.060229,6,1084.11435,60.228575,180.685725,101.622909,1,0
0,0,3,3,11,13,24,17,14,31,0.000333,0.047378,5,710.669188,39.481622,142.133838,86.159464,1,0
0,0,7,7,11,9,20,23,20,43,0.000333,0.061948,10,1858.429081,103.24606,185.842908,66.583073,1,0
0,0,15,15,16,21,37,62,44,106,0.000333,0.184067,16,8835.232908,490.846273,552.202057,156.238666,4,0
0,0,16,16,16,21,37,63,46,109,0.000333,0.189277,16,9085.28667,504.738148,567.830417,156.238666,4,0
0,0,15,15,19,23,42,65,49,114,0.000333,0.204908,18,11065.03535,614.724186,614.724186,184.752548,5,0
0,0,16,16,19,23,42,66,51,117,0.000333,0.2103,18,11356.22049,630.901138,630.901138,184.752548,5,0
0,0,5,5,9,12,21,21,17,38,0.000333,0.055636,4,667.632248,37.09068,166.908062,71.548875,2,0
0,0,6,6,9,13,22,22,19,41,0.000333,0.060946,4,731.346785,40.630377,182.836696,76.635041,2,0
0,0,5,5,10,13,23,22,18,40,0.000333,0.060314,5,904.712391,50.2618,180.942478,81.324997,2,0
0,0,6,6,10,14,24,23,20,43,0.000333,0.065718,5,985.766938,54.76483,197.153388,86.52225,2,0
0,0,16,16,15,22,37,67,48,115,0.000333,0.199696,14,8387.219919,465.956662,599.087137,156.710855,4,0
0,0,17,17,15,22,37,68,50,118,0.000333,0.204905,14,8606.01696,478.112053,614.715497,156.710855,4,0
0,0,9,9,9,16,25,31,27,58,0.000333,0.089781,4,1077.374636,59.854146,269.343659,92.529325,2,0
0,0,7,7,7,11,18,16,18,34,0.000333,0.047259,3,425.33235,23.629575,141.77745,57.705232,1,0
0,0,16,16,18,24,42,70,53,123,0.000333,0.221085,18,11938.59077,663.255043,663.255043,185.09775,5,0
0,0,17,17,18,24,42,71,55,126,0.000333,0.226477,18,12229.77592,679.431995,679.431995,185.09775,5,0
0,0,9,9,10,17,27,32,29,61,0.000333,0.096683,5,1450.240688,80.568927,290.048138,102.706149,2,0
0,0,17,17,16,20,36,58,47,105,0.000333,0.180947,16,8685.474002,482.526333,542.842125,150.438562,3,0
0,0,19,19,18,25,43,76,60,136,0.000333,0.245991,18,13283.49612,737.972007,737.972007,191.155055,5,0
0,0,28,28,25,51,76,131,92,223,0.000333,0.464429,12,16719.45403,928.858557,1393.287835,405.390097,11,0
0,0,27,27,25,50,75,130,90,220,0.000333,0.45678,12,16444.08134,913.560075,1370.340112,398.289214,11,0
0,0,28,28,25,51,76,131,92,223,0.000333,0.464429,12,16719.45403,928.858557,1393.287835,405.390097,11,0
0,0,27,27,25,50,75,130,90,220,0.000333,0.45678,12,16444.08134,913.560075,1370.340112,398.289214,11,0
0,0,11,11,12,15,27,42,35,77,0.000333,0.122042,12,4393.516052,244.084225,366.126338,101.622909,1,0
0,0,32,32,27,56,83,150,109,259,0.000333,0.550378,13,21464.75777,1192.486543,1651.135213,453.593838,13,0
0,0,31,31,27,55,82,149,107,256,0.000333,0.542511,13,21157.93307,1175.440726,1627.533313,446.356747,13,0
0,0,32,32,22,53,75,142,104,246,0.000333,0.510763,11,16855.18338,936.399076,1532.289398,401.68728,11,0
0,0,31,31,22,53,75,141,102,243,0.000333,0.504534,11,16649.63236,924.979576,1513.602942,401.68728,11,0
0,0,32,32,25,55,80,145,111,256,0.000333,0.539471,24,38841.92622,2157.88479,1618.413592,434.071189,12,0
0,0,31,31,25,55,80,144,109,253,0.000333,0.533149,12,19193.3737,1066.298539,1599.447808,434.071189,12,0
0,0,32,32,25,55,80,145,111,256,0.000333,0.539471,24,38841.92622,2157.88479,1618.413592,434.071189,12,0
0,0,31,31,25,55,80,144,109,253,0.000333,0.533149,12,19193.3737,1066.298539,1599.447808,434.071189,12,0
0,0,20,20,17,41,58,93,69,162,0.000333,0.316331,8,7591.94337,421.774632,948.992921,289.1465,7,0
0,0,19,19,17,40,57,92,67,159,0.000333,0.309143,8,7419.436098,412.190894,927.429512,282.363992,7,0
0,0,20,20,18,42,60,94,71,165,0.000333,0.324879,9,8771.732534,487.318474,974.636948,301.535982,7,0
0,0,19,19,18,41,59,93,69,162,0.000333,0.317663,9,8576.893566,476.494087,952.988174,294.718282,7,0
0,0,21,21,17,24,41,100,67,167,0.000333,0.298237,16,14315.37896,795.298831,894.711185,179.525968,6,0
0,0,12,12,14,17,31,48,39,87,0.000333,0.143672,14,6034.211106,335.23395,431.015079,122.789837,2,0
0,0,3,3,12,14,26,21,17,38,0.000333,0.059539,6,1071.700256,59.538903,178.616709,96.322519,1,0
0,0,3,3,12,14,26,21,17,38,0.000333,0.059539,6,1071.700256,59.538903,178.616709,96.322519,1,0
0,0,20,20,16,22,38,94,63,157,0.000333,0.274642,16,13182.79391,732.37744,823.92462,162.107496,5,0
0,0,11,11,12,15,27,42,35,77,0.000333,0.122042,12,4393.516052,244.084225,366.126338,101.622909,1,0
0,0,8,8,12,13,25,28,20,48,0.000333,0.074302,6,1337.430583,74.301699,222.905097,91.125266,2,0
0,0,11,11,12,15,27,42,35,77,0.000333,0.122042,12,4393.516052,244.084225,366.126338,101.622909,1,0
0,0,16,16,15,18,33,75,48,123,0.000333,0.20682,14,8686.446674,482.580371,620.460477,133.662009,5,0
0,0,7,7,11,9,20,23,20,43,0.000333,0.061948,10,1858.429081,103.24606,185.842908,66.583073,1,0
0,0,8,8,13,13,26,28,25,53,0.000333,0.083041,6,1494.73983,83.041102,249.123305,96.211433,2,0
0,0,34,34,22,54,76,149,110,259,0.000333,0.539404,22,35600.69097,1977.816165,1618.213226,408.871421,11,0
0,0,33,33,22,54,76,148,108,256,0.000333,0.533156,22,35188.32776,1954.907098,1599.469443,408.871421,11,0
0,0,34,34,25,56,81,152,115,267,0.000333,0.564247,24,40625.75882,2256.986601,1692.739951,441.30828,12,0
0,0,33,33,25,56,81,151,113,264,0.000333,0.557907,24,40169.28962,2231.627201,1673.720401,441.30828,12,0
0,0,34,34,22,52,74,153,110,263,0.000333,0.544362,22,35927.89717,1995.994287,1633.086235,394.530361,11,0
0,0,33,33,22,52,74,152,108,260,0.000333,0.538153,22,35518.07325,1973.226292,1614.457875,394.530361,11,0
0,0,26,26,17,46,63,116,87,203,0.000333,0.404463,8,9707.102596,539.283478,1213.387824,323.570718,9,0
0,0,7,7,7,11,18,16,18,34,0.000333,0.047259,3,425.33235,23.629575,141.77745,57.705232,1,0
0,0,34,34,25,54,79,156,115,271,0.000333,0.569442,24,40999.78999,2277.76611,1708.324583,426.86033,12,0
0,0,33,33,25,54,79,155,113,268,0.000333,0.563138,24,40545.91777,2252.550987,1689.413241,426.86033,12,0
0,0,26,26,18,47,65,117,89,206,0.000333,0.413536,9,11165.46993,620.303885,1240.607769,336.124326,9,0
0,0,17,17,16,20,36,58,47,105,0.000333,0.180947,16,8685.474002,482.526333,542.842125,150.438562,3,0
0,0,36,36,25,55,80,161,120,281,0.000333,0.592154,24,42635.08307,2368.615726,1776.461795,434.071189,12,0
0,0,29,29,25,52,77,133,101,234,0.000333,0.488809,12,17597.13661,977.6187,1466.428051,412.51927,10,0
0,0,28,28,25,52,77,132,99,231,0.000333,0.482543,12,17371.53229,965.085127,1447.627691,412.51927,10,0
0,0,29,29,25,52,77,133,101,234,0.000333,0.488809,12,17597.13661,977.6187,1466.428051,412.51927,10,0
0,0,28,28,25,52,77,132,99,231,0.000333,0.482543,12,17371.53229,965.085127,1447.627691,412.51927,10,0
0,0,16,16,16,22,38,75,58,133,0.000333,0.232658,16,11167.58975,620.421653,697.974359,162.107496,6,0
0,0,12,12,14,18,32,47,40,87,0.000333,0.145,14,6090,338.333333,435,128.361619,2,0
0,0,3,3,11,13,24,17,14,31,0.000333,0.047378,5,710.669188,39.481622,142.133838,86.159464,1,0
0,0,31,31,25,56,81,143,103,246,0.000333,0.519868,12,18715.23721,1039.7354,1559.603101,441.30828,13,0
0,0,30,30,25,55,80,142,101,243,0.000333,0.512076,12,18434.74233,1024.152351,1536.228527,434.071189,13,0
0,0,31,31,25,56,81,143,103,246,0.000333,0.519868,12,18715.23721,1039.7354,1559.603101,441.30828,13,0
0,0,30,30,25,55,80,142,101,243,0.000333,0.512076,12,18434.74233,1024.152351,1536.228527,434.071189,13,0
0,0,3,3,11,11,22,16,13,29,0.000333,0.043108,5,646.617585,35.923199,129.323517,76.107496,1,0
0,0,14,14,14,17,31,68,42,110,0.000333,0.181654,14,7629.462318,423.859018,544.961594,122.789837,5,0
0,0,5,5,10,8,18,16,12,28,0.000333,0.038919,5,583.7895,32.43275,116.7579,57.219281,1,0
0,0,8,8,11,13,24,27,26,53,0.000333,0.081001,10,2430.030125,135.001674,243.003013,86.159464,1,0
0,0,3,3,11,12,23,17,14,31,0.000333,0.046743,5,701.152103,38.952895,140.230421,81.073298,1,0
0,0,7,7,11,9,20,23,20,43,0.000333,0.061948,10,1858.429081,103.24606,185.842908,66.583073,1,0
0,0,3,3,12,14,26,20,16,36,0.000333,0.056405,6,1015.294979,56.405277,169.21583,96.322519,1,0
0,0,16,16,15,18,33,75,48,123,0.000333,0.20682,14,8686.446674,482.580371,620.460477,133.662009,5,0
0,0,7,7,11,9,20,23,20,43,0.000333,0.061948,10,1858.429081,103.24606,185.842908,66.583073,1,0
0,0,17,17,15,19,34,80,51,131,0.000333,0.222153,14,9330.406851,518.355936,666.457632,139.313982,5,0
0,0,8,8,10,10,20,28,21,49,0.000333,0.070591,10,2117.744766,117.652487,211.774477,66.438562,1,0
0,0,3,3,11,13,24,17,14,31,0.000333,0.047378,5,710.669188,39.481622,142.133838,86.159464,1,0
0,0,7,7,11,9,20,23,20,43,0.000333,0.061948,10,1858.429081,103.24606,185.842908,66.583073,1,0
0,0,16,16,16,18,34,76,48,124,0.000333,0.210282,16,10093.52628,560.75146,630.845392,139.05865,5,0
0,0,3,3,11,12,23,16,13,29,0.000333,0.043728,5,655.916484,36.439805,131.183297,81.073298,1,0
0,0,7,7,11,9,20,24,20,44,0.000333,0.063388,10,1901.648362,105.647131,190.164836,66.583073,1,0
0,0,18,18,15,21,36,72,55,127,0.000333,0.21886,14,9192.126653,510.673703,656.580475,150.842025,2,0
0,0,17,17,15,21,36,70,53,123,0.000333,0.211967,14,8902.610852,494.589492,635.900775,150.842025,2,0
0,0,18,18,16,21,37,72,57,129,0.000333,0.224006,16,10752.31175,597.350653,672.019484,156.238666,2,0
0,0,17,17,16,21,37,70,55,125,0.000333,0.217061,16,10418.90673,578.828152,651.181671,156.238666,2,0
0,0,24,24,18,22,40,100,78,178,0.000333,0.315768,27,25577.18642,1420.954801,947.303201,173.166146,3,0
0,0,12,12,13,19,32,56,41,97,0.000333,0.161667,12,5820,323.333333,485,128.816339,2,0
0,0,18,18,16,23,39,92,66,158,0.000333,0.278365,16,13361.49681,742.305378,835.093551,168.041925,5,0
0,0,6,6,11,17,28,30,25,55,0.000333,0.088135,5,1322.022604,73.4457,264.404521,107.540616,1,0
0,0,6,6,11,18,29,30,26,56,0.000333,0.090682,5,1360.234679,75.568593,272.046936,113.112398,1,0
0,0,7,7,14,24,38,45,34,79,0.000333,0.138195,7,2902.103915,161.227995,414.586274,163.342069,2,0
0,0,10,10,18,31,49,68,51,119,0.000333,0.222717,9,6013.354243,334.075236,668.150471,228.638736,3,0
0,0,9,9,18,29,47,65,48,113,0.000333,0.209223,9,5649.016862,313.83427,627.66854,215.940099,3,0
0,0,17,17,15,25,40,77,60,137,0.000333,0.243035,14,10207.45809,567.081005,729.104149,174.699764,5,0
0,0,11,11,12,17,29,39,37,76,0.000333,0.123069,12,4430.478668,246.137704,369.206556,112.506418,1,0
0,0,11,11,15,13,28,39,31,70,0.000333,0.112172,14,4711.207824,261.733768,336.514845,106.709075,2,0
0,0,11,11,15,13,28,39,31,70,0.000333,0.112172,14,4711.207824,261.733768,336.514845,106.709075,2,0
0,0,11,11,15,15,30,51,36,87,0.000333,0.1423,14,5976.592745,332.03293,426.899482,117.206718,6,0
0,0,7,7,11,10,21,20,17,37,0.000333,0.054172,5,812.578723,45.143262,162.515745,71.273029,3,0
0,0,8,8,14,12,26,28,19,47,0.000333,0.07364,7,1546.444667,85.913593,220.920667,96.322519,2,0
0,0,11,11,14,17,31,51,37,88,0.000333,0.145323,14,6103.569854,339.087214,435.969275,122.789837,6,0
0,0,7,7,10,12,22,20,18,38,0.000333,0.056486,5,847.292008,47.071778,169.458402,76.238831,3,0
0,0,14,14,14,18,32,48,41,89,0.000333,0.148333,14,6230,346.111111,445,128.361619,2,0
0,0,14,14,15,19,34,49,44,93,0.000333,0.157711,14,6623.876619,367.993146,473.134044,139.313982,2,0
0,0,13,13,16,16,32,48,46,94,0.000333,0.156667,16,7520,417.777778,470,128,2,0
0,0,8,8,10,14,24,26,26,52,0.000333,0.079473,5,1192.09025,66.227236,238.41805,86.52225,1,0
0,0,20,20,20,25,45,99,76,175,0.000333,0.320358,30,28832.22876,1601.790486,961.074292,202.534967,2,0
0,0,13,13,17,17,34,54,43,97,0.000333,0.164495,16,7895.74233,438.652352,493.483896,138.973737,2,0
0,0,8,8,13,13,26,27,20,47,0.000333,0.07364,6,1325.524001,73.640222,220.920667,96.211433,2,0
0,0,8,8,13,13,26,32,25,57,0.000333,0.089308,6,1607.550384,89.308355,267.925064,96.211433,1,0
0,0,13,13,13,14,27,57,39,96,0.000333,0.152156,12,5477.630402,304.3128,456.4692,101.408685,2,0
0,0,16,16,16,16,32,70,47,117,0.000333,0.195,16,9360,520,585,128,3,0
0,0,13,13,13,14,27,57,39,96,0.000333,0.152156,12,5477.630402,304.3128,456.4692,101.408685,2,0
0,0,16,16,16,16,32,70,47,117,0.000333,0.195,16,9360,520,585,128,3,0
0,0,13,13,14,15,29,58,40,98,0.000333,0.158694,14,6665.149925,370.286107,476.082138,111.906328,2,0
0,0,16,16,16,17,33,71,48,119,0.000333,0.200094,16,9604.526403,533.5848,600.2829,133.486868,3,0
0,0,10,10,15,15,30,47,32,79,0.000333,0.129215,14,5427.020999,301.501167,387.644357,117.206718,2,0
0,0,13,13,13,15,28,57,40,97,0.000333,0.155438,12,5595.761129,310.875618,466.313427,106.709075,2,0
0,0,16,16,16,17,33,70,48,118,0.000333,0.198413,16,9523.816097,529.100894,595.238506,133.486868,3,0
0,0,10,10,15,15,30,47,32,79,0.000333,0.129215,14,5427.020999,301.501167,387.644357,117.206718,2,0
0,0,28,28,22,48,70,127,93,220,0.000333,0.449481,11,14832.8649,824.04805,1348.442264,366.185696,11,0
0,0,27,27,22,48,70,126,91,217,0.000333,0.443351,11,14630.59856,812.811031,1330.054415,366.185696,11,0
0,0,17,17,13,17,30,59,60,119,0.000333,0.19464,18,10510.55966,583.919981,583.919981,117.592585,2,0
0,0,19,19,16,19,35,67,65,132,0.000333,0.225688,24,16249.5686,902.753811,677.065358,144.710623,3,0
0,0,17,17,13,17,30,59,60,119,0.000333,0.19464,18,10510.55966,583.919981,583.919981,117.592585,2,0
0,0,19,19,16,19,35,67,65,132,0.000333,0.225688,24,16249.5686,902.753811,677.065358,144.710623,3,0
0,0,14,14,13,17,30,50,47,97,0.000333,0.158656,12,5711.620653,317.312259,475.968388,117.592585,2,0
0,0,16,16,15,19,34,58,52,110,0.000333,0.18654,14,7834.692776,435.26071,559.620913,139.313982,3,0
0,0,14,14,12,17,29,49,47,96,0.000333,0.155455,12,5596.394106,310.910784,466.366176,112.506418,2,0
0,0,16,16,15,19,34,57,52,109,0.000333,0.184844,14,7763.468296,431.303794,554.53345,139.313982,3,0
0,0,14,14,13,17,30,50,47,97,0.000333,0.158656,12,5711.620653,317.312259,475.968388,117.592585,2,0
0,0,16,16,15,19,34,58,52,110,0.000333,0.18654,14,7834.692776,435.26071,559.620913,139.313982,3,0
0,0,14,14,12,17,29,49,47,96,0.000333,0.155455,12,5596.394106,310.910784,466.366176,112.506418,2,0
0,0,16,16,15,19,34,57,52,109,0.000333,0.184844,14,7763.468296,431.303794,554.53345,139.313982,3,0
0,0,20,20,14,19,33,74,65,139,0.000333,0.233724,21,14724.58643,818.03258,701.170783,134.013592,2,0
0,0,22,22,16,21,37,82,70,152,0.000333,0.263946,24,19004.08588,1055.782549,791.836912,156.238666,3,0
0,0,14,14,12,16,28,49,46,95,0.000333,0.152233,12,5480.384611,304.465812,456.698718,107.01955,2,0
0,0,16,16,16,18,34,57,51,108,0.000333,0.183149,16,8791.13579,488.396433,549.445987,139.05865,3,0
0,0,14,14,12,16,28,49,46,95,0.000333,0.152233,12,5480.384611,304.465812,456.698718,107.01955,2,0
0,0,16,16,16,18,34,57,51,108,0.000333,0.183149,16,8791.13579,488.396433,549.445987,139.05865,3,0
0,0,15,15,15,21,36,69,55,124,0.000333,0.21369,14,8974.989803,498.610545,641.0707,150.842025,5,0
0,0,11,11,12,17,29,39,37,76,0.000333,0.123069,12,4430.478668,246.137704,369.206556,112.506418,1,0
0,0,14,14,12,15,27,46,39,85,0.000333,0.134722,12,4849.985252,269.443625,404.165438,101.622909,2,0
0,0,17,17,16,18,34,59,47,106,0.000333,0.179757,16,8628.336979,479.352054,539.271061,139.05865,3,0
0,0,10,10,14,15,29,40,29,69,0.000333,0.111734,7,2346.404821,130.355823,335.200689,111.906328,2,0
0,0,15,15,13,19,32,67,53,120,0.000333,0.2,12,7200,400,600,128.816339,1,0
0,0,11,11,16,15,31,43,35,78,0.000333,0.128809,16,6182.836995,343.490944,386.427312,122.603359,2,0
0,0,11,11,16,15,31,43,35,78,0.000333,0.128809,16,6182.836995,343.490944,386.427312,122.603359,2,0
0,0,14,14,15,26,41,58,49,107,0.000333,0.191086,7,4012.806451,222.933692,573.258064,180.814792,4,0
0,0,12,12,14,22,36,41,40,81,0.000333,0.139588,7,2931.347476,162.852638,418.763925,151.410465,2,0
0,0,13,13,13,17,30,50,42,92,0.000333,0.150478,12,5417.207218,300.955957,451.433935,117.592585,2,0
0,0,16,16,17,20,37,63,50,113,0.000333,0.196223,16,9418.691685,523.260649,588.66823,155.92543,3,0
0,0,11,11,16,17,33,42,33,75,0.000333,0.12611,8,3026.636472,168.146471,378.329559,133.486868,2,0
0,0,10,10,13,13,26,46,33,79,0.000333,0.123778,12,4456.016853,247.556492,371.334738,96.211433,1,0
0,0,15,15,15,16,31,51,48,99,0.000333,0.163488,21,10299.77413,572.209674,490.465435,122.603359,2,0
0,0,16,16,16,17,33,58,53,111,0.000333,0.186643,24,13438.26593,746.57033,559.927747,133.486868,2,0
0,0,11,11,15,16,31,40,35,75,0.000333,0.123855,14,5201.906126,288.994785,371.564723,122.603359,2,0
0,0,7,7,11,9,20,24,20,44,0.000333,0.063388,10,1901.648362,105.647131,190.164836,66.583073,1,0
0,0,13,13,13,20,33,56,46,102,0.000333,0.171509,12,6174.338402,343.0188,514.5282,134.544278,3,0
0,0,11,11,12,17,29,41,37,78,0.000333,0.126308,12,4547.070211,252.615012,378.922518,112.506418,1,0
0,0,10,10,13,20,33,42,33,75,0.000333,0.12611,6,2269.977354,126.109853,378.329559,134.544278,3,0
0,0,9,9,13,20,33,41,31,72,0.000333,0.121065,6,2179.17826,121.065459,363.196377,134.544278,3,0
0,0,7,7,10,12,22,20,18,38,0.000333,0.056486,5,847.292008,47.071778,169.458402,76.238831,3,0
0,0,9,9,11,12,23,24,20,44,0.000333,0.066346,5,995.18363,55.287979,199.036726,81.073298,3,0
0,0,11,11,14,15,29,35,32,67,0.000333,0.108495,14,4556.786173,253.154787,325.484727,111.906328,2,0
0,0,20,20,14,27,41,81,65,146,0.000333,0.260734,14,10950.8363,608.379794,782.202593,181.684931,6,0
0,0,14,14,13,17,30,43,46,89,0.000333,0.145571,12,5240.559156,291.142175,436.713263,117.592585,2,0
0,0,21,21,17,22,39,96,70,166,0.000333,0.292459,24,21057.04244,1169.835691,877.376768,167.594364,2,0
0,0,10,10,14,14,28,34,28,62,0.000333,0.099352,14,4172.784072,231.821337,298.056005,106.605938,2,0
0,0,7,7,13,13,26,29,27,56,0.000333,0.087742,12,3158.695491,175.483083,263.224624,96.211433,1,0
0,0,7,7,14,13,27,31,27,58,0.000333,0.091928,14,3860.968652,214.498258,275.783475,101.408685,1,0
0,0,6,6,10,13,23,20,18,38,0.000333,0.057298,5,859.476772,47.74871,171.895354,81.324997,1,0
0,0,9,9,11,14,25,30,30,60,0.000333,0.092877,10,2786.313714,154.795206,278.631371,91.356717,1,0
0,0,9,9,11,14,25,30,30,60,0.000333,0.092877,10,2786.313714,154.795206,278.631371,91.356717,1,0
0,0,16,16,15,28,43,76,60,136,0.000333,0.245991,14,10331.60809,573.978227,737.972007,193.209297,4,0
0,0,14,14,15,26,41,59,51,110,0.000333,0.196444,7,4125.315044,229.184169,589.330721,180.814792,2,0
0,0,16,16,13,17,30,56,57,113,0.000333,0.184826,18,9980.615471,554.478637,554.478637,117.592585,2,0
0,0,19,19,16,19,35,68,66,134,0.000333,0.229108,24,16495.77418,916.431899,687.323924,144.710623,3,0
0,0,16,16,13,17,30,56,57,113,0.000333,0.184826,18,9980.615471,554.478637,554.478637,117.592585,2,0
0,0,19,19,16,19,35,68,66,134,0.000333,0.229108,24,16495.77418,916.431899,687.323924,144.710623,3,0
0,0,14,14,14,18,32,51,49,100,0.000333,0.166667,14,7000,388.888889,500,128.361619,2,0
0,0,17,17,18,20,38,63,58,121,0.000333,0.211666,18,11429.98612,634.999229,634.999229,161.497212,3,0
0,0,13,13,13,17,30,46,44,90,0.000333,0.147207,12,5299.441843,294.413436,441.620154,117.592585,2,0
0,0,16,16,15,19,34,58,53,111,0.000333,0.188236,14,7905.917255,439.217625,564.708375,139.313982,3,0
0,0,13,13,12,17,29,45,44,89,0.000333,0.14412,12,5188.323703,288.240206,432.360309,112.506418,2,0
0,0,16,16,15,19,34,57,53,110,0.000333,0.18654,14,7834.692776,435.26071,559.620913,139.313982,3,0
0,0,12,12,14,16,30,54,39,93,0.000333,0.152114,14,6388.771555,354.931753,456.340825,117.302969,5,0
0,0,10,10,14,15,29,48,35,83,0.000333,0.134404,14,5644.973916,313.609662,403.212423,111.906328,5,0
0,0,6,6,10,10,20,17,16,33,0.000333,0.047541,5,713.118136,39.617674,142.623627,66.438562,2,0
0,0,6,6,11,9,20,17,15,32,0.000333,0.046101,5,691.508495,38.417139,138.301699,66.583073,1,0
0,0,9,9,12,13,25,29,25,54,0.000333,0.083589,6,1504.609405,83.589411,250.768234,91.125266,2,0
0,0,5,5,11,11,22,21,17,38,0.000333,0.056486,5,847.292008,47.071778,169.458402,76.107496,2,0
0,0,9,9,12,14,26,30,28,58,0.000333,0.090875,12,3271.506044,181.750336,272.625504,96.322519,2,0
0,0,8,8,11,13,24,26,23,49,0.000333,0.074888,5,1123.315813,62.406434,224.663163,86.159464,2,0
0,0,11,11,13,18,31,61,45,106,0.000333,0.175048,12,6301.737707,350.096539,525.144809,123.164366,3,0
0,0,8,8,10,13,23,43,31,74,0.000333,0.111581,10,3347.435847,185.968658,334.743585,81.324997,1,0
0,0,11,11,13,17,30,46,36,82,0.000333,0.134122,12,4828.380346,268.243353,402.365029,117.592585,3,0
0,0,8,8,10,11,21,28,22,50,0.000333,0.073205,10,2196.158711,122.008817,219.615871,71.273029,1,0
0,0,16,16,17,17,34,65,43,108,0.000333,0.183149,16,8791.13579,488.396433,549.445987,138.973737,3,0
0,0,16,16,17,17,34,64,43,107,0.000333,0.181453,16,8709.736384,483.874244,544.358524,138.973737,3,0
0,0,14,14,14,21,35,56,50,106,0.000333,0.181235,14,7611.855997,422.880889,543.704,145.541635,3,0
0,0,12,12,13,16,29,52,41,93,0.000333,0.150597,12,5421.506791,301.194822,451.792233,112.105716,3,0
0,0,18,18,18,19,37,76,47,123,0.000333,0.213588,18,11533.72975,640.762764,640.762764,155.769273,3,0
0,0,11,11,16,14,30,48,32,80,0.000333,0.13085,16,6280.819962,348.934442,392.551248,117.302969,2,0
0,0,16,16,17,17,34,65,43,108,0.000333,0.183149,16,8791.13579,488.396433,549.445987,138.973737,3,0
0,0,11,11,16,14,30,48,32,80,0.000333,0.13085,16,6280.819962,348.934442,392.551248,117.302969,2,0
0,0,16,16,17,17,34,64,43,107,0.000333,0.181453,16,8709.736384,483.874244,544.358524,138.973737,3,0
0,0,11,11,16,14,30,48,32,80,0.000333,0.13085,16,6280.819962,348.934442,392.551248,117.302969,2,0
0,0,18,18,18,17,35,69,45,114,0.000333,0.194913,18,10525.28875,584.738264,584.738264,144.545518,3,0
0,0,11,11,16,14,30,48,32,80,0.000333,0.13085,16,6280.819962,348.934442,392.551248,117.302969,2,0
0,0,18,18,18,17,35,69,45,114,0.000333,0.194913,18,10525.28875,584.738264,584.738264,144.545518,3,0
0,0,11,11,16,14,30,48,32,80,0.000333,0.13085,16,6280.819962,348.934442,392.551248,117.302969,2,0
0,0,3,3,12,15,27,21,17,38,0.000333,0.060229,6,1084.11435,60.228575,180.685725,101.622909,1,0
0,0,8,8,10,11,21,24,23,47,0.000333,0.068813,10,2064.389189,114.688288,206.438919,71.273029,2,0
0,0,9,9,13,16,29,34,32,66,0.000333,0.106876,12,3847.520948,213.751164,320.626746,112.105716,2,0
0,0,10,10,13,21,34,39,36,75,0.000333,0.127187,6,2289.358279,127.186571,381.559713,140.344382,2,0
0,0,11,11,14,21,35,44,38,82,0.000333,0.1402,7,2944.208452,163.567136,420.601207,145.541635,2,0
0,0,8,8,13,20,33,33,28,61,0.000333,0.102569,6,1846.248248,102.569347,307.708041,134.544278,2,0
0,0,8,8,13,20,33,33,28,61,0.000333,0.102569,6,1846.248248,102.569347,307.708041,134.544278,2,0
0,0,6,6,11,10,21,22,16,38,0.000333,0.055636,5,834.54031,46.363351,166.908062,71.273029,1,0
0,0,6,6,11,10,21,22,16,38,0.000333,0.055636,5,834.54031,46.363351,166.908062,71.273029,1,0
0,0,6,6,11,10,21,22,16,38,0.000333,0.055636,5,834.54031,46.363351,166.908062,71.273029,1,0
0,0,6,6,11,10,21,22,16,38,0.000333,0.055636,5,834.54031,46.363351,166.908062,71.273029,1,0
0,0,9,9,11,16,27,47,39,86,0.000333,0.136307,10,4089.203252,227.177958,408.920325,102.053748,1,0
0,0,8,8,10,13,23,43,31,74,0.000333,0.111581,10,3347.435847,185.968658,334.743585,81.324997,1,0
0,0,20,20,16,22,38,94,63,157,0.000333,0.274642,16,13182.79391,732.37744,823.92462,162.107496,5,0
0,0,11,11,12,15,27,42,35,77,0.000333,0.122042,12,4393.516052,244.084225,366.126338,101.622909,1,0
0,0,13,13,13,23,36,53,45,98,0.000333,0.168884,6,3039.915901,168.884217,506.65265,152.147641,2,0
0,0,11,11,12,20,32,40,35,75,0.000333,0.125,6,2250,125,375,129.458112,2,0
0,0,12,12,14,20,34,47,39,86,0.000333,0.145841,7,3062.65263,170.147368,437.521804,139.741531,2,0
0,0,13,13,14,21,35,51,42,93,0.000333,0.159008,14,6678.326488,371.018138,477.023321,145.541635,2,0
0,0,13,13,14,24,38,48,45,93,0.000333,0.162686,7,3416.400811,189.800045,488.057259,163.342069,2,0
0,0,12,12,14,21,35,42,39,81,0.000333,0.138491,7,2908.303471,161.572415,415.471924,145.541635,2,0
0,0,11,11,14,15,29,42,41,83,0.000333,0.134404,14,5644.973916,313.609662,403.212423,111.906328,1,0
0,0,8,8,11,14,25,29,28,57,0.000333,0.088233,10,2646.998028,147.055446,264.699803,91.356717,1,0
0,0,14,14,14,26,40,62,51,113,0.000333,0.200459,7,4209.645123,233.869174,601.377875,175.514402,4,0
0,0,12,12,13,22,35,45,44,89,0.000333,0.152169,12,5478.074262,304.337459,456.506189,146.213212,2,0
0,0,7,7,12,13,25,28,27,55,0.000333,0.085137,12,3064.945085,170.274727,255.41209,91.125266,1,0
0,0,7,7,13,13,26,30,27,57,0.000333,0.089308,12,3215.100767,178.616709,267.925064,96.211433,1,0
0,0,9,9,11,16,27,47,39,86,0.000333,0.136307,10,4089.203252,227.177958,408.920325,102.053748,1,0
0,0,8,8,10,14,24,42,32,74,0.000333,0.113096,10,3392.872251,188.492903,339.287225,86.52225,1,0
0,0,9,9,12,11,23,32,26,58,0.000333,0.087456,12,3148.399121,174.911062,262.366593,81.073298,1,0
0,0,20,20,14,19,33,82,64,146,0.000333,0.245494,21,15466.11237,859.228465,736.481541,134.013592,2,0
0,0,23,23,18,21,39,95,72,167,0.000333,0.294221,27,23831.87861,1323.993256,882.662171,167.297316,3,0
0,0,10,10,13,15,28,46,32,78,0.000333,0.124991,12,4499.684207,249.982456,374.973684,106.709075,2,0
0,0,18,18,15,19,34,72,55,127,0.000333,0.215369,14,9045.508932,502.528274,646.107781,139.313982,2,0
0,0,8,8,11,11,22,28,24,52,0.000333,0.077297,10,2318.904442,128.828025,231.890444,76.107496,1,0
0,0,3,3,12,13,25,20,16,36,0.000333,0.055726,6,1003.072937,55.726274,167.178823,91.125266,1,0
0,0,3,3,12,14,26,20,16,36,0.000333,0.056405,6,1015.294979,56.405277,169.21583,96.322519,1,0
0,0,19,19,16,26,42,90,60,150,0.000333,0.269616,16,12941.56182,718.975656,808.847613,186.211433,6,0
0,0,10,10,14,18,32,36,32,68,0.000333,0.113333,7,2380,132.222222,340,128.361619,2,0
0,0,25,25,21,29,50,108,75,183,0.000333,0.344275,20,20656.51366,1147.584092,1032.825683,233.120115,10,0
0,0,41,41,26,56,82,187,129,316,0.000333,0.669662,26,52233.64727,2901.869293,2008.986433,447.423308,16,0
0,0,40,40,26,55,81,186,127,313,0.000333,0.661458,26,51593.69932,2866.316629,1984.373051,440.186217,16,0
0,0,41,41,26,56,82,187,129,316,0.000333,0.669662,26,52233.64727,2901.869293,2008.986433,447.423308,16,0
0,0,40,40,26,55,81,186,127,313,0.000333,0.661458,26,51593.69932,2866.316629,1984.373051,440.186217,16,0
0,0,25,25,21,29,50,108,75,183,0.000333,0.344275,20,20656.51366,1147.584092,1032.825683,233.120115,10,0
0,0,3,3,11,12,23,17,14,31,0.000333,0.046743,5,701.152103,38.952895,140.230421,81.073298,1,0
0,0,13,13,18,21,39,58,39,97,0.000333,0.170895,9,4614.156137,256.342008,512.684015,167.297316,6,0
0,0,14,14,18,22,40,59,41,100,0.000333,0.177398,9,4789.735285,266.096405,532.192809,173.166146,6,0
0,0,13,13,18,21,39,58,39,97,0.000333,0.170895,9,4614.156137,256.342008,512.684015,167.297316,6,0
0,0,14,14,18,22,40,59,41,100,0.000333,0.177398,9,4789.735285,266.096405,532.192809,173.166146,6,0
0,0,13,13,18,21,39,58,39,97,0.000333,0.170895,9,4614.156137,256.342008,512.684015,167.297316,6,0
0,0,14,14,18,22,40,59,41,100,0.000333,0.177398,9,4789.735285,266.096405,532.192809,173.166146,6,0
0,0,13,13,18,21,39,58,39,97,0.000333,0.170895,9,4614.156137,256.342008,512.684015,167.297316,6,0
0,0,14,14,18,22,40,59,41,100,0.000333,0.177398,9,4789.735285,266.096405,532.192809,173.166146,6,0
0,0,8,8,12,14,26,34,26,60,0.000333,0.094009,6,1692.158299,94.008794,282.026383,96.322519,3,0
0,0,3,3,11,12,23,17,14,31,0.000333,0.046743,5,701.152103,38.952895,140.230421,81.073298,1,0
0,0,5,5,10,8,18,16,12,28,0.000333,0.038919,5,583.7895,32.43275,116.7579,57.219281,1,0
0,0,34,34,21,53,74,150,110,260,0.000333,0.538153,20,32289.1575,1793.842083,1614.457875,395.81845,11,0
0,0,33,33,21,53,74,149,108,257,0.000333,0.531943,20,31916.5903,1773.143906,1595.829515,395.81845,11,0
0,0,19,19,12,19,31,69,60,129,0.000333,0.21303,18,11503.64383,639.091324,639.091324,123.730173,2,0
0,0,22,22,16,22,38,82,68,150,0.000333,0.262396,24,18892.53905,1049.585503,787.189127,162.107496,3,0
0,0,14,14,15,18,33,79,55,134,0.000333,0.225316,21,14194.92505,788.606947,675.948812,133.662009,5,0
0,0,8,8,10,12,22,43,30,73,0.000333,0.108513,10,3255.385082,180.854727,325.538508,76.238831,1,0
0,0,17,17,15,19,34,78,58,136,0.000333,0.230632,21,14529.79388,807.210771,691.894946,139.313982,5,0
0,0,11,11,12,15,27,42,35,77,0.000333,0.122042,12,4393.516052,244.084225,366.126338,101.622909,1,0
0,0,3,3,11,12,23,16,13,29,0.000333,0.043728,5,655.916484,36.439805,131.183297,81.073298,1,0
0,0,3,3,12,13,25,20,16,36,0.000333,0.055726,6,1003.072937,55.726274,167.178823,91.125266,1,0
0,0,12,12,12,18,30,46,41,87,0.000333,0.1423,12,5122.793782,284.599655,426.899482,118.0782,1,0
0,0,11,11,12,15,27,42,35,77,0.000333,0.122042,12,4393.516052,244.084225,366.126338,101.622909,1,0
0,0,16,16,17,16,33,64,42,106,0.000333,0.178235,16,8555.292426,475.294024,534.705777,133.486868,3,0
0,0,16,16,17,16,33,64,42,106,0.000333,0.178235,16,8555.292426,475.294024,534.705777,133.486868,3,0
0,0,17,17,15,21,36,81,53,134,0.000333,0.230923,14,9698.779303,538.821072,692.76995,150.842025,5,0
0,0,8,8,10,12,22,27,25,52,0.000333,0.077297,10,2318.904442,128.828025,231.890444,76.238831,1,0
0,0,20,20,16,26,42,94,69,163,0.000333,0.292983,16,14063.16384,781.28688,878.94774,186.211433,6,0
0,0,14,14,17,22,39,57,46,103,0.000333,0.181465,16,8710.342857,483.907936,544.396429,167.594364,2,0
0,0,13,13,15,17,32,45,37,82,0.000333,0.136667,14,5740,318.888889,410,128.090227,2,0
0,0,10,10,14,15,29,33,26,59,0.000333,0.09554,7,2006.346151,111.463675,286.620879,111.906328,2,0
0,0,11,11,15,22,37,47,33,80,0.000333,0.138919,7,2917.293885,162.071882,416.756269,156.710855,5,0
0,0,12,12,15,22,37,48,35,83,0.000333,0.144128,7,3026.692405,168.149578,432.384629,156.710855,5,0
0,0,11,11,15,22,37,47,33,80,0.000333,0.138919,7,2917.293885,162.071882,416.756269,156.710855,5,0
0,0,12,12,15,22,37,48,35,83,0.000333,0.144128,7,3026.692405,168.149578,432.384629,156.710855,5,0
0,0,11,11,15,21,36,47,33,80,0.000333,0.137865,7,2895.158001,160.842111,413.594,150.842025,5,0
0,0,12,12,15,21,36,48,35,83,0.000333,0.143035,7,3003.726426,166.87369,429.103775,150.842025,5,0
0,0,11,11,15,21,36,47,33,80,0.000333,0.137865,7,2895.158001,160.842111,413.594,150.842025,5,0
0,0,12,12,15,21,36,48,35,83,0.000333,0.143035,7,3003.726426,166.87369,429.103775,150.842025,5,0
0,0,11,11,11,14,25,38,30,68,0.000333,0.105261,10,3157.822209,175.434567,315.782221,91.356717,2,0
0,0,14,14,15,17,32,51,38,89,0.000333,0.148333,14,6230,346.111111,445,128.090227,3,0
0,0,10,10,14,15,29,40,29,69,0.000333,0.111734,7,2346.404821,130.355823,335.200689,111.906328,2,0
0,0,11,11,11,19,30,44,38,82,0.000333,0.134122,10,4023.650288,223.536127,402.365029,118.764371,1,0
0,0,10,10,10,16,26,37,33,70,0.000333,0.109677,10,3290.307803,182.794878,329.03078,97.219281,1,0
0,0,10,10,9,15,24,37,33,70,0.000333,0.106982,8,2567.579,142.643278,320.947375,87.132684,1,0
0,0,17,17,19,19,38,64,48,112,0.000333,0.195923,18,10579.82187,587.767882,587.767882,161.421246,3,0
0,0,17,17,19,20,39,64,48,112,0.000333,0.197322,18,10655.37087,591.965049,591.965049,167.149185,3,0
0,0,15,15,19,20,39,61,46,107,0.000333,0.188513,18,10179.68467,565.538037,565.538037,167.149185,3,0
0,0,15,15,18,20,38,60,46,106,0.000333,0.185427,18,10013.0457,556.280316,556.280316,161.497212,3,0
0,0,15,15,19,20,39,61,46,107,0.000333,0.188513,18,10179.68467,565.538037,565.538037,167.149185,3,0
0,0,15,15,18,20,38,60,46,106,0.000333,0.185427,18,10013.0457,556.280316,556.280316,161.497212,3,0
0,0,17,17,19,19,38,65,48,113,0.000333,0.197672,18,10674.28456,593.015809,593.015809,161.421246,3,0
0,0,11,11,16,17,33,48,37,85,0.000333,0.142925,16,6860.376002,381.132,428.7735,133.486868,2,0
0,0,17,17,19,20,39,65,48,113,0.000333,0.199083,18,10750.50811,597.250451,597.250451,167.149185,3,0
0,0,11,11,16,17,33,48,37,85,0.000333,0.142925,16,6860.376002,381.132,428.7735,133.486868,2,0
0,0,15,15,18,19,37,60,45,105,0.000333,0.182331,18,9845.866861,546.992603,546.992603,155.769273,3,0
0,0,15,15,18,19,37,60,45,105,0.000333,0.182331,18,9845.866861,546.992603,546.992603,155.769273,3,0
0,0,15,15,18,19,37,60,45,105,0.000333,0.182331,18,9845.866861,546.992603,546.992603,155.769273,3,0
0,0,15,15,18,19,37,60,45,105,0.000333,0.182331,18,9845.866861,546.992603,546.992603,155.769273,3,0
0,0,15,15,18,16,34,58,42,100,0.000333,0.169582,18,9157.433114,508.746284,508.746284,139.05865,3,0
0,0,20,20,20,18,38,79,58,137,0.000333,0.239655,30,21568.98208,1198.276782,718.966069,161.497212,3,0
0,0,11,11,14,15,29,48,33,81,0.000333,0.131165,14,5508.950448,306.052803,393.496461,111.906328,2,0
0,0,10,10,14,19,33,35,33,68,0.000333,0.11434,7,2401.131601,133.3962,343.0188,134.013592,2,0
0,0,11,11,15,19,34,39,37,76,0.000333,0.128882,7,2706.530232,150.362791,386.647176,139.313982,2,0
0,0,11,11,15,19,34,39,37,76,0.000333,0.128882,7,2706.530232,150.362791,386.647176,139.313982,2,0
0,0,11,11,14,21,35,43,40,83,0.000333,0.14191,7,2980.113433,165.561857,425.73049,145.541635,2,0
0,0,11,11,14,21,35,43,40,83,0.000333,0.14191,7,2980.113433,165.561857,425.73049,145.541635,2,0
0,0,9,9,13,21,34,36,30,66,0.000333,0.111924,6,2014.635285,111.924183,335.772548,140.344382,2,0
0,0,10,10,14,18,32,46,36,82,0.000333,0.136667,14,5740,318.888889,410,128.361619,5,0
0,0,6,6,10,11,21,16,16,32,0.000333,0.046851,5,702.770788,39.042822,140.554158,71.273029,1,0
0,0,18,18,17,18,35,60,56,116,0.000333,0.198332,24,14279.92392,793.329107,594.99683,144.545518,3,0
0,0,18,18,17,18,35,60,56,116,0.000333,0.198332,24,14279.92392,793.329107,594.99683,144.545518,3,0
0,0,7,7,10,14,24,23,20,43,0.000333,0.065718,5,985.766938,54.76483,197.153388,86.52225,1,0
0,0,16,16,16,18,34,60,52,112,0.000333,0.189932,16,9116.733412,506.48519,569.795838,139.05865,3,0
0,0,16,16,16,18,34,59,52,111,0.000333,0.188236,16,9035.334006,501.963,564.708375,139.05865,3,0
0,0,10,10,14,14,28,34,28,62,0.000333,0.099352,14,4172.784072,231.821337,298.056005,106.605938,2,0
0,0,15,15,16,18,34,52,44,96,0.000333,0.162799,16,7814.342924,434.130162,488.396433,139.05865,3,0
0,0,15,15,16,18,34,51,44,95,0.000333,0.161103,16,7732.943519,429.607973,483.30897,139.05865,3,0
0,0,12,12,14,16,30,55,43,98,0.000333,0.160292,14,6732.253897,374.014105,480.875278,117.302969,3,0
0,0,15,15,16,16,32,51,43,94,0.000333,0.156667,16,7520,417.777778,470,128,3,0
0,0,15,15,16,16,32,51,43,94,0.000333,0.156667,16,7520,417.777778,470,128,3,0
0,0,10,10,14,18,32,36,32,68,0.000333,0.113333,7,2380,132.222222,340,128.361619,2,0
0,0,11,11,15,18,33,41,34,75,0.000333,0.12611,7,2648.306913,147.128162,378.329559,133.662009,2,0
0,0,10,10,14,18,32,36,30,66,0.000333,0.11,7,2310,128.333333,330,128.361619,2,0
0,0,9,9,14,18,32,33,26,59,0.000333,0.098333,7,2065,114.722222,295,128.361619,2,0
0,0,5,5,11,12,23,20,19,39,0.000333,0.058806,5,882.094581,49.005255,176.418916,81.073298,2,0
0,0,12,12,17,24,41,47,43,90,0.000333,0.160727,8,3857.437443,214.30208,482.17968,179.525968,3,0
0,0,5,5,11,13,24,20,20,40,0.000333,0.061133,5,916.9925,50.944028,183.3985,86.159464,2,0
0,0,5,5,12,13,25,24,21,45,0.000333,0.069658,6,1253.841171,69.657843,208.973529,91.125266,2,0
0,0,17,17,20,21,41,67,55,122,0.000333,0.217874,20,13072.42689,726.245938,653.621345,178.677228,3,0
0,0,5,5,12,14,26,24,22,46,0.000333,0.072073,6,1297.321362,72.073409,216.220227,96.322519,2,0
0,0,13,13,18,19,37,49,40,89,0.000333,0.154547,18,8345.544292,463.64135,463.64135,155.769273,3,0
0,0,15,15,16,17,33,50,42,92,0.000333,0.154695,16,7425.348144,412.519341,464.084259,133.486868,3,0
0,0,15,15,16,17,33,49,42,91,0.000333,0.153013,16,7344.637838,408.035435,459.039865,133.486868,3,0
0,0,7,7,10,12,22,24,19,43,0.000333,0.063919,5,958.777798,53.265433,191.75556,76.238831,1,0
0,0,6,6,10,11,21,21,17,38,0.000333,0.055636,5,834.54031,46.363351,166.908062,71.273029,1,0
0,0,15,15,16,17,33,51,43,94,0.000333,0.158058,16,7586.768756,421.487153,474.173047,133.486868,3,0
0,0,15,15,16,17,33,51,43,94,0.000333,0.158058,16,7586.768756,421.487153,474.173047,133.486868,3,0
0,0,15,15,16,18,34,52,44,96,0.000333,0.162799,16,7814.342924,434.130162,488.396433,139.05865,3,0
0,0,15,15,16,18,34,51,44,95,0.000333,0.161103,16,7732.943519,429.607973,483.30897,139.05865,3,0
0,0,8,8,13,19,32,34,27,61,0.000333,0.101667,6,1830,101.666667,305,128.816339,2,0
0,0,8,8,13,19,32,34,27,61,0.000333,0.101667,6,1830,101.666667,305,128.816339,2,0
0,0,12,12,15,15,30,46,43,89,0.000333,0.145571,14,6113.985682,339.665871,436.713263,117.206718,1,0
0,0,10,10,14,13,27,34,27,61,0.000333,0.096683,14,4060.673927,225.592996,290.048138,101.408685,2,0
0,0,6,6,11,10,21,22,16,38,0.000333,0.055636,5,834.54031,46.363351,166.908062,71.273029,1,0
0,0,6,6,11,10,21,22,16,38,0.000333,0.055636,5,834.54031,46.363351,166.908062,71.273029,1,0
0,0,12,12,14,17,31,53,46,99,0.000333,0.163488,14,6866.516086,381.473116,490.465435,122.789837,1,0
0,0,9,9,13,15,28,35,31,66,0.000333,0.105762,12,3807.425098,211.523617,317.285425,106.709075,1,0
0,0,21,21,17,23,40,88,72,160,0.000333,0.283836,24,20436.20388,1135.34466,851.508495,173.528793,2,0
0,0,13,13,18,14,32,49,36,85,0.000333,0.141667,18,7650,425,425,128.361619,3,0
0,0,13,13,18,15,33,49,36,85,0.000333,0.142925,18,7717.923003,428.7735,428.7735,133.662009,3,0
0,0,13,13,19,15,34,50,37,87,0.000333,0.147536,18,7966.966809,442.609267,442.609267,139.313982,3,0
0,0,13,13,18,15,33,49,37,86,0.000333,0.144606,18,7808.722097,433.817894,433.817894,133.662009,3,0
0,0,20,20,13,21,34,85,74,159,0.000333,0.269636,18,14560.31865,808.906592,808.906592,140.344382,1,0
0,0,22,22,17,23,40,93,79,172,0.000333,0.305124,24,21968.91918,1220.49551,915.371632,173.528793,2,0
0,0,8,8,14,18,32,29,25,54,0.000333,0.09,7,1890,105,270,128.361619,2,0
0,0,10,10,15,13,28,35,27,62,0.000333,0.099352,14,4172.784072,231.821337,298.056005,106.709075,2,0
0,0,12,12,15,16,31,51,37,88,0.000333,0.145323,14,6103.569854,339.087214,435.969275,122.603359,3,0
0,0,12,12,15,16,31,51,37,88,0.000333,0.145323,14,6103.569854,339.087214,435.969275,122.603359,3,0
0,0,12,12,16,17,33,52,38,90,0.000333,0.151332,16,7263.927532,403.55153,453.995471,133.486868,3,0
0,0,12,12,15,17,32,51,38,89,0.000333,0.148333,14,6230,346.111111,445,128.090227,3,0
0,0,8,8,11,13,24,29,23,52,0.000333,0.079473,5,1192.09025,66.227236,238.41805,86.159464,1,0
0,0,21,21,16,24,40,98,66,164,0.000333,0.290932,16,13964.73932,775.818851,872.796208,174.0391,6,0
0,0,12,12,11,17,28,43,38,81,0.000333,0.129799,10,3893.957487,216.330971,389.395749,107.540616,2,0
0,0,21,21,18,25,43,101,69,170,0.000333,0.307488,18,16604.37015,922.465008,922.465008,191.155055,6,0
0,0,14,14,12,15,27,64,46,110,0.000333,0.174346,18,9414.677254,523.037625,523.037625,101.622909,1,0
0,0,17,17,16,18,34,77,54,131,0.000333,0.222153,24,15994.98317,888.610176,666.457632,139.05865,2,0
0,0,11,11,14,15,29,51,37,88,0.000333,0.142501,14,5985.032586,332.50181,427.502328,111.906328,1,0
0,0,16,16,16,16,32,57,44,101,0.000333,0.168333,16,8080,448.888889,505,128,2,0
0,0,10,10,14,14,28,40,29,69,0.000333,0.110569,14,4643.904855,257.994714,331.70749,106.605938,2,0
0,0,10,10,15,14,29,41,29,70,0.000333,0.113353,14,4760.821375,264.490076,340.05867,111.906328,2,0
0,0,16,16,16,16,32,57,44,101,0.000333,0.168333,16,8080,448.888889,505,128,2,0
0,0,10,10,14,14,28,40,29,69,0.000333,0.110569,14,4643.904855,257.994714,331.70749,106.605938,2,0
0,0,17,17,17,16,33,62,46,108,0.000333,0.181598,16,8716.713038,484.261835,544.794565,133.486868,2,0
0,0,10,10,15,14,29,38,27,65,0.000333,0.105256,7,2210.381353,122.798964,315.768765,111.906328,2,0
0,0,20,20,16,18,34,69,60,129,0.000333,0.218761,24,15750.78496,875.043609,656.282707,139.05865,2,0
0,0,10,10,14,14,28,40,29,69,0.000333,0.110569,14,4643.904855,257.994714,331.70749,106.605938,2,0
0,0,14,14,18,19,37,53,47,100,0.000333,0.173648,18,9377.016058,520.945337,520.945337,155.769273,2,0
0,0,21,21,18,21,39,78,68,146,0.000333,0.257223,27,20835.05555,1157.503086,771.668724,167.297316,2,0
0,0,11,11,14,20,34,37,38,75,0.000333,0.127187,7,2670.917992,148.384333,381.559713,139.741531,2,0
0,0,19,19,17,18,35,69,65,134,0.000333,0.229108,24,16495.77418,916.431899,687.323924,144.545518,3,0
0,0,19,19,17,18,35,69,65,134,0.000333,0.229108,24,16495.77418,916.431899,687.323924,144.545518,3,0
0,0,16,16,20,20,40,64,50,114,0.000333,0.202233,20,12133.99606,674.110892,606.699803,172.877124,3,0
0,0,5,5,11,12,23,20,19,39,0.000333,0.058806,5,882.094581,49.005255,176.418916,81.073298,2,0
0,0,17,17,20,23,43,63,53,116,0.000333,0.209816,20,12588.93423,699.385235,629.446712,190.480487,3,0
0,0,5,5,12,13,25,21,20,41,0.000333,0.063466,6,1142.388623,63.466035,190.398104,91.125266,2,0
0,0,18,18,17,17,34,67,60,127,0.000333,0.215369,24,15506.58674,861.477041,646.107781,138.973737,2,0
0,0,23,23,15,24,39,99,71,170,0.000333,0.299506,14,12579.25728,698.847627,898.518377,168.642459,5,0
0,0,14,14,10,15,25,45,49,94,0.000333,0.145507,15,6547.837228,363.768735,436.522482,91.82264,1,0
0,0,9,9,11,12,23,31,27,58,0.000333,0.087456,10,2623.665935,145.759219,262.366593,81.073298,1,0
0,0,12,12,15,15,30,38,34,72,0.000333,0.117765,14,4946.14572,274.785873,353.296123,117.206718,2,0
0,0,16,16,16,17,33,52,46,98,0.000333,0.164784,16,7909.609979,439.422777,494.350624,133.486868,2,0
0,0,18,18,17,18,35,59,55,114,0.000333,0.194913,24,14033.71833,779.651019,584.738264,144.545518,3,0
0,0,18,18,17,18,35,59,55,114,0.000333,0.194913,24,14033.71833,779.651019,584.738264,144.545518,3,0
0,0,18,18,15,21,36,77,60,137,0.000333,0.236093,14,9915.916153,550.884231,708.279725,150.842025,5,0
0,0,12,12,10,14,24,39,41,80,0.000333,0.122266,10,3667.970001,203.776111,366.797,86.52225,1,0
0,0,11,11,14,15,29,36,32,68,0.000333,0.110114,14,4624.797907,256.933217,330.342708,111.906328,2,0
0,0,21,21,17,22,39,88,66,154,0.000333,0.271317,24,19534.8466,1085.269256,813.951942,167.594364,2,0
0,0,10,10,15,18,33,43,32,75,0.000333,0.12611,7,2648.306913,147.128162,378.329559,133.662009,2,0
0,0,15,15,13,21,34,57,48,105,0.000333,0.178061,12,6410.20318,356.122399,534.183598,140.344382,3,0
0,0,16,16,13,21,34,58,50,108,0.000333,0.183149,12,6593.351842,366.297325,549.445987,140.344382,3,0
0,0,16,16,15,23,38,65,54,119,0.000333,0.208168,14,8743.047237,485.724847,624.503374,162.645284,4,0
0,0,17,17,15,23,38,66,56,122,0.000333,0.213416,14,8963.460193,497.970011,640.247157,162.645284,4,0
0,0,13,13,16,15,31,50,46,96,0.000333,0.158534,24,11414.4683,634.137128,475.602846,122.603359,1,0
0,0,18,18,12,18,30,69,63,132,0.000333,0.215903,18,11658.77206,647.709559,647.709559,118.0782,1,0
0,0,20,20,16,20,36,77,68,145,0.000333,0.24988,24,17991.33901,999.518834,749.639125,150.438562,2,0
0,0,17,17,16,20,36,66,56,122,0.000333,0.210244,16,10091.6936,560.649645,630.73085,150.438562,2,0
0,0,8,8,10,16,26,30,32,62,0.000333,0.097142,10,2914.272625,161.904035,291.427263,97.219281,1,0
0,0,10,10,14,19,33,38,37,75,0.000333,0.12611,7,2648.306913,147.128162,378.329559,134.013592,2,0
0,0,10,10,13,12,25,38,27,65,0.000333,0.100617,12,3622.207828,201.233768,301.850652,91.125266,2,0
0,0,10,10,13,12,25,38,27,65,0.000333,0.100617,12,3622.207828,201.233768,301.850652,91.125266,2,0
0,0,9,9,13,14,27,35,27,62,0.000333,0.098268,6,1768.818151,98.267675,294.803025,101.408685,1,0
0,0,32,32,20,49,69,139,108,247,0.000333,0.502935,20,30176.11082,1676.450601,1508.805541,361.559344,9,0
0,0,31,31,20,49,69,138,106,244,0.000333,0.496827,20,29809.59935,1656.088853,1490.479967,361.559344,9,0
0,0,33,33,21,51,72,144,113,257,0.000333,0.528557,20,31713.41451,1761.856362,1585.670725,381.532358,10,0
0,0,32,32,21,51,72,143,111,254,0.000333,0.522387,20,31343.21901,1741.289945,1567.16095,381.532358,10,0
0,0,12,12,14,18,32,54,41,95,0.000333,0.158333,14,6650,369.444444,475,128.361619,5,0
0,0,10,10,14,15,29,48,35,83,0.000333,0.134404,14,5644.973916,313.609662,403.212423,111.906328,5,0
0,0,6,6,10,10,20,17,16,33,0.000333,0.047541,5,713.118136,39.617674,142.623627,66.438562,2,0
0,0,6,6,11,12,23,17,17,34,0.000333,0.051267,5,769.005533,42.72253,153.801107,81.073298,1,0
0,0,9,9,11,14,25,31,30,61,0.000333,0.094425,10,2832.752276,157.375126,283.275228,91.356717,1,0
0,0,9,9,11,14,25,31,30,61,0.000333,0.094425,10,2832.752276,157.375126,283.275228,91.356717,1,0
0,0,14,14,12,15,27,68,47,115,0.000333,0.182271,18,9842.617129,546.812063,546.812063,101.622909,1,0
0,0,17,17,16,18,34,81,55,136,0.000333,0.230632,24,16605.47871,922.526595,691.894946,139.05865,2,0
0,0,18,18,16,16,32,72,54,126,0.000333,0.21,24,15120,840,630,128,2,0
0,0,19,19,16,19,35,73,57,130,0.000333,0.222269,24,16003.36301,889.075723,666.806792,144.710623,2,0
0,0,10,10,14,14,28,42,31,73,0.000333,0.116979,14,4913.11673,272.950929,350.936909,106.605938,2,0
0,0,18,18,15,16,31,71,54,125,0.000333,0.206425,21,13004.76532,722.486962,619.274539,122.603359,2,0
0,0,18,18,16,16,32,74,54,128,0.000333,0.213333,24,15360,853.333333,640,128,2,0
0,0,10,10,14,14,28,42,31,73,0.000333,0.116979,14,4913.11673,272.950929,350.936909,106.605938,2,0
0,0,19,19,16,16,32,76,58,134,0.000333,0.223333,24,16080,893.333333,670,128,2,0
0,0,10,10,14,14,28,42,31,73,0.000333,0.116979,14,4913.11673,272.950929,350.936909,106.605938,2,0
0,0,17,17,14,24,38,68,55,123,0.000333,0.215165,14,9036.931178,502.051732,645.495084,163.342069,4,0
0,0,20,20,14,27,41,79,62,141,0.000333,0.251805,14,10575.80766,587.54487,755.414833,181.684931,5,0
0,0,14,14,15,19,34,49,47,96,0.000333,0.162799,14,6837.550059,379.863892,488.396433,139.313982,2,0
0,0,13,13,14,22,36,56,43,99,0.000333,0.170608,7,3582.758026,199.042113,511.822575,151.410465,4,0
0,0,16,16,14,25,39,67,50,117,0.000333,0.206131,14,8657.488834,480.971602,618.39206,169.399374,5,0
0,0,10,10,15,17,32,37,31,68,0.000333,0.113333,7,2380,132.222222,340,128.090227,2,0
0,0,17,17,15,26,41,73,53,126,0.000333,0.225017,14,9450.721736,525.040096,675.051553,180.814792,5,0
0,0,14,14,15,23,38,62,46,108,0.000333,0.188925,14,7934.8664,440.825911,566.776171,162.645284,4,0
0,0,11,11,16,18,34,43,34,77,0.000333,0.130578,8,3133.87711,174.104284,391.734639,139.05865,2,0
0,0,11,11,16,17,33,41,33,74,0.000333,0.124428,8,2986.281319,165.904518,373.285165,133.486868,2,0
0,0,18,18,16,27,43,84,64,148,0.000333,0.267696,16,12849.39494,713.855274,803.087184,192.381963,5,0
0,0,12,12,12,20,32,46,41,87,0.000333,0.145,12,5220,290,435,129.458112,1,0
0,0,6,6,10,13,23,20,18,38,0.000333,0.057298,5,859.476772,47.74871,171.895354,81.324997,1,0
0,0,18,18,19,18,37,63,56,119,0.000333,0.206642,27,16737.97366,929.887426,619.924951,155.769273,3,0
0,0,19,19,20,21,41,65,57,122,0.000333,0.217874,20,13072.42689,726.245938,653.621345,178.677228,3,0
0,0,22,22,19,20,39,75,72,147,0.000333,0.258985,27,20977.76141,1165.431189,776.954126,167.149185,3,0
0,0,20,20,19,19,38,69,64,133,0.000333,0.232658,27,18845.3077,1046.961539,697.974359,161.421246,3,0
0,0,7,7,10,17,27,22,26,48,0.000333,0.076078,5,1141.173001,63.3985,228.2346,102.706149,1,0
0,0,6,6,10,14,24,16,19,35,0.000333,0.053491,5,802.368438,44.576024,160.473688,86.52225,1,0
0,0,14,14,12,23,35,56,48,104,0.000333,0.177815,12,6401.345205,355.630289,533.445434,147.061475,2,0
0,0,15,15,12,23,35,57,50,107,0.000333,0.182944,12,6585.999394,365.888855,548.833283,147.061475,2,0
0,0,14,14,20,21,41,70,55,125,0.000333,0.223231,20,13393.88001,744.104445,669.694001,178.677228,2,0
0,0,10,10,19,19,38,56,42,98,0.000333,0.171432,18,9257.344134,514.296896,514.296896,161.421246,2,0
0,0,14,14,16,22,38,62,48,110,0.000333,0.192424,16,9236.352424,513.13069,577.272026,162.107496,1,0
0,0,14,14,17,22,39,63,51,114,0.000333,0.200845,16,9640.573647,535.587425,602.535853,167.594364,1,0
0,0,20,20,20,24,44,90,73,163,0.000333,0.296629,30,26696.62062,1483.14559,889.887354,196.477662,2,0
0,0,10,10,19,20,39,57,43,100,0.000333,0.17618,18,9513.723994,528.540222,528.540222,167.149185,2,0
0,0,21,21,19,18,37,84,64,148,0.000333,0.257,27,20816.97565,1156.498647,770.999098,155.769273,3,0
0,0,24,24,18,20,38,92,78,170,0.000333,0.297383,27,24087.98729,1338.221516,892.147677,161.497212,3,0
0,0,10,10,13,14,27,44,32,76,0.000333,0.120457,12,4336.457402,240.9143,361.37145,101.408685,2,0
0,0,13,13,17,17,34,54,41,95,0.000333,0.161103,16,7732.943519,429.607973,483.30897,138.973737,3,0
0,0,10,10,14,14,28,42,30,72,0.000333,0.115377,14,4845.813761,269.211876,346.129554,106.605938,2,0
0,0,7,7,10,12,22,24,21,45,0.000333,0.066891,5,1003.372114,55.742895,200.674423,76.238831,1,0
0,0,15,15,18,16,34,54,43,97,0.000333,0.164495,18,8882.710121,493.483896,493.483896,139.05865,3,0
0,0,16,16,20,18,38,60,49,109,0.000333,0.190675,20,11440.48198,635.582332,572.024099,161.497212,3,0
0,0,15,15,11,16,27,46,52,98,0.000333,0.155326,15,6989.684628,388.315813,465.978975,102.053748,1,0
0,0,22,22,17,20,37,84,70,154,0.000333,0.267419,24,19254.13964,1069.674424,802.255818,155.92543,3,0
0,0,15,15,18,18,36,60,45,105,0.000333,0.180947,18,9771.158253,542.842125,542.842125,150.1173,3,0
0,0,15,15,18,19,37,60,45,105,0.000333,0.182331,18,9845.866861,546.992603,546.992603,155.769273,3,0
0,0,15,15,18,19,37,60,45,105,0.000333,0.182331,18,9845.866861,546.992603,546.992603,155.769273,3,0
0,0,11,11,16,17,33,48,37,85,0.000333,0.142925,16,6860.376002,381.132,428.7735,133.486868,2,0
0,0,15,15,18,19,37,60,45,105,0.000333,0.182331,18,9845.866861,546.992603,546.992603,155.769273,3,0
0,0,11,11,16,17,33,48,37,85,0.000333,0.142925,16,6860.376002,381.132,428.7735,133.486868,2,0
0,0,15,15,19,20,39,61,46,107,0.000333,0.188513,18,10179.68467,565.538037,565.538037,167.149185,3,0
0,0,11,11,16,17,33,48,37,85,0.000333,0.142925,16,6860.376002,381.132,428.7735,133.486868,2,0
0,0,15,15,18,20,38,60,46,106,0.000333,0.185427,18,10013.0457,556.280316,556.280316,161.497212,3,0
0,0,11,11,16,17,33,48,37,85,0.000333,0.142925,16,6860.376002,381.132,428.7735,133.486868,2,0
0,0,9,9,12,14,26,36,34,70,0.000333,0.109677,12,3948.369363,219.353854,329.03078,96.322519,2,0
0,0,11,11,16,17,33,44,39,83,0.000333,0.139562,16,6698.955391,372.164188,418.684712,133.486868,3,0
0,0,19,19,15,19,34,75,66,141,0.000333,0.239111,21,15063.97747,836.887637,717.332261,139.313982,2,0
0,0,21,21,19,21,40,83,71,154,0.000333,0.273192,27,22128.57702,1229.36539,819.576927,172.949289,3,0
0,0,18,18,15,18,33,66,62,128,0.000333,0.215227,21,13559.33139,753.296188,645.682447,133.662009,2,0
0,0,20,20,19,20,39,74,67,141,0.000333,0.248414,27,20121.52625,1117.862569,745.241713,167.149185,3,0
0,0,20,20,14,20,34,75,69,144,0.000333,0.244198,21,15384.48763,854.693757,732.594649,139.741531,2,0
0,0,22,22,18,22,40,83,74,157,0.000333,0.278514,27,22559.65319,1253.314066,835.542711,173.166146,3,0
0,0,17,17,15,20,35,63,55,118,0.000333,0.201752,14,8473.575544,470.754197,605.255396,145.041921,2,0
0,0,8,8,14,18,32,29,25,54,0.000333,0.09,7,1890,105,270,128.361619,2,0
0,0,10,10,14,20,34,45,38,83,0.000333,0.140753,7,2955.815911,164.211995,422.259416,139.741531,5,0
0,0,6,6,10,14,24,15,19,34,0.000333,0.051963,5,779.443625,43.302424,155.888725,86.52225,1,0
0,0,8,8,13,12,25,35,24,59,0.000333,0.091329,12,3287.850182,182.658343,273.987515,91.125266,2,0
0,0,13,13,14,14,28,48,41,89,0.000333,0.142618,14,5989.964233,332.775791,427.854588,106.605938,2,0
0,0,5,5,10,10,20,22,17,39,0.000333,0.056185,5,842.775979,46.820888,168.555196,66.438562,1,0
0,0,13,13,14,14,28,48,41,89,0.000333,0.142618,14,5989.964233,332.775791,427.854588,106.605938,2,0
0,0,5,5,10,10,20,22,17,39,0.000333,0.056185,5,842.775979,46.820888,168.555196,66.438562,1,0
0,0,17,17,15,16,31,68,49,117,0.000333,0.193214,21,12172.46034,676.247796,579.640968,122.603359,3,0
0,0,17,17,15,15,30,68,49,117,0.000333,0.191369,21,12056.23019,669.790566,574.1062,117.206718,3,0
0,0,17,17,15,16,31,68,49,117,0.000333,0.193214,21,12172.46034,676.247796,579.640968,122.603359,3,0
0,0,17,17,15,16,31,68,49,117,0.000333,0.193214,21,12172.46034,676.247796,579.640968,122.603359,3,0
0,0,17,17,15,17,32,69,50,119,0.000333,0.198333,14,8330,462.777778,595,128.090227,3,0
0,0,17,17,15,17,32,68,50,118,0.000333,0.196667,14,8260,458.888889,590,128.090227,3,0
0,0,17,17,15,17,32,69,50,119,0.000333,0.198333,14,8330,462.777778,595,128.090227,3,0
0,0,10,10,14,14,28,42,31,73,0.000333,0.116979,14,4913.11673,272.950929,350.936909,106.605938,2,0
0,0,17,17,15,17,32,68,50,118,0.000333,0.196667,14,8260,458.888889,590,128.090227,3,0
0,0,10,10,14,14,28,42,31,73,0.000333,0.116979,14,4913.11673,272.950929,350.936909,106.605938,2,0
0,0,7,7,10,10,20,20,17,37,0.000333,0.053304,5,799.556698,44.419817,159.91134,66.438562,3,0
0,0,22,22,17,40,57,100,74,174,0.000333,0.338308,8,8119.3829,451.076828,1014.922862,282.363992,7,0
0,0,18,18,17,39,56,93,66,159,0.000333,0.30779,8,7386.955461,410.386414,923.369433,275.617555,7,0
0,0,10,10,14,15,29,48,35,83,0.000333,0.134404,14,5644.973916,313.609662,403.212423,111.906328,5,0
0,0,6,6,10,10,20,17,16,33,0.000333,0.047541,5,713.118136,39.617674,142.623627,66.438562,2,0
0,0,10,10,14,15,29,35,26,61,0.000333,0.098779,7,2074.357885,115.242105,296.336841,111.906328,2,0
0,0,8,8,11,14,25,28,26,54,0.000333,0.083589,5,1253.841171,69.657843,250.768234,91.356717,1,0
0,0,17,17,19,18,37,60,49,109,0.000333,0.189277,18,10220.9475,567.830417,567.830417,155.769273,4,0
0,0,17,17,19,18,37,60,49,109,0.000333,0.189277,18,10220.9475,567.830417,567.830417,155.769273,4,0
0,0,19,19,20,19,39,65,52,117,0.000333,0.206131,20,12367.84119,687.102288,618.39206,167.149185,4,0
0,0,19,19,20,19,39,65,52,117,0.000333,0.206131,20,12367.84119,687.102288,618.39206,167.149185,4,0
0,0,21,21,20,21,41,77,59,136,0.000333,0.242876,20,14572.54145,809.585636,728.627073,178.677228,4,0
0,0,17,17,16,17,33,71,51,122,0.000333,0.205139,24,14769.98598,820.554777,615.416083,133.486868,2,0
0,0,10,10,12,17,29,39,34,73,0.000333,0.118211,12,4255.591352,236.421742,354.632613,112.506418,1,0
0,0,9,9,11,13,24,33,28,61,0.000333,0.093228,10,2796.827125,155.379285,279.682713,86.159464,1,0
0,0,19,19,19,18,37,76,54,130,0.000333,0.225743,27,18285.18131,1015.843406,677.228938,155.769273,4,0
0,0,11,11,15,14,29,45,31,76,0.000333,0.123069,14,5168.891779,287.160654,369.206556,111.906328,2,0
0,0,14,14,13,15,28,51,46,97,0.000333,0.155438,18,8393.641694,466.313427,466.313427,106.709075,2,0
0,0,16,16,16,17,33,59,51,110,0.000333,0.184961,24,13317.20048,739.844471,554.883353,133.486868,3,0
0,0,14,14,13,15,28,51,46,97,0.000333,0.155438,18,8393.641694,466.313427,466.313427,106.709075,2,0
0,0,16,16,16,17,33,59,51,110,0.000333,0.184961,24,13317.20048,739.844471,554.883353,133.486868,3,0
0,0,14,14,13,15,28,51,46,97,0.000333,0.155438,18,8393.641694,466.313427,466.313427,106.709075,2,0
0,0,16,16,17,17,34,59,51,110,0.000333,0.18654,24,13430.9019,746.161217,559.620913,138.973737,3,0
0,0,14,14,13,15,28,51,46,97,0.000333,0.155438,18,8393.641694,466.313427,466.313427,106.709075,2,0
0,0,16,16,17,17,34,59,51,110,0.000333,0.18654,24,13430.9019,746.161217,559.620913,138.973737,3,0
0,0,10,10,15,19,34,37,33,70,0.000333,0.118707,7,2492.856792,138.492044,356.122399,139.313982,2,0
0,0,20,20,17,39,56,92,67,159,0.000333,0.30779,8,7386.955461,410.386414,923.369433,275.617555,7,0
0,0,19,19,17,39,56,91,65,156,0.000333,0.301982,8,7247.578943,402.643275,905.947368,275.617555,7,0
0,0,20,20,18,40,58,93,68,161,0.000333,0.314378,9,8488.214462,471.56747,943.13494,287.935774,7,0
0,0,19,19,18,40,58,92,66,158,0.000333,0.30852,9,8330.048975,462.780499,925.560997,287.935774,7,0
0,0,23,23,18,39,57,100,75,175,0.000333,0.340252,9,9186.801772,510.377876,1020.755752,281.189337,7,0
0,0,19,19,18,37,55,92,66,158,0.000333,0.304485,9,8221.093513,456.727417,913.454835,267.808425,7,0
0,0,23,23,19,40,59,101,78,179,0.000333,0.350998,9,9476.937953,526.496553,1052.993106,293.587747,7,0
0,0,19,19,18,38,56,92,67,159,0.000333,0.30779,9,8310.324893,461.684716,923.369433,274.479896,7,0
0,0,10,10,15,16,31,36,30,66,0.000333,0.108992,7,2288.838695,127.157705,326.976956,122.603359,2,0
0,0,29,29,20,47,67,123,93,216,0.000333,0.436758,10,13102.75265,727.930703,1310.275265,347.504238,8,0
0,0,28,28,20,47,67,122,91,213,0.000333,0.430692,10,12920.76998,717.820554,1292.076998,347.504238,8,0
0,0,29,29,23,49,72,128,98,226,0.000333,0.464801,22,30676.86711,1704.270395,1394.40305,379.162707,9,0
0,0,28,28,23,49,72,127,96,223,0.000333,0.458631,11,15134.82603,840.823668,1375.893275,379.162707,9,0
0,0,15,15,16,18,34,62,44,106,0.000333,0.179757,16,8628.336979,479.352054,539.271061,139.05865,2,0
0,0,9,9,14,14,28,35,26,61,0.000333,0.09775,7,2052.740552,114.041142,293.24865,106.605938,2,0
0,0,16,16,13,16,29,60,56,116,0.000333,0.187842,18,10143.46432,563.525795,563.525795,112.105716,1,0
0,0,18,18,17,18,35,68,61,129,0.000333,0.220559,24,15880.26022,882.236679,661.677509,144.545518,2,0
0,0,8,8,10,16,26,27,25,52,0.000333,0.081474,5,1222.114327,67.89524,244.422865,97.219281,1,0
0,0,9,9,11,14,25,31,28,59,0.000333,0.091329,10,2739.875152,152.215286,273.987515,91.356717,1,0
0,0,10,10,12,14,26,39,31,70,0.000333,0.109677,12,3948.369363,219.353854,329.03078,96.322519,1,0
0,0,11,11,14,17,31,44,32,76,0.000333,0.125506,7,2635.632437,146.424024,376.51892,122.789837,2,0
0,0,12,12,15,13,28,40,34,74,0.000333,0.118581,14,4980.419699,276.689983,355.744264,106.709075,3,0
0,0,12,12,15,15,30,38,33,71,0.000333,0.11613,14,4877.449252,270.969403,348.389232,117.206718,2,0
0,0,11,11,11,13,24,39,30,69,0.000333,0.105454,10,3163.624125,175.756896,316.362413,86.159464,2,0
0,0,14,14,15,16,31,52,38,90,0.000333,0.148626,14,6242.287351,346.793742,445.877668,122.603359,3,0
0,0,10,10,14,15,29,40,29,69,0.000333,0.111734,7,2346.404821,130.355823,335.200689,111.906328,2,0
0,0,12,12,15,15,30,40,36,76,0.000333,0.124308,14,5220.931594,290.051755,372.923685,117.206718,2,0
0,0,10,10,15,15,30,39,34,73,0.000333,0.119401,14,5014.842189,278.602344,358.203013,117.206718,2,0
0,0,16,16,17,17,34,55,48,103,0.000333,0.17467,16,8384.138762,465.785487,524.008673,138.973737,2,0
0,0,11,11,15,16,31,39,36,75,0.000333,0.123855,14,5201.906126,288.994785,371.564723,122.603359,2,0
0,0,19,19,17,18,35,79,56,135,0.000333,0.230818,24,16618.87698,923.270943,692.453207,144.545518,2,0
0,0,11,11,14,15,29,47,34,81,0.000333,0.131165,14,5508.950448,306.052803,393.496461,111.906328,2,0
0,0,12,12,17,17,34,47,40,87,0.000333,0.147536,16,7081.748275,393.43046,442.609267,138.973737,3,0
0,0,26,26,23,55,78,163,122,285,0.000333,0.597113,22,39409.47191,2189.415106,1791.339632,422.016709,12,0
0,0,8,8,11,12,23,41,30,71,0.000333,0.107058,10,3211.728989,178.429388,321.172899,81.073298,1,0
0,0,17,17,16,21,37,96,61,157,0.000333,0.272628,16,13086.14685,727.008159,817.884178,156.238666,5,0
0,0,27,27,23,53,76,170,125,295,0.000333,0.61438,22,40549.04956,2252.724976,1843.138616,407.621709,12,0
0,0,8,8,13,13,26,31,23,54,0.000333,0.084608,6,1522.942469,84.607915,253.823745,96.211433,2,0
0,0,8,8,12,13,25,30,23,53,0.000333,0.082041,6,1476.746268,82.041459,246.124378,91.125266,2,0
0,0,15,15,14,21,35,70,47,117,0.000333,0.200042,14,8401.765582,466.764755,600.126113,145.541635,6,0
0,0,6,6,10,13,23,16,18,34,0.000333,0.051267,5,769.005533,42.72253,153.801107,81.324997,2,0
0,0,11,11,13,13,26,41,36,77,0.000333,0.120645,12,4343.2063,241.289239,361.933858,96.211433,2,0
0,0,11,11,13,13,26,41,36,77,0.000333,0.120645,12,4343.2063,241.289239,361.933858,96.211433,2,0
0,0,11,11,14,17,31,51,37,88,0.000333,0.145323,14,6103.569854,339.087214,435.969275,122.789837,6,0
0,0,7,7,10,12,22,20,18,38,0.000333,0.056486,5,847.292008,47.071778,169.458402,76.238831,3,0
0,0,27,27,19,43,62,135,86,221,0.000333,0.438626,18,23685.79292,1315.877385,1315.877385,314.040007,9,0
0,0,15,15,14,18,32,70,44,114,0.000333,0.19,14,7980,443.333333,570,128.361619,5,0
0,0,6,6,11,9,20,17,15,32,0.000333,0.046101,5,691.508495,38.417139,138.301699,66.583073,1,0
0,0,13,13,12,15,27,59,44,103,0.000333,0.163251,12,5877.040953,326.502275,489.753413,101.622909,1,0
0,0,16,16,16,18,34,72,52,124,0.000333,0.210282,16,10093.52628,560.75146,630.845392,139.05865,2,0
0,0,4,4,11,11,22,20,15,35,0.000333,0.052027,5,780.400533,43.355585,156.080107,76.107496,2,0
0,0,8,8,11,13,24,26,23,49,0.000333,0.074888,5,1123.315813,62.406434,224.663163,86.159464,2,0
0,0,18,18,11,19,30,67,63,130,0.000333,0.212632,15,9568.436661,531.579815,637.895777,118.764371,1,0
0,0,20,20,15,21,36,75,68,143,0.000333,0.246433,21,15525.28478,862.515821,739.299275,150.842025,2,0
0,0,17,17,15,21,36,64,56,120,0.000333,0.206797,14,8685.474002,482.526333,620.391,150.842025,2,0
0,0,7,7,10,11,21,34,25,59,0.000333,0.086382,10,2591.467279,143.970404,259.146728,71.273029,1,0
0,0,10,10,14,14,28,47,33,80,0.000333,0.128196,14,5384.237513,299.124306,384.588394,106.605938,2,0
0,0,14,14,12,15,27,53,51,104,0.000333,0.164836,18,8901.149404,494.5083,494.5083,101.622909,1,0
0,0,16,16,16,17,33,61,56,117,0.000333,0.196731,24,14164.65869,786.925483,590.194112,133.486868,2,0
0,0,17,17,11,17,28,58,61,119,0.000333,0.190692,15,8581.128536,476.729363,572.075236,107.540616,1,0
0,0,19,19,15,19,34,66,66,132,0.000333,0.223848,21,14102.447,783.469278,671.545095,139.313982,2,0
0,0,16,16,16,21,37,80,55,135,0.000333,0.234425,16,11252.41927,625.134404,703.276204,156.238666,5,0
0,0,10,10,11,14,25,42,32,74,0.000333,0.114548,10,3436.45358,190.914088,343.645358,91.356717,1,0
0,0,9,9,11,12,23,31,27,58,0.000333,0.087456,10,2623.665935,145.759219,262.366593,81.073298,1,0
0,0,13,13,12,17,29,49,42,91,0.000333,0.147359,12,5304.915247,294.717514,442.076271,112.506418,2,0
0,0,16,16,16,20,36,62,50,112,0.000333,0.193011,16,9264.505603,514.694756,579.0316,150.438562,3,0
0,0,11,11,14,14,28,47,34,81,0.000333,0.129799,14,5451.540482,302.86336,389.395749,106.605938,2,0
0,0,19,19,16,17,33,70,57,127,0.000333,0.213546,24,15375.31328,854.184071,640.638053,133.486868,2,0
0,0,11,11,14,14,28,47,34,81,0.000333,0.129799,14,5451.540482,302.86336,389.395749,106.605938,2,0
0,0,13,13,13,16,29,51,55,106,0.000333,0.171649,18,9269.027739,514.945985,514.945985,112.105716,1,0
0,0,8,8,10,14,24,26,24,50,0.000333,0.076416,5,1146.240625,63.680035,229.248125,86.52225,1,0
0,0,31,31,19,48,67,152,101,253,0.000333,0.511574,18,27624.97017,1534.720565,1534.720565,348.788823,9,0
0,0,19,19,15,23,38,87,59,146,0.000333,0.255399,14,10726.76384,595.931324,766.197417,162.645284,5,0
0,0,10,10,11,14,25,34,31,65,0.000333,0.100617,10,3018.506523,167.694807,301.850652,91.356717,1,0
0,0,31,31,19,46,65,157,101,258,0.000333,0.517924,18,27967.87612,1553.770896,1553.770896,334.794473,9,0
0,0,19,19,15,22,37,92,59,151,0.000333,0.262209,14,11012.78442,611.821356,786.627458,156.710855,5,0
0,0,10,10,11,13,24,39,31,70,0.000333,0.106982,10,3209.473751,178.304097,320.947375,86.159464,1,0
0,0,11,11,11,14,25,43,34,77,0.000333,0.119192,10,3575.769266,198.653848,357.576927,91.356717,1,0
0,0,30,30,19,46,65,152,97,249,0.000333,0.499857,18,26992.25254,1499.569585,1499.569585,334.794473,9,0
0,0,18,18,16,21,37,87,55,142,0.000333,0.246581,16,11835.87805,657.54878,739.742378,156.238666,5,0
0,0,9,9,12,12,24,34,27,61,0.000333,0.093228,12,3356.192551,186.455142,279.682713,86.0391,1,0
0,0,14,14,13,14,27,58,41,99,0.000333,0.156911,12,5648.806353,313.822575,470.733863,101.408685,2,0
0,0,17,17,16,16,32,71,49,120,0.000333,0.2,24,14400,800,600,128,3,0
0,0,14,14,13,14,27,58,41,99,0.000333,0.156911,12,5648.806353,313.822575,470.733863,101.408685,2,0
0,0,17,17,16,16,32,71,49,120,0.000333,0.2,24,14400,800,600,128,3,0
0,0,10,10,14,16,30,32,28,60,0.000333,0.098138,7,2060.89405,114.494114,294.413436,117.302969,2,0
0,0,16,16,17,19,36,51,48,99,0.000333,0.170608,16,8189.161202,454.9534,511.822575,150.197491,2,0
0,0,9,9,14,20,34,30,30,60,0.000333,0.101749,7,2136.734393,118.707466,305.24777,139.741531,2,0
0,0,14,14,18,15,33,53,41,94,0.000333,0.158058,18,8535.11485,474.173047,474.173047,133.662009,2,0
0,0,9,9,11,14,25,31,28,59,0.000333,0.091329,10,2739.875152,152.215286,273.987515,91.356717,1,0
0,0,13,13,12,19,31,49,43,92,0.000333,0.151929,12,5469.432727,303.857374,455.786061,123.730173,1,0
0,0,12,12,11,16,27,42,37,79,0.000333,0.125212,10,3756.361127,208.686729,375.636113,102.053748,1,0
0,0,13,13,14,20,34,52,46,98,0.000333,0.16619,14,6979.999018,387.777723,498.571358,139.741531,1,0
0,0,26,26,23,47,70,120,85,205,0.000333,0.418834,11,13821.5332,767.862956,1256.503018,365.107601,10,0
0,0,25,25,23,47,70,119,83,202,0.000333,0.412705,11,13619.26686,756.625937,1238.115169,365.107601,10,0
0,0,26,26,23,47,70,120,85,205,0.000333,0.418834,11,13821.5332,767.862956,1256.503018,365.107601,10,0
0,0,25,25,23,47,70,119,83,202,0.000333,0.412705,11,13619.26686,756.625937,1238.115169,365.107601,10,0
0,0,28,28,24,46,70,124,87,211,0.000333,0.431093,12,15519.3446,862.185811,1293.278717,364.12295,10,0
0,0,27,27,24,46,70,123,85,208,0.000333,0.424964,12,15298.69041,849.927245,1274.890868,364.12295,10,0
0,0,28,28,24,46,70,124,87,211,0.000333,0.431093,12,15519.3446,862.185811,1293.278717,364.12295,10,0
0,0,27,27,24,46,70,123,85,208,0.000333,0.424964,12,15298.69041,849.927245,1274.890868,364.12295,10,0
0,0,7,7,10,12,22,36,26,62,0.000333,0.092162,10,2764.847604,153.602645,276.48476,76.238831,1,0
0,0,10,10,14,15,29,49,34,83,0.000333,0.134404,14,5644.973916,313.609662,403.212423,111.906328,2,0
0,0,9,9,12,11,23,32,28,60,0.000333,0.090471,12,3256.964608,180.942478,271.413717,81.073298,1,0
0,0,9,9,12,11,23,32,28,60,0.000333,0.090471,12,3256.964608,180.942478,271.413717,81.073298,1,0
0,0,18,18,15,24,39,78,58,136,0.000333,0.239605,14,10063.40583,559.078101,718.814702,168.642459,4,0
0,0,15,15,14,21,35,67,51,118,0.000333,0.201752,14,8473.575544,470.754197,605.255396,145.541635,3,0
0,0,12,12,13,17,30,48,39,87,0.000333,0.1423,12,5122.793782,284.599655,426.899482,117.592585,1,0
0,0,11,11,14,20,34,38,39,77,0.000333,0.130578,7,2742.142471,152.341248,391.734639,139.741531,2,0
0,0,14,14,17,19,36,53,48,101,0.000333,0.174054,16,8354.598802,464.144378,522.162425,150.197491,2,0
0,0,8,8,10,12,22,27,25,52,0.000333,0.077297,10,2318.904442,128.828025,231.890444,76.238831,1,0
0,0,8,8,11,13,24,29,23,52,0.000333,0.079473,5,1192.09025,66.227236,238.41805,86.159464,1,0
0,0,9,9,12,11,23,33,28,61,0.000333,0.091979,12,3311.247352,183.958186,275.937279,81.073298,1,0
0,0,9,9,12,11,23,33,28,61,0.000333,0.091979,12,3311.247352,183.958186,275.937279,81.073298,1,0
0,0,14,14,17,17,34,53,44,97,0.000333,0.164495,16,7895.74233,438.652352,493.483896,138.973737,2,0
0,0,11,11,14,19,33,36,36,72,0.000333,0.121065,7,2542.374636,141.243035,363.196377,134.013592,2,0
0,0,16,16,16,18,34,60,52,112,0.000333,0.189932,16,9116.733412,506.48519,569.795838,139.05865,3,0
0,0,16,16,16,18,34,59,52,111,0.000333,0.188236,16,9035.334006,501.963,564.708375,139.05865,3,0
0,0,16,16,16,17,33,59,51,110,0.000333,0.184961,24,13317.20048,739.844471,554.883353,133.486868,3,0
0,0,16,16,16,17,33,59,51,110,0.000333,0.184961,24,13317.20048,739.844471,554.883353,133.486868,3,0
0,0,16,16,16,17,33,59,51,110,0.000333,0.184961,24,13317.20048,739.844471,554.883353,133.486868,3,0
0,0,16,16,16,17,33,59,51,110,0.000333,0.184961,24,13317.20048,739.844471,554.883353,133.486868,3,0
0,0,15,15,18,18,36,61,50,111,0.000333,0.191287,18,10329.51015,573.861675,573.861675,150.1173,3,0
0,0,15,15,18,18,36,61,50,111,0.000333,0.191287,18,10329.51015,573.861675,573.861675,150.1173,3,0
0,0,7,7,10,13,23,24,21,45,0.000333,0.067853,5,1017.80144,56.544524,203.560288,81.324997,1,0
0,0,18,18,16,31,47,79,63,142,0.000333,0.262917,16,12620.02587,701.112548,788.751617,217.580086,6,0
0,0,12,12,14,22,36,41,40,81,0.000333,0.139588,7,2931.347476,162.852638,418.763925,151.410465,2,0
0,0,15,15,14,21,35,70,47,117,0.000333,0.200042,14,8401.765582,466.764755,600.126113,145.541635,5,0
0,0,6,6,10,13,23,16,18,34,0.000333,0.051267,5,769.005533,42.72253,153.801107,81.324997,1,0
0,0,18,18,19,17,36,71,49,120,0.000333,0.206797,18,11167.038,620.391,620.391,150.197491,4,0
0,0,18,18,19,17,36,70,49,119,0.000333,0.205074,18,11073.97935,615.221075,615.221075,150.197491,4,0
0,0,14,14,13,13,26,58,41,99,0.000333,0.155115,18,8376.183578,465.343532,465.343532,96.211433,2,0
0,0,17,17,17,15,32,71,49,120,0.000333,0.2,24,14400,800,600,128.090227,3,0
0,0,14,14,13,14,27,58,41,99,0.000333,0.156911,12,5648.806353,313.822575,470.733863,101.408685,2,0
0,0,17,17,16,16,32,71,49,120,0.000333,0.2,24,14400,800,600,128,3,0
0,0,14,14,13,14,27,58,41,99,0.000333,0.156911,12,5648.806353,313.822575,470.733863,101.408685,2,0
0,0,17,17,16,16,32,71,49,120,0.000333,0.2,24,14400,800,600,128,3,0
0,0,16,16,14,16,30,62,44,106,0.000333,0.173377,14,7281.825644,404.545869,520.130403,117.302969,2,0
0,0,19,19,17,18,35,75,52,127,0.000333,0.21714,16,10422.70309,579.039061,651.418943,144.545518,3,0
0,0,16,16,14,15,29,62,44,106,0.000333,0.171649,14,7209.243797,400.513544,514.945985,111.906328,2,0
0,0,19,19,17,17,34,75,52,127,0.000333,0.215369,24,15506.58674,861.477041,646.107781,138.973737,3,0
0,0,6,6,11,10,21,22,16,38,0.000333,0.055636,5,834.54031,46.363351,166.908062,71.273029,1,0
0,0,6,6,11,10,21,22,16,38,0.000333,0.055636,5,834.54031,46.363351,166.908062,71.273029,1,0
0,0,6,6,11,10,21,22,16,38,0.000333,0.055636,5,834.54031,46.363351,166.908062,71.273029,1,0
0,0,9,9,14,17,31,35,26,61,0.000333,0.100735,7,2115.441825,117.524546,302.205975,122.789837,2,0
0,0,8,8,14,17,31,30,24,54,0.000333,0.089176,7,1872.686205,104.038123,267.526601,122.789837,2,0
0,0,8,8,14,17,31,30,24,54,0.000333,0.089176,7,1872.686205,104.038123,267.526601,122.789837,2,0
0,0,16,16,17,16,33,64,42,106,0.000333,0.178235,16,8555.292426,475.294024,534.705777,133.486868,3,0
0,0,16,16,17,16,33,64,42,106,0.000333,0.178235,16,8555.292426,475.294024,534.705777,133.486868,3,0
0,0,21,21,16,21,37,76,67,143,0.000333,0.248317,24,17878.84395,993.269108,744.951831,156.238666,3,0
0,0,12,12,13,18,31,54,43,97,0.000333,0.160186,12,5766.684505,320.371361,480.557042,123.164366,3,0
0,0,12,12,14,17,31,55,43,98,0.000333,0.161837,14,6797.157338,377.619852,485.511238,122.789837,3,0
0,0,10,10,13,13,26,38,27,65,0.000333,0.101843,12,3666.34298,203.685721,305.528582,96.211433,2,0
0,0,10,10,13,13,26,38,27,65,0.000333,0.101843,12,3666.34298,203.685721,305.528582,96.211433,2,0
0,0,8,8,13,19,32,34,27,61,0.000333,0.101667,6,1830,101.666667,305,128.816339,2,0
0,0,8,8,13,19,32,34,27,61,0.000333,0.101667,6,1830,101.666667,305,128.816339,2,0
0,0,6,6,10,13,23,20,18,38,0.000333,0.057298,5,859.476772,47.74871,171.895354,81.324997,1,0
0,0,6,6,10,13,23,20,18,38,0.000333,0.057298,5,859.476772,47.74871,171.895354,81.324997,1,0
0,0,14,14,15,18,33,65,47,112,0.000333,0.188324,14,7909.609979,439.422777,564.972141,133.662009,5,0
0,0,8,8,11,11,22,28,24,52,0.000333,0.077297,10,2318.904442,128.828025,231.890444,76.107496,1,0
0,0,18,18,15,20,35,77,59,136,0.000333,0.232527,14,9766.154864,542.564159,697.58249,145.041921,5,0
0,0,12,12,11,13,24,40,40,80,0.000333,0.122266,15,5501.955001,305.664167,366.797,86.159464,1,0
0,0,8,8,11,11,22,28,24,52,0.000333,0.077297,10,2318.904442,128.828025,231.890444,76.107496,1,0
0,0,8,8,12,11,23,30,24,54,0.000333,0.081424,12,2931.268148,162.84823,244.272346,81.073298,1,0
0,0,13,13,16,19,35,50,44,94,0.000333,0.160718,16,7714.441657,428.580092,482.152604,144.710623,2,0
0,0,11,11,12,14,26,46,35,81,0.000333,0.126912,12,4568.827406,253.823745,380.735617,96.322519,1,0
0,0,12,12,15,17,32,51,36,87,0.000333,0.145,14,6090,338.333333,435,128.090227,2,0
0,0,10,10,13,16,29,33,29,62,0.000333,0.100398,6,1807.16893,100.398274,301.194822,112.105716,1,0
0,0,9,9,13,14,27,30,26,56,0.000333,0.088758,6,1597.642201,88.7579,266.2737,101.408685,1,0
0,0,14,14,17,16,33,51,42,93,0.000333,0.156376,16,7506.05845,417.003247,469.128653,133.486868,2,0
0,0,17,17,15,17,32,59,58,117,0.000333,0.195,21,12285,682.5,585,128.090227,2,0
0,0,11,11,11,14,25,40,36,76,0.000333,0.117644,10,3529.330704,196.073928,352.93307,91.356717,2,0
0,0,17,17,16,17,33,60,56,116,0.000333,0.19505,24,14043.59323,780.199624,585.149718,133.486868,2,0
0,0,8,8,13,20,33,33,28,61,0.000333,0.102569,6,1846.248248,102.569347,307.708041,134.544278,2,0
0,0,9,9,14,19,33,38,28,66,0.000333,0.110977,7,2330.510083,129.472782,332.930012,134.013592,2,0
0,0,18,18,18,19,37,66,58,124,0.000333,0.215324,27,17441.24987,968.958326,645.972217,155.769273,4,0
0,0,18,18,18,19,37,65,58,123,0.000333,0.213588,27,17300.59463,961.144146,640.762764,155.769273,4,0
0,0,13,13,13,17,30,53,39,92,0.000333,0.150478,12,5417.207218,300.955957,451.433935,117.592585,4,0
0,0,16,16,13,20,33,64,46,110,0.000333,0.184961,12,6658.600238,369.922235,554.883353,134.544278,5,0
0,0,10,10,14,13,27,34,27,61,0.000333,0.096683,14,4060.673927,225.592996,290.048138,101.408685,2,0
0,0,17,17,15,17,32,61,57,118,0.000333,0.196667,21,12390,688.333333,590,128.090227,2,0
0,0,19,19,19,19,38,69,62,131,0.000333,0.22916,27,18561.91962,1031.217756,687.478504,161.421246,3,0
0,0,16,16,15,16,31,57,52,109,0.000333,0.180002,21,11340.15535,630.008631,540.007398,122.603359,3,0
0,0,18,18,19,18,37,65,57,122,0.000333,0.211851,27,17159.93939,953.329966,635.553311,155.769273,4,0
0,0,15,15,14,16,30,54,51,105,0.000333,0.171741,21,10819.69376,601.094098,515.223513,117.302969,2,0
0,0,17,17,18,18,36,62,56,118,0.000333,0.20335,27,16471.38106,915.076725,610.05115,150.1173,3,0
0,0,8,8,14,18,32,29,25,54,0.000333,0.09,7,1890,105,270,128.361619,2,0
0,0,8,8,14,18,32,29,25,54,0.000333,0.09,7,1890,105,270,128.361619,2,0
0,0,5,5,8,7,15,12,11,23,0.000333,0.029953,4,359.433935,19.968552,89.858484,43.651484,1,0
0,0,5,5,9,8,17,13,13,26,0.000333,0.035425,4,425.096135,23.616452,106.274034,52.529325,1,0
0,0,5,5,9,8,17,13,13,26,0.000333,0.035425,4,425.096135,23.616452,106.274034,52.529325,1,0
0,0,6,6,11,10,21,22,16,38,0.000333,0.055636,5,834.54031,46.363351,166.908062,71.273029,1,0
0,0,9,9,13,14,27,30,26,56,0.000333,0.088758,6,1597.642201,88.7579,266.2737,101.408685,1,0
0,0,10,10,13,16,29,33,29,62,0.000333,0.100398,6,1807.16893,100.398274,301.194822,112.105716,1,0
0,0,13,13,15,19,34,47,44,91,0.000333,0.15432,14,6481.42766,360.079314,462.959119,139.313982,2,0
0,0,11,11,14,15,29,35,32,67,0.000333,0.108495,14,4556.786173,253.154787,325.484727,111.906328,2,0
0,0,10,10,14,15,29,32,30,62,0.000333,0.100398,14,4216.727504,234.262639,301.194822,111.906328,2,0
0,0,9,9,11,15,26,32,30,62,0.000333,0.097142,10,2914.272625,161.904035,291.427263,96.657107,1,0
0,0,8,8,11,12,23,25,25,50,0.000333,0.075393,10,2261.780978,125.654499,226.178098,81.073298,1,0
0,0,7,7,10,12,22,24,21,45,0.000333,0.066891,5,1003.372114,55.742895,200.674423,76.238831,1,0
0,0,6,6,10,11,21,21,17,38,0.000333,0.055636,5,834.54031,46.363351,166.908062,71.273029,1,0
0,0,6,6,10,11,21,21,17,38,0.000333,0.055636,5,834.54031,46.363351,166.908062,71.273029,1,0
0,0,31,31,22,57,79,177,131,308,0.000333,0.647188,22,42714.41835,2373.023242,1941.56447,430.582226,14,0
0,0,13,13,15,31,46,84,56,140,0.000333,0.257766,7,5413.090717,300.727262,773.298674,212.183445,7,0
0,0,33,33,22,58,80,184,137,321,0.000333,0.676446,22,44645.45621,2480.303123,2029.338918,437.870393,14,0
0,0,13,13,15,31,46,84,56,140,0.000333,0.257766,7,5413.090717,300.727262,773.298674,212.183445,7,0
0,0,11,11,13,17,30,43,41,84,0.000333,0.137393,12,4946.14572,274.785873,412.17881,117.592585,1,0
0,0,14,14,17,20,37,56,49,105,0.000333,0.182331,16,8751.881654,486.215647,546.992603,155.92543,2,0
0,0,22,22,18,27,45,97,73,170,0.000333,0.311205,18,16805.07048,933.615026,933.615026,203.440613,4,0
0,0,19,19,17,24,41,76,63,139,0.000333,0.248233,16,11915.19566,661.955314,744.699729,179.525968,2,0
0,0,17,17,15,23,38,75,62,137,0.000333,0.239655,14,10065.52497,559.195832,718.966069,162.645284,3,0
0,0,18,18,13,21,34,69,61,130,0.000333,0.220457,12,7936.442032,440.913446,661.370169,140.344382,1,0
0,0,21,21,17,24,41,82,69,151,0.000333,0.269663,16,12943.84564,719.102536,808.990353,179.525968,2,0
0,0,11,11,11,14,25,39,36,75,0.000333,0.116096,10,3482.892142,193.494008,348.289214,91.356717,2,0
0,0,8,8,10,12,22,26,24,50,0.000333,0.074324,10,2229.715809,123.873101,222.971581,76.238831,1,0
0,0,8,8,11,14,25,27,26,53,0.000333,0.082041,5,1230.62189,68.367883,246.124378,91.356717,1,0
0,0,14,14,15,18,33,52,46,98,0.000333,0.164784,14,6920.908732,384.49493,494.350624,133.662009,2,0
0,0,8,8,11,11,22,28,22,50,0.000333,0.074324,10,2229.715809,123.873101,222.971581,76.107496,1,0
0,0,8,8,11,13,24,29,23,52,0.000333,0.079473,5,1192.09025,66.227236,238.41805,86.159464,1,0
0,0,11,11,12,17,29,48,37,85,0.000333,0.137643,12,4955.140615,275.28559,412.928385,112.506418,1,0
0,0,13,13,14,20,34,57,43,100,0.000333,0.169582,14,7122.447978,395.691554,508.746284,139.741531,2,0
0,0,10,10,12,13,25,43,31,74,0.000333,0.114548,12,4123.744297,229.096905,343.645358,91.125266,1,0
0,0,15,15,19,19,38,58,45,103,0.000333,0.180179,18,9729.65761,540.536534,540.536534,161.421246,4,0
0,0,15,15,19,19,38,58,45,103,0.000333,0.180179,18,9729.65761,540.536534,540.536534,161.421246,4,0
0,0,7,7,10,15,25,22,24,46,0.000333,0.071206,5,1068.086924,59.338162,213.617385,91.82264,1,0
0,0,9,9,12,18,30,31,30,61,0.000333,0.099773,6,1795.921958,99.773442,299.320326,118.0782,2,0
0,0,6,6,11,12,23,17,17,34,0.000333,0.051267,5,769.005533,42.72253,153.801107,81.073298,1,0
0,0,14,14,17,17,34,50,42,92,0.000333,0.156016,16,7488.745302,416.041406,468.046581,138.973737,2,0
0,0,16,16,19,17,36,59,56,115,0.000333,0.19818,27,16052.61713,891.812063,594.541375,150.197491,3,0
0,0,16,16,19,17,36,59,56,115,0.000333,0.19818,27,16052.61713,891.812063,594.541375,150.197491,3,0
0,0,13,13,18,16,34,49,40,89,0.000333,0.150928,18,8150.115472,452.784193,452.784193,139.05865,3,0
0,0,14,14,17,18,35,55,46,101,0.000333,0.172686,16,8288.921355,460.495631,518.057585,144.545518,3,0
0,0,16,16,19,19,38,63,48,111,0.000333,0.194173,18,10485.35917,582.519954,582.519954,161.421246,3,0
0,0,13,13,19,17,36,50,41,91,0.000333,0.156821,18,8468.337152,470.463175,470.463175,150.197491,3,0
0,0,13,13,18,17,35,49,41,90,0.000333,0.153878,18,8309.438487,461.635472,461.635472,144.545518,3,0
0,0,10,10,10,13,23,41,41,82,0.000333,0.123644,15,5563.981206,309.110067,370.93208,81.324997,1,0
0,0,7,7,7,10,17,16,16,32,0.000333,0.0436,3,392.396433,21.799802,130.798811,52.870765,1,0
0,0,7,7,8,11,19,17,18,35,0.000333,0.049559,4,594.709852,33.039436,148.677463,62.053748,1,0
0,0,15,15,15,17,32,52,44,96,0.000333,0.16,14,6720,373.333333,480,128.090227,3,0
0,0,8,8,13,13,26,30,28,58,0.000333,0.090875,12,3271.506044,181.750336,272.625504,96.211433,2,0
0,0,12,12,15,16,31,43,37,80,0.000333,0.132112,14,5548.699868,308.261104,396.335705,122.603359,2,0
0,0,12,12,13,16,29,43,35,78,0.000333,0.126308,12,4547.070211,252.615012,378.922518,112.105716,1,0
0,0,5,5,10,10,20,22,17,39,0.000333,0.056185,5,842.775979,46.820888,168.555196,66.438562,1,0
0,0,11,11,13,13,26,42,32,74,0.000333,0.115944,12,4173.99047,231.888359,347.832539,96.211433,1,0
0,0,12,12,17,14,31,46,35,81,0.000333,0.133763,16,6420.638418,356.702134,401.289901,122.789837,2,0
0,0,14,14,17,16,33,55,42,97,0.000333,0.163102,16,7828.899673,434.938871,489.30623,133.486868,3,0
0,0,15,15,18,18,36,54,44,98,0.000333,0.168884,18,9119.747703,506.65265,506.65265,150.1173,2,0
0,0,14,14,17,15,32,52,41,93,0.000333,0.155,16,7440,413.333333,465,128.090227,2,0
0,0,16,16,16,17,33,69,49,118,0.000333,0.198413,16,9523.816097,529.100894,595.238506,133.486868,2,0
0,0,17,17,14,15,29,69,55,124,0.000333,0.200797,21,12650.18251,702.787917,602.389643,111.906328,2,0
0,0,20,20,17,17,34,82,63,145,0.000333,0.245894,24,17704.37069,983.576149,737.682112,138.973737,3,0
0,0,10,10,15,14,29,45,31,76,0.000333,0.123069,14,5168.891779,287.160654,369.206556,111.906328,2,0
0,0,17,17,14,15,29,69,55,124,0.000333,0.200797,21,12650.18251,702.787917,602.389643,111.906328,2,0
0,0,20,20,17,17,34,82,63,145,0.000333,0.245894,24,17704.37069,983.576149,737.682112,138.973737,3,0
0,0,10,10,15,14,29,45,31,76,0.000333,0.123069,14,5168.891779,287.160654,369.206556,111.906328,2,0
0,0,11,11,15,13,28,39,31,70,0.000333,0.112172,14,4711.207824,261.733768,336.514845,106.709075,2,0
0,0,11,11,15,13,28,39,31,70,0.000333,0.112172,14,4711.207824,261.733768,336.514845,106.709075,2,0
0,0,8,8,14,12,26,28,19,47,0.000333,0.07364,7,1546.444667,85.913593,220.920667,96.322519,2,0
0,0,16,16,13,22,35,61,53,114,0.000333,0.194913,12,7016.859167,389.825509,584.738264,146.213212,3,0
0,0,14,14,10,17,27,44,50,94,0.000333,0.148986,10,4469.594252,248.310792,446.959425,102.706149,1,0
0,0,8,8,10,16,26,27,25,52,0.000333,0.081474,5,1222.114327,67.89524,244.422865,97.219281,1,0
0,0,6,6,10,13,23,20,18,38,0.000333,0.057298,5,859.476772,47.74871,171.895354,81.324997,1,0
0,0,9,9,11,14,25,31,28,59,0.000333,0.091329,10,2739.875152,152.215286,273.987515,91.356717,1,0
0,0,12,12,12,15,27,40,38,78,0.000333,0.123627,12,4450.574702,247.25415,370.881225,101.622909,1,0
0,0,13,13,12,17,29,49,42,91,0.000333,0.147359,12,5304.915247,294.717514,442.076271,112.506418,2,0
0,0,16,16,16,20,36,62,50,112,0.000333,0.193011,16,9264.505603,514.694756,579.0316,150.438562,3,0
0,0,13,13,13,17,30,50,42,92,0.000333,0.150478,12,5417.207218,300.955957,451.433935,117.592585,2,0
0,0,16,16,17,20,37,63,50,113,0.000333,0.196223,16,9418.691685,523.260649,588.66823,155.92543,3,0
0,0,10,10,13,18,31,37,32,69,0.000333,0.113947,6,2051.037273,113.946515,341.839545,123.164366,2,0
0,0,9,9,13,14,27,34,26,60,0.000333,0.095098,6,1711.759501,95.09775,285.29325,101.408685,2,0
0,0,15,15,13,17,30,55,52,107,0.000333,0.175012,18,9450.671287,525.037294,525.037294,117.592585,2,0
0,0,9,9,13,14,27,37,28,65,0.000333,0.103023,12,3708.812252,206.045125,309.067688,101.408685,2,0
0,0,7,7,11,12,23,28,22,50,0.000333,0.075393,5,1130.890489,62.827249,226.178098,81.073298,1,0
0,0,27,27,19,46,65,135,89,224,0.000333,0.44967,9,12141.09351,674.505195,1349.01039,334.794473,9,0
0,0,15,15,14,21,35,70,47,117,0.000333,0.200042,14,8401.765582,466.764755,600.126113,145.541635,5,0
0,0,6,6,11,13,24,17,18,35,0.000333,0.053491,5,802.368438,44.576024,160.473688,86.159464,1,0
0,0,12,12,12,14,26,47,43,90,0.000333,0.141013,18,7614.712343,423.039575,423.039575,96.322519,1,0
0,0,14,14,16,16,32,55,48,103,0.000333,0.171667,24,12360,686.666667,515,128,2,0
0,0,13,13,14,15,29,51,45,96,0.000333,0.155455,21,9793.689686,544.093871,466.366176,111.906328,2,0
0,0,15,15,16,17,33,59,50,109,0.000333,0.18328,16,8797.423344,488.745741,549.838959,133.486868,3,0
0,0,13,13,13,15,28,50,45,95,0.000333,0.152233,18,8220.576917,456.698718,456.698718,106.709075,2,0
0,0,15,15,16,17,33,58,50,108,0.000333,0.181598,16,8716.713038,484.261835,544.794565,133.486868,3,0
0,0,13,13,13,15,28,50,44,94,0.000333,0.15063,12,5422.696352,301.260908,451.891363,106.709075,2,0
0,0,15,15,16,17,33,58,49,107,0.000333,0.179917,16,8636.002732,479.77793,539.750171,133.486868,3,0
0,0,13,13,13,15,28,50,44,94,0.000333,0.15063,12,5422.696352,301.260908,451.891363,106.709075,2,0
0,0,15,15,16,17,33,58,49,107,0.000333,0.179917,16,8636.002732,479.77793,539.750171,133.486868,3,0
0,0,18,18,17,18,35,70,56,126,0.000333,0.21543,24,15510.95184,861.719547,646.28966,144.545518,3,0
0,0,18,18,16,19,35,72,57,129,0.000333,0.220559,24,15880.26022,882.236679,661.677509,144.710623,4,0
0,0,12,12,14,16,30,53,41,94,0.000333,0.153749,14,6457.468024,358.748224,461.247716,117.302969,3,0
0,0,13,13,12,16,28,53,48,101,0.000333,0.161848,18,8739.771248,485.542847,485.542847,107.01955,1,0
0,0,16,16,16,19,35,65,57,122,0.000333,0.208591,24,15018.54067,834.363371,625.772528,144.710623,2,0
0,0,9,9,14,19,33,32,27,59,0.000333,0.099206,7,2083.334771,115.740821,297.619253,134.013592,2,0
0,0,8,8,14,18,32,29,25,54,0.000333,0.09,7,1890,105,270,128.361619,2,0
0,0,16,16,15,17,32,57,52,109,0.000333,0.181667,21,11445,635.833333,545,128.090227,3,0
0,0,16,16,15,17,32,56,52,108,0.000333,0.18,21,11340,630,540,128.090227,3,0
0,0,16,16,14,23,37,65,55,120,0.000333,0.208378,14,8751.881654,486.215647,625.134404,157.344894,2,0
0,0,15,15,12,20,32,58,51,109,0.000333,0.181667,12,6540,363.333333,545,129.458112,2,0
0,0,11,11,11,13,24,39,30,69,0.000333,0.105454,10,3163.624125,175.756896,316.362413,86.159464,2,0
0,0,14,14,15,16,31,52,38,90,0.000333,0.148626,14,6242.287351,346.793742,445.877668,122.603359,3,0
0,0,14,14,18,18,36,56,43,99,0.000333,0.170608,18,9212.806353,511.822575,511.822575,150.1173,2,0
0,0,10,10,16,16,32,42,30,72,0.000333,0.12,8,2880,160,360,128,2,0
0,0,12,12,15,14,29,42,31,73,0.000333,0.118211,14,4964.856577,275.825365,354.632613,111.906328,2,0
0,0,11,11,14,20,34,45,37,82,0.000333,0.139057,7,2920.203671,162.233537,417.171953,139.741531,2,0
0,0,11,11,14,20,34,45,39,84,0.000333,0.142449,7,2991.428151,166.190453,427.346879,139.741531,2,0
0,0,11,11,14,20,34,45,39,84,0.000333,0.142449,7,2991.428151,166.190453,427.346879,139.741531,2,0
0,0,36,36,19,51,70,171,113,284,0.000333,0.580239,18,31332.89478,1740.716377,1740.716377,370.004315,12,0
0,0,21,21,15,23,38,93,61,154,0.000333,0.269394,14,11314.53172,628.585095,808.180837,162.645284,6,0
0,0,12,12,14,14,28,40,35,75,0.000333,0.120184,14,5047.722668,280.429037,360.551619,106.605938,2,0
0,0,8,8,11,14,25,27,26,53,0.000333,0.082041,5,1230.62189,68.367883,246.124378,91.356717,1,0
0,0,13,13,16,22,38,62,47,109,0.000333,0.190675,16,9152.385583,508.465866,572.024099,162.107496,5,0
0,0,9,9,11,15,26,32,29,61,0.000333,0.095576,5,1433.634114,79.64634,286.726823,96.657107,1,0
0,0,14,14,15,24,39,62,51,113,0.000333,0.199083,14,8361.50631,464.528128,597.250451,168.642459,5,0
0,0,10,10,10,17,27,32,33,65,0.000333,0.103023,5,1545.338438,85.852135,309.067688,102.706149,1,0
0,0,10,10,14,20,34,45,38,83,0.000333,0.140753,7,2955.815911,164.211995,422.259416,139.741531,6,0
0,0,6,6,10,14,24,15,19,34,0.000333,0.051963,5,779.443625,43.302424,155.888725,86.52225,2,0
0,0,16,16,13,20,33,79,59,138,0.000333,0.232042,12,8353.516662,464.084259,696.126388,134.544278,1,0
0,0,21,21,19,19,38,82,58,140,0.000333,0.244903,27,19837.166,1102.064778,734.709852,161.421246,4,0
0,0,10,10,14,14,28,42,30,72,0.000333,0.115377,14,4845.813761,269.211876,346.129554,106.605938,2,0
0,0,21,21,19,19,38,82,58,140,0.000333,0.244903,27,19837.166,1102.064778,734.709852,161.421246,4,0
0,0,10,10,14,14,28,42,30,72,0.000333,0.115377,14,4845.813761,269.211876,346.129554,106.605938,2,0
0,0,9,9,9,12,21,34,37,71,0.000333,0.103952,12,3742.254444,207.903025,311.854537,71.548875,1,0
0,0,9,9,12,13,25,38,31,69,0.000333,0.106809,12,3845.112925,213.617385,320.426077,91.125266,1,0
0,0,13,13,12,15,27,50,47,97,0.000333,0.153741,18,8302.033579,461.224088,461.224088,101.622909,1,0
0,0,13,13,13,15,28,51,48,99,0.000333,0.158643,18,8566.706471,475.928137,475.928137,106.709075,1,0
0,0,13,13,17,19,36,51,47,98,0.000333,0.168884,16,8106.442402,450.357911,506.65265,150.197491,2,0
0,0,8,8,13,14,27,25,22,47,0.000333,0.074493,6,1340.878276,74.493238,223.479713,101.408685,2,0
0,0,8,8,13,14,27,25,22,47,0.000333,0.074493,6,1340.878276,74.493238,223.479713,101.408685,2,0
0,0,15,15,14,17,31,55,47,102,0.000333,0.168443,14,7074.592331,393.032907,505.328024,122.789837,2,0
0,0,17,17,17,19,36,63,52,115,0.000333,0.19818,16,9512.662003,528.481222,594.541375,150.197491,3,0
0,0,15,15,14,16,30,55,47,102,0.000333,0.166834,14,7007.039771,389.279987,500.502841,117.302969,2,0
0,0,17,17,17,18,35,63,52,115,0.000333,0.196623,16,9437.880751,524.326708,589.867547,144.545518,3,0
0,0,7,7,11,12,23,28,23,51,0.000333,0.076901,5,1153.508299,64.083794,230.70166,81.073298,2,0
0,0,19,19,16,18,34,76,62,138,0.000333,0.234023,24,16849.67693,936.093163,702.069872,139.05865,3,0
0,0,22,22,19,20,39,89,70,159,0.000333,0.280126,27,22690.23173,1260.568429,840.378953,167.149185,4,0
0,0,7,7,12,13,25,29,24,53,0.000333,0.082041,6,1476.746268,82.041459,246.124378,91.125266,2,0
0,0,12,12,17,17,34,54,38,92,0.000333,0.156016,16,7488.745302,416.041406,468.046581,138.973737,3,0
0,0,19,19,16,18,34,76,62,138,0.000333,0.234023,24,16849.67693,936.093163,702.069872,139.05865,3,0
0,0,22,22,19,20,39,89,70,159,0.000333,0.280126,27,22690.23173,1260.568429,840.378953,167.149185,4,0
0,0,7,7,12,13,25,29,24,53,0.000333,0.082041,6,1476.746268,82.041459,246.124378,91.125266,2,0
0,0,12,12,17,17,34,54,38,92,0.000333,0.156016,16,7488.745302,416.041406,468.046581,138.973737,3,0
0,0,7,7,11,12,23,28,23,51,0.000333,0.076901,5,1153.508299,64.083794,230.70166,81.073298,2,0
0,0,17,17,15,17,32,72,53,125,0.000333,0.208333,21,13125,729.166667,625,128.090227,2,0
0,0,20,20,19,19,38,85,61,146,0.000333,0.255399,27,20687.33026,1149.296125,766.197417,161.421246,3,0
0,0,7,7,12,13,25,29,24,53,0.000333,0.082041,6,1476.746268,82.041459,246.124378,91.125266,2,0
0,0,12,12,17,17,34,54,38,92,0.000333,0.156016,16,7488.745302,416.041406,468.046581,138.973737,3,0
0,0,17,17,15,20,35,64,50,114,0.000333,0.194913,14,8186.335695,454.796428,584.738264,145.041921,2,0
0,0,17,17,16,22,38,65,53,118,0.000333,0.206418,16,9908.087145,550.449286,619.255447,162.107496,2,0
0,0,15,15,12,18,30,58,50,108,0.000333,0.176648,12,6359.330212,353.296123,529.944184,118.0782,1,0
0,0,10,10,14,14,28,45,29,74,0.000333,0.118581,14,4980.419699,276.689983,355.744264,106.605938,4,0
0,0,9,9,11,14,25,31,30,61,0.000333,0.094425,10,2832.752276,157.375126,283.275228,91.356717,1,0
0,0,9,9,11,14,25,31,30,61,0.000333,0.094425,10,2832.752276,157.375126,283.275228,91.356717,1,0
0,0,8,8,11,14,25,28,26,54,0.000333,0.083589,5,1253.841171,69.657843,250.768234,91.356717,1,0
0,0,8,8,10,16,26,27,25,52,0.000333,0.081474,5,1222.114327,67.89524,244.422865,97.219281,1,0
0,0,6,6,12,11,23,28,20,48,0.000333,0.072377,6,1302.785843,72.376991,217.130974,81.073298,1,0
0,0,10,10,16,15,31,43,30,73,0.000333,0.120552,16,5786.501291,321.472294,361.656331,122.603359,2,0
0,0,14,14,18,17,35,61,45,106,0.000333,0.181235,18,9786.671996,543.704,543.704,144.545518,2,0
0,0,11,11,12,15,27,55,38,93,0.000333,0.147402,12,5306.454452,294.803025,442.204538,101.622909,1,0
0,0,8,8,13,13,26,31,28,59,0.000333,0.092442,12,3327.91132,184.883962,277.325943,96.211433,2,0
0,0,6,6,9,10,19,16,16,32,0.000333,0.045311,4,543.734722,30.207485,135.93368,61.748606,1,0
0,0,13,13,15,17,32,47,38,85,0.000333,0.141667,14,5950,330.555556,425,128.090227,2,0
0,0,10,10,14,15,29,33,28,61,0.000333,0.098779,7,2074.357885,115.242105,296.336841,111.906328,2,0
0,0,10,10,14,15,29,33,28,61,0.000333,0.098779,7,2074.357885,115.242105,296.336841,111.906328,2,0
0,0,11,11,15,17,32,37,31,68,0.000333,0.113333,7,2380,132.222222,340,128.090227,2,0
0,0,11,11,14,17,31,36,31,67,0.000333,0.110644,7,2323.51807,129.084337,331.931153,122.789837,2,0
0,0,11,11,15,19,34,45,36,81,0.000333,0.137361,7,2884.591431,160.255079,412.08449,139.313982,2,0
0,0,16,16,16,17,33,65,48,113,0.000333,0.190006,16,9120.264568,506.681365,570.016535,133.486868,3,0
0,0,19,19,18,19,37,78,56,134,0.000333,0.232689,18,12565.20152,698.066751,698.066751,155.769273,4,0
0,0,16,16,15,17,32,64,48,112,0.000333,0.186667,14,7840,435.555556,560,128.090227,3,0
0,0,19,19,18,19,37,77,56,133,0.000333,0.230952,18,12471.43136,692.857298,692.857298,155.769273,4,0
0,0,6,6,12,10,22,20,16,36,0.000333,0.053513,6,963.23723,53.513179,160.539538,76.238831,2,0
0,0,25,25,18,44,62,113,86,199,0.000333,0.394962,9,10663.96559,592.442533,1184.885066,315.273641,9,0
0,0,21,21,18,43,61,105,76,181,0.000333,0.357821,9,9661.171123,536.731729,1073.463458,308.388034,9,0
0,0,6,6,14,10,24,24,18,42,0.000333,0.064189,7,1347.978975,74.887721,192.568425,86.52225,3,0
0,0,19,19,18,19,37,77,62,139,0.000333,0.241371,27,19551.07848,1086.171027,724.114018,155.769273,2,0
0,0,13,13,17,17,34,54,44,98,0.000333,0.16619,16,7977.141735,443.174541,498.571358,138.973737,2,0
0,0,16,16,14,19,33,59,46,105,0.000333,0.176554,14,7415.259355,411.958853,529.661383,134.013592,2,0
0,0,16,16,16,20,36,61,50,111,0.000333,0.191287,16,9181.786803,510.099267,573.861675,150.438562,2,0
0,0,21,21,18,24,42,86,71,157,0.000333,0.282198,18,15238.68904,846.593835,846.593835,185.09775,3,0
0,0,15,15,17,17,34,61,50,111,0.000333,0.188236,16,9035.334006,501.963,564.708375,138.973737,2,0
0,0,8,8,15,16,31,31,23,54,0.000333,0.089176,7,1872.686205,104.038123,267.526601,122.603359,2,0
0,0,13,13,17,16,33,55,42,97,0.000333,0.163102,16,7828.899673,434.938871,489.30623,133.486868,2,0
0,0,13,13,17,17,34,57,51,108,0.000333,0.183149,24,13186.70369,732.594649,549.445987,138.973737,2,0
0,0,25,25,22,44,66,114,83,197,0.000333,0.396915,11,13098.20206,727.677892,1190.745642,338.322487,9,0
0,0,24,24,22,44,66,113,81,194,0.000333,0.390871,11,12898.73705,716.596503,1172.612459,338.322487,9,0
0,0,10,10,11,14,25,34,32,66,0.000333,0.102165,10,3064.945085,170.274727,306.494509,91.356717,1,0
0,0,13,13,15,17,32,47,40,87,0.000333,0.145,14,6090,338.333333,435,128.090227,2,0
0,0,15,15,16,19,35,58,48,106,0.000333,0.181235,16,8699.263997,483.292444,543.704,144.710623,2,0
0,0,13,13,15,19,34,57,47,104,0.000333,0.176365,14,7407.345897,411.519216,529.096135,139.313982,3,0
0,0,32,32,21,49,70,142,107,249,0.000333,0.50873,20,30523.82942,1695.768301,1526.191471,367.359448,10,0
0,0,31,31,21,49,70,141,105,246,0.000333,0.502601,20,30156.07244,1675.337358,1507.803622,367.359448,10,0
0,0,14,14,15,15,30,50,45,95,0.000333,0.155385,21,9789.246738,543.847041,466.154607,117.206718,2,0
0,0,15,15,18,17,35,63,49,112,0.000333,0.191493,18,10340.63456,574.479698,574.479698,144.545518,3,0
0,0,15,15,18,17,35,63,49,112,0.000333,0.191493,18,10340.63456,574.479698,574.479698,144.545518,3,0
0,0,13,13,17,16,33,55,42,97,0.000333,0.163102,16,7828.899673,434.938871,489.30623,133.486868,2,0
0,0,7,7,12,13,25,31,27,58,0.000333,0.089781,12,3232.123908,179.562439,269.343659,91.125266,1,0
0,0,12,12,15,16,31,57,41,98,0.000333,0.161837,14,6797.157338,377.619852,485.511238,122.603359,5,0
0,0,8,8,11,11,22,26,22,48,0.000333,0.071351,10,2140.527177,118.918176,214.052718,76.107496,2,0
0,0,9,9,14,19,33,38,28,66,0.000333,0.110977,7,2330.510083,129.472782,332.930012,134.013592,2,0
0,0,10,10,14,19,33,41,32,73,0.000333,0.122747,7,2577.685395,143.204744,368.240771,134.013592,2,0
0,0,16,16,15,24,39,78,57,135,0.000333,0.237843,14,9989.410194,554.967233,713.5293,168.642459,6,0
0,0,10,10,14,19,33,41,34,75,0.000333,0.12611,7,2648.306913,147.128162,378.329559,134.013592,2,0
0,0,17,17,17,17,34,59,40,99,0.000333,0.167886,16,8058.541141,447.69673,503.658821,138.973737,3,0
0,0,10,10,15,14,29,38,27,65,0.000333,0.105256,7,2210.381353,122.798964,315.768765,111.906328,2,0
0,0,17,17,17,17,34,59,40,99,0.000333,0.167886,16,8058.541141,447.69673,503.658821,138.973737,3,0
0,0,10,10,15,14,29,38,27,65,0.000333,0.105256,7,2210.381353,122.798964,315.768765,111.906328,2,0
0,0,6,6,11,10,21,22,16,38,0.000333,0.055636,5,834.54031,46.363351,166.908062,71.273029,1,0
0,0,6,6,11,10,21,22,16,38,0.000333,0.055636,5,834.54031,46.363351,166.908062,71.273029,1,0
0,0,7,7,10,11,21,20,17,37,0.000333,0.054172,5,812.578723,45.143262,162.515745,71.273029,3,0
0,0,7,7,10,12,22,20,18,38,0.000333,0.056486,5,847.292008,47.071778,169.458402,76.238831,3,0
0,0,15,15,15,16,31,64,47,111,0.000333,0.183305,14,7698.821066,427.712281,549.91579,122.603359,2,0
0,0,18,18,19,18,37,77,55,132,0.000333,0.229216,27,18566.4918,1031.471766,687.647844,155.769273,3,0
0,0,15,15,12,14,26,61,46,107,0.000333,0.167649,18,9053.046897,502.94705,502.94705,96.322519,1,0
0,0,18,18,16,16,32,74,54,128,0.000333,0.213333,24,15360,853.333333,640,128,2,0
0,0,8,8,13,14,27,25,22,47,0.000333,0.074493,6,1340.878276,74.493238,223.479713,101.408685,2,0
0,0,8,8,13,14,27,25,22,47,0.000333,0.074493,6,1340.878276,74.493238,223.479713,101.408685,2,0
0,0,12,12,17,17,34,52,43,95,0.000333,0.161103,16,7732.943519,429.607973,483.30897,138.973737,2,0
0,0,6,6,10,13,23,20,18,38,0.000333,0.057298,5,859.476772,47.74871,171.895354,81.324997,1,0
0,0,16,16,15,16,31,64,47,111,0.000333,0.183305,14,7698.821066,427.712281,549.91579,122.603359,3,0
0,0,19,19,18,18,36,77,55,132,0.000333,0.227477,27,18425.61271,1023.64515,682.4301,150.1173,4,0
0,0,16,16,15,16,31,64,47,111,0.000333,0.183305,14,7698.821066,427.712281,549.91579,122.603359,3,0
0,0,19,19,18,18,36,77,55,132,0.000333,0.227477,27,18425.61271,1023.64515,682.4301,150.1173,4,0
0,0,19,19,17,22,39,70,61,131,0.000333,0.230796,16,11078.20305,615.455725,692.387691,167.594364,2,0
0,0,11,11,15,19,34,49,39,88,0.000333,0.149232,14,6267.75422,348.208568,447.69673,139.313982,2,0
0,0,10,10,11,13,24,34,29,63,0.000333,0.096284,10,2888.526375,160.473688,288.852638,86.159464,1,0
0,0,11,11,14,16,30,39,30,69,0.000333,0.112858,7,2370.028158,131.668231,338.575451,117.302969,2,0
0,0,6,6,9,10,19,16,16,32,0.000333,0.045311,4,543.734722,30.207485,135.93368,61.748606,1,0
0,0,13,13,15,17,32,47,38,85,0.000333,0.141667,14,5950,330.555556,425,128.090227,2,0
0,0,11,11,14,15,29,36,32,68,0.000333,0.110114,14,4624.797907,256.933217,330.342708,111.906328,2,0
0,0,8,8,13,14,27,25,22,47,0.000333,0.074493,6,1340.878276,74.493238,223.479713,101.408685,2,0
0,0,17,17,17,17,34,66,51,117,0.000333,0.198411,24,14285.59566,793.644203,595.233152,138.973737,4,0
0,0,17,17,17,18,35,66,51,117,0.000333,0.200042,16,9602.017808,533.445434,600.126113,144.545518,4,0
0,0,16,16,16,17,33,63,50,113,0.000333,0.190006,16,9120.264568,506.681365,570.016535,133.486868,3,0
0,0,12,12,14,16,30,53,41,94,0.000333,0.153749,14,6457.468024,358.748224,461.247716,117.302969,3,0
0,0,17,17,18,18,36,67,52,119,0.000333,0.205074,18,11073.97935,615.221075,615.221075,150.1173,4,0
0,0,17,17,17,18,35,66,52,118,0.000333,0.201752,16,9684.086336,538.004796,605.255396,144.545518,4,0
0,0,14,14,13,15,28,54,49,103,0.000333,0.165053,18,8912.836025,495.157557,495.157557,106.709075,1,0
0,0,16,16,17,17,34,62,54,116,0.000333,0.196715,24,14163.49655,786.860919,590.14569,138.973737,2,0
0,0,15,15,13,18,31,55,52,107,0.000333,0.1767,12,6361.188063,353.399337,530.099005,123.164366,1,0
0,0,17,17,17,20,37,63,57,120,0.000333,0.208378,16,10002.15046,555.675026,625.134404,155.92543,2,0
0,0,9,9,14,17,31,35,26,61,0.000333,0.100735,7,2115.441825,117.524546,302.205975,122.789837,2,0
0,0,10,10,14,18,32,36,32,68,0.000333,0.113333,7,2380,132.222222,340,128.361619,2,0
0,0,9,9,14,18,32,33,26,59,0.000333,0.098333,7,2065,114.722222,295,128.361619,2,0
0,0,10,10,14,20,34,37,31,68,0.000333,0.115316,7,2421.632312,134.535128,345.947473,139.741531,2,0
0,0,11,11,15,18,33,41,36,77,0.000333,0.129473,14,5437.856861,302.103159,388.418347,133.662009,2,0
0,0,11,11,15,18,33,41,36,77,0.000333,0.129473,14,5437.856861,302.103159,388.418347,133.662009,2,0
0,0,8,8,11,14,25,26,26,52,0.000333,0.080494,5,1207.402609,67.077923,241.480522,91.356717,2,0
0,0,10,10,14,14,28,40,29,69,0.000333,0.110569,14,4643.904855,257.994714,331.70749,106.605938,2,0
0,0,20,20,14,26,40,82,67,149,0.000333,0.264322,14,11101.54201,616.752334,792.967286,175.514402,5,0
0,0,14,14,10,17,27,44,50,94,0.000333,0.148986,10,4469.594252,248.310792,446.959425,102.706149,1,0
0,0,19,19,17,18,35,70,65,135,0.000333,0.230818,24,16618.87698,923.270943,692.453207,144.545518,3,0
0,0,19,19,17,18,35,70,65,135,0.000333,0.230818,24,16618.87698,923.270943,692.453207,144.545518,3,0
0,0,17,17,17,17,34,63,56,119,0.000333,0.201803,24,14529.79388,807.210771,605.408078,138.973737,2,0
0,0,17,17,16,17,33,62,58,120,0.000333,0.201776,24,14527.85506,807.103059,605.327294,133.486868,2,0
0,0,14,14,12,14,26,47,39,86,0.000333,0.134746,12,4850.853789,269.491877,404.237816,96.322519,2,0
0,0,17,17,16,17,33,60,47,107,0.000333,0.179917,16,8636.002732,479.77793,539.750171,133.486868,3,0
0,0,10,10,14,15,29,40,29,69,0.000333,0.111734,7,2346.404821,130.355823,335.200689,111.906328,2,0
0,0,9,9,11,12,23,32,27,59,0.000333,0.088963,10,2668.901554,148.272309,266.890155,81.073298,1,0
0,0,8,8,11,12,23,29,25,54,0.000333,0.081424,10,2442.723456,135.706859,244.272346,81.073298,1,0
0,0,15,15,15,15,30,58,43,101,0.000333,0.165199,14,6938.343302,385.463517,495.59595,117.206718,2,0
0,0,19,19,18,19,37,78,56,134,0.000333,0.232689,18,12565.20152,698.066751,698.066751,155.769273,4,0
0,0,19,19,18,19,37,77,56,133,0.000333,0.230952,18,12471.43136,692.857298,692.857298,155.769273,4,0
0,0,8,8,14,17,31,30,24,54,0.000333,0.089176,7,1872.686205,104.038123,267.526601,122.789837,2,0
0,0,10,10,12,14,26,48,34,82,0.000333,0.128479,12,4625.232683,256.957371,385.436057,96.322519,1,0
0,0,12,12,11,16,27,44,46,90,0.000333,0.142647,10,4279.398752,237.744375,427.939875,102.053748,2,0
0,0,20,20,14,20,34,72,70,142,0.000333,0.240807,21,15170.81419,842.823011,722.419723,139.741531,2,0
0,0,22,22,18,23,41,80,75,155,0.000333,0.276807,27,22421.35514,1245.630841,830.420561,179.100575,3,0
0,0,12,12,12,17,29,45,47,92,0.000333,0.148978,12,5363.211019,297.956168,446.934252,112.506418,2,0
0,0,9,9,13,14,27,29,25,54,0.000333,0.085588,6,1540.583551,85.587975,256.763925,101.408685,2,0
0,0,15,15,13,18,31,50,46,96,0.000333,0.158534,12,5707.23415,317.068564,475.602846,123.164366,2,0
0,0,18,18,16,20,36,62,55,117,0.000333,0.201627,16,9678.099603,537.6722,604.881225,150.438562,3,0
0,0,15,15,13,17,30,50,46,96,0.000333,0.15702,12,5652.737966,314.040998,471.061497,117.592585,2,0
0,0,18,18,16,19,35,62,55,117,0.000333,0.200042,16,9602.017808,533.445434,600.126113,144.710623,3,0
0,0,13,13,12,16,28,45,43,88,0.000333,0.141016,12,5076.566798,282.031489,423.047233,107.01955,2,0
0,0,16,16,15,18,33,57,52,109,0.000333,0.18328,14,7697.745426,427.652524,549.838959,133.662009,3,0
0,0,13,13,12,16,28,45,43,88,0.000333,0.141016,12,5076.566798,282.031489,423.047233,107.01955,2,0
0,0,16,16,15,18,33,57,52,109,0.000333,0.18328,14,7697.745426,427.652524,549.838959,133.662009,3,0
0,0,22,22,14,22,36,89,68,157,0.000333,0.270559,21,17045.24273,946.957929,811.678225,151.410465,6,0
0,0,16,16,14,16,30,52,51,103,0.000333,0.16847,21,10613.60436,589.644687,505.409731,117.302969,2,0
0,0,11,11,15,13,28,38,29,67,0.000333,0.107364,14,4509.298917,250.516606,322.09278,106.709075,2,0
0,0,10,10,15,13,28,35,27,62,0.000333,0.099352,14,4172.784072,231.821337,298.056005,106.709075,2,0
0,0,17,17,15,20,35,77,53,130,0.000333,0.222269,14,9335.295091,518.627505,666.806792,145.041921,6,0
0,0,11,11,15,14,29,40,30,70,0.000333,0.113353,14,4760.821375,264.490076,340.05867,111.906328,2,0
0,0,9,9,13,15,28,28,24,52,0.000333,0.083327,6,1499.894736,83.327485,249.982456,106.709075,2,0
0,0,11,11,12,14,26,48,36,84,0.000333,0.131612,12,4738.043236,263.224624,394.836936,96.322519,1,0
0,0,8,8,13,13,26,35,24,59,0.000333,0.092442,6,1663.95566,92.441981,277.325943,96.211433,2,0
0,0,8,8,13,13,26,35,24,59,0.000333,0.092442,6,1663.95566,92.441981,277.325943,96.211433,2,0
0,0,10,10,14,16,30,44,28,72,0.000333,0.117765,7,2473.07286,137.392937,353.296123,117.302969,2,0
0,0,10,10,14,15,29,40,27,67,0.000333,0.108495,7,2278.393087,126.577394,325.484727,111.906328,2,0
0,0,10,10,14,14,28,40,27,67,0.000333,0.107364,7,2254.649458,125.258303,322.09278,106.605938,2,0
0,0,8,8,14,14,28,36,25,61,0.000333,0.09775,7,2052.740552,114.041142,293.24865,106.605938,2,0
0,0,8,8,13,14,27,35,25,60,0.000333,0.095098,6,1711.759501,95.09775,285.29325,101.408685,2,0
0,0,5,5,10,9,19,16,14,30,0.000333,0.042479,5,637.189127,35.399396,127.437825,61.748606,1,0
0,0,22,22,17,19,36,92,64,156,0.000333,0.268836,24,19356.19921,1075.3444,806.5083,150.197491,3,0
0,0,25,25,19,21,40,105,72,177,0.000333,0.313994,27,25433.49437,1412.971909,941.981273,172.949289,4,0
0,0,10,10,14,14,28,42,30,72,0.000333,0.115377,14,4845.813761,269.211876,346.129554,106.605938,2,0
0,0,18,18,16,17,33,68,50,118,0.000333,0.198413,16,9523.816097,529.100894,595.238506,133.486868,3,0
0,0,21,21,19,19,38,81,58,139,0.000333,0.243154,27,19695.47196,1094.192887,729.461924,161.421246,4,0
0,0,18,18,16,17,33,68,50,118,0.000333,0.198413,16,9523.816097,529.100894,595.238506,133.486868,3,0
0,0,21,21,19,19,38,81,58,139,0.000333,0.243154,27,19695.47196,1094.192887,729.461924,161.421246,4,0
0,0,11,11,14,15,29,36,32,68,0.000333,0.110114,14,4624.797907,256.933217,330.342708,111.906328,2,0
0,0,11,11,17,20,37,52,42,94,0.000333,0.16323,16,7835.017862,435.27877,489.688616,155.92543,2,0
0,0,10,10,12,13,25,31,29,60,0.000333,0.092877,12,3343.576457,185.754248,278.631371,91.125266,2,0
0,0,12,12,13,15,28,36,32,68,0.000333,0.108967,12,3922.801616,217.933423,326.900135,106.709075,2,0
0,0,12,12,13,15,28,36,32,68,0.000333,0.108967,12,3922.801616,217.933423,326.900135,106.709075,2,0
0,0,10,10,13,15,28,32,30,62,0.000333,0.099352,12,3576.672062,198.704003,298.056005,106.709075,2,0
0,0,10,10,12,15,27,31,30,61,0.000333,0.096683,12,3480.577652,193.365425,290.048138,101.622909,2,0
0,0,16,16,17,17,34,65,43,108,0.000333,0.183149,16,8791.13579,488.396433,549.445987,138.973737,3,0
0,0,16,16,17,17,34,64,43,107,0.000333,0.181453,16,8709.736384,483.874244,544.358524,138.973737,3,0
0,0,9,9,15,11,26,33,26,59,0.000333,0.092442,14,3882.563207,215.697956,277.325943,96.657107,3,0
0,0,9,9,14,13,27,31,25,56,0.000333,0.088758,7,1863.915901,103.550883,266.2737,101.408685,2,0
0,0,4,4,11,12,23,20,16,36,0.000333,0.054283,5,814.241152,45.23562,162.84823,81.073298,2,0
0,0,8,8,12,14,26,28,26,54,0.000333,0.084608,6,1522.942469,84.607915,253.823745,96.322519,2,0
0,0,9,9,16,11,27,37,28,65,0.000333,0.103023,16,4945.083002,274.726833,309.067688,102.053748,4,0
0,0,9,9,16,13,29,35,27,62,0.000333,0.100398,16,4819.117147,267.72873,301.194822,112.105716,3,0
0,0,13,13,13,17,30,50,42,92,0.000333,0.150478,12,5417.207218,300.955957,451.433935,117.592585,2,0
0,0,16,16,17,20,37,63,50,113,0.000333,0.196223,16,9418.691685,523.260649,588.66823,155.92543,3,0
0,0,37,37,21,56,77,163,120,283,0.000333,0.591167,20,35470.01182,1970.556212,1773.500591,417.450542,13,0
0,0,36,36,21,56,77,162,118,280,0.000333,0.5849,20,35094.00463,1949.666924,1754.700231,417.450542,13,0
0,0,19,19,12,19,31,69,60,129,0.000333,0.21303,18,11503.64383,639.091324,639.091324,123.730173,2,0
0,0,22,22,16,22,38,82,68,150,0.000333,0.262396,24,18892.53905,1049.585503,787.189127,162.107496,3,0
0,0,11,11,15,19,34,40,35,75,0.000333,0.127187,7,2670.917992,148.384333,381.559713,139.313982,2,0
0,0,17,17,14,16,30,67,54,121,0.000333,0.197911,21,12468.409,692.689389,593.733762,117.302969,2,0
0,0,20,20,18,18,36,80,62,142,0.000333,0.24471,27,19821.49246,1101.194025,734.12935,150.1173,3,0
0,0,10,10,13,14,27,44,32,76,0.000333,0.120457,12,4336.457402,240.9143,361.37145,101.408685,2,0
0,0,18,18,15,16,31,72,56,128,0.000333,0.211379,21,13316.87968,739.826649,634.137128,122.603359,2,0
0,0,21,21,19,18,37,85,64,149,0.000333,0.258736,27,20957.63089,1164.312827,776.208551,155.769273,3,0
0,0,10,10,14,14,28,42,30,72,0.000333,0.115377,14,4845.813761,269.211876,346.129554,106.605938,2,0
0,0,17,17,14,16,30,67,54,121,0.000333,0.197911,21,12468.409,692.689389,593.733762,117.302969,2,0
0,0,20,20,18,18,36,80,62,142,0.000333,0.24471,27,19821.49246,1101.194025,734.12935,150.1173,3,0
0,0,10,10,13,14,27,44,32,76,0.000333,0.120457,12,4336.457402,240.9143,361.37145,101.408685,2,0
0,0,17,17,16,17,33,72,50,122,0.000333,0.205139,16,9846.657321,547.036518,615.416083,133.486868,3,0
0,0,17,17,16,17,33,71,50,121,0.000333,0.203457,16,9765.947015,542.552612,610.371688,133.486868,3,0
0,0,11,11,16,14,30,43,30,73,0.000333,0.119401,16,5731.248216,318.402679,358.203013,117.302969,2,0
0,0,11,11,16,14,30,43,30,73,0.000333,0.119401,16,5731.248216,318.402679,358.203013,117.302969,2,0
0,0,11,11,17,15,32,44,31,75,0.000333,0.125,16,6000,333.333333,375,128.090227,2,0
0,0,11,11,16,15,31,43,31,74,0.000333,0.122204,16,5865.768431,325.876024,366.610527,122.603359,2,0
0,0,11,11,16,13,29,43,30,73,0.000333,0.118211,16,5674.121802,315.228989,354.632613,112.105716,2,0
0,0,11,11,16,14,30,43,30,73,0.000333,0.119401,16,5731.248216,318.402679,358.203013,117.302969,2,0
0,0,12,12,17,20,37,56,43,99,0.000333,0.171912,16,8251.774131,458.431896,515.735883,155.92543,2,0
0,0,18,18,17,23,40,88,64,152,0.000333,0.269644,16,12942.92913,719.051618,808.93307,173.528793,2,0
0,0,12,12,18,20,38,57,43,100,0.000333,0.174931,18,9446.269524,524.792751,524.792751,161.497212,2,0
0,0,7,7,11,12,23,28,23,51,0.000333,0.076901,5,1153.508299,64.083794,230.70166,81.073298,2,0
0,0,11,11,12,19,31,45,39,84,0.000333,0.138717,12,4993.829881,277.434993,416.15249,123.730173,2,0
0,0,14,14,16,22,38,58,47,105,0.000333,0.183677,16,8816.518223,489.806568,551.032389,162.107496,3,0
0,0,7,7,11,13,24,28,24,52,0.000333,0.079473,5,1192.09025,66.227236,238.41805,86.159464,2,0
0,0,12,12,16,17,33,53,38,91,0.000333,0.153013,16,7344.637838,408.035435,459.039865,133.486868,3,0
0,0,22,22,15,21,36,94,74,168,0.000333,0.289516,21,18239.49541,1013.3053,868.5474,150.842025,2,0
0,0,25,25,19,23,42,107,82,189,0.000333,0.339716,27,27516.99581,1528.721989,1019.147993,184.752548,3,0
0,0,10,10,11,14,25,34,32,66,0.000333,0.102165,10,3064.945085,170.274727,306.494509,91.356717,1,0
0,0,13,13,15,17,32,47,40,87,0.000333,0.145,14,6090,338.333333,435,128.090227,2,0
0,0,15,15,16,19,35,58,48,106,0.000333,0.181235,16,8699.263997,483.292444,543.704,144.710623,2,0
0,0,5,5,12,12,24,22,17,39,0.000333,0.059605,6,1072.881225,59.604513,178.813538,86.0391,1,0
0,0,8,8,15,15,30,35,25,60,0.000333,0.098138,7,2060.89405,114.494114,294.413436,117.206718,2,0
0,0,16,16,17,20,37,75,58,133,0.000333,0.230952,16,11085.71676,615.873153,692.857298,155.92543,5,0
0,0,11,11,14,21,35,44,40,84,0.000333,0.14362,7,3016.018414,167.556579,430.859773,145.541635,2,0
0,0,11,11,14,21,35,44,40,84,0.000333,0.14362,7,3016.018414,167.556579,430.859773,145.541635,2,0
0,0,22,22,17,22,39,103,75,178,0.000333,0.313601,24,22579.23828,1254.402127,940.801595,167.594364,2,0
0,0,16,16,14,26,40,70,56,126,0.000333,0.223521,14,9387.881159,521.548953,670.56294,175.514402,5,0
0,0,10,10,10,17,27,32,33,65,0.000333,0.103023,5,1545.338438,85.852135,309.067688,102.706149,1,0
0,0,12,12,17,17,34,53,36,89,0.000333,0.150928,16,7244.547086,402.474838,452.784193,138.973737,3,0
0,0,12,12,17,17,34,52,36,88,0.000333,0.149232,16,7163.14768,397.952649,447.69673,138.973737,3,0
0,0,14,14,18,18,36,57,38,95,0.000333,0.163714,18,8840.571752,491.142875,491.142875,150.1173,3,0
0,0,14,14,18,17,35,57,38,95,0.000333,0.162427,18,8771.073959,487.281887,487.281887,144.545518,3,0
0,0,12,12,17,16,33,52,35,87,0.000333,0.146287,16,7021.796614,390.099812,438.862288,133.486868,3,0
0,0,12,12,17,16,33,52,35,87,0.000333,0.146287,16,7021.796614,390.099812,438.862288,133.486868,3,0
0,0,6,6,10,11,21,21,17,38,0.000333,0.055636,5,834.54031,46.363351,166.908062,71.273029,1,0
0,0,6,6,10,11,21,21,17,38,0.000333,0.055636,5,834.54031,46.363351,166.908062,71.273029,1,0
0,0,29,29,20,46,66,127,99,226,0.000333,0.455344,20,27320.66142,1517.814523,1366.033071,340.522412,7,0
0,0,28,28,20,46,66,126,97,223,0.000333,0.4493,20,26957.99777,1497.666543,1347.899889,340.522412,7,0
0,0,13,13,17,18,35,55,45,100,0.000333,0.170976,16,8206.852827,455.936268,512.928302,144.545518,2,0
0,0,5,5,11,12,23,20,19,39,0.000333,0.058806,5,882.094581,49.005255,176.418916,81.073298,2,0
0,0,16,16,19,21,40,73,53,126,0.000333,0.223521,18,12070.13292,670.56294,670.56294,172.949289,3,0
0,0,5,5,12,13,25,21,20,41,0.000333,0.063466,6,1142.388623,63.466035,190.398104,91.125266,2,0
0,0,8,8,14,18,32,35,26,61,0.000333,0.101667,7,2135,118.611111,305,128.361619,2,0
0,0,8,8,14,18,32,35,26,61,0.000333,0.101667,7,2135,118.611111,305,128.361619,2,0
0,0,7,7,9,16,25,27,27,54,0.000333,0.083589,4,1003.072937,55.726274,250.768234,92.529325,1,0
0,0,10,10,13,19,32,40,35,75,0.000333,0.125,6,2250,125,375,128.816339,2,0
0,0,9,9,13,15,28,37,29,66,0.000333,0.105762,6,1903.712549,105.761808,317.285425,106.709075,2,0
0,0,16,16,12,17,29,69,53,122,0.000333,0.197558,18,10668.12627,592.673681,592.673681,112.506418,1,0
0,0,19,19,16,19,35,82,61,143,0.000333,0.244496,24,17603.69931,977.983295,733.487471,144.710623,2,0
0,0,9,9,13,16,29,40,31,71,0.000333,0.114972,6,2069.499904,114.972217,344.916651,112.105716,2,0
0,0,18,18,15,18,33,66,62,128,0.000333,0.215227,21,13559.33139,753.296188,645.682447,133.662009,2,0
0,0,20,20,19,20,39,74,67,141,0.000333,0.248414,27,20121.52625,1117.862569,745.241713,167.149185,3,0
0,0,7,7,13,14,27,29,27,56,0.000333,0.088758,6,1597.642201,88.7579,266.2737,101.408685,2,0
0,0,10,10,13,16,29,42,38,80,0.000333,0.129546,12,4663.661755,259.09232,388.63848,112.105716,2,0
0,0,12,12,17,19,36,50,43,93,0.000333,0.160268,16,7692.848402,427.380467,480.803025,150.197491,3,0
0,0,7,7,13,15,28,29,28,57,0.000333,0.09134,6,1644.115383,91.339744,274.019231,106.709075,2,0
0,0,7,7,12,14,26,28,27,55,0.000333,0.086175,6,1551.145107,86.174728,258.524184,96.322519,2,0
0,0,17,17,14,18,32,62,60,122,0.000333,0.203333,21,12810,711.666667,610,128.361619,2,0
0,0,19,19,18,20,38,70,65,135,0.000333,0.236157,27,19128.69579,1062.705321,708.470214,161.497212,3,0
0,0,7,7,12,15,27,28,28,56,0.000333,0.088758,6,1597.642201,88.7579,266.2737,101.622909,2,0
0,0,18,18,16,16,32,74,56,130,0.000333,0.216667,24,15600,866.666667,650,128,2,0
0,0,10,10,14,14,28,47,33,80,0.000333,0.128196,14,5384.237513,299.124306,384.588394,106.605938,2,0
0,0,20,20,17,17,34,81,63,144,0.000333,0.244198,24,17582.27158,976.792866,732.594649,138.973737,3,0
0,0,10,10,15,14,29,45,31,76,0.000333,0.123069,14,5168.891779,287.160654,369.206556,111.906328,2,0
0,0,20,20,17,17,34,81,63,144,0.000333,0.244198,24,17582.27158,976.792866,732.594649,138.973737,3,0
0,0,10,10,15,14,29,45,31,76,0.000333,0.123069,14,5168.891779,287.160654,369.206556,111.906328,2,0
0,0,14,14,13,21,34,56,45,101,0.000333,0.171278,12,6166.004964,342.555831,513.833747,140.344382,3,0
0,0,15,15,13,21,34,57,47,104,0.000333,0.176365,12,6349.153626,352.730757,529.096135,140.344382,3,0
0,0,14,14,15,23,38,61,50,111,0.000333,0.194173,14,8155.279356,453.071075,582.519954,162.645284,4,0
0,0,15,15,15,23,38,62,52,114,0.000333,0.199421,14,8375.692311,465.31624,598.263737,162.645284,4,0
0,0,14,14,15,15,30,50,45,95,0.000333,0.155385,21,9789.246738,543.847041,466.154607,117.206718,2,0
0,0,16,16,17,21,38,68,56,124,0.000333,0.216914,16,10411.88819,578.438233,650.743012,161.725534,4,0
0,0,7,7,10,14,24,23,23,46,0.000333,0.070303,5,1054.541375,58.585632,210.908275,86.52225,1,0
0,0,11,11,15,19,34,40,35,75,0.000333,0.127187,7,2670.917992,148.384333,381.559713,139.313982,2,0
0,0,11,11,16,14,30,43,30,73,0.000333,0.119401,16,5731.248216,318.402679,358.203013,117.302969,2,0
0,0,11,11,16,14,30,43,30,73,0.000333,0.119401,16,5731.248216,318.402679,358.203013,117.302969,2,0
0,0,12,12,17,16,33,45,35,80,0.000333,0.134517,16,6456.824473,358.712471,403.55153,133.486868,3,0
0,0,15,15,17,18,35,55,49,104,0.000333,0.177815,16,8535.12694,474.173719,533.445434,144.545518,3,0
0,0,15,15,17,18,35,55,49,104,0.000333,0.177815,16,8535.12694,474.173719,533.445434,144.545518,3,0
0,0,11,11,17,15,32,49,34,83,0.000333,0.138333,16,6640,368.888889,415,128.090227,2,0
0,0,12,12,17,16,33,52,35,87,0.000333,0.146287,16,7021.796614,390.099812,438.862288,133.486868,3,0
0,0,12,12,17,15,32,52,35,87,0.000333,0.145,16,6960,386.666667,435,128.090227,3,0
0,0,12,12,17,16,33,53,36,89,0.000333,0.14965,16,7183.217226,399.067624,448.951077,133.486868,3,0
0,0,12,12,17,16,33,52,36,88,0.000333,0.147969,16,7102.50692,394.583718,443.906683,133.486868,3,0
0,0,12,12,17,17,34,53,36,89,0.000333,0.150928,16,7244.547086,402.474838,452.784193,138.973737,3,0
0,0,12,12,17,17,34,52,36,88,0.000333,0.149232,16,7163.14768,397.952649,447.69673,138.973737,3,0
0,0,14,14,18,18,36,57,38,95,0.000333,0.163714,18,8840.571752,491.142875,491.142875,150.1173,3,0
0,0,14,14,18,17,35,57,38,95,0.000333,0.162427,18,8771.073959,487.281887,487.281887,144.545518,3,0
0,0,10,10,14,21,35,40,36,76,0.000333,0.129942,7,2728.778565,151.598809,389.825509,145.541635,2,0
0,0,15,15,15,28,43,66,56,122,0.000333,0.220668,14,9268.060201,514.892233,662.0043,193.209297,2,0
0,0,14,14,15,25,40,60,50,110,0.000333,0.195137,14,8195.769266,455.320515,585.41209,174.699764,2,0
0,0,15,15,13,20,33,63,49,112,0.000333,0.188324,12,6779.665696,376.648094,564.972141,134.544278,3,0
0,0,12,12,11,16,27,42,37,79,0.000333,0.125212,10,3756.361127,208.686729,375.636113,102.053748,1,0
0,0,15,15,15,21,36,66,52,118,0.000333,0.20335,14,8540.716102,474.484228,610.05115,150.842025,3,0
0,0,7,7,11,12,23,28,23,51,0.000333,0.076901,5,1153.508299,64.083794,230.70166,81.073298,2,0
0,0,16,16,15,17,32,66,48,114,0.000333,0.19,14,7980,443.333333,570,128.090227,3,0
0,0,19,19,18,19,37,79,56,135,0.000333,0.234425,18,12658.97168,703.276204,703.276204,155.769273,4,0
0,0,7,7,12,13,25,29,24,53,0.000333,0.082041,6,1476.746268,82.041459,246.124378,91.125266,2,0
0,0,12,12,17,17,34,54,38,92,0.000333,0.156016,16,7488.745302,416.041406,468.046581,138.973737,3,0
0,0,16,16,15,17,32,66,48,114,0.000333,0.19,14,7980,443.333333,570,128.090227,3,0
0,0,19,19,18,19,37,79,56,135,0.000333,0.234425,18,12658.97168,703.276204,703.276204,155.769273,4,0
0,0,7,7,12,13,25,29,24,53,0.000333,0.082041,6,1476.746268,82.041459,246.124378,91.125266,2,0
0,0,12,12,17,17,34,54,38,92,0.000333,0.156016,16,7488.745302,416.041406,468.046581,138.973737,3,0
0,0,10,10,13,19,32,43,35,78,0.000333,0.13,6,2340,130,390,128.816339,3,0
0,0,8,8,10,14,24,26,26,52,0.000333,0.079473,5,1192.09025,66.227236,238.41805,86.52225,1,0
0,0,16,16,16,18,34,67,49,116,0.000333,0.196715,16,9442.331033,524.573946,590.14569,139.05865,3,0
0,0,19,19,18,20,38,80,57,137,0.000333,0.239655,18,12941.38925,718.966069,718.966069,161.497212,4,0
0,0,16,16,15,18,33,66,49,115,0.000333,0.193368,14,8121.474532,451.19303,580.105324,133.662009,3,0
0,0,19,19,18,20,38,79,57,136,0.000333,0.237906,18,12846.92655,713.718142,713.718142,161.497212,4,0
0,0,6,6,12,10,22,20,16,36,0.000333,0.053513,6,963.23723,53.513179,160.539538,76.238831,2,0
0,0,8,8,10,12,22,27,23,50,0.000333,0.074324,5,1114.857905,61.93655,222.971581,76.238831,1,0
0,0,18,18,15,20,35,79,63,142,0.000333,0.242786,21,15295.52196,849.75122,728.358188,145.041921,2,0
0,0,10,10,15,19,34,38,30,68,0.000333,0.115316,7,2421.632312,134.535128,345.947473,139.313982,2,0
0,0,9,9,12,11,23,32,26,58,0.000333,0.087456,12,3148.399121,174.911062,262.366593,81.073298,1,0
0,0,15,15,18,19,37,66,49,115,0.000333,0.199696,18,10783.56847,599.087137,599.087137,155.769273,2,0
0,0,11,11,16,17,33,52,36,88,0.000333,0.147969,16,7102.50692,394.583718,443.906683,133.486868,2,0
0,0,13,13,12,15,27,51,39,90,0.000333,0.142647,12,5135.278502,285.29325,427.939875,101.622909,2,0
0,0,16,16,15,17,32,64,47,111,0.000333,0.185,14,7770,431.666667,555,128.090227,3,0
0,0,13,13,12,14,26,51,39,90,0.000333,0.141013,12,5076.474896,282.026383,423.039575,96.322519,2,0
0,0,16,16,15,16,31,64,47,111,0.000333,0.183305,14,7698.821066,427.712281,549.91579,122.603359,3,0
0,0,15,15,13,19,32,59,48,107,0.000333,0.178333,12,6420,356.666667,535,128.816339,3,0
0,0,18,18,14,22,36,70,55,125,0.000333,0.215414,14,9047.368753,502.631597,646.240625,151.410465,4,0
0,0,12,12,11,13,24,40,40,80,0.000333,0.122266,15,5501.955001,305.664167,366.797,86.159464,1,0
0,0,17,17,12,21,33,57,52,109,0.000333,0.18328,12,6598.067508,366.559306,549.838959,135.258216,2,0
0,0,16,16,13,17,30,51,52,103,0.000333,0.16847,18,9097.375164,505.409731,505.409731,117.592585,2,0
0,0,11,11,14,20,34,44,37,81,0.000333,0.137361,7,2884.591431,160.255079,412.08449,139.741531,2,0
0,0,20,20,17,29,46,100,66,166,0.000333,0.305637,16,14670.58056,815.032253,916.911285,210.368317,6,0
0,0,11,11,14,21,35,46,38,84,0.000333,0.14362,7,3016.018414,167.556579,430.859773,145.541635,2,0
0,0,8,8,13,13,26,31,23,54,0.000333,0.084608,6,1522.942469,84.607915,253.823745,96.211433,2,0
0,0,8,8,12,13,25,30,23,53,0.000333,0.082041,6,1476.746268,82.041459,246.124378,91.125266,2,0
0,0,6,6,10,10,20,17,16,33,0.000333,0.047541,5,713.118136,39.617674,142.623627,66.438562,2,0
0,0,8,8,14,12,26,28,19,47,0.000333,0.07364,7,1546.444667,85.913593,220.920667,96.322519,2,0
0,0,10,10,16,17,33,38,31,69,0.000333,0.116021,8,2784.505554,154.694753,348.063194,133.486868,2,0
0,0,8,8,13,13,26,26,23,49,0.000333,0.076774,6,1381.929277,76.773849,230.321546,96.211433,3,0
0,0,8,8,14,12,26,28,19,47,0.000333,0.07364,7,1546.444667,85.913593,220.920667,96.322519,2,0
0,0,11,11,15,13,28,39,31,70,0.000333,0.112172,14,4711.207824,261.733768,336.514845,106.709075,2,0
0,0,11,11,15,13,28,39,31,70,0.000333,0.112172,14,4711.207824,261.733768,336.514845,106.709075,2,0
0,0,7,7,10,12,22,20,18,38,0.000333,0.056486,5,847.292008,47.071778,169.458402,76.238831,3,0
0,0,14,14,18,18,36,57,44,101,0.000333,0.174054,18,9398.923653,522.162425,522.162425,150.1173,2,0
0,0,10,10,16,16,32,43,31,74,0.000333,0.123333,8,2960,164.444444,370,128,2,0
0,0,14,14,17,18,35,56,44,100,0.000333,0.170976,16,8206.852827,455.936268,512.928302,144.545518,2,0
0,0,10,10,16,16,32,43,31,74,0.000333,0.123333,8,2960,164.444444,370,128,2,0
0,0,9,9,14,14,28,37,29,66,0.000333,0.105762,14,4441.995948,246.777553,317.285425,106.605938,2,0
0,0,14,14,17,18,35,60,47,107,0.000333,0.182944,16,8781.332525,487.851807,548.833283,144.545518,2,0
0,0,10,10,15,16,31,46,34,80,0.000333,0.132112,14,5548.699868,308.261104,396.335705,122.603359,2,0
0,0,15,15,18,18,36,61,50,111,0.000333,0.191287,18,10329.51015,573.861675,573.861675,150.1173,3,0
0,0,15,15,18,18,36,61,50,111,0.000333,0.191287,18,10329.51015,573.861675,573.861675,150.1173,3,0
0,0,7,7,10,11,21,26,19,45,0.000333,0.065885,5,988.27142,54.903968,197.654284,71.273029,1,0
0,0,6,6,10,11,21,21,17,38,0.000333,0.055636,5,834.54031,46.363351,166.908062,71.273029,1,0
0,0,6,6,10,11,21,21,17,38,0.000333,0.055636,5,834.54031,46.363351,166.908062,71.273029,1,0
0,0,23,23,19,24,43,97,83,180,0.000333,0.325576,27,26371.64671,1465.091484,976.727656,190.749723,3,0
0,0,15,15,14,20,34,52,44,96,0.000333,0.162799,14,6837.550059,379.863892,488.396433,139.741531,2,0
0,0,15,15,16,21,37,54,48,102,0.000333,0.177121,16,8501.827893,472.323772,531.364243,156.238666,2,0
0,0,18,18,16,22,38,67,60,127,0.000333,0.222162,16,10663.78871,592.432706,666.486794,162.107496,2,0
0,0,8,8,13,20,33,33,28,61,0.000333,0.102569,6,1846.248248,102.569347,307.708041,134.544278,2,0
0,0,8,8,13,20,33,33,28,61,0.000333,0.102569,6,1846.248248,102.569347,307.708041,134.544278,2,0
0,0,8,8,12,18,30,32,29,61,0.000333,0.099773,6,1795.921958,99.773442,299.320326,118.0782,3,0
0,0,6,6,10,14,24,15,19,34,0.000333,0.051963,5,779.443625,43.302424,155.888725,86.52225,1,0
0,0,18,18,16,32,48,92,66,158,0.000333,0.294141,16,14118.7852,784.376956,882.424075,224,6,0
0,0,12,12,14,23,37,54,43,97,0.000333,0.168439,7,3537.218835,196.512158,505.316976,157.344894,2,0
0,0,18,18,19,20,39,73,62,135,0.000333,0.237843,27,19265.29109,1070.293949,713.5293,167.149185,3,0
0,0,18,18,16,16,32,74,56,130,0.000333,0.216667,24,15600,866.666667,650,128,2,0
0,0,10,10,14,14,28,47,33,80,0.000333,0.128196,14,5384.237513,299.124306,384.588394,106.605938,2,0
0,0,12,12,16,16,32,46,34,80,0.000333,0.133333,16,6400,355.555556,400,128,3,0
0,0,12,12,16,15,31,46,34,80,0.000333,0.132112,16,6341.371277,352.298404,396.335705,122.603359,3,0
0,0,12,12,16,17,33,47,35,82,0.000333,0.13788,16,6618.245085,367.680282,413.640318,133.486868,3,0
0,0,12,12,16,17,33,46,35,81,0.000333,0.136199,16,6537.534779,363.196377,408.595924,133.486868,3,0
0,0,12,12,16,16,32,46,34,80,0.000333,0.133333,16,6400,355.555556,400,128,3,0
0,0,12,12,16,16,32,46,34,80,0.000333,0.133333,16,6400,355.555556,400,128,3,0
0,0,22,22,15,28,43,96,76,172,0.000333,0.311106,14,13066.44553,725.913641,933.317538,193.209297,6,0
0,0,16,16,13,23,36,58,59,117,0.000333,0.201627,12,7258.574702,403.25415,604.881225,152.147641,2,0
0,0,10,10,14,20,34,41,35,76,0.000333,0.128882,7,2706.530232,150.362791,386.647176,139.741531,2,0
0,0,17,17,16,26,42,84,61,145,0.000333,0.260629,16,12510.17642,695.009801,781.886026,186.211433,6,0
0,0,11,11,14,21,35,46,38,84,0.000333,0.14362,7,3016.018414,167.556579,430.859773,145.541635,2,0
0,0,7,7,11,11,22,27,21,48,0.000333,0.071351,5,1070.263588,59.459088,214.052718,76.107496,1,0
0,0,13,13,16,17,33,54,39,93,0.000333,0.156376,16,7506.05845,417.003247,469.128653,133.486868,2,0
0,0,14,14,16,19,35,56,45,101,0.000333,0.172686,16,8288.921355,460.495631,518.057585,144.710623,2,0
0,0,10,10,15,17,32,43,32,75,0.000333,0.125,7,2625,145.833333,375,128.090227,2,0
0,0,21,21,17,22,39,89,67,156,0.000333,0.274841,24,19788.54591,1099.363662,824.522746,167.594364,2,0
0,0,10,10,15,18,33,44,33,77,0.000333,0.129473,7,2718.92843,151.051579,388.418347,133.662009,2,0
0,0,8,8,13,12,25,26,19,45,0.000333,0.069658,6,1253.841171,69.657843,208.973529,91.125266,3,0
0,0,17,17,12,18,30,68,61,129,0.000333,0.210996,18,11393.79996,632.988887,632.988887,118.0782,1,0
0,0,19,19,16,20,36,76,66,142,0.000333,0.24471,24,17619.10441,978.839134,734.12935,150.438562,2,0
0,0,16,16,16,20,36,65,54,119,0.000333,0.205074,16,9843.537203,546.863178,615.221075,150.438562,2,0
0,0,19,19,14,20,34,78,70,148,0.000333,0.250982,21,15811.83451,878.435251,752.944501,139.741531,1,0
0,0,21,21,18,22,40,86,75,161,0.000333,0.28561,27,23134.42143,1285.245635,856.830423,173.166146,2,0
0,0,18,18,15,25,40,84,63,147,0.000333,0.260774,14,10952.52802,608.473779,782.32343,174.699764,6,0
0,0,12,12,14,20,34,47,42,89,0.000333,0.150928,14,6338.9787,352.165483,452.784193,139.741531,2,0
0,0,8,8,14,17,31,30,24,54,0.000333,0.089176,7,1872.686205,104.038123,267.526601,122.789837,2,0
0,0,8,8,14,17,31,30,24,54,0.000333,0.089176,7,1872.686205,104.038123,267.526601,122.789837,2,0
0,0,24,24,20,48,68,117,85,202,0.000333,0.409889,10,12296.67494,683.148608,1229.667494,354.516762,9,0
0,0,23,23,20,48,68,116,83,199,0.000333,0.403802,10,12114.05105,673.002836,1211.405105,354.516762,9,0
0,0,18,18,15,23,38,77,58,135,0.000333,0.236157,14,9918.583,551.032389,708.470214,162.645284,6,0
0,0,12,12,13,17,30,39,35,74,0.000333,0.121037,12,4357.318849,242.073269,363.109904,117.592585,2,0
0,0,8,8,13,13,26,27,20,47,0.000333,0.07364,6,1325.524001,73.640222,220.920667,96.211433,2,0
0,0,8,8,13,13,26,27,20,47,0.000333,0.07364,6,1325.524001,73.640222,220.920667,96.211433,2,0
0,0,8,8,13,13,26,27,20,47,0.000333,0.07364,6,1325.524001,73.640222,220.920667,96.211433,2,0
0,0,8,8,13,13,26,27,20,47,0.000333,0.07364,6,1325.524001,73.640222,220.920667,96.211433,2,0
0,0,14,14,17,18,35,62,47,109,0.000333,0.186364,16,8945.469582,496.970532,559.091849,144.545518,2,0
0,0,10,10,16,16,32,49,34,83,0.000333,0.138333,16,6640,368.888889,415,128,2,0
0,0,14,14,18,18,36,63,47,110,0.000333,0.189564,18,10236.4515,568.69175,568.69175,150.1173,2,0
0,0,10,10,16,16,32,49,34,83,0.000333,0.138333,16,6640,368.888889,415,128,2,0
0,0,12,12,13,21,34,54,41,95,0.000333,0.161103,6,2899.85382,161.10299,483.30897,140.344382,5,0
0,0,6,6,10,11,21,16,16,32,0.000333,0.046851,5,702.770788,39.042822,140.554158,71.273029,1,0
0,0,17,17,18,19,37,59,57,116,0.000333,0.201432,27,16316.00794,906.444886,604.29659,155.769273,2,0
0,0,12,12,13,23,36,53,43,96,0.000333,0.165438,6,2977.876801,165.4376,496.3128,152.147641,5,0
0,0,6,6,10,14,24,15,19,34,0.000333,0.051963,5,779.443625,43.302424,155.888725,86.52225,1,0
0,0,12,12,14,17,31,55,40,95,0.000333,0.156883,14,6589.081093,366.060061,470.648649,122.789837,5,0
0,0,6,6,10,10,20,17,15,32,0.000333,0.046101,5,691.508495,38.417139,138.301699,66.438562,1,0
0,0,13,13,12,16,28,48,43,91,0.000333,0.145823,12,5249.631575,291.646199,437.469298,107.01955,1,0
0,0,6,6,11,12,23,30,21,51,0.000333,0.076901,5,1153.508299,64.083794,230.70166,81.073298,1,0
0,0,11,11,12,14,26,47,37,84,0.000333,0.131612,12,4738.043236,263.224624,394.836936,96.322519,1,0
0,0,8,8,14,12,26,28,19,47,0.000333,0.07364,7,1546.444667,85.913593,220.920667,96.322519,2,0
0,0,12,12,13,20,33,47,37,84,0.000333,0.141243,6,2542.374636,141.243035,423.729106,134.544278,4,0
0,0,9,9,12,17,29,36,30,66,0.000333,0.106876,6,1923.760474,106.875582,320.626746,112.506418,3,0
0,0,6,6,11,12,23,17,17,34,0.000333,0.051267,5,769.005533,42.72253,153.801107,81.073298,1,0
0,0,8,8,13,13,26,27,20,47,0.000333,0.07364,6,1325.524001,73.640222,220.920667,96.211433,2,0
0,0,11,11,14,15,29,50,36,86,0.000333,0.139262,14,5849.009118,324.944951,417.786366,111.906328,1,0
0,0,12,12,15,14,29,42,31,73,0.000333,0.118211,14,4964.856577,275.825365,354.632613,111.906328,2,0
0,0,10,10,15,14,29,38,27,65,0.000333,0.105256,7,2210.381353,122.798964,315.768765,111.906328,2,0
0,0,16,16,14,25,39,75,56,131,0.000333,0.230796,14,9693.427669,538.523759,692.387691,169.399374,5,0
0,0,26,26,19,50,69,134,94,228,0.000333,0.464248,9,12534.69219,696.371788,1392.743576,362.903432,9,0
0,0,10,10,10,16,26,37,33,70,0.000333,0.109677,10,3290.307803,182.794878,329.03078,97.219281,1,0
0,0,7,7,8,12,20,20,20,40,0.000333,0.057626,4,691.508495,38.417139,172.877124,67.01955,1,0
0,0,10,10,9,15,24,37,33,70,0.000333,0.106982,8,2567.579,142.643278,320.947375,87.132684,1,0
0,0,13,13,12,14,26,51,39,90,0.000333,0.141013,12,5076.474896,282.026383,423.039575,96.322519,2,0
0,0,16,16,16,16,32,64,47,111,0.000333,0.185,16,8880,493.333333,555,128,3,0
0,0,13,13,12,15,27,51,39,90,0.000333,0.142647,12,5135.278502,285.29325,427.939875,101.622909,2,0
0,0,16,16,16,17,33,64,47,111,0.000333,0.186643,16,8958.843956,497.713553,559.927747,133.486868,3,0
0,0,9,9,14,15,29,38,29,67,0.000333,0.108495,7,2278.393087,126.577394,325.484727,111.906328,2,0
0,0,13,13,12,15,27,51,39,90,0.000333,0.142647,12,5135.278502,285.29325,427.939875,101.622909,2,0
0,0,16,16,16,17,33,64,47,111,0.000333,0.186643,16,8958.843956,497.713553,559.927747,133.486868,3,0
0,0,9,9,14,15,29,38,29,67,0.000333,0.108495,7,2278.393087,126.577394,325.484727,111.906328,2,0
0,0,16,16,13,15,28,58,55,113,0.000333,0.181077,18,9778.159911,543.231106,543.231106,106.709075,1,0
0,0,18,18,17,17,34,66,60,126,0.000333,0.213673,24,15384.48763,854.693757,641.020318,138.973737,2,0
0,0,13,13,10,15,25,48,52,100,0.000333,0.154795,15,6965.784285,386.988016,464.385619,91.82264,1,0
0,0,15,15,14,18,32,56,57,113,0.000333,0.188333,21,11865,659.166667,565,128.361619,2,0
0,0,17,17,12,16,28,60,61,121,0.000333,0.193897,18,10470.41902,581.689946,581.689946,107.01955,1,0
0,0,19,19,16,18,34,68,66,134,0.000333,0.22724,24,16361.2805,908.960028,681.720021,139.05865,2,0
0,0,11,11,12,15,27,51,37,88,0.000333,0.139477,12,5021.161202,278.9534,418.4301,101.622909,1,0
0,0,12,12,12,14,26,47,43,90,0.000333,0.141013,18,7614.712343,423.039575,423.039575,96.322519,1,0
0,0,14,14,16,16,32,55,48,103,0.000333,0.171667,24,12360,686.666667,515,128,2,0
0,0,9,9,13,13,26,42,28,70,0.000333,0.109677,12,3948.369363,219.353854,329.03078,96.211433,2,0
0,0,9,9,13,13,26,42,28,70,0.000333,0.109677,12,3948.369363,219.353854,329.03078,96.211433,2,0
0,0,9,9,13,12,25,42,28,70,0.000333,0.108357,12,3900.839199,216.713289,325.069933,91.125266,2,0
0,0,11,11,14,15,29,46,31,77,0.000333,0.124688,14,5236.903513,290.939084,374.064537,111.906328,2,0
0,0,11,11,14,14,28,46,31,77,0.000333,0.123389,14,5182.328606,287.907145,370.166329,106.605938,2,0
0,0,9,9,14,14,28,43,29,72,0.000333,0.115377,14,4845.813761,269.211876,346.129554,106.605938,2,0
0,0,9,9,13,14,27,42,29,71,0.000333,0.112532,12,4051.164152,225.064675,337.597013,101.408685,2,0
0,0,9,9,14,14,28,43,29,72,0.000333,0.115377,14,4845.813761,269.211876,346.129554,106.605938,2,0
0,0,9,9,13,14,27,42,29,71,0.000333,0.112532,12,4051.164152,225.064675,337.597013,101.408685,2,0
0,0,8,8,14,13,27,31,28,59,0.000333,0.093513,14,3927.537077,218.196504,280.538363,101.408685,2,0
0,0,8,8,14,16,30,34,28,62,0.000333,0.101409,7,2129.590518,118.310584,304.227217,117.302969,2,0
0,0,15,15,16,18,34,54,50,104,0.000333,0.176365,16,8465.538168,470.307676,529.096135,139.05865,2,0
0,0,37,37,19,50,69,170,115,285,0.000333,0.58031,18,31336.73046,1740.92947,1740.92947,362.903432,10,0
0,0,25,25,15,25,40,105,73,178,0.000333,0.315768,14,13262.24481,736.791378,947.303201,174.699764,6,0
0,0,16,16,14,16,30,52,51,103,0.000333,0.16847,21,10613.60436,589.644687,505.409731,117.302969,2,0
0,0,21,21,17,22,39,88,66,154,0.000333,0.271317,24,19534.8466,1085.269256,813.951942,167.594364,2,0
0,0,10,10,15,18,33,43,32,75,0.000333,0.12611,7,2648.306913,147.128162,378.329559,133.662009,2,0
0,0,18,18,17,23,40,78,63,141,0.000333,0.250131,16,12006.26978,667.014988,750.391861,173.528793,2,0
0,0,8,8,14,18,32,29,25,54,0.000333,0.09,7,1890,105,270,128.361619,2,0
0,0,8,8,14,18,32,29,25,54,0.000333,0.09,7,1890,105,270,128.361619,2,0
0,0,8,8,14,18,32,29,25,54,0.000333,0.09,7,1890,105,270,128.361619,2,0
0,0,8,8,14,18,32,29,25,54,0.000333,0.09,7,1890,105,270,128.361619,2,0
0,0,8,8,14,18,32,29,25,54,0.000333,0.09,7,1890,105,270,128.361619,2,0
0,0,8,8,14,18,32,29,25,54,0.000333,0.09,7,1890,105,270,128.361619,2,0
0,0,13,13,13,20,33,56,46,102,0.000333,0.171509,12,6174.338402,343.0188,514.5282,134.544278,3,0
0,0,11,11,12,17,29,39,37,76,0.000333,0.123069,12,4430.478668,246.137704,369.206556,112.506418,1,0
0,0,8,8,12,18,30,32,29,61,0.000333,0.099773,6,1795.921958,99.773442,299.320326,118.0782,3,0
0,0,6,6,10,14,24,15,19,34,0.000333,0.051963,5,779.443625,43.302424,155.888725,86.52225,1,0
0,0,10,10,15,15,30,37,29,66,0.000333,0.107952,7,2266.983455,125.943525,323.854779,117.206718,2,0
0,0,16,16,11,17,28,54,58,112,0.000333,0.179475,15,8076.356269,448.686459,538.423751,107.540616,1,0
0,0,19,19,15,19,34,66,67,133,0.000333,0.225544,21,14209.28372,789.404651,676.632558,139.313982,2,0
0,0,18,18,15,18,33,72,60,132,0.000333,0.221953,21,13983.0605,776.836694,665.860024,133.662009,2,0
0,0,20,20,17,20,37,80,65,145,0.000333,0.25179,24,18128.89771,1007.160984,755.370738,155.92543,3,0
0,0,13,13,13,15,28,50,44,94,0.000333,0.15063,12,5422.696352,301.260908,451.891363,106.709075,2,0
0,0,15,15,16,17,33,58,49,107,0.000333,0.179917,16,8636.002732,479.77793,539.750171,133.486868,3,0
0,0,13,13,13,15,28,50,44,94,0.000333,0.15063,12,5422.696352,301.260908,451.891363,106.709075,2,0
0,0,15,15,16,17,33,58,49,107,0.000333,0.179917,16,8636.002732,479.77793,539.750171,133.486868,3,0
0,0,13,13,13,14,27,50,44,94,0.000333,0.148986,18,8045.269654,446.959425,446.959425,101.408685,2,0
0,0,15,15,17,16,33,58,49,107,0.000333,0.179917,24,12954.0041,719.666894,539.750171,133.486868,3,0
0,0,15,15,17,15,32,61,41,102,0.000333,0.17,16,8160,453.333333,510,128.090227,2,0
0,0,11,11,16,14,30,48,32,80,0.000333,0.13085,16,6280.819962,348.934442,392.551248,117.302969,2,0
0,0,8,8,14,12,26,28,19,47,0.000333,0.07364,7,1546.444667,85.913593,220.920667,96.322519,2,0
0,0,18,18,13,20,33,77,69,146,0.000333,0.245494,18,13256.66775,736.481541,736.481541,134.544278,1,0
0,0,21,21,17,23,40,89,78,167,0.000333,0.296254,24,21330.2878,1185.015989,888.761992,173.528793,2,0
0,0,19,19,13,20,33,71,57,128,0.000333,0.215227,12,7748.189367,430.454965,645.682447,134.544278,4,0
0,0,22,22,13,23,36,82,64,146,0.000333,0.251603,12,9057.708603,503.206033,754.80905,152.147641,5,0
0,0,16,16,14,16,30,52,51,103,0.000333,0.16847,21,10613.60436,589.644687,505.409731,117.302969,2,0
0,0,14,14,15,19,34,56,45,101,0.000333,0.171278,14,7193.672458,399.64847,513.833747,139.313982,2,0
0,0,14,14,15,25,40,65,51,116,0.000333,0.205781,14,8642.811226,480.156179,617.343659,174.699764,6,0
0,0,10,10,14,19,33,35,33,68,0.000333,0.11434,7,2401.131601,133.3962,343.0188,134.013592,2,0
0,0,11,11,14,14,28,37,32,69,0.000333,0.110569,14,4643.904855,257.994714,331.70749,106.605938,2,0
0,0,11,11,14,14,28,37,32,69,0.000333,0.110569,14,4643.904855,257.994714,331.70749,106.605938,2,0
0,0,11,11,11,13,24,39,30,69,0.000333,0.105454,10,3163.624125,175.756896,316.362413,86.159464,2,0
0,0,14,14,15,16,31,52,38,90,0.000333,0.148626,14,6242.287351,346.793742,445.877668,122.603359,3,0
0,0,22,22,15,21,36,98,75,173,0.000333,0.298132,21,18782.33753,1043.463196,894.397025,150.842025,2,0
0,0,25,25,19,23,42,111,83,194,0.000333,0.348703,27,28244.95866,1569.16437,1046.10958,184.752548,3,0
0,0,17,17,15,16,31,64,49,113,0.000333,0.186608,21,11756.30785,653.128214,559.824183,122.603359,2,0
0,0,13,13,14,16,30,54,42,96,0.000333,0.15702,14,6594.86096,366.381164,471.061497,117.302969,2,0
0,0,19,19,16,17,33,71,58,129,0.000333,0.216909,24,15617.44419,867.635789,650.726841,133.486868,3,0
0,0,9,9,14,14,28,35,26,61,0.000333,0.09775,7,2052.740552,114.041142,293.24865,106.605938,2,0
0,0,19,19,16,17,33,71,58,129,0.000333,0.216909,24,15617.44419,867.635789,650.726841,133.486868,3,0
0,0,9,9,14,14,28,35,26,61,0.000333,0.09775,7,2052.740552,114.041142,293.24865,106.605938,2,0
0,0,13,13,16,16,32,44,37,81,0.000333,0.135,16,6480,360,405,128,2,0
0,0,16,16,16,18,34,72,49,121,0.000333,0.205194,16,9849.328061,547.184892,615.583004,139.05865,2,0
0,0,10,10,15,18,33,38,32,70,0.000333,0.117703,7,2471.753118,137.319618,353.107588,133.662009,2,0
0,0,15,15,14,19,33,71,45,116,0.000333,0.19505,14,8192.09605,455.116447,585.149718,134.013592,5,0
0,0,6,6,10,10,20,17,15,32,0.000333,0.046101,5,691.508495,38.417139,138.301699,66.438562,1,0
0,0,19,19,17,17,34,80,59,139,0.000333,0.235719,24,16971.77604,942.876447,707.157335,138.973737,2,0
0,0,10,10,14,15,29,48,33,81,0.000333,0.131165,14,5508.950448,306.052803,393.496461,111.906328,2,0
0,0,16,16,14,17,31,65,57,122,0.000333,0.201471,21,12692.65095,705.147275,604.41195,122.789837,2,0
0,0,10,10,14,14,28,47,33,80,0.000333,0.128196,14,5384.237513,299.124306,384.588394,106.605938,2,0
0,0,10,10,13,17,30,32,29,61,0.000333,0.099773,6,1795.921958,99.773442,299.320326,117.592585,2,0
0,0,11,11,13,17,30,47,43,90,0.000333,0.147207,12,5299.441843,294.413436,441.620154,117.592585,1,0
0,0,13,13,17,20,37,55,48,103,0.000333,0.178858,16,8585.179147,476.954397,536.573697,155.92543,2,0
0,0,9,9,12,13,25,38,27,65,0.000333,0.100617,12,3622.207828,201.233768,301.850652,91.125266,2,0
0,0,9,9,12,13,25,38,27,65,0.000333,0.100617,12,3622.207828,201.233768,301.850652,91.125266,2,0
0,0,10,10,11,13,24,41,32,73,0.000333,0.111567,10,3347.022626,185.945701,334.702263,86.159464,1,0
0,0,19,19,14,25,39,74,61,135,0.000333,0.237843,14,9989.410194,554.967233,713.5293,169.399374,4,0
0,0,22,22,14,28,42,85,68,153,0.000333,0.275008,14,11550.34392,641.685773,825.024566,187.908907,5,0
0,0,16,16,15,20,35,55,55,110,0.000333,0.188074,14,7899.095846,438.838658,564.221132,145.041921,2,0
0,0,15,15,19,20,39,61,46,107,0.000333,0.188513,18,10179.68467,565.538037,565.538037,167.149185,3,0
0,0,15,15,18,20,38,60,46,106,0.000333,0.185427,18,10013.0457,556.280316,556.280316,161.497212,3,0
0,0,18,18,19,21,40,74,52,126,0.000333,0.223521,18,12070.13292,670.56294,670.56294,172.949289,3,0
0,0,16,16,17,20,37,66,51,117,0.000333,0.203169,16,9752.0967,541.78315,609.506044,155.92543,3,0
0,0,11,11,16,17,33,48,37,85,0.000333,0.142925,16,6860.376002,381.132,428.7735,133.486868,2,0
0,0,7,7,10,16,26,22,25,47,0.000333,0.07364,5,1104.603334,61.366852,220.920667,97.219281,1,0
0,0,6,6,10,14,24,15,19,34,0.000333,0.051963,5,779.443625,43.302424,155.888725,86.52225,1,0
0,0,11,11,11,19,30,44,38,82,0.000333,0.134122,10,4023.650288,223.536127,402.365029,118.764371,1,0
0,0,11,11,12,20,32,40,35,75,0.000333,0.125,6,2250,125,375,129.458112,2,0
0,0,10,10,10,16,26,37,33,70,0.000333,0.109677,10,3290.307803,182.794878,329.03078,97.219281,1,0
0,0,7,7,8,12,20,20,20,40,0.000333,0.057626,4,691.508495,38.417139,172.877124,67.01955,1,0
0,0,10,10,9,15,24,37,33,70,0.000333,0.106982,8,2567.579,142.643278,320.947375,87.132684,1,0
0,0,13,13,13,19,32,54,40,94,0.000333,0.156667,12,5640,313.333333,470,128.816339,2,0
0,0,15,15,13,21,34,63,46,109,0.000333,0.184844,12,6654.401396,369.688966,554.53345,140.344382,3,0
0,0,12,12,15,15,30,49,34,83,0.000333,0.135757,14,5701.806872,316.767048,407.271919,117.206718,2,0
0,0,13,13,12,19,31,50,40,90,0.000333,0.148626,12,5350.532015,297.251779,445.877668,123.730173,2,0
0,0,15,15,12,21,33,59,46,105,0.000333,0.176554,12,6355.93659,353.107588,529.661383,135.258216,3,0
0,0,11,11,12,19,31,40,34,74,0.000333,0.122204,6,2199.663162,122.203509,366.610527,123.730173,2,0
0,0,12,12,14,15,29,45,34,79,0.000333,0.127927,14,5372.926981,298.495943,383.780499,111.906328,2,0
0,0,8,8,11,12,23,26,21,47,0.000333,0.070869,5,1063.03706,59.057614,212.607412,81.073298,1,0
0,0,13,13,14,16,30,49,37,86,0.000333,0.140664,14,5907.896277,328.21646,421.992591,117.302969,2,0
0,0,3,3,6,6,12,7,7,14,0.000333,0.01673,3,150.568425,8.364913,50.189475,31.01955,1,0
0,0,3,3,7,7,14,8,8,16,0.000333,0.020306,3,182.753036,10.152946,60.917679,39.302969,1,0
0,0,9,9,11,12,23,30,26,56,0.000333,0.08444,10,2533.194695,140.733039,253.31947,81.073298,1,0
0,0,6,6,10,11,21,19,17,36,0.000333,0.052708,5,790.617136,43.923174,158.123427,71.273029,1,0
0,0,3,3,7,7,14,8,8,16,0.000333,0.020306,3,182.753036,10.152946,60.917679,39.302969,1,0
0,0,12,12,15,19,34,49,41,90,0.000333,0.152624,14,6410.20318,356.122399,457.871656,139.313982,2,0
0,0,7,7,12,15,27,29,26,55,0.000333,0.087173,6,1569.112876,87.172938,261.518813,101.622909,1,0
0,0,13,13,15,16,31,55,42,97,0.000333,0.160186,14,6727.79859,373.766588,480.557042,122.603359,2,0
0,0,16,16,17,16,33,58,42,100,0.000333,0.168146,16,8071.030591,448.390588,504.439412,133.486868,2,0
0,0,10,10,15,14,29,38,27,65,0.000333,0.105256,7,2210.381353,122.798964,315.768765,111.906328,2,0
0,0,16,16,17,16,33,60,42,102,0.000333,0.171509,16,8232.451203,457.3584,514.5282,133.486868,2,0
0,0,10,10,15,14,29,38,27,65,0.000333,0.105256,7,2210.381353,122.798964,315.768765,111.906328,2,0
0,0,18,18,17,17,34,64,51,115,0.000333,0.195019,24,14041.39744,780.077636,585.058227,138.973737,3,0
0,0,10,10,15,14,29,38,27,65,0.000333,0.105256,7,2210.381353,122.798964,315.768765,111.906328,2,0
0,0,18,18,17,17,34,64,51,115,0.000333,0.195019,24,14041.39744,780.077636,585.058227,138.973737,3,0
0,0,10,10,15,14,29,38,27,65,0.000333,0.105256,7,2210.381353,122.798964,315.768765,111.906328,2,0
0,0,6,6,11,12,23,34,22,56,0.000333,0.08444,5,1266.597348,70.366519,253.31947,81.073298,1,0
0,0,18,18,17,17,34,66,60,126,0.000333,0.213673,24,15384.48763,854.693757,641.020318,138.973737,2,0
0,0,15,15,19,19,38,60,45,105,0.000333,0.183677,18,9918.583,551.032389,551.032389,161.421246,4,0
0,0,15,15,19,19,38,59,45,104,0.000333,0.181928,18,9824.120305,545.784461,545.784461,161.421246,4,0
0,0,10,10,14,15,29,48,35,83,0.000333,0.134404,14,5644.973916,313.609662,403.212423,111.906328,5,0
0,0,6,6,10,10,20,17,16,33,0.000333,0.047541,5,713.118136,39.617674,142.623627,66.438562,2,0
0,0,8,8,11,11,22,28,24,52,0.000333,0.077297,10,2318.904442,128.828025,231.890444,76.107496,1,0
0,0,17,17,16,20,36,67,50,117,0.000333,0.201627,16,9678.099603,537.6722,604.881225,150.438562,2,0
0,0,17,17,17,20,37,68,53,121,0.000333,0.210115,16,10085.50172,560.305651,630.343857,155.92543,2,0
0,0,21,21,17,21,38,87,67,154,0.000333,0.269394,24,19396.34009,1077.574449,808.180837,161.725534,2,0
0,0,10,10,16,17,33,50,35,85,0.000333,0.142925,16,6860.376002,381.132,428.7735,133.486868,2,0
0,0,11,11,14,15,29,37,35,72,0.000333,0.116592,14,4896.844843,272.046936,349.774632,111.906328,2,0
0,0,6,6,11,10,21,22,16,38,0.000333,0.055636,5,834.54031,46.363351,166.908062,71.273029,1,0
0,0,6,6,10,11,21,21,17,38,0.000333,0.055636,5,834.54031,46.363351,166.908062,71.273029,1,0
0,0,15,15,14,19,33,70,45,115,0.000333,0.193368,14,8121.474532,451.19303,580.105324,134.013592,5,0
0,0,6,6,10,10,20,16,16,32,0.000333,0.046101,5,691.508495,38.417139,138.301699,66.438562,1,0
0,0,25,25,18,43,61,111,83,194,0.000333,0.383521,9,10355.06739,575.281522,1150.563043,308.388034,9,0
0,0,21,21,18,42,60,105,75,180,0.000333,0.354413,9,9569.162765,531.620154,1063.240307,301.535982,9,0
0,0,8,8,10,10,20,23,22,45,0.000333,0.064829,10,1944.867643,108.048202,194.486764,66.438562,1,0
0,0,17,17,17,20,37,81,53,134,0.000333,0.232689,16,11169.06802,620.503779,698.066751,155.92543,5,0
0,0,16,16,20,19,39,63,49,112,0.000333,0.197322,20,11839.30097,657.738943,591.965049,167.149185,3,0
0,0,15,15,14,17,31,62,47,109,0.000333,0.180002,14,7560.10357,420.005754,540.007398,122.789837,2,0
0,0,18,18,18,19,37,75,55,130,0.000333,0.225743,18,12190.12088,677.228938,677.228938,155.769273,3,0
0,0,16,16,16,21,37,80,55,135,0.000333,0.234425,16,11252.41927,625.134404,703.276204,156.238666,5,0
0,0,10,10,11,14,25,42,32,74,0.000333,0.114548,10,3436.45358,190.914088,343.645358,91.356717,1,0
0,0,24,24,19,23,42,109,81,190,0.000333,0.341513,27,27662.58838,1536.810465,1024.54031,184.752548,3,0
0,0,10,10,15,17,32,47,34,81,0.000333,0.135,14,5670,315,405,128.090227,2,0
0,0,14,14,17,17,34,46,34,80,0.000333,0.135666,16,6511.952437,361.775135,406.997027,138.973737,3,0
0,0,14,14,17,16,33,46,34,80,0.000333,0.134517,16,6456.824473,358.712471,403.55153,133.486868,3,0
0,0,12,12,16,15,31,42,31,73,0.000333,0.120552,16,5786.501291,321.472294,361.656331,122.603359,3,0
0,0,12,12,16,15,31,42,31,73,0.000333,0.120552,16,5786.501291,321.472294,361.656331,122.603359,3,0
0,0,14,14,17,17,34,47,34,81,0.000333,0.137361,16,6593.351842,366.297325,412.08449,138.973737,3,0
0,0,14,14,17,16,33,47,34,81,0.000333,0.136199,16,6537.534779,363.196377,408.595924,133.486868,3,0
0,0,11,11,12,13,25,45,33,78,0.000333,0.12074,12,4346.649394,241.480522,362.220783,91.125266,1,0
0,0,9,9,14,19,33,38,28,66,0.000333,0.110977,7,2330.510083,129.472782,332.930012,134.013592,2,0
0,0,10,10,15,19,34,43,34,77,0.000333,0.130578,7,2742.142471,152.341248,391.734639,139.313982,2,0
0,0,7,7,10,13,23,22,22,44,0.000333,0.066346,5,995.18363,55.287979,199.036726,81.324997,1,0
0,0,9,9,12,16,28,31,28,59,0.000333,0.094545,6,1701.803642,94.544647,283.63394,107.01955,2,0
0,0,6,6,11,12,23,34,22,56,0.000333,0.08444,5,1266.597348,70.366519,253.31947,81.073298,1,0
0,0,10,10,14,21,35,40,36,76,0.000333,0.129942,7,2728.778565,151.598809,389.825509,145.541635,2,0
0,0,14,14,15,26,41,69,54,123,0.000333,0.21966,14,9225.704552,512.539142,658.978897,180.814792,6,0
0,0,10,10,13,21,34,39,36,75,0.000333,0.127187,6,2289.358279,127.186571,381.559713,140.344382,2,0
0,0,16,16,16,28,44,84,61,145,0.000333,0.263873,16,12665.88136,703.660075,791.617585,198.605938,6,0
0,0,12,12,14,23,37,54,43,97,0.000333,0.168439,7,3537.218835,196.512158,505.316976,157.344894,2,0
0,0,6,6,10,10,20,17,16,33,0.000333,0.047541,5,713.118136,39.617674,142.623627,66.438562,2,0
0,0,10,10,15,19,34,38,30,68,0.000333,0.115316,7,2421.632312,134.535128,345.947473,139.313982,2,0
0,0,11,11,16,17,33,42,33,75,0.000333,0.12611,8,3026.636472,168.146471,378.329559,133.486868,2,0
0,0,13,13,17,17,34,54,41,95,0.000333,0.161103,16,7732.943519,429.607973,483.30897,138.973737,2,0
0,0,16,16,13,16,29,75,53,128,0.000333,0.207274,18,11192.78821,621.821567,621.821567,112.105716,1,0
0,0,19,19,17,18,35,88,61,149,0.000333,0.254754,24,18342.31607,1019.017559,764.26317,144.545518,2,0
0,0,10,10,14,16,30,49,34,83,0.000333,0.135757,14,5701.806872,316.767048,407.271919,117.302969,2,0
0,0,9,9,11,13,24,38,28,66,0.000333,0.100869,10,3026.07525,168.115292,302.607525,86.159464,1,0
0,0,12,12,15,15,30,51,36,87,0.000333,0.1423,14,5976.592745,332.03293,426.899482,117.206718,2,0
0,0,10,10,15,15,30,47,32,79,0.000333,0.129215,14,5427.020999,301.501167,387.644357,117.206718,2,0
0,0,14,14,11,19,30,51,48,99,0.000333,0.161927,10,4857.82169,269.878983,485.782169,118.764371,1,0
0,0,14,14,12,20,32,52,51,103,0.000333,0.171667,12,6180,343.333333,515,129.458112,1,0
0,0,18,18,16,21,37,72,68,140,0.000333,0.243108,24,17503.76331,972.431295,729.323471,156.238666,2,0
0,0,18,18,18,19,37,72,57,129,0.000333,0.224006,27,18144.52607,1008.029226,672.019484,155.769273,2,0
0,0,19,19,18,20,38,64,59,123,0.000333,0.215165,18,11618.91152,645.495084,645.495084,161.497212,2,0
0,0,21,21,19,21,40,82,69,151,0.000333,0.26787,27,21697.50084,1205.416713,803.611142,172.949289,2,0
0,0,6,6,10,11,21,21,17,38,0.000333,0.055636,5,834.54031,46.363351,166.908062,71.273029,1,0
0,0,6,6,10,11,21,21,17,38,0.000333,0.055636,5,834.54031,46.363351,166.908062,71.273029,1,0
0,0,10,10,14,13,27,34,27,61,0.000333,0.096683,14,4060.673927,225.592996,290.048138,101.408685,3,0
0,0,8,8,11,14,25,27,26,53,0.000333,0.082041,5,1230.62189,68.367883,246.124378,91.356717,1,0
0,0,11,11,15,18,33,40,36,76,0.000333,0.127791,14,5367.235343,298.179741,383.373953,133.662009,2,0
0,0,11,11,15,18,33,40,36,76,0.000333,0.127791,14,5367.235343,298.179741,383.373953,133.662009,2,0
0,0,9,9,12,16,28,36,29,65,0.000333,0.104159,6,1874.86842,104.159357,312.47807,107.01955,3,0
0,0,10,10,13,14,27,33,26,59,0.000333,0.093513,6,1683.230176,93.512788,280.538363,101.408685,2,0
0,0,8,8,13,13,26,27,20,47,0.000333,0.07364,6,1325.524001,73.640222,220.920667,96.211433,2,0
0,0,7,7,10,14,24,23,23,46,0.000333,0.070303,5,1054.541375,58.585632,210.908275,86.52225,1,0
0,0,6,6,10,10,20,17,15,32,0.000333,0.046101,5,691.508495,38.417139,138.301699,66.438562,1,0
0,0,22,22,18,22,40,87,77,164,0.000333,0.290932,27,23565.4976,1309.194311,872.796208,173.166146,2,0
0,0,20,20,17,20,37,69,67,136,0.000333,0.236162,24,17003.65579,944.647544,708.485658,155.92543,2,0
0,0,19,19,17,19,36,77,65,142,0.000333,0.24471,24,17619.10441,978.839134,734.12935,150.197491,2,0
0,0,6,6,10,13,23,20,18,38,0.000333,0.057298,5,859.476772,47.74871,171.895354,81.324997,1,0
0,0,9,9,11,14,25,30,30,60,0.000333,0.092877,10,2786.313714,154.795206,278.631371,91.356717,1,0
0,0,9,9,11,14,25,30,30,60,0.000333,0.092877,10,2786.313714,154.795206,278.631371,91.356717,1,0
0,0,18,18,19,21,40,80,61,141,0.000333,0.250131,18,13507.05351,750.391861,750.391861,172.949289,2,0
0,0,16,16,17,19,36,70,52,122,0.000333,0.210244,16,10091.6936,560.649645,630.73085,150.197491,2,0
0,0,15,15,17,18,35,65,47,112,0.000333,0.191493,16,9191.675166,510.64862,574.479698,144.545518,2,0
0,0,6,6,10,11,21,21,17,38,0.000333,0.055636,5,834.54031,46.363351,166.908062,71.273029,1,0
0,0,11,11,11,17,28,39,37,76,0.000333,0.121786,10,3653.589741,202.977208,365.358974,107.540616,1,0
0,0,10,10,10,13,23,33,33,66,0.000333,0.099518,10,2985.550891,165.863938,298.555089,81.324997,1,0
0,0,19,19,18,19,37,68,62,130,0.000333,0.225743,27,18285.18131,1015.843406,677.228938,155.769273,3,0
0,0,19,19,19,19,38,69,62,131,0.000333,0.22916,27,18561.91962,1031.217756,687.478504,161.421246,3,0
0,0,18,18,15,29,44,86,60,146,0.000333,0.265692,14,11159.07823,619.94879,797.077016,199.484808,5,0
0,0,15,15,15,26,41,75,53,128,0.000333,0.228589,14,9600.733192,533.374066,685.766657,180.814792,4,0
0,0,12,12,15,21,36,56,41,97,0.000333,0.167161,7,3510.379076,195.02106,501.482725,150.842025,2,0
0,0,6,6,9,10,19,17,15,32,0.000333,0.045311,4,543.734722,30.207485,135.93368,61.748606,2,0
0,0,15,15,16,20,36,75,46,121,0.000333,0.20852,16,10008.9748,556.054156,625.560925,150.438562,6,0
0,0,13,13,13,14,27,57,39,96,0.000333,0.152156,12,5477.630402,304.3128,456.4692,101.408685,2,0
0,0,16,16,16,16,32,70,47,117,0.000333,0.195,16,9360,520,585,128,3,0
0,0,13,13,13,13,26,57,39,96,0.000333,0.150414,18,8122.359833,451.242213,451.242213,96.211433,2,0
0,0,16,16,16,15,31,70,47,117,0.000333,0.193214,24,13911.38324,772.854624,579.640968,122.603359,3,0
0,0,5,5,9,15,24,19,21,40,0.000333,0.061133,4,733.594,40.755222,183.3985,87.132684,1,0
0,0,25,25,22,46,68,117,84,201,0.000333,0.40786,11,13459.38034,747.743352,1223.580031,352.191346,9,0
0,0,24,24,22,46,68,116,82,198,0.000333,0.401773,11,13258.49407,736.583004,1205.317643,352.191346,9,0
0,0,9,9,12,13,25,38,27,65,0.000333,0.100617,12,3622.207828,201.233768,301.850652,91.125266,2,0
0,0,9,9,12,12,24,38,27,65,0.000333,0.099341,12,3576.270751,198.681708,298.022563,86.0391,2,0
0,0,16,16,14,17,31,55,49,104,0.000333,0.171745,14,7213.309828,400.739435,515.236416,122.789837,2,0
0,0,18,18,17,19,36,63,54,117,0.000333,0.201627,16,9678.099603,537.6722,604.881225,150.197491,3,0
0,0,16,16,14,16,30,55,49,104,0.000333,0.170106,21,10716.64906,595.369392,510.316622,117.302969,2,0
0,0,18,18,17,18,35,63,54,117,0.000333,0.200042,24,14403.02671,800.168151,600.126113,144.545518,3,0
0,0,14,14,13,15,28,51,46,97,0.000333,0.155438,18,8393.641694,466.313427,466.313427,106.709075,2,0
0,0,16,16,16,17,33,59,51,110,0.000333,0.184961,24,13317.20048,739.844471,554.883353,133.486868,3,0
0,0,14,14,13,15,28,51,46,97,0.000333,0.155438,18,8393.641694,466.313427,466.313427,106.709075,2,0
0,0,16,16,16,17,33,59,51,110,0.000333,0.184961,24,13317.20048,739.844471,554.883353,133.486868,3,0
0,0,6,6,10,11,21,21,17,38,0.000333,0.055636,5,834.54031,46.363351,166.908062,71.273029,1,0
0,0,6,6,10,11,21,21,17,38,0.000333,0.055636,5,834.54031,46.363351,166.908062,71.273029,1,0
0,0,8,8,12,14,26,34,30,64,0.000333,0.100276,12,3609.937704,200.552095,300.828142,96.322519,1,0
0,0,8,8,13,14,27,25,22,47,0.000333,0.074493,6,1340.878276,74.493238,223.479713,101.408685,2,0
0,0,8,8,13,14,27,25,22,47,0.000333,0.074493,6,1340.878276,74.493238,223.479713,101.408685,2,0
0,0,8,8,13,14,27,25,22,47,0.000333,0.074493,6,1340.878276,74.493238,223.479713,101.408685,2,0
0,0,23,23,17,22,39,105,77,182,0.000333,0.320648,24,23086.63689,1282.590938,961.943204,167.594364,2,0
0,0,10,10,11,14,25,34,32,66,0.000333,0.102165,10,3064.945085,170.274727,306.494509,91.356717,1,0
0,0,13,13,15,17,32,47,40,87,0.000333,0.145,14,6090,338.333333,435,128.090227,2,0
0,0,15,15,16,19,35,58,48,106,0.000333,0.181235,16,8699.263997,483.292444,543.704,144.710623,2,0
0,0,5,5,12,12,24,22,17,39,0.000333,0.059605,6,1072.881225,59.604513,178.813538,86.0391,1,0
0,0,8,8,15,15,30,35,25,60,0.000333,0.098138,7,2060.89405,114.494114,294.413436,117.206718,2,0
0,0,11,11,13,17,30,43,41,84,0.000333,0.137393,12,4946.14572,274.785873,412.17881,117.592585,1,0
0,0,11,11,14,14,28,38,32,70,0.000333,0.112172,14,4711.207824,261.733768,336.514845,106.605938,2,0
0,0,11,11,14,14,28,38,32,70,0.000333,0.112172,14,4711.207824,261.733768,336.514845,106.605938,2,0
0,0,11,11,14,14,28,37,32,69,0.000333,0.110569,14,4643.904855,257.994714,331.70749,106.605938,2,0
0,0,11,11,14,14,28,37,32,69,0.000333,0.110569,14,4643.904855,257.994714,331.70749,106.605938,2,0
0,0,8,8,13,13,26,27,20,47,0.000333,0.07364,6,1325.524001,73.640222,220.920667,96.211433,2,0
0,0,8,8,13,13,26,27,20,47,0.000333,0.07364,6,1325.524001,73.640222,220.920667,96.211433,2,0
0,0,16,16,15,17,32,54,49,103,0.000333,0.171667,14,7210,400.555556,515,128.090227,3,0
0,0,16,16,15,17,32,54,49,103,0.000333,0.171667,14,7210,400.555556,515,128.090227,3,0
0,0,11,11,16,15,31,38,31,69,0.000333,0.113947,16,5469.432727,303.857374,341.839545,122.603359,2,0
0,0,18,18,18,21,39,74,60,134,0.000333,0.236081,18,12748.39015,708.243897,708.243897,167.297316,2,0
0,0,10,10,13,14,27,33,28,61,0.000333,0.096683,12,3480.577652,193.365425,290.048138,101.408685,2,0
0,0,10,10,13,14,27,33,26,59,0.000333,0.093513,6,1683.230176,93.512788,280.538363,101.408685,2,0
0,0,8,8,13,13,26,27,20,47,0.000333,0.07364,6,1325.524001,73.640222,220.920667,96.211433,2,0
0,0,10,10,13,16,29,34,27,61,0.000333,0.098779,6,1778.021044,98.778947,296.336841,112.105716,2,0
0,0,10,10,14,15,29,48,35,83,0.000333,0.134404,14,5644.973916,313.609662,403.212423,111.906328,5,0
0,0,6,6,10,10,20,17,16,33,0.000333,0.047541,5,713.118136,39.617674,142.623627,66.438562,2,0
0,0,8,8,15,16,31,31,23,54,0.000333,0.089176,7,1872.686205,104.038123,267.526601,122.603359,2,0
0,0,21,21,16,30,46,105,70,175,0.000333,0.322208,16,15465.97348,859.220749,966.623342,211.206718,6,0
0,0,26,26,19,48,67,135,93,228,0.000333,0.461023,9,12447.61502,691.534168,1383.068335,348.788823,9,0
0,0,12,12,13,22,35,51,42,93,0.000333,0.159008,6,2862.139923,159.007774,477.023321,146.213212,2,0
0,0,8,8,10,13,23,25,22,47,0.000333,0.070869,5,1063.03706,59.057614,212.607412,81.324997,1,0
0,0,13,13,13,23,36,55,45,100,0.000333,0.172331,6,3101.955001,172.330833,516.9925,152.147641,2,0
0,0,21,21,17,31,48,100,70,170,0.000333,0.316481,16,15191.098,843.949889,949.443625,223.066954,6,0
0,0,12,12,13,23,36,46,42,88,0.000333,0.151651,6,2729.720401,151.651133,454.9534,152.147641,2,0
0,0,23,23,18,32,50,114,78,192,0.000333,0.361207,18,19505.16699,1083.620388,1083.620388,235.05865,6,0
0,0,14,14,15,25,40,60,50,110,0.000333,0.195137,14,8195.769266,455.320515,585.41209,174.699764,2,0
0,0,18,18,19,17,36,70,48,118,0.000333,0.20335,18,10980.9207,610.05115,610.05115,150.197491,4,0
0,0,18,18,19,17,36,70,48,118,0.000333,0.20335,18,10980.9207,610.05115,610.05115,150.197491,4,0
0,0,9,9,12,13,25,38,27,65,0.000333,0.100617,12,3622.207828,201.233768,301.850652,91.125266,2,0
0,0,9,9,12,13,25,38,27,65,0.000333,0.100617,12,3622.207828,201.233768,301.850652,91.125266,2,0
0,0,9,9,13,14,27,39,28,67,0.000333,0.106192,12,3822.929552,212.384975,318.577463,101.408685,2,0
0,0,9,9,12,14,26,38,28,66,0.000333,0.10341,12,3722.748257,206.819348,310.229021,96.322519,2,0
0,0,9,9,13,14,27,39,28,67,0.000333,0.106192,12,3822.929552,212.384975,318.577463,101.408685,2,0
0,0,9,9,12,14,26,38,28,66,0.000333,0.10341,12,3722.748257,206.819348,310.229021,96.322519,2,0
0,0,11,11,13,15,28,43,30,73,0.000333,0.116979,12,4211.242912,233.95794,350.936909,106.709075,2,0
0,0,11,11,13,14,27,43,30,73,0.000333,0.115702,12,4165.281452,231.404525,347.106788,101.408685,2,0
0,0,9,9,12,13,25,38,27,65,0.000333,0.100617,12,3622.207828,201.233768,301.850652,91.125266,2,0
0,0,9,9,12,13,25,38,27,65,0.000333,0.100617,12,3622.207828,201.233768,301.850652,91.125266,2,0
0,0,15,15,17,16,33,55,38,93,0.000333,0.156376,16,7506.05845,417.003247,469.128653,133.486868,3,0
0,0,10,10,15,14,29,39,28,67,0.000333,0.108495,14,4556.786173,253.154787,325.484727,111.906328,2,0
0,0,15,15,17,16,33,55,38,93,0.000333,0.156376,16,7506.05845,417.003247,469.128653,133.486868,3,0
0,0,10,10,15,14,29,39,28,67,0.000333,0.108495,14,4556.786173,253.154787,325.484727,111.906328,2,0
0,0,12,12,17,18,35,52,37,89,0.000333,0.152169,16,7304.099016,405.783279,456.506189,144.545518,3,0
0,0,12,12,17,18,35,51,37,88,0.000333,0.150459,16,7222.030488,401.223916,451.376905,144.545518,3,0
0,0,8,8,14,17,31,30,24,54,0.000333,0.089176,7,1872.686205,104.038123,267.526601,122.789837,2,0
0,0,13,13,16,14,30,50,39,89,0.000333,0.145571,16,6987.412208,388.189567,436.713263,117.302969,1,0
0,0,15,15,17,18,35,60,51,111,0.000333,0.189783,16,9109.606638,506.089258,569.350415,144.545518,2,0
0,0,11,11,15,18,33,41,36,77,0.000333,0.129473,14,5437.856861,302.103159,388.418347,133.662009,2,0
0,0,11,11,15,18,33,41,36,77,0.000333,0.129473,14,5437.856861,302.103159,388.418347,133.662009,2,0
0,0,11,11,13,17,30,47,43,90,0.000333,0.147207,12,5299.441843,294.413436,441.620154,117.592585,1,0
0,0,13,13,17,20,37,55,48,103,0.000333,0.178858,16,8585.179147,476.954397,536.573697,155.92543,2,0
0,0,11,11,11,13,24,38,35,73,0.000333,0.111567,10,3347.022626,185.945701,334.702263,86.159464,1,0
0,0,11,11,14,20,34,44,39,83,0.000333,0.140753,7,2955.815911,164.211995,422.259416,139.741531,2,0
0,0,11,11,14,20,34,44,39,83,0.000333,0.140753,7,2955.815911,164.211995,422.259416,139.741531,2,0
0,0,10,10,13,20,33,40,35,75,0.000333,0.12611,6,2269.977354,126.109853,378.329559,134.544278,2,0
0,0,12,12,17,19,36,50,41,91,0.000333,0.156821,16,7527.410802,418.189489,470.463175,150.197491,2,0
0,0,14,14,12,15,27,59,51,110,0.000333,0.174346,18,9414.677254,523.037625,523.037625,101.622909,1,0
0,0,16,16,16,18,34,67,56,123,0.000333,0.208586,24,15018.19031,834.343906,625.757929,139.05865,2,0
0,0,12,12,13,21,34,54,41,95,0.000333,0.161103,6,2899.85382,161.10299,483.30897,140.344382,5,0
0,0,6,6,10,11,21,16,16,32,0.000333,0.046851,5,702.770788,39.042822,140.554158,71.273029,1,0
0,0,15,15,13,19,32,76,56,132,0.000333,0.22,12,7920,440,660,128.816339,1,0
0,0,20,20,15,30,45,85,68,153,0.000333,0.280085,14,11763.54933,653.530518,840.253524,205.810077,6,0
0,0,14,14,14,21,35,47,49,96,0.000333,0.164137,14,6893.756375,382.986465,492.41117,145.541635,2,0
0,0,5,5,11,12,23,20,19,39,0.000333,0.058806,5,882.094581,49.005255,176.418916,81.073298,2,0
0,0,14,14,19,18,37,56,43,99,0.000333,0.171912,18,9283.245898,515.735883,515.735883,155.769273,3,0
0,0,5,5,12,13,25,21,20,41,0.000333,0.063466,6,1142.388623,63.466035,190.398104,91.125266,2,0
0,0,16,16,19,20,39,65,50,115,0.000333,0.202607,18,10940.78259,607.821255,607.821255,167.149185,4,0
0,0,5,5,11,12,23,20,19,39,0.000333,0.058806,5,882.094581,49.005255,176.418916,81.073298,2,0
0,0,17,17,20,22,42,64,52,116,0.000333,0.208503,20,12510.17642,695.009801,625.508821,184.546058,3,0
0,0,5,5,12,13,25,21,20,41,0.000333,0.063466,6,1142.388623,63.466035,190.398104,91.125266,2,0
0,0,18,18,15,21,36,77,60,137,0.000333,0.236093,14,9915.916153,550.884231,708.279725,150.842025,5,0
0,0,12,12,10,14,24,39,41,80,0.000333,0.122266,10,3667.970001,203.776111,366.797,86.52225,1,0
0,0,15,15,13,21,34,57,48,105,0.000333,0.178061,12,6410.20318,356.122399,534.183598,140.344382,3,0
0,0,16,16,13,21,34,58,50,108,0.000333,0.183149,12,6593.351842,366.297325,549.445987,140.344382,3,0
0,0,16,16,15,23,38,65,54,119,0.000333,0.208168,14,8743.047237,485.724847,624.503374,162.645284,4,0
0,0,17,17,15,23,38,66,56,122,0.000333,0.213416,14,8963.460193,497.970011,640.247157,162.645284,4,0
0,0,13,13,14,17,31,55,45,100,0.000333,0.16514,14,6935.874835,385.32638,495.419631,122.789837,2,0
0,0,16,16,18,20,38,68,53,121,0.000333,0.211666,18,11429.98612,634.999229,634.999229,161.497212,3,0
0,0,10,10,15,16,31,46,33,79,0.000333,0.130461,14,5479.341119,304.40784,391.381509,122.603359,2,0
0,0,21,21,17,23,40,88,77,165,0.000333,0.292706,24,21074.83526,1170.824181,878.118136,173.528793,2,0
0,0,11,11,14,16,30,51,36,87,0.000333,0.1423,14,5976.592745,332.03293,426.899482,117.302969,6,0
0,0,7,7,10,11,21,20,17,37,0.000333,0.054172,5,812.578723,45.143262,162.515745,71.273029,3,0
0,0,8,8,14,12,26,28,19,47,0.000333,0.07364,7,1546.444667,85.913593,220.920667,96.322519,2,0
0,0,8,8,14,12,26,28,19,47,0.000333,0.07364,7,1546.444667,85.913593,220.920667,96.322519,2,0
0,0,10,10,14,15,29,48,35,83,0.000333,0.134404,14,5644.973916,313.609662,403.212423,111.906328,5,0
0,0,6,6,10,10,20,17,16,33,0.000333,0.047541,5,713.118136,39.617674,142.623627,66.438562,2,0
0,0,10,10,15,19,34,38,30,68,0.000333,0.115316,7,2421.632312,134.535128,345.947473,139.313982,2,0
0,0,9,9,14,13,27,31,21,52,0.000333,0.082418,7,1730.779051,96.154392,247.25415,101.408685,2,0
0,0,10,10,14,13,27,34,25,59,0.000333,0.093513,7,1963.768538,109.098252,280.538363,101.408685,2,0
0,0,12,12,15,15,30,51,37,88,0.000333,0.143935,14,6045.289214,335.849401,431.806372,117.206718,3,0
0,0,12,12,15,15,30,51,37,88,0.000333,0.143935,14,6045.289214,335.849401,431.806372,117.206718,3,0
0,0,12,12,13,23,36,53,43,96,0.000333,0.165438,6,2977.876801,165.4376,496.3128,152.147641,5,0
0,0,6,6,10,14,24,15,19,34,0.000333,0.051963,5,779.443625,43.302424,155.888725,86.52225,1,0
0,0,18,18,15,30,45,84,63,147,0.000333,0.269101,14,11302.23367,627.901871,807.302405,205.810077,6,0
0,0,23,23,19,46,65,121,84,205,0.000333,0.411528,9,11111.26862,617.292701,1234.585402,334.794473,7,0
0,0,12,12,14,21,35,46,40,86,0.000333,0.147039,7,3087.828376,171.546021,441.118339,145.541635,2,0
0,0,7,7,8,12,20,20,20,40,0.000333,0.057626,4,691.508495,38.417139,172.877124,67.01955,1,0
0,0,12,12,13,20,33,46,40,86,0.000333,0.144606,12,5205.814731,289.21193,433.817894,134.544278,2,0
0,0,12,12,13,21,34,54,41,95,0.000333,0.161103,6,2899.85382,161.10299,483.30897,140.344382,5,0
0,0,6,6,10,11,21,16,16,32,0.000333,0.046851,5,702.770788,39.042822,140.554158,71.273029,1,0
0,0,15,15,18,18,36,65,48,113,0.000333,0.194734,18,10515.62745,584.201525,584.201525,150.1173,2,0
0,0,11,11,17,16,33,52,35,87,0.000333,0.146287,16,7021.796614,390.099812,438.862288,133.486868,2,0
0,0,18,18,18,17,35,73,52,125,0.000333,0.21372,27,17311.33018,961.740566,641.160377,144.545518,2,0
0,0,11,11,15,15,30,51,34,85,0.000333,0.139029,14,5839.199809,324.399989,417.085701,117.206718,2,0
0,0,13,13,16,14,30,52,36,88,0.000333,0.143935,16,6908.901959,383.827887,431.806372,117.302969,2,0
0,0,11,11,15,14,29,50,34,84,0.000333,0.136023,14,5712.98565,317.388092,408.070404,111.906328,2,0
0,0,9,9,15,15,30,32,26,58,0.000333,0.094867,7,1992.197582,110.677643,284.599655,117.206718,2,0
0,0,15,15,16,16,32,51,46,97,0.000333,0.161667,16,7760,431.111111,485,128,2,0
0,0,13,13,11,14,25,53,40,93,0.000333,0.14396,10,4318.786256,239.93257,431.878626,91.356717,1,0
0,0,16,16,15,16,31,66,48,114,0.000333,0.188259,21,11860.34597,658.908109,564.778379,122.603359,2,0
0,0,10,10,14,15,29,43,31,74,0.000333,0.11983,14,5032.868311,279.603795,359.490594,111.906328,2,0
0,0,18,18,16,17,33,81,56,137,0.000333,0.230361,24,16585.96786,921.442659,691.081994,133.486868,2,0
0,0,11,11,14,21,35,43,38,81,0.000333,0.138491,7,2908.303471,161.572415,415.471924,145.541635,2,0
0,0,16,16,16,19,35,60,50,110,0.000333,0.188074,16,9027.53811,501.529895,564.221132,144.710623,2,0
0,0,3,3,9,10,19,15,14,29,0.000333,0.041063,4,492.759592,27.375533,123.189898,61.748606,3,0
0,0,9,9,12,12,24,34,27,61,0.000333,0.093228,12,3356.192551,186.455142,279.682713,86.0391,1,0
0,0,8,8,15,16,31,31,23,54,0.000333,0.089176,7,1872.686205,104.038123,267.526601,122.603359,2,0
0,0,8,8,15,16,31,31,23,54,0.000333,0.089176,7,1872.686205,104.038123,267.526601,122.603359,2,0
0,0,8,8,15,16,31,31,23,54,0.000333,0.089176,7,1872.686205,104.038123,267.526601,122.603359,2,0
0,0,11,11,17,19,36,48,40,88,0.000333,0.151651,16,7279.254402,404.403022,454.9534,150.197491,2,0
0,0,18,18,17,23,40,84,64,148,0.000333,0.262548,16,12602.32573,700.129207,787.645358,173.528793,2,0
0,0,8,8,13,14,27,25,22,47,0.000333,0.074493,6,1340.878276,74.493238,223.479713,101.408685,2,0
0,0,22,22,18,41,59,101,76,177,0.000333,0.347076,9,9371.050378,520.61391,1041.22782,294.718282,7,0
0,0,18,18,18,39,57,94,66,160,0.000333,0.311087,9,8399.36162,466.631201,933.262402,281.189337,7,0
0,0,22,22,18,42,60,102,79,181,0.000333,0.356382,9,9622.32478,534.573599,1069.147198,301.535982,7,0
0,0,18,18,18,40,58,94,67,161,0.000333,0.314378,9,8488.214462,471.56747,943.13494,287.935774,7,0
0,0,13,13,12,17,29,49,42,91,0.000333,0.147359,12,5304.915247,294.717514,442.076271,112.506418,2,0
0,0,16,16,16,20,36,62,50,112,0.000333,0.193011,16,9264.505603,514.694756,579.0316,150.438562,3,0
0,0,15,15,14,19,33,71,45,116,0.000333,0.19505,14,8192.09605,455.116447,585.149718,134.013592,5,0
0,0,17,17,17,19,36,60,46,106,0.000333,0.182671,16,8768.192802,487.121822,548.01205,150.197491,2,0
0,0,10,10,15,14,29,39,28,67,0.000333,0.108495,14,4556.786173,253.154787,325.484727,111.906328,2,0
0,0,16,16,16,16,32,58,45,103,0.000333,0.171667,16,8240,457.777778,515,128,2,0
0,0,10,10,14,14,28,41,30,71,0.000333,0.113774,14,4778.510793,265.472822,341.322199,106.605938,2,0
0,0,18,18,17,17,34,66,52,118,0.000333,0.200107,24,14407.69477,800.427487,600.320615,138.973737,3,0
0,0,10,10,15,14,29,39,28,67,0.000333,0.108495,14,4556.786173,253.154787,325.484727,111.906328,2,0
0,0,18,18,17,17,34,66,52,118,0.000333,0.200107,24,14407.69477,800.427487,600.320615,138.973737,3,0
0,0,10,10,15,14,29,39,28,67,0.000333,0.108495,14,4556.786173,253.154787,325.484727,111.906328,2,0
0,0,11,11,14,14,28,37,30,67,0.000333,0.107364,14,4509.298917,250.516606,322.09278,106.605938,2,0
0,0,10,10,15,14,29,42,30,72,0.000333,0.116592,14,4896.844843,272.046936,349.774632,111.906328,2,0
0,0,14,14,14,23,37,64,49,113,0.000333,0.196223,14,8241.355224,457.853068,588.66823,157.344894,5,0
0,0,8,8,10,14,24,26,26,52,0.000333,0.079473,5,1192.09025,66.227236,238.41805,86.52225,1,0
0,0,18,18,15,21,36,86,57,143,0.000333,0.246433,14,10350.18985,575.010547,739.299275,150.842025,6,0
0,0,12,12,15,15,30,49,34,83,0.000333,0.135757,14,5701.806872,316.767048,407.271919,117.206718,2,0
0,0,16,16,18,20,38,61,52,113,0.000333,0.197672,18,10674.28456,593.015809,593.015809,161.497212,2,0
0,0,15,15,16,19,35,62,50,112,0.000333,0.191493,16,9191.675166,510.64862,574.479698,144.710623,2,0
0,0,34,34,21,49,70,155,112,267,0.000333,0.545506,20,32730.37131,1818.353962,1636.518566,367.359448,9,0
0,0,33,33,21,49,70,154,110,264,0.000333,0.539377,20,32362.61433,1797.923018,1618.130716,367.359448,9,0
0,0,9,9,15,21,36,40,34,74,0.000333,0.127525,7,2678.021151,148.778953,382.57445,150.842025,2,0
0,0,16,16,15,19,34,75,58,133,0.000333,0.225544,21,14209.28372,789.404651,676.632558,139.313982,1,0
0,0,12,12,16,14,30,49,35,84,0.000333,0.137393,16,6594.86096,366.381164,412.17881,117.302969,1,0
0,0,12,12,15,14,29,46,37,83,0.000333,0.134404,14,5644.973916,313.609662,403.212423,111.906328,1,0
0,0,8,8,12,11,23,30,24,54,0.000333,0.081424,12,2931.268148,162.84823,244.272346,81.073298,1,0
0,0,8,8,14,13,27,34,26,60,0.000333,0.095098,14,3994.105502,221.89475,285.29325,101.408685,1,0
0,0,11,11,13,17,30,38,38,76,0.000333,0.124308,12,4475.084223,248.61579,372.923685,117.592585,3,0
0,0,16,16,16,19,35,60,54,114,0.000333,0.194913,16,9355.812223,519.767346,584.738264,144.710623,3,0
0,0,18,18,18,21,39,68,59,127,0.000333,0.223749,18,12082.42947,671.246082,671.246082,167.297316,4,0
0,0,11,11,15,17,32,40,39,79,0.000333,0.131667,14,5530,307.222222,395,128.090227,3,0
0,0,16,16,15,19,34,59,54,113,0.000333,0.191628,14,8048.366215,447.131456,574.883301,139.313982,3,0
0,0,18,18,18,21,39,67,59,126,0.000333,0.221987,18,11987.29223,665.96068,665.96068,167.297316,4,0
0,0,11,11,14,17,31,39,39,78,0.000333,0.128809,14,5409.982371,300.554576,386.427312,122.789837,3,0
0,0,13,13,15,17,32,43,40,83,0.000333,0.138333,14,5810,322.777778,415,128.090227,3,0
0,0,18,18,16,19,35,64,56,120,0.000333,0.205171,16,9848.223393,547.123522,615.513962,144.710623,3,0
0,0,20,20,19,21,40,72,61,133,0.000333,0.235939,18,12740.69586,707.816437,707.816437,172.949289,4,0
0,0,13,13,15,17,32,44,41,85,0.000333,0.141667,14,5950,330.555556,425,128.090227,3,0
0,0,18,18,16,19,35,64,56,120,0.000333,0.205171,16,9848.223393,547.123522,615.513962,144.710623,3,0
0,0,20,20,19,21,40,72,61,133,0.000333,0.235939,18,12740.69586,707.816437,707.816437,172.949289,4,0
0,0,13,13,15,17,32,44,41,85,0.000333,0.141667,14,5950,330.555556,425,128.090227,3,0
0,0,11,11,13,17,30,38,38,76,0.000333,0.124308,12,4475.084223,248.61579,372.923685,117.592585,3,0
0,0,16,16,16,19,35,60,54,114,0.000333,0.194913,16,9355.812223,519.767346,584.738264,144.710623,3,0
0,0,18,18,18,21,39,68,59,127,0.000333,0.223749,18,12082.42947,671.246082,671.246082,167.297316,4,0
0,0,11,11,15,17,32,40,39,79,0.000333,0.131667,14,5530,307.222222,395,128.090227,3,0
0,0,16,16,15,19,34,59,54,113,0.000333,0.191628,14,8048.366215,447.131456,574.883301,139.313982,3,0
0,0,18,18,18,21,39,67,59,126,0.000333,0.221987,18,11987.29223,665.96068,665.96068,167.297316,4,0
0,0,11,11,14,17,31,39,39,78,0.000333,0.128809,14,5409.982371,300.554576,386.427312,122.789837,3,0
0,0,16,16,13,15,28,58,55,113,0.000333,0.181077,18,9778.159911,543.231106,543.231106,106.709075,1,0
0,0,18,18,17,17,34,66,60,126,0.000333,0.213673,24,15384.48763,854.693757,641.020318,138.973737,2,0
0,0,15,15,12,15,27,54,53,107,0.000333,0.169591,18,9157.913329,508.772963,508.772963,101.622909,1,0
0,0,17,17,16,17,33,62,58,120,0.000333,0.201776,24,14527.85506,807.103059,605.327294,133.486868,2,0
0,0,11,11,14,16,30,51,36,87,0.000333,0.1423,14,5976.592745,332.03293,426.899482,117.302969,6,0
0,0,7,7,10,11,21,20,17,37,0.000333,0.054172,5,812.578723,45.143262,162.515745,71.273029,3,0
0,0,19,19,15,23,38,92,60,152,0.000333,0.265895,14,11167.58975,620.421653,797.684982,162.645284,5,0
0,0,10,10,10,14,24,38,32,70,0.000333,0.106982,10,3209.473751,178.304097,320.947375,86.52225,1,0
0,0,11,11,10,15,25,42,35,77,0.000333,0.119192,10,3575.769266,198.653848,357.576927,91.82264,1,0
0,0,12,12,14,18,32,54,41,95,0.000333,0.158333,14,6650,369.444444,475,128.361619,5,0
0,0,6,6,11,12,23,17,17,34,0.000333,0.051267,5,769.005533,42.72253,153.801107,81.073298,1,0
0,0,12,12,12,13,25,54,38,92,0.000333,0.142412,12,5126.817234,284.82318,427.234769,91.125266,1,0
0,0,15,15,16,15,31,67,46,113,0.000333,0.186608,24,13435.78039,746.432244,559.824183,122.603359,2,0
0,0,10,10,15,15,30,47,32,79,0.000333,0.129215,14,5427.020999,301.501167,387.644357,117.206718,2,0
0,0,12,12,13,21,34,53,41,94,0.000333,0.159407,6,2869.329042,159.407169,478.221507,140.344382,5,0
0,0,6,6,10,11,21,15,17,32,0.000333,0.046851,5,702.770788,39.042822,140.554158,71.273029,1,0
0,0,16,16,14,25,39,69,53,122,0.000333,0.21494,14,9027.46699,501.525944,644.819071,169.399374,6,0
0,0,10,10,13,15,28,31,30,61,0.000333,0.09775,12,3518.983803,195.4991,293.24865,106.709075,2,0
0,0,8,8,11,13,24,26,23,49,0.000333,0.074888,5,1123.315813,62.406434,224.663163,86.159464,2,0
0,0,8,8,12,14,26,27,26,53,0.000333,0.083041,6,1494.73983,83.041102,249.123305,96.322519,2,0
0,0,10,10,15,15,30,41,34,75,0.000333,0.122672,14,5152.235125,286.235285,368.016795,117.206718,2,0
0,0,8,8,12,18,30,32,29,61,0.000333,0.099773,6,1795.921958,99.773442,299.320326,118.0782,4,0
0,0,6,6,10,14,24,15,19,34,0.000333,0.051963,5,779.443625,43.302424,155.888725,86.52225,2,0
0,0,12,12,13,21,34,54,42,96,0.000333,0.162799,12,5860.757193,325.597622,488.396433,140.344382,3,0
0,0,10,10,10,16,26,37,33,70,0.000333,0.109677,10,3290.307803,182.794878,329.03078,97.219281,1,0
0,0,10,10,9,15,24,37,33,70,0.000333,0.106982,8,2567.579,142.643278,320.947375,87.132684,1,0
0,0,9,9,11,14,25,30,28,58,0.000333,0.089781,10,2693.43659,149.635366,269.343659,91.356717,1,0
0,0,15,15,17,16,33,50,42,92,0.000333,0.154695,16,7425.348144,412.519341,464.084259,133.486868,3,0
0,0,15,15,16,18,34,51,43,94,0.000333,0.159407,16,7651.544113,425.085784,478.221507,139.05865,3,0
0,0,15,15,16,18,34,50,43,93,0.000333,0.157711,16,7570.144708,420.563595,473.134044,139.05865,3,0
0,0,19,19,17,20,37,67,52,119,0.000333,0.206642,16,9918.799208,551.0444,619.924951,155.92543,3,0
0,0,17,17,17,18,35,54,45,99,0.000333,0.169266,16,8124.784299,451.376905,507.799019,144.545518,3,0
0,0,17,17,17,18,35,54,45,99,0.000333,0.169266,16,8124.784299,451.376905,507.799019,144.545518,3,0
0,0,15,15,16,17,33,50,42,92,0.000333,0.154695,16,7425.348144,412.519341,464.084259,133.486868,3,0
0,0,15,15,16,17,33,50,42,92,0.000333,0.154695,16,7425.348144,412.519341,464.084259,133.486868,3,0
0,0,7,7,10,14,24,22,23,45,0.000333,0.068774,5,1031.616563,57.312031,206.323313,86.52225,1,0
0,0,6,6,10,10,20,16,16,32,0.000333,0.046101,5,691.508495,38.417139,138.301699,66.438562,1,0
0,0,19,19,15,18,33,63,64,127,0.000333,0.213546,21,13453.39912,747.411062,640.638053,133.662009,2,0
0,0,32,32,21,49,70,142,104,246,0.000333,0.502601,20,30156.07244,1675.337358,1507.803622,367.359448,9,0
0,0,31,31,21,49,70,141,102,243,0.000333,0.496472,20,29788.31546,1654.906415,1489.415773,367.359448,9,0
0,0,19,19,12,18,30,70,60,130,0.000333,0.212632,18,11482.12399,637.895777,637.895777,118.0782,2,0
0,0,22,22,16,21,37,83,68,151,0.000333,0.262209,24,18879.059,1048.836611,786.627458,156.238666,3,0
0,0,12,12,17,18,35,52,37,89,0.000333,0.152169,16,7304.099016,405.783279,456.506189,144.545518,3,0
0,0,12,12,17,18,35,51,37,88,0.000333,0.150459,16,7222.030488,401.223916,451.376905,144.545518,3,0
0,0,11,11,16,15,31,44,38,82,0.000333,0.135415,16,6499.905559,361.105864,406.244097,122.603359,3,0
0,0,11,11,16,17,33,42,37,79,0.000333,0.132836,16,6376.114167,354.228565,398.507135,133.486868,2,0
0,0,15,15,16,18,34,51,43,94,0.000333,0.159407,16,7651.544113,425.085784,478.221507,139.05865,3,0
0,0,15,15,16,18,34,50,43,93,0.000333,0.157711,16,7570.144708,420.563595,473.134044,139.05865,3,0
0,0,16,16,15,21,36,71,54,125,0.000333,0.215414,14,9047.368753,502.631597,646.240625,150.842025,5,0
0,0,10,10,11,14,25,34,31,65,0.000333,0.100617,10,3018.506523,167.694807,301.850652,91.356717,1,0
0,0,17,17,18,20,38,69,55,124,0.000333,0.216914,18,11713.37421,650.743012,650.743012,161.497212,2,0
0,0,11,11,15,18,33,51,39,90,0.000333,0.151332,14,6355.93659,353.107588,453.995471,133.662009,2,0
0,0,20,20,17,19,36,82,59,141,0.000333,0.242986,24,17495.02621,971.9459,728.959425,150.197491,2,0
0,0,11,11,15,15,30,52,34,86,0.000333,0.140664,14,5907.896277,328.21646,421.992591,117.206718,2,0
0,0,17,17,17,18,35,68,49,117,0.000333,0.200042,16,9602.017808,533.445434,600.126113,144.545518,2,0
0,0,10,10,12,13,25,42,32,74,0.000333,0.114548,12,4123.744297,229.096905,343.645358,91.125266,1,0
0,0,10,10,11,13,24,41,32,73,0.000333,0.111567,10,3347.022626,185.945701,334.702263,86.159464,1,0
0,0,15,15,11,18,29,51,48,99,0.000333,0.160313,10,4809.401185,267.188955,480.940119,113.112398,1,0
0,0,17,17,13,21,34,60,54,114,0.000333,0.193324,12,6959.649167,386.647176,579.970764,140.344382,2,0
0,0,14,14,11,14,25,46,48,94,0.000333,0.145507,15,6547.837228,363.768735,436.522482,91.356717,1,0
0,0,6,6,10,13,23,20,18,38,0.000333,0.057298,5,859.476772,47.74871,171.895354,81.324997,1,0
0,0,6,6,10,13,23,20,18,38,0.000333,0.057298,5,859.476772,47.74871,171.895354,81.324997,1,0
0,0,12,12,13,23,36,53,43,96,0.000333,0.165438,6,2977.876801,165.4376,496.3128,152.147641,5,0
0,0,6,6,10,14,24,15,19,34,0.000333,0.051963,5,779.443625,43.302424,155.888725,86.52225,1,0
0,0,25,25,15,26,41,105,74,179,0.000333,0.319667,14,13426.02532,745.890296,959.001809,180.814792,6,0
0,0,16,16,13,17,30,51,52,103,0.000333,0.16847,18,9097.375164,505.409731,505.409731,117.592585,2,0
0,0,8,8,11,14,25,28,26,54,0.000333,0.083589,5,1253.841171,69.657843,250.768234,91.356717,1,0
0,0,8,8,13,20,33,33,28,61,0.000333,0.102569,6,1846.248248,102.569347,307.708041,134.544278,2,0
0,0,10,10,13,22,35,41,34,75,0.000333,0.128232,6,2308.177358,128.232075,384.696226,146.213212,2,0
0,0,11,11,14,20,34,45,37,82,0.000333,0.139057,7,2920.203671,162.233537,417.171953,139.741531,2,0
0,0,12,12,13,22,35,49,42,91,0.000333,0.155588,6,2800.588527,155.588252,466.764755,146.213212,3,0
0,0,10,10,10,17,27,32,33,65,0.000333,0.103023,5,1545.338438,85.852135,309.067688,102.706149,1,0
0,0,15,15,16,19,35,62,50,112,0.000333,0.191493,16,9191.675166,510.64862,574.479698,144.710623,2,0
0,0,14,14,17,16,33,53,51,104,0.000333,0.174872,24,12590.80772,699.489318,524.616988,133.486868,2,0
0,0,14,14,17,16,33,53,51,104,0.000333,0.174872,24,12590.80772,699.489318,524.616988,133.486868,2,0
0,0,10,10,12,13,25,45,35,80,0.000333,0.123836,12,4458.101942,247.67233,371.508495,91.125266,1,0
0,0,4,4,10,10,20,23,17,40,0.000333,0.057626,5,864.385619,48.021423,172.877124,66.438562,1,0
0,0,23,23,18,30,48,110,75,185,0.000333,0.344406,18,18597.92513,1033.218063,1033.218063,222.265368,6,0
0,0,14,14,16,23,39,56,47,103,0.000333,0.181465,16,8710.342857,483.907936,544.396429,168.041925,2,0
0,0,16,16,14,22,36,67,54,121,0.000333,0.20852,14,8757.852952,486.547386,625.560925,151.410465,6,0
0,0,12,12,13,16,29,37,38,75,0.000333,0.12145,12,4372.182896,242.89905,364.348575,112.105716,2,0
0,0,12,12,14,15,29,42,32,74,0.000333,0.11983,14,5032.868311,279.603795,359.490594,111.906328,2,0
0,0,10,10,14,15,29,38,28,66,0.000333,0.106876,7,2244.38722,124.688179,320.626746,111.906328,2,0
0,0,11,11,14,15,29,35,32,67,0.000333,0.108495,14,4556.786173,253.154787,325.484727,111.906328,2,0
0,0,11,11,17,16,33,44,36,80,0.000333,0.134517,16,6456.824473,358.712471,403.55153,133.486868,2,0
0,0,11,11,16,16,32,43,36,79,0.000333,0.131667,16,6320,351.111111,395,128,2,0
0,0,9,9,13,13,26,42,28,70,0.000333,0.109677,12,3948.369363,219.353854,329.03078,96.211433,2,0
0,0,9,9,13,13,26,42,28,70,0.000333,0.109677,12,3948.369363,219.353854,329.03078,96.211433,2,0
0,0,9,9,14,14,28,43,29,72,0.000333,0.115377,14,4845.813761,269.211876,346.129554,106.605938,2,0
0,0,9,9,13,14,27,42,29,71,0.000333,0.112532,12,4051.164152,225.064675,337.597013,101.408685,2,0
0,0,11,11,16,15,31,43,35,78,0.000333,0.128809,16,6182.836995,343.490944,386.427312,122.603359,2,0
0,0,11,11,16,15,31,43,35,78,0.000333,0.128809,16,6182.836995,343.490944,386.427312,122.603359,2,0
0,0,17,17,17,20,37,71,64,135,0.000333,0.234425,24,16878.62891,937.701606,703.276204,155.92543,1,0
0,0,8,8,9,10,19,24,21,45,0.000333,0.063719,8,1529.253905,84.95855,191.156738,61.748606,1,0
0,0,14,14,14,18,32,60,44,104,0.000333,0.173333,14,7280,404.444444,520,128.361619,4,0
0,0,6,6,11,16,27,29,24,53,0.000333,0.084003,5,1260.045188,70.00251,252.009038,102.053748,1,0
0,0,6,6,11,17,28,29,25,54,0.000333,0.086532,5,1297.985829,72.110324,259.597166,107.540616,1,0
0,0,7,7,14,23,37,44,33,77,0.000333,0.133709,7,2807.895364,155.994187,401.127909,157.344894,2,0
0,0,10,10,18,30,48,67,50,117,0.000333,0.217814,9,5880.965513,326.720306,653.440613,222.265368,3,0
0,0,9,9,18,28,46,64,47,111,0.000333,0.204372,9,5518.038394,306.557689,613.115377,209.664588,3,0
0,0,8,8,9,12,21,39,30,69,0.000333,0.101023,8,2424.559217,134.697734,303.069902,71.548875,1,0
0,0,14,14,14,19,33,75,53,128,0.000333,0.215227,14,9039.554262,502.197459,645.682447,134.013592,4,0
0,0,6,6,11,16,27,29,24,53,0.000333,0.084003,5,1260.045188,70.00251,252.009038,102.053748,1,0
0,0,6,6,11,17,28,29,25,54,0.000333,0.086532,5,1297.985829,72.110324,259.597166,107.540616,1,0
0,0,7,7,14,23,37,44,33,77,0.000333,0.133709,7,2807.895364,155.994187,401.127909,157.344894,2,0
0,0,10,10,18,30,48,67,50,117,0.000333,0.217814,9,5880.965513,326.720306,653.440613,222.265368,3,0
0,0,9,9,18,28,46,64,47,111,0.000333,0.204372,9,5518.038394,306.557689,613.115377,209.664588,3,0
0,0,8,8,11,12,23,28,25,53,0.000333,0.079916,10,2397.487837,133.193769,239.748784,81.073298,1,0
0,0,9,9,12,19,31,36,32,68,0.000333,0.112295,6,2021.312095,112.295116,336.885349,123.730173,3,0
0,0,6,6,10,14,24,16,19,35,0.000333,0.053491,5,802.368438,44.576024,160.473688,86.52225,1,0
0,0,16,16,16,18,34,72,49,121,0.000333,0.205194,16,9849.328061,547.184892,615.583004,139.05865,2,0
0,0,18,18,16,22,38,85,63,148,0.000333,0.258898,16,12427.09235,690.39402,776.693272,162.107496,5,0
0,0,12,12,12,18,30,47,40,87,0.000333,0.1423,12,5122.793782,284.599655,426.899482,118.0782,1,0
0,0,3,3,6,6,12,7,7,14,0.000333,0.01673,3,150.568425,8.364913,50.189475,31.01955,1,0
0,0,3,3,7,7,14,8,8,16,0.000333,0.020306,3,182.753036,10.152946,60.917679,39.302969,1,0
0,0,9,9,11,12,23,30,26,56,0.000333,0.08444,10,2533.194695,140.733039,253.31947,81.073298,1,0
0,0,6,6,10,11,21,19,17,36,0.000333,0.052708,5,790.617136,43.923174,158.123427,71.273029,1,0
0,0,3,3,7,7,14,8,8,16,0.000333,0.020306,3,182.753036,10.152946,60.917679,39.302969,1,0
0,0,12,12,16,18,34,55,41,96,0.000333,0.162799,16,7814.342924,434.130162,488.396433,139.05865,3,0
0,0,12,12,16,18,34,61,43,104,0.000333,0.176365,16,8465.538168,470.307676,529.096135,139.05865,5,0
0,0,11,11,14,15,29,36,34,70,0.000333,0.113353,14,4760.821375,264.490076,340.05867,111.906328,2,0
0,0,11,11,14,15,29,36,34,70,0.000333,0.113353,14,4760.821375,264.490076,340.05867,111.906328,2,0
0,0,10,10,12,13,25,31,29,60,0.000333,0.092877,12,3343.576457,185.754248,278.631371,91.125266,2,0
0,0,10,10,12,13,25,31,29,60,0.000333,0.092877,12,3343.576457,185.754248,278.631371,91.125266,2,0
0,0,8,8,12,16,28,32,27,59,0.000333,0.094545,6,1701.803642,94.544647,283.63394,107.01955,3,0
0,0,6,6,10,11,21,15,17,32,0.000333,0.046851,5,702.770788,39.042822,140.554158,71.273029,1,0
0,0,6,6,9,15,24,23,22,45,0.000333,0.068774,4,825.29325,45.849625,206.323313,87.132684,1,0
0,0,6,6,10,16,26,24,23,47,0.000333,0.07364,5,1104.603334,61.366852,220.920667,97.219281,1,0
0,0,7,7,13,22,35,39,31,70,0.000333,0.119683,6,2154.298867,119.68327,359.049811,146.213212,2,0
0,0,10,10,18,30,48,62,48,110,0.000333,0.204782,9,5529.112876,307.172938,614.345875,222.265368,3,0
0,0,11,11,14,17,31,51,37,88,0.000333,0.145323,14,6103.569854,339.087214,435.969275,122.789837,6,0
0,0,7,7,10,12,22,20,18,38,0.000333,0.056486,5,847.292008,47.071778,169.458402,76.238831,3,0
0,0,6,6,11,10,21,22,16,38,0.000333,0.055636,5,834.54031,46.363351,166.908062,71.273029,1,0
0,0,6,6,11,10,21,22,16,38,0.000333,0.055636,5,834.54031,46.363351,166.908062,71.273029,1,0
0,0,7,7,11,10,21,28,18,46,0.000333,0.067349,5,1010.233007,56.124056,202.046601,71.273029,1,0
0,0,8,8,12,10,22,26,22,48,0.000333,0.071351,12,2568.632612,142.701812,214.052718,76.238831,2,0
0,0,14,14,12,16,28,49,46,95,0.000333,0.152233,12,5480.384611,304.465812,456.698718,107.01955,2,0
0,0,16,16,15,18,33,57,51,108,0.000333,0.181598,14,7627.123908,423.729106,544.794565,133.662009,3,0
0,0,14,14,12,16,28,49,46,95,0.000333,0.152233,12,5480.384611,304.465812,456.698718,107.01955,2,0
0,0,16,16,15,18,33,57,51,108,0.000333,0.181598,14,7627.123908,423.729106,544.794565,133.662009,3,0
0,0,6,6,10,11,21,21,17,38,0.000333,0.055636,5,834.54031,46.363351,166.908062,71.273029,1,0
0,0,6,6,10,11,21,21,17,38,0.000333,0.055636,5,834.54031,46.363351,166.908062,71.273029,1,0
0,0,23,23,18,21,39,99,75,174,0.000333,0.306553,27,24830.81962,1379.489979,919.659986,167.297316,2,0
0,0,25,25,16,31,47,112,81,193,0.000333,0.357345,16,17152.57037,952.920576,1072.035648,217.580086,6,0
0,0,16,16,13,23,36,58,59,117,0.000333,0.201627,12,7258.574702,403.25415,604.881225,152.147641,2,0
0,0,12,12,14,16,30,55,39,94,0.000333,0.153749,14,6457.468024,358.748224,461.247716,117.302969,5,0
0,0,10,10,14,15,29,48,35,83,0.000333,0.134404,14,5644.973916,313.609662,403.212423,111.906328,5,0
0,0,6,6,10,10,20,17,16,33,0.000333,0.047541,5,713.118136,39.617674,142.623627,66.438562,2,0
0,0,6,6,11,9,20,18,14,32,0.000333,0.046101,5,691.508495,38.417139,138.301699,66.583073,1,0
0,0,5,5,10,10,20,22,16,38,0.000333,0.054744,5,821.166338,45.620352,164.233268,66.438562,1,0
0,0,16,16,12,16,28,65,51,116,0.000333,0.185884,18,10037.75708,557.653171,557.653171,107.01955,1,0
0,0,19,19,16,18,34,78,59,137,0.000333,0.232327,24,16727.57782,929.309879,696.982409,139.05865,2,0
0,0,10,10,13,16,29,46,33,79,0.000333,0.127927,12,4605.365983,255.853666,383.780499,112.105716,2,0
0,0,18,18,12,18,30,66,57,123,0.000333,0.201183,18,10863.85578,603.547543,603.547543,118.0782,1,0
0,0,21,21,16,20,36,79,65,144,0.000333,0.248156,24,17867.26081,992.6256,744.4692,150.438562,2,0
0,0,10,10,13,17,30,44,33,77,0.000333,0.125944,6,2266.983455,125.943525,377.830576,117.592585,2,0
0,0,8,8,14,12,26,28,19,47,0.000333,0.07364,7,1546.444667,85.913593,220.920667,96.322519,2,0
0,0,17,17,15,16,31,70,52,122,0.000333,0.201471,21,12692.65095,705.147275,604.41195,122.603359,2,0
0,0,20,20,19,18,37,83,60,143,0.000333,0.248317,27,20113.69945,1117.427747,744.951831,155.769273,3,0
0,0,10,10,14,14,28,42,30,72,0.000333,0.115377,14,4845.813761,269.211876,346.129554,106.605938,2,0
0,0,11,11,15,22,37,47,33,80,0.000333,0.138919,7,2917.293885,162.071882,416.756269,156.710855,5,0
0,0,12,12,15,22,37,48,35,83,0.000333,0.144128,7,3026.692405,168.149578,432.384629,156.710855,5,0
0,0,11,11,15,22,37,47,33,80,0.000333,0.138919,7,2917.293885,162.071882,416.756269,156.710855,5,0
0,0,12,12,15,22,37,48,35,83,0.000333,0.144128,7,3026.692405,168.149578,432.384629,156.710855,5,0
0,0,11,11,16,21,37,47,33,80,0.000333,0.138919,8,3334.050154,185.225009,416.756269,156.238666,4,0
0,0,12,12,16,21,37,48,35,83,0.000333,0.144128,8,3459.077035,192.170946,432.384629,156.238666,4,0
0,0,8,8,11,14,25,27,26,53,0.000333,0.082041,5,1230.62189,68.367883,246.124378,91.356717,1,0
0,0,10,10,15,13,28,36,27,63,0.000333,0.100954,14,4240.087041,235.560391,302.86336,106.709075,2,0
0,0,12,12,14,16,30,55,43,98,0.000333,0.160292,14,6732.253897,374.014105,480.875278,117.302969,3,0
0,0,18,18,18,19,37,69,50,119,0.000333,0.206642,18,11158.64911,619.924951,619.924951,155.769273,2,0
0,0,11,11,16,14,30,48,32,80,0.000333,0.13085,16,6280.819962,348.934442,392.551248,117.302969,2,0
0,0,19,19,17,18,35,74,60,134,0.000333,0.229108,24,16495.77418,916.431899,687.323924,144.545518,3,0
0,0,12,12,14,16,30,53,41,94,0.000333,0.153749,14,6457.468024,358.748224,461.247716,117.302969,3,0
0,0,15,15,15,17,32,58,47,105,0.000333,0.175,14,7350,408.333333,525,128.090227,3,0
0,0,12,12,14,16,30,53,41,94,0.000333,0.153749,14,6457.468024,358.748224,461.247716,117.302969,3,0
0,0,10,10,15,17,32,45,43,88,0.000333,0.146667,14,6160,342.222222,440,128.090227,1,0
0,0,16,16,16,18,34,69,49,118,0.000333,0.200107,16,9605.129844,533.618325,600.320615,139.05865,2,0
0,0,10,10,14,14,28,42,31,73,0.000333,0.116979,14,4913.11673,272.950929,350.936909,106.605938,2,0
0,0,16,16,19,17,36,57,48,105,0.000333,0.180947,18,9771.158253,542.842125,542.842125,150.197491,3,0
0,0,15,15,14,16,30,62,42,104,0.000333,0.170106,14,7144.432707,396.912928,510.316622,117.302969,2,0
0,0,18,18,17,18,35,75,50,125,0.000333,0.21372,16,10258.56603,569.920335,641.160377,144.545518,3,0
0,0,10,10,15,15,30,47,32,79,0.000333,0.129215,14,5427.020999,301.501167,387.644357,117.206718,2,0
0,0,15,15,14,15,29,62,42,104,0.000333,0.16841,14,7073.220329,392.956685,505.230023,111.906328,2,0
0,0,18,18,17,17,34,75,50,125,0.000333,0.211978,16,10174.92568,565.273649,635.932855,138.973737,3,0
0,0,10,10,15,15,30,47,32,79,0.000333,0.129215,14,5427.020999,301.501167,387.644357,117.206718,2,0
0,0,17,17,13,27,40,64,59,123,0.000333,0.218199,12,7855.165868,436.398104,654.597156,176.487679,2,0
0,0,16,16,13,23,36,58,59,117,0.000333,0.201627,12,7258.574702,403.25415,604.881225,152.147641,2,0
0,0,11,11,14,20,34,44,37,81,0.000333,0.137361,7,2884.591431,160.255079,412.08449,139.741531,2,0
0,0,7,7,10,14,24,22,23,45,0.000333,0.068774,5,1031.616563,57.312031,206.323313,86.52225,1,0
0,0,6,6,10,10,20,16,16,32,0.000333,0.046101,5,691.508495,38.417139,138.301699,66.438562,1,0
0,0,13,13,14,26,40,61,48,109,0.000333,0.193363,7,4060.631136,225.590619,580.090162,175.514402,2,0
0,0,12,12,14,22,36,55,42,97,0.000333,0.167161,7,3510.379076,195.02106,501.482725,151.410465,2,0
0,0,18,18,16,28,44,85,66,151,0.000333,0.274791,16,13189.98679,732.777044,824.374174,198.605938,6,0
0,0,14,14,16,24,40,55,48,103,0.000333,0.18272,16,8770.5375,487.252083,548.158594,174.0391,2,0
0,0,7,7,10,14,24,22,23,45,0.000333,0.068774,5,1031.616563,57.312031,206.323313,86.52225,1,0
0,0,6,6,10,10,20,16,16,32,0.000333,0.046101,5,691.508495,38.417139,138.301699,66.438562,1,0
0,0,8,8,12,11,23,30,24,54,0.000333,0.081424,12,2931.268148,162.84823,244.272346,81.073298,1,0
0,0,20,20,17,39,56,91,67,158,0.000333,0.305854,8,7340.496621,407.805368,917.562078,275.617555,7,0
0,0,19,19,17,39,56,90,65,155,0.000333,0.300047,8,7201.120103,400.062228,900.140013,275.617555,7,0
0,0,20,20,18,40,58,92,69,161,0.000333,0.314378,9,8488.214462,471.56747,943.13494,287.935774,7,0
0,0,19,19,18,40,58,91,67,158,0.000333,0.30852,9,8330.048975,462.780499,925.560997,287.935774,7,0
0,0,25,25,23,45,68,117,83,200,0.000333,0.405831,11,13392.41825,744.023236,1217.492568,351.175314,9,0
0,0,24,24,23,45,68,116,81,197,0.000333,0.399743,11,13191.53198,732.862888,1199.23018,351.175314,9,0
0,0,26,26,23,46,69,120,85,205,0.000333,0.417416,11,13774.72265,765.262369,1252.247514,358.125775,9,0
0,0,25,25,23,46,69,119,83,202,0.000333,0.411307,11,13573.14134,754.063408,1233.92194,358.125775,9,0
0,0,27,27,23,46,69,121,89,210,0.000333,0.427597,11,14110.6915,783.927305,1282.790136,358.125775,9,0
0,0,26,26,23,46,69,120,87,207,0.000333,0.421488,11,13909.11019,772.728344,1264.464563,358.125775,9,0
0,0,11,11,17,16,33,44,36,80,0.000333,0.134517,16,6456.824473,358.712471,403.55153,133.486868,2,0
0,0,11,11,16,16,32,43,36,79,0.000333,0.131667,16,6320,351.111111,395,128,2,0
0,0,14,14,17,18,35,57,44,101,0.000333,0.172686,16,8288.921355,460.495631,518.057585,144.545518,2,0
0,0,11,11,16,17,33,48,37,85,0.000333,0.142925,16,6860.376002,381.132,428.7735,133.486868,2,0
0,0,14,14,18,17,35,57,42,99,0.000333,0.169266,18,9140.382336,507.799019,507.799019,144.545518,3,0
0,0,11,11,15,14,29,45,31,76,0.000333,0.123069,14,5168.891779,287.160654,369.206556,111.906328,2,0
0,0,17,17,17,22,39,65,53,118,0.000333,0.207892,16,9978.839389,554.379966,623.677462,167.594364,2,0
0,0,11,11,16,17,33,48,37,85,0.000333,0.142925,16,6860.376002,381.132,428.7735,133.486868,2,0
0,0,16,16,17,19,36,63,52,115,0.000333,0.19818,16,9512.662003,528.481222,594.541375,150.197491,2,0
0,0,11,11,15,17,32,50,39,89,0.000333,0.148333,14,6230,346.111111,445,128.090227,2,0
0,0,10,10,14,13,27,33,27,60,0.000333,0.095098,14,3994.105502,221.89475,285.29325,101.408685,3,0
0,0,11,11,15,19,34,40,35,75,0.000333,0.127187,7,2670.917992,148.384333,381.559713,139.313982,2,0
0,0,18,18,17,17,34,65,51,116,0.000333,0.196715,24,14163.49655,786.860919,590.14569,138.973737,3,0
0,0,10,10,15,14,29,38,27,65,0.000333,0.105256,7,2210.381353,122.798964,315.768765,111.906328,2,0
0,0,18,18,17,17,34,65,51,116,0.000333,0.196715,24,14163.49655,786.860919,590.14569,138.973737,3,0
0,0,10,10,15,14,29,38,27,65,0.000333,0.105256,7,2210.381353,122.798964,315.768765,111.906328,2,0
0,0,16,16,17,16,33,60,42,102,0.000333,0.171509,16,8232.451203,457.3584,514.5282,133.486868,2,0
0,0,10,10,15,14,29,38,27,65,0.000333,0.105256,7,2210.381353,122.798964,315.768765,111.906328,2,0
0,0,13,13,15,16,31,55,39,94,0.000333,0.155231,14,6519.722344,362.206797,465.694453,122.603359,6,0
0,0,9,9,11,12,23,24,20,44,0.000333,0.066346,5,995.18363,55.287979,199.036726,81.073298,3,0
0,0,9,9,13,15,28,34,34,68,0.000333,0.108967,12,3922.801616,217.933423,326.900135,106.709075,1,0
0,0,11,11,14,16,30,51,36,87,0.000333,0.1423,14,5976.592745,332.03293,426.899482,117.302969,6,0
0,0,7,7,10,11,21,20,17,37,0.000333,0.054172,5,812.578723,45.143262,162.515745,71.273029,3,0
0,0,11,11,14,16,30,51,36,87,0.000333,0.1423,14,5976.592745,332.03293,426.899482,117.302969,6,0
0,0,7,7,10,11,21,20,17,37,0.000333,0.054172,5,812.578723,45.143262,162.515745,71.273029,3,0
0,0,5,5,12,13,25,24,21,45,0.000333,0.069658,6,1253.841171,69.657843,208.973529,91.125266,2,0
0,0,17,17,20,20,40,68,54,122,0.000333,0.216425,20,12985.50455,721.41692,649.275228,172.877124,3,0
0,0,5,5,12,14,26,24,22,46,0.000333,0.072073,6,1297.321362,72.073409,216.220227,96.322519,2,0
0,0,17,17,17,18,35,59,52,111,0.000333,0.189783,16,9109.606638,506.089258,569.350415,144.545518,2,0
0,0,11,11,15,16,31,38,35,73,0.000333,0.120552,14,5063.188629,281.288257,361.656331,122.603359,2,0
0,0,18,18,16,18,34,59,57,116,0.000333,0.196715,24,14163.49655,786.860919,590.14569,139.05865,2,0
0,0,15,15,19,22,41,63,51,114,0.000333,0.203587,18,10993.69671,610.760929,610.760929,178.818118,3,0
0,0,13,13,17,17,34,54,41,95,0.000333,0.161103,16,7732.943519,429.607973,483.30897,138.973737,2,0
0,0,13,13,20,19,39,57,42,99,0.000333,0.174418,20,10465.09639,581.394244,523.25482,167.149185,3,0
0,0,16,16,17,17,34,59,51,110,0.000333,0.18654,24,13430.9019,746.161217,559.620913,138.973737,3,0
0,0,16,16,17,17,34,59,51,110,0.000333,0.18654,24,13430.9019,746.161217,559.620913,138.973737,3,0
0,0,8,8,11,12,23,28,25,53,0.000333,0.079916,10,2397.487837,133.193769,239.748784,81.073298,1,0
0,0,16,16,19,18,37,55,47,102,0.000333,0.177121,18,9564.556379,531.364243,531.364243,155.769273,3,0
0,0,19,19,15,24,39,87,60,147,0.000333,0.258985,14,10877.35777,604.297654,776.954126,168.642459,5,0
0,0,10,10,10,15,25,33,32,65,0.000333,0.100617,10,3018.506523,167.694807,301.850652,91.82264,1,0
0,0,17,17,17,18,35,53,44,97,0.000333,0.165847,16,7960.647242,442.25818,497.540453,144.545518,3,0
0,0,17,17,17,18,35,53,44,97,0.000333,0.165847,16,7960.647242,442.25818,497.540453,144.545518,3,0
0,0,14,14,17,18,35,59,51,110,0.000333,0.188074,16,9027.53811,501.529895,564.221132,144.545518,2,0
0,0,20,20,20,18,38,74,51,125,0.000333,0.218664,20,13119.81878,728.878821,655.990939,161.497212,4,0
0,0,11,11,15,14,29,45,31,76,0.000333,0.123069,14,5168.891779,287.160654,369.206556,111.906328,2,0
0,0,20,20,20,18,38,74,51,125,0.000333,0.218664,20,13119.81878,728.878821,655.990939,161.497212,4,0
0,0,11,11,15,14,29,45,31,76,0.000333,0.123069,14,5168.891779,287.160654,369.206556,111.906328,2,0
0,0,29,29,20,47,67,129,100,229,0.000333,0.463045,20,27782.68849,1543.482694,1389.134425,347.504238,7,0
0,0,28,28,20,47,67,128,98,226,0.000333,0.456979,20,27418.72314,1523.262397,1370.936157,347.504238,7,0
0,0,10,10,13,14,27,33,26,59,0.000333,0.093513,6,1683.230176,93.512788,280.538363,101.408685,2,0
0,0,9,9,13,14,27,30,22,52,0.000333,0.082418,6,1483.524901,82.41805,247.25415,101.408685,2,0
0,0,10,10,13,16,29,34,27,61,0.000333,0.098779,6,1778.021044,98.778947,296.336841,112.105716,2,0
0,0,10,10,13,14,27,33,28,61,0.000333,0.096683,12,3480.577652,193.365425,290.048138,101.408685,2,0
0,0,11,11,14,14,28,38,30,68,0.000333,0.108967,14,4576.601886,254.25566,326.900135,106.605938,2,0
0,0,6,6,10,13,23,20,18,38,0.000333,0.057298,5,859.476772,47.74871,171.895354,81.324997,1,0
0,0,6,6,10,13,23,20,18,38,0.000333,0.057298,5,859.476772,47.74871,171.895354,81.324997,1,0
0,0,12,12,18,17,35,49,41,90,0.000333,0.153878,18,8309.438487,461.635472,461.635472,144.545518,2,0
0,0,11,11,16,15,31,43,35,78,0.000333,0.128809,16,6182.836995,343.490944,386.427312,122.603359,2,0
0,0,11,11,16,15,31,43,35,78,0.000333,0.128809,16,6182.836995,343.490944,386.427312,122.603359,2,0
0,0,13,13,16,18,34,48,44,92,0.000333,0.156016,16,7488.745302,416.041406,468.046581,139.05865,1,0
0,0,16,16,15,21,36,76,55,131,0.000333,0.225753,14,9481.642453,526.757914,677.260175,150.842025,5,0
0,0,11,11,13,19,32,46,35,81,0.000333,0.135,6,2430,135,405,128.816339,3,0
0,0,10,10,10,14,24,38,32,70,0.000333,0.106982,10,3209.473751,178.304097,320.947375,86.52225,1,0
0,0,8,8,10,13,23,25,22,47,0.000333,0.070869,5,1063.03706,59.057614,212.607412,81.324997,1,0
0,0,11,11,10,15,25,42,35,77,0.000333,0.119192,10,3575.769266,198.653848,357.576927,91.82264,1,0
0,0,16,16,13,18,31,54,49,103,0.000333,0.170094,12,6123.38664,340.188147,510.28222,123.164366,2,0
0,0,18,18,16,20,36,62,54,116,0.000333,0.199904,16,9595.380803,533.076711,599.7113,150.438562,3,0
0,0,16,16,13,17,30,54,49,103,0.000333,0.16847,12,6064.916776,336.939821,505.409731,117.592585,2,0
0,0,18,18,16,19,35,62,54,116,0.000333,0.198332,16,9519.949279,528.886071,594.99683,144.710623,3,0
0,0,14,14,12,16,28,49,46,95,0.000333,0.152233,12,5480.384611,304.465812,456.698718,107.01955,2,0
0,0,16,16,15,18,33,57,51,108,0.000333,0.181598,14,7627.123908,423.729106,544.794565,133.662009,3,0
0,0,14,14,12,16,28,49,46,95,0.000333,0.152233,12,5480.384611,304.465812,456.698718,107.01955,2,0
0,0,16,16,15,18,33,57,51,108,0.000333,0.181598,14,7627.123908,423.729106,544.794565,133.662009,3,0
0,0,13,13,15,17,32,61,44,105,0.000333,0.175,14,7350,408.333333,525,128.090227,2,0
0,0,7,7,13,13,26,29,27,56,0.000333,0.087742,12,3158.695491,175.483083,263.224624,96.211433,1,0
0,0,7,7,14,13,27,31,27,58,0.000333,0.091928,14,3860.968652,214.498258,275.783475,101.408685,1,0
0,0,8,8,13,20,33,33,28,61,0.000333,0.102569,6,1846.248248,102.569347,307.708041,134.544278,2,0
0,0,8,8,13,20,33,33,28,61,0.000333,0.102569,6,1846.248248,102.569347,307.708041,134.544278,2,0
0,0,8,8,13,20,33,33,28,61,0.000333,0.102569,6,1846.248248,102.569347,307.708041,134.544278,2,0
0,0,8,8,13,20,33,33,28,61,0.000333,0.102569,6,1846.248248,102.569347,307.708041,134.544278,2,0
0,0,21,21,17,25,42,101,68,169,0.000333,0.303767,16,14580.82631,810.045906,911.301644,185.583273,5,0
0,0,12,12,12,18,30,47,40,87,0.000333,0.1423,12,5122.793782,284.599655,426.899482,118.0782,1,0
0,0,11,11,14,17,31,51,37,88,0.000333,0.145323,14,6103.569854,339.087214,435.969275,122.789837,6,0
0,0,7,7,10,12,22,20,18,38,0.000333,0.056486,5,847.292008,47.071778,169.458402,76.238831,3,0
0,0,8,8,14,18,32,35,26,61,0.000333,0.101667,7,2135,118.611111,305,128.361619,2,0
0,0,8,8,14,18,32,35,26,61,0.000333,0.101667,7,2135,118.611111,305,128.361619,2,0
0,0,6,6,10,13,23,20,18,38,0.000333,0.057298,5,859.476772,47.74871,171.895354,81.324997,1,0
0,0,7,7,10,16,26,22,25,47,0.000333,0.07364,5,1104.603334,61.366852,220.920667,97.219281,2,0
0,0,6,6,10,13,23,16,18,34,0.000333,0.051267,5,769.005533,42.72253,153.801107,81.324997,2,0
0,0,11,11,11,18,29,44,38,82,0.000333,0.132785,10,3983.544416,221.308023,398.354442,113.112398,1,0
0,0,11,11,12,20,32,40,35,75,0.000333,0.125,6,2250,125,375,129.458112,2,0
0,0,10,10,10,14,24,38,32,70,0.000333,0.106982,10,3209.473751,178.304097,320.947375,86.52225,1,0
0,0,8,8,10,13,23,25,22,47,0.000333,0.070869,5,1063.03706,59.057614,212.607412,81.324997,1,0
0,0,11,11,10,15,25,42,35,77,0.000333,0.119192,10,3575.769266,198.653848,357.576927,91.82264,1,0
0,0,8,8,12,12,24,39,27,66,0.000333,0.100869,12,3631.290301,201.73835,302.607525,86.0391,1,0
0,0,11,11,15,16,31,51,32,83,0.000333,0.137066,14,5756.776113,319.820895,411.198294,122.603359,2,0
0,0,23,23,16,19,35,96,66,162,0.000333,0.276981,24,19942.65237,1107.925132,830.943849,144.710623,3,0
0,0,10,10,14,14,28,42,31,73,0.000333,0.116979,14,4913.11673,272.950929,350.936909,106.605938,2,0
0,0,16,16,15,15,30,65,48,113,0.000333,0.184826,21,11644.05138,646.891744,554.478637,117.206718,2,0
0,0,10,10,14,14,28,42,31,73,0.000333,0.116979,14,4913.11673,272.950929,350.936909,106.605938,2,0
0,0,6,6,10,11,21,25,19,44,0.000333,0.064421,5,966.309833,53.68388,193.261967,71.273029,1,0
0,0,7,7,10,11,21,20,17,37,0.000333,0.054172,5,812.578723,45.143262,162.515745,71.273029,3,0
0,0,7,7,10,11,21,20,17,37,0.000333,0.054172,5,812.578723,45.143262,162.515745,71.273029,3,0
0,0,8,8,15,16,31,31,23,54,0.000333,0.089176,7,1872.686205,104.038123,267.526601,122.603359,2,0
0,0,8,8,15,16,31,31,23,54,0.000333,0.089176,7,1872.686205,104.038123,267.526601,122.603359,2,0
0,0,8,8,15,16,31,31,23,54,0.000333,0.089176,7,1872.686205,104.038123,267.526601,122.603359,2,0
0,0,6,6,9,14,23,24,21,45,0.000333,0.067853,4,814.241152,45.23562,203.560288,81.832294,1,0
0,0,8,8,13,14,27,38,26,64,0.000333,0.101438,6,1825.876801,101.4376,304.3128,101.408685,2,0
0,0,6,6,10,15,25,25,22,47,0.000333,0.072754,5,1091.306205,60.628122,218.261241,91.82264,1,0
0,0,7,7,13,21,34,40,30,70,0.000333,0.118707,6,2136.734393,118.707466,356.122399,140.344382,2,0
0,0,10,10,18,28,46,63,47,110,0.000333,0.202531,9,5468.326336,303.795908,607.591815,209.664588,3,0
0,0,9,9,18,26,44,60,44,104,0.000333,0.18926,9,5110.027995,283.890444,567.780888,197.270083,3,0
0,0,14,14,16,20,36,74,51,125,0.000333,0.215414,16,10339.85,574.436111,646.240625,150.438562,5,0
0,0,12,12,13,21,34,54,41,95,0.000333,0.161103,6,2899.85382,161.10299,483.30897,140.344382,5,0
0,0,6,6,10,11,21,16,16,32,0.000333,0.046851,5,702.770788,39.042822,140.554158,71.273029,1,0
0,0,12,12,13,21,34,53,41,94,0.000333,0.159407,6,2869.329042,159.407169,478.221507,140.344382,5,0
0,0,6,6,10,11,21,15,17,32,0.000333,0.046851,5,702.770788,39.042822,140.554158,71.273029,1,0
0,0,11,11,11,14,25,38,30,68,0.000333,0.105261,10,3157.822209,175.434567,315.782221,91.356717,2,0
0,0,14,14,15,17,32,51,38,89,0.000333,0.148333,14,6230,346.111111,445,128.090227,3,0
0,0,10,10,14,15,29,40,29,69,0.000333,0.111734,7,2346.404821,130.355823,335.200689,111.906328,2,0
0,0,13,13,12,17,29,49,42,91,0.000333,0.147359,12,5304.915247,294.717514,442.076271,112.506418,2,0
0,0,16,16,16,20,36,62,50,112,0.000333,0.193011,16,9264.505603,514.694756,579.0316,150.438562,3,0
0,0,5,5,12,13,25,23,21,44,0.000333,0.06811,6,1225.978034,68.109891,204.329672,91.125266,2,0
0,0,11,11,17,18,35,48,37,85,0.000333,0.14533,16,6975.824903,387.545828,435.989056,144.545518,3,0
0,0,5,5,12,14,26,23,22,45,0.000333,0.070507,6,1269.118724,70.506596,211.519787,96.322519,2,0
0,0,10,10,16,17,33,38,31,69,0.000333,0.116021,8,2784.505554,154.694753,348.063194,133.486868,2,0
0,0,5,5,11,12,23,20,19,39,0.000333,0.058806,5,882.094581,49.005255,176.418916,81.073298,2,0
0,0,15,15,20,19,39,58,45,103,0.000333,0.181465,20,10887.92857,604.884921,544.396429,167.149185,4,0
0,0,5,5,12,13,25,21,20,41,0.000333,0.063466,6,1142.388623,63.466035,190.398104,91.125266,2,0
0,0,8,8,13,19,32,34,27,61,0.000333,0.101667,6,1830,101.666667,305,128.816339,2,0
0,0,8,8,13,19,32,34,27,61,0.000333,0.101667,6,1830,101.666667,305,128.816339,2,0
0,0,6,6,10,11,21,21,17,38,0.000333,0.055636,5,834.54031,46.363351,166.908062,71.273029,1,0
0,0,7,7,10,11,21,26,19,45,0.000333,0.065885,5,988.27142,54.903968,197.654284,71.273029,1,0
0,0,19,19,14,18,32,70,62,132,0.000333,0.22,21,13860,770,660,128.361619,2,0
0,0,22,22,16,20,36,82,71,153,0.000333,0.263666,24,18983.96461,1054.6647,790.998525,150.438562,3,0
0,0,5,5,12,13,25,23,21,44,0.000333,0.06811,6,1225.978034,68.109891,204.329672,91.125266,2,0
0,0,18,18,20,21,41,77,58,135,0.000333,0.24109,20,14465.39041,803.632801,723.269521,178.677228,3,0
0,0,5,5,12,14,26,23,22,45,0.000333,0.070507,6,1269.118724,70.506596,211.519787,96.322519,2,0
0,0,16,16,18,20,38,61,52,113,0.000333,0.197672,18,10674.28456,593.015809,593.015809,161.497212,2,0
0,0,12,12,15,14,29,46,35,81,0.000333,0.131165,14,5508.950448,306.052803,393.496461,111.906328,1,0
0,0,16,16,17,16,33,65,43,108,0.000333,0.181598,16,8716.713038,484.261835,544.794565,133.486868,3,0
0,0,11,11,16,14,30,48,32,80,0.000333,0.13085,16,6280.819962,348.934442,392.551248,117.302969,2,0
0,0,16,16,17,16,33,64,43,107,0.000333,0.179917,16,8636.002732,479.77793,539.750171,133.486868,3,0
0,0,11,11,16,14,30,48,32,80,0.000333,0.13085,16,6280.819962,348.934442,392.551248,117.302969,2,0
0,0,15,15,18,19,37,60,45,105,0.000333,0.182331,18,9845.866861,546.992603,546.992603,155.769273,3,0
0,0,15,15,18,19,37,60,45,105,0.000333,0.182331,18,9845.866861,546.992603,546.992603,155.769273,3,0
0,0,17,17,19,20,39,68,56,124,0.000333,0.218463,18,11797.01775,655.389875,655.389875,167.149185,3,0
0,0,24,24,20,21,41,98,74,172,0.000333,0.307166,30,27644.96834,1535.831575,921.498945,178.677228,3,0
0,0,11,11,16,17,33,50,35,85,0.000333,0.142925,16,6860.376002,381.132,428.7735,133.486868,2,0
0,0,6,6,10,10,20,17,16,33,0.000333,0.047541,5,713.118136,39.617674,142.623627,66.438562,2,0
0,0,10,10,15,17,32,37,31,68,0.000333,0.113333,7,2380,132.222222,340,128.090227,2,0
0,0,10,10,13,17,30,32,29,61,0.000333,0.099773,6,1795.921958,99.773442,299.320326,117.592585,2,0
0,0,18,18,16,22,38,76,56,132,0.000333,0.230909,16,11083.62291,615.756828,692.726432,162.107496,2,0
0,0,17,17,16,22,38,74,54,128,0.000333,0.223912,16,10747.75555,597.09753,671.734722,162.107496,2,0
0,0,18,18,17,22,39,77,59,136,0.000333,0.239605,16,11501.03523,638.946402,718.814702,167.594364,2,0
0,0,17,17,17,22,39,75,57,132,0.000333,0.232558,16,11162.76949,620.15386,697.673093,167.594364,2,0
0,0,19,19,13,19,32,83,65,148,0.000333,0.246667,18,13320,740,740,128.816339,1,0
0,0,22,22,17,22,39,96,73,169,0.000333,0.297744,24,21437.5914,1190.9773,893.232975,167.594364,2,0
0,0,8,8,14,18,32,29,25,54,0.000333,0.09,7,1890,105,270,128.361619,2,0
0,0,10,10,14,21,35,36,32,68,0.000333,0.116264,7,2441.538716,135.64104,348.791245,145.541635,2,0
0,0,15,15,15,18,33,48,45,93,0.000333,0.156376,14,6567.801143,364.877841,469.128653,133.662009,2,0
0,0,9,9,13,14,27,27,24,51,0.000333,0.080833,6,1454.995576,80.833088,242.499263,101.408685,2,0
0,0,8,8,13,20,33,33,28,61,0.000333,0.102569,6,1846.248248,102.569347,307.708041,134.544278,2,0
0,0,8,8,13,20,33,33,28,61,0.000333,0.102569,6,1846.248248,102.569347,307.708041,134.544278,2,0
0,0,8,8,13,20,33,33,28,61,0.000333,0.102569,6,1846.248248,102.569347,307.708041,134.544278,2,0
0,0,6,6,10,13,23,20,18,38,0.000333,0.057298,5,859.476772,47.74871,171.895354,81.324997,1,0
0,0,15,15,17,15,32,54,37,91,0.000333,0.151667,16,7280,404.444444,455,128.090227,3,0
0,0,10,10,15,14,29,38,27,65,0.000333,0.105256,7,2210.381353,122.798964,315.768765,111.906328,2,0
0,0,8,8,13,13,26,27,20,47,0.000333,0.07364,6,1325.524001,73.640222,220.920667,96.211433,2,0
0,0,8,8,13,13,26,27,20,47,0.000333,0.07364,6,1325.524001,73.640222,220.920667,96.211433,2,0
0,0,15,15,18,18,36,65,51,116,0.000333,0.199904,18,10794.8034,599.7113,599.7113,150.1173,3,0
0,0,12,12,18,17,35,60,45,105,0.000333,0.179525,18,9694.344902,538.574717,538.574717,144.545518,3,0
0,0,14,14,14,19,33,69,52,121,0.000333,0.203457,14,8545.203638,474.733535,610.371688,134.013592,1,0
0,0,12,12,12,13,25,54,38,92,0.000333,0.142412,12,5126.817234,284.82318,427.234769,91.125266,1,0
0,0,15,15,16,15,31,67,46,113,0.000333,0.186608,24,13435.78039,746.432244,559.824183,122.603359,2,0
0,0,10,10,15,15,30,47,32,79,0.000333,0.129215,14,5427.020999,301.501167,387.644357,117.206718,2,0
0,0,13,13,13,14,27,57,39,96,0.000333,0.152156,12,5477.630402,304.3128,456.4692,101.408685,2,0
0,0,16,16,17,16,33,70,47,117,0.000333,0.196731,16,9443.105791,524.616988,590.194112,133.486868,3,0
0,0,10,10,15,15,30,47,32,79,0.000333,0.129215,14,5427.020999,301.501167,387.644357,117.206718,2,0
0,0,13,13,13,14,27,57,39,96,0.000333,0.152156,12,5477.630402,304.3128,456.4692,101.408685,2,0
0,0,16,16,17,16,33,70,47,117,0.000333,0.196731,16,9443.105791,524.616988,590.194112,133.486868,3,0
0,0,10,10,15,15,30,47,32,79,0.000333,0.129215,14,5427.020999,301.501167,387.644357,117.206718,2,0
0,0,15,15,11,16,27,52,53,105,0.000333,0.166421,15,7488.947816,416.052656,499.263188,102.053748,1,0
0,0,17,17,15,18,33,60,58,118,0.000333,0.198413,21,12500.00863,694.444924,595.238506,133.662009,2,0
0,0,8,8,10,14,24,29,30,59,0.000333,0.090171,10,2705.127875,150.284882,270.512788,86.52225,1,0
0,0,10,10,14,17,31,37,35,72,0.000333,0.118901,14,4993.829881,277.434993,356.702134,122.789837,2,0
0,0,11,11,15,18,33,40,34,74,0.000333,0.124428,7,2612.996154,145.166453,373.285165,133.662009,2,0
0,0,16,16,12,19,31,54,54,108,0.000333,0.178351,12,6420.638418,356.702134,535.053202,123.730173,1,0
0,0,18,18,16,21,37,62,59,121,0.000333,0.210115,16,10085.50172,560.305651,630.343857,156.238666,2,0
0,0,16,16,12,16,28,57,55,112,0.000333,0.179475,18,9691.627523,538.423751,538.423751,107.01955,1,0
0,0,18,18,16,18,34,65,60,125,0.000333,0.211978,24,15262.38852,847.910474,635.932855,139.05865,2,0
0,0,15,15,11,16,27,52,53,105,0.000333,0.166421,15,7488.947816,416.052656,499.263188,102.053748,1,0
0,0,17,17,15,18,33,60,58,118,0.000333,0.198413,21,12500.00863,694.444924,595.238506,133.662009,2,0
0,0,7,7,10,13,23,29,28,57,0.000333,0.085948,10,2578.430315,143.246129,257.843031,81.324997,1,0
0,0,9,9,14,16,30,37,33,70,0.000333,0.114494,14,4808.752784,267.152932,343.482342,117.302969,2,0
0,0,10,10,14,13,27,33,27,60,0.000333,0.095098,14,3994.105502,221.89475,285.29325,101.408685,3,0
0,0,11,11,14,18,32,47,37,84,0.000333,0.14,14,5880,326.666667,420,128.361619,2,0
0,0,10,10,14,14,28,44,31,75,0.000333,0.120184,14,5047.722668,280.429037,360.551619,106.605938,2,0
0,0,15,15,15,21,36,59,47,106,0.000333,0.182671,14,7672.168702,426.231595,548.01205,150.842025,2,0
0,0,15,15,16,22,38,60,50,110,0.000333,0.192424,16,9236.352424,513.13069,577.272026,162.107496,2,0
0,0,19,19,13,20,33,92,68,160,0.000333,0.269034,18,14527.85506,807.103059,807.103059,134.544278,1,0
0,0,22,22,17,23,40,105,76,181,0.000333,0.32109,24,23118.45564,1284.358647,963.268985,173.528793,2,0
0,0,10,10,16,18,34,52,36,88,0.000333,0.149232,16,7163.14768,397.952649,447.69673,139.05865,2,0
0,0,11,11,14,16,30,52,40,92,0.000333,0.150478,14,6320.075087,351.115283,451.433935,117.302969,1,0
0,0,14,14,18,19,37,65,48,113,0.000333,0.196223,18,10596.02815,588.66823,588.66823,155.769273,2,0
0,0,10,10,16,17,33,51,35,86,0.000333,0.144606,16,6941.086308,385.615906,433.817894,133.486868,2,0
0,0,12,12,14,16,30,53,38,91,0.000333,0.148842,14,6251.378619,347.298812,446.527044,117.302969,1,0
0,0,21,21,16,19,35,89,66,155,0.000333,0.265013,24,19080.93282,1060.051824,795.038868,144.710623,2,0
0,0,10,10,14,15,29,49,33,82,0.000333,0.132785,14,5576.962182,309.831232,398.354442,111.906328,2,0
0,0,18,18,16,19,35,75,56,131,0.000333,0.223979,16,10750.9772,597.276511,671.936075,144.710623,2,0
0,0,10,10,15,18,33,37,32,69,0.000333,0.116021,7,2436.44236,135.357909,348.063194,133.662009,2,0
0,0,5,5,11,12,23,20,19,39,0.000333,0.058806,5,882.094581,49.005255,176.418916,81.073298,2,0
0,0,17,17,20,20,40,64,47,111,0.000333,0.196911,20,11814.68037,656.371132,590.734019,172.877124,4,0
0,0,5,5,12,13,25,21,20,41,0.000333,0.063466,6,1142.388623,63.466035,190.398104,91.125266,2,0
0,0,17,17,20,20,40,64,47,111,0.000333,0.196911,20,11814.68037,656.371132,590.734019,172.877124,4,0
0,0,5,5,12,13,25,21,20,41,0.000333,0.063466,6,1142.388623,63.466035,190.398104,91.125266,2,0
0,0,9,9,12,16,28,37,29,66,0.000333,0.105762,6,1903.712549,105.761808,317.285425,107.01955,3,0
0,0,6,6,10,10,20,17,15,32,0.000333,0.046101,5,691.508495,38.417139,138.301699,66.438562,1,0
0,0,16,16,17,20,37,66,51,117,0.000333,0.203169,16,9752.0967,541.78315,609.506044,155.92543,3,0
0,0,11,11,16,17,33,48,37,85,0.000333,0.142925,16,6860.376002,381.132,428.7735,133.486868,2,0
0,0,19,19,16,16,32,75,58,133,0.000333,0.221667,24,15960,886.666667,665,128,2,0
0,0,20,20,15,17,32,77,64,141,0.000333,0.235,21,14805,822.5,705,128.090227,2,0
0,0,10,10,13,14,27,44,33,77,0.000333,0.122042,12,4393.516052,244.084225,366.126338,101.408685,2,0
0,0,5,5,11,12,23,20,19,39,0.000333,0.058806,5,882.094581,49.005255,176.418916,81.073298,2,0
0,0,15,15,19,21,40,59,46,105,0.000333,0.186267,18,10058.4441,558.80245,558.80245,172.949289,4,0
0,0,5,5,12,13,25,21,20,41,0.000333,0.063466,6,1142.388623,63.466035,190.398104,91.125266,2,0
0,0,15,15,19,21,40,58,46,104,0.000333,0.184494,18,9962.649394,553.480522,553.480522,172.949289,4,0
0,0,5,5,12,13,25,21,20,41,0.000333,0.063466,6,1142.388623,63.466035,190.398104,91.125266,2,0
0,0,15,15,18,16,34,58,42,100,0.000333,0.169582,18,9157.433114,508.746284,508.746284,139.05865,3,0
0,0,11,11,15,14,29,45,31,76,0.000333,0.123069,14,5168.891779,287.160654,369.206556,111.906328,2,0
0,0,17,17,16,17,33,62,58,120,0.000333,0.201776,24,14527.85506,807.103059,605.327294,133.486868,2,0
0,0,20,20,20,20,40,75,56,131,0.000333,0.232391,20,13943.45161,774.6362,697.17258,172.877124,3,0
0,0,11,11,15,14,29,45,31,76,0.000333,0.123069,14,5168.891779,287.160654,369.206556,111.906328,2,0
0,0,19,19,20,17,37,74,53,127,0.000333,0.220534,30,19848.01732,1102.667629,661.600577,155.92543,3,0
0,0,11,11,15,14,29,45,31,76,0.000333,0.123069,14,5168.891779,287.160654,369.206556,111.906328,2,0
0,0,14,14,11,17,28,49,46,95,0.000333,0.152233,10,4566.987176,253.72151,456.698718,107.540616,1,0
0,0,15,15,14,18,32,53,45,98,0.000333,0.163333,14,6860,381.111111,490,128.361619,2,0
0,0,13,13,12,16,28,49,43,92,0.000333,0.147426,12,5307.319834,294.851102,442.276653,107.01955,1,0
0,0,8,8,12,11,23,29,24,53,0.000333,0.079916,12,2876.985404,159.832522,239.748784,81.073298,1,0
0,0,13,13,11,15,26,44,45,89,0.000333,0.139446,15,6275.087024,348.615946,418.339135,96.657107,1,0
0,0,16,16,15,18,33,56,54,110,0.000333,0.184961,21,11652.55042,647.363912,554.883353,133.662009,2,0
0,0,11,11,14,16,30,35,33,68,0.000333,0.111223,14,4671.359847,259.519992,333.668561,117.302969,2,0
0,0,13,13,13,18,31,53,42,95,0.000333,0.156883,12,5647.783794,313.765766,470.648649,123.164366,3,0
0,0,16,16,14,21,35,64,49,113,0.000333,0.193203,14,8114.525733,450.806985,579.608981,145.541635,4,0
0,0,10,10,11,12,23,34,32,66,0.000333,0.099518,10,2985.550891,165.863938,298.555089,81.073298,1,0
0,0,15,15,18,18,36,65,48,113,0.000333,0.194734,18,10515.62745,584.201525,584.201525,150.1173,2,0
0,0,11,11,17,16,33,52,35,87,0.000333,0.146287,16,7021.796614,390.099812,438.862288,133.486868,2,0
0,0,9,9,11,16,27,47,39,86,0.000333,0.136307,10,4089.203252,227.177958,408.920325,102.053748,1,0
0,0,8,8,10,13,23,41,31,72,0.000333,0.108565,10,3256.964608,180.942478,325.696461,81.324997,1,0
0,0,11,11,12,18,30,48,38,86,0.000333,0.140664,12,5063.911095,281.328394,421.992591,118.0782,1,0
0,0,10,10,11,14,25,42,32,74,0.000333,0.114548,10,3436.45358,190.914088,343.645358,91.356717,1,0
0,0,8,8,11,12,23,28,25,53,0.000333,0.079916,10,2397.487837,133.193769,239.748784,81.073298,1,0
0,0,10,10,12,17,29,39,34,73,0.000333,0.118211,12,4255.591352,236.421742,354.632613,112.506418,1,0
0,0,9,9,11,13,24,33,28,61,0.000333,0.093228,10,2796.827125,155.379285,279.682713,86.159464,1,0
0,0,15,15,12,17,29,54,58,112,0.000333,0.181365,18,9793.689686,544.093871,544.093871,112.506418,2,0
0,0,17,17,16,20,36,62,63,125,0.000333,0.215414,24,15509.775,861.654167,646.240625,150.438562,3,0
0,0,11,11,13,15,28,38,36,74,0.000333,0.118581,12,4268.931171,237.162843,355.744264,106.709075,2,0
0,0,13,13,17,17,34,46,41,87,0.000333,0.147536,16,7081.748275,393.43046,442.609267,138.973737,3,0
0,0,21,21,14,19,33,72,75,147,0.000333,0.247175,21,15572.04465,865.113591,741.525936,134.013592,2,0
0,0,23,23,18,21,39,80,80,160,0.000333,0.281888,27,22832.93759,1268.496533,845.664355,167.297316,3,0
0,0,6,6,10,13,23,20,18,38,0.000333,0.057298,5,859.476772,47.74871,171.895354,81.324997,1,0
0,0,6,6,10,13,23,20,18,38,0.000333,0.057298,5,859.476772,47.74871,171.895354,81.324997,1,0
0,0,15,15,16,17,33,53,46,99,0.000333,0.166465,16,7990.320285,443.906683,499.395018,133.486868,1,0
0,0,27,27,19,43,62,136,86,222,0.000333,0.440611,18,23792.96846,1321.831581,1321.831581,314.040007,9,0
0,0,15,15,14,18,32,71,44,115,0.000333,0.191667,14,8050,447.222222,575,128.361619,5,0
0,0,6,6,11,9,20,18,14,32,0.000333,0.046101,5,691.508495,38.417139,138.301699,66.583073,1,0
0,0,10,10,10,12,22,35,27,62,0.000333,0.092162,10,2764.847604,153.602645,276.48476,76.238831,2,0
0,0,32,32,23,49,72,177,123,300,0.000333,0.616993,22,40721.50501,2262.305834,1850.9775,379.162707,11,0
0,0,27,27,22,46,68,152,107,259,0.000333,0.525551,22,34686.36327,1927.020182,1576.652876,352.191346,11,0
0,0,20,20,22,32,54,121,83,204,0.000333,0.391332,22,25827.93511,1434.885284,1173.99705,258.107496,6,0
0,0,10,10,11,13,24,36,28,64,0.000333,0.097813,10,2934.376,163.020889,293.4376,86.159464,2,0
0,0,27,27,24,54,78,171,125,296,0.000333,0.62016,24,44651.49736,2480.638742,1860.479057,420.803025,12,0
0,0,24,24,22,46,68,146,108,254,0.000333,0.515405,22,34016.74236,1889.81902,1546.215562,352.191346,10,0
0,0,6,6,11,10,21,22,16,38,0.000333,0.055636,5,834.54031,46.363351,166.908062,71.273029,1,0
0,0,20,20,17,19,36,82,59,141,0.000333,0.242986,24,17495.02621,971.9459,728.959425,150.197491,2,0
0,0,11,11,15,15,30,52,34,86,0.000333,0.140664,14,5907.896277,328.21646,421.992591,117.206718,2,0
0,0,17,17,17,18,35,68,49,117,0.000333,0.200042,16,9602.017808,533.445434,600.126113,144.545518,2,0
0,0,10,10,14,15,29,36,32,68,0.000333,0.110114,14,4624.797907,256.933217,330.342708,111.906328,2,0
0,0,16,16,14,18,32,54,56,110,0.000333,0.183333,21,11550,641.666667,550,128.361619,2,0
0,0,17,17,15,20,35,95,60,155,0.000333,0.265013,21,16695.81622,927.545346,795.038868,145.041921,5,0
0,0,8,8,10,12,22,40,30,70,0.000333,0.104053,10,3121.602133,173.422341,312.160213,76.238831,1,0
0,0,17,17,16,21,37,96,61,157,0.000333,0.272628,16,13086.14685,727.008159,817.884178,156.238666,5,0
0,0,15,15,16,18,34,62,44,106,0.000333,0.179757,16,8628.336979,479.352054,539.271061,139.05865,2,0
0,0,9,9,14,14,28,35,26,61,0.000333,0.09775,7,2052.740552,114.041142,293.24865,106.605938,2,0
0,0,10,10,14,18,32,45,36,81,0.000333,0.135,14,5670,315,405,128.361619,5,0
0,0,6,6,10,11,21,15,17,32,0.000333,0.046851,5,702.770788,39.042822,140.554158,71.273029,1,0
0,0,7,7,8,10,18,20,17,37,0.000333,0.051429,4,617.1489,34.28605,154.287225,57.219281,1,0
0,0,7,7,9,11,20,21,19,40,0.000333,0.057626,4,691.508495,38.417139,172.877124,66.583073,1,0
0,0,19,19,17,22,39,78,62,140,0.000333,0.246652,16,11839.30097,657.738943,739.956311,167.594364,2,0
0,0,11,11,15,18,33,52,39,91,0.000333,0.153013,14,6426.558108,357.031006,459.039865,133.662009,2,0
0,0,14,14,14,19,33,56,44,100,0.000333,0.168146,14,7062.151767,392.341765,504.439412,134.013592,1,0
0,0,31,31,19,47,66,161,101,262,0.000333,0.527877,18,28505.36267,1583.631259,1583.631259,341.776299,9,0
0,0,19,19,16,22,38,96,59,155,0.000333,0.271143,16,13014.86023,723.047791,813.428765,162.107496,5,0
0,0,10,10,12,13,25,43,31,74,0.000333,0.114548,12,4123.744297,229.096905,343.645358,91.125266,1,0
0,0,19,19,19,19,38,80,56,136,0.000333,0.237906,18,12846.92655,713.718142,713.718142,161.421246,3,0
0,0,11,11,14,15,29,45,32,77,0.000333,0.124688,14,5236.903513,290.939084,374.064537,111.906328,2,0
0,0,14,14,14,15,29,59,42,101,0.000333,0.163552,14,6869.185127,381.621396,490.656081,111.906328,2,0
0,0,17,17,16,17,33,72,50,122,0.000333,0.205139,16,9846.657321,547.036518,615.416083,133.486868,3,0
0,0,10,10,15,14,29,45,31,76,0.000333,0.123069,14,5168.891779,287.160654,369.206556,111.906328,2,0
0,0,14,14,13,15,28,58,42,100,0.000333,0.160245,12,5768.825906,320.490328,480.735492,106.709075,2,0
0,0,17,17,16,17,33,71,50,121,0.000333,0.203457,16,9765.947015,542.552612,610.371688,133.486868,3,0
0,0,10,10,15,14,29,45,31,76,0.000333,0.123069,14,5168.891779,287.160654,369.206556,111.906328,2,0
0,0,22,22,15,22,37,101,77,178,0.000333,0.309094,21,19472.93668,1081.829816,927.282699,156.710855,2,0
0,0,25,25,19,25,44,114,85,199,0.000333,0.362142,27,29333.52609,1629.640338,1086.426892,196.807027,3,0
0,0,15,15,12,16,28,61,53,114,0.000333,0.182679,18,9864.6923,548.038461,548.038461,107.01955,1,0
0,0,17,17,16,18,34,69,58,127,0.000333,0.215369,24,15506.58674,861.477041,646.107781,139.05865,2,0
0,0,8,8,11,14,25,28,26,54,0.000333,0.083589,5,1253.841171,69.657843,250.768234,91.356717,1,0
0,0,8,8,14,12,26,28,19,47,0.000333,0.07364,7,1546.444667,85.913593,220.920667,96.322519,2,0
0,0,6,6,10,11,21,21,17,38,0.000333,0.055636,5,834.54031,46.363351,166.908062,71.273029,1,0
0,0,7,7,13,13,26,33,28,61,0.000333,0.095576,12,3440.721874,191.151215,286.726823,96.211433,1,0
0,0,11,11,17,17,34,49,44,93,0.000333,0.157711,16,7570.144708,420.563595,473.134044,138.973737,1,0
0,0,17,17,17,20,37,71,64,135,0.000333,0.234425,24,16878.62891,937.701606,703.276204,155.92543,1,0
0,0,7,7,12,13,25,28,27,55,0.000333,0.085137,12,3064.945085,170.274727,255.41209,91.125266,1,0
0,0,7,7,13,13,26,30,27,57,0.000333,0.089308,12,3215.100767,178.616709,267.925064,96.211433,1,0
0,0,6,6,10,13,23,20,18,38,0.000333,0.057298,5,859.476772,47.74871,171.895354,81.324997,1,0
0,0,6,6,10,13,23,20,18,38,0.000333,0.057298,5,859.476772,47.74871,171.895354,81.324997,1,0
0,0,11,11,15,19,34,46,38,84,0.000333,0.142449,14,5982.856301,332.380906,427.346879,139.313982,2,0
0,0,11,11,15,19,34,46,38,84,0.000333,0.142449,14,5982.856301,332.380906,427.346879,139.313982,2,0
0,0,9,9,11,12,23,24,20,44,0.000333,0.066346,5,995.18363,55.287979,199.036726,81.073298,3,0
0,0,14,14,15,20,35,57,38,95,0.000333,0.162427,7,3410.973206,189.498511,487.281887,145.041921,5,0
0,0,9,9,12,14,26,29,21,50,0.000333,0.078341,6,1410.131915,78.340662,235.021986,96.322519,3,0
0,0,9,9,14,18,32,41,28,69,0.000333,0.115,7,2415,134.166667,345,128.361619,2,0
0,0,6,6,10,13,23,20,18,38,0.000333,0.057298,5,859.476772,47.74871,171.895354,81.324997,1,0
0,0,6,6,10,13,23,20,18,38,0.000333,0.057298,5,859.476772,47.74871,171.895354,81.324997,1,0
0,0,6,6,10,13,23,20,18,38,0.000333,0.057298,5,859.476772,47.74871,171.895354,81.324997,1,0
0,0,6,6,10,13,23,20,18,38,0.000333,0.057298,5,859.476772,47.74871,171.895354,81.324997,1,0
0,0,10,10,14,14,28,34,28,62,0.000333,0.099352,14,4172.784072,231.821337,298.056005,106.605938,2,0
0,0,8,8,14,12,26,28,19,47,0.000333,0.07364,7,1546.444667,85.913593,220.920667,96.322519,2,0
0,0,15,15,17,18,35,55,44,99,0.000333,0.169266,16,8124.784299,451.376905,507.799019,144.545518,3,0
0,0,15,15,17,18,35,54,44,98,0.000333,0.167557,16,8042.715771,446.817543,502.669736,144.545518,3,0
0,0,15,15,17,18,35,55,44,99,0.000333,0.169266,16,8124.784299,451.376905,507.799019,144.545518,3,0
0,0,15,15,17,18,35,54,44,98,0.000333,0.167557,16,8042.715771,446.817543,502.669736,144.545518,3,0
0,0,15,15,17,18,35,55,44,99,0.000333,0.169266,16,8124.784299,451.376905,507.799019,144.545518,3,0
0,0,15,15,17,18,35,54,44,98,0.000333,0.167557,16,8042.715771,446.817543,502.669736,144.545518,3,0
0,0,19,19,18,20,38,71,53,124,0.000333,0.216914,18,11713.37421,650.743012,650.743012,161.497212,3,0
0,0,17,17,16,18,34,64,56,120,0.000333,0.203499,24,14651.89298,813.994055,610.495541,139.05865,2,0
0,0,11,11,14,15,29,35,33,68,0.000333,0.110114,14,4624.797907,256.933217,330.342708,111.906328,2,0
0,0,11,11,11,13,24,39,30,69,0.000333,0.105454,10,3163.624125,175.756896,316.362413,86.159464,2,0
0,0,14,14,15,16,31,52,38,90,0.000333,0.148626,14,6242.287351,346.793742,445.877668,122.603359,3,0
0,0,10,10,14,15,29,40,29,69,0.000333,0.111734,7,2346.404821,130.355823,335.200689,111.906328,2,0
0,0,11,11,16,17,33,49,39,88,0.000333,0.147969,16,7102.50692,394.583718,443.906683,133.486868,1,0
0,0,11,11,11,14,25,34,36,70,0.000333,0.108357,10,3250.699333,180.594407,325.069933,91.356717,1,0
0,0,12,12,12,14,26,39,38,77,0.000333,0.120645,12,4343.2063,241.289239,361.933858,96.322519,1,0
0,0,13,13,13,15,28,42,43,85,0.000333,0.136208,12,4903.50202,272.416779,408.625168,106.709075,2,0
0,0,13,13,13,15,28,42,43,85,0.000333,0.136208,12,4903.50202,272.416779,408.625168,106.709075,2,0
0,0,11,11,12,14,26,35,34,69,0.000333,0.10811,12,3891.964087,216.220227,324.330341,96.322519,1,0
0,0,11,11,11,14,25,34,34,68,0.000333,0.105261,10,3157.822209,175.434567,315.782221,91.356717,1,0
0,0,15,15,16,16,32,55,38,93,0.000333,0.155,16,7440,413.333333,465,128,3,0
0,0,15,15,16,16,32,54,38,92,0.000333,0.153333,16,7360,408.888889,460,128,3,0
0,0,14,14,12,18,30,44,40,84,0.000333,0.137393,12,4946.14572,274.785873,412.17881,118.0782,1,0
0,0,14,14,13,18,31,45,45,90,0.000333,0.148626,12,5350.532015,297.251779,445.877668,123.164366,1,0
0,0,13,13,13,16,29,42,42,84,0.000333,0.136023,12,4896.844843,272.046936,408.070404,112.105716,1,0
0,0,8,8,13,13,26,27,20,47,0.000333,0.07364,6,1325.524001,73.640222,220.920667,96.211433,2,0
0,0,8,8,13,13,26,27,20,47,0.000333,0.07364,6,1325.524001,73.640222,220.920667,96.211433,2,0
0,0,11,11,12,17,29,43,42,85,0.000333,0.137643,12,4955.140615,275.28559,412.928385,112.506418,1,0
0,0,13,13,16,20,36,51,47,98,0.000333,0.168884,16,8106.442402,450.357911,506.65265,150.438562,2,0
0,0,9,9,13,13,26,32,22,54,0.000333,0.084608,6,1522.942469,84.607915,253.823745,96.211433,2,0
0,0,8,8,13,13,26,27,20,47,0.000333,0.07364,6,1325.524001,73.640222,220.920667,96.211433,2,0
0,0,16,16,16,18,34,60,52,112,0.000333,0.189932,16,9116.733412,506.48519,569.795838,139.05865,3,0
0,0,16,16,16,18,34,59,52,111,0.000333,0.188236,16,9035.334006,501.963,564.708375,139.05865,3,0
0,0,6,6,14,17,31,44,27,71,0.000333,0.117249,7,2462.235566,136.790865,351.747938,122.789837,5,0
0,0,5,5,14,17,31,41,24,65,0.000333,0.107341,7,2254.159321,125.231073,322.02276,122.789837,5,0
0,0,12,12,21,22,43,67,41,108,0.000333,0.195346,10,5860.365935,325.575885,586.036594,190.346161,8,0
0,0,11,11,21,22,43,64,38,102,0.000333,0.184493,10,5534.79005,307.488336,553.479005,190.346161,8,0
0,0,9,9,17,15,32,42,27,69,0.000333,0.115,8,2760,153.333333,345,128.090227,5,0
0,0,8,8,14,20,34,50,32,82,0.000333,0.139057,7,2920.203671,162.233537,417.171953,139.741531,7,0
0,0,10,10,13,23,36,40,35,75,0.000333,0.129248,6,2326.466251,129.248125,387.744375,152.147641,2,0
0,0,7,7,10,15,25,45,32,77,0.000333,0.119192,10,3575.769266,198.653848,357.576927,91.82264,2,0
0,0,8,8,10,15,25,46,34,80,0.000333,0.123836,10,3715.084952,206.393608,371.508495,91.82264,2,0
0,0,13,13,16,18,34,54,45,99,0.000333,0.167886,16,8058.541141,447.69673,503.658821,139.05865,2,0
0,0,13,13,16,16,32,52,47,99,0.000333,0.165,16,7920,440,495,128,1,0
0,0,33,33,20,53,73,170,111,281,0.000333,0.57978,20,34786.81402,1932.600779,1739.340701,390.018346,10,0
0,0,21,21,16,29,45,105,69,174,0.000333,0.318527,16,15289.31902,849.406612,955.582439,204.881449,6,0
0,0,23,23,19,43,62,122,82,204,0.000333,0.404885,9,10931.90443,607.328024,1214.656047,314.040007,7,0
0,0,12,12,14,21,35,52,41,93,0.000333,0.159008,7,3339.163244,185.509069,477.023321,145.541635,2,0
0,0,8,8,11,12,23,26,21,47,0.000333,0.070869,5,1063.03706,59.057614,212.607412,81.073298,1,0
0,0,13,13,14,22,36,56,44,100,0.000333,0.172331,14,7237.895002,402.105278,516.9925,151.410465,2,0
0,0,5,5,13,14,27,25,22,47,0.000333,0.074493,6,1340.878276,74.493238,223.479713,101.408685,2,0
0,0,15,15,18,24,42,62,53,115,0.000333,0.206706,18,11162.09707,620.116504,620.116504,185.09775,3,0
0,0,5,5,13,15,28,25,23,48,0.000333,0.076918,6,1384.518218,76.917679,230.753036,106.709075,2,0
0,0,14,14,13,15,28,51,46,97,0.000333,0.155438,18,8393.641694,466.313427,466.313427,106.709075,2,0
0,0,16,16,16,17,33,59,51,110,0.000333,0.184961,24,13317.20048,739.844471,554.883353,133.486868,3,0
0,0,14,14,13,15,28,51,46,97,0.000333,0.155438,18,8393.641694,466.313427,466.313427,106.709075,2,0
0,0,16,16,16,17,33,59,51,110,0.000333,0.184961,24,13317.20048,739.844471,554.883353,133.486868,3,0
0,0,20,20,14,22,36,83,63,146,0.000333,0.251603,14,10567.3267,587.073706,754.80905,151.410465,6,0
0,0,14,14,13,16,29,45,44,89,0.000333,0.14412,12,5188.323703,288.240206,432.360309,112.105716,2,0
0,0,13,13,14,16,30,51,45,96,0.000333,0.15702,14,6594.86096,366.381164,471.061497,117.302969,2,0
0,0,15,15,16,18,34,59,50,109,0.000333,0.184844,16,8872.535195,492.918622,554.53345,139.05865,3,0
0,0,13,13,13,16,29,50,45,95,0.000333,0.153836,12,5538.098334,307.67213,461.508195,112.105716,2,0
0,0,15,15,16,18,34,58,50,108,0.000333,0.183149,16,8791.13579,488.396433,549.445987,139.05865,3,0
0,0,13,13,14,16,30,51,45,96,0.000333,0.15702,14,6594.86096,366.381164,471.061497,117.302969,2,0
0,0,15,15,16,18,34,59,50,109,0.000333,0.184844,16,8872.535195,492.918622,554.53345,139.05865,3,0
0,0,13,13,13,16,29,50,45,95,0.000333,0.153836,12,5538.098334,307.67213,461.508195,112.105716,2,0
0,0,15,15,16,18,34,58,50,108,0.000333,0.183149,16,8791.13579,488.396433,549.445987,139.05865,3,0
0,0,8,8,14,18,32,29,25,54,0.000333,0.09,7,1890,105,270,128.361619,2,0
0,0,8,8,14,18,32,29,25,54,0.000333,0.09,7,1890,105,270,128.361619,2,0
0,0,8,8,13,14,27,25,22,47,0.000333,0.074493,6,1340.878276,74.493238,223.479713,101.408685,2,0
0,0,5,5,8,7,15,12,11,23,0.000333,0.029953,4,359.433935,19.968552,89.858484,43.651484,1,0
0,0,5,5,9,8,17,13,13,26,0.000333,0.035425,4,425.096135,23.616452,106.274034,52.529325,1,0
0,0,5,5,9,8,17,13,13,26,0.000333,0.035425,4,425.096135,23.616452,106.274034,52.529325,1,0
0,0,16,16,14,18,32,56,58,114,0.000333,0.19,21,11970,665,570,128.361619,2,0
0,0,18,18,17,19,36,69,57,126,0.000333,0.217137,24,15633.8532,868.5474,651.41055,150.197491,2,0
0,0,12,12,17,18,35,52,37,89,0.000333,0.152169,16,7304.099016,405.783279,456.506189,144.545518,3,0
0,0,12,12,17,18,35,51,37,88,0.000333,0.150459,16,7222.030488,401.223916,451.376905,144.545518,3,0
0,0,9,9,13,15,28,28,24,52,0.000333,0.083327,6,1499.894736,83.327485,249.982456,106.709075,2,0
0,0,7,7,10,14,24,23,23,46,0.000333,0.070303,5,1054.541375,58.585632,210.908275,86.52225,1,0
0,0,6,6,10,11,21,16,16,32,0.000333,0.046851,5,702.770788,39.042822,140.554158,71.273029,1,0
0,0,11,11,12,19,31,38,35,73,0.000333,0.120552,6,2169.937984,120.55211,361.656331,123.730173,2,0
0,0,10,10,13,15,28,31,30,61,0.000333,0.09775,12,3518.983803,195.4991,293.24865,106.709075,2,0
0,0,19,19,15,22,37,88,68,156,0.000333,0.270892,21,17066.16923,948.120513,812.674725,156.710855,2,0
0,0,14,14,12,22,34,54,46,100,0.000333,0.169582,12,6104.95541,339.164189,508.746284,141.127046,2,0
0,0,15,15,12,22,34,55,48,103,0.000333,0.17467,12,6288.104072,349.339115,524.008673,141.127046,2,0
0,0,8,8,14,17,31,30,24,54,0.000333,0.089176,7,1872.686205,104.038123,267.526601,122.789837,2,0
0,0,8,8,14,17,31,30,24,54,0.000333,0.089176,7,1872.686205,104.038123,267.526601,122.789837,2,0
0,0,11,11,11,14,25,42,34,76,0.000333,0.117644,10,3529.330704,196.073928,352.93307,91.356717,1,0
0,0,12,12,14,17,31,47,35,82,0.000333,0.135415,14,5687.417364,315.967631,406.244097,122.789837,2,0
0,0,8,8,13,17,30,34,30,64,0.000333,0.10468,6,1884.245989,104.680333,314.040998,117.592585,3,0
0,0,26,26,22,51,73,161,116,277,0.000333,0.571527,22,37720.79086,2095.599492,1714.581403,387.401188,12,0
0,0,13,13,15,30,45,84,56,140,0.000333,0.256286,7,5382.016034,299.000891,768.859433,205.810077,7,0
0,0,26,26,23,41,64,162,109,271,0.000333,0.542,22,35772,1987.333333,1626,323.701557,10,0
0,0,5,5,12,13,25,23,21,44,0.000333,0.06811,6,1225.978034,68.109891,204.329672,91.125266,2,0
0,0,16,16,19,20,39,61,52,113,0.000333,0.199083,18,10750.50811,597.250451,597.250451,167.149185,3,0
0,0,5,5,12,14,26,23,22,45,0.000333,0.070507,6,1269.118724,70.506596,211.519787,96.322519,2,0
0,0,7,7,10,14,24,23,20,43,0.000333,0.065718,5,985.766938,54.76483,197.153388,86.52225,1,0
0,0,14,14,15,23,38,67,51,118,0.000333,0.206418,14,8669.576252,481.643125,619.255447,162.645284,5,0
0,0,12,12,13,20,33,49,40,89,0.000333,0.14965,12,5387.412919,299.300718,448.951077,134.544278,3,0
0,0,10,10,10,16,26,37,33,70,0.000333,0.109677,10,3290.307803,182.794878,329.03078,97.219281,1,0
0,0,7,7,8,12,20,20,20,40,0.000333,0.057626,4,691.508495,38.417139,172.877124,67.01955,1,0
0,0,10,10,9,15,24,37,33,70,0.000333,0.106982,8,2567.579,142.643278,320.947375,87.132684,1,0
0,0,16,16,14,26,40,70,56,126,0.000333,0.223521,14,9387.881159,521.548953,670.56294,175.514402,5,0
0,0,10,10,10,17,27,32,33,65,0.000333,0.103023,5,1545.338438,85.852135,309.067688,102.706149,1,0
0,0,13,13,15,18,33,52,48,100,0.000333,0.168146,14,7062.151767,392.341765,504.439412,133.662009,2,0
0,0,15,15,19,21,40,60,53,113,0.000333,0.200459,18,10824.80175,601.377875,601.377875,172.949289,3,0
0,0,12,12,17,18,35,52,37,89,0.000333,0.152169,16,7304.099016,405.783279,456.506189,144.545518,3,0
0,0,12,12,17,18,35,51,37,88,0.000333,0.150459,16,7222.030488,401.223916,451.376905,144.545518,3,0
0,0,25,25,18,44,62,112,86,198,0.000333,0.392977,9,10610.37783,589.465435,1178.930869,315.273641,9,0
0,0,21,21,18,43,61,105,76,181,0.000333,0.357821,9,9661.171123,536.731729,1073.463458,308.388034,9,0
0,0,9,9,11,14,25,30,30,60,0.000333,0.092877,10,2786.313714,154.795206,278.631371,91.356717,1,0
0,0,9,9,11,14,25,30,30,60,0.000333,0.092877,10,2786.313714,154.795206,278.631371,91.356717,1,0
0,0,12,12,15,15,30,46,42,88,0.000333,0.143935,14,6045.289214,335.849401,431.806372,117.206718,1,0
0,0,11,11,17,16,33,44,36,80,0.000333,0.134517,16,6456.824473,358.712471,403.55153,133.486868,2,0
0,0,11,11,16,16,32,43,36,79,0.000333,0.131667,16,6320,351.111111,395,128,2,0
0,0,11,11,16,15,31,43,35,78,0.000333,0.128809,16,6182.836995,343.490944,386.427312,122.603359,2,0
0,0,11,11,16,15,31,43,35,78,0.000333,0.128809,16,6182.836995,343.490944,386.427312,122.603359,2,0
0,0,6,6,11,10,21,22,16,38,0.000333,0.055636,5,834.54031,46.363351,166.908062,71.273029,1,0
0,0,15,15,13,19,32,67,53,120,0.000333,0.2,12,7200,400,600,128.816339,1,0
0,0,19,19,12,16,28,73,64,137,0.000333,0.219536,24,15806.58298,878.143499,658.607624,107.01955,1,0
0,0,22,22,16,18,34,86,72,158,0.000333,0.26794,32,25722.21213,1429.011785,803.819129,139.05865,2,0
0,0,10,10,14,14,28,47,33,80,0.000333,0.128196,14,5384.237513,299.124306,384.588394,106.605938,2,0
0,0,13,13,10,14,24,52,49,101,0.000333,0.15436,15,6946.218189,385.90101,463.081213,86.52225,1,0
0,0,16,16,14,17,31,65,57,122,0.000333,0.201471,21,12692.65095,705.147275,604.41195,122.789837,2,0
0,0,10,10,14,14,28,47,33,80,0.000333,0.128196,14,5384.237513,299.124306,384.588394,106.605938,2,0
0,0,15,15,12,14,26,61,48,109,0.000333,0.170783,18,9222.262727,512.347929,512.347929,96.322519,1,0
0,0,18,18,16,16,32,74,56,130,0.000333,0.216667,24,15600,866.666667,650,128,2,0
0,0,10,10,14,14,28,47,33,80,0.000333,0.128196,14,5384.237513,299.124306,384.588394,106.605938,2,0
0,0,16,16,14,16,30,61,58,119,0.000333,0.19464,21,12262.3196,681.239978,583.919981,117.302969,2,0
0,0,18,18,17,18,35,69,63,132,0.000333,0.225688,24,16249.5686,902.753811,677.065358,144.545518,3,0
0,0,16,16,14,16,30,61,58,119,0.000333,0.19464,21,12262.3196,681.239978,583.919981,117.302969,2,0
0,0,18,18,17,18,35,69,63,132,0.000333,0.225688,24,16249.5686,902.753811,677.065358,144.545518,3,0
0,0,7,7,11,13,24,37,25,62,0.000333,0.094756,5,1421.338375,78.963243,284.267675,86.159464,1,0
0,0,11,11,11,14,25,33,34,67,0.000333,0.103713,10,3111.383647,172.854647,311.138365,91.356717,1,0
0,0,9,9,13,14,27,27,24,51,0.000333,0.080833,6,1454.995576,80.833088,242.499263,101.408685,2,0
0,0,6,6,10,11,21,21,17,38,0.000333,0.055636,5,834.54031,46.363351,166.908062,71.273029,1,0
0,0,8,8,10,10,20,24,22,46,0.000333,0.06627,10,1988.086924,110.449274,198.808692,66.438562,1,0
0,0,9,9,13,15,28,34,31,65,0.000333,0.104159,12,3749.736839,208.318713,312.47807,106.709075,1,0
0,0,11,11,13,15,28,49,39,88,0.000333,0.141016,12,5076.566798,282.031489,423.047233,106.709075,1,0
0,0,14,14,17,18,35,62,47,109,0.000333,0.186364,16,8945.469582,496.970532,559.091849,144.545518,2,0
0,0,10,10,16,16,32,49,34,83,0.000333,0.138333,16,6640,368.888889,415,128,2,0
0,0,20,20,13,20,33,92,69,161,0.000333,0.270716,18,14618.65416,812.147453,812.147453,134.544278,1,0
0,0,23,23,17,22,39,105,77,182,0.000333,0.320648,24,23086.63689,1282.590938,961.943204,167.594364,2,0
0,0,10,10,16,17,33,50,35,85,0.000333,0.142925,16,6860.376002,381.132,428.7735,133.486868,2,0
0,0,6,6,10,11,21,21,17,38,0.000333,0.055636,5,834.54031,46.363351,166.908062,71.273029,1,0
0,0,6,6,10,11,21,21,17,38,0.000333,0.055636,5,834.54031,46.363351,166.908062,71.273029,1,0
0,0,6,6,10,11,21,21,17,38,0.000333,0.055636,5,834.54031,46.363351,166.908062,71.273029,1,0
0,0,10,10,12,16,28,39,33,72,0.000333,0.115377,12,4153.554653,230.753036,346.129554,107.01955,1,0
0,0,12,12,14,19,33,48,39,87,0.000333,0.146287,14,6144.072037,341.337335,438.862288,134.013592,2,0
0,0,9,9,12,12,24,34,27,61,0.000333,0.093228,12,3356.192551,186.455142,279.682713,86.0391,1,0
0,0,9,9,11,12,23,31,29,60,0.000333,0.090471,10,2714.137174,150.785399,271.413717,81.073298,1,0
0,0,9,9,11,12,23,31,29,60,0.000333,0.090471,10,2714.137174,150.785399,271.413717,81.073298,1,0
0,0,8,8,14,17,31,30,24,54,0.000333,0.089176,7,1872.686205,104.038123,267.526601,122.789837,2,0
0,0,11,11,13,16,29,45,42,87,0.000333,0.140881,12,5071.732159,281.762898,422.644347,112.105716,1,0
0,0,13,13,17,19,36,53,47,100,0.000333,0.172331,16,8271.880002,459.548889,516.9925,150.197491,2,0
0,0,11,11,11,14,25,42,34,76,0.000333,0.117644,10,3529.330704,196.073928,352.93307,91.356717,1,0
0,0,12,12,14,17,31,47,35,82,0.000333,0.135415,14,5687.417364,315.967631,406.244097,122.789837,2,0
0,0,13,13,16,18,34,52,41,93,0.000333,0.157711,16,7570.144708,420.563595,473.134044,139.05865,2,0
0,0,11,11,16,17,33,48,37,85,0.000333,0.142925,16,6860.376002,381.132,428.7735,133.486868,2,0
0,0,11,11,11,14,25,39,36,75,0.000333,0.116096,10,3482.892142,193.494008,348.289214,91.356717,2,0
0,0,6,6,11,12,23,30,21,51,0.000333,0.076901,5,1153.508299,64.083794,230.70166,81.073298,1,0
0,0,9,9,12,11,23,33,28,61,0.000333,0.091979,12,3311.247352,183.958186,275.937279,81.073298,1,0
0,0,9,9,12,11,23,33,28,61,0.000333,0.091979,12,3311.247352,183.958186,275.937279,81.073298,1,0
0,0,4,4,10,11,21,21,16,37,0.000333,0.054172,5,812.578723,45.143262,162.515745,71.273029,2,0
0,0,8,8,10,13,23,27,24,51,0.000333,0.076901,5,1153.508299,64.083794,230.70166,81.324997,2,0
0,0,20,20,17,21,38,75,68,143,0.000333,0.250151,24,18010.88723,1000.604846,750.453634,161.725534,2,0
0,0,11,11,15,17,32,50,39,89,0.000333,0.148333,14,6230,346.111111,445,128.090227,2,0
0,0,9,9,11,12,23,32,29,61,0.000333,0.091979,10,2759.372793,153.298489,275.937279,81.073298,1,0
0,0,9,9,11,12,23,32,29,61,0.000333,0.091979,10,2759.372793,153.298489,275.937279,81.073298,1,0
0,0,11,11,13,14,27,42,33,75,0.000333,0.118872,12,4279.398752,237.744375,356.616563,101.408685,2,0
0,0,14,14,17,16,33,55,41,96,0.000333,0.161421,16,7748.189367,430.454965,484.261835,133.486868,3,0
0,0,10,10,14,14,28,42,30,72,0.000333,0.115377,14,4845.813761,269.211876,346.129554,106.605938,2,0
0,0,12,12,17,21,38,50,43,93,0.000333,0.162686,16,7808.91614,433.828674,488.057259,161.725534,2,0
0,0,18,18,17,24,41,81,64,145,0.000333,0.258948,16,12429.52065,690.528925,776.845041,179.525968,2,0
0,0,13,13,14,17,31,55,45,100,0.000333,0.16514,14,6935.874835,385.32638,495.419631,122.789837,2,0
0,0,16,16,18,20,38,68,53,121,0.000333,0.211666,18,11429.98612,634.999229,634.999229,161.497212,3,0
0,0,10,10,15,16,31,46,33,79,0.000333,0.130461,14,5479.341119,304.40784,391.381509,122.603359,2,0
0,0,22,22,15,20,35,92,73,165,0.000333,0.282111,21,17772.96565,987.386981,846.331698,145.041921,2,0
0,0,25,25,19,22,41,105,81,186,0.000333,0.332168,27,26905.62617,1494.757009,996.504673,178.818118,3,0
0,0,10,10,15,17,32,47,34,81,0.000333,0.135,14,5670,315,405,128.090227,2,0
0,0,31,31,19,46,65,152,100,252,0.000333,0.505879,18,27317.4604,1517.636689,1517.636689,334.794473,9,0
0,0,19,19,15,21,36,87,58,145,0.000333,0.24988,14,10494.94775,583.052653,749.639125,150.842025,5,0
0,0,10,10,11,12,23,34,32,66,0.000333,0.099518,10,2985.550891,165.863938,298.555089,81.073298,1,0
0,0,6,6,10,11,21,21,17,38,0.000333,0.055636,5,834.54031,46.363351,166.908062,71.273029,1,0
0,0,8,8,10,14,24,26,24,50,0.000333,0.076416,5,1146.240625,63.680035,229.248125,86.52225,1,0
0,0,9,9,11,14,25,31,30,61,0.000333,0.094425,10,2832.752276,157.375126,283.275228,91.356717,1,0
0,0,9,9,11,14,25,31,30,61,0.000333,0.094425,10,2832.752276,157.375126,283.275228,91.356717,1,0
0,0,19,19,19,18,37,77,55,132,0.000333,0.229216,27,18566.4918,1031.471766,687.647844,155.769273,4,0
0,0,10,10,14,14,28,42,30,72,0.000333,0.115377,14,4845.813761,269.211876,346.129554,106.605938,2,0
0,0,19,19,19,18,37,77,55,132,0.000333,0.229216,27,18566.4918,1031.471766,687.647844,155.769273,4,0
0,0,10,10,14,14,28,42,30,72,0.000333,0.115377,14,4845.813761,269.211876,346.129554,106.605938,2,0
0,0,22,22,19,19,38,88,69,157,0.000333,0.274642,27,22245.96473,1235.886929,823.92462,161.421246,4,0
0,0,10,10,14,14,28,42,30,72,0.000333,0.115377,14,4845.813761,269.211876,346.129554,106.605938,2,0
0,0,22,22,19,19,38,88,69,157,0.000333,0.274642,27,22245.96473,1235.886929,823.92462,161.421246,4,0
0,0,10,10,14,14,28,42,30,72,0.000333,0.115377,14,4845.813761,269.211876,346.129554,106.605938,2,0
0,0,13,13,18,15,33,49,36,85,0.000333,0.142925,18,7717.923003,428.7735,428.7735,133.662009,3,0
0,0,13,13,18,15,33,49,36,85,0.000333,0.142925,18,7717.923003,428.7735,428.7735,133.662009,3,0
0,0,7,7,11,13,24,33,29,62,0.000333,0.094756,10,2842.67675,157.926486,284.267675,86.159464,1,0
0,0,9,9,15,16,31,41,34,75,0.000333,0.123855,14,5201.906126,288.994785,371.564723,122.603359,2,0
0,0,11,11,16,16,32,48,38,86,0.000333,0.143333,16,6880,382.222222,430,128,1,0
0,0,13,13,17,19,36,49,45,94,0.000333,0.161991,16,7775.567202,431.975956,485.97295,150.197491,2,0
0,0,21,21,17,23,40,88,72,160,0.000333,0.283836,24,20436.20388,1135.34466,851.508495,173.528793,2,0
0,0,14,14,17,20,37,56,49,105,0.000333,0.182331,16,8751.881654,486.215647,546.992603,155.92543,2,0
0,0,15,15,17,18,35,62,48,110,0.000333,0.188074,16,9027.53811,501.529895,564.221132,144.545518,2,0
0,0,11,11,16,16,32,49,35,84,0.000333,0.14,16,6720,373.333333,420,128,2,0
0,0,10,10,12,17,29,40,35,75,0.000333,0.12145,12,4372.182896,242.89905,364.348575,112.506418,2,0
0,0,13,13,16,20,36,53,43,96,0.000333,0.165438,16,7941.004802,441.166933,496.3128,150.438562,3,0
0,0,10,10,13,14,27,41,30,71,0.000333,0.112532,12,4051.164152,225.064675,337.597013,101.408685,2,0
0,0,15,15,14,19,33,71,45,116,0.000333,0.19505,14,8192.09605,455.116447,585.149718,134.013592,5,0
0,0,6,6,10,10,20,17,15,32,0.000333,0.046101,5,691.508495,38.417139,138.301699,66.438562,1,0
0,0,19,19,15,23,38,92,60,152,0.000333,0.265895,14,11167.58975,620.421653,797.684982,162.645284,5,0
0,0,26,26,19,48,67,135,93,228,0.000333,0.461023,9,12447.61502,691.534168,1383.068335,348.788823,9,0
0,0,10,10,10,14,24,38,32,70,0.000333,0.106982,10,3209.473751,178.304097,320.947375,86.52225,1,0
0,0,8,8,10,13,23,25,22,47,0.000333,0.070869,5,1063.03706,59.057614,212.607412,81.324997,1,0
0,0,11,11,10,15,25,42,35,77,0.000333,0.119192,10,3575.769266,198.653848,357.576927,91.82264,1,0
0,0,11,11,14,20,34,45,39,84,0.000333,0.142449,7,2991.428151,166.190453,427.346879,139.741531,2,0
0,0,11,11,14,20,34,45,39,84,0.000333,0.142449,7,2991.428151,166.190453,427.346879,139.741531,2,0
0,0,11,11,14,20,34,45,37,82,0.000333,0.139057,7,2920.203671,162.233537,417.171953,139.741531,2,0
0,0,10,10,13,22,35,41,34,75,0.000333,0.128232,6,2308.177358,128.232075,384.696226,146.213212,2,0
0,0,12,12,14,16,30,38,35,73,0.000333,0.119401,14,5014.842189,278.602344,358.203013,117.302969,2,0
0,0,6,6,10,13,23,20,18,38,0.000333,0.057298,5,859.476772,47.74871,171.895354,81.324997,1,0
0,0,7,7,10,14,24,23,23,46,0.000333,0.070303,5,1054.541375,58.585632,210.908275,86.52225,1,0
0,0,6,6,10,11,21,16,16,32,0.000333,0.046851,5,702.770788,39.042822,140.554158,71.273029,1,0
0,0,12,12,14,16,30,38,35,73,0.000333,0.119401,14,5014.842189,278.602344,358.203013,117.302969,2,0
0,0,6,6,10,11,21,21,17,38,0.000333,0.055636,5,834.54031,46.363351,166.908062,71.273029,1,0
0,0,6,6,10,11,21,21,17,38,0.000333,0.055636,5,834.54031,46.363351,166.908062,71.273029,1,0
0,0,14,14,15,17,32,64,46,110,0.000333,0.183333,14,7700,427.777778,550,128.090227,5,0
0,0,8,8,11,10,21,27,21,48,0.000333,0.070277,10,2108.312363,117.128465,210.831236,71.273029,1,0
0,0,34,34,21,53,74,150,110,260,0.000333,0.538153,20,32289.1575,1793.842083,1614.457875,395.81845,11,0
0,0,33,33,21,53,74,149,108,257,0.000333,0.531943,20,31916.5903,1773.143906,1595.829515,395.81845,11,0
0,0,19,19,12,19,31,69,60,129,0.000333,0.21303,18,11503.64383,639.091324,639.091324,123.730173,2,0
0,0,22,22,16,22,38,82,68,150,0.000333,0.262396,24,18892.53905,1049.585503,787.189127,162.107496,3,0
0,0,10,10,15,19,34,44,33,77,0.000333,0.130578,7,2742.142471,152.341248,391.734639,139.313982,2,0
0,0,18,18,19,20,39,70,57,127,0.000333,0.223749,18,12082.42947,671.246082,671.246082,167.149185,3,0
0,0,21,21,15,18,33,76,67,143,0.000333,0.240449,21,15148.31554,841.573086,721.348359,133.662009,2,0
0,0,9,9,13,14,27,37,28,65,0.000333,0.103023,12,3708.812252,206.045125,309.067688,101.408685,2,0
0,0,9,9,14,14,28,38,28,66,0.000333,0.105762,14,4441.995948,246.777553,317.285425,106.605938,2,0
0,0,17,17,15,16,31,64,51,115,0.000333,0.189911,21,11964.38409,664.688005,569.732576,122.603359,2,0
0,0,9,9,13,14,27,37,28,65,0.000333,0.103023,12,3708.812252,206.045125,309.067688,101.408685,2,0
0,0,17,17,16,16,32,65,49,114,0.000333,0.19,24,13680,760,570,128,2,0
0,0,9,9,14,14,28,35,26,61,0.000333,0.09775,7,2052.740552,114.041142,293.24865,106.605938,2,0
0,0,17,17,18,19,37,59,53,112,0.000333,0.194486,18,10502.25799,583.458777,583.458777,155.769273,3,0
0,0,9,9,13,14,27,29,25,54,0.000333,0.085588,6,1540.583551,85.587975,256.763925,101.408685,2,0
0,0,17,17,13,21,34,77,64,141,0.000333,0.239111,18,12911.98069,717.332261,717.332261,140.344382,1,0
0,0,19,19,17,24,41,85,69,154,0.000333,0.275021,16,13201.00814,733.389341,825.063009,179.525968,2,0
0,0,11,11,13,17,30,47,43,90,0.000333,0.147207,12,5299.441843,294.413436,441.620154,117.592585,1,0
0,0,13,13,17,20,37,55,48,103,0.000333,0.178858,16,8585.179147,476.954397,536.573697,155.92543,2,0
0,0,9,9,12,13,25,40,31,71,0.000333,0.109905,12,3956.565474,219.809193,329.713789,91.125266,2,0
0,0,12,12,16,16,32,53,39,92,0.000333,0.153333,16,7360,408.888889,460,128,3,0
0,0,10,10,13,14,27,44,32,76,0.000333,0.120457,12,4336.457402,240.9143,361.37145,101.408685,2,0
0,0,7,7,10,15,25,22,24,46,0.000333,0.071206,5,1068.086924,59.338162,213.617385,91.82264,2,0
0,0,9,9,12,18,30,31,30,61,0.000333,0.099773,6,1795.921958,99.773442,299.320326,118.0782,3,0
0,0,6,6,11,12,23,17,17,34,0.000333,0.051267,5,769.005533,42.72253,153.801107,81.073298,2,0
0,0,16,16,19,22,41,70,53,123,0.000333,0.21966,18,11861.62014,658.978897,658.978897,178.818118,3,0
0,0,5,5,12,13,25,21,20,41,0.000333,0.063466,6,1142.388623,63.466035,190.398104,91.125266,2,0
0,0,17,17,15,20,35,77,59,136,0.000333,0.232527,14,9766.154864,542.564159,697.58249,145.041921,1,0
0,0,28,28,24,46,70,125,87,212,0.000333,0.433136,12,15592.896,866.272,1299.408,364.12295,10,0
0,0,27,27,24,46,70,124,85,209,0.000333,0.427007,12,15372.24181,854.013434,1281.020151,364.12295,10,0
0,0,28,28,24,46,70,125,87,212,0.000333,0.433136,12,15592.896,866.272,1299.408,364.12295,10,0
0,0,27,27,24,46,70,124,85,209,0.000333,0.427007,12,15372.24181,854.013434,1281.020151,364.12295,10,0
0,0,16,16,19,21,40,62,54,116,0.000333,0.205781,18,11112.18586,617.343659,617.343659,172.949289,3,0
0,0,15,15,20,22,42,73,57,130,0.000333,0.233667,20,14020.0253,778.890294,701.001265,184.546058,2,0
0,0,11,11,19,20,39,59,44,103,0.000333,0.181465,18,9799.135714,544.396429,544.396429,167.149185,2,0
0,0,5,5,8,7,15,13,11,24,0.000333,0.031255,4,375.061497,20.83675,93.765374,43.651484,1,0
0,0,5,5,9,8,17,14,12,26,0.000333,0.035425,4,425.096135,23.616452,106.274034,52.529325,1,0
0,0,5,5,9,8,17,14,12,26,0.000333,0.035425,4,425.096135,23.616452,106.274034,52.529325,1,0
0,0,8,8,9,9,18,31,22,53,0.000333,0.073669,8,1768.048201,98.2249,221.006025,57.05865,1,0
0,0,8,8,10,10,20,32,25,57,0.000333,0.082117,10,2463.499014,136.861056,246.349901,66.438562,1,0
0,0,8,8,10,10,20,32,25,57,0.000333,0.082117,10,2463.499014,136.861056,246.349901,66.438562,1,0
0,0,11,11,11,14,25,39,36,75,0.000333,0.116096,10,3482.892142,193.494008,348.289214,91.356717,2,0
0,0,11,11,13,17,30,42,41,83,0.000333,0.135757,12,4887.263033,271.514613,407.271919,117.592585,1,0
0,0,16,16,16,16,32,56,51,107,0.000333,0.178333,24,12840,713.333333,535,128,3,0
0,0,11,11,14,21,35,44,38,82,0.000333,0.1402,7,2944.208452,163.567136,420.601207,145.541635,2,0
0,0,10,10,14,21,35,41,36,77,0.000333,0.131652,7,2764.683546,153.59353,394.954792,145.541635,2,0
0,0,11,11,14,16,30,46,42,88,0.000333,0.143935,14,6045.289214,335.849401,431.806372,117.302969,1,0
0,0,13,13,18,19,37,54,47,101,0.000333,0.175385,18,9470.786219,526.15479,526.15479,155.769273,2,0
0,0,11,11,13,16,29,45,42,87,0.000333,0.140881,12,5071.732159,281.762898,422.644347,112.105716,1,0
0,0,13,13,17,19,36,53,47,100,0.000333,0.172331,16,8271.880002,459.548889,516.9925,150.197491,2,0
0,0,18,18,17,16,33,77,54,131,0.000333,0.220272,24,15859.57511,881.087506,660.81563,133.486868,2,0
0,0,10,10,15,14,29,45,31,76,0.000333,0.123069,14,5168.891779,287.160654,369.206556,111.906328,2,0
0,0,6,6,11,10,21,22,16,38,0.000333,0.055636,5,834.54031,46.363351,166.908062,71.273029,1,0
0,0,6,6,11,10,21,22,16,38,0.000333,0.055636,5,834.54031,46.363351,166.908062,71.273029,1,0
0,0,6,6,11,10,21,22,16,38,0.000333,0.055636,5,834.54031,46.363351,166.908062,71.273029,1,0
0,0,6,6,11,10,21,22,16,38,0.000333,0.055636,5,834.54031,46.363351,166.908062,71.273029,1,0
0,0,10,10,13,16,29,40,32,72,0.000333,0.116592,12,4197.29558,233.183088,349.774632,112.105716,1,0
0,0,7,7,12,12,24,32,23,55,0.000333,0.084058,6,1513.037625,84.057646,252.172938,86.0391,1,0
0,0,7,7,9,10,19,34,27,61,0.000333,0.086375,8,2072.988627,115.166035,259.123578,61.748606,1,0
0,0,7,7,10,11,21,35,28,63,0.000333,0.092239,10,2767.159976,153.73111,276.715998,71.273029,1,0
0,0,6,6,10,11,21,21,17,38,0.000333,0.055636,5,834.54031,46.363351,166.908062,71.273029,1,0
0,0,10,10,14,15,29,33,27,60,0.000333,0.09716,7,2040.352018,113.35289,291.47886,111.906328,2,0
0,0,10,10,14,15,29,33,27,60,0.000333,0.09716,7,2040.352018,113.35289,291.47886,111.906328,2,0
0,0,11,11,14,17,31,36,30,66,0.000333,0.108992,7,2288.838695,127.157705,326.976956,122.789837,2,0
0,0,11,11,14,17,31,36,30,66,0.000333,0.108992,7,2288.838695,127.157705,326.976956,122.789837,2,0
0,0,22,22,18,40,58,98,76,174,0.000333,0.339763,9,9173.598238,509.644347,1019.288693,287.935774,7,0
0,0,18,18,17,18,35,63,58,121,0.000333,0.206881,24,14895.43788,827.524327,620.643245,144.545518,2,0
0,0,20,20,17,19,36,69,66,135,0.000333,0.232647,24,16750.55701,930.5865,697.939875,150.197491,2,0
0,0,17,17,18,17,35,62,52,114,0.000333,0.194913,27,15787.93313,877.107396,584.738264,144.545518,2,0
0,0,9,9,13,14,27,29,25,54,0.000333,0.085588,6,1540.583551,85.587975,256.763925,101.408685,2,0
0,0,19,19,16,17,33,75,61,136,0.000333,0.228679,24,16464.90241,914.7168,686.0376,133.486868,3,0
0,0,22,22,19,19,38,88,69,157,0.000333,0.274642,27,22245.96473,1235.886929,823.92462,161.421246,4,0
0,0,10,10,14,14,28,42,30,72,0.000333,0.115377,14,4845.813761,269.211876,346.129554,106.605938,2,0
0,0,19,19,16,17,33,75,61,136,0.000333,0.228679,24,16464.90241,914.7168,686.0376,133.486868,3,0
0,0,22,22,19,19,38,88,69,157,0.000333,0.274642,27,22245.96473,1235.886929,823.92462,161.421246,4,0
0,0,10,10,14,14,28,42,30,72,0.000333,0.115377,14,4845.813761,269.211876,346.129554,106.605938,2,0
0,0,14,14,18,15,33,55,41,96,0.000333,0.161421,18,8716.713038,484.261835,484.261835,133.662009,2,0
0,0,9,9,11,15,26,47,38,85,0.000333,0.133179,10,3995.37376,221.965209,399.537376,96.657107,1,0
0,0,8,8,10,12,22,40,30,70,0.000333,0.104053,10,3121.602133,173.422341,312.160213,76.238831,1,0
0,0,9,9,12,16,28,48,39,87,0.000333,0.139413,12,5018.878539,278.826585,418.239878,107.01955,1,0
0,0,3,3,9,8,17,12,10,22,0.000333,0.029975,4,359.69673,19.983152,89.924183,52.529325,1,0
0,0,3,3,9,9,18,12,11,23,0.000333,0.031969,4,383.6331,21.31295,95.908275,57.05865,1,0
0,0,7,7,12,13,25,28,27,55,0.000333,0.085137,12,3064.945085,170.274727,255.41209,91.125266,1,0
0,0,3,3,9,9,18,12,11,23,0.000333,0.031969,4,383.6331,21.31295,95.908275,57.05865,1,0
0,0,7,7,13,13,26,30,27,57,0.000333,0.089308,12,3215.100767,178.616709,267.925064,96.211433,1,0
0,0,10,10,13,15,28,32,30,62,0.000333,0.099352,12,3576.672062,198.704003,298.056005,106.709075,2,0
0,0,10,10,12,15,27,31,30,61,0.000333,0.096683,12,3480.577652,193.365425,290.048138,101.622909,2,0
0,0,7,7,10,14,24,23,20,43,0.000333,0.065718,5,985.766938,54.76483,197.153388,86.52225,1,0
0,0,17,17,15,20,35,77,59,136,0.000333,0.232527,14,9766.154864,542.564159,697.58249,145.041921,1,0
0,0,9,9,15,11,26,33,26,59,0.000333,0.092442,14,3882.563207,215.697956,277.325943,96.657107,3,0
0,0,9,9,14,13,27,31,25,56,0.000333,0.088758,7,1863.915901,103.550883,266.2737,101.408685,2,0
0,0,10,10,15,13,28,40,29,69,0.000333,0.110569,14,4643.904855,257.994714,331.70749,106.709075,1,0
0,0,17,17,14,16,30,67,52,119,0.000333,0.19464,21,12262.3196,681.239978,583.919981,117.302969,2,0
0,0,20,20,18,18,36,80,60,140,0.000333,0.241263,27,19542.31651,1085.68425,723.7895,150.1173,3,0
0,0,10,10,14,14,28,42,30,72,0.000333,0.115377,14,4845.813761,269.211876,346.129554,106.605938,2,0
0,0,12,12,13,20,33,47,37,84,0.000333,0.141243,6,2542.374636,141.243035,423.729106,134.544278,5,0
0,0,9,9,12,17,29,36,30,66,0.000333,0.106876,6,1923.760474,106.875582,320.626746,112.506418,4,0
0,0,6,6,11,12,23,17,17,34,0.000333,0.051267,5,769.005533,42.72253,153.801107,81.073298,2,0
0,0,15,15,15,21,36,64,46,110,0.000333,0.189564,14,7961.684502,442.315806,568.69175,150.842025,4,0
0,0,12,12,14,18,32,53,39,92,0.000333,0.153333,14,6440,357.777778,460,128.361619,3,0
0,0,9,9,12,12,24,34,27,61,0.000333,0.093228,12,3356.192551,186.455142,279.682713,86.0391,1,0
0,0,11,11,17,14,31,44,31,75,0.000333,0.123855,16,5945.035572,330.279754,371.564723,122.789837,2,0
0,0,11,11,16,14,30,43,31,74,0.000333,0.121037,16,5809.758465,322.764359,363.109904,117.302969,2,0
0,0,11,11,16,14,30,43,30,73,0.000333,0.119401,16,5731.248216,318.402679,358.203013,117.302969,2,0
0,0,11,11,16,14,30,43,30,73,0.000333,0.119401,16,5731.248216,318.402679,358.203013,117.302969,2,0
0,0,7,7,8,8,16,19,18,37,0.000333,0.049333,8,1184,65.777778,148,48,1,0
0,0,7,7,10,10,20,21,20,41,0.000333,0.059066,10,1771.990519,98.443918,177.199052,66.438562,1,0
0,0,11,11,17,20,37,47,41,88,0.000333,0.152811,16,7334.910339,407.495019,458.431896,155.92543,2,0
0,0,27,27,19,48,67,137,99,236,0.000333,0.477199,18,25768.74688,1431.597049,1431.597049,348.788823,11,0
0,0,26,26,19,48,67,136,97,233,0.000333,0.471133,18,25441.17807,1413.398781,1413.398781,348.788823,11,0
0,0,13,13,12,17,29,49,42,91,0.000333,0.147359,12,5304.915247,294.717514,442.076271,112.506418,2,0
0,0,16,16,16,20,36,62,50,112,0.000333,0.193011,16,9264.505603,514.694756,579.0316,150.438562,3,0
0,0,27,27,19,47,66,122,90,212,0.000333,0.427137,9,11532.70398,640.705777,1281.411553,341.776299,11,0
0,0,26,26,19,47,66,121,88,209,0.000333,0.421093,9,11369.50534,631.639185,1263.278371,341.776299,11,0
0,0,13,13,13,17,30,50,42,92,0.000333,0.150478,12,5417.207218,300.955957,451.433935,117.592585,2,0
0,0,16,16,17,20,37,63,50,113,0.000333,0.196223,16,9418.691685,523.260649,588.66823,155.92543,3,0
0,0,13,13,15,18,33,52,48,100,0.000333,0.168146,14,7062.151767,392.341765,504.439412,133.662009,2,0
0,0,15,15,19,21,40,60,53,113,0.000333,0.200459,18,10824.80175,601.377875,601.377875,172.949289,3,0
0,0,22,22,15,22,37,91,80,171,0.000333,0.296939,21,18707.14704,1039.285946,890.816526,156.710855,2,0
0,0,24,24,19,24,43,99,85,184,0.000333,0.332811,27,26957.6833,1497.649072,998.432715,190.749723,3,0
0,0,11,11,15,13,28,38,31,69,0.000333,0.110569,14,4643.904855,257.994714,331.70749,106.709075,2,0
0,0,11,11,15,13,28,38,31,69,0.000333,0.110569,14,4643.904855,257.994714,331.70749,106.709075,2,0
0,0,7,7,9,10,19,34,27,61,0.000333,0.086375,8,2072.988627,115.166035,259.123578,61.748606,1,0
0,0,7,7,11,11,22,36,29,65,0.000333,0.096621,10,2898.630552,161.035031,289.863055,76.107496,1,0
0,0,11,11,16,20,36,46,41,87,0.000333,0.149928,16,7196.535602,399.807533,449.783475,150.438562,2,0
0,0,12,12,15,22,37,52,45,97,0.000333,0.168439,14,7074.437671,393.024315,505.316976,156.710855,3,0
0,0,30,30,24,44,68,180,124,304,0.000333,0.616863,24,44414.12889,2467.451605,1850.588704,350.254091,10,0
0,0,52,52,26,85,111,308,218,526,0.000333,1.191288,26,92920.43139,5162.246188,3573.862746,667.009662,20,0
0,0,13,13,16,33,49,89,60,149,0.000333,0.278864,8,6692.734134,371.818563,836.591767,230.465006,7,0
0,0,13,13,13,14,27,57,39,96,0.000333,0.152156,12,5477.630402,304.3128,456.4692,101.408685,2,0
0,0,16,16,16,16,32,70,47,117,0.000333,0.195,16,9360,520,585,128,3,0
0,0,13,13,13,13,26,57,39,96,0.000333,0.150414,18,8122.359833,451.242213,451.242213,96.211433,2,0
0,0,16,16,16,15,31,70,47,117,0.000333,0.193214,24,13911.38324,772.854624,579.640968,122.603359,3,0
0,0,11,11,11,14,25,38,30,68,0.000333,0.105261,10,3157.822209,175.434567,315.782221,91.356717,2,0
0,0,14,14,15,17,32,51,38,89,0.000333,0.148333,14,6230,346.111111,445,128.090227,3,0
0,0,10,10,14,15,29,40,29,69,0.000333,0.111734,7,2346.404821,130.355823,335.200689,111.906328,2,0
0,0,13,13,13,15,28,50,44,94,0.000333,0.15063,12,5422.696352,301.260908,451.891363,106.709075,2,0
0,0,15,15,16,17,33,58,49,107,0.000333,0.179917,16,8636.002732,479.77793,539.750171,133.486868,3,0
0,0,13,13,13,15,28,50,44,94,0.000333,0.15063,12,5422.696352,301.260908,451.891363,106.709075,2,0
0,0,15,15,16,17,33,58,49,107,0.000333,0.179917,16,8636.002732,479.77793,539.750171,133.486868,3,0
0,0,14,14,16,18,34,59,47,106,0.000333,0.179757,16,8628.336979,479.352054,539.271061,139.05865,2,0
0,0,10,10,15,16,31,46,34,80,0.000333,0.132112,14,5548.699868,308.261104,396.335705,122.603359,2,0
0,0,17,17,15,20,35,64,50,114,0.000333,0.194913,14,8186.335695,454.796428,584.738264,145.041921,2,0
0,0,17,17,16,20,36,65,53,118,0.000333,0.20335,16,9760.818403,542.267689,610.05115,150.438562,2,0
0,0,21,21,16,21,37,84,67,151,0.000333,0.262209,24,18879.059,1048.836611,786.627458,156.238666,2,0
0,0,10,10,15,17,32,47,35,82,0.000333,0.136667,14,5740,318.888889,410,128.090227,2,0
0,0,6,6,11,10,21,22,16,38,0.000333,0.055636,5,834.54031,46.363351,166.908062,71.273029,1,0
0,0,6,6,11,10,21,22,16,38,0.000333,0.055636,5,834.54031,46.363351,166.908062,71.273029,1,0
0,0,8,8,15,16,31,31,23,54,0.000333,0.089176,7,1872.686205,104.038123,267.526601,122.603359,2,0
0,0,14,14,13,14,27,58,41,99,0.000333,0.156911,12,5648.806353,313.822575,470.733863,101.408685,2,0
0,0,17,17,16,16,32,71,49,120,0.000333,0.2,24,14400,800,600,128,3,0
0,0,10,10,15,14,29,45,31,76,0.000333,0.123069,14,5168.891779,287.160654,369.206556,111.906328,2,0
0,0,14,14,13,14,27,58,41,99,0.000333,0.156911,12,5648.806353,313.822575,470.733863,101.408685,2,0
0,0,17,17,16,16,32,71,49,120,0.000333,0.2,24,14400,800,600,128,3,0
0,0,10,10,15,14,29,45,31,76,0.000333,0.123069,14,5168.891779,287.160654,369.206556,111.906328,2,0
0,0,16,16,14,16,30,63,44,107,0.000333,0.175012,14,7350.522112,408.36234,525.037294,117.302969,2,0
0,0,19,19,17,18,35,76,52,128,0.000333,0.218849,16,10504.77162,583.598423,656.548226,144.545518,3,0
0,0,10,10,15,14,29,45,31,76,0.000333,0.123069,14,5168.891779,287.160654,369.206556,111.906328,2,0
0,0,16,16,14,15,29,63,44,107,0.000333,0.173268,14,7277.255531,404.291974,519.803966,111.906328,2,0
0,0,19,19,17,17,34,76,52,128,0.000333,0.217065,24,15628.68585,868.260325,651.195244,138.973737,3,0
0,0,10,10,15,14,29,45,31,76,0.000333,0.123069,14,5168.891779,287.160654,369.206556,111.906328,2,0
0,0,10,10,15,14,29,38,31,69,0.000333,0.111734,14,4692.809641,260.711647,335.200689,111.906328,2,0
0,0,11,11,14,15,29,36,34,70,0.000333,0.113353,14,4760.821375,264.490076,340.05867,111.906328,2,0
0,0,11,11,14,15,29,36,34,70,0.000333,0.113353,14,4760.821375,264.490076,340.05867,111.906328,2,0
0,0,11,11,16,17,33,48,37,85,0.000333,0.142925,16,6860.376002,381.132,428.7735,133.486868,2,0
0,0,18,18,19,20,39,70,59,129,0.000333,0.227272,18,12272.70395,681.816886,681.816886,167.149185,3,0
0,0,11,11,16,17,33,48,37,85,0.000333,0.142925,16,6860.376002,381.132,428.7735,133.486868,2,0
0,0,16,16,17,19,36,63,50,113,0.000333,0.194734,16,9347.224403,519.290245,584.201525,150.197491,2,0
0,0,11,11,16,17,33,48,37,85,0.000333,0.142925,16,6860.376002,381.132,428.7735,133.486868,2,0
0,0,13,13,13,14,27,57,39,96,0.000333,0.152156,12,5477.630402,304.3128,456.4692,101.408685,2,0
0,0,16,16,16,16,32,70,47,117,0.000333,0.195,16,9360,520,585,128,3,0
0,0,10,10,15,15,30,47,32,79,0.000333,0.129215,14,5427.020999,301.501167,387.644357,117.206718,2,0
0,0,13,13,13,14,27,57,39,96,0.000333,0.152156,12,5477.630402,304.3128,456.4692,101.408685,2,0
0,0,16,16,16,16,32,70,47,117,0.000333,0.195,16,9360,520,585,128,3,0
0,0,10,10,15,15,30,47,32,79,0.000333,0.129215,14,5427.020999,301.501167,387.644357,117.206718,2,0
0,0,5,5,11,12,23,20,19,39,0.000333,0.058806,5,882.094581,49.005255,176.418916,81.073298,2,0
0,0,15,15,19,20,39,59,46,105,0.000333,0.184989,18,9989.410194,554.967233,554.967233,167.149185,4,0
0,0,5,5,12,13,25,21,20,41,0.000333,0.063466,6,1142.388623,63.466035,190.398104,91.125266,2,0
0,0,15,15,19,20,39,58,46,104,0.000333,0.183227,18,9894.272954,549.681831,549.681831,167.149185,4,0
0,0,5,5,12,13,25,21,20,41,0.000333,0.063466,6,1142.388623,63.466035,190.398104,91.125266,2,0
0,0,13,13,19,17,36,50,41,91,0.000333,0.156821,18,8468.337152,470.463175,470.463175,150.197491,3,0
0,0,13,13,18,17,35,49,41,90,0.000333,0.153878,18,8309.438487,461.635472,461.635472,144.545518,3,0
0,0,13,13,19,16,35,50,41,91,0.000333,0.155588,18,8401.765582,466.764755,466.764755,144.710623,3,0
0,0,13,13,18,16,34,49,41,90,0.000333,0.152624,18,8241.689803,457.871656,457.871656,139.05865,3,0
0,0,12,12,17,15,32,46,39,85,0.000333,0.141667,16,6800,377.777778,425,128.090227,2,0
0,0,6,6,10,11,21,21,17,38,0.000333,0.055636,5,834.54031,46.363351,166.908062,71.273029,1,0
0,0,9,9,13,13,26,42,28,70,0.000333,0.109677,12,3948.369363,219.353854,329.03078,96.211433,2,0
0,0,9,9,13,13,26,42,28,70,0.000333,0.109677,12,3948.369363,219.353854,329.03078,96.211433,2,0
0,0,13,13,14,14,28,58,40,98,0.000333,0.15704,14,6595.690953,366.427275,471.120782,106.605938,2,0
0,0,16,16,16,16,32,71,48,119,0.000333,0.198333,24,14280,793.333333,595,128,3,0
0,0,10,10,15,15,30,47,32,79,0.000333,0.129215,14,5427.020999,301.501167,387.644357,117.206718,2,0
0,0,13,13,13,14,27,57,40,97,0.000333,0.153741,12,5534.689053,307.482725,461.224088,101.408685,2,0
0,0,16,16,16,16,32,70,48,118,0.000333,0.196667,24,14160,786.666667,590,128,3,0
0,0,10,10,15,15,30,47,32,79,0.000333,0.129215,14,5427.020999,301.501167,387.644357,117.206718,2,0
0,0,9,9,14,14,28,40,33,73,0.000333,0.116979,14,4913.11673,272.950929,350.936909,106.605938,1,0
0,0,5,5,12,12,24,26,20,46,0.000333,0.070303,6,1265.44965,70.302758,210.908275,86.0391,1,0
0,0,8,8,13,14,27,25,22,47,0.000333,0.074493,6,1340.878276,74.493238,223.479713,101.408685,2,0
0,0,8,8,13,14,27,25,22,47,0.000333,0.074493,6,1340.878276,74.493238,223.479713,101.408685,2,0
0,0,8,8,13,14,27,25,22,47,0.000333,0.074493,6,1340.878276,74.493238,223.479713,101.408685,2,0
0,0,8,8,13,14,27,25,22,47,0.000333,0.074493,6,1340.878276,74.493238,223.479713,101.408685,2,0
0,0,11,11,13,13,26,44,32,76,0.000333,0.119078,12,4286.801023,238.155612,357.233419,96.211433,1,0
0,0,5,5,10,10,20,22,17,39,0.000333,0.056185,5,842.775979,46.820888,168.555196,66.438562,1,0
0,0,10,10,14,14,28,39,28,67,0.000333,0.107364,14,4509.298917,250.516606,322.09278,106.605938,2,0
0,0,10,10,13,14,27,38,28,66,0.000333,0.104608,12,3765.870902,209.21505,313.822575,101.408685,2,0
0,0,29,29,21,44,65,145,89,234,0.000333,0.469745,20,28184.68137,1565.815631,1409.234068,332.453657,10,0
0,0,9,9,14,12,26,34,21,55,0.000333,0.086175,7,1809.669291,100.537183,258.524184,96.322519,2,0
0,0,12,12,13,22,35,49,42,91,0.000333,0.155588,6,2800.588527,155.588252,466.764755,146.213212,3,0
0,0,10,10,10,17,27,32,33,65,0.000333,0.103023,5,1545.338438,85.852135,309.067688,102.706149,1,0
0,0,11,11,14,20,34,49,38,87,0.000333,0.147536,7,3098.26487,172.125826,442.609267,139.741531,3,0
0,0,9,9,11,15,26,32,29,61,0.000333,0.095576,5,1433.634114,79.64634,286.726823,96.657107,1,0
0,0,12,12,14,21,35,58,42,100,0.000333,0.170976,14,7180.996224,398.944235,512.928302,145.541635,3,0
0,0,10,10,11,16,27,41,33,74,0.000333,0.117287,10,3518.616752,195.478708,351.861675,102.053748,1,0
0,0,14,14,14,23,37,63,50,113,0.000333,0.196223,14,8241.355224,457.853068,588.66823,157.344894,3,0
0,0,12,12,12,20,32,46,41,87,0.000333,0.145,12,5220,290,435,129.458112,1,0
0,0,6,6,10,13,23,20,18,38,0.000333,0.057298,5,859.476772,47.74871,171.895354,81.324997,1,0
0,0,6,6,10,13,23,20,18,38,0.000333,0.057298,5,859.476772,47.74871,171.895354,81.324997,1,0
0,0,11,11,12,15,27,41,36,77,0.000333,0.122042,12,4393.516052,244.084225,366.126338,101.622909,1,0
0,0,6,6,10,13,23,20,18,38,0.000333,0.057298,5,859.476772,47.74871,171.895354,81.324997,1,0
0,0,6,6,10,13,23,20,18,38,0.000333,0.057298,5,859.476772,47.74871,171.895354,81.324997,1,0
0,0,6,6,10,13,23,20,18,38,0.000333,0.057298,5,859.476772,47.74871,171.895354,81.324997,1,0
0,0,6,6,10,13,23,20,18,38,0.000333,0.057298,5,859.476772,47.74871,171.895354,81.324997,1,0
0,0,6,6,10,13,23,20,18,38,0.000333,0.057298,5,859.476772,47.74871,171.895354,81.324997,1,0
0,0,13,13,11,14,25,45,45,90,0.000333,0.139316,15,6269.205856,348.289214,417.947057,91.356717,1,0
0,0,10,10,12,15,27,35,30,65,0.000333,0.103023,12,3708.812252,206.045125,309.067688,101.622909,1,0
0,0,10,10,12,12,24,38,31,69,0.000333,0.105454,12,3796.348951,210.908275,316.362413,86.0391,1,0
0,0,3,3,9,8,17,12,11,23,0.000333,0.031337,4,376.046581,20.891477,94.011645,52.529325,1,0
0,0,5,5,10,9,19,16,14,30,0.000333,0.042479,5,637.189127,35.399396,127.437825,61.748606,1,0
0,0,9,9,11,12,23,33,29,62,0.000333,0.093487,10,2804.608413,155.811578,280.460841,81.073298,1,0
0,0,19,19,18,18,36,77,55,132,0.000333,0.227477,27,18425.61271,1023.64515,682.4301,150.1173,4,0
0,0,10,10,14,14,28,42,30,72,0.000333,0.115377,14,4845.813761,269.211876,346.129554,106.605938,2,0
0,0,19,19,18,18,36,77,55,132,0.000333,0.227477,27,18425.61271,1023.64515,682.4301,150.1173,4,0
0,0,10,10,14,14,28,42,30,72,0.000333,0.115377,14,4845.813761,269.211876,346.129554,106.605938,2,0
0,0,22,22,17,21,38,89,70,159,0.000333,0.27814,24,20026.09139,1112.560633,834.420475,161.725534,2,0
0,0,9,9,15,17,32,40,30,70,0.000333,0.116667,7,2450,136.111111,350,128.090227,2,0
0,0,19,19,18,17,35,77,55,132,0.000333,0.225688,27,18280.76467,1015.598037,677.065358,144.545518,4,0
0,0,10,10,14,14,28,42,30,72,0.000333,0.115377,14,4845.813761,269.211876,346.129554,106.605938,2,0
0,0,19,19,18,17,35,77,55,132,0.000333,0.225688,27,18280.76467,1015.598037,677.065358,144.545518,4,0
0,0,10,10,14,14,28,42,30,72,0.000333,0.115377,14,4845.813761,269.211876,346.129554,106.605938,2,0
0,0,18,18,18,17,35,74,54,128,0.000333,0.218849,27,17726.80211,984.822339,656.548226,144.545518,3,0
0,0,10,10,14,14,28,42,30,72,0.000333,0.115377,14,4845.813761,269.211876,346.129554,106.605938,2,0
0,0,13,13,18,18,36,55,49,104,0.000333,0.179224,18,9678.099603,537.6722,537.6722,150.1173,2,0
0,0,13,13,17,18,35,54,49,103,0.000333,0.176105,16,8453.058412,469.614356,528.316151,144.545518,2,0
0,0,16,16,17,16,33,64,42,106,0.000333,0.178235,16,8555.292426,475.294024,534.705777,133.486868,3,0
0,0,16,16,17,16,33,64,42,106,0.000333,0.178235,16,8555.292426,475.294024,534.705777,133.486868,3,0
0,0,4,4,14,9,23,24,17,41,0.000333,0.061822,7,1298.262281,72.125682,185.46604,81.832294,3,0
0,0,33,33,20,55,75,165,111,276,0.000333,0.573051,20,34383.07917,1910.171065,1719.153959,404.413346,10,0
0,0,21,21,17,30,47,100,69,169,0.000333,0.312909,16,15019.60826,834.422681,938.725516,216.693586,6,0
0,0,12,12,14,22,36,47,41,88,0.000333,0.151651,7,3184.673801,176.926322,454.9534,151.410465,2,0
0,0,16,16,14,19,33,71,50,121,0.000333,0.203457,14,8545.203638,474.733535,610.371688,134.013592,6,0
0,0,10,10,14,13,27,34,27,61,0.000333,0.096683,14,4060.673927,225.592996,290.048138,101.408685,2,0
0,0,20,20,14,21,35,83,62,145,0.000333,0.247915,14,10412.44452,578.46914,743.746037,145.541635,6,0
0,0,14,14,14,15,29,46,43,89,0.000333,0.14412,14,6053.04432,336.28024,432.360309,111.906328,2,0
0,0,17,17,16,16,32,72,50,122,0.000333,0.203333,24,14640,813.333333,610,128,3,0
0,0,10,10,15,14,29,45,31,76,0.000333,0.123069,14,5168.891779,287.160654,369.206556,111.906328,2,0
0,0,17,17,16,16,32,71,50,121,0.000333,0.201667,24,14520,806.666667,605,128,3,0
0,0,10,10,15,14,29,45,31,76,0.000333,0.123069,14,5168.891779,287.160654,369.206556,111.906328,2,0
0,0,15,15,12,16,28,52,52,104,0.000333,0.166655,18,8999.368414,499.964912,499.964912,107.01955,1,0
0,0,18,18,16,18,34,64,61,125,0.000333,0.211978,24,15262.38852,847.910474,635.932855,139.05865,2,0
0,0,7,7,9,17,26,24,29,53,0.000333,0.083041,4,996.49322,55.360734,249.123305,98.016193,1,0
0,0,10,10,13,20,33,36,38,74,0.000333,0.124428,6,2239.710989,124.428388,373.285165,134.544278,2,0
0,0,19,19,19,20,39,75,64,139,0.000333,0.24489,27,19836.11453,1102.006363,734.670908,167.149185,3,0
0,0,17,17,18,19,37,67,52,119,0.000333,0.206642,18,11158.64911,619.924951,619.924951,155.769273,4,0
0,0,17,17,17,19,36,66,52,118,0.000333,0.20335,16,9760.818403,542.267689,610.05115,150.197491,4,0
0,0,20,20,18,20,38,80,58,138,0.000333,0.241405,18,13035.85194,724.213997,724.213997,161.497212,4,0
0,0,12,12,14,16,30,53,41,94,0.000333,0.153749,14,6457.468024,358.748224,461.247716,117.302969,3,0
0,0,17,17,17,18,35,66,51,117,0.000333,0.200042,16,9602.017808,533.445434,600.126113,144.545518,4,0
0,0,17,17,17,18,35,66,51,117,0.000333,0.200042,16,9602.017808,533.445434,600.126113,144.545518,4,0
0,0,19,19,18,18,36,71,54,125,0.000333,0.215414,27,17448.49688,969.360938,646.240625,150.1173,4,0
0,0,12,12,14,16,30,53,41,94,0.000333,0.153749,14,6457.468024,358.748224,461.247716,117.302969,3,0
0,0,19,19,18,19,37,71,54,125,0.000333,0.217061,18,11721.27007,651.181671,651.181671,155.769273,4,0
0,0,12,12,14,16,30,53,41,94,0.000333,0.153749,14,6457.468024,358.748224,461.247716,117.302969,3,0
0,0,17,17,17,18,35,66,51,117,0.000333,0.200042,16,9602.017808,533.445434,600.126113,144.545518,4,0
0,0,12,12,14,16,30,53,41,94,0.000333,0.153749,14,6457.468024,358.748224,461.247716,117.302969,3,0
0,0,17,17,17,18,35,66,51,117,0.000333,0.200042,16,9602.017808,533.445434,600.126113,144.545518,4,0
0,0,12,12,14,16,30,53,41,94,0.000333,0.153749,14,6457.468024,358.748224,461.247716,117.302969,3,0
0,0,15,15,19,20,39,75,55,130,0.000333,0.229034,18,12367.84119,687.102288,687.102288,167.149185,2,0
0,0,10,10,19,17,36,52,39,91,0.000333,0.156821,18,8468.337152,470.463175,470.463175,150.197491,2,0
0,0,8,8,13,19,32,34,27,61,0.000333,0.101667,6,1830,101.666667,305,128.816339,2,0
0,0,8,8,13,19,32,34,27,61,0.000333,0.101667,6,1830,101.666667,305,128.816339,2,0
0,0,8,8,13,19,32,34,27,61,0.000333,0.101667,6,1830,101.666667,305,128.816339,2,0
0,0,8,8,13,19,32,34,27,61,0.000333,0.101667,6,1830,101.666667,305,128.816339,2,0
0,0,8,8,13,19,32,34,27,61,0.000333,0.101667,6,1830,101.666667,305,128.816339,2,0
0,0,8,8,13,19,32,34,27,61,0.000333,0.101667,6,1830,101.666667,305,128.816339,2,0
0,0,10,10,15,19,34,36,33,69,0.000333,0.117012,7,2457.244552,136.513586,351.034936,139.313982,2,0
0,0,12,12,14,23,37,52,42,94,0.000333,0.16323,7,3427.820315,190.434462,489.688616,157.344894,4,0
0,0,10,10,14,19,33,35,33,68,0.000333,0.11434,7,2401.131601,133.3962,343.0188,134.013592,2,0
0,0,14,14,14,24,38,58,48,106,0.000333,0.185427,14,7787.92443,432.662468,556.280316,163.342069,4,0
0,0,12,12,14,20,34,41,41,82,0.000333,0.139057,14,5840.407342,324.467075,417.171953,139.741531,2,0
0,0,16,16,14,25,39,64,54,118,0.000333,0.207892,14,8731.484466,485.08247,623.677462,169.399374,4,0
0,0,14,14,14,21,35,47,49,96,0.000333,0.164137,14,6893.756375,382.986465,492.41117,145.541635,2,0
0,0,11,11,15,19,34,39,35,74,0.000333,0.125491,7,2635.305752,146.405875,376.47225,139.313982,2,0
0,0,32,32,20,49,69,140,103,243,0.000333,0.49479,20,29687.42886,1649.301603,1484.371443,361.559344,10,0
0,0,31,31,20,49,69,139,101,240,0.000333,0.488682,20,29320.91739,1628.939855,1466.04587,361.559344,10,0
0,0,26,26,17,45,62,115,85,200,0.000333,0.396946,8,9526.714097,529.261894,1190.839262,316.620258,9,0
0,0,7,7,8,11,19,17,18,35,0.000333,0.049559,4,594.709852,33.039436,148.677463,62.053748,1,0
0,0,32,32,23,51,74,145,108,253,0.000333,0.523664,22,34561.81743,1920.100969,1570.991702,393.335617,11,0
0,0,31,31,23,51,74,144,106,250,0.000333,0.517454,22,34151.99351,1897.332973,1552.363341,393.335617,11,0
0,0,26,26,18,46,64,116,87,203,0.000333,0.406,9,10962,609,1218,329.1425,9,0
0,0,15,15,13,17,30,48,42,90,0.000333,0.147207,12,5299.441843,294.413436,441.620154,117.592585,2,0
0,0,34,34,23,52,75,151,113,264,0.000333,0.548136,22,36176.97895,2009.832164,1644.408134,400.46479,11,0
0,0,10,10,14,20,34,41,35,76,0.000333,0.128882,7,2706.530232,150.362791,386.647176,139.741531,2,0
0,0,20,20,17,29,46,100,66,166,0.000333,0.305637,16,14670.58056,815.032253,916.911285,210.368317,6,0
0,0,11,11,14,21,35,46,38,84,0.000333,0.14362,7,3016.018414,167.556579,430.859773,145.541635,2,0
0,0,21,21,16,29,45,100,69,169,0.000333,0.309374,16,14849.97077,824.998376,928.123173,204.881449,6,0
0,0,12,12,13,21,34,46,43,89,0.000333,0.150928,12,5433.410314,301.856129,452.784193,140.344382,2,0
0,0,23,23,16,30,46,106,75,181,0.000333,0.333255,16,15996.23543,888.679746,999.764714,211.206718,6,0
0,0,14,14,13,22,35,52,51,103,0.000333,0.176105,12,6339.793809,352.210767,528.316151,146.213212,2,0
0,0,15,15,14,19,33,70,45,115,0.000333,0.193368,14,8121.474532,451.19303,580.105324,134.013592,5,0
0,0,6,6,10,10,20,16,16,32,0.000333,0.046101,5,691.508495,38.417139,138.301699,66.438562,1,0
0,0,19,19,16,28,44,94,63,157,0.000333,0.28571,16,13714.09223,761.894013,857.130764,198.605938,6,0
0,0,10,10,13,20,33,40,35,75,0.000333,0.12611,6,2269.977354,126.109853,378.329559,134.544278,2,0
0,0,21,21,17,30,47,109,70,179,0.000333,0.331424,16,15908.34247,883.796804,994.271404,216.693586,6,0
0,0,12,12,14,22,36,55,42,97,0.000333,0.167161,7,3510.379076,195.02106,501.482725,151.410465,2,0
0,0,8,8,13,13,26,30,28,58,0.000333,0.090875,12,3271.506044,181.750336,272.625504,96.211433,2,0
0,0,8,8,14,13,27,34,30,64,0.000333,0.101438,14,4260.379202,236.687733,304.3128,101.408685,3,0
0,0,13,13,18,19,37,54,47,101,0.000333,0.175385,18,9470.786219,526.15479,526.15479,155.769273,2,0
0,0,10,10,14,21,35,44,32,76,0.000333,0.129942,7,2728.778565,151.598809,389.825509,145.541635,4,0
0,0,11,11,14,21,35,45,34,79,0.000333,0.135071,7,2836.493508,157.582973,405.213358,145.541635,4,0
0,0,8,8,14,18,32,29,25,54,0.000333,0.09,7,1890,105,270,128.361619,2,0
0,0,8,8,14,18,32,29,25,54,0.000333,0.09,7,1890,105,270,128.361619,2,0
0,0,16,16,14,17,31,58,53,111,0.000333,0.183305,21,11548.2316,641.568422,549.91579,122.789837,2,0
0,0,10,10,14,14,28,40,29,69,0.000333,0.110569,14,4643.904855,257.994714,331.70749,106.605938,2,0
0,0,18,18,16,17,33,63,52,115,0.000333,0.193368,24,13922.52777,773.473765,580.105324,133.486868,2,0
0,0,10,10,14,14,28,40,29,69,0.000333,0.110569,14,4643.904855,257.994714,331.70749,106.605938,2,0
0,0,4,4,14,12,26,32,18,50,0.000333,0.078341,7,1645.153901,91.397439,235.021986,96.322519,2,0
0,0,17,17,15,22,37,77,68,145,0.000333,0.25179,21,15862.7855,881.265861,755.370738,156.710855,1,0
0,0,11,11,16,18,34,49,45,94,0.000333,0.159407,16,7651.544113,425.085784,478.221507,139.05865,1,0
0,0,16,16,18,16,34,64,42,106,0.000333,0.179757,18,9706.879101,539.271061,539.271061,139.05865,3,0
0,0,11,11,16,14,30,48,32,80,0.000333,0.13085,16,6280.819962,348.934442,392.551248,117.302969,2,0
0,0,16,16,18,16,34,64,42,106,0.000333,0.179757,18,9706.879101,539.271061,539.271061,139.05865,3,0
0,0,11,11,16,14,30,48,32,80,0.000333,0.13085,16,6280.819962,348.934442,392.551248,117.302969,2,0
0,0,16,16,17,17,34,65,43,108,0.000333,0.183149,16,8791.13579,488.396433,549.445987,138.973737,3,0
0,0,11,11,16,14,30,48,32,80,0.000333,0.13085,16,6280.819962,348.934442,392.551248,117.302969,2,0
0,0,16,16,17,17,34,64,43,107,0.000333,0.181453,16,8709.736384,483.874244,544.358524,138.973737,3,0
0,0,11,11,16,14,30,48,32,80,0.000333,0.13085,16,6280.819962,348.934442,392.551248,117.302969,2,0
0,0,12,12,14,16,30,54,39,93,0.000333,0.152114,14,6388.771555,354.931753,456.340825,117.302969,5,0
0,0,10,10,14,15,29,48,35,83,0.000333,0.134404,14,5644.973916,313.609662,403.212423,111.906328,5,0
0,0,6,6,10,10,20,17,16,33,0.000333,0.047541,5,713.118136,39.617674,142.623627,66.438562,2,0
0,0,6,6,11,9,20,17,15,32,0.000333,0.046101,5,691.508495,38.417139,138.301699,66.583073,1,0
0,0,10,10,15,13,28,35,27,62,0.000333,0.099352,14,4172.784072,231.821337,298.056005,106.709075,2,0
0,0,40,40,19,53,72,183,125,308,0.000333,0.633446,18,34206.06421,1900.3369,1900.3369,384.290407,12,0
0,0,25,25,15,25,40,105,73,178,0.000333,0.315768,14,13262.24481,736.791378,947.303201,174.699764,6,0
0,0,16,16,14,16,30,52,51,103,0.000333,0.16847,21,10613.60436,589.644687,505.409731,117.302969,2,0
0,0,36,36,19,52,71,180,114,294,0.000333,0.602675,18,32544.46176,1808.025653,1808.025653,377.133488,12,0
0,0,21,21,16,24,40,102,62,164,0.000333,0.290932,16,13964.73932,775.818851,872.796208,174.0391,6,0
0,0,12,12,15,15,30,49,34,83,0.000333,0.135757,14,5701.806872,316.767048,407.271919,117.206718,2,0
0,0,8,8,10,16,26,27,25,52,0.000333,0.081474,5,1222.114327,67.89524,244.422865,97.219281,1,0
0,0,7,7,10,14,24,23,20,43,0.000333,0.065718,5,985.766938,54.76483,197.153388,86.52225,1,0
0,0,8,8,10,14,24,26,24,50,0.000333,0.076416,5,1146.240625,63.680035,229.248125,86.52225,1,0
0,0,10,10,15,13,28,40,29,69,0.000333,0.110569,14,4643.904855,257.994714,331.70749,106.709075,1,0
0,0,11,11,16,14,30,43,30,73,0.000333,0.119401,16,5731.248216,318.402679,358.203013,117.302969,2,0
0,0,16,16,15,17,32,57,52,109,0.000333,0.181667,21,11445,635.833333,545,128.090227,3,0
0,0,18,18,18,19,37,65,57,122,0.000333,0.211851,27,17159.93939,953.329966,635.553311,155.769273,4,0
0,0,16,16,15,17,32,57,52,109,0.000333,0.181667,21,11445,635.833333,545,128.090227,3,0
0,0,18,18,18,19,37,65,57,122,0.000333,0.211851,27,17159.93939,953.329966,635.553311,155.769273,4,0
0,0,16,16,16,18,34,58,53,111,0.000333,0.188236,16,9035.334006,501.963,564.708375,139.05865,3,0
0,0,18,18,18,20,38,66,58,124,0.000333,0.216914,18,11713.37421,650.743012,650.743012,161.497212,4,0
0,0,16,16,15,18,33,57,53,110,0.000333,0.184961,14,7768.366944,431.575941,554.883353,133.662009,3,0
0,0,18,18,18,20,38,65,58,123,0.000333,0.215165,18,11618.91152,645.495084,645.495084,161.497212,4,0
0,0,16,16,16,18,34,58,53,111,0.000333,0.188236,16,9035.334006,501.963,564.708375,139.05865,3,0
0,0,18,18,18,20,38,66,58,124,0.000333,0.216914,18,11713.37421,650.743012,650.743012,161.497212,4,0
0,0,16,16,15,18,33,57,53,110,0.000333,0.184961,14,7768.366944,431.575941,554.883353,133.662009,3,0
0,0,18,18,18,20,38,65,58,123,0.000333,0.215165,18,11618.91152,645.495084,645.495084,161.497212,4,0
0,0,8,8,11,14,25,28,26,54,0.000333,0.083589,5,1253.841171,69.657843,250.768234,91.356717,1,0
0,0,12,12,13,16,29,47,37,84,0.000333,0.136023,12,4896.844843,272.046936,408.070404,112.105716,2,0
0,0,15,15,17,18,35,60,45,105,0.000333,0.179525,16,8617.195468,478.733082,538.574717,144.545518,3,0
0,0,7,7,12,13,25,31,25,56,0.000333,0.086685,6,1560.33568,86.685316,260.055947,91.125266,2,0
0,0,16,16,12,18,30,63,59,122,0.000333,0.199547,18,10775.53175,598.640653,598.640653,118.0782,2,0
0,0,19,19,16,21,37,76,67,143,0.000333,0.248317,24,17878.84395,993.269108,744.951831,156.238666,3,0
0,0,7,7,12,14,26,31,26,57,0.000333,0.089308,6,1607.550384,89.308355,267.925064,96.322519,2,0
0,0,12,12,16,17,33,56,40,96,0.000333,0.161421,16,7748.189367,430.454965,484.261835,133.486868,3,0
0,0,7,7,11,12,23,28,23,51,0.000333,0.076901,5,1153.508299,64.083794,230.70166,81.073298,2,0
0,0,7,7,12,13,25,29,24,53,0.000333,0.082041,6,1476.746268,82.041459,246.124378,91.125266,2,0
0,0,12,12,17,17,34,54,38,92,0.000333,0.156016,16,7488.745302,416.041406,468.046581,138.973737,3,0
0,0,8,8,14,18,32,29,25,54,0.000333,0.09,7,1890,105,270,128.361619,2,0
0,0,8,8,14,18,32,29,25,54,0.000333,0.09,7,1890,105,270,128.361619,2,0
0,0,17,17,15,20,35,68,63,131,0.000333,0.223979,21,14110.65758,783.925421,671.936075,145.041921,2,0
0,0,11,11,15,17,32,50,39,89,0.000333,0.148333,14,6230,346.111111,445,128.090227,2,0
0,0,13,13,13,17,30,50,42,92,0.000333,0.150478,12,5417.207218,300.955957,451.433935,117.592585,2,0
0,0,16,16,17,20,37,63,50,113,0.000333,0.196223,16,9418.691685,523.260649,588.66823,155.92543,3,0
0,0,8,8,10,14,24,26,26,52,0.000333,0.079473,5,1192.09025,66.227236,238.41805,86.52225,1,0
0,0,11,11,13,15,28,49,39,88,0.000333,0.141016,12,5076.566798,282.031489,423.047233,106.709075,1,0
0,0,14,14,17,18,35,62,47,109,0.000333,0.186364,16,8945.469582,496.970532,559.091849,144.545518,2,0
0,0,10,10,16,16,32,49,34,83,0.000333,0.138333,16,6640,368.888889,415,128,2,0
0,0,4,4,11,11,22,22,16,38,0.000333,0.056486,5,847.292008,47.071778,169.458402,76.107496,2,0
0,0,8,8,11,13,24,28,24,52,0.000333,0.079473,5,1192.09025,66.227236,238.41805,86.159464,2,0
0,0,8,8,14,18,32,29,25,54,0.000333,0.09,7,1890,105,270,128.361619,2,0
0,0,8,8,14,18,32,29,25,54,0.000333,0.09,7,1890,105,270,128.361619,2,0
0,0,10,10,14,19,33,41,32,73,0.000333,0.122747,7,2577.685395,143.204744,368.240771,134.013592,2,0
0,0,13,13,17,16,33,50,39,89,0.000333,0.14965,16,7183.217226,399.067624,448.951077,133.486868,2,0
0,0,7,7,10,12,22,20,18,38,0.000333,0.056486,5,847.292008,47.071778,169.458402,76.238831,3,0
0,0,7,7,10,13,23,22,22,44,0.000333,0.066346,5,995.18363,55.287979,199.036726,81.324997,1,0
0,0,9,9,12,16,28,31,28,59,0.000333,0.094545,6,1701.803642,94.544647,283.63394,107.01955,2,0
0,0,6,6,11,9,20,17,15,32,0.000333,0.046101,5,691.508495,38.417139,138.301699,66.583073,1,0
0,0,14,14,15,16,31,52,52,104,0.000333,0.171745,21,10819.96474,601.109152,515.236416,122.603359,1,0
0,0,9,9,14,13,27,43,29,72,0.000333,0.114117,14,4792.926602,266.2737,342.3519,101.408685,2,0
0,0,9,9,13,13,26,42,29,71,0.000333,0.111244,12,4004.77464,222.48748,333.73122,96.211433,2,0
0,0,8,8,14,14,28,34,30,64,0.000333,0.102557,14,4307.39001,239.299445,307.670715,106.605938,1,0
0,0,11,11,15,14,29,45,32,77,0.000333,0.124688,14,5236.903513,290.939084,374.064537,111.906328,2,0
0,0,12,12,14,14,28,52,42,94,0.000333,0.15063,21,9489.718616,527.20659,451.891363,106.605938,2,0
0,0,12,12,14,14,28,52,42,94,0.000333,0.15063,21,9489.718616,527.20659,451.891363,106.605938,2,0
0,0,9,9,13,13,26,42,28,70,0.000333,0.109677,12,3948.369363,219.353854,329.03078,96.211433,2,0
0,0,9,9,13,12,25,42,28,70,0.000333,0.108357,12,3900.839199,216.713289,325.069933,91.125266,2,0
0,0,22,22,17,39,56,97,73,170,0.000333,0.329083,8,7898.002694,438.777927,987.250337,275.617555,7,0
0,0,22,22,18,40,58,98,76,174,0.000333,0.339763,9,9173.598238,509.644347,1019.288693,287.935774,7,0
0,0,10,10,11,14,25,34,32,66,0.000333,0.102165,10,3064.945085,170.274727,306.494509,91.356717,1,0
0,0,13,13,15,17,32,47,40,87,0.000333,0.145,14,6090,338.333333,435,128.090227,2,0
0,0,15,15,16,19,35,57,48,105,0.000333,0.179525,16,8617.195468,478.733082,538.574717,144.710623,2,0
0,0,5,5,12,12,24,22,17,39,0.000333,0.059605,6,1072.881225,59.604513,178.813538,86.0391,1,0
0,0,8,8,15,15,30,35,25,60,0.000333,0.098138,7,2060.89405,114.494114,294.413436,117.206718,2,0
0,0,13,13,15,19,34,56,47,103,0.000333,0.17467,14,7336.121417,407.562301,524.008673,139.313982,3,0
0,0,6,6,11,10,21,22,16,38,0.000333,0.055636,5,834.54031,46.363351,166.908062,71.273029,1,0
0,0,15,15,16,17,33,56,39,95,0.000333,0.159739,16,7667.479061,425.971059,479.217441,133.486868,3,0
0,0,10,10,15,14,29,39,28,67,0.000333,0.108495,14,4556.786173,253.154787,325.484727,111.906328,2,0
0,0,15,15,16,17,33,55,39,94,0.000333,0.158058,16,7586.768756,421.487153,474.173047,133.486868,3,0
0,0,10,10,15,14,29,39,28,67,0.000333,0.108495,14,4556.786173,253.154787,325.484727,111.906328,2,0
0,0,17,17,17,17,34,60,41,101,0.000333,0.171278,16,8221.339951,456.741108,513.833747,138.973737,3,0
0,0,10,10,15,14,29,39,28,67,0.000333,0.108495,14,4556.786173,253.154787,325.484727,111.906328,2,0
0,0,17,17,17,17,34,60,41,101,0.000333,0.171278,16,8221.339951,456.741108,513.833747,138.973737,3,0
0,0,10,10,15,14,29,39,28,67,0.000333,0.108495,14,4556.786173,253.154787,325.484727,111.906328,2,0
0,0,12,12,9,16,25,42,49,91,0.000333,0.140864,12,5071.090959,281.727276,422.590913,92.529325,1,0
0,0,15,15,13,19,32,54,58,112,0.000333,0.186667,18,10080,560,560,128.816339,2,0
0,0,11,11,11,20,31,39,38,77,0.000333,0.127158,5,1907.365579,105.964754,381.473116,124.49231,1,0
0,0,10,10,10,17,27,32,33,65,0.000333,0.103023,5,1545.338438,85.852135,309.067688,102.706149,1,0
0,0,10,10,12,16,28,39,39,78,0.000333,0.124991,12,4499.684207,249.982456,374.973684,107.01955,1,0
0,0,13,13,16,19,35,51,48,99,0.000333,0.169266,16,8124.784299,451.376905,507.799019,144.710623,2,0
0,0,17,17,16,16,32,71,49,120,0.000333,0.2,24,14400,800,600,128,3,0
0,0,10,10,15,14,29,45,31,76,0.000333,0.123069,14,5168.891779,287.160654,369.206556,111.906328,2,0
0,0,17,17,16,16,32,71,49,120,0.000333,0.2,24,14400,800,600,128,3,0
0,0,10,10,15,14,29,45,31,76,0.000333,0.123069,14,5168.891779,287.160654,369.206556,111.906328,2,0
0,0,17,17,18,21,39,71,55,126,0.000333,0.221987,18,11987.29223,665.96068,665.96068,167.297316,3,0
0,0,11,11,15,17,32,49,35,84,0.000333,0.14,14,5880,326.666667,420,128.090227,2,0
0,0,16,16,17,16,33,64,42,106,0.000333,0.178235,16,8555.292426,475.294024,534.705777,133.486868,3,0
0,0,11,11,16,14,30,48,32,80,0.000333,0.13085,16,6280.819962,348.934442,392.551248,117.302969,2,0
0,0,16,16,17,16,33,64,42,106,0.000333,0.178235,16,8555.292426,475.294024,534.705777,133.486868,3,0
0,0,11,11,16,14,30,48,32,80,0.000333,0.13085,16,6280.819962,348.934442,392.551248,117.302969,2,0
0,0,18,18,18,21,39,78,59,137,0.000333,0.241367,18,13033.80187,724.100104,724.100104,167.297316,2,0
0,0,11,11,15,18,33,50,39,89,0.000333,0.14965,14,6285.315073,349.184171,448.951077,133.662009,2,0
0,0,7,7,11,11,22,26,21,47,0.000333,0.069864,5,1047.96643,58.220357,209.593286,76.107496,1,0
0,0,5,5,10,10,20,22,17,39,0.000333,0.056185,5,842.775979,46.820888,168.555196,66.438562,1,0
0,0,14,14,15,20,35,57,52,109,0.000333,0.186364,14,7827.285884,434.849216,559.091849,145.041921,2,0
0,0,16,16,19,23,42,65,57,122,0.000333,0.219288,18,11841.52906,657.862726,657.862726,184.752548,3,0
0,0,7,7,13,16,29,30,29,59,0.000333,0.09554,6,1719.725272,95.540293,286.620879,112.105716,2,0
0,0,7,7,12,14,26,30,27,57,0.000333,0.089308,6,1607.550384,89.308355,267.925064,96.322519,2,0
0,0,20,20,14,21,35,77,70,147,0.000333,0.251335,21,15834.09667,879.672037,754.004603,145.541635,2,0
0,0,22,22,18,23,41,85,75,160,0.000333,0.285736,27,23144.62466,1285.812481,857.208321,179.100575,3,0
0,0,7,7,12,15,27,30,28,58,0.000333,0.091928,6,1654.700851,91.927825,275.783475,101.622909,2,0
0,0,16,16,15,19,34,60,52,112,0.000333,0.189932,14,7977.141735,443.174541,569.795838,139.313982,2,0
0,0,17,17,17,18,35,66,51,117,0.000333,0.200042,16,9602.017808,533.445434,600.126113,144.545518,4,0
0,0,12,12,14,16,30,53,41,94,0.000333,0.153749,14,6457.468024,358.748224,461.247716,117.302969,3,0
0,0,17,17,17,18,35,66,51,117,0.000333,0.200042,16,9602.017808,533.445434,600.126113,144.545518,4,0
0,0,12,12,14,16,30,53,41,94,0.000333,0.153749,14,6457.468024,358.748224,461.247716,117.302969,3,0
0,0,7,7,12,13,25,32,25,57,0.000333,0.088233,6,1588.198817,88.233268,264.699803,91.125266,2,0
0,0,18,18,15,18,33,75,58,133,0.000333,0.223635,21,14088.99278,782.721821,670.904418,133.662009,2,0
0,0,21,21,19,20,39,88,66,154,0.000333,0.271317,27,21976.70243,1220.927913,813.951942,167.149185,3,0
0,0,7,7,12,14,26,32,26,58,0.000333,0.090875,6,1635.753022,90.875168,272.625504,96.322519,2,0
0,0,12,12,16,18,34,57,40,97,0.000333,0.164495,16,7895.74233,438.652352,493.483896,139.05865,3,0
0,0,30,30,20,48,68,130,96,226,0.000333,0.458589,20,27515.33204,1528.629558,1375.766602,354.516762,10,0
0,0,29,29,20,48,68,129,94,223,0.000333,0.452501,10,13575.04214,754.169008,1357.504214,354.516762,10,0
0,0,30,30,23,50,73,135,103,238,0.000333,0.491059,22,32409.92139,1800.551188,1473.178245,386.234734,11,0
0,0,29,29,23,50,73,134,101,235,0.000333,0.48487,22,32001.39297,1777.855165,1454.608771,386.234734,11,0
0,0,30,30,23,50,73,135,103,238,0.000333,0.491059,22,32409.92139,1800.551188,1473.178245,386.234734,11,0
0,0,29,29,23,50,73,134,101,235,0.000333,0.48487,22,32001.39297,1777.855165,1454.608771,386.234734,11,0
0,0,23,23,17,43,60,105,77,182,0.000333,0.358351,8,8600.432707,477.801817,1075.054088,302.816253,9,0
0,0,22,22,17,43,60,104,75,179,0.000333,0.352444,8,8458.667333,469.925963,1057.333417,302.816253,9,0
0,0,23,23,18,44,62,106,78,184,0.000333,0.365191,9,9860.14909,547.786061,1095.572121,315.273641,9,0
0,0,22,22,18,44,62,105,76,181,0.000333,0.359237,9,9699.38579,538.854766,1077.709532,315.273641,9,0
0,0,3,3,6,6,12,7,7,14,0.000333,0.01673,3,150.568425,8.364913,50.189475,31.01955,1,0
0,0,3,3,7,7,14,8,8,16,0.000333,0.020306,3,182.753036,10.152946,60.917679,39.302969,1,0
0,0,6,6,10,10,20,19,18,37,0.000333,0.053304,5,799.556698,44.419817,159.91134,66.438562,1,0
0,0,8,8,11,12,23,27,25,52,0.000333,0.078408,10,2352.252217,130.680679,235.225222,81.073298,1,0
0,0,6,6,11,10,21,21,18,39,0.000333,0.0571,5,856.501897,47.583439,171.300379,71.273029,1,0
0,0,17,17,17,21,38,85,56,141,0.000333,0.246653,16,11839.32447,657.740248,739.957779,161.725534,5,0
0,0,11,11,14,15,29,43,38,81,0.000333,0.131165,14,5508.950448,306.052803,393.496461,111.906328,3,0
0,0,11,11,14,17,31,41,37,78,0.000333,0.128809,14,5409.982371,300.554576,386.427312,122.789837,2,0
0,0,6,6,10,13,23,20,18,38,0.000333,0.057298,5,859.476772,47.74871,171.895354,81.324997,1,0
0,0,10,10,16,15,31,40,35,75,0.000333,0.123855,16,5945.035572,330.279754,371.564723,122.603359,2,0
0,0,14,14,17,17,34,55,44,99,0.000333,0.167886,16,8058.541141,447.69673,503.658821,138.973737,2,0
0,0,8,8,12,12,24,30,22,52,0.000333,0.079473,6,1430.5083,79.472683,238.41805,86.0391,2,0
0,0,8,8,12,12,24,30,22,52,0.000333,0.079473,6,1430.5083,79.472683,238.41805,86.0391,2,0
0,0,8,8,13,13,26,31,23,54,0.000333,0.084608,6,1522.942469,84.607915,253.823745,96.211433,2,0
0,0,8,8,12,13,25,30,23,53,0.000333,0.082041,6,1476.746268,82.041459,246.124378,91.125266,2,0
0,0,8,8,12,12,24,30,22,52,0.000333,0.079473,6,1430.5083,79.472683,238.41805,86.0391,2,0
0,0,8,8,12,12,24,30,22,52,0.000333,0.079473,6,1430.5083,79.472683,238.41805,86.0391,2,0
0,0,10,10,14,15,29,39,26,65,0.000333,0.105256,7,2210.381353,122.798964,315.768765,111.906328,2,0
0,0,18,18,17,24,41,87,65,152,0.000333,0.271449,16,13029.56648,723.864804,814.347905,179.525968,2,0
0,0,9,9,11,14,25,34,31,65,0.000333,0.100617,10,3018.506523,167.694807,301.850652,91.356717,1,0
0,0,11,11,15,16,31,42,36,78,0.000333,0.128809,14,5409.982371,300.554576,386.427312,122.603359,2,0
0,0,14,14,12,15,27,53,51,104,0.000333,0.164836,18,8901.149404,494.5083,494.5083,101.622909,1,0
0,0,16,16,16,17,33,61,56,117,0.000333,0.196731,24,14164.65869,786.925483,590.194112,133.486868,2,0
0,0,32,32,21,49,70,142,104,246,0.000333,0.502601,20,30156.07244,1675.337358,1507.803622,367.359448,9,0
0,0,31,31,21,49,70,141,102,243,0.000333,0.496472,20,29788.31546,1654.906415,1489.415773,367.359448,9,0
0,0,19,19,12,18,30,70,60,130,0.000333,0.212632,18,11482.12399,637.895777,637.895777,118.0782,2,0
0,0,22,22,16,21,37,83,68,151,0.000333,0.262209,24,18879.059,1048.836611,786.627458,156.238666,3,0
0,0,8,8,13,13,26,27,20,47,0.000333,0.07364,6,1325.524001,73.640222,220.920667,96.211433,2,0
0,0,8,8,13,13,26,27,20,47,0.000333,0.07364,6,1325.524001,73.640222,220.920667,96.211433,2,0
0,0,8,8,13,13,26,27,20,47,0.000333,0.07364,6,1325.524001,73.640222,220.920667,96.211433,2,0
0,0,13,13,13,20,33,58,44,102,0.000333,0.171509,12,6174.338402,343.0188,514.5282,134.544278,3,0
0,0,14,14,13,22,35,56,42,98,0.000333,0.167557,6,3016.018414,167.556579,502.669736,146.213212,4,0
0,0,10,10,10,14,24,38,32,70,0.000333,0.106982,10,3209.473751,178.304097,320.947375,86.52225,1,0
0,0,8,8,10,13,23,25,22,47,0.000333,0.070869,5,1063.03706,59.057614,212.607412,81.324997,1,0
0,0,11,11,10,15,25,42,35,77,0.000333,0.119192,10,3575.769266,198.653848,357.576927,91.82264,1,0
0,0,13,13,14,20,34,62,44,106,0.000333,0.179757,14,7549.794856,419.433048,539.271061,139.741531,3,0
0,0,10,10,11,14,25,42,32,74,0.000333,0.114548,10,3436.45358,190.914088,343.645358,91.356717,1,0
0,0,12,12,14,19,33,53,40,93,0.000333,0.156376,14,6567.801143,364.877841,469.128653,134.013592,3,0
0,0,9,9,11,13,24,33,28,61,0.000333,0.093228,10,2796.827125,155.379285,279.682713,86.159464,1,0
0,0,17,17,16,17,33,79,54,133,0.000333,0.223635,24,16101.70603,894.539224,670.904418,133.486868,2,0
0,0,10,10,15,14,29,45,31,76,0.000333,0.123069,14,5168.891779,287.160654,369.206556,111.906328,2,0
0,0,22,22,18,42,60,117,84,201,0.000333,0.395762,18,21371.13018,1187.28501,1187.28501,301.535982,7,0
0,0,21,21,18,42,60,116,82,198,0.000333,0.389855,9,10526.07904,584.782169,1169.564338,301.535982,7,0
0,0,11,11,14,15,29,43,38,81,0.000333,0.131165,14,5508.950448,306.052803,393.496461,111.906328,3,0
0,0,11,11,14,17,31,41,37,78,0.000333,0.128809,14,5409.982371,300.554576,386.427312,122.789837,2,0
0,0,11,11,16,15,31,47,40,87,0.000333,0.143672,16,6896.241264,383.124515,431.015079,122.603359,4,0
0,0,11,11,16,17,33,45,39,84,0.000333,0.141243,16,6779.665696,376.648094,423.729106,133.486868,3,0
0,0,8,8,14,17,31,30,24,54,0.000333,0.089176,7,1872.686205,104.038123,267.526601,122.789837,2,0
0,0,11,11,12,13,25,46,36,82,0.000333,0.126932,12,4569.554491,253.864138,380.796208,91.125266,1,0
0,0,10,10,11,13,24,41,34,75,0.000333,0.114624,10,3438.721876,191.040104,343.872188,86.159464,1,0
0,0,6,6,11,11,22,24,19,43,0.000333,0.063919,5,958.777798,53.265433,191.75556,76.107496,1,0
0,0,13,13,17,19,36,55,50,105,0.000333,0.180947,16,8685.474002,482.526333,542.842125,150.197491,2,0
0,0,8,8,14,17,31,30,24,54,0.000333,0.089176,7,1872.686205,104.038123,267.526601,122.789837,2,0
0,0,8,8,14,17,31,30,24,54,0.000333,0.089176,7,1872.686205,104.038123,267.526601,122.789837,2,0
0,0,16,16,15,23,38,68,56,124,0.000333,0.216914,14,9110.402163,506.133454,650.743012,162.645284,5,0
0,0,12,12,10,16,26,38,42,80,0.000333,0.125345,10,3760.351775,208.908432,376.035177,97.219281,1,0
0,0,17,17,16,17,33,72,50,122,0.000333,0.205139,16,9846.657321,547.036518,615.416083,133.486868,3,0
0,0,17,17,16,17,33,71,50,121,0.000333,0.203457,16,9765.947015,542.552612,610.371688,133.486868,3,0
0,0,10,10,14,13,27,34,25,59,0.000333,0.093513,7,1963.768538,109.098252,280.538363,101.408685,2,0
0,0,16,16,16,15,31,68,48,116,0.000333,0.191562,24,13792.48253,766.249029,574.686772,122.603359,2,0
0,0,10,10,15,14,29,45,31,76,0.000333,0.123069,14,5168.891779,287.160654,369.206556,111.906328,2,0
0,0,15,15,16,17,33,55,38,93,0.000333,0.156376,16,7506.05845,417.003247,469.128653,133.486868,3,0
0,0,15,15,16,17,33,54,38,92,0.000333,0.154695,16,7425.348144,412.519341,464.084259,133.486868,3,0
0,0,15,15,16,17,33,55,38,93,0.000333,0.156376,16,7506.05845,417.003247,469.128653,133.486868,3,0
0,0,15,15,16,17,33,54,38,92,0.000333,0.154695,16,7425.348144,412.519341,464.084259,133.486868,3,0
0,0,15,15,16,16,32,54,37,91,0.000333,0.151667,16,7280,404.444444,455,128,3,0
0,0,15,15,16,16,32,54,37,91,0.000333,0.151667,16,7280,404.444444,455,128,3,0
0,0,17,17,17,19,36,66,42,108,0.000333,0.186117,16,8933.630402,496.3128,558.3519,150.197491,3,0
0,0,10,10,15,14,29,38,27,65,0.000333,0.105256,7,2210.381353,122.798964,315.768765,111.906328,2,0
0,0,8,8,10,13,23,29,25,54,0.000333,0.081424,5,1221.361728,67.853429,244.272346,81.324997,1,0
0,0,11,11,14,15,29,42,33,75,0.000333,0.12145,14,5100.880045,283.382225,364.348575,111.906328,2,0
0,0,9,9,14,15,29,38,29,67,0.000333,0.108495,7,2278.393087,126.577394,325.484727,111.906328,2,0
0,0,14,14,11,15,26,54,46,100,0.000333,0.156681,15,7050.659577,391.70331,470.043972,96.657107,1,0
0,0,17,17,15,17,32,67,54,121,0.000333,0.201667,21,12705,705.833333,605,128.090227,2,0
0,0,9,9,13,15,28,40,31,71,0.000333,0.113774,12,4095.866394,227.548133,341.322199,106.709075,2,0
0,0,15,15,12,18,30,56,47,103,0.000333,0.16847,12,6064.916776,336.939821,505.409731,118.0782,1,0
0,0,18,18,16,20,36,69,55,124,0.000333,0.21369,16,10257.1312,569.840622,641.0707,150.438562,2,0
0,0,9,9,14,15,29,38,29,67,0.000333,0.108495,7,2278.393087,126.577394,325.484727,111.906328,2,0
0,0,14,14,11,15,26,54,46,100,0.000333,0.156681,15,7050.659577,391.70331,470.043972,96.657107,1,0
0,0,17,17,15,17,32,67,54,121,0.000333,0.201667,21,12705,705.833333,605,128.090227,2,0
0,0,9,9,13,15,28,40,31,71,0.000333,0.113774,12,4095.866394,227.548133,341.322199,106.709075,2,0
0,0,16,16,11,16,27,60,54,114,0.000333,0.180686,15,8130.857629,451.714313,542.057175,102.053748,1,0
0,0,19,19,15,18,33,73,62,135,0.000333,0.226998,21,14300.85733,794.492074,680.993206,133.662009,2,0
0,0,9,9,13,15,28,40,31,71,0.000333,0.113774,12,4095.866394,227.548133,341.322199,106.709075,2,0
0,0,10,10,12,15,27,35,36,71,0.000333,0.112532,12,4051.164152,225.064675,337.597013,101.622909,2,0
0,0,17,17,14,18,32,62,58,120,0.000333,0.2,21,12600,700,600,128.361619,2,0
0,0,19,19,18,20,38,70,63,133,0.000333,0.232658,27,18845.3077,1046.961539,697.974359,161.497212,3,0
0,0,10,10,13,15,28,36,37,73,0.000333,0.116979,12,4211.242912,233.95794,350.936909,106.709075,2,0
0,0,7,7,11,13,24,25,25,50,0.000333,0.076416,5,1146.240625,63.680035,229.248125,86.159464,2,0
0,0,19,19,16,19,35,70,67,137,0.000333,0.234237,24,16865.08256,936.949031,702.711773,144.710623,3,0
0,0,21,21,19,21,40,78,72,150,0.000333,0.266096,27,21553.80878,1197.433821,798.289214,172.949289,4,0
0,0,7,7,12,14,26,26,26,52,0.000333,0.081474,6,1466.537192,81.474288,244.422865,96.322519,2,0
0,0,19,19,16,19,35,70,67,137,0.000333,0.234237,24,16865.08256,936.949031,702.711773,144.710623,3,0
0,0,21,21,19,21,40,78,72,150,0.000333,0.266096,27,21553.80878,1197.433821,798.289214,172.949289,4,0
0,0,7,7,12,14,26,26,26,52,0.000333,0.081474,6,1466.537192,81.474288,244.422865,96.322519,2,0
0,0,7,7,11,13,24,25,25,50,0.000333,0.076416,5,1146.240625,63.680035,229.248125,86.159464,2,0
0,0,19,19,16,19,35,69,67,136,0.000333,0.232527,24,16741.97977,930.109987,697.58249,144.710623,3,0
0,0,21,21,19,21,40,77,72,149,0.000333,0.264322,27,21410.11673,1189.450929,792.967286,172.949289,4,0
0,0,7,7,12,14,26,26,26,52,0.000333,0.081474,6,1466.537192,81.474288,244.422865,96.322519,2,0
0,0,19,19,16,19,35,69,67,136,0.000333,0.232527,24,16741.97977,930.109987,697.58249,144.710623,3,0
0,0,21,21,19,21,40,77,72,149,0.000333,0.264322,27,21410.11673,1189.450929,792.967286,172.949289,4,0
0,0,7,7,12,14,26,26,26,52,0.000333,0.081474,6,1466.537192,81.474288,244.422865,96.322519,2,0
0,0,18,18,17,23,40,82,63,145,0.000333,0.257227,16,12346.87318,685.937399,771.679574,173.528793,2,0
0,0,19,19,13,21,34,79,71,150,0.000333,0.254373,18,13736.14967,763.119426,763.119426,140.344382,1,0
0,0,22,22,17,23,40,91,80,171,0.000333,0.30335,24,21841.1929,1213.399606,910.049704,173.528793,2,0
0,0,16,16,16,17,33,62,43,105,0.000333,0.176554,16,8474.582121,470.810118,529.661383,133.486868,3,0
0,0,16,16,16,17,33,61,43,104,0.000333,0.174872,16,8393.871815,466.326212,524.616988,133.486868,3,0
0,0,16,16,16,16,32,61,42,103,0.000333,0.171667,16,8240,457.777778,515,128,3,0
0,0,11,11,15,14,29,45,32,77,0.000333,0.124688,14,5236.903513,290.939084,374.064537,111.906328,2,0
0,0,16,16,16,16,32,61,42,103,0.000333,0.171667,16,8240,457.777778,515,128,3,0
0,0,11,11,15,14,29,45,32,77,0.000333,0.124688,14,5236.903513,290.939084,374.064537,111.906328,2,0
0,0,12,12,13,21,34,54,41,95,0.000333,0.161103,6,2899.85382,161.10299,483.30897,140.344382,5,0
0,0,6,6,10,11,21,16,16,32,0.000333,0.046851,5,702.770788,39.042822,140.554158,71.273029,1,0
0,0,13,13,15,16,31,55,39,94,0.000333,0.155231,14,6519.722344,362.206797,465.694453,122.603359,6,0
0,0,9,9,11,12,23,24,20,44,0.000333,0.066346,5,995.18363,55.287979,199.036726,81.073298,3,0
0,0,22,22,16,19,35,89,61,150,0.000333,0.256464,24,18465.41886,1025.856603,769.392453,144.710623,3,0
0,0,9,9,14,14,28,35,26,61,0.000333,0.09775,7,2052.740552,114.041142,293.24865,106.605938,2,0
0,0,16,16,15,16,31,61,44,105,0.000333,0.173397,14,7282.668576,404.592699,520.190613,122.603359,3,0
0,0,16,16,15,16,31,61,44,105,0.000333,0.173397,14,7282.668576,404.592699,520.190613,122.603359,3,0
0,0,16,16,15,17,32,62,45,107,0.000333,0.178333,14,7490,416.111111,535,128.090227,3,0
0,0,16,16,15,17,32,61,45,106,0.000333,0.176667,14,7420,412.222222,530,128.090227,3,0
0,0,16,16,15,16,31,62,45,107,0.000333,0.1767,14,7421.386073,412.299226,530.099005,122.603359,3,0
0,0,9,9,14,14,28,35,26,61,0.000333,0.09775,7,2052.740552,114.041142,293.24865,106.605938,2,0
0,0,16,16,15,16,31,61,45,106,0.000333,0.175048,14,7352.027325,408.445962,525.144809,122.603359,3,0
0,0,9,9,14,14,28,35,26,61,0.000333,0.09775,7,2052.740552,114.041142,293.24865,106.605938,2,0
0,0,8,8,13,14,27,35,30,65,0.000333,0.103023,12,3708.812252,206.045125,309.067688,101.408685,1,0
0,0,30,30,19,49,68,148,98,246,0.000333,0.499172,18,26955.28546,1497.515859,1497.515859,355.831405,11,0
0,0,15,15,14,20,34,70,46,116,0.000333,0.196715,14,8262.039654,459.002203,590.14569,139.741531,5,0
0,0,6,6,11,12,23,17,17,34,0.000333,0.051267,5,769.005533,42.72253,153.801107,81.073298,1,0
0,0,21,21,17,19,36,81,65,146,0.000333,0.251603,24,18115.41721,1006.412067,754.80905,150.197491,2,0
0,0,10,10,14,16,30,46,33,79,0.000333,0.129215,14,5427.020999,301.501167,387.644357,117.302969,2,0
0,0,10,10,10,14,24,35,28,63,0.000333,0.096284,10,2888.526375,160.473688,288.852638,86.52225,1,0
0,0,10,10,11,14,25,35,29,64,0.000333,0.099069,10,2972.067961,165.114887,297.206796,91.356717,1,0
0,0,21,21,16,19,35,89,66,155,0.000333,0.265013,24,19080.93282,1060.051824,795.038868,144.710623,2,0
0,0,10,10,14,15,29,49,33,82,0.000333,0.132785,14,5576.962182,309.831232,398.354442,111.906328,2,0
0,0,18,18,16,19,35,75,56,131,0.000333,0.223979,16,10750.9772,597.276511,671.936075,144.710623,2,0
0,0,15,15,15,18,33,50,47,97,0.000333,0.163102,14,6850.287214,380.571512,489.30623,133.662009,2,0
0,0,9,9,14,15,29,29,26,55,0.000333,0.089063,7,1870.322683,103.906816,267.188955,111.906328,2,0
0,0,18,18,18,19,37,64,59,123,0.000333,0.213588,27,17300.59463,961.144146,640.762764,155.769273,3,0
0,0,11,11,14,16,30,37,34,71,0.000333,0.11613,14,4877.449252,270.969403,348.389232,117.302969,2,0
0,0,19,19,15,18,33,65,66,131,0.000333,0.220272,21,13877.12822,770.951568,660.81563,133.662009,2,0
0,0,21,21,15,19,34,71,74,145,0.000333,0.245894,21,15491.32435,860.629131,737.682112,139.313982,2,0
0,0,18,18,16,17,33,63,60,123,0.000333,0.20682,24,14891.05144,827.280636,620.460477,133.486868,2,0
0,0,10,10,15,14,29,38,27,65,0.000333,0.105256,7,2210.381353,122.798964,315.768765,111.906328,2,0
0,0,11,11,14,18,32,40,33,73,0.000333,0.121667,7,2555,141.944444,365,128.361619,2,0
0,0,10,10,14,14,28,37,27,64,0.000333,0.102557,7,2153.695005,119.649723,307.670715,106.605938,2,0
0,0,23,23,19,23,42,102,76,178,0.000333,0.319944,27,25915.47753,1439.748752,959.832501,184.752548,3,0
0,0,10,10,15,17,32,47,34,81,0.000333,0.135,14,5670,315,405,128.090227,2,0
0,0,11,11,13,17,30,61,44,105,0.000333,0.171741,12,6182.68215,343.482342,515.223513,117.592585,3,0
0,0,8,8,10,12,22,40,30,70,0.000333,0.104053,10,3121.602133,173.422341,312.160213,76.238831,1,0
0,0,11,11,14,18,32,62,45,107,0.000333,0.178333,14,7490,416.111111,535,128.361619,3,0
0,0,15,15,14,15,29,61,46,107,0.000333,0.173268,21,10915.8833,606.437961,519.803966,111.906328,2,0
0,0,18,18,18,17,35,74,54,128,0.000333,0.218849,27,17726.80211,984.822339,656.548226,144.545518,3,0
0,0,10,10,14,14,28,42,30,72,0.000333,0.115377,14,4845.813761,269.211876,346.129554,106.605938,2,0
0,0,15,15,18,19,37,66,49,115,0.000333,0.199696,18,10783.56847,599.087137,599.087137,155.769273,2,0
0,0,11,11,16,17,33,52,36,88,0.000333,0.147969,16,7102.50692,394.583718,443.906683,133.486868,2,0
0,0,8,8,12,11,23,29,24,53,0.000333,0.079916,12,2876.985404,159.832522,239.748784,81.073298,1,0
0,0,13,13,16,14,30,51,39,90,0.000333,0.147207,16,7065.922458,392.551248,441.620154,117.302969,1,0
0,0,12,12,16,17,33,46,36,82,0.000333,0.13788,16,6618.245085,367.680282,413.640318,133.486868,3,0
0,0,12,12,16,17,33,45,36,81,0.000333,0.136199,16,6537.534779,363.196377,408.595924,133.486868,3,0
0,0,19,19,13,19,32,90,67,157,0.000333,0.261667,18,14130,785,785,128.816339,1,0
0,0,22,22,17,22,39,103,75,178,0.000333,0.313601,24,22579.23828,1254.402127,940.801595,167.594364,2,0
0,0,10,10,16,17,33,50,35,85,0.000333,0.142925,16,6860.376002,381.132,428.7735,133.486868,2,0
0,0,13,13,16,17,33,48,38,86,0.000333,0.144606,16,6941.086308,385.615906,433.817894,133.486868,1,0
0,0,9,9,11,14,25,30,30,60,0.000333,0.092877,10,2786.313714,154.795206,278.631371,91.356717,1,0
0,0,9,9,11,14,25,30,30,60,0.000333,0.092877,10,2786.313714,154.795206,278.631371,91.356717,1,0
0,0,12,12,15,14,29,46,35,81,0.000333,0.131165,14,5508.950448,306.052803,393.496461,111.906328,1,0
0,0,11,11,15,19,34,45,38,83,0.000333,0.140753,14,5911.631822,328.42399,422.259416,139.313982,2,0
0,0,11,11,15,19,34,45,38,83,0.000333,0.140753,14,5911.631822,328.42399,422.259416,139.313982,2,0
0,0,8,8,13,13,26,26,23,49,0.000333,0.076774,6,1381.929277,76.773849,230.321546,96.211433,3,0
0,0,6,6,11,10,21,22,16,38,0.000333,0.055636,5,834.54031,46.363351,166.908062,71.273029,1,0
0,0,7,7,11,11,22,20,17,37,0.000333,0.055,5,824.994849,45.833047,164.99897,76.107496,3,0
0,0,6,6,11,10,21,22,16,38,0.000333,0.055636,5,834.54031,46.363351,166.908062,71.273029,1,0
0,0,6,6,11,10,21,22,16,38,0.000333,0.055636,5,834.54031,46.363351,166.908062,71.273029,1,0
0,0,8,8,12,16,28,33,27,60,0.000333,0.096147,6,1730.647772,96.147098,288.441295,107.01955,3,0
0,0,6,6,10,11,21,16,16,32,0.000333,0.046851,5,702.770788,39.042822,140.554158,71.273029,1,0
0,0,10,10,14,15,29,32,30,62,0.000333,0.100398,14,4216.727504,234.262639,301.194822,111.906328,2,0
0,0,12,12,13,14,27,48,41,89,0.000333,0.141062,12,5078.219852,282.123325,423.184988,101.408685,2,0
0,0,12,12,13,14,27,48,41,89,0.000333,0.141062,12,5078.219852,282.123325,423.184988,101.408685,2,0
0,0,11,11,16,17,33,41,35,76,0.000333,0.127791,16,6133.983249,340.776847,383.373953,133.486868,2,0
0,0,11,11,16,17,33,41,35,76,0.000333,0.127791,16,6133.983249,340.776847,383.373953,133.486868,2,0
0,0,15,15,18,18,36,70,49,119,0.000333,0.205074,18,11073.97935,615.221075,615.221075,150.1173,2,0
0,0,11,11,16,17,33,42,33,75,0.000333,0.12611,8,3026.636472,168.146471,378.329559,133.486868,2,0
0,0,13,13,14,16,30,54,44,98,0.000333,0.160292,14,6732.253897,374.014105,480.875278,117.302969,2,0
0,0,17,17,14,18,32,66,60,126,0.000333,0.21,21,13230,735,630,128.361619,2,0
0,0,9,9,15,12,27,33,26,59,0.000333,0.093513,14,3927.537077,218.196504,280.538363,101.622909,3,0
0,0,6,6,10,11,21,21,17,38,0.000333,0.055636,5,834.54031,46.363351,166.908062,71.273029,1,0
0,0,23,23,17,27,44,107,71,178,0.000333,0.323926,16,15548.46125,863.803403,971.778828,197.868831,6,0
0,0,14,14,15,20,35,53,43,96,0.000333,0.164137,14,6893.756375,382.986465,492.41117,145.041921,2,0
0,0,35,35,19,49,68,164,109,273,0.000333,0.553959,18,29913.7924,1661.877356,1661.877356,355.831405,10,0
0,0,23,23,15,24,39,99,67,166,0.000333,0.292459,14,12283.27476,682.404153,877.376768,168.642459,6,0
0,0,14,14,14,15,29,46,43,89,0.000333,0.14412,14,6053.04432,336.28024,432.360309,111.906328,2,0
0,0,8,8,15,16,31,31,23,54,0.000333,0.089176,7,1872.686205,104.038123,267.526601,122.603359,2,0
0,0,8,8,15,16,31,31,23,54,0.000333,0.089176,7,1872.686205,104.038123,267.526601,122.603359,2,0
0,0,8,8,15,16,31,31,23,54,0.000333,0.089176,7,1872.686205,104.038123,267.526601,122.603359,2,0
0,0,13,13,15,18,33,49,40,89,0.000333,0.14965,14,6285.315073,349.184171,448.951077,133.662009,2,0
0,0,10,10,14,16,30,37,29,66,0.000333,0.107952,7,2266.983455,125.943525,323.854779,117.302969,2,0
0,0,15,15,18,19,37,54,49,103,0.000333,0.178858,18,9658.32654,536.573697,536.573697,155.769273,2,0
0,0,17,17,13,18,31,60,60,120,0.000333,0.198168,18,10701.06403,594.503557,594.503557,123.164366,1,0
0,0,19,19,17,20,37,68,65,133,0.000333,0.230952,24,16628.57514,923.80973,692.857298,155.92543,2,0
0,0,11,11,13,17,30,47,43,90,0.000333,0.147207,12,5299.441843,294.413436,441.620154,117.592585,1,0
0,0,13,13,17,20,37,55,48,103,0.000333,0.178858,16,8585.179147,476.954397,536.573697,155.92543,2,0
0,0,15,15,14,21,35,70,47,117,0.000333,0.200042,14,8401.765582,466.764755,600.126113,145.541635,5,0
0,0,6,6,10,13,23,16,18,34,0.000333,0.051267,5,769.005533,42.72253,153.801107,81.324997,1,0
0,0,20,20,16,28,44,98,73,171,0.000333,0.311188,16,14937.00491,829.833606,933.562807,198.605938,6,0
0,0,14,14,15,25,40,60,50,110,0.000333,0.195137,14,8195.769266,455.320515,585.41209,174.699764,2,0
0,0,14,14,14,19,33,57,42,99,0.000333,0.166465,14,6991.530249,388.418347,499.395018,134.013592,4,0
0,0,11,11,13,16,29,46,35,81,0.000333,0.131165,12,4721.957527,262.330974,393.496461,112.105716,3,0
0,0,8,8,11,10,21,27,21,48,0.000333,0.070277,10,2108.312363,117.128465,210.831236,71.273029,1,0
0,0,18,18,16,17,33,81,56,137,0.000333,0.230361,24,16585.96786,921.442659,691.081994,133.486868,2,0
0,0,10,10,15,14,29,45,31,76,0.000333,0.123069,14,5168.891779,287.160654,369.206556,111.906328,2,0
0,0,9,9,12,13,25,38,27,65,0.000333,0.100617,12,3622.207828,201.233768,301.850652,91.125266,2,0
0,0,9,9,12,13,25,38,27,65,0.000333,0.100617,12,3622.207828,201.233768,301.850652,91.125266,2,0
0,0,11,11,13,15,28,43,30,73,0.000333,0.116979,12,4211.242912,233.95794,350.936909,106.709075,2,0
0,0,11,11,13,14,27,43,30,73,0.000333,0.115702,12,4165.281452,231.404525,347.106788,101.408685,2,0
0,0,9,9,13,14,27,39,28,67,0.000333,0.106192,12,3822.929552,212.384975,318.577463,101.408685,2,0
0,0,9,9,12,14,26,38,28,66,0.000333,0.10341,12,3722.748257,206.819348,310.229021,96.322519,2,0
0,0,9,9,12,13,25,38,27,65,0.000333,0.100617,12,3622.207828,201.233768,301.850652,91.125266,2,0
0,0,9,9,12,13,25,38,27,65,0.000333,0.100617,12,3622.207828,201.233768,301.850652,91.125266,2,0
0,0,15,15,16,21,37,63,52,115,0.000333,0.199696,16,9585.394193,532.5219,599.087137,156.238666,2,0
0,0,11,11,17,15,32,44,31,75,0.000333,0.125,16,6000,333.333333,375,128.090227,2,0
0,0,11,11,16,15,31,43,31,74,0.000333,0.122204,16,5865.768431,325.876024,366.610527,122.603359,2,0
0,0,11,11,11,13,24,38,35,73,0.000333,0.111567,10,3347.022626,185.945701,334.702263,86.159464,1,0
0,0,13,13,15,19,34,56,47,103,0.000333,0.17467,14,7336.121417,407.562301,524.008673,139.313982,3,0
0,0,11,11,18,19,37,54,41,95,0.000333,0.164966,18,8908.165255,494.89807,494.89807,155.769273,2,0
0,0,32,32,20,51,71,161,104,265,0.000333,0.543228,20,32593.65973,1810.758874,1629.682987,375.732254,10,0
0,0,20,20,17,26,43,96,62,158,0.000333,0.285783,16,13717.5973,762.088739,857.349831,191.698301,6,0
0,0,11,11,16,18,34,43,34,77,0.000333,0.130578,8,3133.87711,174.104284,391.734639,139.05865,2,0
0,0,6,6,11,18,29,29,26,55,0.000333,0.089063,5,1335.944774,74.219154,267.188955,113.112398,1,0
0,0,6,6,11,19,30,29,27,56,0.000333,0.091595,5,1373.929367,76.329409,274.785873,118.764371,1,0
0,0,7,7,14,25,39,44,35,79,0.000333,0.139182,7,2922.827427,162.379302,417.546775,169.399374,2,0
0,0,10,10,18,33,51,67,52,119,0.000333,0.225006,9,6075.167541,337.509308,675.018616,241.523656,3,0
0,0,9,9,11,15,26,47,38,85,0.000333,0.133179,10,3995.37376,221.965209,399.537376,96.657107,1,0
0,0,8,8,10,12,22,40,30,70,0.000333,0.104053,10,3121.602133,173.422341,312.160213,76.238831,1,0
0,0,9,9,12,16,28,48,39,87,0.000333,0.139413,12,5018.878539,278.826585,418.239878,107.01955,1,0
0,0,11,11,13,17,30,43,41,84,0.000333,0.137393,12,4946.14572,274.785873,412.17881,117.592585,1,0
0,0,14,14,17,20,37,56,49,105,0.000333,0.182331,16,8751.881654,486.215647,546.992603,155.92543,2,0
0,0,11,11,15,15,30,51,36,87,0.000333,0.1423,14,5976.592745,332.03293,426.899482,117.206718,6,0
0,0,7,7,11,10,21,20,17,37,0.000333,0.054172,5,812.578723,45.143262,162.515745,71.273029,3,0
0,0,6,6,11,10,21,22,16,38,0.000333,0.055636,5,834.54031,46.363351,166.908062,71.273029,1,0
0,0,14,14,18,16,34,55,47,102,0.000333,0.172974,18,9340.581777,518.92121,518.92121,139.05865,2,0
0,0,8,8,13,13,26,27,20,47,0.000333,0.07364,6,1325.524001,73.640222,220.920667,96.211433,2,0
0,0,8,8,13,13,26,27,20,47,0.000333,0.07364,6,1325.524001,73.640222,220.920667,96.211433,2,0
0,0,14,14,18,16,34,53,47,100,0.000333,0.169582,18,9157.433114,508.746284,508.746284,139.05865,2,0
0,0,8,8,13,13,26,27,20,47,0.000333,0.07364,6,1325.524001,73.640222,220.920667,96.211433,2,0
0,0,8,8,13,13,26,27,20,47,0.000333,0.07364,6,1325.524001,73.640222,220.920667,96.211433,2,0
0,0,8,8,13,13,26,27,20,47,0.000333,0.07364,6,1325.524001,73.640222,220.920667,96.211433,2,0
0,0,8,8,13,13,26,27,20,47,0.000333,0.07364,6,1325.524001,73.640222,220.920667,96.211433,2,0
0,0,15,15,18,16,34,57,51,108,0.000333,0.183149,27,14835.04165,824.16898,549.445987,139.05865,2,0
0,0,14,14,17,16,33,49,41,90,0.000333,0.151332,16,7263.927532,403.55153,453.995471,133.486868,2,0
0,0,9,9,15,16,31,31,27,58,0.000333,0.095781,7,2011.403702,111.74465,287.343386,122.603359,2,0
0,0,17,17,16,18,34,56,55,111,0.000333,0.188236,24,13553.00101,752.944501,564.708375,139.05865,2,0
0,0,10,10,14,14,28,47,33,80,0.000333,0.128196,14,5384.237513,299.124306,384.588394,106.605938,2,0
0,0,9,9,12,15,27,37,28,65,0.000333,0.103023,6,1854.406126,103.022563,309.067688,101.622909,3,0
0,0,12,12,13,18,31,48,35,83,0.000333,0.137066,6,2467.189763,137.066098,411.198294,123.164366,4,0
0,0,6,6,10,10,20,17,16,33,0.000333,0.047541,5,713.118136,39.617674,142.623627,66.438562,2,0
0,0,6,6,11,9,20,18,14,32,0.000333,0.046101,5,691.508495,38.417139,138.301699,66.583073,1,0
0,0,11,11,14,14,28,37,30,67,0.000333,0.107364,14,4509.298917,250.516606,322.09278,106.605938,2,0
0,0,12,12,13,19,32,45,37,82,0.000333,0.136667,6,2460,136.666667,410,128.816339,2,0
0,0,11,11,14,15,29,39,31,70,0.000333,0.113353,14,4760.821375,264.490076,340.05867,111.906328,2,0
0,0,13,13,12,15,27,51,39,90,0.000333,0.142647,12,5135.278502,285.29325,427.939875,101.622909,2,0
0,0,16,16,15,17,32,64,47,111,0.000333,0.185,14,7770,431.666667,555,128.090227,3,0
0,0,13,13,12,15,27,51,39,90,0.000333,0.142647,12,5135.278502,285.29325,427.939875,101.622909,2,0
0,0,16,16,15,17,32,64,47,111,0.000333,0.185,14,7770,431.666667,555,128.090227,3,0
0,0,10,10,16,17,33,38,31,69,0.000333,0.116021,8,2784.505554,154.694753,348.063194,133.486868,2,0
0,0,16,16,18,19,37,64,50,114,0.000333,0.197959,18,10689.79831,593.877684,593.877684,155.769273,2,0
0,0,16,16,18,19,37,66,50,116,0.000333,0.201432,18,10877.33863,604.29659,604.29659,155.769273,2,0
0,0,11,11,16,17,33,48,37,85,0.000333,0.142925,16,6860.376002,381.132,428.7735,133.486868,2,0
0,0,11,11,16,17,33,51,39,90,0.000333,0.151332,16,7263.927532,403.55153,453.995471,133.486868,2,0
0,0,8,8,10,14,24,26,26,52,0.000333,0.079473,5,1192.09025,66.227236,238.41805,86.52225,1,0
0,0,7,7,10,14,24,23,23,46,0.000333,0.070303,5,1054.541375,58.585632,210.908275,86.52225,1,0
0,0,6,6,10,11,21,16,16,32,0.000333,0.046851,5,702.770788,39.042822,140.554158,71.273029,1,0
0,0,13,13,11,19,30,45,43,88,0.000333,0.143935,10,4318.063724,239.892429,431.806372,118.764371,1,0
0,0,12,12,10,16,26,38,42,80,0.000333,0.125345,10,3760.351775,208.908432,376.035177,97.219281,1,0
0,0,13,13,14,15,29,49,37,86,0.000333,0.139262,14,5849.009118,324.944951,417.786366,111.906328,2,0
0,0,11,11,14,15,29,45,33,78,0.000333,0.126308,14,5304.915247,294.717514,378.922518,111.906328,2,0
0,0,20,20,13,20,33,92,69,161,0.000333,0.270716,18,14618.65416,812.147453,812.147453,134.544278,1,0
0,0,23,23,17,22,39,105,77,182,0.000333,0.320648,24,23086.63689,1282.590938,961.943204,167.594364,2,0
0,0,10,10,16,17,33,50,35,85,0.000333,0.142925,16,6860.376002,381.132,428.7735,133.486868,2,0
0,0,10,10,14,21,35,40,36,76,0.000333,0.129942,7,2728.778565,151.598809,389.825509,145.541635,2,0
0,0,17,17,16,31,47,83,62,145,0.000333,0.268472,16,12886.64614,715.924785,805.415383,217.580086,6,0
0,0,11,11,14,22,36,45,39,84,0.000333,0.144758,7,3039.915901,168.884217,434.2737,151.410465,2,0
0,0,12,12,13,21,34,53,41,94,0.000333,0.159407,6,2869.329042,159.407169,478.221507,140.344382,5,0
0,0,6,6,10,11,21,15,17,32,0.000333,0.046851,5,702.770788,39.042822,140.554158,71.273029,1,0
0,0,16,16,15,30,45,77,59,136,0.000333,0.248964,7,5228.244148,290.458008,746.892021,205.810077,6,0
0,0,10,10,13,21,34,39,36,75,0.000333,0.127187,6,2289.358279,127.186571,381.559713,140.344382,2,0
0,0,8,8,14,14,28,31,24,55,0.000333,0.088135,7,1850.831645,102.82398,264.404521,106.605938,2,0
0,0,14,14,17,16,33,51,41,92,0.000333,0.154695,16,7425.348144,412.519341,464.084259,133.486868,2,0
0,0,14,14,14,17,31,49,48,97,0.000333,0.160186,14,6727.79859,373.766588,480.557042,122.789837,2,0
0,0,12,12,17,18,35,46,38,84,0.000333,0.14362,16,6893.756375,382.986465,430.859773,144.545518,2,0
0,0,7,7,13,14,27,33,26,59,0.000333,0.093513,6,1683.230176,93.512788,280.538363,101.408685,2,0
0,0,14,14,15,19,34,61,49,110,0.000333,0.18654,14,7834.692776,435.26071,559.620913,139.313982,2,0
0,0,17,17,19,22,41,74,57,131,0.000333,0.233946,18,12633.10763,701.839313,701.839313,178.818118,3,0
0,0,7,7,13,15,28,33,27,60,0.000333,0.096147,6,1730.647772,96.147098,288.441295,106.709075,2,0
0,0,12,12,17,19,36,58,41,99,0.000333,0.170608,16,8189.161202,454.9534,511.822575,150.197491,3,0
0,0,7,7,8,8,16,19,18,37,0.000333,0.049333,8,1184,65.777778,148,48,1,0
0,0,7,7,9,9,18,20,19,39,0.000333,0.054209,8,1301.0166,72.2787,162.627075,57.05865,1,0
0,0,14,14,14,20,34,72,51,123,0.000333,0.208586,14,8760.611013,486.700612,625.757929,139.741531,4,0
0,0,11,11,13,17,30,61,44,105,0.000333,0.171741,12,6182.68215,343.482342,515.223513,117.592585,3,0
0,0,8,8,11,12,23,42,30,72,0.000333,0.108565,10,3256.964608,180.942478,325.696461,81.073298,1,0
0,0,7,7,10,11,21,20,17,37,0.000333,0.054172,5,812.578723,45.143262,162.515745,71.273029,3,0
0,0,9,9,12,12,24,25,20,45,0.000333,0.068774,6,1237.939875,68.774438,206.323313,86.0391,3,0
0,0,8,8,14,12,26,28,19,47,0.000333,0.07364,7,1546.444667,85.913593,220.920667,96.322519,2,0
0,0,8,8,14,12,26,28,19,47,0.000333,0.07364,7,1546.444667,85.913593,220.920667,96.322519,2,0
0,0,7,7,10,12,22,20,18,38,0.000333,0.056486,5,847.292008,47.071778,169.458402,76.238831,3,0
0,0,7,7,10,11,21,20,18,38,0.000333,0.055636,5,834.54031,46.363351,166.908062,71.273029,3,0
0,0,8,8,14,12,26,28,19,47,0.000333,0.07364,7,1546.444667,85.913593,220.920667,96.322519,2,0
0,0,8,8,14,12,26,28,19,47,0.000333,0.07364,7,1546.444667,85.913593,220.920667,96.322519,2,0
0,0,7,7,10,11,21,20,17,37,0.000333,0.054172,5,812.578723,45.143262,162.515745,71.273029,3,0
0,0,8,8,14,12,26,28,19,47,0.000333,0.07364,7,1546.444667,85.913593,220.920667,96.322519,2,0
0,0,8,8,14,12,26,28,19,47,0.000333,0.07364,7,1546.444667,85.913593,220.920667,96.322519,2,0
0,0,13,13,16,19,35,48,45,93,0.000333,0.159008,16,7632.373129,424.020729,477.023321,144.710623,2,0
0,0,20,20,17,23,40,86,71,157,0.000333,0.278514,24,20053.02506,1114.056948,835.542711,173.528793,2,0
0,0,22,22,15,27,42,96,75,171,0.000333,0.307362,14,12909.20791,717.178217,922.086279,186.985321,6,0
0,0,16,16,14,22,36,59,58,117,0.000333,0.201627,14,8468.337152,470.463175,604.881225,151.410465,2,0
0,0,11,11,15,19,34,45,36,81,0.000333,0.137361,7,2884.591431,160.255079,412.08449,139.313982,2,0
0,0,14,14,12,15,27,46,39,85,0.000333,0.134722,12,4849.985252,269.443625,404.165438,101.622909,2,0
0,0,17,17,16,18,34,59,47,106,0.000333,0.179757,16,8628.336979,479.352054,539.271061,139.05865,3,0
0,0,10,10,14,15,29,40,29,69,0.000333,0.111734,7,2346.404821,130.355823,335.200689,111.906328,2,0
0,0,7,7,9,11,20,34,29,63,0.000333,0.09076,8,2178.25176,121.013987,272.28147,66.583073,1,0
0,0,7,7,10,12,22,35,30,65,0.000333,0.096621,10,2898.630552,161.035031,289.863055,76.238831,1,0
0,0,16,16,15,28,43,73,56,129,0.000333,0.233329,14,9799.834147,544.43523,699.988153,193.209297,6,0
0,0,10,10,14,19,33,35,33,68,0.000333,0.11434,7,2401.131601,133.3962,343.0188,134.013592,2,0
0,0,10,10,15,19,34,37,33,70,0.000333,0.118707,7,2492.856792,138.492044,356.122399,139.313982,2,0
0,0,13,13,17,17,34,49,40,89,0.000333,0.150928,16,7244.547086,402.474838,452.784193,138.973737,2,0
0,0,8,8,15,16,31,35,28,63,0.000333,0.104038,7,2184.800573,121.37781,312.114368,122.603359,2,0
0,0,11,11,14,19,33,41,31,72,0.000333,0.121065,7,2542.374636,141.243035,363.196377,134.013592,3,0
0,0,9,9,14,12,26,34,21,55,0.000333,0.086175,7,1809.669291,100.537183,258.524184,96.322519,2,0
0,0,9,9,15,17,32,35,30,65,0.000333,0.108333,7,2275,126.388889,325,128.090227,2,0
0,0,12,12,17,18,35,52,48,100,0.000333,0.170976,16,8206.852827,455.936268,512.928302,144.545518,2,0
0,0,16,16,15,17,32,66,48,114,0.000333,0.19,14,7980,443.333333,570,128.090227,3,0
0,0,19,19,18,19,37,79,56,135,0.000333,0.234425,18,12658.97168,703.276204,703.276204,155.769273,4,0
0,0,16,16,15,17,32,66,48,114,0.000333,0.19,14,7980,443.333333,570,128.090227,3,0
0,0,19,19,18,19,37,79,56,135,0.000333,0.234425,18,12658.97168,703.276204,703.276204,155.769273,4,0
0,0,7,7,11,12,23,28,23,51,0.000333,0.076901,5,1153.508299,64.083794,230.70166,81.073298,2,0
0,0,16,16,15,17,32,66,48,114,0.000333,0.19,14,7980,443.333333,570,128.090227,3,0
0,0,19,19,19,19,38,79,56,135,0.000333,0.236157,18,12752.46386,708.470214,708.470214,161.421246,4,0
0,0,7,7,12,13,25,29,24,53,0.000333,0.082041,6,1476.746268,82.041459,246.124378,91.125266,2,0
0,0,12,12,17,17,34,54,38,92,0.000333,0.156016,16,7488.745302,416.041406,468.046581,138.973737,3,0
0,0,16,16,15,17,32,66,48,114,0.000333,0.19,14,7980,443.333333,570,128.090227,3,0
0,0,19,19,19,19,38,79,56,135,0.000333,0.236157,18,12752.46386,708.470214,708.470214,161.421246,4,0
0,0,7,7,12,13,25,29,24,53,0.000333,0.082041,6,1476.746268,82.041459,246.124378,91.125266,2,0
0,0,12,12,17,17,34,54,38,92,0.000333,0.156016,16,7488.745302,416.041406,468.046581,138.973737,3,0
0,0,8,8,12,19,31,32,30,62,0.000333,0.102387,6,1842.961027,102.386724,307.160171,123.730173,3,0
0,0,6,6,10,15,25,15,20,35,0.000333,0.054178,5,812.674833,45.148602,162.534967,91.82264,1,0
0,0,8,8,10,12,22,27,25,52,0.000333,0.077297,10,2318.904442,128.828025,231.890444,76.238831,1,0
0,0,18,18,16,17,33,64,53,117,0.000333,0.196731,24,14164.65869,786.925483,590.194112,133.486868,2,0
0,0,10,10,14,14,28,41,30,71,0.000333,0.113774,14,4778.510793,265.472822,341.322199,106.605938,2,0
0,0,10,10,13,18,31,57,43,100,0.000333,0.16514,12,5945.035572,330.279754,495.419631,123.164366,3,0
0,0,8,8,10,14,24,40,32,72,0.000333,0.110039,10,3301.173001,183.3985,330.1173,86.52225,1,0
0,0,6,6,10,13,23,20,18,38,0.000333,0.057298,5,859.476772,47.74871,171.895354,81.324997,1,0
0,0,6,6,10,13,23,20,18,38,0.000333,0.057298,5,859.476772,47.74871,171.895354,81.324997,1,0
0,0,6,6,10,11,21,21,17,38,0.000333,0.055636,5,834.54031,46.363351,166.908062,71.273029,1,0
0,0,12,12,17,17,34,52,37,89,0.000333,0.150928,16,7244.547086,402.474838,452.784193,138.973737,3,0
0,0,12,12,17,17,34,51,37,88,0.000333,0.149232,16,7163.14768,397.952649,447.69673,138.973737,3,0
0,0,5,5,13,15,28,26,23,49,0.000333,0.07852,6,1413.362347,78.52013,235.560391,106.709075,2,0
0,0,21,21,19,26,45,94,74,168,0.000333,0.307544,18,16607.36376,922.63132,922.63132,202.922055,3,0
0,0,5,5,13,16,29,26,24,50,0.000333,0.080966,6,1457.394299,80.96635,242.89905,112.105716,2,0
0,0,12,12,14,14,28,46,35,81,0.000333,0.129799,14,5451.540482,302.86336,389.395749,106.605938,2,0
0,0,10,10,14,14,28,42,31,73,0.000333,0.116979,14,4913.11673,272.950929,350.936909,106.605938,2,0
0,0,12,12,18,17,35,51,36,87,0.000333,0.148749,18,8032.457205,446.247622,446.247622,144.545518,3,0
0,0,12,12,18,17,35,51,36,87,0.000333,0.148749,18,8032.457205,446.247622,446.247622,144.545518,3,0
0,0,14,14,16,16,32,61,44,105,0.000333,0.175,16,8400,466.666667,525,128,1,0
0,0,15,15,18,19,37,69,50,119,0.000333,0.206642,18,11158.64911,619.924951,619.924951,155.769273,2,0
0,0,8,8,11,13,24,37,28,65,0.000333,0.099341,10,2980.225625,165.56809,298.022563,86.159464,1,0
0,0,11,11,15,16,31,50,36,86,0.000333,0.14202,14,5964.852358,331.380687,426.060883,122.603359,2,0
0,0,10,10,15,15,30,47,32,79,0.000333,0.129215,14,5427.020999,301.501167,387.644357,117.206718,2,0
0,0,7,7,11,12,23,37,26,63,0.000333,0.094995,10,2849.844032,158.324668,284.984403,81.073298,1,0
0,0,10,10,15,15,30,50,34,84,0.000333,0.137393,14,5770.50334,320.583519,412.17881,117.206718,2,0
0,0,14,14,13,14,27,61,44,105,0.000333,0.166421,18,8986.737379,499.263188,499.263188,101.408685,1,0
0,0,17,17,17,16,33,74,52,126,0.000333,0.211865,24,15254.24782,847.458212,635.593659,133.486868,2,0
0,0,10,10,15,15,30,47,32,79,0.000333,0.129215,14,5427.020999,301.501167,387.644357,117.206718,2,0
0,0,15,15,13,17,30,62,47,109,0.000333,0.178284,12,6418.212899,356.567383,534.851075,117.592585,1,0
0,0,18,18,17,19,36,75,55,130,0.000333,0.22403,16,10753.444,597.413556,672.09025,150.197491,2,0
0,0,10,10,15,15,30,47,32,79,0.000333,0.129215,14,5427.020999,301.501167,387.644357,117.206718,2,0
0,0,6,6,10,11,21,21,17,38,0.000333,0.055636,5,834.54031,46.363351,166.908062,71.273029,1,0
0,0,6,6,10,11,21,21,17,38,0.000333,0.055636,5,834.54031,46.363351,166.908062,71.273029,1,0
0,0,13,13,15,18,33,43,39,82,0.000333,0.13788,14,5790.964449,321.720247,413.640318,133.662009,2,0
0,0,9,9,14,15,29,28,25,53,0.000333,0.085824,7,1802.310949,100.128386,257.472993,111.906328,2,0
0,0,6,6,10,11,21,21,17,38,0.000333,0.055636,5,834.54031,46.363351,166.908062,71.273029,1,0
0,0,6,6,10,11,21,21,17,38,0.000333,0.055636,5,834.54031,46.363351,166.908062,71.273029,1,0
0,0,6,6,10,11,21,21,17,38,0.000333,0.055636,5,834.54031,46.363351,166.908062,71.273029,1,0
0,0,20,20,14,27,41,81,65,146,0.000333,0.260734,14,10950.8363,608.379794,782.202593,181.684931,6,0
0,0,14,14,13,17,30,43,46,89,0.000333,0.145571,12,5240.559156,291.142175,436.713263,117.592585,2,0
0,0,24,24,18,26,44,112,76,188,0.000333,0.342124,18,18474.7166,1026.373144,1026.373144,197.270083,5,0
0,0,15,15,12,19,31,57,50,107,0.000333,0.1767,12,6361.188063,353.399337,530.099005,123.730173,1,0
0,0,23,23,18,26,44,109,78,187,0.000333,0.340305,27,27564.67024,1531.370569,1020.913713,197.270083,5,0
0,0,11,11,16,16,32,42,34,76,0.000333,0.126667,16,6080,337.777778,380,128,2,0
0,0,15,15,13,23,36,68,52,120,0.000333,0.206797,12,7444.692002,413.594,620.391,152.147641,5,0
0,0,26,26,19,50,69,134,94,228,0.000333,0.464248,9,12534.69219,696.371788,1392.743576,362.903432,9,0
0,0,9,9,10,13,23,30,29,59,0.000333,0.088963,10,2668.901554,148.272309,266.890155,81.324997,1,0
0,0,7,7,8,12,20,20,20,40,0.000333,0.057626,4,691.508495,38.417139,172.877124,67.01955,1,0
0,0,9,9,8,12,20,30,29,59,0.000333,0.084998,8,2039.950061,113.330559,254.993758,67.01955,1,0
0,0,14,14,15,18,33,79,55,134,0.000333,0.225316,21,14194.92505,788.606947,675.948812,133.662009,5,0
0,0,8,8,11,12,23,42,30,72,0.000333,0.108565,10,3256.964608,180.942478,325.696461,81.073298,2,0
0,0,12,12,16,17,33,52,38,90,0.000333,0.151332,16,7263.927532,403.55153,453.995471,133.486868,3,0
0,0,12,12,15,17,32,51,38,89,0.000333,0.148333,14,6230,346.111111,445,128.090227,3,0
0,0,11,11,16,14,30,43,30,73,0.000333,0.119401,16,5731.248216,318.402679,358.203013,117.302969,2,0
0,0,6,6,10,13,23,20,18,38,0.000333,0.057298,5,859.476772,47.74871,171.895354,81.324997,1,0
0,0,14,14,14,23,37,63,50,113,0.000333,0.196223,14,8241.355224,457.853068,588.66823,157.344894,3,0
0,0,12,12,12,20,32,46,41,87,0.000333,0.145,12,5220,290,435,129.458112,1,0
0,0,20,20,17,22,39,86,65,151,0.000333,0.266032,16,12769.53176,709.418431,798.095735,167.594364,2,0
0,0,15,15,17,17,34,57,48,105,0.000333,0.178061,16,8546.937573,474.829865,534.183598,138.973737,3,0
0,0,15,15,17,17,34,57,48,105,0.000333,0.178061,16,8546.937573,474.829865,534.183598,138.973737,3,0
0,0,23,23,18,21,39,80,80,160,0.000333,0.281888,27,22832.93759,1268.496533,845.664355,167.297316,3,0
0,0,11,11,11,13,24,39,30,69,0.000333,0.105454,10,3163.624125,175.756896,316.362413,86.159464,2,0
0,0,14,14,15,16,31,52,38,90,0.000333,0.148626,14,6242.287351,346.793742,445.877668,122.603359,3,0
0,0,10,10,14,15,29,40,29,69,0.000333,0.111734,7,2346.404821,130.355823,335.200689,111.906328,2,0
0,0,11,11,17,17,34,45,39,84,0.000333,0.142449,16,6837.550059,379.863892,427.346879,138.973737,3,0
0,0,31,31,21,49,70,137,105,242,0.000333,0.494429,20,29665.7298,1648.0961,1483.28649,367.359448,9,0
0,0,30,30,21,49,70,136,103,239,0.000333,0.4883,20,29297.97282,1627.665157,1464.898641,367.359448,9,0
0,0,32,32,22,50,72,142,110,252,0.000333,0.518274,22,34206.06421,1900.3369,1554.8211,380.300305,10,0
0,0,31,31,22,50,72,141,108,249,0.000333,0.512104,22,33798.84916,1877.713842,1536.311325,380.300305,10,0
0,0,10,10,14,15,29,33,27,60,0.000333,0.09716,7,2040.352018,113.35289,291.47886,111.906328,2,0
0,0,8,8,11,14,25,27,26,53,0.000333,0.082041,5,1230.62189,68.367883,246.124378,91.356717,2,0
0,0,4,4,10,11,21,20,16,36,0.000333,0.052708,5,790.617136,43.923174,158.123427,71.273029,2,0
0,0,8,8,12,15,27,28,29,57,0.000333,0.090343,6,1626.171526,90.342863,271.028588,101.622909,2,0
0,0,4,4,10,12,22,20,17,37,0.000333,0.055,5,824.994849,45.833047,164.99897,76.238831,2,0
0,0,10,10,14,13,27,33,27,60,0.000333,0.095098,14,3994.105502,221.89475,285.29325,101.408685,3,0
0,0,14,14,11,15,26,53,50,103,0.000333,0.161382,15,7262.179365,403.454409,484.145291,96.657107,1,0
0,0,10,10,9,13,22,37,40,77,0.000333,0.114459,12,4120.514816,228.91749,343.376235,76.635041,1,0
0,0,10,10,14,18,32,36,30,66,0.000333,0.11,7,2310,128.333333,330,128.361619,2,0
0,0,9,9,14,17,31,35,26,61,0.000333,0.100735,7,2115.441825,117.524546,302.205975,122.789837,2,0
0,0,23,23,19,43,62,105,77,182,0.000333,0.361221,9,9752.973556,541.831864,1083.663728,314.040007,8,0
0,0,22,22,19,43,62,104,75,179,0.000333,0.355267,9,9592.210256,532.90057,1065.80114,314.040007,8,0
0,0,13,13,17,19,36,51,47,98,0.000333,0.168884,16,8106.442402,450.357911,506.65265,150.197491,2,0
0,0,14,14,14,15,29,50,45,95,0.000333,0.153836,21,9691.672085,538.426227,461.508195,111.906328,2,0
0,0,14,14,16,15,31,56,47,103,0.000333,0.170094,24,12246.77328,680.376293,510.28222,122.603359,3,0
0,0,13,13,16,15,31,45,38,83,0.000333,0.137066,16,6579.1727,365.509594,411.198294,122.603359,2,0
0,0,12,12,14,17,31,54,40,94,0.000333,0.155231,14,6519.722344,362.206797,465.694453,122.789837,5,0
0,0,6,6,10,10,20,16,16,32,0.000333,0.046101,5,691.508495,38.417139,138.301699,66.438562,1,0
0,0,11,11,15,13,28,39,31,70,0.000333,0.112172,14,4711.207824,261.733768,336.514845,106.709075,2,0
0,0,11,11,15,13,28,39,31,70,0.000333,0.112172,14,4711.207824,261.733768,336.514845,106.709075,2,0
0,0,9,9,13,14,27,30,22,52,0.000333,0.082418,6,1483.524901,82.41805,247.25415,101.408685,2,0
0,0,14,14,12,14,26,47,39,86,0.000333,0.134746,12,4850.853789,269.491877,404.237816,96.322519,2,0
0,0,17,17,16,17,33,60,47,107,0.000333,0.179917,16,8636.002732,479.77793,539.750171,133.486868,3,0
0,0,10,10,14,15,29,40,29,69,0.000333,0.111734,7,2346.404821,130.355823,335.200689,111.906328,2,0
0,0,13,13,12,16,28,45,40,85,0.000333,0.136208,12,4903.50202,272.416779,408.625168,107.01955,1,0
0,0,16,16,16,19,35,58,48,106,0.000333,0.181235,16,8699.263997,483.292444,543.704,144.710623,2,0
0,0,13,13,15,18,33,50,40,90,0.000333,0.151332,14,6355.93659,353.107588,453.995471,133.662009,2,0
0,0,5,5,12,12,24,22,17,39,0.000333,0.059605,6,1072.881225,59.604513,178.813538,86.0391,1,0
0,0,8,8,15,15,30,35,25,60,0.000333,0.098138,7,2060.89405,114.494114,294.413436,117.206718,2,0
0,0,9,9,12,16,28,35,33,68,0.000333,0.108967,12,3922.801616,217.933423,326.900135,107.01955,1,0
0,0,15,15,14,19,33,70,45,115,0.000333,0.193368,14,8121.474532,451.19303,580.105324,134.013592,5,0
0,0,6,6,10,10,20,16,16,32,0.000333,0.046101,5,691.508495,38.417139,138.301699,66.438562,1,0
0,0,11,11,13,24,37,46,41,87,0.000333,0.151074,6,2719.334657,151.074148,453.222443,158.144816,2,0
0,0,10,10,13,21,34,39,36,75,0.000333,0.127187,6,2289.358279,127.186571,381.559713,140.344382,2,0
0,0,10,10,13,16,29,34,27,61,0.000333,0.098779,6,1778.021044,98.778947,296.336841,112.105716,2,0
0,0,10,10,14,14,28,35,28,63,0.000333,0.100954,14,4240.087041,235.560391,302.86336,106.605938,2,0
0,0,9,9,13,20,33,37,31,68,0.000333,0.11434,6,2058.112801,114.3396,343.0188,134.544278,2,0
0,0,8,8,13,20,33,33,28,61,0.000333,0.102569,6,1846.248248,102.569347,307.708041,134.544278,2,0
0,0,8,8,13,20,33,33,28,61,0.000333,0.102569,6,1846.248248,102.569347,307.708041,134.544278,2,0
0,0,20,20,17,22,39,86,65,151,0.000333,0.266032,16,12769.53176,709.418431,798.095735,167.594364,2,0
0,0,9,9,15,17,32,40,30,70,0.000333,0.116667,7,2450,136.111111,350,128.090227,2,0
0,0,12,12,16,16,32,41,32,73,0.000333,0.121667,16,5840,324.444444,365,128,3,0
0,0,12,12,16,16,32,41,32,73,0.000333,0.121667,16,5840,324.444444,365,128,3,0
0,0,11,11,14,17,31,51,37,88,0.000333,0.145323,14,6103.569854,339.087214,435.969275,122.789837,6,0
0,0,7,7,10,12,22,20,18,38,0.000333,0.056486,5,847.292008,47.071778,169.458402,76.238831,3,0
0,0,6,6,10,13,23,20,18,38,0.000333,0.057298,5,859.476772,47.74871,171.895354,81.324997,1,0
0,0,8,8,13,19,32,34,27,61,0.000333,0.101667,6,1830,101.666667,305,128.816339,2,0
0,0,8,8,13,13,26,27,20,47,0.000333,0.07364,6,1325.524001,73.640222,220.920667,96.211433,2,0
0,0,8,8,13,13,26,27,20,47,0.000333,0.07364,6,1325.524001,73.640222,220.920667,96.211433,2,0
0,0,9,9,13,13,26,32,22,54,0.000333,0.084608,6,1522.942469,84.607915,253.823745,96.211433,2,0
0,0,9,9,14,15,29,34,27,61,0.000333,0.098779,7,2074.357885,115.242105,296.336841,111.906328,2,0
0,0,11,11,16,15,31,44,38,82,0.000333,0.135415,16,6499.905559,361.105864,406.244097,122.603359,3,0
0,0,11,11,16,17,33,42,37,79,0.000333,0.132836,16,6376.114167,354.228565,398.507135,133.486868,2,0
0,0,11,11,15,15,30,43,38,81,0.000333,0.132486,14,5564.413935,309.134108,397.458138,117.206718,3,0
0,0,11,11,15,17,32,41,37,78,0.000333,0.13,14,5460,303.333333,390,128.090227,2,0
0,0,22,22,17,42,59,118,84,202,0.000333,0.396098,16,19012.70234,1056.261241,1188.293896,295.9642,7,0
0,0,21,21,17,42,59,117,82,199,0.000333,0.390215,8,9365.167735,520.287096,1170.645967,295.9642,7,0
0,0,22,22,18,43,61,119,85,204,0.000333,0.40329,9,10888.83375,604.935208,1209.870417,308.388034,7,0
0,0,21,21,18,43,61,118,83,201,0.000333,0.397359,9,10728.70384,596.039102,1192.078205,308.388034,7,0
0,0,29,29,21,47,68,132,100,232,0.000333,0.470764,20,28245.82758,1569.212644,1412.291379,353.304342,7,0
0,0,28,28,21,47,68,131,98,229,0.000333,0.464676,20,27880.57981,1548.921101,1394.028991,353.304342,7,0
0,0,30,30,22,50,72,139,106,245,0.000333,0.503877,22,33255.89576,1847.549764,1511.631625,380.300305,8,0
0,0,29,29,22,50,72,138,104,242,0.000333,0.497707,22,32848.68071,1824.926706,1493.12185,380.300305,8,0
0,0,7,7,12,12,24,32,23,55,0.000333,0.084058,6,1513.037625,84.057646,252.172938,86.0391,1,0
0,0,11,11,15,13,28,39,29,68,0.000333,0.108967,14,4576.601886,254.25566,326.900135,106.709075,2,0
0,0,10,10,15,13,28,36,27,63,0.000333,0.100954,14,4240.087041,235.560391,302.86336,106.709075,2,0
0,0,15,15,13,18,31,59,45,104,0.000333,0.171745,12,6182.836995,343.490944,515.236416,123.164366,4,0
0,0,18,18,13,21,34,70,52,122,0.000333,0.20689,12,7448.0456,413.780311,620.670467,140.344382,5,0
0,0,12,12,14,14,28,40,35,75,0.000333,0.120184,14,5047.722668,280.429037,360.551619,106.605938,2,0
0,0,17,17,13,19,32,65,51,116,0.000333,0.193333,12,6960,386.666667,580,128.816339,4,0
0,0,20,20,13,22,35,76,58,134,0.000333,0.229108,12,8247.887091,458.21595,687.323924,146.213212,5,0
0,0,6,6,10,10,20,17,16,33,0.000333,0.047541,5,713.118136,39.617674,142.623627,66.438562,2,0
0,0,14,14,14,15,29,46,43,89,0.000333,0.14412,14,6053.04432,336.28024,432.360309,111.906328,2,0
0,0,8,8,14,17,31,30,24,54,0.000333,0.089176,7,1872.686205,104.038123,267.526601,122.789837,2,0
0,0,8,8,14,17,31,30,24,54,0.000333,0.089176,7,1872.686205,104.038123,267.526601,122.789837,2,0
0,0,6,6,10,11,21,21,17,38,0.000333,0.055636,5,834.54031,46.363351,166.908062,71.273029,1,0
0,0,5,5,10,15,25,23,22,45,0.000333,0.069658,5,1044.867643,58.048202,208.973529,91.82264,1,0
0,0,8,8,14,17,31,30,24,54,0.000333,0.089176,7,1872.686205,104.038123,267.526601,122.789837,2,0
0,0,8,8,14,17,31,30,24,54,0.000333,0.089176,7,1872.686205,104.038123,267.526601,122.789837,2,0
0,0,15,15,17,19,36,63,49,112,0.000333,0.193011,16,9264.505603,514.694756,579.0316,150.197491,2,0
0,0,11,11,15,17,32,49,36,85,0.000333,0.141667,14,5950,330.555556,425,128.090227,2,0
0,0,14,14,13,16,29,57,42,99,0.000333,0.160313,12,5771.281422,320.626746,480.940119,112.105716,2,0
0,0,17,17,15,18,33,70,50,120,0.000333,0.201776,14,8474.582121,470.810118,605.327294,133.662009,3,0
0,0,14,14,12,16,28,56,42,98,0.000333,0.15704,12,5653.449388,314.080522,471.120782,107.01955,2,0
0,0,17,17,15,18,33,69,50,119,0.000333,0.200094,14,8403.960603,466.8867,600.2829,133.662009,3,0
0,0,14,14,12,15,27,56,41,97,0.000333,0.153741,12,5534.689053,307.482725,461.224088,101.622909,2,0
0,0,17,17,15,17,32,69,49,118,0.000333,0.196667,14,8260,458.888889,590,128.090227,3,0
0,0,10,10,14,15,29,43,31,74,0.000333,0.11983,14,5032.868311,279.603795,359.490594,111.906328,2,0
0,0,14,14,12,15,27,56,41,97,0.000333,0.153741,12,5534.689053,307.482725,461.224088,101.622909,2,0
0,0,17,17,15,17,32,69,49,118,0.000333,0.196667,14,8260,458.888889,590,128.090227,3,0
0,0,10,10,14,15,29,43,31,74,0.000333,0.11983,14,5032.868311,279.603795,359.490594,111.906328,2,0
0,0,14,14,13,15,28,57,42,99,0.000333,0.158643,12,5711.137647,317.285425,475.928137,106.709075,2,0
0,0,17,17,15,17,32,70,50,120,0.000333,0.2,14,8400,466.666667,600,128.090227,3,0
0,0,10,10,14,15,29,43,31,74,0.000333,0.11983,14,5032.868311,279.603795,359.490594,111.906328,2,0
0,0,14,14,12,15,27,56,42,98,0.000333,0.155326,12,5591.747703,310.65265,465.978975,101.622909,2,0
0,0,17,17,15,17,32,69,50,119,0.000333,0.198333,14,8330,462.777778,595,128.090227,3,0
0,0,10,10,14,15,29,43,31,74,0.000333,0.11983,14,5032.868311,279.603795,359.490594,111.906328,2,0
0,0,7,7,10,12,22,30,28,58,0.000333,0.086216,10,2586.470339,143.692797,258.647034,76.238831,1,0
0,0,9,9,14,15,29,38,33,71,0.000333,0.114972,14,4828.833109,268.268506,344.916651,111.906328,2,0
0,0,13,13,16,20,36,58,45,103,0.000333,0.177501,16,8520.036402,473.335356,532.502275,150.438562,2,0
0,0,8,8,14,18,32,29,25,54,0.000333,0.09,7,1890,105,270,128.361619,2,0
0,0,8,8,14,18,32,29,25,54,0.000333,0.09,7,1890,105,270,128.361619,2,0
0,0,8,8,14,17,31,30,24,54,0.000333,0.089176,7,1872.686205,104.038123,267.526601,122.789837,2,0
0,0,8,8,14,17,31,30,24,54,0.000333,0.089176,7,1872.686205,104.038123,267.526601,122.789837,2,0
0,0,8,8,14,18,32,29,25,54,0.000333,0.09,7,1890,105,270,128.361619,2,0
0,0,8,8,12,16,28,33,27,60,0.000333,0.096147,6,1730.647772,96.147098,288.441295,107.01955,3,0
0,0,6,6,10,11,21,16,16,32,0.000333,0.046851,5,702.770788,39.042822,140.554158,71.273029,1,0
0,0,12,12,15,14,29,49,35,84,0.000333,0.136023,14,5712.98565,317.388092,408.070404,111.906328,2,0
0,0,10,10,15,14,29,45,31,76,0.000333,0.123069,14,5168.891779,287.160654,369.206556,111.906328,2,0
0,0,6,6,10,13,23,20,18,38,0.000333,0.057298,5,859.476772,47.74871,171.895354,81.324997,1,0
0,0,6,6,10,13,23,20,18,38,0.000333,0.057298,5,859.476772,47.74871,171.895354,81.324997,1,0
0,0,15,15,17,15,32,55,38,93,0.000333,0.155,16,7440,413.333333,465,128.090227,3,0
0,0,10,10,15,14,29,39,28,67,0.000333,0.108495,14,4556.786173,253.154787,325.484727,111.906328,2,0
0,0,5,5,11,12,23,20,19,39,0.000333,0.058806,5,882.094581,49.005255,176.418916,81.073298,2,0
0,0,17,17,20,20,40,63,47,110,0.000333,0.195137,20,11708.24181,650.457878,585.41209,172.877124,4,0
0,0,5,5,12,13,25,21,20,41,0.000333,0.063466,6,1142.388623,63.466035,190.398104,91.125266,2,0
0,0,17,17,20,20,40,63,47,110,0.000333,0.195137,20,11708.24181,650.457878,585.41209,172.877124,4,0
0,0,5,5,12,13,25,21,20,41,0.000333,0.063466,6,1142.388623,63.466035,190.398104,91.125266,2,0
0,0,5,5,11,12,23,20,19,39,0.000333,0.058806,5,882.094581,49.005255,176.418916,81.073298,2,0
0,0,15,15,19,20,39,60,45,105,0.000333,0.184989,18,9989.410194,554.967233,554.967233,167.149185,4,0
0,0,5,5,12,13,25,21,20,41,0.000333,0.063466,6,1142.388623,63.466035,190.398104,91.125266,2,0
0,0,15,15,19,20,39,59,45,104,0.000333,0.183227,18,9894.272954,549.681831,549.681831,167.149185,4,0
0,0,5,5,12,13,25,21,20,41,0.000333,0.063466,6,1142.388623,63.466035,190.398104,91.125266,2,0
0,0,25,25,19,23,42,111,83,194,0.000333,0.348703,27,28244.95866,1569.16437,1046.10958,184.752548,3,0
0,0,10,10,15,17,32,47,34,81,0.000333,0.135,14,5670,315,405,128.090227,2,0
0,0,6,6,10,11,21,21,17,38,0.000333,0.055636,5,834.54031,46.363351,166.908062,71.273029,1,0
0,0,6,6,10,11,21,21,17,38,0.000333,0.055636,5,834.54031,46.363351,166.908062,71.273029,1,0
0,0,11,11,14,17,31,51,37,88,0.000333,0.145323,14,6103.569854,339.087214,435.969275,122.789837,6,0
0,0,7,7,10,12,22,20,18,38,0.000333,0.056486,5,847.292008,47.071778,169.458402,76.238831,3,0
0,0,6,6,11,10,21,22,16,38,0.000333,0.055636,5,834.54031,46.363351,166.908062,71.273029,1,0
0,0,6,6,11,10,21,22,16,38,0.000333,0.055636,5,834.54031,46.363351,166.908062,71.273029,1,0
0,0,37,37,20,53,73,173,119,292,0.000333,0.602476,20,36148.57542,2008.25419,1807.428771,390.018346,10,0
0,0,25,25,16,28,44,108,77,185,0.000333,0.336665,16,16159.91759,897.7732,1009.994849,198.605938,6,0
0,0,16,16,15,20,35,55,55,110,0.000333,0.188074,14,7899.095846,438.838658,564.221132,145.041921,2,0
0,0,11,11,15,17,32,48,39,87,0.000333,0.145,14,6090,338.333333,435,128.090227,1,0
0,0,10,10,15,19,34,42,34,76,0.000333,0.128882,7,2706.530232,150.362791,386.647176,139.313982,2,0
0,0,12,12,14,24,38,52,43,95,0.000333,0.166184,7,3489.871796,193.881766,498.553114,163.342069,2,0
0,0,14,14,14,26,40,61,49,110,0.000333,0.195137,7,4097.884633,227.660257,585.41209,175.514402,3,0
0,0,11,11,15,20,35,47,37,84,0.000333,0.14362,7,3016.018414,167.556579,430.859773,145.041921,2,0
0,0,13,13,14,26,40,52,47,99,0.000333,0.175624,7,3688.09617,204.894232,526.870881,175.514402,2,0
0,0,15,15,14,28,42,61,53,114,0.000333,0.204908,7,4303.069303,239.059406,614.724186,187.908907,3,0
0,0,12,12,14,22,36,47,41,88,0.000333,0.151651,7,3184.673801,176.926322,454.9534,151.410465,2,0
0,0,9,9,13,14,27,45,31,76,0.000333,0.120457,12,4336.457402,240.9143,361.37145,101.408685,1,0
0,0,8,8,14,12,26,28,19,47,0.000333,0.07364,7,1546.444667,85.913593,220.920667,96.322519,2,0
0,0,8,8,14,12,26,28,19,47,0.000333,0.07364,7,1546.444667,85.913593,220.920667,96.322519,2,0
0,0,8,8,14,12,26,28,19,47,0.000333,0.07364,7,1546.444667,85.913593,220.920667,96.322519,2,0
0,0,8,8,14,12,26,28,19,47,0.000333,0.07364,7,1546.444667,85.913593,220.920667,96.322519,2,0
0,0,8,8,14,12,26,28,19,47,0.000333,0.07364,7,1546.444667,85.913593,220.920667,96.322519,2,0
0,0,8,8,14,12,26,28,19,47,0.000333,0.07364,7,1546.444667,85.913593,220.920667,96.322519,2,0
0,0,16,16,19,20,39,76,61,137,0.000333,0.241367,27,19550.70281,1086.150156,724.100104,167.149185,3,0
0,0,11,11,18,18,36,61,46,107,0.000333,0.184394,18,9957.275553,553.181975,553.181975,150.1173,3,0
0,0,18,18,17,18,35,73,52,125,0.000333,0.21372,16,10258.56603,569.920335,641.160377,144.545518,2,0
0,0,10,10,14,15,29,41,30,71,0.000333,0.114972,14,4828.833109,268.268506,344.916651,111.906328,2,0
0,0,20,20,17,23,40,86,71,157,0.000333,0.278514,24,20053.02506,1114.056948,835.542711,173.528793,2,0
0,0,13,13,18,19,37,54,47,101,0.000333,0.175385,18,9470.786219,526.15479,526.15479,155.769273,2,0
0,0,11,11,15,15,30,42,32,74,0.000333,0.121037,14,5083.538657,282.418814,363.109904,117.206718,2,0
0,0,10,10,15,14,29,39,28,67,0.000333,0.108495,14,4556.786173,253.154787,325.484727,111.906328,2,0
0,0,8,8,8,12,20,23,20,43,0.000333,0.061948,4,743.371632,41.298424,185.842908,67.01955,1,0
0,0,8,8,9,13,22,24,22,46,0.000333,0.068378,4,820.535418,45.585301,205.133854,76.635041,1,0
0,0,14,14,14,16,30,49,42,91,0.000333,0.148842,14,6251.378619,347.298812,446.527044,117.302969,2,0
0,0,11,11,13,16,29,45,42,87,0.000333,0.140881,12,5071.732159,281.762898,422.644347,112.105716,1,0
0,0,13,13,17,19,36,53,47,100,0.000333,0.172331,16,8271.880002,459.548889,516.9925,150.197491,2,0
0,0,13,13,13,20,33,45,40,85,0.000333,0.142925,12,5145.282002,285.849,428.7735,134.544278,2,0
0,0,15,15,13,22,35,54,46,100,0.000333,0.170976,12,6155.13962,341.952201,512.928302,146.213212,3,0
0,0,12,12,14,16,30,40,34,74,0.000333,0.121037,14,5083.538657,282.418814,363.109904,117.302969,2,0
0,0,8,8,14,12,26,28,19,47,0.000333,0.07364,7,1546.444667,85.913593,220.920667,96.322519,2,0
0,0,8,8,14,12,26,28,19,47,0.000333,0.07364,7,1546.444667,85.913593,220.920667,96.322519,2,0
0,0,12,12,17,17,34,51,36,87,0.000333,0.147536,16,7081.748275,393.43046,442.609267,138.973737,3,0
0,0,12,12,17,17,34,51,36,87,0.000333,0.147536,16,7081.748275,393.43046,442.609267,138.973737,3,0
0,0,12,12,18,16,34,51,36,87,0.000333,0.147536,18,7966.966809,442.609267,442.609267,139.05865,3,0
0,0,6,6,10,13,23,20,18,38,0.000333,0.057298,5,859.476772,47.74871,171.895354,81.324997,1,0
0,0,6,6,10,13,23,20,18,38,0.000333,0.057298,5,859.476772,47.74871,171.895354,81.324997,1,0
0,0,8,8,15,15,30,41,28,69,0.000333,0.112858,7,2370.028158,131.668231,338.575451,117.206718,2,0
0,0,8,8,14,12,26,28,19,47,0.000333,0.07364,7,1546.444667,85.913593,220.920667,96.322519,2,0
0,0,21,21,15,20,35,96,73,169,0.000333,0.28895,21,18203.82543,1011.323635,866.84883,145.041921,2,0
0,0,24,24,19,23,42,109,81,190,0.000333,0.341513,27,27662.58838,1536.810465,1024.54031,184.752548,3,0
0,0,10,10,15,17,32,47,34,81,0.000333,0.135,14,5670,315,405,128.090227,2,0
0,0,10,10,16,15,31,43,30,73,0.000333,0.120552,16,5786.501291,321.472294,361.656331,122.603359,2,0
0,0,14,14,15,18,33,59,52,111,0.000333,0.186643,14,7838.988461,435.499359,559.927747,133.662009,2,0
0,0,9,9,11,12,23,31,29,60,0.000333,0.090471,10,2714.137174,150.785399,271.413717,81.073298,1,0
0,0,9,9,11,12,23,31,29,60,0.000333,0.090471,10,2714.137174,150.785399,271.413717,81.073298,1,0
0,0,7,7,10,14,24,23,23,46,0.000333,0.070303,5,1054.541375,58.585632,210.908275,86.52225,1,0
0,0,6,6,10,10,20,17,15,32,0.000333,0.046101,5,691.508495,38.417139,138.301699,66.438562,1,0
0,0,10,10,14,20,34,42,35,77,0.000333,0.130578,7,2742.142471,152.341248,391.734639,139.741531,2,0
0,0,10,10,14,21,35,41,36,77,0.000333,0.131652,7,2764.683546,153.59353,394.954792,145.541635,2,0
0,0,9,9,13,21,34,36,30,66,0.000333,0.111924,6,2014.635285,111.924183,335.772548,140.344382,2,0
0,0,11,11,14,21,35,44,38,82,0.000333,0.1402,7,2944.208452,163.567136,420.601207,145.541635,2,0
0,0,10,10,13,23,36,40,35,75,0.000333,0.129248,6,2326.466251,129.248125,387.744375,152.147641,2,0
0,0,6,6,10,11,21,21,17,38,0.000333,0.055636,5,834.54031,46.363351,166.908062,71.273029,1,0
0,0,6,6,10,11,21,21,17,38,0.000333,0.055636,5,834.54031,46.363351,166.908062,71.273029,1,0
0,0,10,10,13,19,32,43,35,78,0.000333,0.13,6,2340,130,390,128.816339,3,0
0,0,8,8,10,14,24,26,26,52,0.000333,0.079473,5,1192.09025,66.227236,238.41805,86.52225,1,0
0,0,8,8,11,14,25,28,26,54,0.000333,0.083589,5,1253.841171,69.657843,250.768234,91.356717,1,0
0,0,18,18,18,19,37,65,57,122,0.000333,0.211851,27,17159.93939,953.329966,635.553311,155.769273,4,0
0,0,18,18,18,19,37,65,57,122,0.000333,0.211851,27,17159.93939,953.329966,635.553311,155.769273,4,0
0,0,18,18,18,19,37,65,57,122,0.000333,0.211851,27,17159.93939,953.329966,635.553311,155.769273,4,0
0,0,18,18,18,19,37,65,57,122,0.000333,0.211851,27,17159.93939,953.329966,635.553311,155.769273,4,0
0,0,20,20,19,20,39,70,60,130,0.000333,0.229034,27,18551.76179,1030.653433,687.102288,167.149185,4,0
0,0,20,20,19,20,39,70,60,130,0.000333,0.229034,27,18551.76179,1030.653433,687.102288,167.149185,4,0
0,0,18,18,18,20,38,66,58,124,0.000333,0.216914,18,11713.37421,650.743012,650.743012,161.497212,4,0
0,0,18,18,18,20,38,65,58,123,0.000333,0.215165,18,11618.91152,645.495084,645.495084,161.497212,4,0
0,0,18,18,18,20,38,66,58,124,0.000333,0.216914,18,11713.37421,650.743012,650.743012,161.497212,4,0
0,0,18,18,18,20,38,65,58,123,0.000333,0.215165,18,11618.91152,645.495084,645.495084,161.497212,4,0
0,0,18,18,18,20,38,66,58,124,0.000333,0.216914,18,11713.37421,650.743012,650.743012,161.497212,4,0
0,0,18,18,18,20,38,65,58,123,0.000333,0.215165,18,11618.91152,645.495084,645.495084,161.497212,4,0
0,0,19,19,14,19,33,85,65,150,0.000333,0.25222,21,15889.84148,882.768971,756.659118,134.013592,1,0
0,0,22,22,18,21,39,98,73,171,0.000333,0.301268,27,24402.70204,1355.705669,903.803779,167.297316,2,0
0,0,10,10,16,18,34,52,36,88,0.000333,0.149232,16,7163.14768,397.952649,447.69673,139.05865,2,0
0,0,17,17,15,20,35,95,60,155,0.000333,0.265013,21,16695.81622,927.545346,795.038868,145.041921,5,0
0,0,8,8,10,12,22,40,30,70,0.000333,0.104053,10,3121.602133,173.422341,312.160213,76.238831,1,0
0,0,17,17,16,21,37,96,61,157,0.000333,0.272628,16,13086.14685,727.008159,817.884178,156.238666,5,0
0,0,11,11,13,16,29,38,38,76,0.000333,0.123069,12,4430.478668,246.137704,369.206556,112.105716,3,0
0,0,16,16,16,18,34,60,54,114,0.000333,0.193324,24,13919.29833,773.294352,579.970764,139.05865,3,0
0,0,18,18,18,20,38,68,59,127,0.000333,0.222162,18,11996.7623,666.486794,666.486794,161.497212,4,0
0,0,11,11,15,16,31,40,39,79,0.000333,0.130461,14,5479.341119,304.40784,391.381509,122.603359,3,0
0,0,16,16,15,18,33,59,54,113,0.000333,0.190006,21,11970.34725,665.019291,570.016535,133.662009,3,0
0,0,18,18,18,20,38,67,59,126,0.000333,0.220413,18,11902.2996,661.238867,661.238867,161.497212,4,0
0,0,11,11,14,16,30,39,39,78,0.000333,0.127579,14,5358.32453,297.684696,382.737466,117.302969,3,0
0,0,16,16,12,15,27,64,50,114,0.000333,0.180686,18,9757.029154,542.057175,542.057175,101.622909,1,0
0,0,19,19,16,17,33,77,58,135,0.000333,0.226998,24,16343.83695,907.990941,680.993206,133.486868,2,0
0,0,10,10,14,15,29,43,31,74,0.000333,0.11983,14,5032.868311,279.603795,359.490594,111.906328,2,0
0,0,15,15,13,17,30,62,47,109,0.000333,0.178284,12,6418.212899,356.567383,534.851075,117.592585,1,0
0,0,18,18,17,19,36,75,55,130,0.000333,0.22403,16,10753.444,597.413556,672.09025,150.197491,2,0
0,0,10,10,15,15,30,47,32,79,0.000333,0.129215,14,5427.020999,301.501167,387.644357,117.206718,2,0
0,0,14,14,12,14,26,60,44,104,0.000333,0.162949,18,8799.223152,488.845731,488.845731,96.322519,1,0
0,0,17,17,16,16,32,73,52,125,0.000333,0.208333,24,15000,833.333333,625,128,2,0
0,0,10,10,15,15,30,47,32,79,0.000333,0.129215,14,5427.020999,301.501167,387.644357,117.206718,2,0
0,0,14,14,13,14,27,63,44,107,0.000333,0.169591,18,9157.913329,508.772963,508.772963,101.408685,1,0
0,0,17,17,17,16,33,76,52,128,0.000333,0.215227,24,15496.37874,860.90993,645.682447,133.486868,2,0
0,0,10,10,15,15,30,47,32,79,0.000333,0.129215,14,5427.020999,301.501167,387.644357,117.206718,2,0
0,0,9,9,11,13,24,38,28,66,0.000333,0.100869,10,3026.07525,168.115292,302.607525,86.159464,1,0
0,0,12,12,15,15,30,51,36,87,0.000333,0.1423,14,5976.592745,332.03293,426.899482,117.206718,2,0
0,0,10,10,15,15,30,47,32,79,0.000333,0.129215,14,5427.020999,301.501167,387.644357,117.206718,2,0
0,0,11,11,15,15,30,44,37,81,0.000333,0.132486,14,5564.413935,309.134108,397.458138,117.206718,1,0
0,0,11,11,15,15,30,45,39,84,0.000333,0.137393,14,5770.50334,320.583519,412.17881,117.206718,1,0
0,0,13,13,12,17,29,49,42,91,0.000333,0.147359,12,5304.915247,294.717514,442.076271,112.506418,2,0
0,0,16,16,16,20,36,62,50,112,0.000333,0.193011,16,9264.505603,514.694756,579.0316,150.438562,3,0
0,0,10,10,15,18,33,43,32,75,0.000333,0.12611,7,2648.306913,147.128162,378.329559,133.662009,2,0
0,0,9,9,13,15,28,33,31,64,0.000333,0.102557,12,3692.04858,205.11381,307.670715,106.709075,2,0
0,0,10,10,13,19,32,33,35,68,0.000333,0.113333,6,2040,113.333333,340,128.816339,2,0
0,0,8,8,12,11,23,29,24,53,0.000333,0.079916,12,2876.985404,159.832522,239.748784,81.073298,1,0
0,0,17,17,18,18,36,63,53,116,0.000333,0.199904,18,10794.8034,599.7113,599.7113,150.1173,2,0
0,0,13,13,16,14,30,52,36,88,0.000333,0.143935,16,6908.901959,383.827887,431.806372,117.302969,2,0
0,0,11,11,16,14,30,48,32,80,0.000333,0.13085,16,6280.819962,348.934442,392.551248,117.302969,2,0
0,0,12,12,13,14,27,48,41,89,0.000333,0.141062,12,5078.219852,282.123325,423.184988,101.408685,2,0
0,0,12,12,13,14,27,48,41,89,0.000333,0.141062,12,5078.219852,282.123325,423.184988,101.408685,2,0
0,0,9,9,13,14,27,39,28,67,0.000333,0.106192,12,3822.929552,212.384975,318.577463,101.408685,2,0
0,0,9,9,12,14,26,38,28,66,0.000333,0.10341,12,3722.748257,206.819348,310.229021,96.322519,2,0
0,0,10,10,14,15,29,44,33,77,0.000333,0.124688,14,5236.903513,290.939084,374.064537,111.906328,2,0
0,0,9,9,12,12,24,38,27,65,0.000333,0.099341,12,3576.270751,198.681708,298.022563,86.0391,2,0
0,0,15,15,13,20,33,64,47,111,0.000333,0.186643,12,6719.132967,373.285165,559.927747,134.544278,4,0
0,0,14,14,13,22,35,56,42,98,0.000333,0.167557,6,3016.018414,167.556579,502.669736,146.213212,4,0
0,0,12,12,13,16,29,44,35,79,0.000333,0.127927,12,4605.365983,255.853666,383.780499,112.105716,2,0
0,0,8,8,10,13,23,25,22,47,0.000333,0.070869,5,1063.03706,59.057614,212.607412,81.324997,1,0
0,0,13,13,13,17,30,48,38,86,0.000333,0.140664,12,5063.911095,281.328394,421.992591,117.592585,2,0
0,0,13,13,14,15,29,42,36,78,0.000333,0.126308,14,5304.915247,294.717514,378.922518,111.906328,2,0
0,0,12,12,14,15,29,40,34,74,0.000333,0.11983,14,5032.868311,279.603795,359.490594,111.906328,2,0
0,0,14,14,14,18,32,45,42,87,0.000333,0.145,14,6090,338.333333,435,128.361619,2,0
0,0,13,13,14,18,32,43,40,83,0.000333,0.138333,14,5810,322.777778,415,128.361619,2,0
0,0,15,15,12,19,31,51,45,96,0.000333,0.158534,12,5707.23415,317.068564,475.602846,123.730173,2,0
0,0,17,17,12,21,33,60,51,111,0.000333,0.186643,12,6719.132967,373.285165,559.927747,135.258216,3,0
0,0,14,14,14,15,29,46,43,89,0.000333,0.14412,14,6053.04432,336.28024,432.360309,111.906328,2,0
0,0,9,9,12,16,28,37,29,66,0.000333,0.105762,6,1903.712549,105.761808,317.285425,107.01955,3,0
0,0,6,6,10,10,20,17,15,32,0.000333,0.046101,5,691.508495,38.417139,138.301699,66.438562,1,0
0,0,9,9,13,19,32,39,29,68,0.000333,0.113333,6,2040,113.333333,340,128.816339,2,0
0,0,8,8,13,19,32,34,27,61,0.000333,0.101667,6,1830,101.666667,305,128.816339,2,0
0,0,8,8,13,19,32,34,27,61,0.000333,0.101667,6,1830,101.666667,305,128.816339,2,0
0,0,8,8,13,19,32,34,27,61,0.000333,0.101667,6,1830,101.666667,305,128.816339,2,0
0,0,8,8,13,19,32,34,27,61,0.000333,0.101667,6,1830,101.666667,305,128.816339,2,0
0,0,8,8,13,19,32,34,27,61,0.000333,0.101667,6,1830,101.666667,305,128.816339,2,0
0,0,9,9,13,14,27,39,33,72,0.000333,0.114117,12,4108.222802,228.2346,342.3519,101.408685,1,0
0,0,5,5,12,12,24,26,20,46,0.000333,0.070303,6,1265.44965,70.302758,210.908275,86.0391,1,0
0,0,31,31,23,49,72,143,104,247,0.000333,0.50799,22,33527.37246,1862.631803,1523.971475,379.162707,8,0
0,0,30,30,23,49,72,142,102,244,0.000333,0.501821,22,33120.15741,1840.008745,1505.4617,379.162707,8,0
0,0,5,5,11,12,23,20,19,39,0.000333,0.058806,5,882.094581,49.005255,176.418916,81.073298,2,0
0,0,16,16,19,22,41,71,55,126,0.000333,0.225017,18,12150.92795,675.051553,675.051553,178.818118,3,0
0,0,5,5,12,13,25,21,20,41,0.000333,0.063466,6,1142.388623,63.466035,190.398104,91.125266,2,0
0,0,31,31,23,48,71,150,104,254,0.000333,0.520679,22,34364.7869,1909.154828,1562.035768,372.120125,8,0
0,0,30,30,23,48,71,149,102,251,0.000333,0.514529,22,33958.90359,1886.605755,1543.586527,372.120125,8,0
0,0,19,19,12,19,31,69,60,129,0.000333,0.21303,18,11503.64383,639.091324,639.091324,123.730173,2,0
0,0,22,22,16,22,38,82,68,150,0.000333,0.262396,24,18892.53905,1049.585503,787.189127,162.107496,3,0
0,0,10,10,15,19,34,44,33,77,0.000333,0.130578,7,2742.142471,152.341248,391.734639,139.313982,2,0
0,0,12,12,16,16,32,46,34,80,0.000333,0.133333,16,6400,355.555556,400,128,3,0
0,0,12,12,16,16,32,46,34,80,0.000333,0.133333,16,6400,355.555556,400,128,3,0
0,0,12,12,14,17,31,54,40,94,0.000333,0.155231,14,6519.722344,362.206797,465.694453,122.789837,5,0
0,0,6,6,10,10,20,16,16,32,0.000333,0.046101,5,691.508495,38.417139,138.301699,66.438562,1,0
0,0,18,18,15,26,41,84,64,148,0.000333,0.264306,14,11100.84775,616.713764,792.917697,180.814792,6,0
0,0,12,12,13,21,34,46,43,89,0.000333,0.150928,12,5433.410314,301.856129,452.784193,140.344382,2,0
0,0,8,8,13,19,32,34,27,61,0.000333,0.101667,6,1830,101.666667,305,128.816339,2,0
0,0,11,11,14,20,34,44,37,81,0.000333,0.137361,7,2884.591431,160.255079,412.08449,139.741531,2,0
0,0,12,12,17,20,37,56,43,99,0.000333,0.171912,16,8251.774131,458.431896,515.735883,155.92543,2,0
0,0,25,25,18,45,63,115,85,200,0.000333,0.398485,9,10759.10386,597.727992,1195.455985,322.192039,9,0
0,0,24,24,18,45,63,114,83,197,0.000333,0.392508,9,10597.7173,588.762072,1177.524145,322.192039,9,0
0,0,11,11,16,15,31,44,38,82,0.000333,0.135415,16,6499.905559,361.105864,406.244097,122.603359,3,0
0,0,11,11,16,17,33,42,37,79,0.000333,0.132836,16,6376.114167,354.228565,398.507135,133.486868,2,0
0,0,11,11,17,15,32,48,40,88,0.000333,0.146667,16,7040,391.111111,440,128.090227,4,0
0,0,11,11,17,17,34,46,39,85,0.000333,0.144145,16,6918.949464,384.386081,432.434342,138.973737,3,0
0,0,12,12,18,20,38,57,43,100,0.000333,0.174931,18,9446.269524,524.792751,524.792751,161.497212,2,0
0,0,8,8,11,17,28,32,25,57,0.000333,0.09134,5,1370.096153,76.116453,274.019231,107.540616,3,0
0,0,9,9,11,17,28,33,27,60,0.000333,0.096147,5,1442.206477,80.122582,288.441295,107.540616,3,0
0,0,15,15,11,15,26,59,48,107,0.000333,0.167649,15,7544.205748,419.122542,502.94705,96.657107,1,0
0,0,18,18,15,17,32,72,56,128,0.000333,0.213333,21,13440,746.666667,640,128.090227,2,0
0,0,10,10,13,15,28,45,33,78,0.000333,0.124991,12,4499.684207,249.982456,374.973684,106.709075,2,0
0,0,13,13,12,21,33,51,43,94,0.000333,0.158058,12,5690.076567,316.115365,474.173047,135.258216,2,0
0,0,14,14,12,21,33,52,45,97,0.000333,0.163102,12,5871.674755,326.204153,489.30623,135.258216,2,0
0,0,14,14,13,22,35,56,48,104,0.000333,0.177815,12,6401.345205,355.630289,533.445434,146.213212,3,0
0,0,15,15,13,22,35,57,50,107,0.000333,0.182944,12,6585.999394,365.888855,548.833283,146.213212,3,0
0,0,6,6,16,15,31,33,24,57,0.000333,0.09413,8,2259.113518,125.506307,282.38919,122.603359,5,0
0,0,7,7,16,16,32,34,26,60,0.000333,0.1,8,2400,133.333333,300,128,5,0
0,0,6,6,10,13,23,20,18,38,0.000333,0.057298,5,859.476772,47.74871,171.895354,81.324997,1,0
0,0,6,6,10,13,23,20,18,38,0.000333,0.057298,5,859.476772,47.74871,171.895354,81.324997,1,0
0,0,13,13,11,15,26,47,40,87,0.000333,0.136313,10,4089.382555,227.18792,408.938255,96.657107,1,0
0,0,18,18,11,17,28,62,62,124,0.000333,0.198704,15,8941.680155,496.760009,596.11201,107.540616,1,0
0,0,10,10,17,16,33,42,33,75,0.000333,0.12611,16,6053.272943,336.292941,378.329559,133.486868,2,0
0,0,10,10,16,16,32,41,33,74,0.000333,0.123333,16,5920,328.888889,370,128,2,0
0,0,8,8,13,19,32,34,27,61,0.000333,0.101667,6,1830,101.666667,305,128.816339,2,0
0,0,13,13,16,17,33,52,39,91,0.000333,0.153013,16,7344.637838,408.035435,459.039865,133.486868,2,0
0,0,13,13,17,18,35,53,42,95,0.000333,0.162427,16,7796.510186,433.139455,487.281887,144.545518,2,0
0,0,9,9,15,16,31,39,29,68,0.000333,0.112295,7,2358.197444,131.010969,336.885349,122.603359,2,0
0,0,8,8,13,14,27,38,31,69,0.000333,0.109362,12,3937.046852,218.724825,328.087238,101.408685,1,0
0,0,15,15,14,18,32,70,54,124,0.000333,0.206667,21,13020,723.333333,620,128.361619,1,0
0,0,8,8,14,18,32,35,26,61,0.000333,0.101667,7,2135,118.611111,305,128.361619,2,0
0,0,8,8,14,18,32,35,26,61,0.000333,0.101667,7,2135,118.611111,305,128.361619,2,0
0,0,8,8,13,14,27,25,22,47,0.000333,0.074493,6,1340.878276,74.493238,223.479713,101.408685,2,0
0,0,8,8,13,14,27,25,22,47,0.000333,0.074493,6,1340.878276,74.493238,223.479713,101.408685,2,0
0,0,12,12,15,19,34,55,43,98,0.000333,0.16619,14,6979.999018,387.777723,498.571358,139.313982,5,0
0,0,8,8,10,12,22,25,23,48,0.000333,0.071351,5,1070.263588,59.459088,214.052718,76.238831,1,0
0,0,17,17,16,22,38,66,56,122,0.000333,0.213416,16,10243.95451,569.108584,640.247157,162.107496,2,0
0,0,17,17,17,22,39,66,58,124,0.000333,0.218463,16,10486.238,582.568778,655.389875,167.594364,2,0
0,0,21,21,17,22,39,82,74,156,0.000333,0.274841,24,19788.54591,1099.363662,824.522746,167.594364,2,0
0,0,11,11,11,13,24,39,30,69,0.000333,0.105454,10,3163.624125,175.756896,316.362413,86.159464,2,0
0,0,14,14,15,16,31,52,38,90,0.000333,0.148626,14,6242.287351,346.793742,445.877668,122.603359,3,0
0,0,10,10,14,15,29,40,29,69,0.000333,0.111734,7,2346.404821,130.355823,335.200689,111.906328,2,0
0,0,15,15,16,16,32,50,42,92,0.000333,0.153333,16,7360,408.888889,460,128,3,0
0,0,15,15,16,16,32,50,42,92,0.000333,0.153333,16,7360,408.888889,460,128,3,0
0,0,15,15,16,17,33,51,43,94,0.000333,0.158058,16,7586.768756,421.487153,474.173047,133.486868,3,0
0,0,15,15,16,17,33,50,43,93,0.000333,0.156376,16,7506.05845,417.003247,469.128653,133.486868,3,0
0,0,15,15,16,17,33,50,42,92,0.000333,0.154695,16,7425.348144,412.519341,464.084259,133.486868,3,0
0,0,15,15,16,17,33,50,42,92,0.000333,0.154695,16,7425.348144,412.519341,464.084259,133.486868,3,0
0,0,11,11,11,13,24,39,30,69,0.000333,0.105454,10,3163.624125,175.756896,316.362413,86.159464,2,0
0,0,14,14,15,16,31,52,38,90,0.000333,0.148626,14,6242.287351,346.793742,445.877668,122.603359,3,0
0,0,19,19,12,18,30,70,60,130,0.000333,0.212632,18,11482.12399,637.895777,637.895777,118.0782,2,0
0,0,22,22,16,21,37,83,68,151,0.000333,0.262209,24,18879.059,1048.836611,786.627458,156.238666,3,0
0,0,10,10,15,18,33,44,33,77,0.000333,0.129473,7,2718.92843,151.051579,388.418347,133.662009,2,0
0,0,15,15,13,19,32,59,46,105,0.000333,0.175,12,6300,350,525,128.816339,4,0
0,0,12,12,13,15,28,39,36,75,0.000333,0.120184,12,4326.61943,240.367746,360.551619,106.709075,2,0
0,0,20,20,19,19,38,72,66,138,0.000333,0.241405,27,19553.77792,1086.320995,724.213997,161.421246,3,0
0,0,19,19,18,19,37,68,64,132,0.000333,0.229216,27,18566.4918,1031.471766,687.647844,155.769273,3,0
0,0,17,17,18,16,34,70,47,117,0.000333,0.198411,18,10714.19674,595.233152,595.233152,139.05865,2,0
0,0,11,11,16,14,30,48,32,80,0.000333,0.13085,16,6280.819962,348.934442,392.551248,117.302969,2,0
0,0,19,19,18,17,35,74,56,130,0.000333,0.222269,27,18003.78339,1000.210188,666.806792,144.545518,3,0
0,0,11,11,16,14,30,48,32,80,0.000333,0.13085,16,6280.819962,348.934442,392.551248,117.302969,2,0
0,0,19,19,18,17,35,74,56,130,0.000333,0.222269,27,18003.78339,1000.210188,666.806792,144.545518,3,0
0,0,11,11,16,14,30,48,32,80,0.000333,0.13085,16,6280.819962,348.934442,392.551248,117.302969,2,0
0,0,17,17,13,20,33,65,52,117,0.000333,0.196731,12,7082.329344,393.462741,590.194112,134.544278,4,0
0,0,14,14,13,16,29,45,44,89,0.000333,0.14412,12,5188.323703,288.240206,432.360309,112.105716,2,0
0,0,15,15,14,26,40,66,53,119,0.000333,0.211103,14,8866.332206,492.574011,633.309443,175.514402,4,0
0,0,12,12,13,21,34,46,43,89,0.000333,0.150928,12,5433.410314,301.856129,452.784193,140.344382,2,0
0,0,14,14,12,15,27,46,39,85,0.000333,0.134722,12,4849.985252,269.443625,404.165438,101.622909,2,0
0,0,17,17,16,18,34,59,47,106,0.000333,0.179757,16,8628.336979,479.352054,539.271061,139.05865,3,0
0,0,18,18,12,16,28,72,62,134,0.000333,0.214729,18,11595.34007,644.18556,644.18556,107.01955,1,0
0,0,21,21,16,18,34,85,70,155,0.000333,0.262852,24,18925.36177,1051.408987,788.55674,139.05865,2,0
0,0,10,10,14,15,29,49,34,83,0.000333,0.134404,14,5644.973916,313.609662,403.212423,111.906328,2,0
0,0,7,7,10,12,22,36,26,62,0.000333,0.092162,10,2764.847604,153.602645,276.48476,76.238831,1,0
0,0,10,10,14,15,29,49,34,83,0.000333,0.134404,14,5644.973916,313.609662,403.212423,111.906328,2,0
0,0,9,9,11,13,24,38,28,66,0.000333,0.100869,10,3026.07525,168.115292,302.607525,86.159464,1,0
0,0,12,12,15,15,30,51,36,87,0.000333,0.1423,14,5976.592745,332.03293,426.899482,117.206718,2,0
0,0,10,10,15,15,30,47,32,79,0.000333,0.129215,14,5427.020999,301.501167,387.644357,117.206718,2,0
0,0,9,9,10,12,22,31,24,55,0.000333,0.081756,10,2452.68739,136.260411,245.268739,76.238831,1,0
0,0,9,9,11,13,24,32,26,58,0.000333,0.088643,10,2659.27825,147.737681,265.927825,86.159464,1,0
0,0,17,17,12,17,29,75,56,131,0.000333,0.212132,18,11455.11919,636.39551,636.39551,112.506418,1,0
0,0,20,20,16,19,35,88,64,152,0.000333,0.259884,24,18711.62445,1039.534691,779.651019,144.710623,2,0
0,0,10,10,14,16,30,51,34,85,0.000333,0.139029,14,5839.199809,324.399989,417.085701,117.302969,2,0
0,0,17,17,16,19,35,74,54,128,0.000333,0.218849,16,10504.77162,583.598423,656.548226,144.710623,2,0
0,0,17,17,13,17,30,67,55,122,0.000333,0.199547,18,10775.53175,598.640653,598.640653,117.592585,1,0
0,0,20,20,17,19,36,80,63,143,0.000333,0.246433,24,17743.18261,985.732367,739.299275,150.197491,2,0
0,0,10,10,14,17,31,48,34,82,0.000333,0.135415,14,5687.417364,315.967631,406.244097,122.789837,2,0
0,0,13,13,12,14,26,48,45,93,0.000333,0.145714,18,7868.536088,437.140894,437.140894,96.322519,1,0
0,0,15,15,16,16,32,56,50,106,0.000333,0.176667,24,12720,706.666667,530,128,2,0
0,0,16,16,15,30,45,77,59,136,0.000333,0.248964,7,5228.244148,290.458008,746.892021,205.810077,6,0
0,0,10,10,13,21,34,39,36,75,0.000333,0.127187,6,2289.358279,127.186571,381.559713,140.344382,2,0
0,0,11,11,18,18,36,48,39,87,0.000333,0.149928,18,8096.102552,449.783475,449.783475,150.1173,2,0
0,0,11,11,15,15,30,40,35,75,0.000333,0.122672,14,5152.235125,286.235285,368.016795,117.206718,2,0
0,0,17,17,15,17,32,57,54,111,0.000333,0.185,21,11655,647.5,555,128.090227,2,0
0,0,17,17,16,17,33,60,54,114,0.000333,0.191687,24,13801.46231,766.747906,575.06093,133.486868,2,0
0,0,8,8,10,13,23,29,25,54,0.000333,0.081424,5,1221.361728,67.853429,244.272346,81.324997,1,0
0,0,11,11,14,15,29,42,33,75,0.000333,0.12145,14,5100.880045,283.382225,364.348575,111.906328,2,0
0,0,9,9,14,15,29,38,29,67,0.000333,0.108495,7,2278.393087,126.577394,325.484727,111.906328,2,0
0,0,10,10,12,15,27,42,37,79,0.000333,0.125212,12,4507.633352,250.424075,375.636113,101.622909,1,0
0,0,13,13,16,18,34,55,45,100,0.000333,0.169582,16,8139.940546,452.218919,508.746284,139.05865,2,0
0,0,9,9,15,17,32,42,32,74,0.000333,0.123333,7,2590,143.888889,370,128.090227,2,0
0,0,8,8,14,13,27,31,28,59,0.000333,0.093513,14,3927.537077,218.196504,280.538363,101.408685,2,0
0,0,8,8,15,13,28,35,30,65,0.000333,0.104159,14,4374.692979,243.038499,312.47807,106.709075,3,0
0,0,12,12,16,15,31,43,36,79,0.000333,0.130461,16,6262.104136,347.894674,391.381509,122.603359,2,0
0,0,14,14,15,26,41,66,50,116,0.000333,0.207159,7,4350.332228,241.685124,621.476033,180.814792,4,0
0,0,11,11,14,21,35,46,38,84,0.000333,0.14362,7,3016.018414,167.556579,430.859773,145.541635,2,0
0,0,11,11,14,20,34,44,37,81,0.000333,0.137361,7,2884.591431,160.255079,412.08449,139.741531,2,0
0,0,7,7,13,15,28,30,28,58,0.000333,0.092942,6,1672.959513,92.942195,278.826585,106.709075,2,0
0,0,14,14,15,20,35,57,52,109,0.000333,0.186364,14,7827.285884,434.849216,559.091849,145.041921,2,0
0,0,16,16,19,23,42,65,57,122,0.000333,0.219288,18,11841.52906,657.862726,657.862726,184.752548,3,0
0,0,7,7,13,16,29,30,29,59,0.000333,0.09554,6,1719.725272,95.540293,286.620879,112.105716,2,0
0,0,8,8,14,18,32,35,26,61,0.000333,0.101667,7,2135,118.611111,305,128.361619,2,0
0,0,8,8,14,18,32,35,26,61,0.000333,0.101667,7,2135,118.611111,305,128.361619,2,0
0,0,17,17,14,19,33,62,51,113,0.000333,0.190006,14,7980.231497,443.346194,570.016535,134.013592,2,0
0,0,16,16,14,19,33,60,49,109,0.000333,0.18328,14,7697.745426,427.652524,549.838959,134.013592,2,0
0,0,18,18,16,27,43,93,65,158,0.000333,0.285783,16,13717.5973,762.088739,857.349831,192.381963,6,0
0,0,12,12,14,22,36,55,42,97,0.000333,0.167161,7,3510.379076,195.02106,501.482725,151.410465,2,0
0,0,17,17,17,16,33,67,49,116,0.000333,0.19505,24,14043.59323,780.199624,585.149718,133.486868,2,0
0,0,11,11,15,14,29,50,34,84,0.000333,0.136023,14,5712.98565,317.388092,408.070404,111.906328,2,0
0,0,21,21,17,18,35,79,65,144,0.000333,0.246206,24,17726.80211,984.822339,738.616754,144.545518,2,0
0,0,11,11,15,14,29,50,34,84,0.000333,0.136023,14,5712.98565,317.388092,408.070404,111.906328,2,0
0,0,7,7,10,12,22,24,19,43,0.000333,0.063919,5,958.777798,53.265433,191.75556,76.238831,1,0
0,0,8,8,10,12,22,27,23,50,0.000333,0.074324,5,1114.857905,61.93655,222.971581,76.238831,1,0
0,0,17,17,15,19,34,80,51,131,0.000333,0.222153,14,9330.406851,518.355936,666.457632,139.313982,5,0
0,0,8,8,10,10,20,25,21,46,0.000333,0.06627,10,1988.086924,110.449274,198.808692,66.438562,1,0
0,0,17,17,16,20,36,81,52,133,0.000333,0.2292,16,11001.6004,611.200022,687.600025,150.438562,5,0
0,0,21,21,16,23,39,97,65,162,0.000333,0.285412,16,13699.76255,761.09792,856.235159,168.041925,5,0
0,0,12,12,11,16,27,42,37,79,0.000333,0.125212,10,3756.361127,208.686729,375.636113,102.053748,1,0
0,0,21,21,18,24,42,100,68,168,0.000333,0.30197,18,16306.36789,905.909327,905.909327,185.09775,5,0
0,0,5,5,11,12,23,20,19,39,0.000333,0.058806,5,882.094581,49.005255,176.418916,81.073298,2,0
0,0,13,13,17,19,36,50,40,90,0.000333,0.155098,16,7444.692002,413.594,465.29325,150.197491,3,0
0,0,5,5,12,13,25,21,20,41,0.000333,0.063466,6,1142.388623,63.466035,190.398104,91.125266,2,0
0,0,4,4,10,11,21,19,15,34,0.000333,0.04978,5,746.693962,41.482998,149.338792,71.273029,2,0
0,0,8,8,11,13,24,26,23,49,0.000333,0.074888,5,1123.315813,62.406434,224.663163,86.159464,2,0
0,0,4,4,10,12,22,19,16,35,0.000333,0.052027,5,780.400533,43.355585,156.080107,76.238831,2,0
0,0,8,8,12,14,26,27,26,53,0.000333,0.083041,6,1494.73983,83.041102,249.123305,96.322519,2,0
0,0,23,23,17,27,44,107,71,178,0.000333,0.323926,16,15548.46125,863.803403,971.778828,197.868831,6,0
0,0,14,14,15,20,35,53,43,96,0.000333,0.164137,14,6893.756375,382.986465,492.41117,145.041921,2,0
0,0,16,16,15,24,39,74,55,129,0.000333,0.227272,14,9545.436407,530.302023,681.816886,168.642459,6,0
0,0,10,10,14,18,32,36,32,68,0.000333,0.113333,7,2380,132.222222,340,128.361619,2,0
0,0,10,10,15,18,33,37,32,69,0.000333,0.116021,7,2436.44236,135.357909,348.063194,133.662009,2,0
0,0,9,9,13,14,27,35,27,62,0.000333,0.098268,6,1768.818151,98.267675,294.803025,101.408685,1,0
0,0,28,28,21,45,66,124,95,219,0.000333,0.441241,20,26474.44624,1470.802569,1323.722312,339.372055,7,0
0,0,27,27,21,45,66,123,93,216,0.000333,0.435196,20,26111.7826,1450.654589,1305.58913,339.372055,7,0
0,0,29,29,22,46,68,129,100,229,0.000333,0.464676,22,30668.63779,1703.813211,1394.028991,352.191346,8,0
0,0,28,28,22,46,68,128,98,226,0.000333,0.458589,22,30266.86525,1681.492514,1375.766602,352.191346,8,0
0,0,22,22,17,40,57,101,74,175,0.000333,0.340252,8,8166.04602,453.669223,1020.755752,282.363992,7,0
0,0,21,21,17,40,57,100,72,172,0.000333,0.334419,8,8026.056659,445.892037,1003.257082,282.363992,7,0
0,0,22,22,18,41,59,102,75,177,0.000333,0.347076,9,9371.050378,520.61391,1041.22782,294.718282,7,0
0,0,21,21,18,41,59,101,73,174,0.000333,0.341193,9,9212.219015,511.789945,1023.579891,294.718282,7,0
0,0,21,21,17,18,35,79,65,144,0.000333,0.246206,24,17726.80211,984.822339,738.616754,144.545518,2,0
0,0,11,11,15,14,29,50,34,84,0.000333,0.136023,14,5712.98565,317.388092,408.070404,111.906328,2,0
0,0,17,17,15,17,32,68,58,126,0.000333,0.21,21,13230,735,630,128.090227,2,0
0,0,11,11,15,14,29,50,34,84,0.000333,0.136023,14,5712.98565,317.388092,408.070404,111.906328,2,0
0,0,11,11,16,14,30,48,32,80,0.000333,0.13085,16,6280.819962,348.934442,392.551248,117.302969,2,0
0,0,12,12,16,16,32,43,32,75,0.000333,0.125,16,6000,333.333333,375,128,3,0
0,0,12,12,16,16,32,42,32,74,0.000333,0.123333,16,5920,328.888889,370,128,3,0
0,0,12,12,17,14,31,42,31,73,0.000333,0.120552,16,5786.501291,321.472294,361.656331,122.789837,3,0
0,0,12,12,16,15,31,43,36,79,0.000333,0.130461,16,6262.104136,347.894674,391.381509,122.603359,2,0
0,0,10,10,16,15,31,42,34,76,0.000333,0.125506,16,6024.302713,334.683484,376.51892,122.603359,2,0
0,0,7,7,13,15,28,30,28,58,0.000333,0.092942,6,1672.959513,92.942195,278.826585,106.709075,2,0
0,0,14,14,14,20,34,56,52,108,0.000333,0.183149,14,7692.243816,427.346879,549.445987,139.741531,2,0
0,0,16,16,18,23,41,64,57,121,0.000333,0.216088,18,11668.74827,648.263793,648.263793,179.100575,3,0
0,0,7,7,13,16,29,30,29,59,0.000333,0.09554,6,1719.725272,95.540293,286.620879,112.105716,2,0
0,0,12,12,12,15,27,40,38,78,0.000333,0.123627,12,4450.574702,247.25415,370.881225,101.622909,1,0
0,0,11,11,12,14,26,48,36,84,0.000333,0.131612,12,4738.043236,263.224624,394.836936,96.322519,1,0
0,0,3,3,8,8,16,11,11,22,0.000333,0.029333,4,352,19.555556,88,48,1,0
0,0,13,13,13,22,35,53,44,97,0.000333,0.165847,12,5970.485432,331.693635,497.540453,146.213212,2,0
0,0,15,15,13,25,38,62,50,112,0.000333,0.195923,12,7053.214578,391.845254,587.767882,164.202121,3,0
0,0,11,11,12,19,31,40,34,74,0.000333,0.122204,6,2199.663162,122.203509,366.610527,123.730173,2,0
0,0,12,12,15,19,34,48,38,86,0.000333,0.145841,14,6125.305261,340.294737,437.521804,139.313982,2,0
0,0,8,8,11,12,23,26,21,47,0.000333,0.070869,5,1063.03706,59.057614,212.607412,81.073298,1,0
0,0,13,13,15,20,35,52,41,93,0.000333,0.159008,14,6678.326488,371.018138,477.023321,145.041921,2,0
0,0,13,13,14,23,37,48,44,92,0.000333,0.159757,7,3354.887967,186.382665,479.26971,157.344894,2,0
0,0,15,15,14,26,40,57,50,107,0.000333,0.189815,7,3986.124143,221.451341,569.446306,175.514402,3,0
0,0,12,12,15,20,35,43,38,81,0.000333,0.138491,7,2908.303471,161.572415,415.471924,145.041921,2,0
0,0,15,15,15,25,40,62,52,114,0.000333,0.202233,14,8493.797239,471.877624,606.699803,174.699764,2,0
0,0,17,17,15,28,43,71,58,129,0.000333,0.233329,14,9799.834147,544.43523,699.988153,193.209297,3,0
0,0,14,14,17,22,39,57,46,103,0.000333,0.181465,16,8710.342857,483.907936,544.396429,167.594364,2,0
0,0,11,11,14,15,29,36,34,70,0.000333,0.113353,14,4760.821375,264.490076,340.05867,111.906328,2,0
0,0,11,11,14,15,29,36,34,70,0.000333,0.113353,14,4760.821375,264.490076,340.05867,111.906328,2,0
0,0,8,8,13,14,27,25,22,47,0.000333,0.074493,6,1340.878276,74.493238,223.479713,101.408685,2,0
0,0,8,8,13,14,27,25,22,47,0.000333,0.074493,6,1340.878276,74.493238,223.479713,101.408685,2,0
0,0,9,9,13,14,27,29,25,54,0.000333,0.085588,6,1540.583551,85.587975,256.763925,101.408685,2,0
0,0,17,17,14,18,32,53,55,108,0.000333,0.18,21,11340,630,540,128.361619,2,0
0,0,13,13,14,16,30,41,41,82,0.000333,0.134122,14,5633.110404,312.950578,402.365029,117.302969,2,0
0,0,10,10,10,12,22,29,30,59,0.000333,0.087702,10,2631.064655,146.170259,263.106465,76.238831,1,0
0,0,9,9,12,13,25,26,23,49,0.000333,0.07585,6,1365.29372,75.849651,227.548953,91.125266,2,0
0,0,11,11,11,14,25,33,34,67,0.000333,0.103713,10,3111.383647,172.854647,311.138365,91.356717,1,0
0,0,9,9,13,14,27,27,24,51,0.000333,0.080833,6,1454.995576,80.833088,242.499263,101.408685,2,0
0,0,8,8,9,11,20,22,24,46,0.000333,0.06627,8,1590.469539,88.359419,198.808692,66.583073,1,0
0,0,11,11,14,14,28,34,29,63,0.000333,0.100954,14,4240.087041,235.560391,302.86336,106.605938,2,0
0,0,8,8,10,12,22,23,25,48,0.000333,0.071351,10,2140.527177,118.918176,214.052718,76.238831,1,0
0,0,12,12,14,16,30,38,35,73,0.000333,0.119401,14,5014.842189,278.602344,358.203013,117.302969,2,0
0,0,6,6,11,10,21,22,16,38,0.000333,0.055636,5,834.54031,46.363351,166.908062,71.273029,1,0
0,0,6,6,11,10,21,22,16,38,0.000333,0.055636,5,834.54031,46.363351,166.908062,71.273029,1,0
0,0,11,11,12,15,27,53,42,95,0.000333,0.150571,12,5420.571752,301.142875,451.714313,101.622909,2,0
0,0,10,10,11,15,26,51,40,91,0.000333,0.14258,10,4277.400144,237.633341,427.740014,96.657107,2,0
0,0,18,18,18,22,40,75,60,135,0.000333,0.239487,18,12932.28527,718.460293,718.460293,173.166146,2,0
0,0,17,17,18,22,40,73,58,131,0.000333,0.232391,18,12549.10645,697.17258,697.17258,173.166146,2,0
0,0,22,22,18,39,57,99,73,172,0.000333,0.334419,9,9029.313742,501.628541,1003.257082,281.189337,7,0
0,0,18,18,18,38,56,92,65,157,0.000333,0.303918,9,8205.792505,455.877361,911.754723,274.479896,7,0
0,0,22,22,18,40,58,100,76,176,0.000333,0.343668,9,9279.041896,515.502328,1031.004655,287.935774,7,0
0,0,18,18,18,39,57,92,66,158,0.000333,0.307199,9,8294.3696,460.798311,921.596622,281.189337,7,0
0,0,10,10,9,15,24,36,33,69,0.000333,0.105454,8,2530.8993,140.605517,316.362413,87.132684,1,0
0,0,9,9,13,13,26,26,24,50,0.000333,0.078341,6,1410.131915,78.340662,235.021986,96.211433,2,0
0,0,9,9,13,13,26,26,24,50,0.000333,0.078341,6,1410.131915,78.340662,235.021986,96.211433,2,0
0,0,10,10,14,14,28,29,25,54,0.000333,0.086532,7,1817.180161,100.954453,259.597166,106.605938,3,0
0,0,10,10,14,14,28,29,25,54,0.000333,0.086532,7,1817.180161,100.954453,259.597166,106.605938,3,0
0,0,11,11,13,14,27,33,32,65,0.000333,0.103023,12,3708.812252,206.045125,309.067688,101.408685,2,0
0,0,10,10,18,16,34,47,34,81,0.000333,0.137361,18,7417.520823,412.08449,412.08449,139.05865,2,0
0,0,10,10,17,16,33,46,34,80,0.000333,0.134517,16,6456.824473,358.712471,403.55153,133.486868,2,0
0,0,12,12,12,16,28,44,36,80,0.000333,0.128196,12,4615.060725,256.392263,384.588394,107.01955,2,0
0,0,12,12,13,17,30,45,39,84,0.000333,0.137393,12,4946.14572,274.785873,412.17881,117.592585,2,0
0,0,12,12,16,19,35,70,50,120,0.000333,0.205171,16,9848.223393,547.123522,615.513962,144.710623,1,0
0,0,7,7,8,9,17,17,16,33,0.000333,0.044962,4,539.545095,29.974728,134.886274,52.529325,1,0
0,0,7,7,9,10,19,18,18,36,0.000333,0.050975,4,611.701562,33.98342,152.92539,61.748606,1,0
0,0,9,9,9,10,19,28,27,55,0.000333,0.077879,8,1869.088106,103.838228,233.636013,61.748606,1,0
0,0,8,8,14,18,32,35,26,61,0.000333,0.101667,7,2135,118.611111,305,128.361619,2,0
0,0,10,10,10,13,23,26,24,50,0.000333,0.075393,5,1130.890489,62.827249,226.178098,81.324997,1,0
0,0,9,9,12,11,23,32,26,58,0.000333,0.087456,12,3148.399121,174.911062,262.366593,81.073298,1,0
0,0,8,8,12,11,23,29,24,53,0.000333,0.079916,12,2876.985404,159.832522,239.748784,81.073298,1,0
0,0,10,10,15,15,30,40,34,74,0.000333,0.121037,14,5083.538657,282.418814,363.109904,117.206718,1,0
0,0,26,26,21,43,64,123,92,215,0.000333,0.43,20,25800,1433.333333,1290,325.56805,8,0
0,0,25,25,21,43,64,122,90,212,0.000333,0.424,20,25440,1413.333333,1272,325.56805,8,0
0,0,27,27,24,45,69,130,99,229,0.000333,0.466284,24,33572.45041,1865.136134,1398.852101,357.172489,10,0
0,0,26,26,24,45,69,129,97,226,0.000333,0.460176,24,33132.63665,1840.702036,1380.526527,357.172489,10,0
0,0,10,10,16,17,33,39,31,70,0.000333,0.117703,8,2824.860707,156.936706,353.107588,133.486868,2,0
0,0,10,10,15,17,32,37,31,68,0.000333,0.113333,7,2380,132.222222,340,128.090227,2,0
0,0,11,11,16,17,33,42,33,75,0.000333,0.12611,8,3026.636472,168.146471,378.329559,133.486868,2,0
0,0,8,8,9,12,21,23,20,43,0.000333,0.062957,4,755.478597,41.971033,188.869649,71.548875,1,0
0,0,13,13,13,16,29,43,39,82,0.000333,0.132785,12,4780.253299,265.569628,398.354442,112.105716,2,0
0,0,9,9,9,14,23,24,24,48,0.000333,0.072377,4,868.523896,48.251328,217.130974,81.832294,1,0
0,0,8,8,10,13,23,24,22,46,0.000333,0.069361,5,1040.41925,57.801069,208.08385,81.324997,1,0
0,0,10,10,9,12,21,33,28,61,0.000333,0.08931,8,2143.450902,119.080606,267.931363,71.548875,1,0
0,0,11,11,9,14,23,34,33,67,0.000333,0.101026,8,2424.629208,134.701623,303.078651,81.832294,1,0
0,0,10,10,10,13,23,34,31,65,0.000333,0.098011,10,2940.315271,163.350848,294.031527,81.324997,1,0
0,0,13,13,14,17,31,38,39,77,0.000333,0.127158,14,5340.623623,296.701312,381.473116,122.789837,2,0
0,0,12,12,14,17,31,53,42,95,0.000333,0.156883,14,6589.081093,366.060061,470.648649,122.789837,2,0
0,0,7,7,9,11,20,21,19,40,0.000333,0.057626,4,691.508495,38.417139,172.877124,66.583073,1,0
0,0,11,11,16,16,32,50,42,92,0.000333,0.153333,16,7360,408.888889,460,128,1,0
0,0,19,19,13,18,31,59,54,113,0.000333,0.186608,18,10076.8353,559.824183,559.824183,123.164366,2,0
0,0,18,18,13,18,31,57,52,109,0.000333,0.180002,12,6480.088774,360.004932,540.007398,123.164366,2,0
0,0,8,8,10,12,22,23,22,45,0.000333,0.066891,5,1003.372114,55.742895,200.674423,76.238831,2,0
0,0,7,7,9,12,21,21,20,41,0.000333,0.060028,4,720.340057,40.018892,180.085014,71.548875,2,0
0,0,13,13,14,15,29,42,27,69,0.000333,0.111734,7,2346.404821,130.355823,335.200689,111.906328,3,0
0,0,11,11,14,16,30,38,25,63,0.000333,0.103045,7,2163.938753,120.21882,309.134108,117.302969,3,0
0,0,12,12,14,16,30,40,27,67,0.000333,0.109587,7,2301.331689,127.851761,328.76167,117.302969,3,0
0,0,12,12,14,16,30,40,27,67,0.000333,0.109587,7,2301.331689,127.851761,328.76167,117.302969,3,0
0,0,11,11,14,16,30,38,25,63,0.000333,0.103045,7,2163.938753,120.21882,309.134108,117.302969,3,0
0,0,10,10,13,13,26,31,23,54,0.000333,0.084608,6,1522.942469,84.607915,253.823745,96.211433,3,0
0,0,10,10,13,13,26,31,23,54,0.000333,0.084608,6,1522.942469,84.607915,253.823745,96.211433,3,0
0,0,14,14,13,18,31,43,41,84,0.000333,0.138717,12,4993.829881,277.434993,416.15249,123.164366,2,0
0,0,11,11,13,17,30,36,34,70,0.000333,0.114494,12,4121.7881,228.988228,343.482342,117.592585,2,0
0,0,11,11,13,15,28,34,30,64,0.000333,0.102557,12,3692.04858,205.11381,307.670715,106.709075,2,0
0,0,14,14,14,19,33,44,42,86,0.000333,0.144606,14,6073.45052,337.413918,433.817894,134.013592,2,0
0,0,11,11,14,18,32,37,35,72,0.000333,0.12,7,2520,140,360,128.361619,2,0
0,0,12,12,14,17,31,38,36,74,0.000333,0.122204,14,5132.547378,285.141521,366.610527,122.789837,2,0
0,0,9,9,9,11,20,21,20,41,0.000333,0.059066,4,708.796208,39.377567,177.199052,66.583073,1,0
0,0,11,11,8,9,17,31,28,59,0.000333,0.080387,12,2893.923692,160.773538,241.160308,52.529325,1,0
0,0,9,9,8,8,16,25,22,47,0.000333,0.062667,8,1504,83.555556,188,48,1,0
0,0,10,10,10,13,23,26,24,50,0.000333,0.075393,5,1130.890489,62.827249,226.178098,81.324997,1,0
0,0,11,11,13,16,29,47,35,82,0.000333,0.132785,12,4780.253299,265.569628,398.354442,112.105716,3,0
0,0,8,8,10,11,21,26,22,48,0.000333,0.070277,10,2108.312363,117.128465,210.831236,71.273029,1,0
0,0,17,17,15,16,31,52,48,100,0.000333,0.16514,21,10403.81225,577.98957,495.419631,122.603359,2,0
0,0,5,5,8,9,17,14,12,26,0.000333,0.035425,4,425.096135,23.616452,106.274034,52.529325,2,0
0,0,8,8,13,12,25,27,20,47,0.000333,0.072754,6,1309.567446,72.753747,218.261241,91.125266,3,0
0,0,5,5,10,9,19,16,12,28,0.000333,0.039647,5,594.709852,33.039436,118.94197,61.748606,2,0
0,0,8,8,14,12,26,29,20,49,0.000333,0.076774,7,1612.250823,89.56949,230.321546,96.322519,3,0
0,0,5,5,9,9,18,15,12,27,0.000333,0.037529,4,450.3519,25.01955,112.587975,57.05865,2,0
0,0,8,8,14,12,26,28,20,48,0.000333,0.075207,7,1579.347745,87.741541,225.621106,96.322519,3,0
0,0,16,16,14,21,35,58,56,114,0.000333,0.194913,14,8186.335695,454.796428,584.738264,145.541635,2,0
0,0,16,16,13,18,31,58,49,107,0.000333,0.1767,12,6361.188063,353.399337,530.099005,123.164366,2,0
0,0,15,15,13,18,31,56,47,103,0.000333,0.170094,12,6123.38664,340.188147,510.28222,123.164366,2,0
0,0,8,8,10,13,23,22,23,45,0.000333,0.067853,5,1017.80144,56.544524,203.560288,81.324997,2,0
0,0,7,7,9,13,22,20,21,41,0.000333,0.060946,4,731.346785,40.630377,182.836696,76.635041,2,0
0,0,9,9,11,13,24,27,23,50,0.000333,0.076416,5,1146.240625,63.680035,229.248125,86.159464,2,0
0,0,9,9,11,13,24,27,23,50,0.000333,0.076416,5,1146.240625,63.680035,229.248125,86.159464,2,0
0,0,9,9,12,13,25,28,24,52,0.000333,0.080494,6,1448.883131,80.493507,241.480522,91.125266,2,0
0,0,9,9,11,13,24,27,24,51,0.000333,0.077944,5,1169.165438,64.953635,233.833088,86.159464,2,0
0,0,9,9,11,13,24,27,23,50,0.000333,0.076416,5,1146.240625,63.680035,229.248125,86.159464,2,0
0,0,9,9,11,13,24,27,23,50,0.000333,0.076416,5,1146.240625,63.680035,229.248125,86.159464,2,0
0,0,9,9,11,13,24,27,23,50,0.000333,0.076416,5,1146.240625,63.680035,229.248125,86.159464,2,0
0,0,9,9,11,13,24,27,23,50,0.000333,0.076416,5,1146.240625,63.680035,229.248125,86.159464,2,0
0,0,8,8,15,16,31,31,23,54,0.000333,0.089176,7,1872.686205,104.038123,267.526601,122.603359,2,0
0,0,8,8,15,16,31,31,23,54,0.000333,0.089176,7,1872.686205,104.038123,267.526601,122.603359,2,0
0,0,8,8,15,16,31,31,23,54,0.000333,0.089176,7,1872.686205,104.038123,267.526601,122.603359,2,0
0,0,8,8,15,16,31,31,23,54,0.000333,0.089176,7,1872.686205,104.038123,267.526601,122.603359,2,0
0,0,8,8,15,16,31,31,23,54,0.000333,0.089176,7,1872.686205,104.038123,267.526601,122.603359,2,0
0,0,8,8,15,16,31,31,23,54,0.000333,0.089176,7,1872.686205,104.038123,267.526601,122.603359,2,0
0,0,11,11,12,15,27,53,42,95,0.000333,0.150571,12,5420.571752,301.142875,451.714313,101.622909,2,0
0,0,10,10,11,15,26,51,40,91,0.000333,0.14258,10,4277.400144,237.633341,427.740014,96.657107,2,0
0,0,9,9,11,15,26,28,28,56,0.000333,0.087742,5,1316.123121,73.117951,263.224624,96.657107,2,0
0,0,8,8,10,15,25,26,26,52,0.000333,0.080494,5,1207.402609,67.077923,241.480522,91.82264,2,0
0,0,7,7,9,11,20,21,19,40,0.000333,0.057626,4,691.508495,38.417139,172.877124,66.583073,1,0
0,0,9,9,9,11,20,31,28,59,0.000333,0.084998,8,2039.950061,113.330559,254.993758,66.583073,1,0
0,0,21,21,16,23,39,98,65,163,0.000333,0.287174,16,13784.32899,765.796055,861.520562,168.041925,5,0
0,0,12,12,11,17,28,43,38,81,0.000333,0.129799,10,3893.957487,216.330971,389.395749,107.540616,1,0
0,0,16,16,14,19,33,50,47,97,0.000333,0.163102,14,6850.287214,380.571512,489.30623,134.013592,2,0
0,0,11,11,13,17,30,36,34,70,0.000333,0.114494,12,4121.7881,228.988228,343.482342,117.592585,2,0
0,0,9,9,12,14,26,27,24,51,0.000333,0.079907,6,1438.334554,79.907475,239.722426,96.322519,2,0
0,0,17,17,15,21,36,54,51,105,0.000333,0.180947,14,7599.789752,422.210542,542.842125,150.842025,2,0
0,0,11,11,14,18,32,37,35,72,0.000333,0.12,7,2520,140,360,128.361619,2,0
0,0,9,9,13,15,28,28,25,53,0.000333,0.08493,6,1528.738865,84.929937,254.789811,106.709075,2,0
0,0,7,7,8,10,18,20,17,37,0.000333,0.051429,4,617.1489,34.28605,154.287225,57.219281,1,0
0,0,7,7,9,11,20,21,19,40,0.000333,0.057626,4,691.508495,38.417139,172.877124,66.583073,1,0
0,0,9,9,9,11,20,31,28,59,0.000333,0.084998,8,2039.950061,113.330559,254.993758,66.583073,1,0
0,0,38,38,22,56,78,188,126,314,0.000333,0.657872,22,43419.55853,2412.197696,1973.616297,423.319371,12,0
0,0,23,23,18,29,47,110,74,184,0.000333,0.340681,18,18396.79828,1022.044349,1022.044349,215.940099,6,0
0,0,14,14,17,22,39,57,46,103,0.000333,0.181465,16,8710.342857,483.907936,544.396429,167.594364,2,0
0,0,36,36,20,55,75,179,118,297,0.000333,0.616653,20,36999.18302,2055.510168,1849.959151,404.413346,12,0
0,0,21,21,16,27,43,101,66,167,0.000333,0.302062,16,14498.97943,805.498857,906.186214,192.381963,6,0
0,0,26,26,19,47,66,135,92,227,0.000333,0.457359,9,12348.69719,686.038733,1372.077465,341.776299,9,0
0,0,12,12,15,19,34,48,38,86,0.000333,0.145841,14,6125.305261,340.294737,437.521804,139.313982,2,0
0,0,8,8,11,12,23,26,21,47,0.000333,0.070869,5,1063.03706,59.057614,212.607412,81.073298,1,0
0,0,13,13,15,20,35,52,41,93,0.000333,0.159008,14,6678.326488,371.018138,477.023321,145.041921,2,0
0,0,12,12,16,17,33,61,41,102,0.000333,0.171509,16,8232.451203,457.3584,514.5282,133.486868,6,0
0,0,6,6,12,11,23,22,16,38,0.000333,0.057298,6,1031.372126,57.298451,171.895354,81.073298,2,0
0,0,12,12,17,18,35,62,42,104,0.000333,0.177815,16,8535.12694,474.173719,533.445434,144.545518,6,0
0,0,29,29,21,47,68,136,102,238,0.000333,0.482939,20,28976.32312,1609.795729,1448.816156,353.304342,10,0
0,0,28,28,21,47,68,135,100,235,0.000333,0.476851,20,28611.07535,1589.504186,1430.553768,353.304342,10,0
0,0,30,30,24,49,73,143,109,252,0.000333,0.519945,24,37436.05893,2079.781052,1559.835789,385.159882,12,0
0,0,29,29,24,49,73,142,107,249,0.000333,0.513755,24,36990.39156,2055.021754,1541.266315,385.159882,12,0
0,0,7,7,8,9,17,17,16,33,0.000333,0.044962,4,539.545095,29.974728,134.886274,52.529325,1,0
0,0,7,7,9,12,21,27,21,48,0.000333,0.070277,4,843.324945,46.851386,210.831236,71.548875,1,0
0,0,7,7,9,10,19,18,18,36,0.000333,0.050975,4,611.701562,33.98342,152.92539,61.748606,1,0
0,0,10,10,9,13,22,40,32,72,0.000333,0.107026,8,2568.632612,142.701812,321.079077,76.635041,1,0
0,0,9,9,9,10,19,28,27,55,0.000333,0.077879,8,1869.088106,103.838228,233.636013,61.748606,1,0
0,0,14,14,10,15,25,42,46,88,0.000333,0.13622,15,6129.890171,340.549454,408.659345,91.82264,1,0
0,0,12,12,10,14,24,36,38,74,0.000333,0.113096,10,3392.872251,188.492903,339.287225,86.52225,1,0
0,0,10,10,10,13,23,30,30,60,0.000333,0.090471,10,2714.137174,150.785399,271.413717,81.324997,1,0
0,0,10,10,11,15,26,31,29,60,0.000333,0.094009,5,1410.131915,78.340662,282.026383,96.657107,1,0
0,0,10,10,10,13,23,30,28,58,0.000333,0.087456,10,2623.665935,145.759219,262.366593,81.324997,1,0
0,0,19,19,14,21,35,74,56,130,0.000333,0.222269,14,9335.295091,518.627505,666.806792,145.541635,2,0
0,0,18,18,14,21,35,73,54,127,0.000333,0.21714,14,9119.865204,506.659178,651.418943,145.541635,2,0
0,0,17,17,10,16,26,56,48,104,0.000333,0.162949,15,7332.68596,407.371442,488.845731,97.219281,1,0
0,0,20,20,15,19,34,69,56,125,0.000333,0.211978,14,8903.059972,494.614443,635.932855,139.313982,2,0
0,0,10,10,14,18,32,40,29,69,0.000333,0.115,7,2415,134.166667,345,128.361619,2,0
0,0,9,9,12,13,25,30,26,56,0.000333,0.086685,12,3120.67136,173.370631,260.055947,91.125266,2,0
0,0,8,8,11,13,24,28,24,52,0.000333,0.079473,5,1192.09025,66.227236,238.41805,86.159464,2,0
0,0,14,14,14,17,31,42,42,84,0.000333,0.138717,14,5826.134861,323.674159,416.15249,122.789837,2,0
0,0,19,19,14,17,31,57,54,111,0.000333,0.183305,21,11548.2316,641.568422,549.91579,122.789837,2,0
0,0,14,14,14,16,30,51,42,93,0.000333,0.152114,14,6388.771555,354.931753,456.340825,117.302969,2,0
0,0,7,7,9,11,20,26,19,45,0.000333,0.064829,4,777.947057,43.219281,194.486764,66.583073,1,0
0,0,7,7,10,12,22,27,21,48,0.000333,0.071351,5,1070.263588,59.459088,214.052718,76.238831,1,0
0,0,10,10,10,13,23,40,32,72,0.000333,0.108565,10,3256.964608,180.942478,325.696461,81.324997,1,0
0,0,9,9,13,15,28,36,30,66,0.000333,0.105762,12,3807.425098,211.523617,317.285425,106.709075,2,0
0,0,8,8,12,12,24,29,24,53,0.000333,0.081001,12,2916.03615,162.002008,243.003013,86.0391,2,0
0,0,9,9,14,16,30,37,33,70,0.000333,0.114494,14,4808.752784,267.152932,343.482342,117.302969,2,0
0,0,8,8,9,11,20,29,22,51,0.000333,0.073473,8,1763.346663,97.963703,220.418333,66.583073,1,0
0,0,7,7,9,10,19,18,18,36,0.000333,0.050975,4,611.701562,33.98342,152.92539,61.748606,1,0
0,0,8,8,10,12,22,30,24,54,0.000333,0.08027,10,2408.093074,133.782949,240.809307,76.238831,1,0
0,0,9,9,9,10,19,28,27,55,0.000333,0.077879,8,1869.088106,103.838228,233.636013,61.748606,1,0
0,0,11,11,10,13,23,43,35,78,0.000333,0.117613,10,3528.378326,196.021018,352.837833,81.324997,1,0
0,0,11,11,12,14,26,39,33,72,0.000333,0.112811,12,4061.179916,225.621106,338.43166,96.322519,2,0
0,0,10,10,11,14,25,37,31,68,0.000333,0.105261,10,3157.822209,175.434567,315.782221,91.356717,2,0
0,0,9,9,9,12,21,21,25,46,0.000333,0.067349,8,1616.372812,89.79849,202.046601,71.548875,1,0
0,0,17,17,16,19,35,64,49,113,0.000333,0.193203,16,9273.743695,515.207983,579.608981,144.710623,2,0
0,0,16,16,16,19,35,62,47,109,0.000333,0.186364,16,8945.469582,496.970532,559.091849,144.710623,2,0
0,0,7,7,9,11,20,20,20,40,0.000333,0.057626,4,691.508495,38.417139,172.877124,66.583073,1,0
0,0,6,6,8,11,19,18,18,36,0.000333,0.050975,4,611.701562,33.98342,152.92539,62.053748,1,0
0,0,10,10,9,13,22,25,24,49,0.000333,0.072837,4,874.048597,48.558255,218.512149,76.635041,1,0
0,0,10,10,10,13,23,27,27,54,0.000333,0.081424,10,2442.723456,135.706859,244.272346,81.324997,1,0
0,0,15,15,14,17,31,54,48,102,0.000333,0.168443,14,7074.592331,393.032907,505.328024,122.789837,1,0
0,0,8,8,12,14,26,24,24,48,0.000333,0.075207,6,1353.726639,75.207035,225.621106,96.322519,2,0
0,0,8,8,11,14,25,23,24,47,0.000333,0.072754,5,1091.306205,60.628122,218.261241,91.356717,2,0
0,0,9,9,10,13,23,26,33,59,0.000333,0.088963,10,2668.901554,148.272309,266.890155,81.324997,1,0
0,0,9,9,10,13,23,27,31,58,0.000333,0.087456,10,2623.665935,145.759219,262.366593,81.324997,1,0
0,0,7,7,10,12,22,20,22,42,0.000333,0.062432,5,936.48064,52.026702,187.296128,76.238831,1,0
0,0,7,7,8,10,18,20,17,37,0.000333,0.051429,4,617.1489,34.28605,154.287225,57.219281,1,0
0,0,7,7,9,11,20,21,19,40,0.000333,0.057626,4,691.508495,38.417139,172.877124,66.583073,1,0
0,0,7,7,9,11,20,21,19,40,0.000333,0.057626,4,691.508495,38.417139,172.877124,66.583073,1,0
0,0,9,9,9,11,20,31,28,59,0.000333,0.084998,8,2039.950061,113.330559,254.993758,66.583073,1,0
0,0,9,9,9,11,20,31,28,59,0.000333,0.084998,8,2039.950061,113.330559,254.993758,66.583073,1,0
0,0,7,7,8,8,16,22,18,40,0.000333,0.053333,8,1280,71.111111,160,48,1,0
0,0,8,8,9,10,19,26,23,49,0.000333,0.069383,8,1665.187585,92.510421,208.148448,61.748606,1,0
0,0,22,22,17,41,58,116,83,199,0.000333,0.388579,16,18651.81149,1036.211749,1165.738218,289.1465,7,0
0,0,21,21,17,41,58,115,81,196,0.000333,0.382721,8,9185.3142,510.295233,1148.164275,289.1465,7,0
0,0,4,4,7,7,14,11,10,21,0.000333,0.026651,3,239.86336,13.325742,79.954453,39.302969,1,0
0,0,7,7,13,10,23,24,18,42,0.000333,0.06333,6,1139.937613,63.329867,189.989602,81.324997,2,0
0,0,4,4,8,7,15,12,10,22,0.000333,0.028651,4,343.806372,19.100354,85.951593,43.651484,1,0
0,0,7,7,14,10,24,25,18,43,0.000333,0.065718,7,1380.073713,76.670762,197.153388,86.52225,2,0
0,0,9,9,11,15,26,48,38,86,0.000333,0.134746,10,4042.378158,224.576564,404.237816,96.657107,1,0
0,0,8,8,10,13,23,41,31,72,0.000333,0.108565,10,3256.964608,180.942478,325.696461,81.324997,1,0
0,0,10,10,9,13,22,28,26,54,0.000333,0.08027,8,1926.474459,107.026359,240.809307,76.635041,1,0
0,0,10,10,10,13,23,27,27,54,0.000333,0.081424,10,2442.723456,135.706859,244.272346,81.324997,1,0
0,0,15,15,12,17,29,48,45,93,0.000333,0.150597,12,5421.506791,301.194822,451.792233,112.506418,1,0
0,0,5,5,7,7,14,13,11,24,0.000333,0.030459,3,274.129554,15.22942,91.376518,39.302969,1,0
0,0,5,5,8,8,16,14,12,26,0.000333,0.034667,4,416,23.111111,104,48,1,0
0,0,8,8,8,9,17,31,22,53,0.000333,0.072212,8,1733.084245,96.282458,216.635531,52.529325,1,0
0,0,9,9,9,11,20,35,27,62,0.000333,0.08932,8,2143.676335,119.09313,267.959542,66.583073,1,0
0,0,9,9,11,11,22,46,34,80,0.000333,0.118918,15,5351.317942,297.295441,356.754529,76.107496,1,0
0,0,8,8,10,11,21,44,32,76,0.000333,0.111272,10,3338.161241,185.453402,333.816124,71.273029,1,0
0,0,34,34,23,51,74,155,113,268,0.000333,0.554711,22,36610.93704,2033.940947,1664.133502,393.335617,10,0
0,0,33,33,23,51,74,154,111,265,0.000333,0.548502,22,36201.11312,2011.172951,1645.505142,393.335617,10,0
0,0,23,23,17,43,60,104,77,181,0.000333,0.356382,8,8553.177582,475.176532,1069.147198,302.816253,9,0
0,0,22,22,17,43,60,103,75,178,0.000333,0.350476,8,8411.412208,467.300678,1051.426526,302.816253,9,0
0,0,32,32,23,50,73,150,107,257,0.000333,0.530262,22,34997.26806,1944.29267,1590.784912,386.234734,10,0
0,0,31,31,23,50,73,149,105,254,0.000333,0.524072,22,34588.73964,1921.596646,1572.215438,386.234734,10,0
0,0,38,38,23,53,76,165,125,290,0.000333,0.603966,22,39861.77754,2214.543196,1811.898979,407.621709,10,0
0,0,37,37,23,53,76,164,123,287,0.000333,0.597718,22,39449.41432,2191.634129,1793.155196,407.621709,10,0
0,0,7,7,9,11,20,21,19,40,0.000333,0.057626,4,691.508495,38.417139,172.877124,66.583073,1,0
0,0,9,9,9,11,20,31,28,59,0.000333,0.084998,8,2039.950061,113.330559,254.993758,66.583073,1,0
0,0,16,16,15,18,33,60,47,107,0.000333,0.179917,14,7556.502391,419.805688,539.750171,133.662009,2,0
0,0,15,15,15,18,33,58,45,103,0.000333,0.173191,14,7274.01632,404.112018,519.572594,133.662009,2,0
0,0,13,13,14,15,29,52,44,96,0.000333,0.155455,14,6529.126457,362.729248,466.366176,111.906328,2,0
0,0,13,13,14,15,29,52,44,96,0.000333,0.155455,14,6529.126457,362.729248,466.366176,111.906328,2,0
0,0,13,13,14,15,29,52,44,96,0.000333,0.155455,14,6529.126457,362.729248,466.366176,111.906328,2,0
0,0,13,13,14,15,29,52,44,96,0.000333,0.155455,14,6529.126457,362.729248,466.366176,111.906328,2,0
0,0,13,13,14,15,29,52,44,96,0.000333,0.155455,14,6529.126457,362.729248,466.366176,111.906328,2,0
0,0,13,13,14,15,29,52,44,96,0.000333,0.155455,14,6529.126457,362.729248,466.366176,111.906328,2,0
0,0,18,18,19,19,38,68,56,124,0.000333,0.216914,18,11713.37421,650.743012,650.743012,161.421246,2,0
0,0,17,17,19,19,38,66,54,120,0.000333,0.209917,18,11335.52343,629.751302,629.751302,161.421246,2,0
0,0,16,16,19,18,37,62,50,112,0.000333,0.194486,18,10502.25799,583.458777,583.458777,155.769273,2,0
0,0,15,15,19,18,37,60,48,108,0.000333,0.18754,18,10127.17734,562.620963,562.620963,155.769273,2,0
0,0,14,14,19,17,36,56,44,100,0.000333,0.172331,18,9305.865003,516.9925,516.9925,150.197491,2,0
0,0,13,13,19,17,36,54,42,96,0.000333,0.165438,18,8933.630402,496.3128,496.3128,150.197491,2,0
0,0,38,38,22,57,79,192,129,321,0.000333,0.674505,22,44517.29964,2473.183314,2023.51362,430.582226,12,0
0,0,23,23,18,31,49,114,77,191,0.000333,0.35747,18,19303.37244,1072.40958,1072.40958,228.638736,6,0
0,0,14,14,16,24,40,61,49,110,0.000333,0.195137,16,9366.593447,520.366303,585.41209,174.0391,2,0
0,0,13,13,12,14,26,47,39,86,0.000333,0.134746,12,4850.853789,269.491877,404.237816,96.322519,2,0
0,0,13,13,12,15,27,47,39,86,0.000333,0.136307,12,4907.043902,272.61355,408.920325,101.622909,2,0
0,0,8,8,10,12,22,27,17,44,0.000333,0.065405,5,981.074956,54.504164,196.214991,76.238831,2,0
0,0,9,9,11,12,23,29,19,48,0.000333,0.072377,5,1085.654869,60.314159,217.130974,81.073298,2,0
0,0,9,9,11,12,23,29,19,48,0.000333,0.072377,5,1085.654869,60.314159,217.130974,81.073298,2,0
0,0,8,8,10,12,22,27,17,44,0.000333,0.065405,5,981.074956,54.504164,196.214991,76.238831,2,0
0,0,6,6,9,9,18,17,13,30,0.000333,0.041699,4,500.391,27.7995,125.09775,57.05865,2,0
0,0,6,6,9,9,18,17,13,30,0.000333,0.041699,4,500.391,27.7995,125.09775,57.05865,2,0
0,0,9,9,8,12,20,31,25,56,0.000333,0.080676,8,1936.223787,107.567988,242.027973,67.01955,1,0
0,0,5,5,8,11,19,25,18,43,0.000333,0.060887,4,730.643532,40.591307,182.660883,62.053748,1,0
0,0,9,9,7,12,19,26,20,46,0.000333,0.065135,3,586.213997,32.567444,195.404666,62.671034,1,0
0,0,12,12,13,15,28,39,28,67,0.000333,0.107364,6,1932.556679,107.36426,322.09278,106.709075,2,0
0,0,10,10,13,15,28,36,25,61,0.000333,0.09775,6,1759.491901,97.74955,293.24865,106.709075,2,0
0,0,16,16,14,15,29,70,58,128,0.000333,0.207274,21,13058.25292,725.458495,621.821567,111.906328,3,0
0,0,16,16,14,15,29,70,58,128,0.000333,0.207274,21,13058.25292,725.458495,621.821567,111.906328,3,0
0,0,13,13,14,15,29,52,44,96,0.000333,0.155455,14,6529.126457,362.729248,466.366176,111.906328,2,0
0,0,13,13,14,15,29,52,44,96,0.000333,0.155455,14,6529.126457,362.729248,466.366176,111.906328,2,0
0,0,17,17,15,20,35,95,60,155,0.000333,0.265013,21,16695.81622,927.545346,795.038868,145.041921,5,0
0,0,8,8,10,12,22,40,30,70,0.000333,0.104053,10,3121.602133,173.422341,312.160213,76.238831,1,0
0,0,17,17,16,21,37,96,61,157,0.000333,0.272628,16,13086.14685,727.008159,817.884178,156.238666,5,0
0,0,7,7,9,11,20,26,19,45,0.000333,0.064829,4,777.947057,43.219281,194.486764,66.583073,1,0
0,0,7,7,9,10,19,18,18,36,0.000333,0.050975,4,611.701562,33.98342,152.92539,61.748606,1,0
0,0,7,7,10,12,22,27,21,48,0.000333,0.071351,5,1070.263588,59.459088,214.052718,76.238831,1,0
0,0,9,9,9,10,19,28,27,55,0.000333,0.077879,8,1869.088106,103.838228,233.636013,61.748606,1,0
0,0,10,10,10,13,23,40,32,72,0.000333,0.108565,10,3256.964608,180.942478,325.696461,81.324997,1,0
0,0,11,11,13,19,32,50,40,90,0.000333,0.15,12,5400,300,450,128.816339,3,0
0,0,12,12,13,19,32,51,42,93,0.000333,0.155,12,5580,310,465,128.816339,3,0
0,0,12,12,16,21,37,57,47,104,0.000333,0.180594,16,8668.5304,481.585022,541.78315,156.238666,5,0
0,0,13,13,16,21,37,58,49,107,0.000333,0.185804,16,8918.584162,495.476898,557.41151,156.238666,5,0
0,0,10,10,14,21,35,42,33,75,0.000333,0.128232,7,2692.873584,149.604088,384.696226,145.541635,2,0
0,0,10,10,14,19,33,41,32,73,0.000333,0.122747,7,2577.685395,143.204744,368.240771,134.013592,2,0
0,0,6,6,11,11,22,24,17,41,0.000333,0.060946,5,914.183482,50.787971,182.836696,76.107496,3,0
0,0,10,10,12,14,26,32,26,58,0.000333,0.090875,6,1635.753022,90.875168,272.625504,96.322519,3,0
0,0,6,6,10,11,21,23,17,40,0.000333,0.058564,5,878.463485,48.803527,175.692697,71.273029,3,0
0,0,10,10,11,14,25,31,26,57,0.000333,0.088233,5,1323.499014,73.527723,264.699803,91.356717,3,0
0,0,8,8,11,13,24,26,23,49,0.000333,0.074888,5,1123.315813,62.406434,224.663163,86.159464,2,0
0,0,8,8,12,14,26,27,26,53,0.000333,0.083041,6,1494.73983,83.041102,249.123305,96.322519,2,0
0,0,10,10,12,16,28,46,41,87,0.000333,0.139413,12,5018.878539,278.826585,418.239878,107.01955,2,0
0,0,8,8,9,11,20,29,22,51,0.000333,0.073473,8,1763.346663,97.963703,220.418333,66.583073,1,0
0,0,7,7,9,10,19,18,18,36,0.000333,0.050975,4,611.701562,33.98342,152.92539,61.748606,1,0
0,0,8,8,10,12,22,30,24,54,0.000333,0.08027,10,2408.093074,133.782949,240.809307,76.238831,1,0
0,0,9,9,9,10,19,28,27,55,0.000333,0.077879,8,1869.088106,103.838228,233.636013,61.748606,1,0
0,0,11,11,10,13,23,43,35,78,0.000333,0.117613,10,3528.378326,196.021018,352.837833,81.324997,1,0
0,0,9,9,8,13,21,30,30,60,0.000333,0.087846,8,2108.312363,117.128465,263.539045,72.105716,1,0
0,0,8,8,8,9,17,20,17,37,0.000333,0.050412,4,604.944501,33.608028,151.236125,52.529325,1,0
0,0,8,8,9,11,20,22,19,41,0.000333,0.059066,4,708.796208,39.377567,177.199052,66.583073,1,0
0,0,8,8,9,10,19,21,19,40,0.000333,0.056639,4,679.668402,37.759356,169.917101,61.748606,1,0
0,0,10,10,8,9,17,30,25,55,0.000333,0.074937,8,1798.48365,99.915758,224.810456,52.529325,1,0
0,0,10,10,9,11,20,32,28,60,0.000333,0.086439,8,2074.525486,115.251416,259.315686,66.583073,1,0
0,0,10,10,9,10,19,31,28,59,0.000333,0.083543,8,2005.021786,111.390099,250.627723,61.748606,1,0
0,0,18,18,15,27,42,82,59,141,0.000333,0.253439,14,10644.43459,591.357477,760.316757,186.985321,4,0
0,0,19,19,15,27,42,83,61,144,0.000333,0.258831,14,10870.91192,603.939551,776.493709,186.985321,4,0
0,0,18,18,17,29,46,85,64,149,0.000333,0.274337,16,13168.1717,731.565095,823.010731,210.368317,5,0
0,0,19,19,17,29,46,86,66,152,0.000333,0.27986,16,13433.30268,746.294593,839.581417,210.368317,5,0
0,0,7,7,8,9,17,17,16,33,0.000333,0.044962,4,539.545095,29.974728,134.886274,52.529325,1,0
0,0,7,7,9,12,21,27,21,48,0.000333,0.070277,4,843.324945,46.851386,210.831236,71.548875,1,0
0,0,7,7,9,10,19,18,18,36,0.000333,0.050975,4,611.701562,33.98342,152.92539,61.748606,1,0
0,0,10,10,9,13,22,40,32,72,0.000333,0.107026,8,2568.632612,142.701812,321.079077,76.635041,1,0
0,0,9,9,9,10,19,28,27,55,0.000333,0.077879,8,1869.088106,103.838228,233.636013,61.748606,1,0
0,0,17,17,16,20,36,60,52,112,0.000333,0.193011,16,9264.505603,514.694756,579.0316,150.438562,2,0
0,0,10,10,11,12,23,33,31,64,0.000333,0.096503,10,2895.079652,160.837758,289.507965,81.073298,8,0
0,0,11,11,14,13,27,41,36,77,0.000333,0.122042,14,5125.768727,284.764929,366.126338,101.408685,9,0
0,0,12,12,16,17,33,57,43,100,0.000333,0.168146,16,8071.030591,448.390588,504.439412,133.486868,1,0
0,0,8,8,7,12,19,22,20,42,0.000333,0.059471,3,535.238867,29.735493,178.412956,62.671034,1,0
0,0,7,7,9,10,19,18,18,36,0.000333,0.050975,4,611.701562,33.98342,152.92539,61.748606,1,0
0,0,8,8,8,13,21,23,22,45,0.000333,0.065885,4,790.617136,43.923174,197.654284,72.105716,1,0
0,0,9,9,9,10,19,28,27,55,0.000333,0.077879,8,1869.088106,103.838228,233.636013,61.748606,1,0
0,0,11,11,8,14,22,36,33,69,0.000333,0.102567,8,2461.606253,136.755903,307.700782,77.302969,1,0
0,0,30,30,19,49,68,148,98,246,0.000333,0.499172,18,26955.28546,1497.515859,1497.515859,355.831405,11,0
0,0,15,15,14,20,34,70,46,116,0.000333,0.196715,14,8262.039654,459.002203,590.14569,139.741531,5,0
0,0,6,6,11,12,23,17,17,34,0.000333,0.051267,5,769.005533,42.72253,153.801107,81.073298,1,0
0,0,36,36,21,51,72,179,119,298,0.000333,0.612879,20,36772.75301,2042.930723,1838.63765,381.532358,11,0
0,0,21,21,17,24,41,101,67,168,0.000333,0.300023,16,14401.09979,800.061099,900.068737,179.525968,5,0
0,0,12,12,13,17,30,48,39,87,0.000333,0.1423,12,5122.793782,284.599655,426.899482,117.592585,1,0
0,0,34,34,19,52,71,165,111,276,0.000333,0.565777,18,30551.94369,1697.330205,1697.330205,377.133488,11,0
0,0,19,19,15,23,38,87,59,146,0.000333,0.255399,14,10726.76384,595.931324,766.197417,162.645284,5,0
0,0,10,10,11,14,25,34,31,65,0.000333,0.100617,10,3018.506523,167.694807,301.850652,91.356717,1,0
0,0,17,17,16,19,35,71,64,135,0.000333,0.230818,24,16618.87698,923.270943,692.453207,144.710623,1,0
0,0,15,15,16,18,34,64,56,120,0.000333,0.203499,24,14651.89298,813.994055,610.495541,139.05865,1,0
0,0,15,15,17,20,37,58,50,108,0.000333,0.18754,16,9001.935416,500.107523,562.620963,155.92543,2,0
0,0,14,14,17,20,37,56,48,104,0.000333,0.180594,16,8668.5304,481.585022,541.78315,155.92543,2,0
0,0,18,18,18,19,37,67,56,123,0.000333,0.213588,18,11533.72975,640.762764,640.762764,155.769273,2,0
0,0,17,17,18,19,37,65,54,119,0.000333,0.206642,18,11158.64911,619.924951,619.924951,155.769273,2,0
0,0,9,9,11,13,24,29,26,55,0.000333,0.084058,10,2521.729375,140.096076,252.172938,86.159464,2,0
0,0,8,8,10,13,23,27,24,51,0.000333,0.076901,5,1153.508299,64.083794,230.70166,81.324997,2,0
0,0,13,13,17,17,34,52,36,88,0.000333,0.149232,16,7163.14768,397.952649,447.69673,138.973737,2,0
0,0,11,11,17,18,35,48,34,82,0.000333,0.1402,8,3364.809659,186.93387,420.601207,144.545518,2,0
0,0,12,12,17,18,35,50,36,86,0.000333,0.147039,16,7057.893431,392.105191,441.118339,144.545518,2,0
0,0,12,12,17,18,35,50,36,86,0.000333,0.147039,16,7057.893431,392.105191,441.118339,144.545518,2,0
0,0,11,11,17,18,35,48,34,82,0.000333,0.1402,8,3364.809659,186.93387,420.601207,144.545518,2,0
0,0,9,9,8,10,18,21,20,41,0.000333,0.056989,8,1367.7354,75.9853,170.966925,57.219281,1,0
0,0,9,9,9,11,20,24,23,47,0.000333,0.06771,8,1625.044964,90.280276,203.13062,66.583073,1,0
0,0,14,14,11,14,25,45,40,85,0.000333,0.131576,10,3947.277761,219.293209,394.727776,91.356717,1,0
0,0,10,10,12,13,25,33,29,62,0.000333,0.095973,12,3455.029005,191.946056,287.919084,91.125266,2,0
0,0,9,9,11,13,24,31,27,58,0.000333,0.088643,10,2659.27825,147.737681,265.927825,86.159464,2,0
0,0,7,7,8,10,18,20,17,37,0.000333,0.051429,4,617.1489,34.28605,154.287225,57.219281,1,0
0,0,7,7,9,12,21,27,21,48,0.000333,0.070277,4,843.324945,46.851386,210.831236,71.548875,1,0
0,0,7,7,9,11,20,21,19,40,0.000333,0.057626,4,691.508495,38.417139,172.877124,66.583073,1,0
0,0,10,10,9,13,22,40,32,72,0.000333,0.107026,8,2568.632612,142.701812,321.079077,76.635041,1,0
0,0,9,9,9,11,20,31,28,59,0.000333,0.084998,8,2039.950061,113.330559,254.993758,66.583073,1,0
0,0,15,15,11,18,29,71,56,127,0.000333,0.205655,15,9254.453796,514.136322,616.963586,113.112398,1,0
0,0,15,15,11,16,27,56,47,103,0.000333,0.163251,10,4897.534127,272.085229,489.753413,102.053748,1,0
0,0,23,23,19,45,64,120,84,204,0.000333,0.408,9,11016,612,1224,327.844012,7,0
0,0,7,7,8,12,20,19,20,39,0.000333,0.056185,4,674.220783,37.45671,168.555196,67.01955,1,0
0,0,10,10,9,15,24,36,33,69,0.000333,0.105454,8,2530.8993,140.605517,316.362413,87.132684,1,0
0,0,8,8,10,11,21,24,23,47,0.000333,0.068813,10,2064.389189,114.688288,206.438919,71.273029,1,0
0,0,26,26,19,49,68,133,94,227,0.000333,0.460618,9,12436.68659,690.927032,1381.854065,355.831405,9,0
0,0,7,7,8,12,20,19,20,39,0.000333,0.056185,4,674.220783,37.45671,168.555196,67.01955,1,0
0,0,12,12,13,20,33,45,40,85,0.000333,0.142925,12,5145.282002,285.849,428.7735,134.544278,2,0
0,0,16,16,14,18,32,54,44,98,0.000333,0.163333,14,6860,381.111111,490,128.361619,2,0
0,0,11,11,13,16,29,40,31,71,0.000333,0.114972,6,2069.499904,114.972217,344.916651,112.105716,2,0
0,0,10,10,13,15,28,39,29,68,0.000333,0.108967,6,1961.400808,108.966712,326.900135,106.709075,2,0
0,0,9,9,12,13,25,28,23,51,0.000333,0.078946,6,1421.019994,78.945555,236.836666,91.125266,2,0
0,0,17,17,15,20,35,59,47,106,0.000333,0.181235,14,7611.855997,422.880889,543.704,145.041921,2,0
0,0,11,11,14,17,31,41,32,73,0.000333,0.120552,7,2531.594315,140.644129,361.656331,122.789837,2,0
0,0,10,10,14,16,30,40,30,70,0.000333,0.114494,7,2404.376392,133.576466,343.482342,117.302969,2,0
0,0,10,10,13,15,28,33,26,59,0.000333,0.094545,6,1701.803642,94.544647,283.63394,106.709075,2,0
0,0,35,35,22,53,75,166,121,287,0.000333,0.59589,22,39328.76121,2184.931178,1787.670964,401.68728,10,0
0,0,34,34,22,53,75,165,119,284,0.000333,0.589662,22,38917.65918,2162.092177,1768.984508,401.68728,10,0
0,0,25,25,17,44,61,114,84,198,0.000333,0.391429,8,9394.287943,521.904886,1174.285993,309.70186,9,0
0,0,24,24,17,44,61,113,82,195,0.000333,0.385498,8,9251.950247,513.997236,1156.493781,309.70186,9,0
0,0,7,7,8,11,19,26,19,45,0.000333,0.063719,4,764.626952,42.479275,191.156738,62.053748,1,0
0,0,7,7,9,11,20,21,19,40,0.000333,0.057626,4,691.508495,38.417139,172.877124,66.583073,1,0
0,0,7,7,9,12,21,27,21,48,0.000333,0.070277,4,843.324945,46.851386,210.831236,71.548875,1,0
0,0,9,9,9,11,20,31,28,59,0.000333,0.084998,8,2039.950061,113.330559,254.993758,66.583073,1,0
0,0,10,10,9,13,22,40,32,72,0.000333,0.107026,8,2568.632612,142.701812,321.079077,76.635041,1,0
0,0,8,8,9,10,19,24,21,45,0.000333,0.063719,8,1529.253905,84.95855,191.156738,61.748606,1,0
0,0,8,8,10,11,21,25,22,47,0.000333,0.068813,10,2064.389189,114.688288,206.438919,71.273029,1,0
0,0,14,14,12,19,31,50,40,90,0.000333,0.148626,12,5350.532015,297.251779,445.877668,123.730173,2,0
0,0,14,14,13,20,33,51,43,94,0.000333,0.158058,12,5690.076567,316.115365,474.173047,134.544278,2,0
0,0,9,9,8,11,19,25,21,46,0.000333,0.065135,4,781.618662,43.423259,195.404666,62.053748,1,0
0,0,9,9,9,11,20,24,22,46,0.000333,0.06627,8,1590.469539,88.359419,198.808692,66.583073,1,0
0,0,14,14,11,15,26,45,40,85,0.000333,0.133179,10,3995.37376,221.965209,399.537376,96.657107,1,0
0,0,22,22,17,39,56,98,73,171,0.000333,0.331019,8,7944.461533,441.358974,993.057692,275.617555,7,0
0,0,18,18,17,38,55,91,65,156,0.000333,0.300631,8,7215.136922,400.84094,901.892115,268.908114,7,0
0,0,8,8,11,12,23,24,22,46,0.000333,0.069361,5,1040.41925,57.801069,208.08385,81.073298,2,0
0,0,7,7,10,12,22,22,20,42,0.000333,0.062432,5,936.48064,52.026702,187.296128,76.238831,2,0
0,0,10,10,13,14,27,29,26,55,0.000333,0.087173,6,1569.112876,87.172938,261.518813,101.408685,2,0
0,0,8,8,15,16,31,31,23,54,0.000333,0.089176,7,1872.686205,104.038123,267.526601,122.603359,2,0
0,0,8,8,15,16,31,31,23,54,0.000333,0.089176,7,1872.686205,104.038123,267.526601,122.603359,2,0
0,0,8,8,15,16,31,31,23,54,0.000333,0.089176,7,1872.686205,104.038123,267.526601,122.603359,2,0
0,0,9,9,15,16,31,37,25,62,0.000333,0.102387,7,2150.121199,119.451178,307.160171,122.603359,2,0
0,0,8,8,15,16,31,31,23,54,0.000333,0.089176,7,1872.686205,104.038123,267.526601,122.603359,2,0
0,0,7,7,9,10,19,18,18,36,0.000333,0.050975,4,611.701562,33.98342,152.92539,61.748606,1,0
0,0,9,9,9,10,19,28,27,55,0.000333,0.077879,8,1869.088106,103.838228,233.636013,61.748606,1,0
0,0,15,15,14,19,33,60,47,107,0.000333,0.179917,14,7556.502391,419.805688,539.750171,134.013592,2,0
0,0,14,14,14,19,33,58,45,103,0.000333,0.173191,14,7274.01632,404.112018,519.572594,134.013592,2,0
0,0,16,16,14,18,32,54,47,101,0.000333,0.168333,14,7070,392.777778,505,128.361619,2,0
0,0,15,15,14,18,32,52,45,97,0.000333,0.161667,14,6790,377.222222,485,128.361619,2,0
0,0,18,18,14,19,33,60,53,113,0.000333,0.190006,14,7980.231497,443.346194,570.016535,134.013592,2,0
0,0,17,17,14,19,33,58,51,109,0.000333,0.18328,14,7697.745426,427.652524,549.838959,134.013592,2,0
0,0,12,12,12,18,30,48,37,85,0.000333,0.139029,12,5005.028408,278.057134,417.085701,118.0782,2,0
0,0,21,21,18,24,42,103,67,170,0.000333,0.305565,18,16500.49131,916.693962,916.693962,185.09775,6,0
0,0,12,12,14,17,31,48,39,87,0.000333,0.143672,14,6034.211106,335.23395,431.015079,122.789837,2,0
0,0,21,21,19,25,44,104,70,174,0.000333,0.316647,18,17098.93983,949.941102,949.941102,196.807027,6,0
0,0,7,7,8,10,18,17,20,37,0.000333,0.051429,8,1234.2978,68.5721,154.287225,57.219281,1,0
0,0,15,15,13,16,29,44,48,92,0.000333,0.148978,18,8044.816528,446.934252,446.934252,112.105716,2,0
0,0,6,6,11,10,21,22,16,38,0.000333,0.055636,5,834.54031,46.363351,166.908062,71.273029,1,0
0,0,13,13,14,14,28,39,36,75,0.000333,0.120184,14,5047.722668,280.429037,360.551619,106.605938,2,0
0,0,10,10,18,17,35,47,34,81,0.000333,0.138491,18,7478.494639,415.471924,415.471924,144.545518,2,0
0,0,10,10,17,17,34,46,34,80,0.000333,0.135666,16,6511.952437,361.775135,406.997027,138.973737,2,0
0,0,34,34,20,54,74,168,111,279,0.000333,0.577479,20,34648.74978,1924.930543,1732.437489,397.202487,12,0
0,0,19,19,16,25,41,90,59,149,0.000333,0.266092,16,12772.40398,709.577999,798.275249,180.096405,6,0
0,0,10,10,15,17,32,37,31,68,0.000333,0.113333,7,2380,132.222222,340,128.090227,2,0
0,0,13,13,18,18,36,57,37,94,0.000333,0.161991,18,8747.513102,485.97295,485.97295,150.1173,2,0
0,0,11,11,18,19,37,52,35,87,0.000333,0.151074,9,4079.001985,226.611221,453.222443,155.769273,2,0
0,0,12,12,18,19,37,55,37,92,0.000333,0.159757,9,4313.427387,239.634855,479.26971,155.769273,2,0
0,0,12,12,18,19,37,55,37,92,0.000333,0.159757,9,4313.427387,239.634855,479.26971,155.769273,2,0
0,0,11,11,18,19,37,52,35,87,0.000333,0.151074,9,4079.001985,226.611221,453.222443,155.769273,2,0
0,0,10,10,13,15,28,30,26,56,0.000333,0.089737,6,1615.271254,89.737292,269.211876,106.709075,3,0
0,0,10,10,13,15,28,29,26,55,0.000333,0.088135,6,1586.427124,88.13484,264.404521,106.709075,3,0
0,0,10,10,13,15,28,30,26,56,0.000333,0.089737,6,1615.271254,89.737292,269.211876,106.709075,3,0
0,0,10,10,13,15,28,29,26,55,0.000333,0.088135,6,1586.427124,88.13484,264.404521,106.709075,3,0
0,0,10,10,13,14,27,29,25,54,0.000333,0.085588,6,1540.583551,85.587975,256.763925,101.408685,3,0
0,0,10,10,13,14,27,29,25,54,0.000333,0.085588,6,1540.583551,85.587975,256.763925,101.408685,3,0
0,0,12,12,11,16,27,36,37,73,0.000333,0.115702,10,3471.067877,192.837104,347.106788,102.053748,1,0
0,0,12,12,11,15,26,45,37,82,0.000333,0.128479,10,3854.360569,214.131143,385.436057,96.657107,1,0
0,0,16,16,13,20,33,58,50,108,0.000333,0.181598,12,6537.534779,363.196377,544.794565,134.544278,2,0
0,0,15,15,13,20,33,56,48,104,0.000333,0.174872,12,6295.403861,349.744659,524.616988,134.544278,2,0
0,0,8,8,10,14,24,22,24,46,0.000333,0.070303,5,1054.541375,58.585632,210.908275,86.52225,2,0
0,0,7,7,9,14,23,20,22,42,0.000333,0.06333,4,759.958409,42.219912,189.989602,81.832294,2,0
0,0,11,11,13,13,26,34,28,62,0.000333,0.097142,12,3497.12715,194.284842,291.427263,96.211433,2,0
0,0,10,10,13,13,26,31,24,55,0.000333,0.086175,6,1551.145107,86.174728,258.524184,96.211433,2,0
0,0,11,11,14,15,29,35,29,64,0.000333,0.103637,7,2176.375486,120.909749,310.910784,111.906328,2,0
0,0,10,10,15,15,30,40,34,74,0.000333,0.121037,14,5083.538657,282.418814,363.109904,117.206718,1,0
0,0,30,30,23,54,77,147,103,250,0.000333,0.522232,11,17233.66299,957.425721,1566.696635,414.80585,12,0
0,0,29,29,23,53,76,146,101,247,0.000333,0.514413,11,16975.61905,943.089947,1543.238096,407.621709,12,0
0,0,10,10,17,16,33,46,33,79,0.000333,0.132836,16,6376.114167,354.228565,398.507135,133.486868,2,0
0,0,10,10,17,16,33,46,33,79,0.000333,0.132836,16,6376.114167,354.228565,398.507135,133.486868,2,0
0,0,13,13,15,16,31,50,47,97,0.000333,0.160186,14,6727.79859,373.766588,480.557042,122.603359,1,0
0,0,15,15,15,17,32,56,55,111,0.000333,0.185,21,11655,647.5,555,128.090227,1,0
0,0,9,9,12,11,23,33,28,61,0.000333,0.091979,12,3311.247352,183.958186,275.937279,81.073298,1,0
0,0,9,9,12,11,23,33,28,61,0.000333,0.091979,12,3311.247352,183.958186,275.937279,81.073298,1,0
0,0,8,8,11,13,24,29,23,52,0.000333,0.079473,5,1192.09025,66.227236,238.41805,86.159464,1,0
0,0,6,6,11,10,21,22,16,38,0.000333,0.055636,5,834.54031,46.363351,166.908062,71.273029,1,0
0,0,7,7,11,11,22,25,18,43,0.000333,0.063919,5,958.777798,53.265433,191.75556,76.107496,1,0
0,0,9,9,9,13,22,30,25,55,0.000333,0.081756,4,981.074956,54.504164,245.268739,76.635041,1,0
0,0,13,13,15,17,32,55,46,101,0.000333,0.168333,14,7070,392.777778,505,128.090227,1,0
0,0,10,10,9,15,24,31,29,60,0.000333,0.091699,4,1100.391,61.132833,275.09775,87.132684,1,0
0,0,9,9,10,14,24,31,27,58,0.000333,0.088643,5,1329.639125,73.86884,265.927825,86.52225,1,0
0,0,11,11,9,13,22,40,33,73,0.000333,0.108513,8,2604.308065,144.683781,325.538508,76.635041,1,0
0,0,12,12,9,15,24,41,38,79,0.000333,0.120737,8,2897.6963,160.983128,362.212038,87.132684,1,0
0,0,11,11,10,14,24,41,36,77,0.000333,0.117681,10,3530.421126,196.134507,353.042113,86.52225,1,0
0,0,8,8,11,13,24,22,25,47,0.000333,0.071831,5,1077.466188,59.859233,215.493238,86.159464,2,0
0,0,14,14,12,16,28,49,41,90,0.000333,0.144221,12,5191.943316,288.441295,432.661943,107.01955,2,0
0,0,13,13,12,16,28,47,39,86,0.000333,0.137811,12,4961.19028,275.621682,413.432523,107.01955,2,0
0,0,11,11,10,14,24,33,29,62,0.000333,0.094756,10,2842.67675,157.926486,284.267675,86.52225,2,0
0,0,19,19,13,17,30,59,53,112,0.000333,0.183191,18,9892.291441,549.571747,549.571747,117.592585,2,0
0,0,18,18,13,17,30,57,51,108,0.000333,0.176648,18,9538.995318,529.944184,529.944184,117.592585,2,0
0,0,8,8,10,11,21,23,21,44,0.000333,0.064421,5,966.309833,53.68388,193.261967,71.273029,2,0
0,0,7,7,9,11,20,21,19,40,0.000333,0.057626,4,691.508495,38.417139,172.877124,66.583073,2,0
0,0,15,15,13,15,28,47,41,88,0.000333,0.141016,12,5076.566798,282.031489,423.047233,106.709075,2,0
0,0,14,14,13,15,28,45,39,84,0.000333,0.134606,12,4845.813761,269.211876,403.817813,106.709075,2,0
0,0,34,34,19,52,71,165,111,276,0.000333,0.565777,18,30551.94369,1697.330205,1697.330205,377.133488,11,0
0,0,19,19,15,23,38,87,59,146,0.000333,0.255399,14,10726.76384,595.931324,766.197417,162.645284,5,0
0,0,10,10,11,14,25,34,31,65,0.000333,0.100617,10,3018.506523,167.694807,301.850652,91.356717,1,0
0,0,9,9,11,13,24,27,23,50,0.000333,0.076416,5,1146.240625,63.680035,229.248125,86.159464,2,0
0,0,14,14,14,15,29,48,38,86,0.000333,0.139262,14,5849.009118,324.944951,417.786366,111.906328,2,0
0,0,9,9,13,13,26,34,25,59,0.000333,0.092442,6,1663.95566,92.441981,277.325943,96.211433,2,0
0,0,9,9,12,12,24,27,22,49,0.000333,0.074888,6,1347.978975,74.887721,224.663163,86.0391,2,0
0,0,15,15,15,17,32,53,41,94,0.000333,0.156667,14,6580,365.555556,470,128.090227,2,0
0,0,9,9,14,14,28,35,26,61,0.000333,0.09775,7,2052.740552,114.041142,293.24865,106.605938,2,0
0,0,10,10,13,14,27,32,25,57,0.000333,0.090343,6,1626.171526,90.342863,271.028588,101.408685,2,0
0,0,7,7,9,10,19,18,18,36,0.000333,0.050975,4,611.701562,33.98342,152.92539,61.748606,1,0
0,0,9,9,9,10,19,28,27,55,0.000333,0.077879,8,1869.088106,103.838228,233.636013,61.748606,1,0
0,0,14,14,15,17,32,49,41,90,0.000333,0.15,14,6300,350,450,128.090227,2,0
0,0,13,13,15,17,32,47,39,86,0.000333,0.143333,14,6020,334.444444,430,128.090227,2,0
0,0,7,7,9,12,21,18,22,40,0.000333,0.058564,4,702.770788,39.042822,175.692697,71.548875,1,0
0,0,5,5,8,9,17,15,14,29,0.000333,0.039512,4,474.14569,26.341427,118.536422,52.529325,1,0
0,0,5,5,9,10,19,16,16,32,0.000333,0.045311,4,543.734722,30.207485,135.93368,61.748606,1,0
0,0,5,5,9,10,19,16,16,32,0.000333,0.045311,4,543.734722,30.207485,135.93368,61.748606,1,0
0,0,11,11,17,15,32,51,39,90,0.000333,0.15,16,7200,400,450,128.090227,3,0
0,0,9,9,15,14,29,42,36,78,0.000333,0.126308,14,5304.915247,294.717514,378.922518,111.906328,2,0
0,0,17,17,15,19,34,80,51,131,0.000333,0.222153,14,9330.406851,518.355936,666.457632,139.313982,5,0
0,0,8,8,10,10,20,25,21,46,0.000333,0.06627,10,1988.086924,110.449274,198.808692,66.438562,1,0
0,0,17,17,16,20,36,81,52,133,0.000333,0.2292,16,11001.6004,611.200022,687.600025,150.438562,5,0
0,0,8,8,10,13,23,23,24,47,0.000333,0.070869,5,1063.03706,59.057614,212.607412,81.324997,1,0
0,0,8,8,10,13,23,22,25,47,0.000333,0.070869,5,1063.03706,59.057614,212.607412,81.324997,1,0
0,0,9,9,8,12,20,31,24,55,0.000333,0.079235,8,1901.648362,105.647131,237.706045,67.01955,1,0
0,0,7,7,7,10,17,18,16,34,0.000333,0.046325,3,416.92121,23.162289,138.973737,52.870765,1,0
0,0,7,7,8,11,19,17,18,35,0.000333,0.049559,4,594.709852,33.039436,148.677463,62.053748,1,0
0,0,17,17,17,20,37,68,53,121,0.000333,0.210115,16,10085.50172,560.305651,630.343857,155.92543,2,0
0,0,10,10,9,13,22,34,27,61,0.000333,0.090675,8,2176.20263,120.900146,272.025329,76.635041,1,0
0,0,14,14,14,19,33,44,47,91,0.000333,0.153013,14,6426.558108,357.031006,459.039865,134.013592,2,0
0,0,14,14,13,18,31,49,48,97,0.000333,0.160186,12,5766.684505,320.371361,480.557042,123.164366,2,0
0,0,11,11,11,16,27,33,34,67,0.000333,0.106192,10,3185.774626,176.987479,318.577463,102.053748,2,0
0,0,8,8,10,12,22,24,22,46,0.000333,0.068378,5,1025.669272,56.981626,205.133854,76.238831,1,0
0,0,10,10,10,13,23,31,30,61,0.000333,0.091979,10,2759.372793,153.298489,275.937279,81.324997,1,0
0,0,9,9,14,15,29,37,30,67,0.000333,0.108495,14,4556.786173,253.154787,325.484727,111.906328,2,0
0,0,8,8,12,12,24,30,24,54,0.000333,0.082529,12,2971.0557,165.05865,247.587975,86.0391,2,0
0,0,9,9,14,16,30,38,33,71,0.000333,0.11613,14,4877.449252,270.969403,348.389232,117.302969,2,0
0,0,25,25,17,43,60,111,83,194,0.000333,0.381979,8,9167.494204,509.305234,1145.936776,302.816253,9,0
0,0,25,25,18,44,62,112,86,198,0.000333,0.392977,9,10610.37783,589.465435,1178.930869,315.273641,9,0
0,0,23,23,19,45,64,120,84,204,0.000333,0.408,9,11016,612,1224,327.844012,7,0
0,0,7,7,8,12,20,19,20,39,0.000333,0.056185,4,674.220783,37.45671,168.555196,67.01955,1,0
0,0,9,9,8,12,20,29,29,58,0.000333,0.083557,8,2005.374636,111.409702,250.67183,67.01955,1,0
0,0,24,24,21,45,66,112,82,194,0.000333,0.390871,10,11726.12459,651.451366,1172.612459,339.372055,11,0
0,0,23,23,21,45,66,111,80,191,0.000333,0.384826,10,11544.79277,641.377376,1154.479277,339.372055,11,0
0,0,17,17,17,20,37,85,52,137,0.000333,0.237898,16,11419.12178,634.395654,713.695111,155.92543,6,0
0,0,8,8,12,12,24,30,24,54,0.000333,0.082529,12,2971.0557,165.05865,247.587975,86.0391,2,0
0,0,17,17,17,21,38,86,55,141,0.000333,0.246653,16,11839.32447,657.740248,739.957779,161.725534,6,0
0,0,15,15,16,19,35,77,46,123,0.000333,0.210301,16,10094.42898,560.80161,630.901811,144.710623,6,0
0,0,6,6,12,11,23,22,16,38,0.000333,0.057298,6,1031.372126,57.298451,171.895354,81.073298,2,0
0,0,15,15,17,20,37,78,47,125,0.000333,0.217061,16,10418.90673,578.828152,651.181671,155.92543,6,0
0,0,13,13,10,15,25,38,49,87,0.000333,0.134672,15,6060.232328,336.679574,404.015489,91.82264,1,0
0,0,20,20,18,20,38,73,62,135,0.000333,0.236157,27,19128.69579,1062.705321,708.470214,161.497212,2,0
0,0,19,19,18,20,38,71,60,131,0.000333,0.22916,27,18561.91962,1031.217756,687.478504,161.497212,2,0
0,0,13,13,15,13,28,44,33,77,0.000333,0.123389,14,5182.328606,287.907145,370.166329,106.709075,2,0
0,0,12,12,15,13,28,42,31,73,0.000333,0.116979,14,4913.11673,272.950929,350.936909,106.709075,2,0
0,0,23,23,17,45,62,104,79,183,0.000333,0.363206,8,8716.943398,484.274633,1089.617925,316.620258,9,0
0,0,22,22,17,45,62,103,77,180,0.000333,0.357252,8,8574.042687,476.335705,1071.755336,316.620258,9,0
0,0,5,5,8,8,16,14,11,25,0.000333,0.033333,4,400,22.222222,100,48,2,0
0,0,8,8,14,11,25,27,19,46,0.000333,0.071206,7,1495.321693,83.073427,213.617385,91.356717,3,0
0,0,5,5,9,8,17,15,11,26,0.000333,0.035425,4,425.096135,23.616452,106.274034,52.529325,2,0
0,0,8,8,15,11,26,28,19,47,0.000333,0.07364,7,1546.444667,85.913593,220.920667,96.657107,3,0
0,0,5,5,9,8,17,15,11,26,0.000333,0.035425,4,425.096135,23.616452,106.274034,52.529325,2,0
0,0,8,8,15,11,26,28,19,47,0.000333,0.07364,7,1546.444667,85.913593,220.920667,96.657107,3,0
0,0,7,7,9,9,18,18,14,32,0.000333,0.044479,4,533.7504,29.6528,133.4376,57.05865,2,0
0,0,10,10,14,12,26,31,22,53,0.000333,0.083041,7,1743.863135,96.881285,249.123305,96.322519,3,0
0,0,7,7,10,10,20,19,14,33,0.000333,0.047541,5,713.118136,39.617674,142.623627,66.438562,2,0
0,0,10,10,15,13,28,32,22,54,0.000333,0.086532,7,1817.180161,100.954453,259.597166,106.709075,3,0
0,0,7,7,10,9,19,19,14,33,0.000333,0.046727,5,700.90804,38.939336,140.181608,61.748606,2,0
0,0,10,10,15,12,27,32,22,54,0.000333,0.085588,7,1797.347476,99.852638,256.763925,101.622909,3,0
0,0,7,7,10,9,19,19,14,33,0.000333,0.046727,5,700.90804,38.939336,140.181608,61.748606,2,0
0,0,10,10,15,12,27,32,22,54,0.000333,0.085588,7,1797.347476,99.852638,256.763925,101.622909,3,0
0,0,7,7,10,10,20,20,14,34,0.000333,0.048982,5,734.727776,40.81821,146.945555,66.438562,2,0
0,0,10,10,15,13,28,33,22,55,0.000333,0.088135,7,1850.831645,102.82398,264.404521,106.709075,3,0
0,0,7,7,10,9,19,20,14,34,0.000333,0.048143,5,722.147677,40.119315,144.429535,61.748606,2,0
0,0,10,10,15,12,27,33,22,55,0.000333,0.087173,7,1830.631688,101.70176,261.518813,101.622909,3,0
0,0,5,5,8,9,17,14,12,26,0.000333,0.035425,4,425.096135,23.616452,106.274034,52.529325,2,0
0,0,8,8,13,12,25,27,20,47,0.000333,0.072754,6,1309.567446,72.753747,218.261241,91.125266,3,0
0,0,5,5,10,9,19,16,12,28,0.000333,0.039647,5,594.709852,33.039436,118.94197,61.748606,2,0
0,0,8,8,14,12,26,29,20,49,0.000333,0.076774,7,1612.250823,89.56949,230.321546,96.322519,3,0
0,0,5,5,9,9,18,15,12,27,0.000333,0.037529,4,450.3519,25.01955,112.587975,57.05865,2,0
0,0,8,8,14,12,26,28,20,48,0.000333,0.075207,7,1579.347745,87.741541,225.621106,96.322519,3,0
0,0,19,19,15,16,31,62,51,113,0.000333,0.186608,21,11756.30785,653.128214,559.824183,122.603359,2,0
0,0,18,18,15,16,31,60,49,109,0.000333,0.180002,21,11340.15535,630.008631,540.007398,122.603359,2,0
0,0,7,7,8,8,16,22,18,40,0.000333,0.053333,8,1280,71.111111,160,48,1,0
0,0,7,7,9,9,18,23,19,42,0.000333,0.058379,8,1401.0948,77.8386,175.13685,57.05865,1,0
0,0,16,16,15,19,34,56,50,106,0.000333,0.179757,14,7549.794856,419.433048,539.271061,139.313982,2,0
0,0,25,25,17,43,60,111,83,194,0.000333,0.381979,8,9167.494204,509.305234,1145.936776,302.816253,9,0
0,0,9,9,14,16,30,43,30,73,0.000333,0.119401,7,2507.421094,139.301172,358.203013,117.302969,4,0
0,0,6,6,12,11,23,22,16,38,0.000333,0.057298,6,1031.372126,57.298451,171.895354,81.073298,2,0
0,0,9,9,15,17,32,44,31,75,0.000333,0.125,7,2625,145.833333,375,128.090227,4,0
0,0,15,15,10,16,26,44,58,102,0.000333,0.159815,15,7191.672769,399.537376,479.444851,97.219281,1,0
0,0,8,8,10,13,23,22,25,47,0.000333,0.070869,5,1063.03706,59.057614,212.607412,81.324997,1,0
0,0,7,7,10,12,22,20,22,42,0.000333,0.062432,5,936.48064,52.026702,187.296128,76.238831,1,0
0,0,9,9,10,13,23,27,31,58,0.000333,0.087456,10,2623.665935,145.759219,262.366593,81.324997,1,0
0,0,8,8,10,13,23,23,24,47,0.000333,0.070869,5,1063.03706,59.057614,212.607412,81.324997,1,0
0,0,12,12,13,19,32,48,40,88,0.000333,0.146667,12,5280,293.333333,440,128.816339,3,0
0,0,7,7,8,12,20,19,20,39,0.000333,0.056185,4,674.220783,37.45671,168.555196,67.01955,1,0
0,0,9,9,8,12,20,29,29,58,0.000333,0.083557,8,2005.374636,111.409702,250.67183,67.01955,1,0
0,0,30,30,19,47,66,149,96,245,0.000333,0.493626,18,26655.77807,1480.876559,1480.876559,341.776299,11,0
0,0,15,15,14,18,32,71,44,115,0.000333,0.191667,14,8050,447.222222,575,128.361619,5,0
0,0,6,6,11,9,20,18,14,32,0.000333,0.046101,5,691.508495,38.417139,138.301699,66.583073,1,0
0,0,35,35,20,56,76,178,117,295,0.000333,0.61438,20,36862.77233,2047.931796,1843.138616,411.650438,12,0
0,0,20,20,17,28,45,100,65,165,0.000333,0.302052,16,14498.49217,805.471787,906.155761,204.092806,6,0
0,0,11,11,15,20,35,47,37,84,0.000333,0.14362,7,3016.018414,167.556579,430.859773,145.041921,2,0
0,0,10,10,15,19,34,42,34,76,0.000333,0.128882,7,2706.530232,150.362791,386.647176,139.313982,2,0
0,0,36,36,20,56,76,183,121,304,0.000333,0.633123,20,37987.39928,2110.411071,1899.369964,411.650438,12,0
0,0,21,21,16,29,45,105,69,174,0.000333,0.318527,16,15289.31902,849.406612,955.582439,204.881449,6,0
0,0,26,26,19,47,66,135,92,227,0.000333,0.457359,9,12348.69719,686.038733,1372.077465,341.776299,9,0
0,0,12,12,14,21,35,52,41,93,0.000333,0.159008,7,3339.163244,185.509069,477.023321,145.541635,2,0
0,0,8,8,11,12,23,26,21,47,0.000333,0.070869,5,1063.03706,59.057614,212.607412,81.073298,1,0
0,0,13,13,14,22,36,56,44,100,0.000333,0.172331,14,7237.895002,402.105278,516.9925,151.410465,2,0
0,0,14,14,13,19,32,43,47,90,0.000333,0.15,12,5400,300,450,128.816339,2,0
0,0,8,8,10,13,23,22,25,47,0.000333,0.070869,5,1063.03706,59.057614,212.607412,81.324997,2,0
0,0,22,22,17,39,56,98,73,171,0.000333,0.331019,8,7944.461533,441.358974,993.057692,275.617555,7,0
0,0,22,22,18,40,58,99,76,175,0.000333,0.341716,9,9226.320067,512.573337,1025.146674,287.935774,7,0
0,0,14,14,11,16,27,54,42,96,0.000333,0.152156,10,4564.692002,253.594,456.4692,102.053748,1,0
0,0,16,16,12,17,29,65,53,118,0.000333,0.191081,18,10318.35163,573.241757,573.241757,112.506418,1,0
0,0,17,17,15,18,33,73,59,132,0.000333,0.221953,21,13983.0605,776.836694,665.860024,133.662009,2,0
0,0,18,18,18,24,42,83,60,143,0.000333,0.257034,18,13879.82505,771.101391,771.101391,185.09775,3,0
0,0,19,19,18,24,42,84,62,146,0.000333,0.262426,18,14171.01019,787.278344,787.278344,185.09775,3,0
0,0,11,11,12,20,32,39,35,74,0.000333,0.123333,6,2220,123.333333,370,129.458112,2,0
0,0,7,7,8,12,20,19,20,39,0.000333,0.056185,4,674.220783,37.45671,168.555196,67.01955,1,0
0,0,9,9,8,12,20,29,29,58,0.000333,0.083557,8,2005.374636,111.409702,250.67183,67.01955,1,0
0,0,32,32,21,48,69,158,99,257,0.000333,0.523297,20,31397.81571,1744.323095,1569.890785,360.316866,12,0
0,0,9,9,14,18,32,41,28,69,0.000333,0.115,7,2415,134.166667,345,128.361619,2,0
0,0,11,11,15,19,34,46,38,84,0.000333,0.142449,14,5982.856301,332.380906,427.346879,139.313982,2,0
0,0,11,11,15,19,34,46,38,84,0.000333,0.142449,14,5982.856301,332.380906,427.346879,139.313982,2,0
0,0,10,10,11,12,23,32,30,62,0.000333,0.093487,10,2804.608413,155.811578,280.460841,81.073298,1,0
0,0,12,12,14,13,27,44,38,82,0.000333,0.129967,14,5458.610852,303.256158,389.900775,101.408685,2,0
0,0,27,27,23,51,74,134,93,227,0.000333,0.469849,11,15505.00505,861.38917,1409.545914,393.335617,10,0
0,0,26,26,23,50,73,133,91,224,0.000333,0.462174,11,15251.72771,847.318206,1386.520701,386.234734,10,0
0,0,13,13,13,16,29,48,40,88,0.000333,0.142501,12,5130.027931,285.001552,427.502328,112.105716,2,0
0,0,13,13,12,16,28,47,40,87,0.000333,0.139413,12,5018.878539,278.826585,418.239878,107.01955,2,0
0,0,15,15,13,15,28,51,42,93,0.000333,0.149028,12,5365.008093,298.056005,447.084008,106.709075,2,0
0,0,15,15,13,16,29,51,42,93,0.000333,0.150597,12,5421.506791,301.194822,451.792233,112.105716,2,0
0,0,13,13,12,15,27,47,39,86,0.000333,0.136307,12,4907.043902,272.61355,408.920325,101.622909,2,0
0,0,13,13,12,15,27,47,39,86,0.000333,0.136307,12,4907.043902,272.61355,408.920325,101.622909,2,0
0,0,15,15,13,15,28,52,42,94,0.000333,0.15063,12,5422.696352,301.260908,451.891363,106.709075,2,0
0,0,15,15,13,16,29,52,42,94,0.000333,0.152217,12,5479.802563,304.433476,456.650214,112.105716,2,0
0,0,5,5,8,8,16,14,12,26,0.000333,0.034667,4,416,23.111111,104,48,1,0
0,0,9,9,7,12,19,26,20,46,0.000333,0.065135,3,586.213997,32.567444,195.404666,62.671034,1,0
0,0,12,12,13,15,28,39,28,67,0.000333,0.107364,6,1932.556679,107.36426,322.09278,106.709075,2,0
0,0,10,10,13,15,28,36,25,61,0.000333,0.09775,6,1759.491901,97.74955,293.24865,106.709075,2,0
0,0,9,9,7,12,19,30,25,55,0.000333,0.077879,6,1401.816079,77.878671,233.636013,62.671034,1,0
0,0,5,5,7,11,18,24,18,42,0.000333,0.058379,3,525.41055,29.189475,175.13685,57.705232,1,0
0,0,4,4,11,11,22,20,15,35,0.000333,0.052027,5,780.400533,43.355585,156.080107,76.107496,2,0
0,0,8,8,12,13,25,27,23,50,0.000333,0.077398,6,1393.156857,77.397603,232.192809,91.125266,2,0
0,0,4,4,11,12,23,20,16,36,0.000333,0.054283,5,814.241152,45.23562,162.84823,81.073298,2,0
0,0,8,8,12,14,26,28,26,54,0.000333,0.084608,6,1522.942469,84.607915,253.823745,96.322519,2,0
0,0,7,7,9,9,18,21,18,39,0.000333,0.054209,8,1301.0166,72.2787,162.627075,57.05865,1,0
0,0,6,6,8,9,17,19,16,35,0.000333,0.047687,4,572.244798,31.791378,143.061199,52.529325,1,0
0,0,17,17,13,21,34,61,52,113,0.000333,0.191628,12,6898.599613,383.255534,574.883301,140.344382,2,0
0,0,16,16,13,21,34,59,50,109,0.000333,0.184844,12,6654.401396,369.688966,554.53345,140.344382,2,0
0,0,10,10,11,13,24,32,29,61,0.000333,0.093228,10,2796.827125,155.379285,279.682713,86.159464,2,0
0,0,9,9,10,13,23,30,27,57,0.000333,0.085948,10,2578.430315,143.246129,257.843031,81.324997,2,0
0,0,17,17,16,20,36,84,52,136,0.000333,0.23437,16,11249.7568,624.986489,703.1098,150.438562,6,0
0,0,8,8,12,12,24,29,24,53,0.000333,0.081001,12,2916.03615,162.002008,243.003013,86.0391,2,0
0,0,17,17,17,21,38,85,55,140,0.000333,0.244903,16,11755.35763,653.075424,734.709852,161.725534,6,0
0,0,14,14,17,20,37,64,45,109,0.000333,0.189277,16,9085.28667,504.738148,567.830417,155.92543,3,0
0,0,15,15,17,20,37,65,47,112,0.000333,0.194486,16,9335.340431,518.630024,583.458777,155.92543,3,0
0,0,5,5,7,7,14,12,11,23,0.000333,0.02919,3,262.70749,14.594861,87.569163,39.302969,1,0
0,0,5,5,8,8,16,13,13,26,0.000333,0.034667,4,416,23.111111,104,48,1,0
0,0,8,8,7,9,16,27,22,49,0.000333,0.065333,6,1176,65.333333,196,48.180809,1,0
0,0,8,8,7,11,18,23,19,42,0.000333,0.058379,3,525.41055,29.189475,175.13685,57.705232,1,0
0,0,7,7,9,11,20,21,19,40,0.000333,0.057626,4,691.508495,38.417139,172.877124,66.583073,1,0
0,0,9,9,8,11,19,31,27,58,0.000333,0.082127,8,1971.038366,109.502131,246.379796,62.053748,1,0
0,0,8,8,8,12,20,24,21,45,0.000333,0.064829,4,777.947057,43.219281,194.486764,67.01955,1,0
0,0,9,9,9,11,20,31,28,59,0.000333,0.084998,8,2039.950061,113.330559,254.993758,66.583073,1,0
0,0,11,11,8,13,21,37,32,69,0.000333,0.101023,8,2424.559217,134.697734,303.069902,72.105716,1,0
0,0,5,5,7,7,14,13,11,24,0.000333,0.030459,3,274.129554,15.22942,91.376518,39.302969,1,0
0,0,5,5,8,8,16,14,12,26,0.000333,0.034667,4,416,23.111111,104,48,1,0
0,0,10,10,12,14,26,28,26,54,0.000333,0.084608,6,1522.942469,84.607915,253.823745,96.322519,2,0
0,0,10,10,12,15,27,28,26,54,0.000333,0.085588,6,1540.583551,85.587975,256.763925,101.622909,2,0
0,0,19,19,14,17,31,60,53,113,0.000333,0.186608,21,11756.30785,653.128214,559.824183,122.789837,2,0
0,0,18,18,14,17,31,58,51,109,0.000333,0.180002,21,11340.15535,630.008631,540.007398,122.789837,2,0
0,0,14,14,14,16,30,54,41,95,0.000333,0.155385,14,6526.164492,362.564694,466.154607,117.302969,2,0
0,0,13,13,14,16,30,52,39,91,0.000333,0.148842,14,6251.378619,347.298812,446.527044,117.302969,2,0
0,0,13,13,14,14,28,42,35,77,0.000333,0.123389,14,5182.328606,287.907145,370.166329,106.605938,2,0
0,0,12,12,14,14,28,40,33,73,0.000333,0.116979,14,4913.11673,272.950929,350.936909,106.605938,2,0
0,0,8,8,11,11,22,23,21,44,0.000333,0.065405,5,981.074956,54.504164,196.214991,76.107496,2,0
0,0,7,7,10,11,21,21,19,40,0.000333,0.058564,5,878.463485,48.803527,175.692697,71.273029,2,0
0,0,8,8,12,12,24,27,24,51,0.000333,0.077944,12,2805.99705,155.888725,233.833088,86.0391,2,0
0,0,7,7,8,11,19,26,19,45,0.000333,0.063719,4,764.626952,42.479275,191.156738,62.053748,1,0
0,0,7,7,9,12,21,27,21,48,0.000333,0.070277,4,843.324945,46.851386,210.831236,71.548875,1,0
0,0,10,10,9,13,22,40,32,72,0.000333,0.107026,8,2568.632612,142.701812,321.079077,76.635041,1,0
0,0,8,8,9,11,20,29,22,51,0.000333,0.073473,8,1763.346663,97.963703,220.418333,66.583073,1,0
0,0,7,7,9,11,20,21,19,40,0.000333,0.057626,4,691.508495,38.417139,172.877124,66.583073,1,0
0,0,8,8,10,12,22,30,24,54,0.000333,0.08027,10,2408.093074,133.782949,240.809307,76.238831,1,0
0,0,9,9,9,11,20,31,28,59,0.000333,0.084998,8,2039.950061,113.330559,254.993758,66.583073,1,0
0,0,11,11,10,13,23,43,35,78,0.000333,0.117613,10,3528.378326,196.021018,352.837833,81.324997,1,0
0,0,26,26,19,49,68,133,94,227,0.000333,0.460618,9,12436.68659,690.927032,1381.854065,355.831405,9,0
0,0,7,7,8,12,20,19,20,39,0.000333,0.056185,4,674.220783,37.45671,168.555196,67.01955,1,0
0,0,10,10,9,15,24,36,33,69,0.000333,0.105454,8,2530.8993,140.605517,316.362413,87.132684,1,0
0,0,24,24,19,40,59,104,76,180,0.000333,0.352959,9,9529.88174,529.437874,1058.875749,293.587747,8,0
0,0,20,20,19,38,57,96,67,163,0.000333,0.31692,9,8556.849651,475.380536,950.761072,280.131868,8,0
0,0,21,21,16,23,39,98,65,163,0.000333,0.287174,16,13784.32899,765.796055,861.520562,168.041925,5,0
0,0,12,12,11,17,28,43,38,81,0.000333,0.129799,10,3893.957487,216.330971,389.395749,107.540616,1,0
0,0,20,20,13,21,34,70,76,146,0.000333,0.24759,18,13369.85235,742.769575,742.769575,140.344382,2,0
0,0,19,19,13,21,34,68,74,142,0.000333,0.240807,18,13003.55502,722.419723,722.419723,140.344382,2,0
0,0,20,20,14,22,36,70,82,152,0.000333,0.261943,21,16502.40061,916.800034,785.8286,151.410465,2,0
0,0,19,19,14,22,36,68,80,148,0.000333,0.25505,21,16068.1269,892.673717,765.1489,151.410465,2,0
0,0,18,18,16,21,37,71,77,148,0.000333,0.257,24,18503.97836,1027.998797,770.999098,156.238666,3,0
0,0,10,10,13,16,29,44,34,78,0.000333,0.126308,12,4547.070211,252.615012,378.922518,112.105716,2,0
0,0,7,7,9,12,21,22,21,43,0.000333,0.062957,4,755.478597,41.971033,188.869649,71.548875,1,0
0,0,6,6,8,12,20,20,19,39,0.000333,0.056185,4,674.220783,37.45671,168.555196,67.01955,1,0
0,0,12,12,16,18,34,53,41,94,0.000333,0.159407,16,7651.544113,425.085784,478.221507,139.05865,3,0
0,0,10,10,13,16,29,44,34,78,0.000333,0.126308,12,4547.070211,252.615012,378.922518,112.105716,2,0
0,0,5,5,9,10,19,22,17,39,0.000333,0.055223,4,662.676692,36.815372,165.669173,61.748606,1,0
0,0,5,5,10,11,21,22,17,39,0.000333,0.0571,5,856.501897,47.583439,171.300379,71.273029,1,0
0,0,14,14,17,15,32,49,38,87,0.000333,0.145,16,6960,386.666667,435,128.090227,3,0
0,0,11,11,12,14,26,34,27,61,0.000333,0.095576,6,1720.360937,95.575608,286.726823,96.322519,2,0
0,0,14,14,17,16,33,49,38,87,0.000333,0.146287,16,7021.796614,390.099812,438.862288,133.486868,3,0
0,0,11,11,12,15,27,34,27,61,0.000333,0.096683,6,1740.288826,96.682713,290.048138,101.622909,2,0
0,0,13,13,13,20,33,46,68,114,0.000333,0.191687,18,10351.09673,575.06093,575.06093,134.544278,2,0
0,0,7,7,13,17,30,28,26,54,0.000333,0.088324,6,1589.832553,88.324031,264.972092,117.592585,2,0
0,0,8,8,14,19,33,29,28,57,0.000333,0.095843,7,2012.713254,111.817403,287.530465,134.013592,2,0
0,0,17,17,15,24,39,67,76,143,0.000333,0.251938,21,15872.06286,881.78127,755.812517,168.642459,2,0
0,0,12,12,12,17,29,39,42,81,0.000333,0.131165,12,4721.957527,262.330974,393.496461,112.506418,2,0
0,0,8,8,7,15,22,21,26,47,0.000333,0.069864,3,628.779858,34.932214,209.593286,78.254843,1,0
0,0,12,12,13,19,32,40,42,82,0.000333,0.136667,12,4920,273.333333,410,128.816339,2,0
0,0,8,8,8,17,25,22,25,47,0.000333,0.072754,4,873.044964,48.502498,218.261241,93.486868,1,0
0,0,14,14,12,19,31,46,48,94,0.000333,0.155231,12,5588.333438,310.462969,465.694453,123.730173,2,0
0,0,14,14,13,21,34,47,48,95,0.000333,0.161103,12,5799.707639,322.20598,483.30897,140.344382,2,0
0,0,5,5,5,10,15,9,17,26,0.000333,0.03386,2,203.158311,11.286573,101.579155,44.828921,1,0
0,0,5,5,6,12,18,10,16,26,0.000333,0.036139,3,325.25415,18.069675,108.41805,58.529325,1,0
0,0,5,5,7,10,17,10,14,24,0.000333,0.0327,3,294.297325,16.349851,98.099108,52.870765,1,0
0,0,5,5,8,8,16,11,12,23,0.000333,0.030667,4,368,20.444444,92,48,1,0
0,0,5,5,6,14,20,10,19,29,0.000333,0.041779,3,376.007744,20.889319,125.335915,68.812744,1,0
0,0,10,10,9,18,27,31,44,75,0.000333,0.118872,8,2852.932501,158.49625,356.616563,103.587975,1,0
0,0,10,10,10,20,30,32,43,75,0.000333,0.122672,10,3680.167947,204.453775,368.016795,119.657843,1,0
0,0,13,13,15,21,36,47,55,102,0.000333,0.175777,14,7382.652902,410.147383,527.33235,150.842025,2,0
0,0,14,14,9,20,29,43,74,117,0.000333,0.189461,12,6820.605317,378.922518,568.383776,114.967887,1,0
0,0,14,14,10,22,32,44,77,121,0.000333,0.201667,15,9075,504.166667,605,131.326777,1,0
0,0,17,17,15,23,38,59,89,148,0.000333,0.258898,21,16310.55871,906.142151,776.693272,162.645284,2,0
0,0,13,13,15,19,34,49,42,91,0.000333,0.15432,14,6481.42766,360.079314,462.959119,139.313982,2,0
0,0,10,10,14,17,31,35,30,65,0.000333,0.107341,7,2254.159321,125.231073,322.02276,122.789837,2,0
0,0,30,30,22,51,73,136,102,238,0.000333,0.491059,22,32409.92139,1800.551188,1473.178245,387.401188,11,0
0,0,29,29,22,51,73,135,100,235,0.000333,0.48487,11,16000.69649,888.927582,1454.608771,387.401188,11,0
0,0,15,15,15,17,32,67,44,111,0.000333,0.185,14,7770,431.666667,555,128.090227,2,0
0,0,11,11,15,15,30,48,33,81,0.000333,0.132486,14,5564.413935,309.134108,397.458138,117.206718,2,0
0,0,18,18,16,24,40,75,56,131,0.000333,0.232391,16,11154.76129,619.70896,697.17258,174.0391,2,0
0,0,11,11,15,15,30,48,33,81,0.000333,0.132486,14,5564.413935,309.134108,397.458138,117.206718,2,0
0,0,9,9,15,15,30,40,34,74,0.000333,0.121037,14,5083.538657,282.418814,363.109904,117.206718,2,0
0,0,14,14,16,23,39,58,60,118,0.000333,0.207892,16,9978.839389,554.379966,623.677462,168.041925,2,0
0,0,20,20,17,42,59,91,73,164,0.000333,0.321584,8,7718.027681,428.779316,964.75346,295.9642,7,0
0,0,19,19,17,42,59,90,71,161,0.000333,0.315702,8,7576.844248,420.935792,947.105531,295.9642,7,0
0,0,20,20,18,44,62,92,72,164,0.000333,0.325496,9,8788.393754,488.244097,976.488195,315.273641,7,0
0,0,19,19,18,44,62,91,70,161,0.000333,0.319542,9,8627.630454,479.312803,958.625606,315.273641,7,0
0,0,28,28,19,49,68,122,99,221,0.000333,0.448443,18,24215.92718,1345.329288,1345.329288,355.831405,8,0
0,0,27,27,19,49,68,121,97,218,0.000333,0.442356,9,11943.6021,663.53345,1327.066899,355.831405,8,0
0,0,28,28,22,52,74,127,101,228,0.000333,0.471918,11,15573.30904,865.183836,1415.755367,394.530361,9,0
0,0,27,27,22,52,74,126,99,225,0.000333,0.465709,11,15368.39708,853.799838,1397.127007,394.530361,9,0
0,0,11,11,15,17,32,50,34,84,0.000333,0.14,14,5880,326.666667,420,128.090227,2,0
0,0,11,11,14,17,31,49,34,83,0.000333,0.137066,14,5756.776113,319.820895,411.198294,122.789837,2,0
0,0,11,11,12,14,26,35,33,68,0.000333,0.106543,12,3835.55881,213.086601,319.629901,96.322519,2,0
0,0,4,4,8,12,20,11,17,28,0.000333,0.040338,4,484.055947,26.891997,121.013987,67.01955,1,0
0,0,10,10,12,11,23,29,27,56,0.000333,0.08444,12,3039.833634,168.879646,253.31947,81.073298,2,0
0,0,10,10,12,13,25,33,29,62,0.000333,0.095973,12,3455.029005,191.946056,287.919084,91.125266,2,0
0,0,19,19,19,24,43,68,83,151,0.000333,0.273122,27,22122.88141,1229.048967,819.365978,190.749723,2,0
0,0,13,13,12,19,31,50,71,121,0.000333,0.199819,18,10790.23956,599.457754,599.457754,123.730173,2,0
0,0,12,12,12,13,25,36,33,69,0.000333,0.106809,12,3845.112925,213.617385,320.426077,91.125266,2,0
0,0,15,15,15,21,36,62,53,115,0.000333,0.19818,14,8323.579252,462.42107,594.541375,150.842025,2,0
0,0,15,15,16,23,39,63,53,116,0.000333,0.204369,16,9809.706518,544.983695,613.106657,168.041925,2,0
0,0,12,12,12,19,31,51,46,97,0.000333,0.160186,12,5766.684505,320.371361,480.557042,123.730173,1,0
0,0,12,12,14,19,33,45,44,89,0.000333,0.14965,14,6285.315073,349.184171,448.951077,134.013592,2,0
0,0,12,12,15,21,36,46,44,90,0.000333,0.155098,14,6514.105502,361.89475,465.29325,150.842025,2,0
0,0,14,14,16,19,35,58,45,103,0.000333,0.176105,16,8453.058412,469.614356,528.316151,144.710623,3,0
0,0,14,14,16,19,35,58,45,103,0.000333,0.176105,16,8453.058412,469.614356,528.316151,144.710623,3,0
0,0,14,14,16,18,34,58,45,103,0.000333,0.17467,16,8384.138762,465.785487,524.008673,139.05865,3,0
0,0,13,13,15,18,33,55,44,99,0.000333,0.166465,14,6991.530249,388.418347,499.395018,133.662009,2,0
0,0,15,15,17,18,35,55,42,97,0.000333,0.165847,16,7960.647242,442.25818,497.540453,144.545518,3,0
0,0,12,12,16,17,33,41,32,73,0.000333,0.122747,8,2945.926166,163.662565,368.240771,133.486868,3,0
0,0,13,13,14,16,30,46,35,81,0.000333,0.132486,14,5564.413935,309.134108,397.458138,117.302969,2,0
0,0,10,10,13,14,27,32,25,57,0.000333,0.090343,6,1626.171526,90.342863,271.028588,101.408685,2,0
0,0,8,8,10,13,23,26,21,47,0.000333,0.070869,5,1063.03706,59.057614,212.607412,81.324997,3,0
0,0,6,6,9,10,19,19,16,35,0.000333,0.049559,4,594.709852,33.039436,148.677463,61.748606,2,0
0,0,12,12,12,19,31,46,48,94,0.000333,0.155231,12,5588.333438,310.462969,465.694453,123.730173,1,0
0,0,19,19,16,25,41,78,72,150,0.000333,0.267878,16,12858.12481,714.340267,803.632801,180.096405,2,0
0,0,10,10,14,19,33,46,39,85,0.000333,0.142925,14,6002.829002,333.4905,428.7735,134.013592,2,0
0,0,17,17,16,23,39,74,60,134,0.000333,0.236081,16,11331.90236,629.550131,708.243897,168.041925,2,0
0,0,10,10,13,18,31,45,36,81,0.000333,0.133763,12,4815.478814,267.526601,401.289901,123.164366,2,0
0,0,16,16,13,20,33,62,78,140,0.000333,0.235405,18,12711.87318,706.215177,706.215177,134.544278,2,0
0,0,10,10,13,17,30,44,36,80,0.000333,0.13085,12,4710.614972,261.700832,392.551248,117.592585,2,0
0,0,17,17,16,19,35,64,43,107,0.000333,0.182944,16,8781.332525,487.851807,548.833283,144.710623,3,0
0,0,17,17,16,19,35,64,43,107,0.000333,0.182944,16,8781.332525,487.851807,548.833283,144.710623,3,0
0,0,12,12,15,18,33,60,38,98,0.000333,0.164784,14,6920.908732,384.49493,494.350624,133.662009,3,0
0,0,12,12,15,17,32,60,38,98,0.000333,0.163333,14,6860,381.111111,490,128.090227,3,0
0,0,13,13,17,21,38,50,59,109,0.000333,0.190675,16,9152.385583,508.465866,572.024099,161.725534,2,0
0,0,19,19,22,26,48,79,85,164,0.000333,0.305311,33,30225.81705,1679.212059,915.93385,220.318928,3,0
0,0,13,13,18,22,40,54,69,123,0.000333,0.218199,27,17674.1232,981.895734,654.597156,173.166146,2,0
0,0,12,12,15,19,34,61,39,100,0.000333,0.169582,14,7122.447978,395.691554,508.746284,139.313982,3,0
0,0,12,12,15,19,34,60,39,99,0.000333,0.167886,14,7051.223498,391.734639,503.658821,139.313982,3,0
0,0,9,9,14,19,33,37,37,74,0.000333,0.124428,7,2612.996154,145.166453,373.285165,134.013592,2,0
0,0,5,5,11,15,26,20,22,42,0.000333,0.065806,5,987.092341,54.838463,197.418468,96.657107,2,0
0,0,15,15,17,21,38,59,46,105,0.000333,0.183677,16,8816.518223,489.806568,551.032389,161.725534,4,0
0,0,11,11,14,17,31,39,29,68,0.000333,0.112295,7,2358.197444,131.010969,336.885349,122.789837,3,0
0,0,15,15,17,21,38,58,46,104,0.000333,0.181928,16,8732.551382,485.141743,545.784461,161.725534,4,0
0,0,11,11,14,17,31,38,29,67,0.000333,0.110644,7,2323.51807,129.084337,331.931153,122.789837,3,0
0,0,5,5,11,15,26,20,22,42,0.000333,0.065806,5,987.092341,54.838463,197.418468,96.657107,2,0
0,0,14,14,17,19,36,55,44,99,0.000333,0.170608,16,8189.161202,454.9534,511.822575,150.197491,3,0
0,0,10,10,14,15,29,35,27,62,0.000333,0.100398,7,2108.363752,117.13132,301.194822,111.906328,2,0
0,0,14,14,15,18,33,46,43,89,0.000333,0.14965,14,6285.315073,349.184171,448.951077,133.662009,2,0
0,0,10,10,13,15,28,30,26,56,0.000333,0.089737,6,1615.271254,89.737292,269.211876,106.709075,2,0
0,0,15,15,15,19,34,57,46,103,0.000333,0.17467,14,7336.121417,407.562301,524.008673,139.313982,3,0
0,0,15,15,15,19,34,57,46,103,0.000333,0.17467,14,7336.121417,407.562301,524.008673,139.313982,3,0
0,0,5,5,7,9,16,10,13,23,0.000333,0.030667,3,276,15.333333,92,48.180809,1,0
0,0,9,9,13,17,30,33,33,66,0.000333,0.107952,6,1943.128676,107.951593,323.854779,117.592585,2,0
0,0,13,13,13,19,32,38,44,82,0.000333,0.136667,12,4920,273.333333,410,128.816339,2,0
0,0,13,13,14,21,35,39,45,84,0.000333,0.14362,14,6032.036828,335.113157,430.859773,145.541635,2,0
0,0,18,18,15,24,39,54,64,118,0.000333,0.207892,14,8731.484466,485.08247,623.677462,168.642459,2,0
0,0,13,13,12,18,30,43,42,85,0.000333,0.139029,12,5005.028408,278.057134,417.085701,118.0782,2,0
0,0,8,8,7,14,21,21,24,45,0.000333,0.065885,3,592.962852,32.942381,197.654284,72.954453,1,0
0,0,13,13,13,20,33,44,43,87,0.000333,0.146287,12,5266.347461,292.574859,438.862288,134.544278,2,0
0,0,8,8,8,16,24,22,24,46,0.000333,0.070303,4,843.6331,46.868506,210.908275,88,1,0
0,0,18,18,14,24,38,62,61,123,0.000333,0.215165,14,9036.931178,502.051732,645.495084,163.342069,2,0
0,0,15,15,13,22,35,51,49,100,0.000333,0.170976,12,6155.13962,341.952201,512.928302,146.213212,2,0
0,0,15,15,12,18,30,44,55,99,0.000333,0.161927,18,8744.079041,485.782169,485.782169,118.0782,2,0
0,0,15,15,13,20,33,45,60,105,0.000333,0.176554,18,9533.904886,529.661383,529.661383,134.544278,2,0
0,0,19,19,14,23,37,59,75,134,0.000333,0.232689,21,14659.40177,814.411209,698.066751,157.344894,2,0
0,0,17,17,12,19,31,50,65,115,0.000333,0.189911,18,10255.18636,569.732576,569.732576,123.730173,2,0
0,0,17,17,13,21,34,51,72,123,0.000333,0.208586,18,11263.64273,625.757929,625.757929,140.344382,2,0
0,0,15,15,13,20,33,51,69,120,0.000333,0.201776,18,10895.8913,605.327294,605.327294,134.544278,2,0
0,0,5,5,10,15,25,20,21,41,0.000333,0.063466,5,951.990519,52.888362,190.398104,91.82264,1,0
0,0,10,10,11,18,29,47,42,89,0.000333,0.14412,10,4323.603086,240.200171,432.360309,113.112398,1,0
0,0,14,14,11,20,31,59,70,129,0.000333,0.21303,15,9586.369861,532.576103,639.091324,124.49231,1,0
0,0,8,8,13,12,25,26,19,45,0.000333,0.069658,6,1253.841171,69.657843,208.973529,91.125266,3,0
0,0,8,8,13,12,25,26,19,45,0.000333,0.069658,6,1253.841171,69.657843,208.973529,91.125266,3,0
0,0,8,8,13,12,25,26,19,45,0.000333,0.069658,6,1253.841171,69.657843,208.973529,91.125266,3,0
0,0,15,15,15,15,30,63,45,108,0.000333,0.176648,21,11128.82787,618.268215,529.944184,117.206718,2,0
0,0,12,12,15,15,30,49,35,84,0.000333,0.137393,14,5770.50334,320.583519,412.17881,117.206718,2,0
0,0,11,11,15,15,30,47,33,80,0.000333,0.13085,14,5495.717467,305.317637,392.551248,117.206718,2,0
0,0,18,18,16,19,35,76,52,128,0.000333,0.218849,16,10504.77162,583.598423,656.548226,144.710623,3,0
0,0,18,18,16,18,34,76,52,128,0.000333,0.217065,16,10419.1239,578.840217,651.195244,139.05865,3,0
0,0,15,15,15,16,31,69,48,117,0.000333,0.193214,21,12172.46034,676.247796,579.640968,122.603359,2,0
0,0,3,3,9,8,17,15,11,26,0.000333,0.035425,4,425.096135,23.616452,106.274034,52.529325,1,0
0,0,12,12,14,21,35,52,43,95,0.000333,0.162427,14,6821.946413,378.997023,487.281887,145.541635,1,0
0,0,13,13,15,18,33,60,42,102,0.000333,0.171509,14,7203.394802,400.1886,514.5282,133.662009,3,0
0,0,13,13,15,18,33,60,42,102,0.000333,0.171509,14,7203.394802,400.1886,514.5282,133.662009,3,0
0,0,13,13,15,17,32,60,42,102,0.000333,0.17,14,7140,396.666667,510,128.090227,3,0
0,0,12,12,14,17,31,57,41,98,0.000333,0.161837,14,6797.157338,377.619852,485.511238,122.789837,2,0
0,0,10,10,16,18,34,36,38,74,0.000333,0.125491,16,6023.556004,334.642,376.47225,139.05865,2,0
0,0,19,19,18,22,40,62,80,142,0.000333,0.251905,27,20404.27232,1133.570684,755.713789,173.166146,2,0
0,0,16,16,20,19,39,69,54,123,0.000333,0.216701,20,13002.08946,722.338303,650.104473,167.149185,4,0
0,0,9,9,16,18,34,38,29,67,0.000333,0.11362,8,2726.880083,151.493338,340.86001,139.05865,2,0
0,0,16,16,19,19,38,68,54,122,0.000333,0.213416,18,11524.44882,640.247157,640.247157,161.421246,4,0
0,0,9,9,15,18,33,37,29,66,0.000333,0.110977,7,2330.510083,129.472782,332.930012,133.662009,2,0
0,0,16,16,20,19,39,69,54,123,0.000333,0.216701,20,13002.08946,722.338303,650.104473,167.149185,4,0
0,0,9,9,16,18,34,38,29,67,0.000333,0.11362,8,2726.880083,151.493338,340.86001,139.05865,2,0
0,0,16,16,19,19,38,68,54,122,0.000333,0.213416,18,11524.44882,640.247157,640.247157,161.421246,4,0
0,0,9,9,15,18,33,37,29,66,0.000333,0.110977,7,2330.510083,129.472782,332.930012,133.662009,2,0
0,0,18,18,20,19,39,72,56,128,0.000333,0.22551,20,13530.62968,751.701649,676.531484,167.149185,4,0
0,0,11,11,16,18,34,41,31,72,0.000333,0.122099,8,2930.378597,162.798811,366.297325,139.05865,2,0
0,0,18,18,20,20,40,72,56,128,0.000333,0.227069,20,13624.13592,756.89644,681.206796,172.877124,4,0
0,0,11,11,16,19,35,41,31,72,0.000333,0.123103,8,2954.467018,164.137057,369.308377,144.710623,2,0
0,0,14,14,15,23,38,49,52,101,0.000333,0.17668,14,7420.569504,412.253861,530.040679,162.645284,2,0
0,0,17,17,12,21,33,54,77,131,0.000333,0.220272,18,11894.68133,660.81563,660.81563,135.258216,2,0
0,0,17,17,13,23,36,55,83,138,0.000333,0.237817,18,12842.0937,713.44965,713.44965,152.147641,2,0
0,0,11,11,18,22,40,54,49,103,0.000333,0.18272,18,9866.854688,548.158594,548.158594,173.166146,2,0
0,0,10,10,18,20,38,51,42,93,0.000333,0.162686,18,8785.030658,488.057259,488.057259,161.497212,2,0
0,0,29,29,22,51,73,133,95,228,0.000333,0.470427,11,15524.07999,862.448889,1411.279999,387.401188,12,0
0,0,28,28,22,51,73,132,93,225,0.000333,0.464237,11,15319.81578,851.100877,1392.710526,387.401188,12,0
0,0,29,29,22,51,73,133,95,228,0.000333,0.470427,11,15524.07999,862.448889,1411.279999,387.401188,12,0
0,0,28,28,22,51,73,132,93,225,0.000333,0.464237,11,15319.81578,851.100877,1392.710526,387.401188,12,0
0,0,14,14,15,19,34,50,46,96,0.000333,0.162799,14,6837.550059,379.863892,488.396433,139.313982,2,0
0,0,13,13,17,18,35,55,44,99,0.000333,0.169266,16,8124.784299,451.376905,507.799019,144.545518,3,0
0,0,16,16,18,23,41,72,86,158,0.000333,0.282164,27,22855.31685,1269.739825,846.493217,179.100575,2,0
0,0,10,10,18,20,38,54,44,98,0.000333,0.171432,18,9257.344134,514.296896,514.296896,161.497212,2,0
0,0,13,13,17,18,35,55,44,99,0.000333,0.169266,16,8124.784299,451.376905,507.799019,144.545518,3,0
0,0,13,13,17,18,35,55,44,99,0.000333,0.169266,16,8124.784299,451.376905,507.799019,144.545518,3,0
0,0,10,10,12,12,24,32,26,58,0.000333,0.088643,12,3191.133901,177.285217,265.927825,86.0391,3,0
0,0,10,10,13,15,28,38,32,70,0.000333,0.112172,12,4038.178135,224.34323,336.514845,106.709075,2,0
0,0,10,10,12,15,27,37,32,69,0.000333,0.109362,12,3937.046852,218.724825,328.087238,101.622909,2,0
0,0,10,10,12,14,26,37,31,68,0.000333,0.106543,12,3835.55881,213.086601,319.629901,96.322519,2,0
0,0,10,10,12,14,26,37,31,68,0.000333,0.106543,12,3835.55881,213.086601,319.629901,96.322519,2,0
0,0,10,10,14,18,32,42,33,75,0.000333,0.125,7,2625,145.833333,375,128.361619,2,0
0,0,9,9,11,13,24,30,24,54,0.000333,0.082529,5,1237.939875,68.774438,247.587975,86.159464,2,0
0,0,9,9,11,13,24,30,24,54,0.000333,0.082529,5,1237.939875,68.774438,247.587975,86.159464,2,0
0,0,9,9,11,13,24,30,24,54,0.000333,0.082529,5,1237.939875,68.774438,247.587975,86.159464,2,0
0,0,9,9,11,13,24,30,24,54,0.000333,0.082529,5,1237.939875,68.774438,247.587975,86.159464,2,0
0,0,19,19,16,22,38,79,57,136,0.000333,0.237906,16,11419.49027,634.416126,713.718142,162.107496,3,0
0,0,10,10,13,13,26,36,29,65,0.000333,0.101843,12,3666.34298,203.685721,305.528582,96.211433,3,0
0,0,11,11,13,13,26,34,29,63,0.000333,0.098709,12,3553.532427,197.418468,296.127702,96.211433,3,0
0,0,10,10,13,12,25,36,29,65,0.000333,0.100617,12,3622.207828,201.233768,301.850652,91.125266,3,0
0,0,13,13,14,20,34,56,48,104,0.000333,0.176365,14,7407.345897,411.519216,529.096135,139.741531,1,0
0,0,7,7,13,15,28,31,31,62,0.000333,0.099352,12,3576.672062,198.704003,298.056005,106.709075,2,0
0,0,9,9,12,14,26,48,30,78,0.000333,0.122211,12,4399.611576,244.422865,366.634298,96.322519,2,0
0,0,9,9,12,14,26,48,30,78,0.000333,0.122211,12,4399.611576,244.422865,366.634298,96.322519,2,0
0,0,11,11,13,16,29,53,33,86,0.000333,0.139262,12,5013.436387,278.524244,417.786366,112.105716,2,0
0,0,11,11,13,15,28,53,33,86,0.000333,0.137811,12,4961.19028,275.621682,413.432523,106.709075,2,0
0,0,9,9,13,15,28,49,31,80,0.000333,0.128196,12,4615.060725,256.392263,384.588394,106.709075,2,0
0,0,9,9,12,15,27,48,31,79,0.000333,0.125212,12,4507.633352,250.424075,375.636113,101.622909,2,0
0,0,9,9,13,15,28,30,26,56,0.000333,0.089737,6,1615.271254,89.737292,269.211876,106.709075,2,0
0,0,20,20,19,27,46,74,79,153,0.000333,0.281702,18,15211.88963,845.104979,845.104979,209.092585,3,0
0,0,17,17,16,23,39,62,84,146,0.000333,0.257223,24,18520.04938,1028.891632,771.668724,168.041925,3,0
0,0,15,15,18,20,38,61,51,112,0.000333,0.195923,18,10579.82187,587.767882,587.767882,161.497212,3,0
0,0,14,14,15,20,35,56,46,102,0.000333,0.174396,14,7324.616148,406.923119,523.186868,145.041921,3,0
0,0,14,14,15,20,35,55,46,101,0.000333,0.172686,14,7252.806186,402.933677,518.057585,145.041921,3,0
0,0,7,7,11,12,23,33,23,56,0.000333,0.08444,5,1266.597348,70.366519,253.31947,81.073298,1,0
0,0,10,10,13,15,28,40,27,67,0.000333,0.107364,6,1932.556679,107.36426,322.09278,106.709075,2,0
0,0,10,10,13,14,27,40,27,67,0.000333,0.106192,6,1911.464776,106.192488,318.577463,101.408685,2,0
0,0,3,3,8,9,17,13,12,25,0.000333,0.034062,4,408.746284,22.708127,102.186571,52.529325,1,0
0,0,3,3,9,8,17,15,11,26,0.000333,0.035425,4,425.096135,23.616452,106.274034,52.529325,1,0
0,0,8,8,15,20,35,36,32,68,0.000333,0.116264,7,2441.538716,135.64104,348.791245,145.041921,2,0
0,0,11,11,14,16,30,49,33,82,0.000333,0.134122,14,5633.110404,312.950578,402.365029,117.302969,2,0
0,0,11,11,14,16,30,49,33,82,0.000333,0.134122,14,5633.110404,312.950578,402.365029,117.302969,2,0
0,0,14,14,15,23,38,46,43,89,0.000333,0.155689,7,3269.458841,181.636602,467.065549,162.645284,2,0
0,0,12,12,15,18,33,40,33,73,0.000333,0.122747,7,2577.685395,143.204744,368.240771,133.662009,2,0
0,0,13,13,15,17,32,47,37,84,0.000333,0.14,14,5880,326.666667,420,128.090227,2,0
0,0,11,11,14,16,30,36,28,64,0.000333,0.10468,7,2198.286987,122.127055,314.040998,117.302969,2,0
0,0,11,11,15,19,34,57,40,97,0.000333,0.164495,14,6908.774538,383.820808,493.483896,139.313982,2,0
0,0,12,12,15,20,35,54,39,93,0.000333,0.159008,7,3339.163244,185.509069,477.023321,145.041921,3,0
0,0,12,12,15,20,35,53,39,92,0.000333,0.157298,7,3303.258263,183.514348,471.894038,145.041921,3,0
0,0,11,11,15,18,33,50,37,87,0.000333,0.146287,14,6144.072037,341.337335,438.862288,133.662009,2,0
0,0,15,15,16,24,40,63,61,124,0.000333,0.219973,16,10558.70534,586.594741,659.919084,174.0391,3,0
0,0,15,15,16,24,40,63,61,124,0.000333,0.219973,16,10558.70534,586.594741,659.919084,174.0391,3,0
0,0,12,12,15,17,32,40,42,82,0.000333,0.136667,14,5740,318.888889,410,128.090227,3,0
0,0,12,12,14,19,33,38,41,79,0.000333,0.132836,14,5579.099896,309.949994,398.507135,134.013592,2,0
0,0,12,12,16,17,33,46,44,90,0.000333,0.151332,16,7263.927532,403.55153,453.995471,133.486868,4,0
0,0,12,12,16,19,35,44,43,87,0.000333,0.148749,16,7139.96196,396.664553,446.247622,144.710623,3,0
0,0,12,12,13,14,27,39,33,72,0.000333,0.114117,12,4108.222802,228.2346,342.3519,101.408685,3,0
0,0,13,13,13,14,27,37,33,70,0.000333,0.110947,12,3994.105502,221.89475,332.842125,101.408685,3,0
0,0,14,14,15,18,33,57,45,102,0.000333,0.171509,14,7203.394802,400.1886,514.5282,133.662009,2,0
0,0,15,15,15,19,34,60,46,106,0.000333,0.179757,14,7549.794856,419.433048,539.271061,139.313982,3,0
0,0,15,15,15,19,34,60,46,106,0.000333,0.179757,14,7549.794856,419.433048,539.271061,139.313982,3,0
0,0,15,15,15,19,34,56,45,101,0.000333,0.171278,14,7193.672458,399.64847,513.833747,139.313982,3,0
0,0,15,15,15,19,34,56,45,101,0.000333,0.171278,14,7193.672458,399.64847,513.833747,139.313982,3,0
0,0,15,15,13,23,36,62,55,117,0.000333,0.201627,12,7258.574702,403.25415,604.881225,152.147641,4,0
0,0,14,14,13,24,37,56,47,103,0.000333,0.178858,6,3219.44218,178.857899,536.573697,158.144816,4,0
0,0,12,12,13,19,32,43,40,83,0.000333,0.138333,12,4980,276.666667,415,128.816339,3,0
0,0,8,8,11,16,27,26,24,50,0.000333,0.079248,5,1188.721876,66.040104,237.744375,102.053748,2,0
0,0,13,13,13,20,33,47,43,90,0.000333,0.151332,12,5447.945649,302.663647,453.995471,134.544278,3,0
0,0,15,15,14,24,38,57,58,115,0.000333,0.201171,14,8449.163297,469.397961,603.511664,163.342069,4,0
0,0,12,12,13,20,33,38,43,81,0.000333,0.136199,12,4903.151084,272.397282,408.595924,134.544278,3,0
0,0,6,6,11,10,21,19,15,34,0.000333,0.04978,5,746.693962,41.482998,149.338792,71.273029,2,0
0,0,14,14,15,17,32,44,40,84,0.000333,0.14,14,5880,326.666667,420,128.090227,3,0
0,0,10,10,14,15,29,30,25,55,0.000333,0.089063,7,1870.322683,103.906816,267.188955,111.906328,3,0
0,0,14,14,15,18,33,44,40,84,0.000333,0.141243,14,5932.207484,329.567082,423.729106,133.662009,3,0
0,0,10,10,14,15,29,30,25,55,0.000333,0.089063,7,1870.322683,103.906816,267.188955,111.906328,3,0
0,0,14,14,15,18,33,44,40,84,0.000333,0.141243,14,5932.207484,329.567082,423.729106,133.662009,3,0
0,0,10,10,14,15,29,30,25,55,0.000333,0.089063,7,1870.322683,103.906816,267.188955,111.906328,3,0
0,0,14,14,14,19,33,45,41,86,0.000333,0.144606,14,6073.45052,337.413918,433.817894,134.013592,3,0
0,0,10,10,13,16,29,31,26,57,0.000333,0.092302,6,1661.4295,92.301639,276.904917,112.105716,3,0
0,0,14,14,14,19,33,44,41,85,0.000333,0.142925,14,6002.829002,333.4905,428.7735,134.013592,3,0
0,0,10,10,13,16,29,30,26,56,0.000333,0.090682,6,1632.281614,90.682312,272.046936,112.105716,3,0
0,0,18,18,15,21,36,58,49,107,0.000333,0.184394,14,7744.547652,430.252647,553.181975,150.842025,3,0
0,0,12,12,14,18,32,39,29,68,0.000333,0.113333,7,2380,132.222222,340,128.361619,3,0
0,0,12,12,14,18,32,39,29,68,0.000333,0.113333,7,2380,132.222222,340,128.361619,3,0
0,0,9,9,12,14,26,35,26,61,0.000333,0.095576,6,1720.360937,95.575608,286.726823,96.322519,2,0
0,0,9,9,12,14,26,35,26,61,0.000333,0.095576,6,1720.360937,95.575608,286.726823,96.322519,2,0
0,0,9,9,12,14,26,35,26,61,0.000333,0.095576,6,1720.360937,95.575608,286.726823,96.322519,2,0
0,0,9,9,12,13,25,35,26,61,0.000333,0.094425,12,3399.302731,188.850152,283.275228,91.125266,2,0
0,0,9,9,12,14,26,35,26,61,0.000333,0.095576,6,1720.360937,95.575608,286.726823,96.322519,2,0
0,0,11,11,14,17,31,44,32,76,0.000333,0.125506,7,2635.632437,146.424024,376.51892,122.789837,2,0
0,0,9,9,12,14,26,35,26,61,0.000333,0.095576,6,1720.360937,95.575608,286.726823,96.322519,2,0
0,0,11,11,14,17,31,44,32,76,0.000333,0.125506,7,2635.632437,146.424024,376.51892,122.789837,2,0
0,0,9,9,13,14,27,36,27,63,0.000333,0.099853,6,1797.347476,99.852638,299.557913,101.408685,2,0
0,0,9,9,12,14,26,35,27,62,0.000333,0.097142,6,1748.563575,97.142421,291.427263,96.322519,2,0
0,0,9,9,12,14,26,35,26,61,0.000333,0.095576,6,1720.360937,95.575608,286.726823,96.322519,2,0
0,0,9,9,12,14,26,35,26,61,0.000333,0.095576,6,1720.360937,95.575608,286.726823,96.322519,2,0
0,0,12,12,14,14,28,41,30,71,0.000333,0.113774,14,4778.510793,265.472822,341.322199,106.605938,5,0
0,0,12,12,14,16,30,39,29,68,0.000333,0.111223,7,2335.679924,129.759996,333.668561,117.302969,4,0
0,0,12,12,14,13,27,41,30,71,0.000333,0.112532,14,4726.358177,262.575454,337.597013,101.408685,5,0
0,0,12,12,14,15,29,39,29,68,0.000333,0.110114,7,2312.398954,128.466609,330.342708,111.906328,4,0
0,0,12,12,15,14,29,42,32,74,0.000333,0.11983,14,5032.868311,279.603795,359.490594,111.906328,5,0
0,0,12,12,15,16,31,40,31,71,0.000333,0.117249,7,2462.235566,136.790865,351.747938,122.603359,4,0
0,0,12,12,14,14,28,41,32,73,0.000333,0.116979,14,4913.11673,272.950929,350.936909,106.605938,5,0
0,0,12,12,14,16,30,39,31,70,0.000333,0.114494,7,2404.376392,133.576466,343.482342,117.302969,4,0
0,0,12,12,14,14,28,41,30,71,0.000333,0.113774,14,4778.510793,265.472822,341.322199,106.605938,5,0
0,0,12,12,14,16,30,39,29,68,0.000333,0.111223,7,2335.679924,129.759996,333.668561,117.302969,4,0
0,0,12,12,14,13,27,41,30,71,0.000333,0.112532,14,4726.358177,262.575454,337.597013,101.408685,5,0
0,0,12,12,14,15,29,39,29,68,0.000333,0.110114,7,2312.398954,128.466609,330.342708,111.906328,4,0
0,0,16,16,14,20,34,66,54,120,0.000333,0.203499,14,8546.937573,474.829865,610.495541,139.741531,2,0
0,0,15,15,14,20,34,64,52,116,0.000333,0.196715,14,8262.039654,459.002203,590.14569,139.741531,2,0
0,0,9,9,9,15,24,30,29,59,0.000333,0.090171,4,1082.05115,60.113953,270.512788,87.132684,1,0
0,0,16,16,15,21,36,66,54,120,0.000333,0.206797,14,8685.474002,482.526333,620.391,150.842025,2,0
0,0,15,15,15,21,36,64,52,116,0.000333,0.199904,14,8395.958202,466.442122,599.7113,150.842025,2,0
0,0,9,9,10,16,26,30,28,58,0.000333,0.090875,5,1363.127518,75.729307,272.625504,97.219281,1,0
0,0,20,20,15,22,37,84,67,151,0.000333,0.262209,21,16519.17662,917.732035,786.627458,156.710855,2,0
0,0,10,10,14,17,31,49,35,84,0.000333,0.138717,14,5826.134861,323.674159,416.15249,122.789837,2,0
0,0,17,17,15,22,37,70,57,127,0.000333,0.220534,14,9262.408084,514.578227,661.600577,156.710855,2,0
0,0,10,10,13,16,29,44,35,79,0.000333,0.127927,12,4605.365983,255.853666,383.780499,112.105716,2,0
0,0,3,3,9,11,20,16,13,29,0.000333,0.041779,4,501.343659,27.852426,125.335915,66.583073,1,0
0,0,3,3,9,11,20,16,13,29,0.000333,0.041779,4,501.343659,27.852426,125.335915,66.583073,1,0
0,0,10,10,15,16,31,48,33,81,0.000333,0.133763,14,5618.058616,312.114368,401.289901,122.603359,2,0
0,0,10,10,14,16,30,47,33,80,0.000333,0.13085,14,5495.717467,305.317637,392.551248,117.302969,2,0
0,0,6,6,14,16,30,32,27,59,0.000333,0.096502,7,2026.545816,112.585879,289.506545,117.302969,1,0
0,0,7,7,12,16,28,32,29,61,0.000333,0.09775,6,1759.491901,97.74955,293.24865,107.01955,2,0
0,0,16,16,14,23,37,69,69,138,0.000333,0.239635,21,15096.99585,838.721992,718.904564,157.344894,2,0
0,0,13,13,12,19,31,50,71,121,0.000333,0.199819,18,10790.23956,599.457754,599.457754,123.730173,2,0
0,0,16,16,13,22,35,57,77,134,0.000333,0.229108,18,12371.83064,687.323924,687.323924,146.213212,1,0
0,0,16,16,14,24,38,58,83,141,0.000333,0.246653,21,15539.11337,863.284076,739.957779,163.342069,1,0
0,0,11,11,17,19,36,59,48,107,0.000333,0.184394,16,8850.911602,491.717311,553.181975,150.197491,3,0
0,0,9,9,12,11,23,27,22,49,0.000333,0.073885,12,2659.85443,147.769691,221.654536,81.073298,3,0
0,0,12,12,13,14,27,39,33,72,0.000333,0.114117,12,4108.222802,228.2346,342.3519,101.408685,3,0
0,0,13,13,12,13,25,35,33,68,0.000333,0.105261,12,3789.386651,210.521481,315.782221,91.125266,2,0
0,0,13,13,12,14,26,35,33,68,0.000333,0.106543,12,3835.55881,213.086601,319.629901,96.322519,2,0
0,0,11,11,12,17,29,46,40,86,0.000333,0.139262,12,5013.436387,278.524244,417.786366,112.506418,1,0
0,0,9,9,8,13,21,29,49,78,0.000333,0.1142,12,4111.209108,228.400506,342.600759,72.105716,1,0
0,0,12,12,11,18,29,48,50,98,0.000333,0.158694,10,4760.821375,264.490076,476.082138,113.112398,1,0
0,0,14,14,13,14,27,38,34,72,0.000333,0.114117,12,4108.222802,228.2346,342.3519,101.408685,3,0
0,0,12,12,13,14,27,39,33,72,0.000333,0.114117,12,4108.222802,228.2346,342.3519,101.408685,3,0
0,0,14,14,15,23,38,59,67,126,0.000333,0.220413,14,9257.344134,514.296896,661.238867,162.645284,2,0
0,0,14,14,15,23,38,59,67,126,0.000333,0.220413,14,9257.344134,514.296896,661.238867,162.645284,2,0
0,0,12,12,13,13,26,35,30,65,0.000333,0.101843,12,3666.34298,203.685721,305.528582,96.211433,3,0
0,0,19,19,19,24,43,72,84,156,0.000333,0.282166,27,22855.42715,1269.745953,846.497302,190.749723,2,0
0,0,11,11,12,12,24,32,29,61,0.000333,0.093228,12,3356.192551,186.455142,279.682713,86.0391,2,0
0,0,10,10,12,13,25,33,29,62,0.000333,0.095973,12,3455.029005,191.946056,287.919084,91.125266,2,0
0,0,10,10,13,13,26,36,29,65,0.000333,0.101843,12,3666.34298,203.685721,305.528582,96.211433,3,0
0,0,12,12,13,19,32,38,43,81,0.000333,0.135,12,4860,270,405,128.816339,2,0
0,0,12,12,14,20,34,39,43,82,0.000333,0.139057,14,5840.407342,324.467075,417.171953,139.741531,2,0
0,0,17,17,17,23,40,58,61,119,0.000333,0.211103,16,10132.95109,562.941727,633.309443,173.528793,3,0
0,0,12,12,17,22,39,45,44,89,0.000333,0.1568,16,7526.41276,418.134042,470.400797,167.594364,3,0
0,0,5,5,6,12,18,10,16,26,0.000333,0.036139,3,325.25415,18.069675,108.41805,58.529325,1,0
0,0,17,17,21,21,42,80,58,138,0.000333,0.248047,20,14882.79609,826.822005,744.139804,184.477332,4,0
0,0,12,12,18,17,35,60,45,105,0.000333,0.179525,18,9694.344902,538.574717,538.574717,144.545518,3,0
0,0,17,17,20,21,41,79,58,137,0.000333,0.244662,20,14679.69249,815.538472,733.984625,178.677228,4,0
0,0,12,12,18,17,35,60,45,105,0.000333,0.179525,18,9694.344902,538.574717,538.574717,144.545518,3,0
0,0,17,17,21,21,42,80,58,138,0.000333,0.248047,20,14882.79609,826.822005,744.139804,184.477332,4,0
0,0,12,12,18,17,35,60,45,105,0.000333,0.179525,18,9694.344902,538.574717,538.574717,144.545518,3,0
0,0,17,17,20,21,41,79,58,137,0.000333,0.244662,20,14679.69249,815.538472,733.984625,178.677228,4,0
0,0,12,12,18,17,35,60,45,105,0.000333,0.179525,18,9694.344902,538.574717,538.574717,144.545518,3,0
0,0,11,11,12,18,30,35,40,75,0.000333,0.122672,12,4416.201536,245.34453,368.016795,118.0782,2,0
0,0,11,11,13,20,33,36,40,76,0.000333,0.127791,12,4600.487437,255.582635,383.373953,134.544278,2,0
0,0,9,9,13,15,28,49,31,80,0.000333,0.128196,12,4615.060725,256.392263,384.588394,106.709075,2,0
0,0,9,9,12,15,27,48,31,79,0.000333,0.125212,12,4507.633352,250.424075,375.636113,101.622909,2,0
0,0,12,12,15,17,32,48,56,104,0.000333,0.173333,21,10920,606.666667,520,128.090227,1,0
0,0,4,4,8,12,20,11,17,28,0.000333,0.040338,4,484.055947,26.891997,121.013987,67.01955,1,0
0,0,8,8,10,14,24,35,28,63,0.000333,0.096284,10,2888.526375,160.473688,288.852638,86.52225,1,0
0,0,8,8,11,17,28,36,28,64,0.000333,0.102557,5,1538.353575,85.464088,307.670715,107.540616,1,0
0,0,12,12,11,19,30,54,45,99,0.000333,0.161927,10,4857.82169,269.878983,485.782169,118.764371,1,0
0,0,16,16,15,24,39,69,54,123,0.000333,0.216701,14,9101.462621,505.636812,650.104473,168.642459,2,0
0,0,11,11,14,16,30,49,33,82,0.000333,0.134122,14,5633.110404,312.950578,402.365029,117.302969,2,0
0,0,11,11,14,16,30,49,33,82,0.000333,0.134122,14,5633.110404,312.950578,402.365029,117.302969,2,0
0,0,16,16,18,20,38,64,51,115,0.000333,0.201171,18,10863.20995,603.511664,603.511664,161.497212,4,0
0,0,16,16,18,20,38,64,51,115,0.000333,0.201171,18,10863.20995,603.511664,603.511664,161.497212,4,0
0,0,18,18,19,21,40,68,54,122,0.000333,0.216425,18,11686.9541,649.275228,649.275228,172.949289,4,0
0,0,18,18,19,21,40,68,54,122,0.000333,0.216425,18,11686.9541,649.275228,649.275228,172.949289,4,0
0,0,20,20,19,23,42,78,60,138,0.000333,0.248047,18,13394.51648,744.139804,744.139804,184.752548,4,0
0,0,15,15,18,19,37,61,50,111,0.000333,0.19275,18,10408.48783,578.249324,578.249324,155.769273,3,0
0,0,16,16,20,19,39,77,56,133,0.000333,0.234319,20,14059.1699,781.064995,702.958495,167.149185,4,0
0,0,16,16,20,19,39,77,56,133,0.000333,0.234319,20,14059.1699,781.064995,702.958495,167.149185,4,0
0,0,16,16,20,19,39,77,56,133,0.000333,0.234319,20,14059.1699,781.064995,702.958495,167.149185,4,0
0,0,16,16,20,19,39,77,56,133,0.000333,0.234319,20,14059.1699,781.064995,702.958495,167.149185,4,0
0,0,18,18,21,20,41,82,59,141,0.000333,0.251805,20,15108.29665,839.349814,755.414833,178.677228,4,0
0,0,18,18,21,21,42,82,59,141,0.000333,0.253439,20,15206.33513,844.796396,760.316757,184.477332,4,0
0,0,16,16,21,20,41,78,57,135,0.000333,0.24109,20,14465.39041,803.632801,723.269521,178.677228,4,0
0,0,16,16,20,20,40,77,57,134,0.000333,0.237713,20,14262.76729,792.375961,713.138365,172.877124,4,0
0,0,10,10,11,13,24,38,29,67,0.000333,0.102397,10,3071.924875,170.662493,307.192488,86.159464,2,0
0,0,12,12,14,17,31,47,35,82,0.000333,0.135415,14,5687.417364,315.967631,406.244097,122.789837,2,0
0,0,5,5,12,16,28,24,24,48,0.000333,0.076918,6,1384.518218,76.917679,230.753036,107.01955,2,0
0,0,17,17,19,27,46,76,66,142,0.000333,0.261449,18,14118.22436,784.345798,784.345798,209.092585,3,0
0,0,5,5,12,17,29,24,25,49,0.000333,0.079347,6,1428.246413,79.347023,238.041069,112.506418,2,0
0,0,5,5,11,15,26,20,22,42,0.000333,0.065806,5,987.092341,54.838463,197.418468,96.657107,2,0
0,0,11,11,16,24,40,44,45,89,0.000333,0.157884,8,3789.212804,210.511822,473.6516,174.0391,3,0
0,0,5,5,11,16,27,20,23,43,0.000333,0.068153,5,1022.300813,56.79449,204.460163,102.053748,2,0
0,0,8,8,8,16,24,32,29,61,0.000333,0.093228,4,1118.73085,62.151714,279.682713,88,1,0
0,0,8,8,10,19,29,34,29,63,0.000333,0.102018,5,1530.264013,85.014667,306.052803,113.929904,1,0
0,0,5,5,12,16,28,25,24,49,0.000333,0.07852,6,1413.362347,78.52013,235.560391,107.01955,2,0
0,0,19,19,18,29,47,85,73,158,0.000333,0.292542,18,15797.25069,877.625039,877.625039,215.940099,3,0
0,0,5,5,12,17,29,25,25,50,0.000333,0.080966,6,1457.394299,80.96635,242.89905,112.506418,2,0
0,0,15,15,15,25,40,65,56,121,0.000333,0.214651,14,9015.346193,500.852566,643.953299,174.699764,2,0
0,0,16,16,15,18,33,67,45,112,0.000333,0.188324,14,7909.609979,439.422777,564.972141,133.662009,3,0
0,0,16,16,15,18,33,67,45,112,0.000333,0.188324,14,7909.609979,439.422777,564.972141,133.662009,3,0
0,0,11,11,12,14,26,47,36,83,0.000333,0.130045,12,4681.637959,260.090998,390.136497,96.322519,1,0
0,0,31,31,19,53,72,140,111,251,0.000333,0.516217,18,27875.72116,1548.651175,1548.651175,384.290407,10,0
0,0,30,30,19,53,72,139,109,248,0.000333,0.510047,18,27542.54521,1530.1414,1530.1414,384.290407,10,0
0,0,31,31,22,56,78,145,113,258,0.000333,0.540545,22,35675.94299,1981.996833,1621.633772,423.319371,11,0
0,0,30,30,22,56,78,144,111,255,0.000333,0.534259,11,17630.55322,979.475179,1602.777566,423.319371,11,0
0,0,14,14,17,19,36,53,49,102,0.000333,0.175777,16,8437.317602,468.739867,527.33235,150.197491,3,0
0,0,14,14,16,21,37,51,48,99,0.000333,0.171912,16,8251.774131,458.431896,515.735883,156.238666,2,0
0,0,33,33,25,54,79,156,120,276,0.000333,0.579948,24,41756.24368,2319.791315,1739.843486,426.86033,12,0
0,0,33,33,24,56,80,154,119,273,0.000333,0.575295,24,41421.27288,2301.181827,1725.88637,435.250976,11,0
0,0,18,18,16,24,40,65,86,151,0.000333,0.26787,24,19286.66742,1071.481523,803.611142,174.0391,3,0
0,0,16,16,15,18,33,67,45,112,0.000333,0.188324,14,7909.609979,439.422777,564.972141,133.662009,3,0
0,0,16,16,15,18,33,67,45,112,0.000333,0.188324,14,7909.609979,439.422777,564.972141,133.662009,3,0
0,0,10,10,13,17,30,32,33,65,0.000333,0.106316,6,1913.687332,106.315963,318.947889,117.592585,3,0
0,0,11,11,14,13,27,37,29,66,0.000333,0.104608,14,4393.516052,244.084225,313.822575,101.408685,3,0
0,0,15,15,20,21,41,73,51,124,0.000333,0.221445,20,13286.72897,738.15161,664.336449,178.677228,3,0
0,0,15,15,20,21,41,73,51,124,0.000333,0.221445,20,13286.72897,738.15161,664.336449,178.677228,3,0
0,0,8,8,13,12,25,26,19,45,0.000333,0.069658,6,1253.841171,69.657843,208.973529,91.125266,3,0
0,0,15,15,15,18,33,61,44,105,0.000333,0.176554,14,7415.259355,411.958853,529.661383,133.662009,2,0
0,0,9,9,14,14,28,35,26,61,0.000333,0.09775,7,2052.740552,114.041142,293.24865,106.605938,2,0
0,0,10,10,14,18,32,38,32,70,0.000333,0.116667,7,2450,136.111111,350,128.361619,2,0
0,0,9,9,14,14,28,35,26,61,0.000333,0.09775,7,2052.740552,114.041142,293.24865,106.605938,2,0
0,0,10,10,11,18,29,47,42,89,0.000333,0.14412,10,4323.603086,240.200171,432.360309,113.112398,1,0
0,0,11,11,12,14,26,52,38,90,0.000333,0.141013,12,5076.474896,282.026383,423.039575,96.322519,1,0
0,0,11,11,12,14,26,43,35,78,0.000333,0.122211,12,4399.611576,244.422865,366.634298,96.322519,1,0
0,0,14,14,15,18,33,55,42,97,0.000333,0.163102,14,6850.287214,380.571512,489.30623,133.662009,2,0
0,0,11,11,11,18,29,41,43,84,0.000333,0.136023,10,4080.704036,226.70578,408.070404,113.112398,1,0
0,0,9,9,14,15,29,34,27,61,0.000333,0.098779,7,2074.357885,115.242105,296.336841,111.906328,2,0
0,0,12,12,14,13,27,41,36,77,0.000333,0.122042,14,5125.768727,284.764929,366.126338,101.408685,3,0
0,0,12,12,14,15,29,39,35,74,0.000333,0.11983,14,5032.868311,279.603795,359.490594,111.906328,2,0
0,0,13,13,15,19,34,42,40,82,0.000333,0.139057,14,5840.407342,324.467075,417.171953,139.313982,3,0
0,0,13,13,15,21,36,40,39,79,0.000333,0.136141,7,2858.968526,158.831585,408.424075,150.842025,2,0
0,0,15,15,19,25,44,60,51,111,0.000333,0.201999,18,10907.94437,605.99691,605.99691,196.807027,5,0
0,0,15,15,18,27,45,58,50,108,0.000333,0.197707,9,5338.08121,296.560067,593.120134,203.440613,4,0
0,0,16,16,15,14,29,51,36,87,0.000333,0.140881,14,5917.020852,328.723381,422.644347,111.906328,5,0
0,0,16,16,15,16,31,49,35,84,0.000333,0.138717,14,5826.134861,323.674159,416.15249,122.603359,4,0
0,0,16,16,15,13,28,51,36,87,0.000333,0.139413,14,5855.358295,325.297683,418.239878,106.709075,5,0
0,0,16,16,15,15,30,49,35,84,0.000333,0.137393,14,5770.50334,320.583519,412.17881,117.206718,4,0
0,0,10,10,13,15,28,46,32,78,0.000333,0.124991,12,4499.684207,249.982456,374.973684,106.709075,1,0
0,0,13,13,14,18,32,50,65,115,0.000333,0.191667,21,12075,670.833333,575,128.361619,1,0
0,0,15,15,19,23,42,63,60,123,0.000333,0.221085,18,11938.59077,663.255043,663.255043,184.752548,2,0
0,0,11,11,14,17,31,36,33,69,0.000333,0.113947,7,2392.876818,132.937601,341.839545,122.789837,2,0
0,0,5,5,6,12,18,10,16,26,0.000333,0.036139,3,325.25415,18.069675,108.41805,58.529325,1,0
0,0,3,3,9,11,20,16,13,29,0.000333,0.041779,4,501.343659,27.852426,125.335915,66.583073,1,0
0,0,10,10,13,16,29,52,34,86,0.000333,0.139262,12,5013.436387,278.524244,417.786366,112.105716,2,0
0,0,10,10,12,16,28,51,34,85,0.000333,0.136208,12,4903.50202,272.416779,408.625168,107.01955,2,0
0,0,10,10,12,15,27,51,33,84,0.000333,0.133137,12,4792.926602,266.2737,399.41055,101.622909,2,0
0,0,10,10,12,14,26,51,33,84,0.000333,0.131612,12,4738.043236,263.224624,394.836936,96.322519,2,0
0,0,10,10,12,15,27,51,33,84,0.000333,0.133137,12,4792.926602,266.2737,399.41055,101.622909,2,0
0,0,10,10,12,15,27,51,33,84,0.000333,0.133137,12,4792.926602,266.2737,399.41055,101.622909,2,0
0,0,15,15,19,21,40,68,53,121,0.000333,0.214651,18,11591.15939,643.953299,643.953299,172.949289,3,0
0,0,10,10,18,19,37,46,35,81,0.000333,0.140655,9,3797.691504,210.982861,421.965723,155.769273,2,0
0,0,8,8,11,11,22,26,22,48,0.000333,0.071351,10,2140.527177,118.918176,214.052718,76.107496,2,0
0,0,8,8,11,11,22,22,20,42,0.000333,0.062432,5,936.48064,52.026702,187.296128,76.107496,2,0
0,0,15,15,14,21,35,53,50,103,0.000333,0.176105,14,7396.42611,410.912562,528.316151,145.541635,2,0
0,0,9,9,13,17,30,38,32,70,0.000333,0.114494,6,2060.89405,114.494114,343.482342,117.592585,2,0
0,0,12,12,13,19,32,39,40,79,0.000333,0.131667,12,4740,263.333333,395,128.816339,2,0
0,0,15,15,14,17,31,53,42,95,0.000333,0.156883,14,6589.081093,366.060061,470.648649,122.789837,2,0
0,0,12,12,13,15,28,39,32,71,0.000333,0.113774,12,4095.866394,227.548133,341.322199,106.709075,2,0
0,0,8,8,13,12,25,26,19,45,0.000333,0.069658,6,1253.841171,69.657843,208.973529,91.125266,3,0
0,0,5,5,11,15,26,20,22,42,0.000333,0.065806,5,987.092341,54.838463,197.418468,96.657107,2,0
0,0,18,18,19,24,43,90,57,147,0.000333,0.265887,18,14357.89654,797.660919,797.660919,190.749723,4,0
0,0,13,13,15,18,33,54,42,96,0.000333,0.161421,14,6779.665696,376.648094,484.261835,133.662009,2,0
0,0,13,13,15,19,34,54,42,96,0.000333,0.162799,14,6837.550059,379.863892,488.396433,139.313982,2,0
0,0,18,18,18,19,37,76,51,127,0.000333,0.220534,18,11908.81039,661.600577,661.600577,155.769273,4,0
0,0,18,18,18,19,37,76,51,127,0.000333,0.220534,18,11908.81039,661.600577,661.600577,155.769273,4,0
0,0,18,18,16,24,40,70,69,139,0.000333,0.246583,16,11835.96808,657.553782,739.748005,174.0391,3,0
0,0,18,18,16,24,40,70,69,139,0.000333,0.246583,16,11835.96808,657.553782,739.748005,174.0391,3,0
0,0,17,17,16,19,35,68,55,123,0.000333,0.210301,16,10094.42898,560.80161,630.901811,144.710623,2,0
0,0,11,11,11,17,28,45,47,92,0.000333,0.147426,10,4422.766528,245.709252,442.276653,107.540616,1,0
0,0,10,10,11,12,23,29,26,55,0.000333,0.082932,10,2487.959076,138.219949,248.795908,81.073298,2,0
0,0,13,13,12,13,25,35,33,68,0.000333,0.105261,12,3789.386651,210.521481,315.782221,91.125266,2,0
0,0,11,11,12,13,25,32,29,61,0.000333,0.094425,12,3399.302731,188.850152,283.275228,91.125266,2,0
0,0,11,11,12,13,25,32,29,61,0.000333,0.094425,12,3399.302731,188.850152,283.275228,91.125266,2,0
0,0,11,11,12,13,25,32,29,61,0.000333,0.094425,12,3399.302731,188.850152,283.275228,91.125266,2,0
0,0,11,11,12,13,25,32,29,61,0.000333,0.094425,12,3399.302731,188.850152,283.275228,91.125266,2,0
0,0,16,16,17,20,37,77,50,127,0.000333,0.220534,16,10585.60924,588.089402,661.600577,155.92543,3,0
0,0,12,12,16,18,34,58,40,98,0.000333,0.16619,16,7977.141735,443.174541,498.571358,139.05865,3,0
0,0,12,12,15,18,33,57,40,97,0.000333,0.163102,14,6850.287214,380.571512,489.30623,133.662009,3,0
0,0,15,15,15,19,34,55,44,99,0.000333,0.167886,14,7051.223498,391.734639,503.658821,139.313982,3,0
0,0,15,15,15,19,34,55,44,99,0.000333,0.167886,14,7051.223498,391.734639,503.658821,139.313982,3,0
0,0,11,11,13,14,27,47,38,85,0.000333,0.134722,12,4849.985252,269.443625,404.165438,101.408685,2,0
0,0,11,11,13,14,27,47,38,85,0.000333,0.134722,12,4849.985252,269.443625,404.165438,101.408685,2,0
0,0,9,9,11,13,24,39,29,68,0.000333,0.103926,10,3117.7745,173.209694,311.77745,86.159464,1,0
0,0,10,10,12,18,30,41,34,75,0.000333,0.122672,6,2208.100768,122.672265,368.016795,118.0782,1,0
0,0,10,10,12,13,25,44,33,77,0.000333,0.119192,12,4290.923119,238.384618,357.576927,91.125266,1,0
0,0,16,16,14,23,37,60,78,138,0.000333,0.239635,21,15096.99585,838.721992,718.904564,157.344894,1,0
0,0,16,16,15,24,39,61,84,145,0.000333,0.255461,21,16094.04976,894.113875,766.383322,168.642459,1,0
0,0,16,16,18,23,41,72,86,158,0.000333,0.282164,27,22855.31685,1269.739825,846.493217,179.100575,2,0
0,0,10,10,18,20,38,54,44,98,0.000333,0.171432,18,9257.344134,514.296896,514.296896,161.497212,2,0
0,0,5,5,5,10,15,9,17,26,0.000333,0.03386,2,203.158311,11.286573,101.579155,44.828921,1,0
0,0,5,5,6,12,18,10,16,26,0.000333,0.036139,3,325.25415,18.069675,108.41805,58.529325,1,0
0,0,11,11,18,22,40,54,49,103,0.000333,0.18272,18,9866.854688,548.158594,548.158594,173.166146,2,0
0,0,10,10,18,20,38,51,42,93,0.000333,0.162686,18,8785.030658,488.057259,488.057259,161.497212,2,0
0,0,12,12,14,22,36,53,49,102,0.000333,0.175777,14,7382.652902,410.147383,527.33235,151.410465,1,0
0,0,7,7,7,13,20,18,23,41,0.000333,0.059066,3,531.597156,29.533175,177.199052,67.757201,1,0
0,0,12,12,15,23,38,54,49,103,0.000333,0.180179,14,7567.511474,420.417304,540.536534,162.645284,1,0
0,0,7,7,8,15,23,19,22,41,0.000333,0.061822,4,741.864161,41.214676,185.46604,82.603359,1,0
0,0,18,18,19,26,45,80,70,150,0.000333,0.274593,18,14828.00336,823.777964,823.777964,202.922055,2,0
0,0,10,10,18,21,39,56,44,100,0.000333,0.17618,18,9513.723994,528.540222,528.540222,167.297316,2,0
0,0,13,13,15,24,39,58,52,110,0.000333,0.193798,14,8139.519417,452.195523,581.394244,168.642459,1,0
0,0,7,7,13,17,30,31,28,59,0.000333,0.096502,6,1737.039271,96.502182,289.506545,117.592585,1,0
0,0,5,5,6,12,18,10,16,26,0.000333,0.036139,3,325.25415,18.069675,108.41805,58.529325,1,0
0,0,10,10,15,16,31,39,35,74,0.000333,0.122204,14,5132.547378,285.141521,366.610527,122.603359,2,0
0,0,9,9,13,16,29,33,30,63,0.000333,0.102018,6,1836.316816,102.017601,306.052803,112.105716,2,0
0,0,10,10,14,16,30,38,35,73,0.000333,0.119401,14,5014.842189,278.602344,358.203013,117.302969,2,0
0,0,9,9,12,16,28,32,30,62,0.000333,0.099352,6,1788.336031,99.352002,298.056005,107.01955,2,0
0,0,9,9,13,14,27,35,33,68,0.000333,0.107777,12,3879.988202,215.5549,323.33235,101.408685,1,0
0,0,8,8,11,14,25,29,28,57,0.000333,0.088233,10,2646.998028,147.055446,264.699803,91.356717,1,0
0,0,10,10,14,15,29,38,34,72,0.000333,0.116592,14,4896.844843,272.046936,349.774632,111.906328,2,0
0,0,9,9,12,15,27,32,29,61,0.000333,0.096683,6,1740.288826,96.682713,290.048138,101.622909,2,0
0,0,10,10,14,15,29,38,34,72,0.000333,0.116592,14,4896.844843,272.046936,349.774632,111.906328,2,0
0,0,9,9,12,15,27,32,29,61,0.000333,0.096683,6,1740.288826,96.682713,290.048138,101.622909,2,0
0,0,12,12,13,25,38,46,40,86,0.000333,0.150441,6,2707.930597,150.440589,451.321766,164.202121,3,0
0,0,13,13,13,25,38,47,42,89,0.000333,0.155689,6,2802.393292,155.688516,467.065549,164.202121,3,0
0,0,12,12,16,27,43,51,44,95,0.000333,0.171832,8,4123.961214,229.108956,515.495152,192.381963,4,0
0,0,13,13,16,27,43,52,46,98,0.000333,0.177258,8,4254.191568,236.343976,531.773946,192.381963,4,0
0,0,13,13,14,21,35,53,49,102,0.000333,0.174396,14,7324.616148,406.923119,523.186868,145.541635,2,0
0,0,8,8,7,15,22,21,26,47,0.000333,0.069864,3,628.779858,34.932214,209.593286,78.254843,1,0
0,0,13,13,15,23,38,55,50,105,0.000333,0.183677,14,7714.453445,428.580747,551.032389,162.645284,2,0
0,0,8,8,9,18,27,23,26,49,0.000333,0.077663,4,931.95795,51.775442,232.989488,103.587975,1,0
0,0,16,16,15,26,41,67,61,128,0.000333,0.228589,14,9600.733192,533.374066,685.766657,180.814792,2,0
0,0,15,15,15,25,40,62,56,118,0.000333,0.209329,14,8791.825213,488.434734,627.987515,174.699764,2,0
0,0,17,17,14,22,36,60,78,138,0.000333,0.237817,21,14982.44265,832.357925,713.44965,151.410465,2,0
0,0,17,17,15,24,39,62,85,147,0.000333,0.258985,21,16316.03665,906.446481,776.954126,168.642459,2,0
0,0,13,13,14,22,36,55,73,128,0.000333,0.220583,21,13896.7584,772.042134,661.7504,151.410465,2,0
0,0,11,11,15,19,34,57,40,97,0.000333,0.164495,14,6908.774538,383.820808,493.483896,139.313982,2,0
0,0,14,14,12,18,30,45,52,97,0.000333,0.158656,12,5711.620653,317.312259,475.968388,118.0782,2,0
0,0,14,14,14,21,35,47,55,102,0.000333,0.174396,14,7324.616148,406.923119,523.186868,145.541635,2,0
0,0,5,5,12,16,28,23,24,47,0.000333,0.075315,6,1355.674088,75.315227,225.945681,107.01955,2,0
0,0,18,18,17,25,42,67,72,139,0.000333,0.249844,16,11992.51395,666.250775,749.532122,185.583273,3,0
0,0,5,5,12,17,29,23,25,48,0.000333,0.077728,6,1399.098527,77.727696,233.183088,112.506418,2,0
0,0,12,12,15,20,35,60,41,101,0.000333,0.172686,14,7252.806186,402.933677,518.057585,145.041921,3,0
0,0,12,12,15,20,35,60,41,101,0.000333,0.172686,14,7252.806186,402.933677,518.057585,145.041921,3,0
0,0,6,6,5,11,16,13,19,32,0.000333,0.042667,2,256,14.222222,128,49.663388,1,0
0,0,11,11,17,23,40,46,41,87,0.000333,0.154336,8,3704.061954,205.78122,463.007744,173.528793,3,0
0,0,6,6,7,14,21,15,19,34,0.000333,0.04978,3,448.016377,24.889799,149.338792,72.954453,1,0
0,0,7,7,11,10,21,22,18,40,0.000333,0.058564,5,878.463485,48.803527,175.692697,71.273029,2,0
0,0,7,7,11,10,21,22,18,40,0.000333,0.058564,5,878.463485,48.803527,175.692697,71.273029,2,0
0,0,5,5,11,10,21,22,18,40,0.000333,0.058564,5,878.463485,48.803527,175.692697,71.273029,2,0
0,0,7,7,11,10,21,22,18,40,0.000333,0.058564,5,878.463485,48.803527,175.692697,71.273029,2,0
0,0,19,19,19,21,40,70,55,125,0.000333,0.221747,18,11974.33821,665.241012,665.241012,172.949289,4,0
0,0,19,19,19,21,40,70,55,125,0.000333,0.221747,18,11974.33821,665.241012,665.241012,172.949289,4,0
0,0,17,17,18,20,38,66,52,118,0.000333,0.206418,18,11146.59804,619.255447,619.255447,161.497212,4,0
0,0,17,17,18,20,38,66,52,118,0.000333,0.206418,18,11146.59804,619.255447,619.255447,161.497212,4,0
0,0,17,17,18,21,39,67,53,120,0.000333,0.211416,18,11416.46879,634.248266,634.248266,167.297316,4,0
0,0,17,17,18,21,39,66,53,119,0.000333,0.209654,18,11321.33155,628.962864,628.962864,167.297316,4,0
0,0,17,17,18,21,39,67,53,120,0.000333,0.211416,18,11416.46879,634.248266,634.248266,167.297316,4,0
0,0,17,17,18,21,39,66,53,119,0.000333,0.209654,18,11321.33155,628.962864,628.962864,167.297316,4,0
0,0,11,11,17,20,37,49,44,93,0.000333,0.161493,16,7751.666608,430.648145,484.479163,155.92543,2,0
0,0,14,14,16,20,36,64,41,105,0.000333,0.180947,16,8685.474002,482.526333,542.842125,150.438562,3,0
0,0,14,14,16,19,35,64,41,105,0.000333,0.179525,16,8617.195468,478.733082,538.574717,144.710623,3,0
0,0,12,12,16,17,33,60,38,98,0.000333,0.164784,16,7909.609979,439.422777,494.350624,133.486868,3,0
0,0,12,12,16,18,34,60,38,98,0.000333,0.16619,16,7977.141735,443.174541,498.571358,139.05865,3,0
0,0,12,12,16,18,34,60,38,98,0.000333,0.16619,16,7977.141735,443.174541,498.571358,139.05865,3,0
0,0,13,13,18,20,38,66,44,110,0.000333,0.192424,18,10390.89648,577.272026,577.272026,161.497212,3,0
0,0,6,6,10,15,25,19,24,43,0.000333,0.066562,5,998.429081,55.468282,199.685816,91.82264,1,0
0,0,5,5,12,16,28,23,24,47,0.000333,0.075315,6,1355.674088,75.315227,225.945681,107.01955,2,0
0,0,16,16,18,26,44,69,61,130,0.000333,0.236575,18,12775.06999,709.72611,709.72611,197.270083,3,0
0,0,5,5,12,17,29,23,25,48,0.000333,0.077728,6,1399.098527,77.727696,233.183088,112.506418,2,0
0,0,20,20,16,26,42,91,67,158,0.000333,0.283995,16,13631.77845,757.321025,851.986153,186.211433,6,0
0,0,11,11,14,18,32,38,36,74,0.000333,0.123333,14,5180,287.777778,370,128.361619,3,0
0,0,14,14,15,18,33,58,39,97,0.000333,0.163102,14,6850.287214,380.571512,489.30623,133.662009,3,0
0,0,14,14,15,18,33,58,39,97,0.000333,0.163102,14,6850.287214,380.571512,489.30623,133.662009,3,0
0,0,14,14,15,18,33,59,40,99,0.000333,0.166465,14,6991.530249,388.418347,499.395018,133.662009,3,0
0,0,14,14,15,18,33,58,40,98,0.000333,0.164784,14,6920.908732,384.49493,494.350624,133.662009,3,0
0,0,11,11,14,20,34,38,37,75,0.000333,0.127187,7,2670.917992,148.384333,381.559713,139.741531,2,0
0,0,11,11,15,21,36,39,39,78,0.000333,0.134418,7,2822.779051,156.821058,403.25415,150.842025,2,0
0,0,17,17,17,23,40,56,70,126,0.000333,0.223521,24,16093.51056,894.08392,670.56294,173.528793,2,0
0,0,17,17,18,24,42,57,79,136,0.000333,0.244452,27,19800.58958,1100.032754,733.355169,185.09775,2,0
0,0,9,9,10,13,23,35,28,63,0.000333,0.094995,10,2849.844032,158.324668,284.984403,81.324997,1,0
0,0,12,12,14,17,31,47,35,82,0.000333,0.135415,14,5687.417364,315.967631,406.244097,122.789837,2,0
0,0,10,10,12,12,24,28,23,51,0.000333,0.077944,6,1402.998525,77.944363,233.833088,86.0391,3,0
0,0,8,8,12,11,23,29,22,51,0.000333,0.076901,12,2768.419917,153.801107,230.70166,81.073298,3,0
0,0,10,10,12,12,24,28,23,51,0.000333,0.077944,6,1402.998525,77.944363,233.833088,86.0391,3,0
0,0,19,19,13,21,34,63,72,135,0.000333,0.228936,18,12362.5347,686.807484,686.807484,140.344382,2,0
0,0,18,18,13,21,34,61,70,131,0.000333,0.222153,18,11996.23738,666.457632,666.457632,140.344382,2,0
0,0,19,19,14,22,36,63,78,141,0.000333,0.242986,21,15308.14793,850.452663,728.959425,151.410465,2,0
0,0,18,18,14,22,36,61,76,137,0.000333,0.236093,21,14873.87423,826.326346,708.279725,151.410465,2,0
0,0,15,15,13,19,32,55,66,121,0.000333,0.201667,18,10890,605,605,128.816339,2,0
0,0,9,9,13,16,29,37,30,67,0.000333,0.108495,6,1952.90836,108.494909,325.484727,112.105716,2,0
0,0,11,11,11,19,30,54,46,100,0.000333,0.163563,10,4906.890596,272.605033,490.68906,118.764371,1,0
0,0,13,13,12,16,28,66,44,110,0.000333,0.17627,12,6345.708497,352.539361,528.809041,107.01955,1,0
0,0,12,12,12,21,33,56,44,100,0.000333,0.168146,12,6053.272943,336.292941,504.439412,135.258216,1,0
0,0,12,12,14,22,36,53,49,102,0.000333,0.175777,14,7382.652902,410.147383,527.33235,151.410465,1,0
0,0,7,7,7,13,20,18,23,41,0.000333,0.059066,3,531.597156,29.533175,177.199052,67.757201,1,0
0,0,12,12,15,23,38,54,49,103,0.000333,0.180179,14,7567.511474,420.417304,540.536534,162.645284,1,0
0,0,7,7,8,15,23,19,22,41,0.000333,0.061822,4,741.864161,41.214676,185.46604,82.603359,1,0
0,0,18,18,19,26,45,80,70,150,0.000333,0.274593,18,14828.00336,823.777964,823.777964,202.922055,2,0
0,0,10,10,18,21,39,56,44,100,0.000333,0.17618,18,9513.723994,528.540222,528.540222,167.297316,2,0
0,0,13,13,15,24,39,58,52,110,0.000333,0.193798,14,8139.519417,452.195523,581.394244,168.642459,1,0
0,0,5,5,7,10,17,10,14,24,0.000333,0.0327,3,294.297325,16.349851,98.099108,52.870765,1,0
0,0,5,5,8,8,16,11,12,23,0.000333,0.030667,4,368,20.444444,92,48,1,0
0,0,10,10,18,20,38,54,44,98,0.000333,0.171432,18,9257.344134,514.296896,514.296896,161.497212,2,0
0,0,11,11,14,21,35,48,45,93,0.000333,0.159008,14,6678.326488,371.018138,477.023321,145.541635,1,0
0,0,11,11,15,22,37,49,45,94,0.000333,0.16323,14,6855.640629,380.868924,489.688616,156.710855,1,0
0,0,16,16,19,24,43,71,63,134,0.000333,0.242373,18,13088.15059,727.119477,727.119477,190.749723,2,0
0,0,10,10,18,21,39,55,44,99,0.000333,0.174418,18,9418.586754,523.25482,523.25482,167.297316,2,0
0,0,15,15,14,21,35,58,51,109,0.000333,0.186364,14,7827.285884,434.849216,559.091849,145.541635,2,0
0,0,8,8,7,14,21,22,25,47,0.000333,0.068813,3,619.316757,34.406486,206.438919,72.954453,1,0
0,0,15,15,15,22,37,59,51,110,0.000333,0.191013,14,8022.558183,445.697677,573.03987,156.710855,2,0
0,0,8,8,8,16,24,23,24,47,0.000333,0.071831,4,861.97295,47.887386,215.493238,88,1,0
0,0,19,19,15,24,39,77,64,141,0.000333,0.248414,14,10433.38398,579.632443,745.241713,168.642459,2,0
0,0,10,10,14,18,32,49,36,85,0.000333,0.141667,14,5950,330.555556,425,128.361619,2,0
0,0,16,16,15,23,38,63,54,117,0.000333,0.204669,14,8596.105267,477.561404,614.007519,162.645284,2,0
0,0,6,6,7,11,18,14,16,30,0.000333,0.041699,3,375.29325,20.849625,125.09775,57.705232,1,0
0,0,10,10,14,17,31,47,36,83,0.000333,0.137066,14,5756.776113,319.820895,411.198294,122.789837,2,0
0,0,9,9,11,10,21,25,22,47,0.000333,0.068813,10,2064.389189,114.688288,206.438919,71.273029,2,0
0,0,3,3,9,9,18,10,14,24,0.000333,0.033359,4,400.3128,22.2396,100.0782,57.05865,1,0
0,0,12,12,17,16,33,52,37,89,0.000333,0.14965,16,7183.217226,399.067624,448.951077,133.486868,3,0
0,0,12,12,17,16,33,52,37,89,0.000333,0.14965,16,7183.217226,399.067624,448.951077,133.486868,3,0
0,0,9,9,14,18,32,40,33,73,0.000333,0.121667,7,2555,141.944444,365,128.361619,2,0
0,0,16,16,17,23,40,58,58,116,0.000333,0.205781,16,9877.498544,548.749919,617.343659,173.528793,2,0
0,0,12,12,14,20,34,40,36,76,0.000333,0.128882,7,2706.530232,150.362791,386.647176,139.741531,2,0
0,0,12,12,15,20,35,41,38,79,0.000333,0.135071,7,2836.493508,157.582973,405.213358,145.041921,2,0
0,0,13,13,15,23,38,65,52,117,0.000333,0.204669,14,8596.105267,477.561404,614.007519,162.645284,2,0
0,0,15,15,15,24,39,71,66,137,0.000333,0.241367,14,10137.40146,563.18897,724.100104,168.642459,2,0
0,0,15,15,20,21,41,73,51,124,0.000333,0.221445,20,13286.72897,738.15161,664.336449,178.677228,3,0
0,0,15,15,20,21,41,73,51,124,0.000333,0.221445,20,13286.72897,738.15161,664.336449,178.677228,3,0
0,0,14,14,15,18,33,57,45,102,0.000333,0.171509,14,7203.394802,400.1886,514.5282,133.662009,2,0
0,0,15,15,15,20,35,61,47,108,0.000333,0.184654,14,7755.475922,430.859773,553.962566,145.041921,3,0
0,0,15,15,15,20,35,60,47,107,0.000333,0.182944,14,7683.665959,426.870331,548.833283,145.041921,3,0
0,0,9,9,14,17,31,39,31,70,0.000333,0.115598,7,2427.556192,134.864233,346.793742,122.789837,2,0
0,0,18,18,18,19,37,82,56,138,0.000333,0.239635,18,12940.28216,718.904564,718.904564,155.769273,4,0
0,0,18,18,18,19,37,81,56,137,0.000333,0.237898,18,12846.512,713.695111,713.695111,155.769273,4,0
0,0,18,18,18,20,38,82,56,138,0.000333,0.241405,18,13035.85194,724.213997,724.213997,161.497212,4,0
0,0,18,18,18,20,38,81,56,137,0.000333,0.239655,18,12941.38925,718.966069,718.966069,161.497212,4,0
0,0,8,8,10,13,23,33,28,61,0.000333,0.091979,10,2759.372793,153.298489,275.937279,81.324997,1,0
0,0,7,7,10,13,23,30,25,55,0.000333,0.082932,5,1243.979538,69.109974,248.795908,81.324997,1,0
0,0,8,8,10,14,24,31,27,58,0.000333,0.088643,5,1329.639125,73.86884,265.927825,86.52225,1,0
0,0,5,5,10,12,22,25,20,45,0.000333,0.066891,5,1003.372114,55.742895,200.674423,76.238831,1,0
0,0,8,8,10,14,24,33,28,61,0.000333,0.093228,10,2796.827125,155.379285,279.682713,86.52225,1,0
0,0,7,7,10,13,23,30,25,55,0.000333,0.082932,5,1243.979538,69.109974,248.795908,81.324997,1,0
0,0,8,8,10,13,23,31,27,58,0.000333,0.087456,10,2623.665935,145.759219,262.366593,81.324997,1,0
0,0,5,5,10,12,22,25,20,45,0.000333,0.066891,5,1003.372114,55.742895,200.674423,76.238831,1,0
0,0,11,11,14,20,34,40,41,81,0.000333,0.137361,14,5769.182862,320.510159,412.08449,139.741531,2,0
0,0,14,14,20,19,39,62,47,109,0.000333,0.192036,20,11522.17684,640.120935,576.108842,167.149185,3,0
0,0,9,9,16,17,33,40,29,69,0.000333,0.116021,8,2784.505554,154.694753,348.063194,133.486868,2,0
0,0,14,14,20,19,39,62,47,109,0.000333,0.192036,20,11522.17684,640.120935,576.108842,167.149185,3,0
0,0,9,9,16,17,33,40,29,69,0.000333,0.116021,8,2784.505554,154.694753,348.063194,133.486868,2,0
0,0,10,10,15,15,30,39,30,69,0.000333,0.112858,14,4740.056315,263.336462,338.575451,117.206718,2,0
0,0,9,9,13,15,28,33,26,59,0.000333,0.094545,6,1701.803642,94.544647,283.63394,106.709075,2,0
0,0,10,10,14,15,29,38,30,68,0.000333,0.110114,14,4624.797907,256.933217,330.342708,111.906328,2,0
0,0,9,9,12,15,27,32,26,58,0.000333,0.091928,6,1654.700851,91.927825,275.783475,101.622909,2,0
0,0,10,10,14,13,27,38,29,67,0.000333,0.106192,14,4460.084477,247.782471,318.577463,101.408685,2,0
0,0,9,9,12,13,25,32,25,57,0.000333,0.088233,6,1588.198817,88.233268,264.699803,91.125266,2,0
0,0,10,10,14,14,28,38,29,67,0.000333,0.107364,14,4509.298917,250.516606,322.09278,106.605938,2,0
0,0,9,9,12,14,26,32,25,57,0.000333,0.089308,6,1607.550384,89.308355,267.925064,96.322519,2,0
0,0,10,10,15,15,30,39,30,69,0.000333,0.112858,14,4740.056315,263.336462,338.575451,117.206718,2,0
0,0,9,9,13,15,28,33,26,59,0.000333,0.094545,6,1701.803642,94.544647,283.63394,106.709075,2,0
0,0,10,10,14,15,29,38,30,68,0.000333,0.110114,14,4624.797907,256.933217,330.342708,111.906328,2,0
0,0,9,9,12,15,27,32,26,58,0.000333,0.091928,6,1654.700851,91.927825,275.783475,101.622909,2,0
0,0,10,10,14,14,28,38,29,67,0.000333,0.107364,14,4509.298917,250.516606,322.09278,106.605938,2,0
0,0,9,9,12,14,26,32,25,57,0.000333,0.089308,6,1607.550384,89.308355,267.925064,96.322519,2,0
0,0,10,10,14,14,28,38,29,67,0.000333,0.107364,14,4509.298917,250.516606,322.09278,106.605938,2,0
0,0,9,9,12,14,26,32,25,57,0.000333,0.089308,6,1607.550384,89.308355,267.925064,96.322519,2,0
0,0,9,9,11,13,24,39,29,68,0.000333,0.103926,10,3117.7745,173.209694,311.77745,86.159464,1,0
0,0,12,12,15,17,32,51,36,87,0.000333,0.145,14,6090,338.333333,435,128.090227,2,0
0,0,10,10,12,14,26,42,30,72,0.000333,0.112811,12,4061.179916,225.621106,338.43166,96.322519,2,0
0,0,12,12,15,17,32,51,36,87,0.000333,0.145,14,6090,338.333333,435,128.090227,2,0
0,0,10,10,12,14,26,42,30,72,0.000333,0.112811,12,4061.179916,225.621106,338.43166,96.322519,2,0
0,0,12,12,15,17,32,51,36,87,0.000333,0.145,14,6090,338.333333,435,128.090227,2,0
0,0,10,10,12,13,25,42,30,72,0.000333,0.111453,12,4012.291748,222.905097,334.357646,91.125266,2,0
0,0,12,12,15,17,32,51,36,87,0.000333,0.145,14,6090,338.333333,435,128.090227,2,0
0,0,13,13,13,15,28,53,44,97,0.000333,0.155438,12,5595.761129,310.875618,466.313427,106.709075,2,0
0,0,15,15,16,18,34,62,48,110,0.000333,0.18654,16,8953.934601,497.440811,559.620913,139.05865,2,0
0,0,13,13,13,15,28,53,44,97,0.000333,0.155438,12,5595.761129,310.875618,466.313427,106.709075,2,0
0,0,15,15,16,18,34,62,48,110,0.000333,0.18654,16,8953.934601,497.440811,559.620913,139.05865,2,0
0,0,13,13,13,19,32,52,53,105,0.000333,0.175,12,6300,350,525,128.816339,2,0
0,0,15,15,16,22,38,61,54,115,0.000333,0.201171,16,9656.186625,536.454812,603.511664,162.107496,2,0
0,0,13,13,13,19,32,52,53,105,0.000333,0.175,12,6300,350,525,128.816339,2,0
0,0,15,15,16,22,38,61,54,115,0.000333,0.201171,16,9656.186625,536.454812,603.511664,162.107496,2,0
0,0,15,15,17,25,42,60,57,117,0.000333,0.2103,16,10094.41822,560.801012,630.901138,185.583273,2,0
0,0,14,14,16,20,36,53,41,94,0.000333,0.161991,16,7775.567202,431.975956,485.97295,150.438562,3,0
0,0,12,12,16,19,35,45,33,78,0.000333,0.133361,8,3200.672603,177.815145,400.084075,144.710623,3,0
0,0,14,14,16,20,36,53,41,94,0.000333,0.161991,16,7775.567202,431.975956,485.97295,150.438562,3,0
0,0,12,12,16,18,34,45,33,78,0.000333,0.132274,8,3174.576813,176.365378,396.822102,139.05865,3,0
0,0,12,12,15,19,34,49,38,87,0.000333,0.147536,14,6196.529741,344.251652,442.609267,139.313982,3,0
0,0,10,10,15,17,32,41,30,71,0.000333,0.118333,7,2485,138.055556,355,128.090227,3,0
0,0,12,12,15,19,34,49,38,87,0.000333,0.147536,14,6196.529741,344.251652,442.609267,139.313982,3,0
0,0,10,10,15,17,32,41,30,71,0.000333,0.118333,7,2485,138.055556,355,128.090227,3,0
0,0,12,12,15,20,35,50,39,89,0.000333,0.152169,7,3195.54332,177.530184,456.506189,145.041921,3,0
0,0,10,10,15,18,33,42,31,73,0.000333,0.122747,7,2577.685395,143.204744,368.240771,133.662009,3,0
0,0,12,12,15,20,35,49,39,88,0.000333,0.150459,7,3159.638338,175.535463,451.376905,145.041921,3,0
0,0,10,10,15,18,33,41,31,72,0.000333,0.121065,7,2542.374636,141.243035,363.196377,133.662009,3,0
0,0,8,8,11,10,21,22,20,42,0.000333,0.061492,10,1844.773318,102.487407,184.477332,71.273029,2,0
0,0,8,8,13,12,25,26,19,45,0.000333,0.069658,6,1253.841171,69.657843,208.973529,91.125266,3,0
0,0,8,8,13,12,25,26,19,45,0.000333,0.069658,6,1253.841171,69.657843,208.973529,91.125266,3,0
0,0,7,7,13,19,32,31,33,64,0.000333,0.106667,6,1920,106.666667,320,128.816339,1,0
0,0,5,5,6,14,20,10,19,29,0.000333,0.041779,3,376.007744,20.889319,125.335915,68.812744,1,0
0,0,11,11,13,15,28,41,41,82,0.000333,0.131401,12,4730.437243,262.802069,394.203104,106.709075,1,0
0,0,10,10,11,15,26,35,36,71,0.000333,0.111244,10,3337.3122,185.406233,333.73122,96.657107,1,0
0,0,14,14,10,21,31,46,76,122,0.000333,0.201471,15,9066.179248,503.676625,604.41195,125.457947,1,0
0,0,14,14,11,22,33,47,79,126,0.000333,0.211865,15,9533.904886,529.661383,635.593659,136.161243,1,0
0,0,15,15,13,22,35,53,84,137,0.000333,0.234237,18,12648.81192,702.711773,702.711773,146.213212,1,0
0,0,12,12,10,20,30,40,61,101,0.000333,0.165199,15,7433.939252,412.996625,495.59595,119.657843,1,0
0,0,12,12,11,21,32,41,62,103,0.000333,0.171667,10,5150,286.111111,515,130.292414,1,0
0,0,13,13,13,21,34,47,67,114,0.000333,0.193324,18,10439.47375,579.970764,579.970764,140.344382,1,0
0,0,14,14,16,25,41,69,57,126,0.000333,0.225017,16,10800.82484,600.045825,675.051553,180.096405,2,0
0,0,13,13,14,22,36,55,73,128,0.000333,0.220583,21,13896.7584,772.042134,661.7504,151.410465,2,0
0,0,11,11,12,23,35,39,41,80,0.000333,0.136781,6,2462.055848,136.78088,410.342641,147.061475,2,0
0,0,8,8,11,17,28,24,26,50,0.000333,0.080123,5,1201.838731,66.768818,240.367746,107.540616,2,0
0,0,13,13,13,21,34,45,45,90,0.000333,0.152624,12,5494.459869,305.24777,457.871656,140.344382,3,0
0,0,8,8,12,11,23,25,19,44,0.000333,0.066346,6,1194.220356,66.345575,199.036726,81.073298,3,0
0,0,7,7,11,10,21,22,18,40,0.000333,0.058564,5,878.463485,48.803527,175.692697,71.273029,2,0
0,0,9,9,12,16,28,29,28,57,0.000333,0.09134,6,1644.115383,91.339744,274.019231,107.01955,2,0
0,0,5,5,11,11,22,21,17,38,0.000333,0.056486,5,847.292008,47.071778,169.458402,76.107496,2,0
0,0,9,9,12,14,26,30,28,58,0.000333,0.090875,12,3271.506044,181.750336,272.625504,96.322519,2,0
0,0,14,14,11,24,35,49,56,105,0.000333,0.179525,10,5385.747168,299.208176,538.574717,148.092848,3,0
0,0,15,15,11,24,35,50,58,108,0.000333,0.184654,10,5539.625658,307.756981,553.962566,148.092848,3,0
0,0,14,14,14,27,41,54,60,114,0.000333,0.203587,14,8550.652999,475.036278,610.760929,181.684931,4,0
0,0,15,15,14,27,41,55,62,117,0.000333,0.208945,14,8775.670184,487.537232,626.833585,181.684931,4,0
0,0,9,9,16,18,34,41,35,76,0.000333,0.128882,8,3093.177407,171.843189,386.647176,139.05865,2,0
0,0,11,11,14,15,29,49,33,82,0.000333,0.132785,14,5576.962182,309.831232,398.354442,111.906328,2,0
0,0,11,11,14,16,30,49,33,82,0.000333,0.134122,14,5633.110404,312.950578,402.365029,117.302969,2,0
0,0,12,12,15,18,33,49,35,84,0.000333,0.141243,7,2966.103742,164.783541,423.729106,133.662009,3,0
0,0,12,12,15,18,33,49,35,84,0.000333,0.141243,7,2966.103742,164.783541,423.729106,133.662009,3,0
0,0,8,8,14,21,35,36,33,69,0.000333,0.117974,7,2477.443697,137.635761,353.920528,145.541635,2,0
0,0,14,14,18,25,43,61,59,120,0.000333,0.217051,18,11720.73187,651.151771,651.151771,191.155055,2,0
0,0,14,14,16,21,37,64,42,106,0.000333,0.184067,16,8835.232908,490.846273,552.202057,156.238666,3,0
0,0,14,14,16,20,36,64,42,106,0.000333,0.182671,16,8768.192802,487.121822,548.01205,150.438562,3,0
0,0,12,12,12,13,25,31,27,58,0.000333,0.089781,12,3232.123908,179.562439,269.343659,91.125266,3,0
0,0,12,12,12,13,25,31,27,58,0.000333,0.089781,12,3232.123908,179.562439,269.343659,91.125266,3,0
0,0,11,11,12,12,24,30,26,56,0.000333,0.085586,12,3081.0948,171.171933,256.7579,86.0391,3,0
0,0,11,11,16,17,33,41,33,74,0.000333,0.124428,8,2986.281319,165.904518,373.285165,133.486868,3,0
0,0,11,11,16,17,33,41,33,74,0.000333,0.124428,8,2986.281319,165.904518,373.285165,133.486868,3,0
0,0,16,16,18,25,43,59,60,119,0.000333,0.215242,18,11623.05911,645.725506,645.725506,191.155055,3,0
0,0,16,16,18,25,43,59,60,119,0.000333,0.215242,18,11623.05911,645.725506,645.725506,191.155055,3,0
0,0,10,10,13,18,31,37,34,71,0.000333,0.117249,6,2110.487628,117.249313,351.747938,123.164366,2,0
0,0,9,9,13,16,29,34,28,62,0.000333,0.100398,6,1807.16893,100.398274,301.194822,112.105716,2,0
0,0,16,16,15,22,37,58,55,113,0.000333,0.196223,14,8241.355224,457.853068,588.66823,156.710855,2,0
0,0,21,21,18,21,39,83,58,141,0.000333,0.248414,18,13414.35083,745.241713,745.241713,167.297316,4,0
0,0,15,15,15,19,34,58,39,97,0.000333,0.164495,14,6908.774538,383.820808,493.483896,139.313982,3,0
0,0,15,15,15,19,34,58,39,97,0.000333,0.164495,14,6908.774538,383.820808,493.483896,139.313982,3,0
0,0,12,12,14,15,29,46,34,80,0.000333,0.129546,14,5440.938715,302.274373,388.63848,111.906328,2,0
0,0,20,20,18,19,37,76,55,131,0.000333,0.227479,18,12283.89104,682.438391,682.438391,155.769273,4,0
0,0,15,15,15,18,33,53,38,91,0.000333,0.153013,14,6426.558108,357.031006,459.039865,133.662009,3,0
0,0,20,20,18,19,37,76,55,131,0.000333,0.227479,18,12283.89104,682.438391,682.438391,155.769273,4,0
0,0,15,15,15,17,32,53,38,91,0.000333,0.151667,14,6370,353.888889,455,128.090227,3,0
0,0,20,20,13,23,36,70,85,155,0.000333,0.267113,18,14424.09075,801.338375,801.338375,152.147641,2,0
0,0,20,20,14,25,39,71,91,162,0.000333,0.285412,21,17980.93835,998.941019,856.235159,169.399374,2,0
0,0,10,10,9,16,25,37,61,98,0.000333,0.151699,12,5461.174879,303.398604,455.097907,92.529325,1,0
0,0,14,14,13,20,33,52,49,101,0.000333,0.169828,12,6113.805673,339.655871,509.483806,134.544278,2,0
0,0,14,14,14,22,36,53,49,102,0.000333,0.175777,14,7382.652902,410.147383,527.33235,151.410465,2,0
0,0,11,11,10,18,28,41,42,83,0.000333,0.133003,10,3990.104585,221.672477,399.010459,108.277931,1,0
0,0,10,10,12,15,27,51,33,84,0.000333,0.133137,12,4792.926602,266.2737,399.41055,101.622909,2,0
0,0,10,10,12,15,27,51,33,84,0.000333,0.133137,12,4792.926602,266.2737,399.41055,101.622909,2,0
0,0,17,17,17,19,36,58,53,111,0.000333,0.191287,16,9181.786803,510.099267,573.861675,150.197491,3,0
0,0,11,11,13,15,28,35,31,66,0.000333,0.105762,12,3807.425098,211.523617,317.285425,106.709075,2,0
0,0,13,13,17,13,30,49,40,89,0.000333,0.145571,24,10481.11831,582.284351,436.713263,117.592585,4,0
0,0,13,13,17,15,32,47,39,86,0.000333,0.143333,16,6880,382.222222,430,128.090227,3,0
0,0,12,12,16,13,29,46,38,84,0.000333,0.136023,16,6529.126457,362.729248,408.070404,112.105716,4,0
0,0,12,12,16,15,31,44,37,81,0.000333,0.133763,16,6420.638418,356.702134,401.289901,122.603359,3,0
0,0,12,12,16,13,29,44,36,80,0.000333,0.129546,16,6218.215674,345.456426,388.63848,112.105716,4,0
0,0,12,12,16,15,31,42,35,77,0.000333,0.127158,16,6103.569854,339.087214,381.473116,122.603359,3,0
0,0,7,7,11,11,22,25,22,47,0.000333,0.069864,10,2095.932861,116.440714,209.593286,76.107496,2,0
0,0,9,9,11,11,22,25,22,47,0.000333,0.069864,10,2095.932861,116.440714,209.593286,76.107496,2,0
0,0,7,7,15,20,35,39,32,71,0.000333,0.121393,7,2549.253659,141.625203,364.179094,145.041921,2,0
0,0,14,14,17,16,33,60,46,106,0.000333,0.178235,16,8555.292426,475.294024,534.705777,133.486868,2,0
0,0,12,12,15,20,35,61,42,103,0.000333,0.176105,14,7396.42611,410.912562,528.316151,145.041921,3,0
0,0,12,12,15,20,35,60,42,102,0.000333,0.174396,14,7324.616148,406.923119,523.186868,145.041921,3,0
0,0,13,13,16,17,33,58,43,101,0.000333,0.169828,16,8151.740897,452.874494,509.483806,133.486868,3,0
0,0,14,14,17,22,39,57,48,105,0.000333,0.184989,16,8879.475728,493.304207,554.967233,167.594364,2,0
0,0,17,17,13,21,34,56,68,124,0.000333,0.210282,18,11355.21706,630.845392,630.845392,140.344382,2,0
0,0,17,17,14,22,36,57,72,129,0.000333,0.222307,21,14005.32683,778.073713,666.920325,151.410465,2,0
0,0,20,20,14,23,37,71,82,153,0.000333,0.265682,21,16737.97366,929.887426,797.046365,157.344894,2,0
0,0,10,10,13,17,30,44,36,80,0.000333,0.13085,12,4710.614972,261.700832,392.551248,117.592585,2,0
0,0,16,16,14,21,35,59,54,113,0.000333,0.193203,14,8114.525733,450.806985,579.608981,145.541635,2,0
0,0,10,10,13,17,30,44,36,80,0.000333,0.13085,12,4710.614972,261.700832,392.551248,117.592585,2,0
0,0,13,13,14,20,34,45,44,89,0.000333,0.150928,14,6338.9787,352.165483,452.784193,139.741531,2,0
0,0,11,11,19,18,37,58,43,101,0.000333,0.175385,18,9470.786219,526.15479,526.15479,155.769273,2,0
0,0,22,22,22,24,46,88,89,177,0.000333,0.32589,33,32263.12539,1792.395855,977.670466,208.146596,3,0
0,0,20,20,19,23,42,79,82,161,0.000333,0.289388,27,23440.40384,1302.244658,868.163105,184.752548,2,0
0,0,16,16,15,18,33,71,46,117,0.000333,0.196731,14,8262.717568,459.039865,590.194112,133.662009,3,0
0,0,16,16,15,18,33,70,46,116,0.000333,0.19505,14,8192.09605,455.116447,585.149718,133.662009,3,0
0,0,12,12,15,19,34,62,39,101,0.000333,0.171278,14,7193.672458,399.64847,513.833747,139.313982,3,0
0,0,12,12,15,19,34,62,39,101,0.000333,0.171278,14,7193.672458,399.64847,513.833747,139.313982,3,0
0,0,10,10,13,12,25,32,26,58,0.000333,0.089781,12,3232.123908,179.562439,269.343659,91.125266,3,0
0,0,9,9,13,11,24,31,25,56,0.000333,0.085586,12,3081.0948,171.171933,256.7579,86.159464,3,0
0,0,9,9,13,12,25,31,25,56,0.000333,0.086685,12,3120.67136,173.370631,260.055947,91.125266,3,0
0,0,16,16,15,23,38,63,59,122,0.000333,0.213416,14,8963.460193,497.970011,640.247157,162.645284,2,0
0,0,11,11,15,21,36,42,40,82,0.000333,0.141311,7,2967.536951,164.863164,423.93385,150.842025,2,0
0,0,12,12,14,14,28,41,30,71,0.000333,0.113774,14,4778.510793,265.472822,341.322199,106.605938,5,0
0,0,12,12,14,16,30,39,29,68,0.000333,0.111223,7,2335.679924,129.759996,333.668561,117.302969,4,0
0,0,12,12,14,13,27,41,30,71,0.000333,0.112532,14,4726.358177,262.575454,337.597013,101.408685,5,0
0,0,12,12,14,15,29,39,29,68,0.000333,0.110114,7,2312.398954,128.466609,330.342708,111.906328,4,0
0,0,20,20,18,22,40,69,57,126,0.000333,0.223521,18,12070.13292,670.56294,670.56294,173.166146,4,0
0,0,12,12,14,18,32,41,30,71,0.000333,0.118333,7,2485,138.055556,355,128.361619,3,0
0,0,12,12,14,18,32,41,30,71,0.000333,0.118333,7,2485,138.055556,355,128.361619,3,0
0,0,16,16,18,18,36,55,48,103,0.000333,0.177501,18,9585.040953,532.502275,532.502275,150.1173,4,0
0,0,10,10,14,15,29,32,26,58,0.000333,0.093921,7,1972.340284,109.57446,281.762898,111.906328,3,0
0,0,16,16,17,20,37,56,49,105,0.000333,0.182331,16,8751.881654,486.215647,546.992603,155.92543,4,0
0,0,10,10,13,16,29,33,27,60,0.000333,0.09716,6,1748.873158,97.15962,291.47886,112.105716,3,0
0,0,16,16,17,20,37,55,49,104,0.000333,0.180594,16,8668.5304,481.585022,541.78315,155.92543,4,0
0,0,10,10,13,16,29,32,27,59,0.000333,0.09554,6,1719.725272,95.540293,286.620879,112.105716,3,0
0,0,16,16,16,18,34,67,45,112,0.000333,0.189932,16,9116.733412,506.48519,569.795838,139.05865,3,0
0,0,11,11,14,15,29,45,33,78,0.000333,0.126308,14,5304.915247,294.717514,378.922518,111.906328,2,0
0,0,16,16,16,18,34,67,45,112,0.000333,0.189932,16,9116.733412,506.48519,569.795838,139.05865,3,0
0,0,11,11,14,15,29,45,33,78,0.000333,0.126308,14,5304.915247,294.717514,378.922518,111.906328,2,0
0,0,15,15,13,21,34,48,65,113,0.000333,0.191628,18,10347.89942,574.883301,574.883301,140.344382,2,0
0,0,15,15,14,23,37,50,70,120,0.000333,0.208378,21,13127.82248,729.323471,625.134404,157.344894,2,0
0,0,17,17,14,25,39,58,78,136,0.000333,0.239605,21,15095.10874,838.617152,718.814702,169.399374,2,0
0,0,3,3,8,8,16,13,11,24,0.000333,0.032,4,384,21.333333,96,48,1,0
0,0,7,7,11,12,23,33,23,56,0.000333,0.08444,5,1266.597348,70.366519,253.31947,81.073298,1,0
0,0,15,15,14,21,35,70,50,120,0.000333,0.205171,14,8617.195468,478.733082,615.513962,145.541635,5,0
0,0,6,6,11,13,24,17,18,35,0.000333,0.053491,5,802.368438,44.576024,160.473688,86.159464,2,0
0,0,13,13,12,20,32,55,49,104,0.000333,0.173333,12,6240,346.666667,520,129.458112,1,0
0,0,7,7,9,12,21,21,21,42,0.000333,0.061492,4,737.909327,40.994963,184.477332,71.548875,1,0
0,0,12,12,14,21,35,59,54,113,0.000333,0.193203,14,8114.525733,450.806985,579.608981,145.541635,1,0
0,0,4,4,12,14,26,25,21,46,0.000333,0.072073,6,1297.321362,72.073409,216.220227,96.322519,1,0
0,0,4,4,12,12,24,22,22,44,0.000333,0.067246,6,1210.4301,67.246117,201.73835,86.0391,1,0
0,0,6,6,9,12,21,26,21,47,0.000333,0.068813,4,825.755675,45.875315,206.438919,71.548875,1,0
0,0,5,5,9,11,20,23,18,41,0.000333,0.059066,4,708.796208,39.377567,177.199052,66.583073,1,0
0,0,3,3,7,8,15,13,11,24,0.000333,0.031255,3,281.296123,15.627562,93.765374,43.651484,1,0
0,0,17,17,15,16,31,69,51,120,0.000333,0.198168,21,12484.5747,693.587483,594.503557,122.603359,2,0
0,0,13,13,14,16,30,49,37,86,0.000333,0.140664,14,5907.896277,328.21646,421.992591,117.302969,2,0
0,0,12,12,14,16,30,47,35,82,0.000333,0.134122,14,5633.110404,312.950578,402.365029,117.302969,2,0
0,0,17,17,14,16,30,66,51,117,0.000333,0.191369,21,12056.23019,669.790566,574.1062,117.302969,2,0
0,0,14,14,14,16,30,52,41,93,0.000333,0.152114,14,6388.771555,354.931753,456.340825,117.302969,2,0
0,0,13,13,14,16,30,50,39,89,0.000333,0.145571,14,6113.985682,339.665871,436.713263,117.302969,2,0
0,0,17,17,14,19,33,66,57,123,0.000333,0.20682,21,13029.67001,723.870556,620.460477,134.013592,2,0
0,0,10,10,13,16,29,44,35,79,0.000333,0.127927,12,4605.365983,255.853666,383.780499,112.105716,2,0
0,0,14,14,14,19,33,52,47,99,0.000333,0.166465,14,6991.530249,388.418347,499.395018,134.013592,2,0
0,0,13,13,14,19,33,50,45,95,0.000333,0.159739,14,6709.044179,372.724677,479.217441,134.013592,2,0
0,0,11,11,11,17,28,39,40,79,0.000333,0.126594,10,3797.810388,210.989466,379.781039,107.540616,1,0
0,0,5,5,10,13,23,24,22,46,0.000333,0.069361,5,1040.41925,57.801069,208.08385,81.324997,1,0
0,0,12,12,13,19,32,41,40,81,0.000333,0.135,12,4860,270,405,128.816339,2,0
0,0,12,12,15,19,34,63,40,103,0.000333,0.17467,14,7336.121417,407.562301,524.008673,139.313982,3,0
0,0,12,12,15,19,34,62,40,102,0.000333,0.172974,14,7264.896937,403.605385,518.92121,139.313982,3,0
0,0,12,12,15,19,34,62,39,101,0.000333,0.171278,14,7193.672458,399.64847,513.833747,139.313982,3,0
0,0,12,12,15,19,34,62,39,101,0.000333,0.171278,14,7193.672458,399.64847,513.833747,139.313982,3,0
0,0,12,12,15,20,35,63,40,103,0.000333,0.176105,14,7396.42611,410.912562,528.316151,145.041921,3,0
0,0,12,12,15,20,35,62,40,102,0.000333,0.174396,14,7324.616148,406.923119,523.186868,145.041921,3,0
2,0,10,12,15,17,32,45,31,76,0.000333,0.126667,7,2660,147.777778,380,128.090227,3,0
0,0,7,7,12,12,24,29,25,54,0.000333,0.082529,12,2971.0557,165.05865,247.587975,86.0391,2,0
0,0,9,9,12,11,23,27,22,49,0.000333,0.073885,12,2659.85443,147.769691,221.654536,81.073298,3,0
0,0,9,9,12,10,22,27,22,49,0.000333,0.072837,12,2622.145792,145.674766,218.512149,76.238831,3,0
0,0,12,12,13,13,26,35,30,65,0.000333,0.101843,12,3666.34298,203.685721,305.528582,96.211433,3,0
0,0,12,12,13,13,26,35,30,65,0.000333,0.101843,12,3666.34298,203.685721,305.528582,96.211433,3,0
0,0,9,9,12,14,26,31,25,56,0.000333,0.087742,6,1579.347745,87.741541,263.224624,96.322519,2,0
0,0,11,11,14,16,30,39,30,69,0.000333,0.112858,7,2370.028158,131.668231,338.575451,117.302969,2,0
0,0,9,9,11,14,25,30,25,55,0.000333,0.085137,5,1277.060452,70.947803,255.41209,91.356717,2,0
0,0,11,11,14,16,30,39,30,69,0.000333,0.112858,7,2370.028158,131.668231,338.575451,117.302969,2,0
0,0,9,9,12,14,26,31,25,56,0.000333,0.087742,6,1579.347745,87.741541,263.224624,96.322519,2,0
0,0,11,11,14,16,30,39,30,69,0.000333,0.112858,7,2370.028158,131.668231,338.575451,117.302969,2,0
0,0,9,9,11,14,25,30,25,55,0.000333,0.085137,5,1277.060452,70.947803,255.41209,91.356717,2,0
0,0,11,11,14,16,30,39,30,69,0.000333,0.112858,7,2370.028158,131.668231,338.575451,117.302969,2,0
0,0,9,9,12,13,25,31,25,56,0.000333,0.086685,6,1560.33568,86.685316,260.055947,91.125266,2,0
0,0,9,9,11,13,24,30,25,55,0.000333,0.084058,5,1260.864688,70.048038,252.172938,86.159464,2,0
0,0,11,11,12,15,27,34,27,61,0.000333,0.096683,6,1740.288826,96.682713,290.048138,101.622909,2,0
0,0,11,11,12,14,26,34,27,61,0.000333,0.095576,6,1720.360937,95.575608,286.726823,96.322519,2,0
0,0,23,23,17,46,63,104,83,187,0.000333,0.372584,8,8942.010766,496.778376,1117.751346,323.570718,9,0
0,0,22,22,17,46,63,103,81,184,0.000333,0.366607,8,8798.556047,488.808669,1099.819506,323.570718,9,0
0,0,8,8,13,16,29,31,29,60,0.000333,0.09716,6,1748.873158,97.15962,291.47886,112.105716,3,0
0,0,8,8,13,18,31,29,28,57,0.000333,0.09413,6,1694.335138,94.12973,282.38919,123.164366,2,0
0,0,8,8,15,16,31,35,31,66,0.000333,0.108992,7,2288.838695,127.157705,326.976956,122.603359,4,0
0,0,8,8,15,18,33,33,30,63,0.000333,0.105932,7,2224.577807,123.587656,317.79683,133.662009,3,0
0,0,23,23,18,48,66,105,82,187,0.000333,0.376767,9,10172.7153,565.15085,1130.3017,343.13685,9,0
0,0,22,22,18,48,66,104,80,184,0.000333,0.370723,9,10009.51666,556.084259,1112.168518,343.13685,9,0
0,0,19,19,16,22,38,93,67,160,0.000333,0.279889,24,20152.04165,1119.55787,839.668402,162.107496,2,0
0,0,10,10,14,17,31,47,35,82,0.000333,0.135415,14,5687.417364,315.967631,406.244097,122.789837,2,0
0,0,13,13,15,17,32,43,44,87,0.000333,0.145,14,6090,338.333333,435,128.090227,3,0
0,0,13,13,15,19,34,41,43,84,0.000333,0.142449,14,5982.856301,332.380906,427.346879,139.313982,2,0
0,0,32,32,26,52,78,146,115,261,0.000333,0.54683,26,42652.73946,2369.596637,1640.489979,418.634298,12,0
0,0,32,32,25,54,79,144,114,258,0.000333,0.542125,24,39033.01039,2168.500577,1626.375433,426.86033,11,0
0,0,26,26,18,46,64,113,94,207,0.000333,0.414,18,22356,1242,1242,329.1425,9,0
0,0,22,22,18,44,62,105,79,184,0.000333,0.365191,9,9860.14909,547.786061,1095.572121,315.273641,9,0
0,0,26,26,19,48,67,114,94,208,0.000333,0.420582,9,11355.71897,630.873276,1261.746552,348.788823,9,0
0,0,22,22,18,45,63,105,80,185,0.000333,0.368599,9,9952.171073,552.898393,1105.796786,322.192039,9,0
0,0,7,7,12,9,21,24,18,42,0.000333,0.061492,12,2213.727981,122.984888,184.477332,71.548875,3,0
0,0,11,11,14,20,34,52,50,102,0.000333,0.172974,14,7264.896937,403.605385,518.92121,139.741531,1,0
0,0,9,9,13,14,27,45,30,75,0.000333,0.118872,12,4279.398752,237.744375,356.616563,101.408685,2,0
0,0,9,9,12,14,26,44,30,74,0.000333,0.115944,12,4173.99047,231.888359,347.832539,96.322519,2,0
0,0,4,4,12,9,21,19,14,33,0.000333,0.048315,6,869.67885,48.315492,144.946475,71.548875,2,0
0,0,3,3,11,9,20,15,12,27,0.000333,0.038897,5,583.460293,32.414461,116.692059,66.583073,2,0
0,0,4,4,12,9,21,19,14,33,0.000333,0.048315,6,869.67885,48.315492,144.946475,71.548875,2,0
0,0,3,3,11,9,20,15,12,27,0.000333,0.038897,5,583.460293,32.414461,116.692059,66.583073,2,0
0,0,4,4,12,9,21,19,14,33,0.000333,0.048315,6,869.67885,48.315492,144.946475,71.548875,2,0
0,0,3,3,11,9,20,15,12,27,0.000333,0.038897,5,583.460293,32.414461,116.692059,66.583073,2,0
0,0,17,17,21,23,44,82,56,138,0.000333,0.251134,20,15068.03127,837.112848,753.401563,196.280591,3,0
0,0,14,14,20,20,40,71,50,121,0.000333,0.214651,20,12879.06599,715.503666,643.953299,172.877124,3,0
0,0,10,10,19,17,36,52,39,91,0.000333,0.156821,18,8468.337152,470.463175,470.463175,150.197491,2,0
0,0,14,14,21,21,42,72,51,123,0.000333,0.221085,20,13265.10086,736.950048,663.255043,184.477332,3,0
0,0,14,14,20,21,41,71,51,122,0.000333,0.217874,20,13072.42689,726.245938,653.621345,178.677228,3,0
0,0,18,18,13,22,35,56,80,136,0.000333,0.232527,18,12556.48483,697.58249,697.58249,146.213212,2,0
0,0,18,18,14,23,37,57,86,143,0.000333,0.248317,21,15643.98846,869.11047,744.951831,157.344894,2,0
0,0,15,15,13,21,34,53,78,131,0.000333,0.222153,18,11996.23738,666.457632,666.457632,140.344382,2,0
0,0,13,13,13,21,34,45,47,92,0.000333,0.156016,12,5616.558977,312.031054,468.046581,140.344382,2,0
0,0,8,8,7,15,22,21,26,47,0.000333,0.069864,3,628.779858,34.932214,209.593286,78.254843,1,0
0,0,13,13,14,22,36,46,47,93,0.000333,0.160268,14,6731.242352,373.957908,480.803025,151.410465,2,0
0,0,8,8,8,17,25,22,25,47,0.000333,0.072754,4,873.044964,48.502498,218.261241,93.486868,1,0
0,0,18,18,14,25,39,64,65,129,0.000333,0.227272,14,9545.436407,530.302023,681.816886,169.399374,2,0
0,0,15,15,14,24,38,53,53,106,0.000333,0.185427,14,7787.92443,432.662468,556.280316,163.342069,2,0
0,0,10,10,14,15,29,47,32,79,0.000333,0.127927,14,5372.926981,298.495943,383.780499,111.906328,2,0
0,0,10,10,14,15,29,47,32,79,0.000333,0.127927,14,5372.926981,298.495943,383.780499,111.906328,2,0
0,0,10,10,15,16,31,48,33,81,0.000333,0.133763,14,5618.058616,312.114368,401.289901,122.603359,2,0
0,0,10,10,14,16,30,47,33,80,0.000333,0.13085,14,5495.717467,305.317637,392.551248,117.302969,2,0
0,0,13,13,16,22,38,56,60,116,0.000333,0.20292,16,9740.153465,541.119637,608.759592,162.107496,2,0
0,0,15,15,15,17,32,68,44,112,0.000333,0.186667,14,7840,435.555556,560,128.090227,3,0
0,0,15,15,15,17,32,68,44,112,0.000333,0.186667,14,7840,435.555556,560,128.090227,3,0
0,0,12,12,17,20,37,55,43,98,0.000333,0.170175,16,8168.422877,453.801271,510.52643,155.92543,3,0
0,0,10,10,14,18,32,46,36,82,0.000333,0.136667,14,5740,318.888889,410,128.361619,2,0
0,0,14,14,17,22,39,63,57,120,0.000333,0.211416,16,10147.97226,563.776237,634.248266,167.594364,3,0
0,0,12,12,17,20,37,59,48,107,0.000333,0.185804,16,8918.584162,495.476898,557.41151,155.92543,3,0
0,0,11,11,15,16,31,47,33,80,0.000333,0.132112,14,5548.699868,308.261104,396.335705,122.603359,2,0
0,0,12,12,15,17,32,50,34,84,0.000333,0.14,14,5880,326.666667,420,128.090227,3,0
0,0,12,12,15,16,31,50,34,84,0.000333,0.138717,14,5826.134861,323.674159,416.15249,122.603359,3,0
0,0,13,13,14,23,37,58,59,117,0.000333,0.203169,14,8533.084613,474.060256,609.506044,157.344894,1,0
0,0,13,13,16,18,34,66,43,109,0.000333,0.184844,16,8872.535195,492.918622,554.53345,139.05865,2,0
0,0,14,14,16,18,34,68,47,115,0.000333,0.195019,16,9360.931628,520.051757,585.058227,139.05865,2,0
0,0,7,7,9,12,21,20,24,44,0.000333,0.064421,8,1546.095733,85.894207,193.261967,71.548875,1,0
0,0,7,7,10,15,25,21,23,44,0.000333,0.06811,5,1021.648362,56.758242,204.329672,91.82264,1,0
0,0,4,4,9,14,23,16,21,37,0.000333,0.055791,4,669.487169,37.193732,167.371792,81.832294,1,0
0,0,11,11,14,20,34,43,47,90,0.000333,0.152624,14,6410.20318,356.122399,457.871656,139.741531,1,0
0,0,13,13,15,21,36,51,42,93,0.000333,0.160268,14,6731.242352,373.957908,480.803025,150.842025,2,0
0,0,13,13,16,23,39,52,44,96,0.000333,0.169133,8,4059.188904,225.510495,507.398613,168.041925,2,0
0,0,3,3,10,11,21,15,18,33,0.000333,0.048315,5,724.732375,40.26291,144.946475,71.273029,1,0
0,0,6,6,11,10,21,23,18,41,0.000333,0.060028,5,900.425072,50.023615,180.085014,71.273029,2,0
0,0,15,15,15,22,37,56,54,110,0.000333,0.191013,14,8022.558183,445.697677,573.03987,156.710855,2,0
0,0,8,8,12,13,25,36,24,60,0.000333,0.092877,6,1671.788228,92.877124,278.631371,91.125266,2,0
0,0,8,8,12,13,25,36,24,60,0.000333,0.092877,6,1671.788228,92.877124,278.631371,91.125266,2,0
0,0,10,10,13,15,28,41,27,68,0.000333,0.108967,6,1961.400808,108.966712,326.900135,106.709075,2,0
0,0,10,10,13,14,27,41,27,68,0.000333,0.107777,6,1939.994101,107.77745,323.33235,101.408685,2,0
0,0,16,16,15,16,31,66,46,112,0.000333,0.184957,14,7768.179815,431.565545,554.869987,122.603359,3,0
0,0,13,13,15,16,31,52,36,88,0.000333,0.145323,14,6103.569854,339.087214,435.969275,122.603359,3,0
0,0,16,16,15,16,31,66,46,112,0.000333,0.184957,14,7768.179815,431.565545,554.869987,122.603359,3,0
0,0,13,13,15,16,31,52,36,88,0.000333,0.145323,14,6103.569854,339.087214,435.969275,122.603359,3,0
0,0,16,16,15,18,33,73,50,123,0.000333,0.20682,14,8686.446674,482.580371,620.460477,133.662009,3,0
0,0,16,16,15,18,33,72,50,122,0.000333,0.205139,14,8615.825156,478.656953,615.416083,133.662009,3,0
0,0,10,10,13,14,27,43,31,74,0.000333,0.117287,12,4222.340102,234.57445,351.861675,101.408685,2,0
0,0,10,10,12,14,26,42,31,73,0.000333,0.114377,12,4117.585193,228.754733,343.132099,96.322519,2,0
0,0,10,10,12,14,26,42,30,72,0.000333,0.112811,12,4061.179916,225.621106,338.43166,96.322519,2,0
0,0,10,10,12,14,26,42,30,72,0.000333,0.112811,12,4061.179916,225.621106,338.43166,96.322519,2,0
0,0,16,16,15,17,32,72,49,121,0.000333,0.201667,14,8470,470.555556,605,128.090227,3,0
0,0,16,16,15,17,32,72,49,121,0.000333,0.201667,14,8470,470.555556,605,128.090227,3,0
0,0,10,10,13,15,28,43,31,74,0.000333,0.118581,12,4268.931171,237.162843,355.744264,106.709075,2,0
0,0,12,12,15,17,32,51,36,87,0.000333,0.145,14,6090,338.333333,435,128.090227,2,0
0,0,10,10,12,15,27,42,31,73,0.000333,0.115702,12,4165.281452,231.404525,347.106788,101.622909,2,0
0,0,12,12,15,17,32,51,36,87,0.000333,0.145,14,6090,338.333333,435,128.090227,2,0
0,0,11,11,11,15,26,50,37,87,0.000333,0.136313,10,4089.382555,227.18792,408.938255,96.657107,1,0
0,0,13,13,13,16,29,58,46,104,0.000333,0.16841,12,6062.760282,336.820016,505.230023,112.105716,2,0
0,0,13,13,13,16,29,58,46,104,0.000333,0.16841,12,6062.760282,336.820016,505.230023,112.105716,2,0
0,0,9,9,11,14,25,44,31,75,0.000333,0.116096,10,3482.892142,193.494008,348.289214,91.356717,1,0
0,0,11,11,14,17,31,53,38,91,0.000333,0.150277,14,6311.646099,350.647006,450.831864,122.789837,2,0
0,0,15,15,14,22,36,50,53,103,0.000333,0.177501,14,7455.031852,414.168436,532.502275,151.410465,2,0
0,0,15,15,15,23,38,51,53,104,0.000333,0.181928,14,7640.98246,424.499026,545.784461,162.645284,2,0
0,0,21,21,18,25,43,75,75,150,0.000333,0.271313,27,21976.37226,1220.90957,813.939713,191.155055,3,0
0,0,10,10,13,19,32,43,38,81,0.000333,0.135,12,4860,270,405,128.816339,2,0
0,0,15,15,14,21,35,59,50,109,0.000333,0.186364,14,7827.285884,434.849216,559.091849,145.541635,2,0
0,0,15,15,15,22,37,60,50,110,0.000333,0.191013,14,8022.558183,445.697677,573.03987,156.710855,2,0
0,0,20,20,18,24,42,83,67,150,0.000333,0.269616,18,14559.25704,808.847613,808.847613,185.09775,3,0
0,0,10,10,13,18,31,44,35,79,0.000333,0.130461,6,2348.289051,130.460503,391.381509,123.164366,2,0
0,0,14,14,14,20,34,50,46,96,0.000333,0.162799,14,6837.550059,379.863892,488.396433,139.741531,2,0
0,0,14,14,15,21,36,51,46,97,0.000333,0.167161,14,7020.758152,390.04212,501.482725,150.842025,2,0
0,0,19,19,18,23,41,74,63,137,0.000333,0.244662,18,13211.72324,733.984625,733.984625,179.100575,3,0
0,0,10,10,13,18,31,45,35,80,0.000333,0.132112,6,2378.014229,132.111902,396.335705,123.164366,2,0
0,0,15,15,14,15,29,60,45,105,0.000333,0.170029,21,10711.84809,595.102672,510.088004,111.906328,2,0
0,0,12,12,14,15,29,46,35,81,0.000333,0.131165,14,5508.950448,306.052803,393.496461,111.906328,2,0
0,0,11,11,14,15,29,44,33,77,0.000333,0.124688,14,5236.903513,290.939084,374.064537,111.906328,2,0
0,0,18,18,15,18,33,68,49,117,0.000333,0.196731,14,8262.717568,459.039865,590.194112,133.662009,3,0
0,0,15,15,15,18,33,54,39,93,0.000333,0.156376,14,6567.801143,364.877841,469.128653,133.662009,3,0
0,0,11,11,14,15,29,44,33,77,0.000333,0.124688,14,5236.903513,290.939084,374.064537,111.906328,2,0
0,0,18,18,15,17,32,68,49,117,0.000333,0.195,14,8190,455,585,128.090227,3,0
0,0,15,15,15,17,32,54,39,93,0.000333,0.155,14,6510,361.666667,465,128.090227,3,0
0,0,11,11,14,15,29,44,33,77,0.000333,0.124688,14,5236.903513,290.939084,374.064537,111.906328,2,0
0,0,5,5,11,15,26,20,22,42,0.000333,0.065806,5,987.092341,54.838463,197.418468,96.657107,2,0
0,0,17,17,18,22,40,60,50,110,0.000333,0.195137,18,10537.41763,585.41209,585.41209,173.166146,4,0
0,0,12,12,15,18,33,37,30,67,0.000333,0.112658,7,2365.820842,131.434491,337.974406,133.662009,3,0
0,0,17,17,18,22,40,60,50,110,0.000333,0.195137,18,10537.41763,585.41209,585.41209,173.166146,4,0
0,0,12,12,15,17,32,37,30,67,0.000333,0.111667,7,2345,130.277778,335,128.090227,3,0
0,0,5,5,11,15,26,20,22,42,0.000333,0.065806,5,987.092341,54.838463,197.418468,96.657107,2,0
0,0,19,19,18,24,42,70,56,126,0.000333,0.226477,18,12229.77592,679.431995,679.431995,185.09775,4,0
0,0,12,12,15,19,34,42,31,73,0.000333,0.123795,7,2599.693512,144.427417,371.384787,139.313982,3,0
0,0,12,12,15,19,34,42,31,73,0.000333,0.123795,7,2599.693512,144.427417,371.384787,139.313982,3,0
0,0,5,5,11,15,26,20,22,42,0.000333,0.065806,5,987.092341,54.838463,197.418468,96.657107,2,0
0,0,15,15,17,22,39,57,48,105,0.000333,0.184989,16,8879.475728,493.304207,554.967233,167.594364,4,0
0,0,10,10,14,17,31,34,28,62,0.000333,0.102387,7,2150.121199,119.451178,307.160171,122.789837,3,0
0,0,15,15,17,22,39,56,48,104,0.000333,0.183227,16,8794.909292,488.606072,549.681831,167.594364,4,0
0,0,10,10,14,17,31,33,28,61,0.000333,0.100735,7,2115.441825,117.524546,302.205975,122.789837,3,0
0,0,5,5,11,15,26,20,22,42,0.000333,0.065806,5,987.092341,54.838463,197.418468,96.657107,2,0
0,0,15,15,18,21,39,56,47,103,0.000333,0.181465,18,9799.135714,544.396429,544.396429,167.297316,4,0
0,0,10,10,15,16,31,33,27,60,0.000333,0.099084,7,2080.76245,115.597914,297.251779,122.603359,3,0
0,0,15,15,18,21,39,56,47,103,0.000333,0.181465,18,9799.135714,544.396429,544.396429,167.297316,4,0
0,0,10,10,15,16,31,33,27,60,0.000333,0.099084,7,2080.76245,115.597914,297.251779,122.603359,3,0
0,0,5,5,11,15,26,20,22,42,0.000333,0.065806,5,987.092341,54.838463,197.418468,96.657107,2,0
0,0,15,15,18,20,38,56,47,103,0.000333,0.180179,18,9729.65761,540.536534,540.536534,161.497212,4,0
0,0,10,10,15,15,30,33,27,60,0.000333,0.098138,7,2060.89405,114.494114,294.413436,117.206718,3,0
0,0,10,10,13,13,26,45,30,75,0.000333,0.117511,12,4230.395746,235.021986,352.532979,96.211433,2,0
0,0,10,10,13,13,26,45,30,75,0.000333,0.117511,12,4230.395746,235.021986,352.532979,96.211433,2,0
0,0,3,3,9,7,16,14,11,25,0.000333,0.033333,4,400,22.222222,100,48.180809,1,0
0,0,13,13,13,21,34,45,69,114,0.000333,0.193324,18,10439.47375,579.970764,579.970764,140.344382,2,0
0,0,15,15,16,25,41,68,57,125,0.000333,0.223231,16,10715.10401,595.283556,669.694001,180.096405,2,0
0,0,7,7,13,18,31,27,27,54,0.000333,0.089176,6,1605.159605,89.175534,267.526601,123.164366,2,0
0,0,29,29,22,50,72,133,95,228,0.000333,0.468914,11,15474.1719,859.676217,1406.7429,380.300305,12,0
0,0,28,28,22,50,72,132,93,225,0.000333,0.462744,11,15270.56438,848.364688,1388.233125,380.300305,12,0
0,0,29,29,22,50,72,133,95,228,0.000333,0.468914,11,15474.1719,859.676217,1406.7429,380.300305,12,0
0,0,28,28,22,50,72,132,93,225,0.000333,0.462744,11,15270.56438,848.364688,1388.233125,380.300305,12,0
0,0,5,5,11,17,28,22,27,49,0.000333,0.07852,5,1177.801956,65.433442,235.560391,107.540616,2,0
0,0,19,19,19,28,47,77,75,152,0.000333,0.281433,18,15197.3551,844.297505,844.297505,215.316561,3,0
0,0,5,5,11,18,29,22,28,50,0.000333,0.080966,5,1214.495249,67.471958,242.89905,113.112398,2,0
0,0,14,14,13,13,26,38,34,72,0.000333,0.112811,12,4061.179916,225.621106,338.43166,96.211433,3,0
0,0,12,12,15,20,35,54,39,93,0.000333,0.159008,7,3339.163244,185.509069,477.023321,145.041921,3,0
0,0,12,12,15,20,35,53,39,92,0.000333,0.157298,7,3303.258263,183.514348,471.894038,145.041921,3,0
0,0,12,12,15,19,34,53,38,91,0.000333,0.15432,14,6481.42766,360.079314,462.959119,139.313982,3,0
0,0,12,12,15,19,34,53,38,91,0.000333,0.15432,14,6481.42766,360.079314,462.959119,139.313982,3,0
0,0,12,12,15,20,35,54,39,93,0.000333,0.159008,7,3339.163244,185.509069,477.023321,145.041921,3,0
0,0,12,12,15,20,35,53,39,92,0.000333,0.157298,7,3303.258263,183.514348,471.894038,145.041921,3,0
0,0,6,6,9,11,20,15,19,34,0.000333,0.048982,4,587.782221,32.654568,146.945555,66.583073,1,0
0,0,6,6,11,13,24,17,18,35,0.000333,0.053491,5,802.368438,44.576024,160.473688,86.159464,2,0
0,0,10,10,13,17,30,32,29,61,0.000333,0.099773,6,1795.921958,99.773442,299.320326,117.592585,2,0
0,0,10,10,15,18,33,34,31,65,0.000333,0.109295,7,2295.199324,127.511074,327.885618,133.662009,3,0
0,0,18,18,16,20,36,67,59,126,0.000333,0.217137,16,10422.5688,579.0316,651.41055,150.438562,3,0
0,0,18,18,16,20,36,67,59,126,0.000333,0.217137,16,10422.5688,579.0316,651.41055,150.438562,3,0
0,0,8,8,12,10,22,29,22,51,0.000333,0.07581,12,2729.172151,151.620675,227.431013,76.238831,3,0
0,0,9,9,11,10,21,25,22,47,0.000333,0.068813,10,2064.389189,114.688288,206.438919,71.273029,2,0
0,0,9,9,11,11,22,25,22,47,0.000333,0.069864,10,2095.932861,116.440714,209.593286,76.107496,2,0
0,0,10,10,12,12,24,28,23,51,0.000333,0.077944,6,1402.998525,77.944363,233.833088,86.0391,3,0
0,0,12,12,15,12,27,41,30,71,0.000333,0.112532,14,4726.358177,262.575454,337.597013,101.622909,5,0
0,0,12,12,15,14,29,39,29,68,0.000333,0.110114,14,4624.797907,256.933217,330.342708,111.906328,4,0
0,0,17,17,18,19,37,81,55,136,0.000333,0.236162,18,12752.74184,708.485658,708.485658,155.769273,3,0
0,0,16,16,15,14,29,51,36,87,0.000333,0.140881,14,5917.020852,328.723381,422.644347,111.906328,5,0
0,0,16,16,15,16,31,49,35,84,0.000333,0.138717,14,5826.134861,323.674159,416.15249,122.603359,4,0
0,0,16,16,15,13,28,51,36,87,0.000333,0.139413,14,5855.358295,325.297683,418.239878,106.709075,5,0
0,0,16,16,15,15,30,49,35,84,0.000333,0.137393,14,5770.50334,320.583519,412.17881,117.206718,4,0
0,0,12,12,14,14,28,41,30,71,0.000333,0.113774,14,4778.510793,265.472822,341.322199,106.605938,5,0
0,0,12,12,14,16,30,39,29,68,0.000333,0.111223,7,2335.679924,129.759996,333.668561,117.302969,4,0
0,0,12,12,14,13,27,41,30,71,0.000333,0.112532,14,4726.358177,262.575454,337.597013,101.408685,5,0
0,0,12,12,14,15,29,39,29,68,0.000333,0.110114,7,2312.398954,128.466609,330.342708,111.906328,4,0
0,0,12,12,15,14,29,42,32,74,0.000333,0.11983,14,5032.868311,279.603795,359.490594,111.906328,5,0
0,0,12,12,15,16,31,40,31,71,0.000333,0.117249,7,2462.235566,136.790865,351.747938,122.603359,4,0
0,0,12,12,14,14,28,41,32,73,0.000333,0.116979,14,4913.11673,272.950929,350.936909,106.605938,5,0
0,0,12,12,14,16,30,39,31,70,0.000333,0.114494,7,2404.376392,133.576466,343.482342,117.302969,4,0
0,0,4,4,10,12,22,18,21,39,0.000333,0.057973,5,869.589166,48.310509,173.917833,76.238831,1,0
0,0,8,8,14,15,29,42,27,69,0.000333,0.111734,7,2346.404821,130.355823,335.200689,111.906328,2,0
0,0,8,8,13,15,28,41,27,68,0.000333,0.108967,6,1961.400808,108.966712,326.900135,106.709075,2,0
0,0,8,8,14,15,29,42,27,69,0.000333,0.111734,7,2346.404821,130.355823,335.200689,111.906328,2,0
0,0,8,8,13,15,28,41,27,68,0.000333,0.108967,6,1961.400808,108.966712,326.900135,106.709075,2,0
0,0,16,16,16,20,36,60,48,108,0.000333,0.186117,16,8933.630402,496.3128,558.3519,150.438562,3,0
0,0,16,16,16,20,36,60,48,108,0.000333,0.186117,16,8933.630402,496.3128,558.3519,150.438562,3,0
0,0,9,9,14,19,33,36,36,72,0.000333,0.121065,7,2542.374636,141.243035,363.196377,134.013592,2,0
0,0,16,16,18,25,43,62,65,127,0.000333,0.229712,18,12404.44123,689.135624,689.135624,191.155055,2,0
0,0,14,14,15,19,34,55,45,100,0.000333,0.169582,14,7122.447978,395.691554,508.746284,139.313982,3,0
0,0,14,14,15,19,34,55,45,100,0.000333,0.169582,14,7122.447978,395.691554,508.746284,139.313982,3,0
0,0,16,16,15,17,32,73,50,123,0.000333,0.205,14,8610,478.333333,615,128.090227,3,0
0,0,16,16,15,17,32,72,50,122,0.000333,0.203333,14,8540,474.444444,610,128.090227,3,0
0,0,15,15,15,16,31,69,48,117,0.000333,0.193214,21,12172.46034,676.247796,579.640968,122.603359,2,0
0,0,10,10,14,14,28,42,31,73,0.000333,0.116979,14,4913.11673,272.950929,350.936909,106.605938,2,0
0,0,10,10,15,20,35,39,38,77,0.000333,0.131652,7,2764.683546,153.59353,394.954792,145.041921,2,0
0,0,5,5,6,12,18,10,16,26,0.000333,0.036139,3,325.25415,18.069675,108.41805,58.529325,1,0
0,0,15,15,15,22,37,52,55,107,0.000333,0.185804,14,7803.761142,433.542286,557.41151,156.710855,2,0
0,0,12,12,15,20,35,42,44,86,0.000333,0.147039,14,6175.656752,343.092042,441.118339,145.041921,2,0
0,0,11,11,11,19,30,50,45,95,0.000333,0.155385,10,4661.546066,258.974781,466.154607,118.764371,1,0
0,0,12,12,12,15,27,55,41,96,0.000333,0.152156,12,5477.630402,304.3128,456.4692,101.622909,1,0
0,0,12,12,18,18,36,54,45,99,0.000333,0.170608,18,9212.806353,511.822575,511.822575,150.1173,3,0
0,0,12,12,17,18,35,53,45,98,0.000333,0.167557,16,8042.715771,446.817543,502.669736,144.545518,3,0
0,0,16,16,15,22,37,71,57,128,0.000333,0.22227,14,9335.340431,518.630024,666.810031,156.710855,2,0
0,0,10,10,14,17,31,47,36,83,0.000333,0.137066,14,5756.776113,319.820895,411.198294,122.789837,2,0
0,0,11,11,15,19,34,48,38,86,0.000333,0.145841,14,6125.305261,340.294737,437.521804,139.313982,2,0
0,0,17,17,16,24,40,73,55,128,0.000333,0.227069,16,10899.30874,605.517152,681.206796,174.0391,2,0
0,0,5,5,12,16,28,23,24,47,0.000333,0.075315,6,1355.674088,75.315227,225.945681,107.01955,2,0
0,0,16,16,18,25,43,72,61,133,0.000333,0.240564,18,12990.47782,721.693212,721.693212,191.155055,3,0
0,0,5,5,12,17,29,23,25,48,0.000333,0.077728,6,1399.098527,77.727696,233.183088,112.506418,2,0
0,0,21,21,15,24,39,85,86,171,0.000333,0.301268,21,18979.87937,1054.437743,903.803779,168.642459,2,0
0,0,11,11,14,18,32,50,38,88,0.000333,0.146667,14,6160,342.222222,440,128.361619,2,0
0,0,12,12,15,18,33,51,36,87,0.000333,0.146287,14,6144.072037,341.337335,438.862288,133.662009,3,0
0,0,11,11,15,17,32,46,31,77,0.000333,0.128333,7,2695,149.722222,385,128.090227,3,0
0,0,12,12,15,18,33,51,36,87,0.000333,0.146287,14,6144.072037,341.337335,438.862288,133.662009,3,0
0,0,11,11,15,17,32,46,31,77,0.000333,0.128333,7,2695,149.722222,385,128.090227,3,0
0,0,13,13,18,19,37,57,42,99,0.000333,0.171912,18,9283.245898,515.735883,515.735883,155.769273,3,0
0,0,12,12,18,18,36,52,37,89,0.000333,0.153374,18,8282.219852,460.123325,460.123325,150.1173,3,0
0,0,7,7,15,18,33,35,33,68,0.000333,0.11434,7,2401.131601,133.3962,343.0188,133.662009,1,0
0,0,8,8,12,11,23,26,23,49,0.000333,0.073885,12,2659.85443,147.769691,221.654536,81.073298,2,0
0,0,8,8,12,12,24,30,25,55,0.000333,0.084058,12,3026.07525,168.115292,252.172938,86.0391,2,0
0,0,8,8,12,12,24,30,25,55,0.000333,0.084058,12,3026.07525,168.115292,252.172938,86.0391,2,0
0,0,9,9,12,12,24,29,25,54,0.000333,0.082529,12,2971.0557,165.05865,247.587975,86.0391,2,0
0,0,9,9,13,14,27,27,24,51,0.000333,0.080833,6,1454.995576,80.833088,242.499263,101.408685,2,0
0,0,9,9,13,14,27,27,24,51,0.000333,0.080833,6,1454.995576,80.833088,242.499263,101.408685,2,0
0,0,7,7,12,10,22,24,18,42,0.000333,0.062432,6,1123.776768,62.432043,187.296128,76.238831,3,0
0,0,17,17,17,23,40,69,59,128,0.000333,0.227069,16,10899.30874,605.517152,681.206796,173.528793,3,0
0,0,17,17,18,25,43,70,59,129,0.000333,0.233329,18,12599.78676,699.988153,699.988153,191.155055,3,0
0,0,15,15,14,22,36,60,55,115,0.000333,0.19818,14,8323.579252,462.42107,594.541375,151.410465,2,0
0,0,13,13,13,20,33,38,48,86,0.000333,0.144606,12,5205.814731,289.21193,433.817894,134.544278,2,0
0,0,13,13,15,23,38,40,49,89,0.000333,0.155689,14,6538.917682,363.273205,467.065549,162.645284,2,0
0,0,16,16,15,25,40,49,62,111,0.000333,0.196911,14,8270.276259,459.459792,590.734019,174.699764,2,0
0,0,12,12,14,18,32,45,35,80,0.000333,0.133333,7,2800,155.555556,400,128.361619,3,0
0,0,11,11,14,17,31,40,30,70,0.000333,0.115598,7,2427.556192,134.864233,346.793742,122.789837,3,0
0,0,12,12,14,18,32,45,35,80,0.000333,0.133333,7,2800,155.555556,400,128.361619,3,0
0,0,11,11,14,17,31,40,30,70,0.000333,0.115598,7,2427.556192,134.864233,346.793742,122.789837,3,0
0,0,12,12,14,19,33,46,36,82,0.000333,0.13788,7,2895.482225,160.860124,413.640318,134.013592,3,0
0,0,11,11,14,18,32,41,31,72,0.000333,0.12,7,2520,140,360,128.361619,3,0
0,0,12,12,14,19,33,45,36,81,0.000333,0.136199,7,2860.171466,158.898415,408.595924,134.013592,3,0
0,0,11,11,14,18,32,40,31,71,0.000333,0.118333,7,2485,138.055556,355,128.361619,3,0
0,0,10,10,13,17,30,38,40,78,0.000333,0.127579,12,4592.849597,255.158311,382.737466,117.592585,1,0
0,0,14,14,14,23,37,58,75,133,0.000333,0.230952,21,14550.00325,808.333514,692.857298,157.344894,2,0
0,0,17,17,15,25,40,74,80,154,0.000333,0.273192,21,17211.11546,956.173081,819.576927,174.699764,2,0
0,0,8,8,14,20,34,40,33,73,0.000333,0.123795,7,2599.693512,144.427417,371.384787,139.741531,2,0
0,0,6,6,9,11,20,15,19,34,0.000333,0.048982,4,587.782221,32.654568,146.945555,66.583073,1,0
0,0,6,6,11,13,24,17,18,35,0.000333,0.053491,5,802.368438,44.576024,160.473688,86.159464,2,0
0,0,19,19,16,25,41,65,68,133,0.000333,0.237518,16,11400.87067,633.381704,712.554417,180.096405,2,0
0,0,9,9,11,11,22,25,22,47,0.000333,0.069864,10,2095.932861,116.440714,209.593286,76.107496,2,0
0,0,9,9,11,11,22,25,22,47,0.000333,0.069864,10,2095.932861,116.440714,209.593286,76.107496,2,0
0,0,9,9,11,11,22,25,22,47,0.000333,0.069864,10,2095.932861,116.440714,209.593286,76.107496,2,0
0,0,9,9,11,11,22,25,22,47,0.000333,0.069864,10,2095.932861,116.440714,209.593286,76.107496,2,0
0,0,12,12,12,14,26,36,33,69,0.000333,0.10811,12,3891.964087,216.220227,324.330341,96.322519,2,0
0,0,12,12,12,14,26,36,33,69,0.000333,0.10811,12,3891.964087,216.220227,324.330341,96.322519,2,0
0,0,10,10,11,11,22,29,26,55,0.000333,0.081756,10,2452.68739,136.260411,245.268739,76.107496,2,0
0,0,9,9,10,17,27,35,35,70,0.000333,0.110947,10,3328.421252,184.912292,332.842125,102.706149,1,0
0,0,9,9,11,20,31,36,34,70,0.000333,0.115598,5,1733.968709,96.331595,346.793742,124.49231,1,0
0,0,18,18,18,29,47,79,69,148,0.000333,0.274026,18,14797.4247,822.07915,822.07915,215.940099,3,0
0,0,9,9,10,16,26,39,32,71,0.000333,0.111244,10,3337.3122,185.406233,333.73122,97.219281,1,0
0,0,9,9,11,17,28,39,31,70,0.000333,0.112172,5,1682.574223,93.476346,336.514845,107.540616,1,0
0,0,20,20,15,23,38,93,70,163,0.000333,0.285137,21,17963.65588,997.980882,855.412185,162.645284,2,0
0,0,10,10,14,17,31,49,35,84,0.000333,0.138717,14,5826.134861,323.674159,416.15249,122.789837,2,0
0,0,17,17,15,23,38,79,60,139,0.000333,0.243154,14,10212.46694,567.359275,729.461924,162.645284,2,0
0,0,18,18,16,21,37,84,63,147,0.000333,0.255263,24,18378.95147,1021.05286,765.789645,156.238666,2,0
0,0,10,10,14,17,31,48,35,83,0.000333,0.137066,14,5756.776113,319.820895,411.198294,122.789837,2,0
0,0,19,19,16,22,38,93,67,160,0.000333,0.279889,24,20152.04165,1119.55787,839.668402,162.107496,2,0
0,0,10,10,14,17,31,47,35,82,0.000333,0.135415,14,5687.417364,315.967631,406.244097,122.789837,2,0
0,0,9,9,12,14,26,48,30,78,0.000333,0.122211,12,4399.611576,244.422865,366.634298,96.322519,2,0
0,0,9,9,12,14,26,48,30,78,0.000333,0.122211,12,4399.611576,244.422865,366.634298,96.322519,2,0
0,0,9,9,12,14,26,48,30,78,0.000333,0.122211,12,4399.611576,244.422865,366.634298,96.322519,2,0
0,0,9,9,12,14,26,48,30,78,0.000333,0.122211,12,4399.611576,244.422865,366.634298,96.322519,2,0
0,0,32,32,19,51,70,129,130,259,0.000333,0.529161,18,28574.71743,1587.484301,1587.484301,370.004315,8,0
0,0,31,31,19,51,70,128,128,256,0.000333,0.523032,18,28243.73614,1569.096452,1569.096452,370.004315,8,0
0,0,32,32,22,53,75,134,138,272,0.000333,0.564746,22,37273.25104,2070.736169,1694.238684,401.68728,9,0
0,0,31,31,22,53,75,133,136,269,0.000333,0.558517,22,36862.14901,2047.897167,1675.552228,401.68728,9,0
0,0,13,13,12,17,29,45,69,114,0.000333,0.184603,24,13291.436,738.413111,553.809833,112.506418,3,0
0,0,13,13,12,19,31,43,68,111,0.000333,0.183305,18,9898.484228,549.91579,549.91579,123.730173,2,0
0,0,13,13,14,17,31,49,71,120,0.000333,0.198168,28,16646.0996,924.783311,594.503557,122.789837,4,0
0,0,13,13,14,19,33,47,70,117,0.000333,0.196731,21,12394.07635,688.559797,590.194112,134.013592,3,0
0,0,28,28,19,49,68,124,101,225,0.000333,0.45656,18,24654.22451,1369.679139,1369.679139,355.831405,8,0
0,0,27,27,19,49,68,123,99,222,0.000333,0.450472,18,24325.50151,1351.416751,1351.416751,355.831405,8,0
0,0,23,23,17,44,61,102,81,183,0.000333,0.361775,8,8682.599462,482.366637,1085.324933,309.70186,7,0
0,0,7,7,8,15,23,17,21,38,0.000333,0.057298,4,687.581417,38.198968,171.895354,82.603359,1,0
0,0,28,28,22,51,73,129,103,232,0.000333,0.47868,22,31592.86455,1755.159142,1436.039298,387.401188,9,0
0,0,27,27,22,51,73,128,101,229,0.000333,0.47249,11,15592.16806,866.231559,1417.469824,387.401188,9,0
0,0,23,23,18,46,64,103,80,183,0.000333,0.366,9,9882,549,1098,329.1425,7,0
0,0,15,15,14,20,34,53,52,105,0.000333,0.178061,14,7478.570377,415.476132,534.183598,139.741531,3,0
0,0,15,15,14,22,36,51,51,102,0.000333,0.175777,14,7382.652902,410.147383,527.33235,151.410465,2,0
0,0,31,31,25,50,75,143,113,256,0.000333,0.531526,24,38269.86203,2126.103446,1594.577585,398.289214,10,0
0,0,31,31,24,52,76,141,112,253,0.000333,0.526909,24,37937.41586,2107.634215,1580.725661,406.461965,9,0
0,0,14,14,12,21,33,45,47,92,0.000333,0.154695,12,5569.011108,309.389506,464.084259,135.258216,2,0
0,0,30,30,22,52,74,135,108,243,0.000333,0.502966,22,33195.73769,1844.20765,1508.897168,394.530361,9,0
0,0,28,28,19,51,70,120,104,224,0.000333,0.457653,18,24713.26912,1372.959396,1372.959396,370.004315,8,0
0,0,27,27,19,51,70,119,102,221,0.000333,0.451524,18,24382.28784,1354.571547,1354.571547,370.004315,8,0
0,0,28,28,22,53,75,125,106,231,0.000333,0.479619,22,31654.85659,1758.603144,1438.857118,401.68728,9,0
0,0,27,27,22,53,75,124,104,228,0.000333,0.47339,11,15621.87728,867.882071,1420.170661,401.68728,9,0
0,0,15,15,15,20,35,47,57,104,0.000333,0.177815,14,7468.236073,414.902004,533.445434,145.041921,3,0
0,0,15,15,15,22,37,45,56,101,0.000333,0.175385,14,7366.167059,409.231503,526.15479,156.710855,2,0
0,0,31,31,25,51,76,137,118,255,0.000333,0.531074,24,38237.31638,2124.295355,1593.221516,405.390097,10,0
0,0,31,31,24,53,77,135,117,252,0.000333,0.52641,24,37901.525,2105.640278,1579.230208,413.618884,9,0
0,0,9,9,14,15,29,34,27,61,0.000333,0.098779,7,2074.357885,115.242105,296.336841,111.906328,2,0
0,0,9,9,14,15,29,34,27,61,0.000333,0.098779,7,2074.357885,115.242105,296.336841,111.906328,2,0
0,0,9,9,14,15,29,34,27,61,0.000333,0.098779,7,2074.357885,115.242105,296.336841,111.906328,2,0
0,0,9,9,14,15,29,34,27,61,0.000333,0.098779,7,2074.357885,115.242105,296.336841,111.906328,2,0
0,0,11,11,14,16,30,49,33,82,0.000333,0.134122,14,5633.110404,312.950578,402.365029,117.302969,2,0
0,0,11,11,14,16,30,49,33,82,0.000333,0.134122,14,5633.110404,312.950578,402.365029,117.302969,2,0
0,0,16,16,20,19,39,77,56,133,0.000333,0.234319,20,14059.1699,781.064995,702.958495,167.149185,4,0
0,0,11,11,18,16,34,57,43,100,0.000333,0.169582,18,9157.433114,508.746284,508.746284,139.05865,3,0
0,0,16,16,20,19,39,77,56,133,0.000333,0.234319,20,14059.1699,781.064995,702.958495,167.149185,4,0
0,0,11,11,18,16,34,57,43,100,0.000333,0.169582,18,9157.433114,508.746284,508.746284,139.05865,3,0
0,0,16,16,20,19,39,77,56,133,0.000333,0.234319,20,14059.1699,781.064995,702.958495,167.149185,4,0
0,0,11,11,18,16,34,57,43,100,0.000333,0.169582,18,9157.433114,508.746284,508.746284,139.05865,3,0
0,0,16,16,21,20,41,78,57,135,0.000333,0.24109,20,14465.39041,803.632801,723.269521,178.677228,4,0
0,0,16,16,20,20,40,77,57,134,0.000333,0.237713,20,14262.76729,792.375961,713.138365,172.877124,4,0
0,0,18,18,21,20,41,81,59,140,0.000333,0.250019,20,15001.14561,833.396978,750.057281,178.677228,4,0
0,0,18,18,21,21,42,81,59,140,0.000333,0.251641,20,15098.48878,838.804932,754.924439,184.477332,4,0
0,0,16,16,20,19,39,77,56,133,0.000333,0.234319,20,14059.1699,781.064995,702.958495,167.149185,4,0
0,0,16,16,20,19,39,77,56,133,0.000333,0.234319,20,14059.1699,781.064995,702.958495,167.149185,4,0
0,0,14,14,15,18,33,49,42,91,0.000333,0.153013,14,6426.558108,357.031006,459.039865,133.662009,3,0
0,0,10,10,14,15,29,35,27,62,0.000333,0.100398,7,2108.363752,117.13132,301.194822,111.906328,3,0
0,0,14,14,15,18,33,49,42,91,0.000333,0.153013,14,6426.558108,357.031006,459.039865,133.662009,3,0
0,0,10,10,14,15,29,35,27,62,0.000333,0.100398,7,2108.363752,117.13132,301.194822,111.906328,3,0
0,0,14,14,15,19,34,50,43,93,0.000333,0.157711,14,6623.876619,367.993146,473.134044,139.313982,3,0
0,0,10,10,14,16,30,36,28,64,0.000333,0.10468,7,2198.286987,122.127055,314.040998,117.302969,3,0
0,0,14,14,15,19,34,49,43,92,0.000333,0.156016,14,6552.65214,364.03623,468.046581,139.313982,3,0
0,0,10,10,14,16,30,35,28,63,0.000333,0.103045,7,2163.938753,120.21882,309.134108,117.302969,3,0
0,0,13,13,15,17,32,46,41,87,0.000333,0.145,14,6090,338.333333,435,128.090227,2,0
0,0,9,9,14,14,28,32,26,58,0.000333,0.092942,7,1951.786098,108.432561,278.826585,106.605938,2,0
0,0,13,13,18,18,36,56,40,96,0.000333,0.165438,18,8933.630402,496.3128,496.3128,150.1173,3,0
0,0,13,13,17,18,35,55,40,95,0.000333,0.162427,16,7796.510186,433.139455,487.281887,144.545518,3,0
0,0,13,13,18,18,36,56,40,96,0.000333,0.165438,18,8933.630402,496.3128,496.3128,150.1173,3,0
0,0,13,13,17,18,35,55,40,95,0.000333,0.162427,16,7796.510186,433.139455,487.281887,144.545518,3,0
0,0,13,13,18,18,36,56,40,96,0.000333,0.165438,18,8933.630402,496.3128,496.3128,150.1173,3,0
0,0,13,13,17,18,35,55,40,95,0.000333,0.162427,16,7796.510186,433.139455,487.281887,144.545518,3,0
0,0,13,13,18,18,36,56,40,96,0.000333,0.165438,18,8933.630402,496.3128,496.3128,150.1173,3,0
0,0,13,13,17,18,35,55,40,95,0.000333,0.162427,16,7796.510186,433.139455,487.281887,144.545518,3,0
0,0,13,13,17,17,34,55,39,94,0.000333,0.159407,16,7651.544113,425.085784,478.221507,138.973737,3,0
0,0,13,13,17,17,34,55,39,94,0.000333,0.159407,16,7651.544113,425.085784,478.221507,138.973737,3,0
0,0,14,14,17,22,39,57,46,103,0.000333,0.181465,16,8710.342857,483.907936,544.396429,167.594364,3,0
0,0,11,11,14,15,29,45,32,77,0.000333,0.124688,14,5236.903513,290.939084,374.064537,111.906328,2,0
0,0,19,19,18,23,41,79,64,143,0.000333,0.255377,18,13790.33886,766.129937,766.129937,179.100575,3,0
0,0,11,11,13,18,31,47,37,84,0.000333,0.138717,12,4993.829881,277.434993,416.15249,123.164366,2,0
0,0,11,11,14,15,29,52,36,88,0.000333,0.142501,14,5985.032586,332.50181,427.502328,111.906328,1,0
0,0,11,11,14,16,30,53,46,99,0.000333,0.161927,14,6800.950366,377.830576,485.782169,117.302969,1,0
0,0,6,6,13,13,26,31,27,58,0.000333,0.090875,12,3271.506044,181.750336,272.625504,96.211433,1,0
0,0,15,15,15,17,32,61,41,102,0.000333,0.17,14,7140,396.666667,510,128.090227,3,0
0,0,15,15,15,17,32,61,41,102,0.000333,0.17,14,7140,396.666667,510,128.090227,3,0
0,0,14,14,16,25,41,64,50,114,0.000333,0.203587,16,9772.174856,542.898603,610.760929,180.096405,2,0
0,0,13,13,15,20,35,53,46,99,0.000333,0.169266,14,7109.186261,394.954792,507.799019,145.041921,2,0
0,0,13,13,16,22,38,55,47,102,0.000333,0.17843,16,8564.617702,475.812095,535.288606,162.107496,2,0
0,0,14,14,16,23,39,60,52,112,0.000333,0.197322,16,9471.440776,526.191154,591.965049,168.041925,2,0
0,0,18,18,14,22,36,65,79,144,0.000333,0.248156,21,15633.8532,868.5474,744.4692,151.410465,2,0
0,0,18,18,15,24,39,67,86,153,0.000333,0.269556,21,16981.99733,943.444296,808.666539,168.642459,2,0
0,0,13,13,14,21,35,56,72,128,0.000333,0.218849,21,13787.51275,765.972931,656.548226,145.541635,2,0
0,0,6,6,7,11,18,14,16,30,0.000333,0.041699,3,375.29325,20.849625,125.09775,57.705232,1,0
0,0,7,7,14,18,32,38,30,68,0.000333,0.113333,7,2380,132.222222,340,128.361619,2,0
0,0,6,6,5,11,16,13,19,32,0.000333,0.042667,2,256,14.222222,128,49.663388,1,0
0,0,6,6,7,14,21,15,19,34,0.000333,0.04978,3,448.016377,24.889799,149.338792,72.954453,1,0
0,0,8,8,14,20,34,38,35,73,0.000333,0.123795,7,2599.693512,144.427417,371.384787,139.741531,2,0
0,0,13,13,17,18,35,45,45,90,0.000333,0.153878,16,7386.167544,410.342641,461.635472,144.545518,3,0
0,0,13,13,16,20,36,43,44,87,0.000333,0.149928,16,7196.535602,399.807533,449.783475,150.438562,2,0
0,0,13,13,18,17,35,49,47,96,0.000333,0.164137,18,8863.401053,492.41117,492.41117,144.545518,4,0
0,0,13,13,18,19,37,47,46,93,0.000333,0.161493,18,8720.624934,484.479163,484.479163,155.769273,3,0
0,0,14,14,17,19,36,53,49,102,0.000333,0.175777,16,8437.317602,468.739867,527.33235,150.197491,3,0
0,0,14,14,16,21,37,51,48,99,0.000333,0.171912,16,8251.774131,458.431896,515.735883,156.238666,2,0
0,0,14,14,18,18,36,57,51,108,0.000333,0.186117,18,10050.3342,558.3519,558.3519,150.1173,4,0
0,0,14,14,18,20,38,55,50,105,0.000333,0.183677,18,9918.583,551.032389,551.032389,161.497212,3,0
0,0,33,33,19,54,73,137,128,265,0.000333,0.546768,18,29525.46315,1640.303508,1640.303508,391.474548,10,0
0,0,32,32,19,54,73,136,126,262,0.000333,0.540578,18,29191.21262,1621.734034,1621.734034,391.474548,10,0
0,0,33,33,22,56,78,142,134,276,0.000333,0.578257,22,38164.96227,2120.275682,1734.771012,423.319371,11,0
0,0,32,32,22,56,78,141,132,273,0.000333,0.571972,22,37750.12573,2097.229207,1715.914806,423.319371,11,0
0,0,16,16,14,19,33,50,70,120,0.000333,0.201776,21,12711.87318,706.215177,605.327294,134.013592,3,0
0,0,16,16,14,21,35,48,69,117,0.000333,0.200042,21,12602.64837,700.147132,600.126113,145.541635,2,0
0,0,35,35,25,54,79,153,141,294,0.000333,0.617771,24,44479.47696,2471.082053,1853.31154,426.86033,12,0
0,0,35,35,24,56,80,151,140,291,0.000333,0.613227,24,44152.34582,2452.908101,1839.681076,435.250976,11,0
0,0,15,15,15,16,31,56,41,97,0.000333,0.160186,14,6727.79859,373.766588,480.557042,122.603359,3,0
0,0,12,12,15,16,31,42,31,73,0.000333,0.120552,7,2531.594315,140.644129,361.656331,122.603359,3,0
0,0,10,10,14,15,29,37,28,65,0.000333,0.105256,7,2210.381353,122.798964,315.768765,111.906328,2,0
0,0,15,15,15,16,31,56,41,97,0.000333,0.160186,14,6727.79859,373.766588,480.557042,122.603359,3,0
0,0,12,12,15,16,31,42,31,73,0.000333,0.120552,7,2531.594315,140.644129,361.656331,122.603359,3,0
0,0,10,10,14,15,29,37,28,65,0.000333,0.105256,7,2210.381353,122.798964,315.768765,111.906328,2,0
0,0,5,5,9,14,23,18,21,39,0.000333,0.058806,4,705.675665,39.204204,176.418916,81.832294,2,0
0,0,6,6,9,15,24,19,23,42,0.000333,0.064189,4,770.2737,42.792983,192.568425,87.132684,2,0
0,0,8,8,14,16,30,31,29,60,0.000333,0.098138,7,2060.89405,114.494114,294.413436,117.302969,3,0
0,0,8,8,13,18,31,29,28,57,0.000333,0.09413,6,1694.335138,94.12973,282.38919,123.164366,2,0
0,0,8,8,15,16,31,35,31,66,0.000333,0.108992,7,2288.838695,127.157705,326.976956,122.603359,4,0
0,0,8,8,15,18,33,33,30,63,0.000333,0.105932,7,2224.577807,123.587656,317.79683,133.662009,3,0
0,0,5,5,10,16,26,19,20,39,0.000333,0.061106,5,916.585745,50.92143,183.317149,97.219281,2,0
0,0,6,6,10,17,27,20,22,42,0.000333,0.066568,5,998.526375,55.473688,199.705275,102.706149,2,0
0,0,13,13,15,22,37,57,50,107,0.000333,0.185804,14,7803.761142,433.542286,557.41151,156.710855,2,0
0,0,8,8,14,16,30,36,28,64,0.000333,0.10468,7,2198.286987,122.127055,314.040998,117.302969,2,0
0,0,16,16,16,17,33,67,45,112,0.000333,0.188324,16,9039.554262,502.197459,564.972141,133.486868,3,0
0,0,16,16,15,19,34,68,46,114,0.000333,0.193324,14,8119.590695,451.088372,579.970764,139.313982,3,0
0,0,16,16,15,19,34,67,46,113,0.000333,0.191628,14,8048.366215,447.131456,574.883301,139.313982,3,0
0,0,19,19,16,23,39,77,68,145,0.000333,0.255461,16,12262.13315,681.229619,766.383322,168.041925,3,0
0,0,11,11,14,15,29,45,33,78,0.000333,0.126308,14,5304.915247,294.717514,378.922518,111.906328,2,0
0,0,19,19,16,23,39,77,68,145,0.000333,0.255461,16,12262.13315,681.229619,766.383322,168.041925,3,0
0,0,11,11,14,15,29,45,33,78,0.000333,0.126308,14,5304.915247,294.717514,378.922518,111.906328,2,0
0,0,19,19,16,19,35,78,59,137,0.000333,0.234237,24,16865.08256,936.949031,702.711773,144.710623,3,0
0,0,11,11,14,15,29,45,33,78,0.000333,0.126308,14,5304.915247,294.717514,378.922518,111.906328,2,0
0,0,19,19,16,19,35,78,59,137,0.000333,0.234237,24,16865.08256,936.949031,702.711773,144.710623,3,0
0,0,11,11,14,15,29,45,33,78,0.000333,0.126308,14,5304.915247,294.717514,378.922518,111.906328,2,0
0,0,15,15,15,17,32,64,44,108,0.000333,0.18,14,7560,420,540,128.090227,2,0
0,0,11,11,14,15,29,45,33,78,0.000333,0.126308,14,5304.915247,294.717514,378.922518,111.906328,2,0
0,0,11,11,11,18,29,35,34,69,0.000333,0.111734,5,1676.003443,93.111302,335.200689,113.112398,1,0
0,0,13,13,15,19,34,46,37,83,0.000333,0.140753,7,2955.815911,164.211995,422.259416,139.313982,2,0
0,0,8,8,12,12,24,30,25,55,0.000333,0.084058,12,3026.07525,168.115292,252.172938,86.0391,2,0
0,0,11,11,13,12,25,34,29,63,0.000333,0.097521,12,3510.755279,195.04196,292.56294,91.125266,3,0
0,0,6,6,12,10,22,26,18,44,0.000333,0.065405,6,1177.289947,65.404997,196.214991,76.238831,3,0
0,0,12,12,12,19,31,47,46,93,0.000333,0.15358,12,5528.883082,307.160171,460.740257,123.730173,1,0
0,0,14,14,16,23,39,52,52,104,0.000333,0.183227,16,8794.909292,488.606072,549.681831,168.041925,2,0
0,0,17,17,15,18,33,61,44,105,0.000333,0.176554,14,7415.259355,411.958853,529.661383,133.662009,3,0
0,0,14,14,15,18,33,47,34,81,0.000333,0.136199,7,2860.171466,158.898415,408.595924,133.662009,3,0
0,0,10,10,14,15,29,37,28,65,0.000333,0.105256,7,2210.381353,122.798964,315.768765,111.906328,2,0
0,0,17,17,15,17,32,61,44,105,0.000333,0.175,14,7350,408.333333,525,128.090227,3,0
0,0,14,14,15,17,32,47,34,81,0.000333,0.135,14,5670,315,405,128.090227,3,0
0,0,10,10,14,15,29,37,28,65,0.000333,0.105256,7,2210.381353,122.798964,315.768765,111.906328,2,0
0,0,7,7,14,20,34,33,31,64,0.000333,0.108533,7,2279.183353,126.621297,325.597622,139.741531,2,0
0,0,11,11,14,17,31,36,33,69,0.000333,0.113947,7,2392.876818,132.937601,341.839545,122.789837,2,0
0,0,9,9,14,15,29,28,25,53,0.000333,0.085824,7,1802.310949,100.128386,257.472993,111.906328,2,0
0,0,10,10,15,17,32,48,40,88,0.000333,0.146667,14,6160,342.222222,440,128.090227,2,0
0,0,10,10,14,17,31,47,40,87,0.000333,0.143672,14,6034.211106,335.23395,431.015079,122.789837,2,0
0,0,10,10,14,16,30,47,39,86,0.000333,0.140664,14,5907.896277,328.21646,421.992591,117.302969,2,0
0,0,10,10,14,16,30,47,39,86,0.000333,0.140664,14,5907.896277,328.21646,421.992591,117.302969,2,0
0,0,7,7,12,19,31,30,37,67,0.000333,0.110644,6,1991.586917,110.643718,331.931153,123.730173,1,0
0,0,5,5,12,16,28,23,24,47,0.000333,0.075315,6,1355.674088,75.315227,225.945681,107.01955,2,0
0,0,16,16,17,24,41,61,58,119,0.000333,0.212516,16,10200.77902,566.709945,637.548689,179.525968,3,0
0,0,5,5,12,17,29,23,25,48,0.000333,0.077728,6,1399.098527,77.727696,233.183088,112.506418,2,0
0,0,12,12,14,20,34,41,41,82,0.000333,0.139057,14,5840.407342,324.467075,417.171953,139.741531,2,0
0,0,9,9,11,12,23,28,26,54,0.000333,0.081424,10,2442.723456,135.706859,244.272346,81.073298,2,0
0,0,9,9,11,11,22,28,26,54,0.000333,0.08027,10,2408.093074,133.782949,240.809307,76.107496,2,0
0,0,11,11,12,14,26,39,32,71,0.000333,0.111244,12,4004.77464,222.48748,333.73122,96.322519,2,0
0,0,5,5,9,12,21,24,19,43,0.000333,0.062957,4,755.478597,41.971033,188.869649,71.548875,1,0
0,0,9,9,11,12,23,28,26,54,0.000333,0.081424,10,2442.723456,135.706859,244.272346,81.073298,2,0
0,0,9,9,10,13,23,26,28,54,0.000333,0.081424,10,2442.723456,135.706859,244.272346,81.324997,1,0
0,0,9,9,13,14,27,27,24,51,0.000333,0.080833,6,1454.995576,80.833088,242.499263,101.408685,2,0
0,0,16,16,19,25,44,76,64,140,0.000333,0.254773,18,13757.76768,764.320427,764.320427,196.807027,2,0
0,0,11,11,18,21,39,57,46,103,0.000333,0.181465,18,9799.135714,544.396429,544.396429,167.297316,2,0
0,0,13,13,17,20,37,51,51,102,0.000333,0.177121,16,8501.827893,472.323772,531.364243,155.92543,1,0
0,0,10,10,15,16,31,42,35,77,0.000333,0.127158,14,5340.623623,296.701312,381.473116,122.603359,2,0
0,0,16,16,16,17,33,71,49,120,0.000333,0.201776,16,9685.236709,538.068706,605.327294,133.486868,2,0
0,0,10,10,13,16,29,38,32,70,0.000333,0.113353,12,4080.704036,226.70578,340.05867,112.105716,2,0
0,0,10,10,12,16,28,37,32,69,0.000333,0.110569,12,3980.489875,221.138326,331.70749,107.01955,2,0
0,0,10,10,13,16,29,38,32,70,0.000333,0.113353,12,4080.704036,226.70578,340.05867,112.105716,2,0
0,0,10,10,12,16,28,37,32,69,0.000333,0.110569,12,3980.489875,221.138326,331.70749,107.01955,2,0
0,0,12,12,13,16,29,42,34,76,0.000333,0.123069,12,4430.478668,246.137704,369.206556,112.105716,2,0
0,0,12,12,13,16,29,42,34,76,0.000333,0.123069,12,4430.478668,246.137704,369.206556,112.105716,2,0
0,0,10,10,12,15,27,37,31,68,0.000333,0.107777,12,3879.988202,215.5549,323.33235,101.622909,2,0
0,0,10,10,12,15,27,37,31,68,0.000333,0.107777,12,3879.988202,215.5549,323.33235,101.622909,2,0
0,0,14,14,14,18,32,60,43,103,0.000333,0.171667,14,7210,400.555556,515,128.361619,2,0
0,0,6,6,8,10,18,19,17,36,0.000333,0.050039,4,600.4692,33.3594,150.1173,57.219281,1,0
0,0,6,6,8,10,18,19,17,36,0.000333,0.050039,4,600.4692,33.3594,150.1173,57.219281,1,0
0,0,16,16,17,19,36,55,48,103,0.000333,0.177501,16,8520.036402,473.335356,532.502275,150.197491,4,0
0,0,10,10,13,15,28,32,26,58,0.000333,0.092942,6,1672.959513,92.942195,278.826585,106.709075,3,0
0,0,16,16,17,19,36,55,48,103,0.000333,0.177501,16,8520.036402,473.335356,532.502275,150.197491,4,0
0,0,10,10,13,15,28,32,26,58,0.000333,0.092942,6,1672.959513,92.942195,278.826585,106.709075,3,0
0,0,16,16,17,20,37,56,49,105,0.000333,0.182331,16,8751.881654,486.215647,546.992603,155.92543,4,0
0,0,10,10,13,16,29,33,27,60,0.000333,0.09716,6,1748.873158,97.15962,291.47886,112.105716,3,0
0,0,16,16,17,20,37,55,49,104,0.000333,0.180594,16,8668.5304,481.585022,541.78315,155.92543,4,0
0,0,10,10,13,16,29,32,27,59,0.000333,0.09554,6,1719.725272,95.540293,286.620879,112.105716,3,0
0,0,17,17,17,20,37,61,54,115,0.000333,0.199696,16,9585.394193,532.5219,599.087137,155.92543,4,0
0,0,11,11,16,18,34,38,32,70,0.000333,0.118707,8,2848.979191,158.276622,356.122399,139.05865,3,0
0,0,14,14,20,20,40,71,50,121,0.000333,0.214651,20,12879.06599,715.503666,643.953299,172.877124,3,0
0,0,14,14,20,20,40,71,50,121,0.000333,0.214651,20,12879.06599,715.503666,643.953299,172.877124,3,0
0,0,12,12,10,18,28,40,50,90,0.000333,0.144221,10,4326.61943,240.367746,432.661943,108.277931,1,0
0,0,12,12,11,19,30,41,52,93,0.000333,0.152114,10,4563.408254,253.522681,456.340825,118.764371,1,0
0,0,17,17,12,20,32,52,75,127,0.000333,0.211667,18,11430,635,635,129.458112,2,0
0,0,17,17,14,23,37,54,82,136,0.000333,0.236162,21,14878.19881,826.566601,708.485658,157.344894,2,0
0,0,5,5,12,16,28,23,24,47,0.000333,0.075315,6,1355.674088,75.315227,225.945681,107.01955,2,0
0,0,16,16,16,25,41,62,82,144,0.000333,0.257162,24,18515.69973,1028.649985,771.487489,180.096405,3,0
0,0,5,5,12,17,29,23,25,48,0.000333,0.077728,6,1399.098527,77.727696,233.183088,112.506418,2,0
0,0,13,13,13,20,33,40,49,89,0.000333,0.14965,12,5387.412919,299.300718,448.951077,134.544278,2,0
0,0,13,13,15,23,38,42,50,92,0.000333,0.160936,14,6759.330637,375.518369,482.809331,162.645284,2,0
0,0,5,5,11,17,28,22,27,49,0.000333,0.07852,5,1177.801956,65.433442,235.560391,107.540616,2,0
0,0,19,19,18,28,46,66,75,141,0.000333,0.259607,18,14018.80024,778.822236,778.822236,209.664588,3,0
0,0,5,5,11,18,29,22,28,50,0.000333,0.080966,5,1214.495249,67.471958,242.89905,113.112398,2,0
0,0,13,13,13,20,33,48,46,94,0.000333,0.158058,12,5690.076567,316.115365,474.173047,134.544278,2,0
0,0,13,13,14,21,35,49,46,95,0.000333,0.162427,14,6821.946413,378.997023,487.281887,145.541635,2,0
0,0,17,17,15,24,39,63,61,124,0.000333,0.218463,14,9175.458252,509.747681,655.389875,168.642459,2,0
0,0,12,12,14,17,31,40,42,82,0.000333,0.135415,14,5687.417364,315.967631,406.244097,122.789837,3,0
0,0,12,12,14,19,33,38,41,79,0.000333,0.132836,14,5579.099896,309.949994,398.507135,134.013592,2,0
0,0,12,12,16,17,33,45,44,89,0.000333,0.14965,16,7183.217226,399.067624,448.951077,133.486868,4,0
0,0,12,12,16,19,35,43,43,86,0.000333,0.147039,16,7057.893431,392.105191,441.118339,144.710623,3,0
0,0,7,7,12,14,26,30,27,57,0.000333,0.089308,6,1607.550384,89.308355,267.925064,96.322519,3,0
0,0,7,7,12,16,28,28,26,54,0.000333,0.086532,6,1557.582995,86.532389,259.597166,107.01955,2,0
0,0,7,7,14,14,28,34,29,63,0.000333,0.100954,14,4240.087041,235.560391,302.86336,106.605938,4,0
0,0,7,7,14,16,30,32,28,60,0.000333,0.098138,7,2060.89405,114.494114,294.413436,117.302969,3,0
0,0,16,16,17,17,34,62,46,108,0.000333,0.183149,16,8791.13579,488.396433,549.445987,138.973737,3,0
0,0,11,11,14,15,29,39,29,68,0.000333,0.110114,7,2312.398954,128.466609,330.342708,111.906328,2,0
0,0,18,18,17,19,36,71,53,124,0.000333,0.21369,16,10257.1312,569.840622,641.0707,150.197491,4,0
0,0,13,13,17,17,34,48,36,84,0.000333,0.142449,16,6837.550059,379.863892,427.346879,138.973737,3,0
0,0,17,17,18,18,36,65,47,112,0.000333,0.193011,18,10422.5688,579.0316,579.0316,150.1173,4,0
0,0,12,12,15,16,31,42,30,72,0.000333,0.118901,7,2496.91494,138.717497,356.702134,122.603359,3,0
0,0,17,17,18,18,36,65,47,112,0.000333,0.193011,18,10422.5688,579.0316,579.0316,150.1173,4,0
0,0,12,12,15,16,31,42,30,72,0.000333,0.118901,7,2496.91494,138.717497,356.702134,122.603359,3,0
0,0,20,20,18,21,39,76,53,129,0.000333,0.227272,18,12272.70395,681.816886,681.816886,167.297316,4,0
0,0,14,14,15,19,34,51,34,85,0.000333,0.144145,7,3027.040391,168.168911,432.434342,139.313982,3,0
0,0,14,14,15,19,34,51,34,85,0.000333,0.144145,7,3027.040391,168.168911,432.434342,139.313982,3,0
0,0,17,17,17,18,35,65,47,112,0.000333,0.191493,16,9191.675166,510.64862,574.479698,144.545518,4,0
0,0,12,12,14,16,30,42,30,72,0.000333,0.117765,7,2473.07286,137.392937,353.296123,117.302969,3,0
0,0,17,17,17,18,35,65,47,112,0.000333,0.191493,16,9191.675166,510.64862,574.479698,144.545518,4,0
0,0,12,12,14,16,30,42,30,72,0.000333,0.117765,7,2473.07286,137.392937,353.296123,117.302969,3,0
0,0,17,17,18,18,36,74,50,124,0.000333,0.21369,18,11539.2726,641.0707,641.0707,150.1173,4,0
0,0,17,17,18,18,36,74,50,124,0.000333,0.21369,18,11539.2726,641.0707,641.0707,150.1173,4,0
0,0,19,19,19,20,39,79,53,132,0.000333,0.232558,18,12558.11567,697.673093,697.673093,167.149185,4,0
0,0,19,19,19,20,39,79,53,132,0.000333,0.232558,18,12558.11567,697.673093,697.673093,167.149185,4,0
0,0,11,11,14,23,37,47,34,81,0.000333,0.140655,7,2953.760058,164.097781,421.965723,157.344894,5,0
0,0,12,12,14,23,37,48,36,84,0.000333,0.145865,7,3063.158579,170.175477,437.594083,157.344894,5,0
0,0,11,11,14,23,37,47,34,81,0.000333,0.140655,7,2953.760058,164.097781,421.965723,157.344894,5,0
0,0,12,12,14,23,37,48,36,84,0.000333,0.145865,7,3063.158579,170.175477,437.594083,157.344894,5,0
0,0,5,5,8,8,16,11,12,23,0.000333,0.030667,4,368,20.444444,92,48,1,0
0,0,13,13,15,22,37,52,36,88,0.000333,0.152811,7,3209.023273,178.279071,458.431896,156.710855,5,0
0,0,14,14,15,22,37,53,38,91,0.000333,0.15802,7,3318.421794,184.356766,474.060256,156.710855,5,0
0,0,13,13,15,22,37,52,36,88,0.000333,0.152811,7,3209.023273,178.279071,458.431896,156.710855,5,0
0,0,14,14,15,22,37,53,38,91,0.000333,0.15802,7,3318.421794,184.356766,474.060256,156.710855,5,0
0,0,11,11,14,23,37,47,34,81,0.000333,0.140655,7,2953.760058,164.097781,421.965723,157.344894,5,0
0,0,12,12,14,23,37,48,36,84,0.000333,0.145865,7,3063.158579,170.175477,437.594083,157.344894,5,0
0,0,11,11,14,23,37,47,34,81,0.000333,0.140655,7,2953.760058,164.097781,421.965723,157.344894,5,0
0,0,12,12,14,23,37,48,36,84,0.000333,0.145865,7,3063.158579,170.175477,437.594083,157.344894,5,0
0,0,10,10,10,17,27,34,38,72,0.000333,0.114117,10,3423.519002,190.1955,342.3519,102.706149,1,0
0,0,10,10,11,18,29,35,38,73,0.000333,0.118211,10,3546.326126,197.018118,354.632613,113.112398,1,0
0,0,18,18,16,23,39,70,80,150,0.000333,0.26427,24,19027.44799,1057.080444,792.810333,168.041925,2,0
0,0,14,14,16,21,37,58,52,110,0.000333,0.191013,16,9168.637924,509.368774,573.03987,156.238666,2,0
0,0,7,7,13,17,30,31,28,59,0.000333,0.096502,6,1737.039271,96.502182,289.506545,117.592585,1,0
0,0,5,5,6,12,18,10,16,26,0.000333,0.036139,3,325.25415,18.069675,108.41805,58.529325,1,0
0,0,14,14,16,21,37,58,52,110,0.000333,0.191013,16,9168.637924,509.368774,573.03987,156.238666,2,0
0,0,11,11,12,14,26,52,38,90,0.000333,0.141013,12,5076.474896,282.026383,423.039575,96.322519,1,0
0,0,15,15,16,24,40,67,55,122,0.000333,0.216425,16,10388.40364,577.133536,649.275228,174.0391,2,0
0,0,14,14,16,23,39,58,51,109,0.000333,0.192036,16,9217.74147,512.096748,576.108842,168.041925,2,0
0,0,13,13,13,19,32,38,44,82,0.000333,0.136667,12,4920,273.333333,410,128.816339,2,0
0,0,13,13,14,21,35,39,45,84,0.000333,0.14362,14,6032.036828,335.113157,430.859773,145.541635,2,0
0,0,13,13,12,20,32,44,46,90,0.000333,0.15,12,5400,300,450,129.458112,2,0
0,0,8,8,7,15,22,21,26,47,0.000333,0.069864,3,628.779858,34.932214,209.593286,78.254843,1,0
0,0,13,13,13,21,34,45,46,91,0.000333,0.15432,12,5555.509423,308.639412,462.959119,140.344382,2,0
0,0,8,8,8,17,25,22,25,47,0.000333,0.072754,4,873.044964,48.502498,218.261241,93.486868,1,0
0,0,18,18,14,25,39,63,64,127,0.000333,0.223749,14,9397.445145,522.080286,671.246082,169.399374,2,0
0,0,15,15,13,23,36,52,52,104,0.000333,0.179224,12,6452.066402,358.448133,537.6722,152.147641,2,0
0,0,10,10,12,15,27,38,32,70,0.000333,0.110947,12,3994.105502,221.89475,332.842125,101.622909,2,0
0,0,10,10,12,15,27,38,32,70,0.000333,0.110947,12,3994.105502,221.89475,332.842125,101.622909,2,0
0,0,7,7,12,10,22,24,18,42,0.000333,0.062432,6,1123.776768,62.432043,187.296128,76.238831,3,0
0,0,13,13,11,20,31,60,60,120,0.000333,0.198168,15,8917.553359,495.419631,594.503557,124.49231,1,0
0,0,11,11,11,19,30,54,46,100,0.000333,0.163563,10,4906.890596,272.605033,490.68906,118.764371,1,0
0,0,10,10,14,14,28,38,29,67,0.000333,0.107364,14,4509.298917,250.516606,322.09278,106.605938,2,0
0,0,9,9,12,14,26,32,25,57,0.000333,0.089308,6,1607.550384,89.308355,267.925064,96.322519,2,0
0,0,10,10,14,14,28,38,29,67,0.000333,0.107364,14,4509.298917,250.516606,322.09278,106.605938,2,0
0,0,9,9,12,14,26,32,25,57,0.000333,0.089308,6,1607.550384,89.308355,267.925064,96.322519,2,0
0,0,10,10,14,14,28,38,29,67,0.000333,0.107364,14,4509.298917,250.516606,322.09278,106.605938,2,0
0,0,9,9,12,14,26,32,25,57,0.000333,0.089308,6,1607.550384,89.308355,267.925064,96.322519,2,0
0,0,10,10,14,14,28,38,29,67,0.000333,0.107364,14,4509.298917,250.516606,322.09278,106.605938,2,0
0,0,9,9,12,14,26,32,25,57,0.000333,0.089308,6,1607.550384,89.308355,267.925064,96.322519,2,0
0,0,25,25,15,28,43,103,100,203,0.000333,0.367177,21,23132.16665,1285.120369,1101.531745,193.209297,6,0
0,0,16,16,13,20,33,50,75,125,0.000333,0.210183,18,11349.88677,630.549265,630.549265,134.544278,3,0
0,0,11,11,14,17,31,36,35,71,0.000333,0.117249,14,4924.471133,273.58173,351.747938,122.789837,3,0
0,0,12,12,17,13,30,47,34,81,0.000333,0.132486,16,6359.330212,353.296123,397.458138,117.592585,6,0
0,0,12,12,17,15,32,45,33,78,0.000333,0.13,16,6240,346.666667,390,128.090227,5,0
0,0,12,12,16,13,29,46,34,80,0.000333,0.129546,16,6218.215674,345.456426,388.63848,112.105716,6,0
0,0,12,12,16,15,31,44,33,77,0.000333,0.127158,16,6103.569854,339.087214,381.473116,122.603359,5,0
0,0,12,12,17,13,30,47,34,81,0.000333,0.132486,16,6359.330212,353.296123,397.458138,117.592585,6,0
0,0,12,12,17,15,32,45,33,78,0.000333,0.13,16,6240,346.666667,390,128.090227,5,0
0,0,12,12,16,13,29,46,34,80,0.000333,0.129546,16,6218.215674,345.456426,388.63848,112.105716,6,0
0,0,12,12,16,15,31,44,33,77,0.000333,0.127158,16,6103.569854,339.087214,381.473116,122.603359,5,0
0,0,9,9,11,12,23,33,26,59,0.000333,0.088963,10,2668.901554,148.272309,266.890155,81.073298,1,0
0,0,5,5,10,10,20,22,17,39,0.000333,0.056185,5,842.775979,46.820888,168.555196,66.438562,1,0
0,0,10,10,13,14,27,35,26,61,0.000333,0.096683,6,1740.288826,96.682713,290.048138,101.408685,2,0
0,0,12,12,13,14,27,41,30,71,0.000333,0.112532,12,4051.164152,225.064675,337.597013,101.408685,2,0
0,0,13,13,14,16,30,43,30,73,0.000333,0.119401,7,2507.421094,139.301172,358.203013,117.302969,3,0
0,0,12,12,13,14,27,41,30,71,0.000333,0.112532,12,4051.164152,225.064675,337.597013,101.408685,2,0
0,0,13,13,14,17,31,43,30,73,0.000333,0.120552,7,2531.594315,140.644129,361.656331,122.789837,3,0
0,0,13,13,17,16,33,55,39,94,0.000333,0.158058,16,7586.768756,421.487153,474.173047,133.486868,3,0
0,0,13,13,17,17,34,55,39,94,0.000333,0.159407,16,7651.544113,425.085784,478.221507,138.973737,3,0
0,0,14,14,16,25,41,67,50,117,0.000333,0.208945,16,10029.33735,557.185408,626.833585,180.096405,2,0
0,0,16,16,17,23,40,62,65,127,0.000333,0.225295,16,10814.15789,600.786549,675.884868,173.528793,2,0
0,0,8,8,16,17,33,38,33,71,0.000333,0.119384,8,2865.21586,159.178659,358.151982,133.486868,2,0
0,0,8,8,12,12,24,30,25,55,0.000333,0.084058,12,3026.07525,168.115292,252.172938,86.0391,2,0
0,0,8,8,12,12,24,30,25,55,0.000333,0.084058,12,3026.07525,168.115292,252.172938,86.0391,2,0
0,0,8,8,12,11,23,26,23,49,0.000333,0.073885,12,2659.85443,147.769691,221.654536,81.073298,2,0
0,0,12,12,13,15,28,59,44,103,0.000333,0.165053,12,5941.890684,330.105038,495.157557,106.709075,2,0
0,0,12,12,13,15,28,59,44,103,0.000333,0.165053,12,5941.890684,330.105038,495.157557,106.709075,2,0
0,0,11,11,12,14,26,56,39,95,0.000333,0.148847,12,5358.501279,297.694515,446.541773,96.322519,1,0
0,0,25,25,19,48,67,114,97,211,0.000333,0.426648,18,23039.00675,1279.944819,1279.944819,348.788823,9,0
0,0,25,25,20,49,69,115,103,218,0.000333,0.443886,20,26633.16663,1479.620368,1331.658332,361.559344,9,0
0,0,50,50,30,57,87,192,159,351,0.000333,0.753824,30,67844.19501,3769.121945,2261.473167,479.681449,15,0
0,0,50,50,29,59,88,190,158,348,0.000333,0.749294,28,62940.70169,3496.70565,2247.882203,487.957389,14,0
0,0,15,15,19,18,37,49,67,116,0.000333,0.201432,27,16316.00794,906.444886,604.29659,155.769273,3,0
0,0,15,15,19,20,39,47,66,113,0.000333,0.199083,27,16125.76217,895.875676,597.250451,167.149185,2,0
0,0,14,14,15,16,31,62,43,105,0.000333,0.173397,14,7282.668576,404.592699,520.190613,122.603359,2,0
0,0,17,17,16,19,35,70,47,117,0.000333,0.200042,16,9602.017808,533.445434,600.126113,144.710623,3,0
0,0,9,9,14,14,28,35,26,61,0.000333,0.09775,7,2052.740552,114.041142,293.24865,106.605938,2,0
0,0,17,17,16,18,34,70,47,117,0.000333,0.198411,16,9523.730439,529.096135,595.233152,139.05865,3,0
0,0,9,9,14,14,28,35,26,61,0.000333,0.09775,7,2052.740552,114.041142,293.24865,106.605938,2,0
0,0,10,10,12,14,26,42,30,72,0.000333,0.112811,12,4061.179916,225.621106,338.43166,96.322519,2,0
0,0,10,10,12,14,26,42,30,72,0.000333,0.112811,12,4061.179916,225.621106,338.43166,96.322519,2,0
0,0,9,9,15,14,29,40,31,71,0.000333,0.114972,14,4828.833109,268.268506,344.916651,111.906328,2,0
0,0,12,12,12,21,33,52,43,95,0.000333,0.159739,12,5750.609296,319.478294,479.217441,135.258216,1,0
0,0,16,16,19,23,42,79,57,136,0.000333,0.244452,18,13200.39305,733.355169,733.355169,184.752548,3,0
0,0,12,12,13,19,32,54,52,106,0.000333,0.176667,12,6360,353.333333,530,128.816339,2,0
0,0,12,12,13,19,32,54,52,106,0.000333,0.176667,12,6360,353.333333,530,128.816339,2,0
0,0,9,9,12,13,25,44,29,73,0.000333,0.113001,12,4068.018022,226.001001,339.001502,91.125266,2,0
0,0,9,9,12,14,26,44,29,73,0.000333,0.114377,12,4117.585193,228.754733,343.132099,96.322519,2,0
0,0,9,9,12,14,26,44,29,73,0.000333,0.114377,12,4117.585193,228.754733,343.132099,96.322519,2,0
0,0,6,6,9,10,19,19,16,35,0.000333,0.049559,4,594.709852,33.039436,148.677463,61.748606,2,0
0,0,12,12,15,14,29,43,32,75,0.000333,0.12145,14,5100.880045,283.382225,364.348575,111.906328,2,0
0,0,11,11,13,14,27,37,28,65,0.000333,0.103023,12,3708.812252,206.045125,309.067688,101.408685,2,0
0,0,12,12,15,15,30,43,32,75,0.000333,0.122672,14,5152.235125,286.235285,368.016795,117.206718,2,0
0,0,11,11,13,15,28,37,28,65,0.000333,0.104159,6,1874.86842,104.159357,312.47807,106.709075,2,0
0,0,10,10,14,14,28,38,29,67,0.000333,0.107364,14,4509.298917,250.516606,322.09278,106.605938,2,0
0,0,9,9,12,14,26,32,25,57,0.000333,0.089308,6,1607.550384,89.308355,267.925064,96.322519,2,0
0,0,10,10,14,14,28,38,29,67,0.000333,0.107364,14,4509.298917,250.516606,322.09278,106.605938,2,0
0,0,9,9,12,14,26,32,25,57,0.000333,0.089308,6,1607.550384,89.308355,267.925064,96.322519,2,0
0,0,10,10,14,13,27,38,29,67,0.000333,0.106192,14,4460.084477,247.782471,318.577463,101.408685,2,0
0,0,9,9,12,13,25,32,25,57,0.000333,0.088233,6,1588.198817,88.233268,264.699803,91.125266,2,0
0,0,10,10,14,14,28,38,29,67,0.000333,0.107364,14,4509.298917,250.516606,322.09278,106.605938,2,0
0,0,9,9,12,14,26,32,25,57,0.000333,0.089308,6,1607.550384,89.308355,267.925064,96.322519,2,0
0,0,17,17,19,26,45,89,70,159,0.000333,0.291068,18,15717.68356,873.204642,873.204642,202.922055,2,0
0,0,10,10,18,21,39,54,44,98,0.000333,0.172656,18,9323.449514,517.969417,517.969417,167.297316,2,0
0,0,12,12,15,20,35,50,39,89,0.000333,0.152169,7,3195.54332,177.530184,456.506189,145.041921,3,0
0,0,10,10,15,18,33,42,31,73,0.000333,0.122747,7,2577.685395,143.204744,368.240771,133.662009,3,0
0,0,12,12,15,20,35,49,39,88,0.000333,0.150459,7,3159.638338,175.535463,451.376905,145.041921,3,0
0,0,10,10,15,18,33,41,31,72,0.000333,0.121065,7,2542.374636,141.243035,363.196377,133.662009,3,0
0,0,14,14,16,20,36,53,41,94,0.000333,0.161991,16,7775.567202,431.975956,485.97295,150.438562,3,0
0,0,12,12,16,19,35,45,33,78,0.000333,0.133361,8,3200.672603,177.815145,400.084075,144.710623,3,0
0,0,14,14,16,20,36,53,41,94,0.000333,0.161991,16,7775.567202,431.975956,485.97295,150.438562,3,0
0,0,12,12,16,18,34,45,33,78,0.000333,0.132274,8,3174.576813,176.365378,396.822102,139.05865,3,0
0,0,12,12,15,19,34,49,38,87,0.000333,0.147536,14,6196.529741,344.251652,442.609267,139.313982,3,0
0,0,10,10,15,17,32,41,30,71,0.000333,0.118333,7,2485,138.055556,355,128.090227,3,0
0,0,12,12,15,19,34,49,38,87,0.000333,0.147536,14,6196.529741,344.251652,442.609267,139.313982,3,0
0,0,10,10,15,17,32,41,30,71,0.000333,0.118333,7,2485,138.055556,355,128.090227,3,0
0,0,14,14,14,19,33,46,42,88,0.000333,0.147969,14,6214.693555,345.260753,443.906683,134.013592,3,0
0,0,10,10,13,16,29,32,27,59,0.000333,0.09554,6,1719.725272,95.540293,286.620879,112.105716,3,0
0,0,14,14,14,19,33,45,42,87,0.000333,0.146287,14,6144.072037,341.337335,438.862288,134.013592,3,0
0,0,10,10,13,16,29,31,27,58,0.000333,0.093921,6,1690.577386,93.920966,281.762898,112.105716,3,0
0,0,14,14,14,18,32,45,41,86,0.000333,0.143333,14,6020,334.444444,430,128.361619,3,0
0,0,10,10,13,15,28,31,26,57,0.000333,0.09134,6,1644.115383,91.339744,274.019231,106.709075,3,0
0,0,14,14,14,18,32,45,41,86,0.000333,0.143333,14,6020,334.444444,430,128.361619,3,0
0,0,10,10,13,15,28,31,26,57,0.000333,0.09134,6,1644.115383,91.339744,274.019231,106.709075,3,0
0,0,16,16,14,16,30,64,47,111,0.000333,0.181555,14,7625.307986,423.628221,544.664856,117.302969,3,0
0,0,13,13,14,16,30,50,37,87,0.000333,0.1423,14,5976.592745,332.03293,426.899482,117.302969,3,0
0,0,16,16,14,16,30,63,47,110,0.000333,0.179919,14,7556.611517,419.811751,539.757966,117.302969,3,0
0,0,13,13,14,16,30,49,37,86,0.000333,0.140664,14,5907.896277,328.21646,421.992591,117.302969,3,0
0,0,20,20,18,24,42,83,77,160,0.000333,0.28759,27,23294.81127,1294.156181,862.770788,185.09775,3,0
0,0,10,10,13,17,30,44,35,79,0.000333,0.129215,12,4651.732285,258.429571,387.644357,117.592585,2,0
0,0,18,18,18,19,37,77,55,132,0.000333,0.229216,18,12377.6612,687.647844,687.647844,155.769273,3,0
0,0,11,11,14,20,34,42,36,78,0.000333,0.132274,7,2777.754711,154.319706,396.822102,139.741531,2,0
0,0,10,10,14,15,29,39,29,68,0.000333,0.110114,7,2312.398954,128.466609,330.342708,111.906328,2,0
0,0,17,17,16,24,40,66,52,118,0.000333,0.209329,16,10047.80024,558.211125,627.987515,174.0391,2,0
0,0,10,10,14,15,29,39,29,68,0.000333,0.110114,7,2312.398954,128.466609,330.342708,111.906328,2,0
0,0,17,17,16,18,34,69,50,119,0.000333,0.201803,16,9686.52925,538.140514,605.408078,139.05865,2,0
0,0,10,10,14,15,29,39,29,68,0.000333,0.110114,7,2312.398954,128.466609,330.342708,111.906328,2,0
0,0,26,26,19,52,71,133,100,233,0.000333,0.47763,9,12896.01971,716.445539,1432.891079,377.133488,9,0
0,0,8,8,11,17,28,24,26,50,0.000333,0.080123,5,1201.838731,66.768818,240.367746,107.540616,2,0
0,0,13,13,13,21,34,45,45,90,0.000333,0.152624,12,5494.459869,305.24777,457.871656,140.344382,3,0
0,0,7,7,7,12,19,20,23,43,0.000333,0.060887,3,547.982649,30.443481,182.660883,62.671034,1,0
0,0,7,7,8,14,22,21,22,43,0.000333,0.063919,4,767.022238,42.612347,191.75556,77.302969,1,0
0,0,7,7,8,14,22,21,22,43,0.000333,0.063919,4,767.022238,42.612347,191.75556,77.302969,1,0
0,0,17,17,14,26,40,78,64,142,0.000333,0.251905,14,10579.99305,587.777392,755.713789,175.514402,2,0
0,0,17,17,15,27,42,84,66,150,0.000333,0.269616,14,11323.86659,629.103699,808.847613,186.985321,2,0
0,0,8,8,13,12,25,26,19,45,0.000333,0.069658,6,1253.841171,69.657843,208.973529,91.125266,3,0
0,0,13,13,16,17,33,47,52,99,0.000333,0.166465,24,11985.48043,665.860024,499.395018,133.486868,5,0
0,0,13,13,16,19,35,45,51,96,0.000333,0.164137,16,7878.578714,437.698817,492.41117,144.710623,4,0
0,0,13,13,16,17,33,47,52,99,0.000333,0.166465,24,11985.48043,665.860024,499.395018,133.486868,5,0
0,0,13,13,16,19,35,45,51,96,0.000333,0.164137,16,7878.578714,437.698817,492.41117,144.710623,4,0
0,0,13,13,15,18,33,43,47,90,0.000333,0.151332,14,6355.93659,353.107588,453.995471,133.662009,4,0
0,0,13,13,14,20,34,41,46,87,0.000333,0.147536,14,6196.529741,344.251652,442.609267,139.741531,3,0
0,0,12,12,17,13,30,46,34,80,0.000333,0.13085,16,6280.819962,348.934442,392.551248,117.592585,6,0
0,0,12,12,17,15,32,44,33,77,0.000333,0.128333,16,6160,342.222222,385,128.090227,5,0
0,0,12,12,16,13,29,45,34,79,0.000333,0.127927,16,6140.487978,341.138221,383.780499,112.105716,6,0
0,0,12,12,16,15,31,43,33,76,0.000333,0.125506,16,6024.302713,334.683484,376.51892,122.603359,5,0
0,0,16,16,17,13,30,53,38,91,0.000333,0.148842,16,7144.432707,396.912928,446.527044,117.592585,6,0
0,0,16,16,17,15,32,51,37,88,0.000333,0.146667,16,7040,391.111111,440,128.090227,5,0
0,0,16,16,17,12,29,53,38,91,0.000333,0.147359,24,10609.83049,589.435027,442.076271,112.506418,6,0
0,0,16,16,17,14,31,51,37,88,0.000333,0.145323,16,6975.508405,387.528245,435.969275,122.789837,5,0
0,0,12,12,17,11,28,45,32,77,0.000333,0.123389,16,5922.661264,329.036737,370.166329,107.540616,6,0
0,0,12,12,17,13,30,43,31,74,0.000333,0.121037,16,5809.758465,322.764359,363.109904,117.592585,5,0
0,0,13,13,18,18,36,56,40,96,0.000333,0.165438,18,8933.630402,496.3128,496.3128,150.1173,3,0
0,0,13,13,17,18,35,55,40,95,0.000333,0.162427,16,7796.510186,433.139455,487.281887,144.545518,3,0
0,0,8,8,16,19,35,40,34,74,0.000333,0.126522,8,3036.535546,168.696419,379.566943,144.710623,2,0
0,0,5,5,11,15,26,20,22,42,0.000333,0.065806,5,987.092341,54.838463,197.418468,96.657107,2,0
0,0,15,15,18,22,40,66,48,114,0.000333,0.202233,18,10920.59645,606.699803,606.699803,173.166146,4,0
0,0,15,15,18,22,40,66,48,114,0.000333,0.202233,18,10920.59645,606.699803,606.699803,173.166146,4,0
0,0,5,5,11,15,26,20,22,42,0.000333,0.065806,5,987.092341,54.838463,197.418468,96.657107,2,0
0,0,17,17,19,23,42,70,51,121,0.000333,0.21749,18,11744.46735,652.470408,652.470408,184.752548,4,0
0,0,17,17,19,23,42,70,51,121,0.000333,0.21749,18,11744.46735,652.470408,652.470408,184.752548,4,0
0,0,9,9,14,22,36,35,34,69,0.000333,0.118908,7,2497.073776,138.726321,356.724825,151.410465,2,0
0,0,8,8,11,11,22,22,20,42,0.000333,0.062432,5,936.48064,52.026702,187.296128,76.107496,2,0
0,0,8,8,11,10,21,22,20,42,0.000333,0.061492,10,1844.773318,102.487407,184.477332,71.273029,2,0
0,0,8,8,11,11,22,22,20,42,0.000333,0.062432,5,936.48064,52.026702,187.296128,76.107496,2,0
0,0,8,8,11,11,22,22,20,42,0.000333,0.062432,5,936.48064,52.026702,187.296128,76.107496,2,0
0,0,28,28,23,46,69,163,104,267,0.000333,0.543659,22,35881.47266,1993.415148,1630.97603,358.125775,17,0
0,0,35,35,25,59,84,203,130,333,0.000333,0.709547,24,51087.40084,2838.188936,2128.641702,463.172345,19,0
0,0,3,3,11,13,24,17,14,31,0.000333,0.047378,5,710.669188,39.481622,142.133838,86.159464,1,0
0,0,3,3,11,13,24,17,14,31,0.000333,0.047378,5,710.669188,39.481622,142.133838,86.159464,1,0
0,0,15,15,18,23,41,78,49,127,0.000333,0.226803,18,12247.36388,680.409105,680.409105,179.100575,3,0
0,0,36,36,24,40,64,175,111,286,0.000333,0.572,24,41184,2288,1716,322.916224,21,0
0,0,24,24,19,37,56,120,83,203,0.000333,0.392964,18,21220.07489,1178.893049,1178.893049,273.460397,10,0
0,0,28,28,19,37,56,134,95,229,0.000333,0.443295,18,23937.91699,1329.884277,1329.884277,273.460397,11,0
0,0,24,24,16,21,37,111,79,190,0.000333,0.329932,24,23755.10735,1319.728186,989.796139,156.238666,7,0
0,0,3,3,10,15,25,18,18,36,0.000333,0.055726,5,835.894114,46.438562,167.178823,91.82264,1,0
0,0,3,3,11,11,22,16,13,29,0.000333,0.043108,5,646.617585,35.923199,129.323517,76.107496,1,0
0,0,3,3,11,11,22,16,13,29,0.000333,0.043108,5,646.617585,35.923199,129.323517,76.107496,1,0
0,0,3,3,11,11,22,16,13,29,0.000333,0.043108,5,646.617585,35.923199,129.323517,76.107496,1,0
0,0,3,3,11,11,22,16,13,29,0.000333,0.043108,5,646.617585,35.923199,129.323517,76.107496,1,0
0,0,2,2,6,5,11,6,7,13,0.000333,0.014991,3,134.917833,7.495435,44.972611,27.119415,1,0
0,0,2,2,6,5,11,6,7,13,0.000333,0.014991,3,134.917833,7.495435,44.972611,27.119415,1,0
0,0,2,2,6,5,11,6,7,13,0.000333,0.014991,3,134.917833,7.495435,44.972611,27.119415,1,0
0,0,2,2,8,5,13,8,7,15,0.000333,0.018502,4,222.026383,12.334799,55.506596,35.60964,1,0
0,0,51,51,28,69,97,294,189,483,0.000333,1.062586,28,89257.22128,4958.734515,3187.757903,556.094125,24,0
0,0,28,28,22,35,57,173,108,281,0.000333,0.546347,33,54088.3891,3004.910506,1639.042094,277.632401,15,0
0,0,35,35,25,57,82,214,138,352,0.000333,0.745953,24,53708.59934,2983.811074,2237.858306,448.571136,21,0
0,0,50,50,28,69,97,293,187,480,0.000333,1.055986,28,88702.8286,4927.934922,3167.958164,556.094125,24,0
0,0,27,27,22,35,57,172,106,278,0.000333,0.540514,33,53510.93299,2972.829611,1621.543424,277.632401,15,0
0,0,34,34,25,57,82,213,136,349,0.000333,0.739595,24,53250.85559,2958.380866,2218.78565,448.571136,21,0
0,0,10,10,13,20,33,56,40,96,0.000333,0.161421,12,5811.142026,322.841224,484.261835,134.544278,8,0
0,0,12,12,14,21,35,55,45,100,0.000333,0.170976,14,7180.996224,398.944235,512.928302,145.541635,8,0
0,0,8,8,13,17,30,40,32,72,0.000333,0.117765,6,2119.776737,117.765374,353.296123,117.592585,7,0
0,0,7,7,13,17,30,36,29,65,0.000333,0.106316,6,1913.687332,106.315963,318.947889,117.592585,6,0
0,0,6,6,14,17,31,33,26,59,0.000333,0.097433,7,2046.083076,113.671282,292.297582,122.789837,5,0
0,0,6,6,12,16,28,30,23,53,0.000333,0.08493,6,1528.738865,84.929937,254.789811,107.01955,4,0
0,0,6,6,13,16,29,31,23,54,0.000333,0.087444,6,1573.985842,87.443658,262.330974,112.105716,4,0
0,0,42,42,25,55,80,256,156,412,0.000333,0.868211,24,62511.225,3472.845833,2604.634375,434.071189,19,0
0,0,41,41,25,55,80,255,154,409,0.000333,0.86189,24,62056.04618,3447.558121,2585.668591,434.071189,19,0
0,0,31,31,31,46,77,193,131,324,0.000333,0.676813,30,60913.16518,3384.064732,2030.438839,407.663936,13,0
0,0,25,25,29,42,71,146,105,251,0.000333,0.514529,28,43220.42276,2401.134598,1543.586527,367.358781,11,0
0,0,21,21,26,45,71,127,100,227,0.000333,0.465331,26,36295.8075,2016.43375,1395.992596,369.344822,25,0
0,0,25,25,25,41,66,129,92,221,0.000333,0.44527,24,32059.46641,1781.081467,1335.8111,335.756037,16,0
0,0,37,37,27,47,74,216,153,369,0.000333,0.763763,39,89360.24339,4964.457966,2291.288292,389.447639,24,0
0,0,36,36,26,50,76,197,143,340,0.000333,0.708098,26,55231.67922,3068.426623,2124.295355,404.404242,28,0
0,0,29,29,31,46,77,183,123,306,0.000333,0.639212,30,57529.10044,3196.061136,1917.636681,407.663936,12,0
0,0,23,23,29,42,71,136,97,233,0.000333,0.47763,28,40120.95021,2228.941678,1432.891079,367.358781,10,0
0,0,19,19,26,44,70,117,92,209,0.000333,0.427007,26,33306.52391,1850.36244,1281.020151,362.426424,24,0
0,0,23,23,25,41,66,119,84,203,0.000333,0.409004,24,29448.28815,1636.016008,1227.012006,335.756037,15,0
0,0,35,35,27,47,74,206,145,351,0.000333,0.726506,39,85001.20712,4722.289285,2179.518131,389.447639,23,0
0,0,34,34,26,50,76,187,135,322,0.000333,0.670611,26,52307.64914,2905.980508,2011.832659,404.404242,27,0
0,0,30,30,31,47,78,194,131,325,0.000333,0.680919,30,61282.67163,3404.592869,2042.755721,414.645762,12,0
0,0,24,24,29,43,72,147,105,252,0.000333,0.518274,28,43534.99081,2418.610601,1554.8211,374.210833,10,0
0,0,20,20,26,45,71,128,100,228,0.000333,0.467381,26,36455.70092,2025.316718,1402.142343,369.344822,24,0
0,0,24,24,25,42,67,130,92,222,0.000333,0.448891,24,32320.12321,1795.5624,1346.6718,342.573737,15,0
0,0,36,36,27,48,75,217,153,370,0.000333,0.768221,39,89881.8537,4993.436317,2304.662915,396.460163,23,0
0,0,35,35,26,51,77,198,143,341,0.000333,0.712325,26,55561.32947,3086.740526,2136.97421,411.505125,27,0
0,0,30,30,31,47,78,198,133,331,0.000333,0.693489,30,62414.04403,3467.446891,2080.468134,414.645762,13,0
0,0,24,24,29,43,72,151,107,258,0.000333,0.530614,28,44571.53821,2476.196567,1591.84065,374.210833,11,0
0,0,20,20,26,45,71,132,102,234,0.000333,0.47968,26,37415.06148,2078.614526,1439.040826,369.344822,25,0
0,0,24,24,25,42,67,134,94,228,0.000333,0.461023,24,33193.64005,1844.091114,1383.068335,342.573737,16,0
0,0,36,36,27,48,75,221,155,376,0.000333,0.780679,39,91339.39728,5074.41096,2342.035828,396.460163,24,0
0,0,35,35,26,51,77,202,145,347,0.000333,0.724858,26,56538.94817,3141.052676,2174.57493,411.505125,28,0
0,0,80,80,35,81,116,591,381,972,0.000333,2.221986,68,453285.1119,25182.50621,6665.957527,693.052756,34,0
0,0,60,60,34,76,110,479,332,811,0.000333,1.833228,68,373978.4255,20776.57919,5499.682728,647.816228,23,0
0,0,11,11,18,20,38,68,45,113,0.000333,0.197672,18,10674.28456,593.015809,593.015809,161.497212,5,0
0,0,57,57,37,56,93,489,323,812,0.000333,1.769932,90,477881.7259,26548.98477,5309.796955,517.96165,26,0
0,0,53,53,35,73,108,443,297,740,0.000333,1.666206,68,339905.9391,18883.66328,4998.616752,631.382098,20,0
0,0,33,33,27,37,64,170,124,294,0.000333,0.588,39,68796,3822,1764,321.131737,9,0
0,0,70,70,29,47,76,320,227,547,0.000333,1.139205,56,191386.5156,10632.5842,3417.61635,401.947125,21,0
0,0,61,61,29,47,76,290,206,496,0.000333,1.032991,56,173542.4346,9641.246367,3098.972047,401.947125,23,0
0,0,40,40,25,59,84,256,158,414,0.000333,0.88214,24,63514.06591,3528.559217,2646.419413,463.172345,18,0
0,0,39,39,25,59,84,255,156,411,0.000333,0.875747,24,63053.81906,3502.989948,2627.242461,463.172345,18,0
0,0,6,6,14,15,29,36,27,63,0.000333,0.102018,7,2142.369619,119.020534,306.052803,111.906328,3,0
0,0,6,6,12,12,24,25,20,45,0.000333,0.068774,6,1237.939875,68.774438,206.323313,86.0391,1,0
0,0,24,24,22,30,52,119,85,204,0.000333,0.38763,22,25583.57346,1421.309636,1162.889703,245.314213,8,0
0,0,24,24,21,31,52,136,96,232,0.000333,0.440834,30,39675.06044,2204.170024,1322.502015,245.818752,9,0
0,0,7,7,19,19,38,46,30,76,0.000333,0.132947,9,3589.582419,199.421246,398.842491,161.421246,4,0
0,0,29,29,23,41,64,167,98,265,0.000333,0.53,22,34980,1943.333333,1590,323.701557,18,0
0,0,30,30,23,42,65,175,102,277,0.000333,0.556065,22,36700.30945,2038.906081,1668.195884,330.519257,18,0
0,0,32,32,23,43,66,182,108,290,0.000333,0.584291,22,38563.23448,2142.401916,1752.874295,337.371309,18,0
0,0,28,28,21,41,62,159,94,253,0.000333,0.502137,20,30128.23333,1673.790741,1506.411667,311.898298,15,0
0,0,20,20,22,46,68,171,103,274,0.000333,0.555988,22,36695.22601,2038.623667,1667.964819,352.191346,16,0
0,0,20,20,23,44,67,169,99,268,0.000333,0.541904,22,35765.66187,1986.981215,1625.711903,344.256916,16,0
0,0,14,14,22,42,64,149,90,239,0.000333,0.478,22,31548,1752.666667,1434,324.584827,15,0
0,0,16,16,20,30,50,112,65,177,0.000333,0.332988,20,19979.25091,1109.958384,998.962546,233.64528,12,0
0,0,14,14,19,27,46,100,60,160,0.000333,0.29459,18,15907.85843,883.769913,883.769913,209.092585,10,0
0,0,12,12,19,25,44,96,60,156,0.000333,0.28389,18,15330.08399,851.671333,851.671333,196.807027,8,0
0,0,4,4,12,18,30,32,24,56,0.000333,0.091595,6,1648.71524,91.595291,274.785873,118.0782,2,0
0,0,32,32,25,41,66,148,99,247,0.000333,0.497655,24,35831.16834,1990.620463,1492.965347,335.756037,16,0
0,0,32,32,24,43,67,151,101,252,0.000333,0.509551,24,36687.70742,2038.205968,1528.654476,343.368484,16,0
0,0,37,37,27,50,77,184,120,304,0.000333,0.635034,26,49532.68082,2751.815601,1905.103108,410.574772,19,0
0,0,25,25,19,37,56,121,79,200,0.000333,0.387157,18,20906.47772,1161.470984,1161.470984,273.460397,13,0
0,0,36,36,25,50,75,183,118,301,0.000333,0.624958,24,44996.98622,2499.832568,1874.874426,398.289214,18,0
0,0,18,18,17,29,46,89,58,147,0.000333,0.270655,16,12991.41772,721.745429,811.963608,210.368317,10,0
0,0,31,31,24,44,68,163,104,267,0.000333,0.541784,24,39008.46189,2167.136771,1625.352579,350.254091,15,0
0,0,31,31,26,55,81,145,107,252,0.000333,0.532547,13,20769.34861,1153.852701,1597.642201,440.186217,16,0
0,0,28,28,25,52,77,134,98,232,0.000333,0.484631,12,17446.73373,969.262985,1453.894477,412.51927,16,0
0,0,37,37,27,66,93,236,171,407,0.000333,0.887146,26,69197.37854,3844.298808,2661.437636,527.311974,20,0
0,0,38,38,29,71,100,254,188,442,0.000333,0.978861,28,82224.36421,4568.020234,2936.584436,577.513494,22,0
0,0,73,73,34,79,113,481,355,836,0.000333,1.900557,68,387713.5337,21539.64076,5701.669613,670.972416,41,0
0,0,87,87,34,90,124,575,437,1012,0.000333,2.345882,68,478559.9733,26586.66518,7037.646666,757.240515,57,0
0,0,71,71,34,75,109,474,342,816,0.000333,1.840946,68,375553.0118,20864.05621,5522.838409,640.135138,37,0
0,0,73,73,34,78,112,478,351,829,0.000333,1.881099,68,383744.2117,21319.12287,5643.29723,663.23511,41,0
0,0,87,87,34,90,124,575,437,1012,0.000333,2.345882,68,478559.9733,26586.66518,7037.646666,757.240515,57,0
0,0,71,71,34,75,109,474,342,816,0.000333,1.840946,68,375553.0118,20864.05621,5522.838409,640.135138,37,0
0,0,73,73,34,78,112,478,351,829,0.000333,1.881099,68,383744.2117,21319.12287,5643.29723,663.23511,41,0
0,0,87,87,34,91,125,578,441,1019,0.000333,2.366045,68,482673.1247,26815.17359,7098.134186,765.183049,57,0
0,0,71,71,34,76,110,477,346,823,0.000333,1.860353,68,379512.015,21084.00083,5581.059044,647.816228,37,0
0,0,73,73,34,79,113,481,355,836,0.000333,1.900557,68,387713.5337,21539.64076,5701.669613,670.972416,41,0
0,0,30,30,26,52,78,141,103,244,0.000333,0.511213,13,19937.29584,1107.627547,1533.638141,418.634298,16,0
0,0,27,27,25,49,74,130,94,224,0.000333,0.463639,12,16691.01065,927.278369,1390.917554,391.217187,16,0
0,0,36,36,27,65,92,232,167,399,0.000333,0.867634,26,67675.43173,3759.746207,2602.90122,519.83587,20,0
0,0,37,37,29,70,99,250,184,434,0.000333,0.959047,28,80559.94165,4475.552314,2877.140773,569.93126,22,0
0,0,72,72,34,78,112,477,351,828,0.000333,1.87883,68,383281.3115,21293.4062,5636.489875,663.23511,41,0
0,0,86,86,34,89,123,571,433,1004,0.000333,2.323428,68,473979.3503,26332.18613,6970.284563,749.314012,57,0
0,0,70,70,34,74,108,470,338,808,0.000333,1.819316,68,371140.5389,20618.91883,5457.949102,632.473286,37,0
0,0,72,72,34,77,111,474,347,821,0.000333,1.859405,68,379318.649,21073.25828,5578.215426,655.5163,41,0
0,0,86,86,34,89,123,571,433,1004,0.000333,2.323428,68,473979.3503,26332.18613,6970.284563,749.314012,57,0
0,0,70,70,34,74,108,470,338,808,0.000333,1.819316,68,371140.5389,20618.91883,5457.949102,632.473286,37,0
0,0,72,72,34,77,111,474,347,821,0.000333,1.859405,68,379318.649,21073.25828,5578.215426,655.5163,41,0
0,0,86,86,34,90,124,574,437,1011,0.000333,2.343564,68,478087.0879,26560.39378,7030.69247,757.240515,57,0
0,0,70,70,34,75,109,473,342,815,0.000333,1.83869,68,375092.7753,20838.48752,5516.070225,640.135138,37,0
0,0,72,72,34,78,112,477,351,828,0.000333,1.87883,68,383281.3115,21293.4062,5636.489875,663.23511,41,0
0,0,12,12,24,28,52,91,50,141,0.000333,0.267921,12,9645.144003,535.841334,803.762,244.645038,9,0
0,0,12,12,23,26,49,86,47,133,0.000333,0.248919,11,8214.320502,456.351139,746.756409,226.253358,9,0
0,0,3,3,9,6,15,10,7,17,0.000333,0.022139,4,265.668561,14.759364,66.41714,44.0391,1,0
0,0,7,7,14,15,29,46,27,73,0.000333,0.118211,7,2482.428289,137.912683,354.632613,111.906328,2,0
0,0,29,29,23,38,61,136,90,226,0.000333,0.446782,22,29487.62604,1638.201447,1340.346638,303.463171,12,0
0,0,17,17,16,19,35,77,59,136,0.000333,0.232527,24,16741.97977,930.109987,697.58249,144.710623,4,0
0,0,22,22,18,25,43,94,70,164,0.000333,0.296636,18,16018.33356,889.90742,889.90742,191.155055,5,0
0,0,8,8,17,22,39,55,34,89,0.000333,0.1568,8,3763.20638,209.067021,470.400797,167.594364,3,0
0,0,14,14,16,35,51,93,56,149,0.000333,0.28173,8,6761.531008,375.640612,845.191376,243.524906,5,0
0,0,58,58,30,99,129,625,347,972,0.000333,2.271638,45,306671.0802,17037.28223,6814.912892,803.513023,11,0
0,0,54,54,30,99,129,609,330,939,0.000333,2.194514,45,296259.4077,16458.85598,6583.542393,803.513023,11,0
0,0,70,70,28,109,137,610,364,974,0.000333,2.304494,42,290366.2965,16131.46091,6913.483249,872.338029,21,0
0,0,69,69,28,108,136,609,362,971,0.000333,2.293975,42,289040.9096,16057.82831,6881.926419,864.133788,21,0
0,0,72,72,27,110,137,603,377,980,0.000333,2.31869,39,271286.7862,15071.48812,6956.071441,874.331531,24,0
0,0,71,71,27,109,136,602,375,977,0.000333,2.30815,39,270053.5966,15002.97759,6924.451196,866.114054,24,0
0,0,32,32,23,72,95,442,197,639,0.000333,1.399379,22,92359.03014,5131.05723,4198.137734,548.276525,3,0
0,0,31,31,23,71,94,441,195,636,0.000333,1.389573,22,91711.80721,5095.100401,4168.71851,540.67397,3,0
0,0,29,29,23,68,91,432,187,619,0.000333,1.342775,22,88623.14741,4923.508189,4028.324882,517.989398,3,0
0,0,18,18,14,45,59,171,94,265,0.000333,0.519633,14,21824.60571,1212.478095,1558.900408,300.436358,2,0
0,0,41,41,16,44,60,286,183,469,0.000333,0.923444,32,88650.61406,4925.034114,2770.331689,304.214991,4,0
0,0,35,35,14,42,56,270,170,440,0.000333,0.851745,28,71546.61264,3974.811813,2555.236166,279.780301,1,0
0,0,34,34,16,42,58,259,163,422,0.000333,0.824023,24,59329.63152,3296.09064,2472.06798,290.477332,2,0
0,0,34,34,16,42,58,252,161,413,0.000333,0.806449,24,58064.30762,3225.794868,2419.346151,290.477332,2,0
0,0,36,36,16,42,58,274,172,446,0.000333,0.870887,32,83605.10476,4644.728042,2612.659524,290.477332,2,0
0,0,35,35,16,42,58,263,165,428,0.000333,0.835739,24,60173.18078,3342.954488,2507.215866,290.477332,3,0
0,0,35,35,16,42,58,257,164,421,0.000333,0.82207,24,59189.03998,3288.279999,2466.209999,290.477332,3,0
0,0,37,37,16,42,58,278,174,452,0.000333,0.882602,32,84729.83711,4707.213173,2647.80741,290.477332,3,0
0,0,36,36,16,42,58,267,167,434,0.000333,0.847455,24,61016.73005,3389.818336,2542.363752,290.477332,4,0
0,0,36,36,16,42,58,261,166,427,0.000333,0.833786,24,60032.58924,3335.143847,2501.357885,290.477332,4,0
0,0,38,38,16,42,58,282,176,458,0.000333,0.894318,32,85854.56947,4769.698304,2682.955296,290.477332,4,0
0,0,18,18,14,34,48,127,82,209,0.000333,0.389086,14,16341.60028,907.866682,1167.257163,226.276706,1,0
0,0,17,17,14,34,48,126,80,206,0.000333,0.383501,14,16107.03185,894.835103,1150.502275,226.276706,1,0
0,0,18,18,14,31,45,116,78,194,0.000333,0.35514,14,14915.87301,828.659612,1065.419501,206.883055,1,0
0,0,17,17,14,31,45,115,76,191,0.000333,0.349648,14,14685.21518,815.845288,1048.943941,206.883055,1,0
0,0,19,19,14,36,50,127,82,209,0.000333,0.393189,14,16513.92321,917.440178,1179.565944,239.420269,4,0
0,0,18,18,14,36,50,126,80,206,0.000333,0.387545,14,16276.88125,904.271181,1162.634375,239.420269,4,0
0,0,26,26,21,46,67,129,88,217,0.000333,0.43878,10,13163.41354,731.300752,1316.341354,346.322516,14,0
0,0,21,21,15,26,41,100,76,176,0.000333,0.31431,14,13201.00814,733.389341,942.929153,180.814792,16,0
0,0,32,32,21,49,70,151,109,260,0.000333,0.531205,20,31872.27169,1770.68176,1593.613584,367.359448,19,0
0,0,3,3,12,18,30,21,20,41,0.000333,0.067061,6,1207.095087,67.060838,201.182514,118.0782,1,0
0,0,20,20,20,30,50,102,63,165,0.000333,0.310412,20,18624.72543,1034.706968,931.236271,233.64528,10,0
0,0,22,22,20,31,51,109,69,178,0.000333,0.336564,20,20193.83422,1121.879679,1009.691711,240.018648,10,0
0,0,19,19,18,30,48,91,59,150,0.000333,0.279248,9,7539.699376,418.872188,837.744375,222.265368,10,0
0,0,10,10,18,21,39,90,61,151,0.000333,0.266032,18,14365.72323,798.095735,798.095735,167.297316,4,0
0,0,8,8,18,19,37,74,50,124,0.000333,0.215324,18,11627.49991,645.972217,645.972217,155.769273,4,0
0,0,6,6,15,14,29,70,45,115,0.000333,0.186223,21,11732.0241,651.779117,558.667814,111.906328,1,0
0,0,3,3,7,10,17,16,16,32,0.000333,0.0436,3,392.396433,21.799802,130.798811,52.870765,1,0
0,0,27,27,28,39,67,167,114,281,0.000333,0.56819,28,47727.98975,2651.554986,1704.571063,340.736624,15,0
0,0,22,22,24,35,59,152,101,253,0.000333,0.496103,24,35719.4086,1984.411589,1488.308691,289.564006,13,0
0,0,52,52,37,59,96,407,270,677,0.000333,1.486007,72,320977.4121,17832.07845,4458.019613,539.825714,34,0
0,0,64,64,37,70,107,496,340,836,0.000333,1.878622,72,405782.3808,22543.4656,5635.866401,621.799586,34,0
0,0,51,51,37,59,96,398,266,664,0.000333,1.457472,72,314813.8872,17489.6604,4372.4151,539.825714,32,0
0,0,59,59,37,64,101,464,316,780,0.000333,1.731135,72,373925.1569,20773.61983,5193.404957,576.749775,34,0
0,0,69,69,30,87,117,549,356,905,0.000333,2.07256,60,373060.8043,20725.60024,6217.680071,707.742802,70,0
0,0,81,81,30,86,116,604,370,974,0.000333,2.226558,60,400780.4094,22265.5783,6679.673489,699.865487,73,0
0,0,69,69,29,78,107,550,344,894,0.000333,2.008957,56,337504.8032,18750.26685,6026.871486,631.142822,68,0
0,0,78,78,31,89,120,582,360,942,0.000333,2.168764,60,390377.4565,21687.63647,6506.290941,729.920361,71,0
0,0,66,66,30,81,111,528,334,862,0.000333,1.952262,60,351407.1886,19522.62159,5856.786477,660.734568,66,0
0,0,78,78,30,85,115,588,358,946,0.000333,2.158611,60,388550.0153,21586.11196,6475.833588,692.004947,70,0
0,0,66,66,29,77,106,534,332,866,0.000333,1.942126,56,326277.2304,18126.5128,5826.379114,623.424012,65,0
0,0,66,66,30,85,115,488,296,784,0.000333,1.788955,45,241508.889,13417.1605,5366.8642,692.004947,57,0
0,0,54,54,29,78,107,434,270,704,0.000333,1.581998,42,199331.6959,11073.9831,4745.992758,631.142822,52,0
0,0,70,70,30,88,118,562,362,924,0.000333,2.119854,60,381573.7307,21198.54059,6359.562178,715.6367,70,0
0,0,79,79,31,90,121,595,366,961,0.000333,2.216343,60,398941.6543,22163.42524,6649.027571,737.846864,71,0
0,0,67,67,30,82,112,541,340,881,0.000333,1.999093,60,359836.7812,19990.93229,5997.279686,668.525982,66,0
0,0,70,70,31,90,121,539,327,866,0.000333,1.997245,45,269628.1004,14979.33891,5991.735563,737.846864,64,0
0,0,58,58,30,83,113,485,301,786,0.000333,1.786887,45,241229.7299,13401.65166,5360.660664,676.334991,59,0
0,0,16,16,29,25,54,129,97,226,0.000333,0.433535,42,54625.39217,3034.744009,1300.604575,256.977854,14,0
0,0,7,7,11,13,24,39,37,76,0.000333,0.116152,10,3484.571501,193.587306,348.45715,86.159464,2,0
0,0,26,26,24,37,61,175,122,297,0.000333,0.587143,36,63411.44361,3522.857979,1761.428989,302.788875,14,0
0,0,13,13,22,35,57,109,74,183,0.000333,0.355806,22,23483.2152,1304.623067,1067.418873,277.632401,6,0
0,0,15,15,22,35,57,118,81,199,0.000333,0.386915,22,25536.39248,1418.688471,1160.745113,277.632401,7,0
0,0,3,3,14,12,26,33,28,61,0.000333,0.095576,14,4014.175519,223.009751,286.726823,96.322519,4,0
0,0,28,28,25,54,79,149,104,253,0.000333,0.531619,12,19138.27835,1063.237686,1594.856529,426.86033,16,0
0,0,31,31,26,57,83,160,113,273,0.000333,0.580129,13,22625.01494,1256.945275,1740.385765,454.686163,16,0
0,0,37,37,27,66,93,236,171,407,0.000333,0.887146,26,69197.37854,3844.298808,2661.437636,527.311974,20,0
0,0,38,38,29,71,100,254,188,442,0.000333,0.978861,28,82224.36421,4568.020234,2936.584436,577.513494,22,0
0,0,73,73,34,78,112,478,351,829,0.000333,1.881099,68,383744.2117,21319.12287,5643.29723,663.23511,41,0
0,0,71,71,34,75,109,474,342,816,0.000333,1.840946,68,375553.0118,20864.05621,5522.838409,640.135138,37,0
0,0,73,73,34,79,113,481,355,836,0.000333,1.900557,68,387713.5337,21539.64076,5701.669613,670.972416,41,0
0,0,71,71,34,76,110,477,346,823,0.000333,1.860353,68,379512.015,21084.00083,5581.059044,647.816228,37,0
0,0,73,73,34,79,113,481,355,836,0.000333,1.900557,68,387713.5337,21539.64076,5701.669613,670.972416,41,0
0,0,71,71,34,76,110,477,346,823,0.000333,1.860353,68,379512.015,21084.00083,5581.059044,647.816228,37,0
0,0,27,27,25,51,76,145,100,245,0.000333,0.510247,12,18368.90689,1020.494827,1530.742241,405.390097,16,0
0,0,30,30,26,54,80,156,109,265,0.000333,0.558437,26,43558.08457,2419.893587,1675.310945,432.975358,16,0
0,0,36,36,27,65,92,232,167,399,0.000333,0.867634,26,67675.43173,3759.746207,2602.90122,519.83587,20,0
0,0,37,37,29,70,99,250,184,434,0.000333,0.959047,28,80559.94165,4475.552314,2877.140773,569.93126,22,0
0,0,72,72,34,77,111,474,347,821,0.000333,1.859405,68,379318.649,21073.25828,5578.215426,655.5163,41,0
0,0,70,70,34,74,108,470,338,808,0.000333,1.819316,68,371140.5389,20618.91883,5457.949102,632.473286,37,0
0,0,72,72,34,78,112,477,351,828,0.000333,1.87883,68,383281.3115,21293.4062,5636.489875,663.23511,41,0
0,0,70,70,34,75,109,473,342,815,0.000333,1.83869,68,375092.7753,20838.48752,5516.070225,640.135138,37,0
0,0,72,72,34,78,112,477,351,828,0.000333,1.87883,68,383281.3115,21293.4062,5636.489875,663.23511,41,0
0,0,70,70,34,75,109,473,342,815,0.000333,1.83869,68,375092.7753,20838.48752,5516.070225,640.135138,37,0
0,0,12,12,24,28,52,91,50,141,0.000333,0.267921,12,9645.144003,535.841334,803.762,244.645038,9,0
0,0,12,12,23,26,49,86,47,133,0.000333,0.248919,11,8214.320502,456.351139,746.756409,226.253358,9,0
0,0,47,47,26,59,85,217,158,375,0.000333,0.801174,26,62491.56163,3471.753424,2403.521601,469.287373,23,0
0,0,38,38,24,56,80,265,157,422,0.000333,0.889285,24,64028.48775,3557.138208,2667.853656,435.250976,17,0
0,0,33,33,20,40,60,156,100,256,0.000333,0.504055,20,30243.27985,1680.182214,1512.163992,299.315686,17,0
0,0,38,38,29,64,93,259,172,431,0.000333,0.939459,28,78914.56853,4384.142696,2818.377448,524.881449,23,0
0,0,39,39,29,66,95,256,172,428,0.000333,0.937299,28,78733.14961,4374.063867,2811.8982,539.811461,23,0
0,0,38,38,29,66,95,257,172,429,0.000333,0.939489,28,78917.10557,4384.283643,2818.468056,539.811461,19,0
0,0,25,25,20,46,66,243,146,389,0.000333,0.783756,30,70538.07937,3918.782187,2351.269312,340.522412,9,0
0,0,39,39,23,62,85,307,190,497,0.000333,1.061822,33,105120.4207,5840.023375,3185.467295,473.202096,16,0
0,0,44,44,25,64,89,328,208,536,0.000333,1.156998,36,124955.7523,6941.986238,3470.993119,500.096405,16,0
0,0,45,45,25,64,89,331,209,540,0.000333,1.165632,36,125888.2579,6993.792105,3496.896053,500.096405,17,0
0,0,52,52,26,67,93,372,231,603,0.000333,1.314371,39,153781.3978,8543.410987,3943.112763,528.639408,21,0
0,0,53,53,28,69,97,382,238,620,0.000333,1.363982,42,171861.7304,9547.873912,4091.945962,556.094125,24,0
0,0,67,67,31,76,107,451,286,737,0.000333,1.656154,45,223580.7526,12421.15292,4968.461169,628.422577,30,0
0,0,71,71,32,76,108,459,296,755,0.000333,1.69998,48,244797.1231,13599.84017,5099.940064,634.842491,32,0
0,0,78,78,33,84,117,485,317,802,0.000333,1.836678,48,264481.5602,14693.42001,5510.032505,703.419669,34,0
0,0,26,26,22,45,67,159,111,270,0.000333,0.545948,22,36032.56979,2001.809433,1637.844081,345.240885,11,0
0,0,43,43,29,62,91,261,190,451,0.000333,0.978338,42,123270.6461,6848.369226,2935.015383,510.04162,15,0
0,0,46,46,30,65,95,284,203,487,0.000333,1.066507,45,143978.3857,7998.799203,3199.519681,538.660626,18,0
0,0,37,37,29,66,95,253,170,423,0.000333,0.92635,28,77813.36983,4322.96499,2779.048922,539.811461,17,0
0,0,3,3,9,6,15,10,7,17,0.000333,0.022139,4,265.668561,14.759364,66.41714,44.0391,1,0
0,0,7,7,14,15,29,46,27,73,0.000333,0.118211,7,2482.428289,137.912683,354.632613,111.906328,2,0
0,0,21,21,17,39,56,92,68,160,0.000333,0.309726,8,7433.4143,412.967461,929.176788,275.617555,12,0
0,0,21,21,17,41,58,94,69,163,0.000333,0.318284,8,7638.807218,424.378179,954.850902,289.1465,11,0
0,0,24,24,18,43,61,122,84,206,0.000333,0.407244,9,10995.58702,610.865946,1221.731892,308.388034,12,0
0,0,24,24,18,45,63,124,85,209,0.000333,0.416417,9,11243.26354,624.625752,1249.251504,322.192039,11,0
0,0,24,24,18,43,61,122,84,206,0.000333,0.407244,9,10995.58702,610.865946,1221.731892,308.388034,12,0
0,0,24,24,18,45,63,124,85,209,0.000333,0.416417,9,11243.26354,624.625752,1249.251504,322.192039,11,0
0,0,2,2,6,5,11,6,7,13,0.000333,0.014991,3,134.917833,7.495435,44.972611,27.119415,1,0
0,0,2,2,6,5,11,6,7,13,0.000333,0.014991,3,134.917833,7.495435,44.972611,27.119415,1,0
0,0,2,2,6,5,11,6,7,13,0.000333,0.014991,3,134.917833,7.495435,44.972611,27.119415,1,0
0,0,2,2,8,5,13,8,7,15,0.000333,0.018502,4,222.026383,12.334799,55.506596,35.60964,1,0
0,0,21,21,26,45,71,127,100,227,0.000333,0.465331,26,36295.8075,2016.43375,1395.992596,369.344822,25,0
0,0,31,31,31,46,77,193,131,324,0.000333,0.676813,30,60913.16518,3384.064732,2030.438839,407.663936,13,0
0,0,24,24,25,40,65,124,89,213,0.000333,0.427588,24,30786.34426,1710.352459,1282.764344,328.973529,16,0
0,0,25,25,29,42,71,146,105,251,0.000333,0.514529,28,43220.42276,2401.134598,1543.586527,367.358781,11,0
0,0,40,40,26,46,72,214,156,370,0.000333,0.760957,39,89032.01777,4946.223209,2282.872251,376.295283,24,0
0,0,71,71,29,47,76,350,271,621,0.000333,1.293321,70,271597.409,15088.74495,3879.962986,401.947125,24,0
0,0,36,36,27,46,73,189,144,333,0.000333,0.687071,39,80387.25155,4465.958419,2061.211578,382.465813,19,0
0,0,32,32,27,47,74,194,137,331,0.000333,0.68511,26,53438.55567,2968.808648,2055.329064,389.447639,28,0
0,0,19,19,26,44,70,117,92,209,0.000333,0.427007,26,33306.52391,1850.36244,1281.020151,362.426424,24,0
0,0,29,29,31,46,77,183,123,306,0.000333,0.639212,30,57529.10044,3196.061136,1917.636681,407.663936,12,0
0,0,22,22,25,39,64,114,81,195,0.000333,0.39,24,28080,1560,1170,322.227091,15,0
0,0,23,23,29,42,71,136,97,233,0.000333,0.47763,28,40120.95021,2228.941678,1432.891079,367.358781,10,0
0,0,38,38,26,46,72,204,148,352,0.000333,0.723938,39,84700.73042,4705.596134,2171.813601,376.295283,23,0
0,0,69,69,29,47,76,340,263,603,0.000333,1.255833,70,263725.0203,14651.39002,3767.500291,401.947125,23,0
0,0,34,34,27,46,73,179,136,315,0.000333,0.649932,26,50694.66314,2816.370174,1949.794736,382.465813,18,0
0,0,30,30,27,46,73,184,129,313,0.000333,0.645805,26,50372.79226,2798.488459,1937.415087,382.465813,27,0
0,0,20,20,26,45,71,128,100,228,0.000333,0.467381,26,36455.70092,2025.316718,1402.142343,369.344822,24,0
0,0,30,30,31,47,78,194,131,325,0.000333,0.680919,30,61282.67163,3404.592869,2042.755721,414.645762,12,0
0,0,23,23,25,40,65,125,89,214,0.000333,0.429596,24,30930.88109,1718.382283,1288.786712,328.973529,15,0
0,0,24,24,29,43,72,147,105,252,0.000333,0.518274,28,43534.99081,2418.610601,1554.8211,374.210833,10,0
0,0,39,39,26,47,73,215,156,371,0.000333,0.765475,39,89560.57154,4975.587308,2296.424911,383.277109,23,0
0,0,70,70,29,48,77,351,271,622,0.000333,1.299314,70,272855.886,15158.66033,3897.941228,408.959649,23,0
0,0,35,35,27,47,74,190,144,334,0.000333,0.691319,39,80884.33954,4493.574419,2073.957424,389.447639,18,0
0,0,31,31,27,47,74,195,137,332,0.000333,0.68718,26,53600.00145,2977.777858,2061.538517,389.447639,27,0
0,0,20,20,26,45,71,132,102,234,0.000333,0.47968,26,37415.06148,2078.614526,1439.040826,369.344822,25,0
0,0,30,30,31,47,78,198,133,331,0.000333,0.693489,30,62414.04403,3467.446891,2080.468134,414.645762,13,0
0,0,23,23,25,40,65,129,91,220,0.000333,0.44164,24,31798.10205,1766.561225,1324.920919,328.973529,16,0
0,0,24,24,29,43,72,151,107,258,0.000333,0.530614,28,44571.53821,2476.196567,1591.84065,374.210833,11,0
0,0,39,39,26,47,73,219,158,377,0.000333,0.777855,39,91008.99049,5056.055027,2333.563859,383.277109,24,0
0,0,70,70,29,48,77,355,273,628,0.000333,1.311847,70,275487.9363,15304.88535,3935.541948,408.959649,24,0
0,0,35,35,27,47,74,194,146,340,0.000333,0.703738,39,82337.35163,4574.297313,2111.214144,389.447639,19,0
0,0,31,31,27,47,74,199,139,338,0.000333,0.699598,26,54568.67618,3031.593121,2098.795238,389.447639,28,0
0,0,11,11,18,20,38,68,45,113,0.000333,0.197672,18,10674.28456,593.015809,593.015809,161.497212,5,0
0,0,22,22,23,33,56,139,83,222,0.000333,0.429744,22,28363.12144,1575.728969,1289.232793,270.506931,9,0
0,0,20,20,23,32,55,111,71,182,0.000333,0.350736,22,23148.56429,1286.03135,1052.207468,264.041925,9,0
0,0,57,57,37,56,93,489,323,812,0.000333,1.769932,90,477881.7259,26548.98477,5309.796955,517.96165,26,0
0,0,53,53,35,73,108,443,297,740,0.000333,1.666206,68,339905.9391,18883.66328,4998.616752,631.382098,20,0
0,0,55,55,31,52,83,379,223,602,0.000333,1.279258,60,230266.4243,12792.57913,3837.773738,450.002951,21,0
0,0,49,49,31,46,77,314,184,498,0.000333,1.040287,60,187251.5818,10402.86566,3120.859697,407.663936,21,0
0,0,43,43,31,41,72,287,162,449,0.000333,0.923432,45,124663.3347,6925.740814,2770.296326,373.239718,19,0
0,0,53,53,31,49,80,346,206,552,0.000333,1.163235,60,209382.2585,11632.3477,3489.704308,428.700868,21,0
0,0,47,47,31,43,74,281,167,448,0.000333,0.927278,45,125182.5799,6954.58777,2781.835108,386.90947,21,0
0,0,47,47,31,44,75,297,176,473,0.000333,0.982077,60,176773.8744,9820.770802,2946.231241,393.795077,19,0
0,0,41,41,31,38,69,232,137,369,0.000333,0.751349,45,101432.0486,5635.113811,2254.045525,353.001331,19,0
0,0,10,10,17,26,43,67,41,108,0.000333,0.195346,8,4688.292748,260.460708,586.036594,191.698301,4,0
0,0,7,7,15,21,36,51,31,82,0.000333,0.141311,7,2967.536951,164.863164,423.93385,150.842025,4,0
0,0,9,9,17,25,42,66,39,105,0.000333,0.188731,8,4529.546635,251.64148,566.193329,185.583273,4,0
0,0,7,7,16,20,36,51,29,80,0.000333,0.137865,8,3308.752001,183.819556,413.594,150.438562,4,0
0,0,65,65,29,62,91,427,265,692,0.000333,1.501131,56,252190.0579,14010.55877,4503.393891,510.04162,38,0
0,0,62,62,29,61,90,421,259,680,0.000333,1.471487,56,247209.7659,13733.87588,4414.460106,502.656426,38,0
0,0,33,33,27,37,64,170,124,294,0.000333,0.588,39,68796,3822,1764,321.131737,9,0
0,0,70,70,29,47,76,320,227,547,0.000333,1.139205,56,191386.5156,10632.5842,3417.61635,401.947125,21,0
0,0,61,61,29,47,76,290,206,496,0.000333,1.032991,56,173542.4346,9641.246367,3098.972047,401.947125,23,0
0,0,11,11,10,18,28,48,37,85,0.000333,0.136208,10,4086.251684,227.013982,408.625168,108.277931,1,0
0,0,11,11,10,18,28,46,36,82,0.000333,0.131401,10,3942.031036,219.001724,394.203104,108.277931,1,0
0,0,15,15,13,27,40,74,53,127,0.000333,0.225295,6,4055.309208,225.294956,675.884868,176.487679,4,0
0,0,5,5,9,12,21,24,18,42,0.000333,0.061492,4,737.909327,40.994963,184.477332,71.548875,1,0
0,0,8,8,19,11,30,165,28,193,0.000333,0.315677,18,17046.53793,947.029885,947.029885,118.764371,8,0
0,0,12,12,15,28,43,71,43,114,0.000333,0.206198,7,4330.159274,240.564404,618.594182,193.209297,6,0
0,0,12,12,14,28,42,69,42,111,0.000333,0.199516,7,4189.830637,232.768369,598.547234,187.908907,6,0
0,0,16,16,16,37,53,93,58,151,0.000333,0.288305,8,6919.327909,384.407106,864.915989,256.749775,9,0
0,0,10,10,13,25,38,55,37,92,0.000333,0.160936,6,2896.855987,160.936444,482.809331,164.202121,6,0
0,0,28,28,20,51,71,139,96,235,0.000333,0.48173,10,14451.90573,802.883652,1445.190573,375.732254,14,0
0,0,34,34,20,54,74,159,117,276,0.000333,0.57127,20,34276.18258,1904.232365,1713.809129,397.202487,17,0
0,0,22,22,16,32,48,110,83,193,0.000333,0.359299,16,17246.3642,958.131345,1077.897763,224,14,0
0,0,37,37,25,57,82,199,127,326,0.000333,0.690854,24,49741.48688,2763.415938,2072.561954,448.571136,24,0
0,0,30,30,19,45,64,157,107,264,0.000333,0.528,18,28512,1584,1584,327.844012,21,0
0,0,22,22,18,34,52,125,85,210,0.000333,0.399031,18,21547.66214,1197.092341,1197.092341,248.032387,20,0
0,0,44,44,22,43,65,283,179,462,0.000333,0.927445,44,122422.6929,6801.260717,2782.33393,331.43688,17,0
0,0,42,42,22,40,62,275,173,448,0.000333,0.88916,44,117369.1177,6520.506537,2667.479947,310.984619,17,0
0,0,55,55,28,49,77,354,228,582,0.000333,1.215757,56,204247.1069,11347.0615,3647.269767,409.72672,20,0
0,0,41,41,22,40,62,274,172,446,0.000333,0.885191,44,116845.1484,6491.397133,2655.571554,310.984619,16,0
0,0,60,60,28,50,78,401,253,654,0.000333,1.370218,70,287745.7136,15985.87298,4110.653051,416.798747,23,0
0,0,72,72,29,52,81,493,313,806,0.000333,1.703306,84,429233.2046,23846.28914,5109.919102,437.304314,26,0
0,0,37,37,21,37,58,243,156,399,0.000333,0.779111,40,93493.37668,5194.076482,2337.334417,284.98844,15,0
0,0,30,30,21,31,52,156,105,261,0.000333,0.495938,30,44634.44299,2479.691277,1487.814766,245.818752,15,0
0,0,17,17,22,25,47,89,67,156,0.000333,0.288839,22,19063.34894,1059.074941,866.515861,214.2039,6,0
0,0,16,16,21,21,42,84,62,146,0.000333,0.262426,20,15745.56688,874.753715,787.278344,184.477332,6,0
0,0,84,84,29,55,84,527,322,849,0.000333,1.809026,70,379895.4244,21105.30136,5427.077492,458.856233,34,0
0,0,28,28,23,46,69,163,104,267,0.000333,0.543659,22,35881.47266,1993.415148,1630.97603,358.125775,17,0
0,0,33,33,24,59,83,205,128,333,0.000333,0.707629,24,50949.31514,2830.517508,2122.888131,457.11504,19,0
0,0,19,19,20,28,48,90,58,148,0.000333,0.275525,20,16531.489,918.416056,826.57445,221.0445,10,0
0,0,3,3,8,8,16,30,12,42,0.000333,0.056,4,672,37.333333,168,48,3,0
0,0,2,2,7,7,14,17,8,25,0.000333,0.031728,3,285.551619,15.863979,95.183873,39.302969,3,0
0,0,2,2,6,5,11,6,7,13,0.000333,0.014991,3,134.917833,7.495435,44.972611,27.119415,1,0
0,0,2,2,6,5,11,6,7,13,0.000333,0.014991,3,134.917833,7.495435,44.972611,27.119415,1,0
0,0,2,2,6,5,11,6,7,13,0.000333,0.014991,3,134.917833,7.495435,44.972611,27.119415,1,0
0,0,2,2,8,5,13,8,7,15,0.000333,0.018502,4,222.026383,12.334799,55.506596,35.60964,1,0
0,0,3,3,10,16,26,19,19,38,0.000333,0.059539,5,893.083546,49.615753,178.616709,97.219281,1,0
0,0,41,41,27,30,57,176,119,295,0.000333,0.573568,39,67107.39961,3728.188867,1720.702554,275.58868,13,0
0,0,47,47,27,31,58,218,141,359,0.000333,0.701005,52,109356.7892,6075.377179,2103.015177,281.962048,16,0
0,0,30,30,26,30,56,158,93,251,0.000333,0.485882,39,56848.19733,3158.233185,1457.646085,269.418151,9,0
0,0,27,27,25,28,53,148,89,237,0.000333,0.452506,36,48870.61732,2715.034295,1357.517148,250.702343,9,0
0,0,20,20,24,25,49,113,70,183,0.000333,0.342497,24,24659.80564,1369.989202,1027.491901,226.135505,7,0
0,0,72,72,26,49,75,544,216,760,0.000333,1.577967,52,246162.9146,13675.71748,4733.902205,397.332215,70,0
0,0,77,77,29,60,89,635,264,899,0.000333,1.940561,56,326014.3238,18111.90688,5821.684354,495.294885,70,0
0,0,71,71,27,49,76,563,228,791,0.000333,1.64737,52,256989.7545,14277.20858,4942.110663,403.502745,67,0
0,0,70,70,27,50,77,562,226,788,0.000333,1.646076,52,256787.8453,14265.99141,4938.227794,410.574772,66,0
0,0,70,70,28,48,76,562,224,786,0.000333,1.636957,56,275008.7774,15278.26541,4910.871026,402.684138,66,0
0,0,77,77,29,60,89,635,264,899,0.000333,1.940561,56,326014.3238,18111.90688,5821.684354,495.294885,70,0
0,0,71,71,27,49,76,554,226,780,0.000333,1.624461,52,253415.9399,14078.66333,4873.38346,403.502745,67,0
0,0,70,70,27,50,77,562,226,788,0.000333,1.646076,52,256787.8453,14265.99141,4938.227794,410.574772,66,0
0,0,70,70,28,48,76,562,224,786,0.000333,1.636957,56,275008.7774,15278.26541,4910.871026,402.684138,66,0
0,0,74,74,27,52,79,579,241,820,0.000333,1.723033,52,268793.2111,14932.95617,5169.100214,424.804828,68,0
0,0,74,74,27,52,79,578,241,819,0.000333,1.720932,52,268465.4145,14914.74525,5162.796433,424.804828,68,0
0,0,33,33,31,49,80,248,156,404,0.000333,0.851353,45,114932.6528,6385.147376,2554.05895,428.700868,13,0
0,0,24,24,27,41,68,144,106,250,0.000333,0.507289,26,39568.50847,2198.25047,1521.86571,348.041595,10,0
0,0,25,25,25,41,66,129,92,221,0.000333,0.44527,24,32059.46641,1781.081467,1335.8111,335.756037,16,0
0,0,41,41,32,55,87,235,171,406,0.000333,0.871945,48,125560.0828,6975.560158,2615.835059,477.974784,24,0
0,0,32,32,29,47,76,214,154,368,0.000333,0.766412,42,96567.96765,5364.887092,2299.237325,401.947125,22,0
0,0,31,31,31,49,80,238,148,386,0.000333,0.813421,45,109811.891,6100.660612,2440.264245,428.700868,12,0
0,0,22,22,27,41,68,134,98,232,0.000333,0.470764,26,36719.57586,2039.976437,1412.291379,348.041595,9,0
0,0,23,23,25,41,66,119,84,203,0.000333,0.409004,24,29448.28815,1636.016008,1227.012006,335.756037,15,0
0,0,39,39,32,55,87,225,163,388,0.000333,0.833287,32,79995.58644,4444.199247,2499.862076,477.974784,23,0
0,0,30,30,29,47,76,204,146,350,0.000333,0.728925,42,91844.53445,5102.474136,2186.77463,401.947125,21,0
0,0,32,32,31,50,81,249,156,405,0.000333,0.85588,45,115543.7663,6419.098128,2567.639251,435.772895,12,0
0,0,23,23,27,42,69,145,106,251,0.000333,0.51108,26,39864.23061,2214.679478,1533.239639,354.859294,9,0
0,0,24,24,25,42,67,130,92,222,0.000333,0.448891,24,32320.12321,1795.5624,1346.6718,342.573737,15,0
0,0,40,40,32,56,88,236,171,407,0.000333,0.87633,48,126191.4561,7010.63645,2628.988669,485.211876,23,0
0,0,31,31,29,48,77,215,154,369,0.000333,0.770815,42,97122.65781,5395.703212,2312.444234,408.959649,21,0
0,0,32,32,31,50,81,253,158,411,0.000333,0.868559,45,117255.5258,6514.195878,2605.678351,435.772895,13,0
0,0,23,23,27,42,69,149,108,257,0.000333,0.523297,26,40817.16042,2267.620023,1569.890785,354.859294,10,0
0,0,24,24,25,42,67,134,94,228,0.000333,0.461023,24,33193.64005,1844.091114,1383.068335,342.573737,16,0
0,0,40,40,32,56,88,240,173,413,0.000333,0.889248,48,128051.7724,7113.987356,2667.745258,485.211876,24,0
0,0,31,31,29,48,77,219,156,375,0.000333,0.783348,42,98701.88802,5483.438223,2350.044953,408.959649,22,0
0,0,11,11,18,20,38,68,45,113,0.000333,0.197672,18,10674.28456,593.015809,593.015809,161.497212,5,0
0,0,29,29,36,52,88,316,207,523,0.000333,1.126094,54,182427.2678,10134.84821,3378.282737,482.540165,13,0
0,0,49,49,31,46,77,314,184,498,0.000333,1.040287,60,187251.5818,10402.86566,3120.859697,407.663936,21,0
0,0,19,19,24,31,55,166,104,270,0.000333,0.520322,36,56194.81642,3121.934245,1560.967123,263.619186,7,0
0,0,43,43,31,41,72,287,162,449,0.000333,0.923432,45,124663.3347,6925.740814,2770.296326,373.239718,19,0
0,0,47,47,31,43,74,281,167,448,0.000333,0.927278,45,125182.5799,6954.58777,2781.835108,386.90947,21,0
0,0,17,17,24,28,52,133,87,220,0.000333,0.418032,36,45147.48257,2508.193476,1254.096738,244.645038,7,0
0,0,41,41,31,38,69,232,137,369,0.000333,0.751349,45,101432.0486,5635.113811,2254.045525,353.001331,19,0
0,0,11,11,20,23,43,84,57,141,0.000333,0.255034,20,15302.06661,850.114812,765.10333,190.480487,5,0
0,0,44,44,22,43,65,283,179,462,0.000333,0.927445,44,122422.6929,6801.260717,2782.33393,331.43688,17,0
0,0,42,42,22,40,62,275,173,448,0.000333,0.88916,44,117369.1177,6520.506537,2667.479947,310.984619,17,0
0,0,55,55,28,49,77,354,228,582,0.000333,1.215757,56,204247.1069,11347.0615,3647.269767,409.72672,20,0
0,0,41,41,22,40,62,274,172,446,0.000333,0.885191,44,116845.1484,6491.397133,2655.571554,310.984619,16,0
0,0,60,60,28,50,78,401,253,654,0.000333,1.370218,70,287745.7136,15985.87298,4110.653051,416.798747,23,0
0,0,72,72,29,52,81,493,313,806,0.000333,1.703306,84,429233.2046,23846.28914,5109.919102,437.304314,26,0
0,0,37,37,21,37,58,243,156,399,0.000333,0.779111,40,93493.37668,5194.076482,2337.334417,284.98844,15,0
0,0,17,17,22,25,47,89,67,156,0.000333,0.288839,22,19063.34894,1059.074941,866.515861,214.2039,6,0
0,0,16,16,21,21,42,84,62,146,0.000333,0.262426,20,15745.56688,874.753715,787.278344,184.477332,6,0
0,0,30,30,21,31,52,156,105,261,0.000333,0.495938,30,44634.44299,2479.691277,1487.814766,245.818752,15,0
0,0,84,84,29,55,84,527,322,849,0.000333,1.809026,70,379895.4244,21105.30136,5427.077492,458.856233,34,0
0,0,34,34,25,52,77,267,156,423,0.000333,0.883617,36,95430.62544,5301.701413,2650.850707,412.51927,21,0
0,0,36,36,25,53,78,274,162,436,0.000333,0.913478,36,98655.67323,5480.870735,2740.435367,419.676189,21,0
0,0,33,33,23,51,74,262,153,415,0.000333,0.858974,33,85038.46384,4724.359102,2576.923147,393.335617,19,0
0,0,39,39,27,47,74,212,139,351,0.000333,0.726506,26,56667.47142,3148.192856,2179.518131,389.447639,29,0
0,0,36,36,28,50,78,223,146,369,0.000333,0.773104,28,64940.77573,3607.820874,2319.313419,416.798747,36,0
0,0,85,85,39,76,115,548,324,872,0.000333,1.989756,76,453664.3167,25203.57315,5969.267324,680.973178,55,0
0,0,48,48,28,62,90,299,201,500,0.000333,1.081976,42,136328.915,7573.828612,3245.926548,503.766109,27,0
0,0,66,66,27,45,72,386,212,598,0.000333,1.229872,52,191859.9878,10658.88821,3689.615151,375.515352,43,0
0,0,36,36,27,44,71,202,131,333,0.000333,0.682622,26,53244.51056,2958.028364,2047.865791,368.596954,24,0
0,0,37,37,28,50,78,225,146,371,0.000333,0.777295,28,65292.75825,3627.375458,2331.884223,416.798747,36,0
0,0,63,63,37,65,102,436,259,695,0.000333,1.545779,54,250416.1231,13912.00684,4637.335613,584.203682,39,0
0,0,49,49,28,62,90,301,201,502,0.000333,1.086303,42,136874.2307,7604.123927,3258.910254,503.766109,27,0
0,0,40,40,27,47,74,215,140,355,0.000333,0.734785,26,57313.25457,3184.069698,2204.355945,389.447639,29,0
0,0,37,37,28,50,78,226,147,373,0.000333,0.781485,28,65644.74077,3646.930043,2344.455028,416.798747,36,0
0,0,86,86,39,76,115,551,325,876,0.000333,1.998883,76,455745.3456,25319.18587,5996.649285,680.973178,55,0
0,0,49,49,28,62,90,302,202,504,0.000333,1.090631,42,137419.5463,7634.419241,3271.893961,503.766109,27,0
0,0,67,67,27,45,72,389,213,602,0.000333,1.238098,52,193143.3322,10730.18513,3714.294851,375.515352,43,0
0,0,37,37,27,44,71,205,132,337,0.000333,0.690822,39,80826.12639,4490.340355,2072.464779,368.596954,24,0
0,0,38,38,28,50,78,228,147,375,0.000333,0.785675,28,65996.7233,3666.484628,2357.025832,416.798747,36,0
0,0,64,64,37,65,102,439,260,699,0.000333,1.554675,72,335809.8226,18656.10126,4664.025314,584.203682,39,0
0,0,50,50,28,62,90,304,202,506,0.000333,1.094959,42,137964.862,7664.714556,3284.877667,503.766109,27,0
0,0,11,11,15,17,32,128,72,200,0.000333,0.333333,28,28000,1555.555556,1000,128.090227,19,0
0,0,46,46,30,42,72,292,165,457,0.000333,0.939885,45,126884.5077,7049.139314,2819.655726,373.68405,29,0
0,0,31,31,27,52,79,222,157,379,0.000333,0.796378,39,93176.18324,5176.454624,2389.132904,424.804828,37,0
0,0,79,79,37,85,122,562,353,915,0.000333,2.113875,72,456596.9758,25366.49866,6341.624664,737.548004,66,0
0,0,54,54,36,70,106,408,263,671,0.000333,1.504812,54,243779.4698,13543.30388,4514.434625,615.167111,36,0
0,0,66,66,32,82,114,421,311,732,0.000333,1.667225,48,240080.4235,13337.80131,5001.67549,681.319264,33,0
0,0,58,58,29,79,108,383,278,661,0.000333,1.488327,42,187529.1868,10418.28816,4464.980639,638.880128,31,0
0,0,17,17,20,38,58,132,77,209,0.000333,0.408106,20,24486.36056,1360.353364,1224.318028,285.859807,11,0
0,0,20,20,22,43,65,148,90,238,0.000333,0.477775,22,31533.11787,1751.839882,1433.32354,331.43688,12,0
0,0,20,20,22,41,63,149,89,238,0.000333,0.474198,22,31297.03768,1738.724316,1422.592622,317.767128,13,0
0,0,25,25,22,49,71,184,121,305,0.000333,0.625224,22,41264.80317,2292.489065,1875.672871,373.228278,16,0
0,0,30,30,22,50,72,213,140,353,0.000333,0.725995,22,47915.63756,2661.979865,2177.983526,380.300305,19,0
0,0,17,17,22,37,59,143,82,225,0.000333,0.441198,22,29119.08309,1617.726839,1323.594686,290.85727,11,0
0,0,20,20,24,42,66,159,95,254,0.000333,0.511759,24,36846.62655,2047.034808,1535.276106,336.516432,12,0
0,0,20,20,24,40,64,160,94,254,0.000333,0.508,24,36576,2032,1524,322.916224,13,0
0,0,25,25,24,48,72,195,126,321,0.000333,0.660182,24,47533.10221,2640.727901,1980.545925,378.1173,16,0
0,0,30,30,24,49,73,224,145,369,0.000333,0.761348,24,54817.08629,3045.393683,2284.045262,385.159882,19,0
0,0,3,3,10,14,24,23,18,41,0.000333,0.062661,5,939.917313,52.217628,187.983463,86.52225,2,0
0,0,13,13,20,30,50,99,76,175,0.000333,0.329225,20,19753.49666,1097.416481,987.674833,233.64528,9,0
0,0,18,18,20,32,52,128,95,223,0.000333,0.423733,20,25423.96114,1412.442286,1271.198057,246.438562,12,0
0,0,39,39,25,33,58,220,130,350,0.000333,0.683431,36,73810.56054,4100.586697,2050.293348,282.561411,21,0
0,0,7,7,18,22,40,148,44,192,0.000333,0.340603,18,18392.5835,1021.810194,1021.810194,173.166146,1,0
0,0,8,8,14,79,93,307,206,513,0.000333,1.118196,14,46964.23858,2609.124366,3354.58847,551.301648,4,0
0,0,7,7,14,83,97,326,225,551,0.000333,1.212184,14,50911.72767,2828.429315,3636.551976,582.431242,3,0
0,0,7,7,14,77,91,328,224,552,0.000333,1.197434,14,50292.23698,2794.013166,3592.302641,535.845533,3,0
0,0,7,7,14,70,84,280,183,463,0.000333,0.986548,14,41435.00153,2301.94453,2959.642967,482.35278,3,0
0,0,3,3,9,13,22,16,16,32,0.000333,0.047567,4,570.807247,31.711514,142.701812,76.635041,1,0
0,0,4,4,11,14,25,28,23,51,0.000333,0.078946,5,1184.183328,65.787963,236.836666,91.356717,2,0
0,0,6,6,20,20,40,58,41,99,0.000333,0.175624,20,10537.41763,585.41209,526.870881,172.877124,6,0
0,0,7,7,19,18,37,61,42,103,0.000333,0.178858,18,9658.32654,536.573697,536.573697,155.769273,7,0
0,0,7,7,19,18,37,60,40,100,0.000333,0.173648,18,9377.016058,520.945337,520.945337,155.769273,7,0
0,0,6,6,19,17,36,57,40,97,0.000333,0.167161,18,9026.689053,501.482725,501.482725,150.197491,6,0
0,0,59,59,29,57,86,463,276,739,0.000333,1.583003,56,265944.5406,14774.6967,4749.009654,473.35618,40,0
0,0,58,58,31,47,78,412,240,652,0.000333,1.366027,75,307356.1685,17075.3427,4098.082247,414.645762,35,0
0,0,3,3,11,10,21,19,14,33,0.000333,0.048315,5,724.732375,40.26291,144.946475,71.273029,2,0
0,0,4,4,11,13,24,27,19,46,0.000333,0.070303,5,1054.541375,58.585632,210.908275,86.159464,1,0
0,0,45,45,23,47,70,244,132,376,0.000333,0.768203,22,50701.42912,2816.746062,2304.610414,365.107601,21,0
0,0,41,41,21,43,64,207,112,319,0.000333,0.638,20,38280,2126.666667,1914,325.56805,18,0
0,0,37,37,21,37,58,182,99,281,0.000333,0.548698,20,32921.85319,1828.991844,1646.09266,284.98844,14,0
0,0,38,38,21,38,59,189,101,290,0.000333,0.568655,20,34119.32969,1895.518316,1705.966484,291.659911,15,0
0,0,45,45,23,47,70,251,135,386,0.000333,0.788634,22,52049.87138,2891.659521,2365.903245,365.107601,21,0
0,0,41,41,21,43,64,214,115,329,0.000333,0.658,20,39480,2193.333333,1974,325.56805,18,0
0,0,37,37,21,37,58,189,102,291,0.000333,0.568224,20,34093.44939,1894.080522,1704.67247,284.98844,14,0
0,0,38,38,21,38,59,196,104,300,0.000333,0.588264,20,35295.8583,1960.881016,1764.792915,291.659911,15,0
0,0,41,41,23,44,67,232,123,355,0.000333,0.717821,22,47376.15658,2632.008699,2153.461663,344.256916,19,0
0,0,37,37,21,40,61,195,103,298,0.000333,0.58912,20,35347.19453,1963.73303,1767.359727,305.11579,16,0
0,0,33,33,21,34,55,170,90,260,0.000333,0.501051,20,30063.07051,1670.170584,1503.153526,265.212402,12,0
0,0,34,34,21,35,56,177,92,269,0.000333,0.520726,20,31243.56948,1735.75386,1562.178474,271.763571,13,0
0,0,36,36,23,40,63,206,110,316,0.000333,0.629607,22,41554.05003,2308.558335,1888.820456,316.919049,17,0
0,0,32,32,21,36,57,169,90,259,0.000333,0.503573,20,30214.37027,1678.576126,1510.718514,278.355966,14,0
0,0,28,28,21,30,51,144,77,221,0.000333,0.417869,20,25072.12001,1392.895556,1253.606001,239.445384,10,0
0,0,29,29,21,31,52,151,79,230,0.000333,0.437034,20,26222.0227,1456.779039,1311.101135,245.818752,11,0
0,0,39,39,23,41,64,228,119,347,0.000333,0.694,22,45804,2544.666667,2082,323.701557,17,0
0,0,35,35,21,37,58,191,99,290,0.000333,0.566271,20,33976.28977,1887.571654,1698.814489,284.98844,14,0
0,0,31,31,21,31,52,166,86,252,0.000333,0.478837,20,28730.21618,1596.123121,1436.510809,245.818752,10,0
0,0,32,32,21,32,53,173,88,261,0.000333,0.498329,20,29899.74477,1661.096932,1494.987239,252.238666,11,0
0,0,44,44,23,46,69,242,130,372,0.000333,0.757457,22,49992.16415,2777.342453,2272.371098,358.125775,21,0
0,0,40,40,21,42,63,205,110,315,0.000333,0.627614,20,37656.86352,2092.047973,1882.843176,318.715998,18,0
0,0,36,36,21,36,57,180,97,277,0.000333,0.53857,20,32314.21068,1795.233927,1615.710534,278.355966,14,0
0,0,37,37,21,37,58,187,99,286,0.000333,0.558461,20,33507.65129,1861.536183,1675.382565,284.98844,15,0
0,0,39,39,20,42,62,218,116,334,0.000333,0.662901,20,39774.03135,2209.668409,1988.701568,312.915894,19,0
0,0,35,35,18,38,56,181,96,277,0.000333,0.536212,18,28955.47164,1608.637313,1608.637313,274.479896,16,0
0,0,31,31,18,32,50,156,83,239,0.000333,0.449627,18,24279.86933,1348.881629,1348.881629,235.05865,12,0
0,0,32,32,18,33,51,163,85,248,0.000333,0.46892,18,25321.70673,1406.761485,1406.761485,241.523656,13,0
0,0,31,31,20,38,58,183,98,281,0.000333,0.548698,20,32921.85319,1828.991844,1646.09266,285.859807,15,0
0,0,27,27,18,34,52,146,78,224,0.000333,0.425633,18,22984.17294,1276.898497,1276.898497,248.032387,12,0
0,0,23,23,18,28,46,121,65,186,0.000333,0.342461,18,18492.88543,1027.382524,1027.382524,209.664588,8,0
0,0,24,24,18,29,47,128,67,195,0.000333,0.361048,18,19496.60687,1083.144826,1083.144826,215.940099,9,0
0,0,5,5,14,21,35,53,31,84,0.000333,0.14362,7,3016.018414,167.556579,430.859773,145.541635,3,0
0,0,21,21,29,28,57,131,68,199,0.000333,0.386915,28,32500.86316,1805.603509,1160.745113,275.487387,10,0
0,0,14,14,23,22,45,89,44,133,0.000333,0.243472,22,16069.16216,892.731231,730.416462,202.149421,5,0
0,0,5,5,15,14,29,36,23,59,0.000333,0.09554,7,2006.346151,111.463675,286.620879,111.906328,2,0
0,0,13,13,25,26,51,128,70,198,0.000333,0.37438,24,26955.36523,1497.52029,1123.140218,238.307837,7,0
0,0,12,12,24,26,50,126,69,195,0.000333,0.366851,24,26413.24697,1467.402609,1100.551957,232.250533,7,0
0,0,79,79,32,67,99,582,346,928,0.000333,2.050681,80,492163.4355,27342.41308,6152.042943,566.427976,47,0
0,0,79,79,32,68,100,582,347,929,0.000333,2.057381,80,493771.392,27431.744,6172.1424,573.947473,47,0
0,0,79,79,30,62,92,567,336,903,0.000333,1.963592,75,441808.2335,24544.90186,5890.776446,516.366889,47,0
0,0,41,41,27,30,57,176,119,295,0.000333,0.573568,39,67107.39961,3728.188867,1720.702554,275.58868,13,0
0,0,47,47,27,31,58,218,141,359,0.000333,0.701005,52,109356.7892,6075.377179,2103.015177,281.962048,16,0
0,0,30,30,26,30,56,158,93,251,0.000333,0.485882,39,56848.19733,3158.233185,1457.646085,269.418151,9,0
0,0,27,27,25,28,53,148,89,237,0.000333,0.452506,36,48870.61732,2715.034295,1357.517148,250.702343,9,0
0,0,20,20,24,25,49,113,70,183,0.000333,0.342497,24,24659.80564,1369.989202,1027.491901,226.135505,7,0
0,0,72,72,26,49,75,544,216,760,0.000333,1.577967,52,246162.9146,13675.71748,4733.902205,397.332215,70,0
0,0,71,71,27,49,76,554,226,780,0.000333,1.624461,52,253415.9399,14078.66333,4873.38346,403.502745,67,0
0,0,70,70,27,50,77,562,226,788,0.000333,1.646076,52,256787.8453,14265.99141,4938.227794,410.574772,66,0
0,0,70,70,28,48,76,562,224,786,0.000333,1.636957,56,275008.7774,15278.26541,4910.871026,402.684138,66,0
0,0,77,77,29,60,89,635,264,899,0.000333,1.940561,56,326014.3238,18111.90688,5821.684354,495.294885,70,0
0,0,77,77,29,60,89,635,264,899,0.000333,1.940561,56,326014.3238,18111.90688,5821.684354,495.294885,70,0
0,0,71,71,27,49,76,563,228,791,0.000333,1.64737,52,256989.7545,14277.20858,4942.110663,403.502745,67,0
0,0,70,70,27,50,77,562,226,788,0.000333,1.646076,52,256787.8453,14265.99141,4938.227794,410.574772,66,0
0,0,70,70,28,48,76,562,224,786,0.000333,1.636957,56,275008.7774,15278.26541,4910.871026,402.684138,66,0
0,0,74,74,27,52,79,578,241,819,0.000333,1.720932,52,268465.4145,14914.74525,5162.796433,424.804828,68,0
0,0,74,74,27,52,79,579,241,820,0.000333,1.723033,52,268793.2111,14932.95617,5169.100214,424.804828,68,0
0,0,20,20,22,46,68,171,103,274,0.000333,0.555988,22,36695.22601,2038.623667,1667.964819,352.191346,16,0
0,0,20,20,23,44,67,169,99,268,0.000333,0.541904,22,35765.66187,1986.981215,1625.711903,344.256916,16,0
0,0,14,14,22,42,64,149,90,239,0.000333,0.478,22,31548,1752.666667,1434,324.584827,15,0
0,0,18,18,21,34,55,123,73,196,0.000333,0.377716,20,22662.93008,1259.051671,1133.146504,265.212402,13,0
0,0,14,14,19,27,46,100,60,160,0.000333,0.29459,18,15907.85843,883.769913,883.769913,209.092585,10,0
0,0,12,12,19,25,44,96,60,156,0.000333,0.28389,18,15330.08399,851.671333,851.671333,196.807027,8,0
0,0,11,11,17,24,41,54,38,92,0.000333,0.164298,8,3943.158275,219.064349,492.894784,179.525968,4,0
0,0,4,4,12,18,30,32,24,56,0.000333,0.091595,6,1648.71524,91.595291,274.785873,118.0782,2,0
0,0,14,14,18,25,43,57,40,97,0.000333,0.175449,9,4737.129131,263.173841,526.347681,191.155055,7,0
0,0,11,11,18,23,41,51,34,85,0.000333,0.151797,9,4098.527284,227.69596,455.39192,179.100575,7,0
0,0,2,2,6,5,11,6,7,13,0.000333,0.014991,3,134.917833,7.495435,44.972611,27.119415,1,0
0,0,2,2,6,5,11,6,7,13,0.000333,0.014991,3,134.917833,7.495435,44.972611,27.119415,1,0
0,0,2,2,6,5,11,6,7,13,0.000333,0.014991,3,134.917833,7.495435,44.972611,27.119415,1,0
0,0,2,2,8,5,13,8,7,15,0.000333,0.018502,4,222.026383,12.334799,55.506596,35.60964,1,0
0,0,10,10,15,34,49,108,72,180,0.000333,0.336883,14,14149.06881,786.059378,1010.647772,231.577096,5,0
0,0,18,18,14,35,49,145,96,241,0.000333,0.451048,14,18944.03101,1052.446167,1353.145072,232.827875,11,0
0,0,8,8,13,22,35,58,43,101,0.000333,0.172686,6,3108.345508,172.685862,518.057585,146.213212,2,0
0,0,16,16,12,23,35,95,67,162,0.000333,0.276981,12,9971.326185,553.962566,830.943849,147.061475,8,0
0,0,38,38,22,48,70,243,143,386,0.000333,0.788634,22,52049.87138,2891.659521,2365.903245,366.185696,16,0
0,0,37,37,22,48,70,242,141,383,0.000333,0.782505,22,51645.3387,2869.185483,2347.515395,366.185696,16,0
0,0,9,9,14,23,37,44,32,76,0.000333,0.131973,7,2771.429191,153.968288,395.918456,157.344894,4,0
0,0,44,44,22,43,65,283,179,462,0.000333,0.927445,44,122422.6929,6801.260717,2782.33393,331.43688,17,0
0,0,42,42,22,40,62,275,173,448,0.000333,0.88916,44,117369.1177,6520.506537,2667.479947,310.984619,17,0
0,0,55,55,28,49,77,354,228,582,0.000333,1.215757,56,204247.1069,11347.0615,3647.269767,409.72672,20,0
0,0,41,41,22,40,62,274,172,446,0.000333,0.885191,44,116845.1484,6491.397133,2655.571554,310.984619,16,0
0,0,60,60,28,50,78,401,253,654,0.000333,1.370218,70,287745.7136,15985.87298,4110.653051,416.798747,23,0
0,0,72,72,29,52,81,493,313,806,0.000333,1.703306,84,429233.2046,23846.28914,5109.919102,437.304314,26,0
0,0,37,37,21,37,58,243,156,399,0.000333,0.779111,40,93493.37668,5194.076482,2337.334417,284.98844,15,0
0,0,30,30,21,31,52,156,105,261,0.000333,0.495938,30,44634.44299,2479.691277,1487.814766,245.818752,15,0
0,0,17,17,22,25,47,89,67,156,0.000333,0.288839,22,19063.34894,1059.074941,866.515861,214.2039,6,0
0,0,16,16,21,21,42,84,62,146,0.000333,0.262426,20,15745.56688,874.753715,787.278344,184.477332,6,0
0,0,84,84,29,55,84,527,322,849,0.000333,1.809026,70,379895.4244,21105.30136,5427.077492,458.856233,34,0
0,0,9,9,15,22,37,47,31,78,0.000333,0.135446,7,2844.361538,158.020085,406.337363,156.710855,4,0
0,0,3,3,11,12,23,17,14,31,0.000333,0.046743,5,701.152103,38.952895,140.230421,81.073298,1,0
0,0,29,29,19,48,67,180,86,266,0.000333,0.53786,9,14522.21752,806.789862,1613.579725,348.788823,8,0
0,0,66,66,36,65,101,447,313,760,0.000333,1.686747,72,364337.3323,20240.96291,5060.240727,577.571208,51,0
0,0,67,67,37,71,108,454,327,781,0.000333,1.758522,72,379840.834,21102.26856,5275.567139,629.38182,50,0
0,0,66,66,36,65,101,442,309,751,0.000333,1.666772,72,360022.8113,20001.26729,5000.316824,577.571208,50,0
0,0,4,4,10,16,26,26,20,46,0.000333,0.072073,5,1081.101135,60.061174,216.220227,97.219281,1,0
0,0,14,14,20,24,44,84,54,138,0.000333,0.251134,20,15068.03127,837.112848,753.401563,196.477662,6,0
0,0,2,2,6,5,11,6,7,13,0.000333,0.014991,3,134.917833,7.495435,44.972611,27.119415,1,0
0,0,2,2,6,5,11,6,7,13,0.000333,0.014991,3,134.917833,7.495435,44.972611,27.119415,1,0
0,0,2,2,6,5,11,6,7,13,0.000333,0.014991,3,134.917833,7.495435,44.972611,27.119415,1,0
0,0,2,2,8,5,13,8,7,15,0.000333,0.018502,4,222.026383,12.334799,55.506596,35.60964,1,0
0,0,10,10,13,20,33,56,40,96,0.000333,0.161421,12,5811.142026,322.841224,484.261835,134.544278,8,0
0,0,12,12,14,21,35,55,45,100,0.000333,0.170976,14,7180.996224,398.944235,512.928302,145.541635,8,0
0,0,8,8,13,17,30,40,32,72,0.000333,0.117765,6,2119.776737,117.765374,353.296123,117.592585,7,0
0,0,7,7,13,17,30,36,29,65,0.000333,0.106316,6,1913.687332,106.315963,318.947889,117.592585,6,0
0,0,6,6,14,17,31,33,26,59,0.000333,0.097433,7,2046.083076,113.671282,292.297582,122.789837,5,0
0,0,6,6,12,16,28,30,23,53,0.000333,0.08493,6,1528.738865,84.929937,254.789811,107.01955,4,0
0,0,6,6,13,16,29,31,23,54,0.000333,0.087444,6,1573.985842,87.443658,262.330974,112.105716,4,0
0,0,2,2,6,5,11,6,7,13,0.000333,0.014991,3,134.917833,7.495435,44.972611,27.119415,1,0
0,0,2,2,6,5,11,6,7,13,0.000333,0.014991,3,134.917833,7.495435,44.972611,27.119415,1,0
0,0,2,2,6,5,11,6,7,13,0.000333,0.014991,3,134.917833,7.495435,44.972611,27.119415,1,0
0,0,2,2,8,5,13,8,7,15,0.000333,0.018502,4,222.026383,12.334799,55.506596,35.60964,1,0
0,0,44,44,22,43,65,283,179,462,0.000333,0.927445,44,122422.6929,6801.260717,2782.33393,331.43688,17,0
0,0,42,42,22,40,62,275,173,448,0.000333,0.88916,44,117369.1177,6520.506537,2667.479947,310.984619,17,0
0,0,55,55,28,49,77,354,228,582,0.000333,1.215757,56,204247.1069,11347.0615,3647.269767,409.72672,20,0
0,0,41,41,22,40,62,274,172,446,0.000333,0.885191,44,116845.1484,6491.397133,2655.571554,310.984619,16,0
0,0,60,60,28,50,78,401,253,654,0.000333,1.370218,70,287745.7136,15985.87298,4110.653051,416.798747,23,0
0,0,72,72,29,52,81,493,313,806,0.000333,1.703306,84,429233.2046,23846.28914,5109.919102,437.304314,26,0
0,0,37,37,21,37,58,243,156,399,0.000333,0.779111,40,93493.37668,5194.076482,2337.334417,284.98844,15,0
0,0,30,30,21,31,52,156,105,261,0.000333,0.495938,30,44634.44299,2479.691277,1487.814766,245.818752,15,0
0,0,17,17,22,25,47,89,67,156,0.000333,0.288839,22,19063.34894,1059.074941,866.515861,214.2039,6,0
0,0,16,16,21,21,42,84,62,146,0.000333,0.262426,20,15745.56688,874.753715,787.278344,184.477332,6,0
0,0,84,84,29,55,84,527,322,849,0.000333,1.809026,70,379895.4244,21105.30136,5427.077492,458.856233,34,0
0,0,11,11,14,24,38,55,40,95,0.000333,0.166184,7,3489.871796,193.881766,498.553114,163.342069,3,0
0,0,10,10,14,22,36,50,37,87,0.000333,0.149928,7,3148.484326,174.915796,449.783475,151.410465,3,0
0,0,8,8,14,22,36,44,33,77,0.000333,0.132695,7,2786.589576,154.810532,398.084225,151.410465,2,0
0,0,11,11,14,24,38,55,40,95,0.000333,0.166184,7,3489.871796,193.881766,498.553114,163.342069,3,0
0,0,10,10,14,22,36,50,37,87,0.000333,0.149928,7,3148.484326,174.915796,449.783475,151.410465,3,0
0,0,8,8,14,22,36,44,33,77,0.000333,0.132695,7,2786.589576,154.810532,398.084225,151.410465,2,0
0,0,10,10,14,24,38,52,39,91,0.000333,0.159187,7,3342.929826,185.718324,477.561404,163.342069,2,0
0,0,9,9,14,22,36,47,36,83,0.000333,0.143035,7,3003.726426,166.87369,429.103775,151.410465,2,0
0,0,8,8,14,22,36,44,33,77,0.000333,0.132695,7,2786.589576,154.810532,398.084225,151.410465,2,0
0,0,6,6,14,24,38,40,37,77,0.000333,0.134697,7,2828.63293,157.146274,404.090419,163.342069,2,0
0,0,5,5,14,22,36,35,34,69,0.000333,0.118908,7,2497.073776,138.726321,356.724825,151.410465,2,0
0,0,4,4,5,6,11,8,9,17,0.000333,0.019603,2,117.620675,6.534482,58.810338,27.119415,1,0
0,0,4,4,6,7,13,9,10,19,0.000333,0.023436,3,210.925064,11.718059,70.308355,35.161259,1,0
0,0,3,3,10,15,25,18,18,36,0.000333,0.055726,5,835.894114,46.438562,167.178823,91.82264,1,0
0,0,3,3,10,14,24,15,16,31,0.000333,0.047378,5,710.669188,39.481622,142.133838,86.52225,1,0
0,0,63,63,15,73,88,503,138,641,0.000333,1.380165,7,28983.46967,1610.19276,4140.495668,510.460552,18,0
0,0,4,4,10,17,27,27,20,47,0.000333,0.074493,5,1117.398563,62.077698,223.479713,102.706149,2,0
0,0,26,26,25,42,67,141,95,236,0.000333,0.477199,24,34358.32918,1908.796065,1431.597049,342.573737,12,0
0,0,14,14,17,29,46,94,61,155,0.000333,0.285384,16,13698.43365,761.024092,856.152103,210.368317,8,0
0,0,27,27,20,49,69,168,109,277,0.000333,0.56402,20,33841.22549,1880.068083,1692.061275,361.559344,10,0
0,0,10,10,17,26,43,67,41,108,0.000333,0.195346,8,4688.292748,260.460708,586.036594,191.698301,4,0
0,0,7,7,15,21,36,51,31,82,0.000333,0.141311,7,2967.536951,164.863164,423.93385,150.842025,4,0
0,0,9,9,17,25,42,66,39,105,0.000333,0.188731,8,4529.546635,251.64148,566.193329,185.583273,4,0
0,0,7,7,16,20,36,51,29,80,0.000333,0.137865,8,3308.752001,183.819556,413.594,150.438562,4,0
0,0,18,18,18,36,54,141,92,233,0.000333,0.446963,18,24135.99818,1340.888788,1340.888788,261.17595,15,0
0,0,17,17,18,34,52,127,86,213,0.000333,0.404731,18,21855.48588,1214.19366,1214.19366,248.032387,14,0
0,0,44,44,25,62,87,279,171,450,0.000333,0.966442,24,69583.78976,3865.766098,2899.324573,485.256576,23,0
0,0,43,43,25,62,87,278,169,447,0.000333,0.959999,24,69119.89782,3839.994324,2879.995743,485.256576,23,0
0,0,58,58,30,99,129,625,347,972,0.000333,2.271638,45,306671.0802,17037.28223,6814.912892,803.513023,11,0
0,0,54,54,30,99,129,609,330,939,0.000333,2.194514,45,296259.4077,16458.85598,6583.542393,803.513023,11,0
0,0,70,70,28,109,137,610,364,974,0.000333,2.304494,42,290366.2965,16131.46091,6913.483249,872.338029,21,0
0,0,69,69,28,108,136,609,362,971,0.000333,2.293975,42,289040.9096,16057.82831,6881.926419,864.133788,21,0
0,0,72,72,27,110,137,603,377,980,0.000333,2.31869,39,271286.7862,15071.48812,6956.071441,874.331531,24,0
0,0,71,71,27,109,136,602,375,977,0.000333,2.30815,39,270053.5966,15002.97759,6924.451196,866.114054,24,0
0,0,32,32,23,72,95,442,197,639,0.000333,1.399379,22,92359.03014,5131.05723,4198.137734,548.276525,3,0
0,0,31,31,23,71,94,441,195,636,0.000333,1.389573,22,91711.80721,5095.100401,4168.71851,540.67397,3,0
0,0,29,29,23,68,91,432,187,619,0.000333,1.342775,22,88623.14741,4923.508189,4028.324882,517.989398,3,0
0,0,18,18,14,45,59,171,94,265,0.000333,0.519633,14,21824.60571,1212.478095,1558.900408,300.436358,2,0
0,0,41,41,16,44,60,286,183,469,0.000333,0.923444,32,88650.61406,4925.034114,2770.331689,304.214991,4,0
0,0,35,35,14,42,56,270,170,440,0.000333,0.851745,28,71546.61264,3974.811813,2555.236166,279.780301,1,0
0,0,34,34,16,42,58,259,163,422,0.000333,0.824023,24,59329.63152,3296.09064,2472.06798,290.477332,2,0
0,0,34,34,16,42,58,252,161,413,0.000333,0.806449,24,58064.30762,3225.794868,2419.346151,290.477332,2,0
0,0,36,36,16,42,58,274,172,446,0.000333,0.870887,32,83605.10476,4644.728042,2612.659524,290.477332,2,0
0,0,35,35,16,42,58,263,165,428,0.000333,0.835739,24,60173.18078,3342.954488,2507.215866,290.477332,3,0
0,0,35,35,16,42,58,257,164,421,0.000333,0.82207,24,59189.03998,3288.279999,2466.209999,290.477332,3,0
0,0,37,37,16,42,58,278,174,452,0.000333,0.882602,32,84729.83711,4707.213173,2647.80741,290.477332,3,0
0,0,36,36,16,42,58,267,167,434,0.000333,0.847455,24,61016.73005,3389.818336,2542.363752,290.477332,4,0
0,0,36,36,16,42,58,261,166,427,0.000333,0.833786,24,60032.58924,3335.143847,2501.357885,290.477332,4,0
0,0,38,38,16,42,58,282,176,458,0.000333,0.894318,32,85854.56947,4769.698304,2682.955296,290.477332,4,0
0,0,18,18,14,34,48,127,82,209,0.000333,0.389086,14,16341.60028,907.866682,1167.257163,226.276706,1,0
0,0,17,17,14,34,48,126,80,206,0.000333,0.383501,14,16107.03185,894.835103,1150.502275,226.276706,1,0
0,0,18,18,14,31,45,116,78,194,0.000333,0.35514,14,14915.87301,828.659612,1065.419501,206.883055,1,0
0,0,17,17,14,31,45,115,76,191,0.000333,0.349648,14,14685.21518,815.845288,1048.943941,206.883055,1,0
0,0,19,19,14,36,50,127,82,209,0.000333,0.393189,14,16513.92321,917.440178,1179.565944,239.420269,4,0
0,0,18,18,14,36,50,126,80,206,0.000333,0.387545,14,16276.88125,904.271181,1162.634375,239.420269,4,0
0,0,33,33,31,49,80,248,156,404,0.000333,0.851353,45,114932.6528,6385.147376,2554.05895,428.700868,13,0
0,0,24,24,27,41,68,144,106,250,0.000333,0.507289,26,39568.50847,2198.25047,1521.86571,348.041595,10,0
0,0,23,23,25,40,65,121,87,208,0.000333,0.417551,24,30063.66012,1670.20334,1252.652505,328.973529,15,0
0,0,44,44,26,46,72,262,186,448,0.000333,0.921375,52,143734.5728,7985.254046,2764.126401,376.295283,34,0
0,0,32,32,26,41,67,195,138,333,0.000333,0.673336,39,78780.30032,4376.683351,2020.0077,341.871065,23,0
0,0,31,31,31,49,80,238,148,386,0.000333,0.813421,45,109811.891,6100.660612,2440.264245,428.700868,12,0
0,0,22,22,27,41,68,134,98,232,0.000333,0.470764,26,36719.57586,2039.976437,1412.291379,348.041595,9,0
0,0,21,21,25,39,64,111,79,190,0.000333,0.38,24,27360,1520,1140,322.227091,14,0
0,0,42,42,26,46,72,252,178,430,0.000333,0.884356,39,103469.6423,5748.31346,2653.067751,376.295283,33,0
0,0,30,30,26,40,66,185,130,315,0.000333,0.634661,39,74255.38176,4125.298986,1903.984148,335.088556,22,0
0,0,32,32,31,50,81,249,156,405,0.000333,0.85588,45,115543.7663,6419.098128,2567.639251,435.772895,12,0
0,0,23,23,27,42,69,145,106,251,0.000333,0.51108,26,39864.23061,2214.679478,1533.239639,354.859294,9,0
0,0,22,22,25,40,65,122,87,209,0.000333,0.419558,24,30208.19695,1678.233164,1258.674873,328.973529,14,0
0,0,43,43,26,47,73,263,186,449,0.000333,0.92641,39,108390.0179,6021.667658,2779.231227,383.277109,33,0
0,0,31,31,26,41,67,196,138,334,0.000333,0.675358,39,79016.8778,4389.826544,2026.07379,341.871065,22,0
0,0,32,32,31,50,81,253,158,411,0.000333,0.868559,45,117255.5258,6514.195878,2605.678351,435.772895,13,0
0,0,23,23,27,42,69,149,108,257,0.000333,0.523297,26,40817.16042,2267.620023,1569.890785,354.859294,10,0
0,0,22,22,25,40,65,126,89,215,0.000333,0.431603,24,31075.41792,1726.412106,1294.80908,328.973529,15,0
0,0,43,43,26,47,73,267,188,455,0.000333,0.93879,52,146451.2491,8136.180504,2816.370174,383.277109,34,0
0,0,31,31,26,41,67,200,140,340,0.000333,0.68749,39,80436.34267,4468.685704,2062.470325,341.871065,23,0
0,0,11,11,18,20,38,68,45,113,0.000333,0.197672,18,10674.28456,593.015809,593.015809,161.497212,5,0
0,0,49,49,31,46,77,314,184,498,0.000333,1.040287,60,187251.5818,10402.86566,3120.859697,407.663936,21,0
0,0,43,43,31,41,72,287,162,449,0.000333,0.923432,45,124663.3347,6925.740814,2770.296326,373.239718,19,0
0,0,47,47,31,43,74,281,167,448,0.000333,0.927278,45,125182.5799,6954.58777,2781.835108,386.90947,21,0
0,0,41,41,31,38,69,232,137,369,0.000333,0.751349,45,101432.0486,5635.113811,2254.045525,353.001331,19,0
0,0,2,2,6,5,11,6,7,13,0.000333,0.014991,3,134.917833,7.495435,44.972611,27.119415,1,0
0,0,2,2,6,5,11,6,7,13,0.000333,0.014991,3,134.917833,7.495435,44.972611,27.119415,1,0
0,0,2,2,6,5,11,6,7,13,0.000333,0.014991,3,134.917833,7.495435,44.972611,27.119415,1,0
0,0,2,2,8,5,13,8,7,15,0.000333,0.018502,4,222.026383,12.334799,55.506596,35.60964,1,0
0,0,23,23,15,38,53,149,62,211,0.000333,0.402864,7,8460.138511,470.007695,1208.591216,258.024604,8,0
0,0,29,29,19,27,46,155,117,272,0.000333,0.500803,36,54086.71867,3004.817704,1502.408852,209.092585,5,0
0,0,28,28,18,26,44,147,112,259,0.000333,0.471331,36,50903.74041,2827.985578,1413.992789,197.270083,5,0
0,0,30,30,19,31,50,156,131,287,0.000333,0.539929,36,58312.32215,3239.573453,1619.786726,234.290708,4,0
0,0,32,32,19,34,53,174,139,313,0.000333,0.597613,36,64542.20768,3585.678205,1792.839102,253.684359,5,0
0,0,31,31,19,33,52,164,135,299,0.000333,0.568144,36,61359.53313,3408.862951,1704.431476,247.175629,5,0
0,0,29,29,19,27,46,157,119,276,0.000333,0.508168,36,54882.1116,3049.0062,1524.5031,209.092585,5,0
0,0,28,28,18,26,44,149,114,263,0.000333,0.47861,36,51689.89857,2871.661031,1435.830516,197.270083,5,0
0,0,30,30,18,31,49,158,133,291,0.000333,0.544627,36,58819.70033,3267.761129,1633.880565,228.638736,4,0
0,0,32,32,18,34,52,176,141,317,0.000333,0.602346,36,65053.41806,3614.078781,1807.039391,248.032387,5,0
0,0,31,31,18,33,51,166,137,303,0.000333,0.572915,36,61874.81563,3437.489757,1718.744879,241.523656,5,0
0,0,20,20,17,25,42,132,97,229,0.000333,0.411614,24,29636.17656,1646.454253,1234.84069,185.583273,3,0
0,0,19,19,16,24,40,124,92,216,0.000333,0.383179,24,27588.87524,1532.715291,1149.536468,174.0391,3,0
0,0,21,21,16,29,45,133,111,244,0.000333,0.446671,24,32160.29173,1786.682874,1340.012156,204.881449,2,0
0,0,23,23,16,32,48,151,119,270,0.000333,0.502647,24,36190.55701,2010.5865,1507.939875,224,3,0
0,0,22,22,16,31,47,141,115,256,0.000333,0.473992,24,34127.39391,1895.966328,1421.974746,217.580086,3,0
0,0,19,19,17,25,42,130,95,225,0.000333,0.404424,24,29118.51408,1617.695227,1213.27142,185.583273,3,0
0,0,18,18,16,24,40,122,90,212,0.000333,0.376083,24,27077.97015,1504.331675,1128.248756,174.0391,3,0
0,0,20,20,16,29,45,131,109,240,0.000333,0.439348,24,31633.07384,1757.392991,1318.044743,204.881449,2,0
0,0,22,22,16,32,48,149,117,266,0.000333,0.4952,24,35654.40061,1980.800034,1485.600025,224,3,0
0,0,21,21,16,31,47,139,113,252,0.000333,0.466585,24,33594.15338,1866.341854,1399.756391,217.580086,3,0
0,0,3,3,8,13,21,15,17,32,0.000333,0.046851,4,562.21663,31.234257,140.554158,72.105716,1,0
0,0,3,3,7,13,20,15,19,34,0.000333,0.048982,3,440.836666,24.490926,146.945555,67.757201,1,0
0,0,5,5,11,15,26,23,22,45,0.000333,0.070507,5,1057.598937,58.755496,211.519787,96.657107,2,0
0,0,4,4,9,15,24,23,23,46,0.000333,0.070303,4,843.6331,46.868506,210.908275,87.132684,2,0
0,0,5,5,12,17,29,33,27,60,0.000333,0.09716,6,1748.873158,97.15962,291.47886,112.506418,2,0
0,0,40,40,23,39,62,247,177,424,0.000333,0.841526,44,111081.4864,6171.193687,2524.579236,310.172612,8,0
0,0,66,66,27,45,72,386,212,598,0.000333,1.229872,52,191859.9878,10658.88821,3689.615151,375.515352,43,0
0,0,89,89,39,76,115,560,332,892,0.000333,2.035392,76,464069.4615,25781.63675,6106.177125,680.973178,60,0
0,0,36,36,28,50,78,223,146,369,0.000333,0.773104,28,64940.77573,3607.820874,2319.313419,416.798747,36,0
0,0,35,35,27,44,71,200,131,331,0.000333,0.678522,26,52924.72371,2940.262428,2035.566297,368.596954,24,0
0,0,48,48,28,62,90,299,201,500,0.000333,1.081976,42,136328.915,7573.828612,3245.926548,503.766109,27,0
0,0,63,63,37,65,102,436,259,695,0.000333,1.545779,54,250416.1231,13912.00684,4637.335613,584.203682,39,0
0,0,37,37,28,50,78,225,146,371,0.000333,0.777295,28,65292.75825,3627.375458,2331.884223,416.798747,36,0
0,0,36,36,27,44,71,202,131,333,0.000333,0.682622,26,53244.51056,2958.028364,2047.865791,368.596954,24,0
0,0,49,49,28,62,90,301,201,502,0.000333,1.086303,42,136874.2307,7604.123927,3258.910254,503.766109,27,0
0,0,67,67,27,45,72,389,213,602,0.000333,1.238098,52,193143.3322,10730.18513,3714.294851,375.515352,43,0
0,0,90,90,39,76,115,563,333,896,0.000333,2.04452,76,466150.4905,25897.24947,6133.559086,680.973178,60,0
0,0,37,37,28,50,78,226,147,373,0.000333,0.781485,28,65644.74077,3646.930043,2344.455028,416.798747,36,0
0,0,36,36,27,44,71,203,132,335,0.000333,0.686722,39,80346.44612,4463.691451,2060.165285,368.596954,24,0
0,0,49,49,28,62,90,302,202,504,0.000333,1.090631,42,137419.5463,7634.419241,3271.893961,503.766109,27,0
0,0,64,64,37,65,102,439,260,699,0.000333,1.554675,72,335809.8226,18656.10126,4664.025314,584.203682,39,0
0,0,38,38,28,50,78,228,147,375,0.000333,0.785675,28,65996.7233,3666.484628,2357.025832,416.798747,36,0
0,0,37,37,27,44,71,205,132,337,0.000333,0.690822,39,80826.12639,4490.340355,2072.464779,368.596954,24,0
0,0,50,50,28,62,90,304,202,506,0.000333,1.094959,42,137964.862,7664.714556,3284.877667,503.766109,27,0
0,0,11,11,15,17,32,128,72,200,0.000333,0.333333,28,28000,1555.555556,1000,128.090227,19,0
0,0,46,46,30,42,72,292,165,457,0.000333,0.939885,45,126884.5077,7049.139314,2819.655726,373.68405,29,0
0,0,77,77,38,83,121,522,328,850,0.000333,1.960345,57,335218.9238,18623.27355,5881.033752,728.549518,52,0
0,0,56,56,36,72,108,448,288,736,0.000333,1.657199,72,357954.9985,19886.38881,4971.597202,630.3519,50,0
0,0,31,31,27,52,79,222,157,379,0.000333,0.796378,39,93176.18324,5176.454624,2389.132904,424.804828,37,0
0,0,60,60,30,75,105,373,283,656,0.000333,1.468182,45,198204.5277,11011.36265,4404.54506,614.36812,30,0
0,0,60,60,31,74,105,383,280,663,0.000333,1.483848,45,200319.515,11128.86195,4451.544778,613.079635,32,0
0,0,20,20,22,41,63,149,89,238,0.000333,0.474198,22,31297.03768,1738.724316,1422.592622,317.767128,13,0
0,0,20,20,22,43,65,148,90,238,0.000333,0.477775,22,31533.11787,1751.839882,1433.32354,331.43688,12,0
0,0,17,17,20,38,58,132,77,209,0.000333,0.408106,20,24486.36056,1360.353364,1224.318028,285.859807,11,0
0,0,25,25,22,49,71,184,121,305,0.000333,0.625224,22,41264.80317,2292.489065,1875.672871,373.228278,16,0
0,0,30,30,22,50,72,213,140,353,0.000333,0.725995,22,47915.63756,2661.979865,2177.983526,380.300305,19,0
0,0,20,20,24,40,64,160,94,254,0.000333,0.508,24,36576,2032,1524,322.916224,13,0
0,0,20,20,24,42,66,159,95,254,0.000333,0.511759,24,36846.62655,2047.034808,1535.276106,336.516432,12,0
0,0,17,17,22,37,59,143,82,225,0.000333,0.441198,22,29119.08309,1617.726839,1323.594686,290.85727,11,0
0,0,25,25,24,48,72,195,126,321,0.000333,0.660182,24,47533.10221,2640.727901,1980.545925,378.1173,16,0
0,0,30,30,24,49,73,224,145,369,0.000333,0.761348,24,54817.08629,3045.393683,2284.045262,385.159882,19,0
0,0,3,3,10,14,24,23,18,41,0.000333,0.062661,5,939.917313,52.217628,187.983463,86.52225,2,0
0,0,13,13,20,30,50,99,76,175,0.000333,0.329225,20,19753.49666,1097.416481,987.674833,233.64528,9,0
0,0,18,18,20,32,52,128,95,223,0.000333,0.423733,20,25423.96114,1412.442286,1271.198057,246.438562,12,0
0,0,39,39,25,33,58,220,130,350,0.000333,0.683431,36,73810.56054,4100.586697,2050.293348,282.561411,21,0
0,0,7,7,18,22,40,148,44,192,0.000333,0.340603,18,18392.5835,1021.810194,1021.810194,173.166146,1,0
0,0,8,8,14,79,93,307,206,513,0.000333,1.118196,14,46964.23858,2609.124366,3354.58847,551.301648,4,0
0,0,7,7,14,83,97,326,225,551,0.000333,1.212184,14,50911.72767,2828.429315,3636.551976,582.431242,3,0
0,0,7,7,14,77,91,328,224,552,0.000333,1.197434,14,50292.23698,2794.013166,3592.302641,535.845533,3,0
0,0,7,7,14,70,84,280,183,463,0.000333,0.986548,14,41435.00153,2301.94453,2959.642967,482.35278,3,0
0,0,14,14,20,25,45,80,51,131,0.000333,0.239811,20,14388.65511,799.369728,719.432756,202.534967,5,0
0,0,13,13,20,19,39,70,42,112,0.000333,0.197322,20,11839.30097,657.738943,591.965049,167.149185,5,0
0,0,12,12,19,19,38,68,40,108,0.000333,0.188925,18,10201.97109,566.776171,566.776171,161.421246,5,0
0,0,12,12,20,23,43,68,45,113,0.000333,0.204389,10,6131.679173,340.648843,613.167917,190.480487,4,0
0,0,11,11,20,18,38,56,34,90,0.000333,0.157438,10,4723.134762,262.396376,472.313476,161.497212,4,0
0,0,46,46,30,55,85,231,151,382,0.000333,0.816129,30,73451.62013,4080.645563,2448.387338,465.181502,15,0
0,0,50,50,30,55,85,243,159,402,0.000333,0.858858,30,77297.25469,4294.291927,2576.575156,465.181502,15,0
0,0,10,10,14,23,37,55,37,92,0.000333,0.159757,7,3354.887967,186.382665,479.26971,157.344894,4,0
0,0,22,22,19,44,63,100,75,175,0.000333,0.348675,9,9414.21588,523.011993,1046.023987,320.925614,9,0
0,0,21,21,19,44,63,99,73,172,0.000333,0.342697,9,9252.829322,514.046073,1028.092147,320.925614,9,0
0,0,9,9,11,13,24,37,28,65,0.000333,0.099341,10,2980.225625,165.56809,298.022563,86.159464,2,0
0,0,12,12,15,16,31,50,36,86,0.000333,0.14202,14,5964.852358,331.380687,426.060883,122.603359,3,0
0,0,10,10,14,16,30,42,31,73,0.000333,0.119401,7,2507.421094,139.301172,358.203013,117.302969,2,0
0,0,24,24,21,44,65,107,80,187,0.000333,0.375394,10,11261.82781,625.657101,1126.182781,332.453657,8,0
0,0,23,23,21,44,65,106,78,184,0.000333,0.369372,10,11081.15678,615.619821,1108.115678,332.453657,8,0
0,0,10,10,13,16,29,38,32,70,0.000333,0.113353,12,4080.704036,226.70578,340.05867,112.105716,3,0
0,0,12,12,16,19,35,47,38,85,0.000333,0.14533,16,6975.824903,387.545828,435.989056,144.710623,4,0
0,0,10,10,12,16,28,37,32,69,0.000333,0.110569,12,3980.489875,221.138326,331.70749,107.01955,3,0
0,0,12,12,16,19,35,46,38,84,0.000333,0.14362,16,6893.756375,382.986465,430.859773,144.710623,4,0
0,0,10,10,13,17,30,38,32,70,0.000333,0.114494,6,2060.89405,114.494114,343.482342,117.592585,3,0
0,0,12,12,16,20,36,47,38,85,0.000333,0.146481,8,3515.549001,195.308278,439.443625,150.438562,4,0
0,0,10,10,12,17,29,37,32,69,0.000333,0.111734,6,2011.204132,111.733563,335.200689,112.506418,3,0
0,0,12,12,16,20,36,46,38,84,0.000333,0.144758,8,3474.189601,193.010533,434.2737,150.438562,4,0
0,0,12,12,12,22,34,40,46,86,0.000333,0.145841,12,5250.261652,291.681203,437.521804,141.127046,2,0
0,0,13,13,12,22,34,41,48,89,0.000333,0.150928,12,5433.410314,301.856129,452.784193,141.127046,2,0
0,0,13,13,14,25,39,45,49,94,0.000333,0.165609,7,3477.79466,193.210814,496.827809,169.399374,3,0
0,0,14,14,14,25,39,46,51,97,0.000333,0.170895,14,7177.576213,398.754234,512.684015,169.399374,3,0
0,0,16,16,15,18,33,68,47,115,0.000333,0.193368,14,8121.474532,451.19303,580.105324,133.662009,3,0
0,0,9,9,14,14,28,35,26,61,0.000333,0.09775,7,2052.740552,114.041142,293.24865,106.605938,2,0
0,0,16,16,15,18,33,67,47,114,0.000333,0.191687,14,8050.853014,447.269612,575.06093,133.662009,3,0
0,0,9,9,14,14,28,35,26,61,0.000333,0.09775,7,2052.740552,114.041142,293.24865,106.605938,2,0
0,0,30,30,22,49,71,133,101,234,0.000333,0.47968,22,31658.89817,1758.827676,1439.040826,373.228278,11,0
0,0,29,29,22,49,71,132,99,231,0.000333,0.473531,22,31253.01486,1736.278603,1420.591585,373.228278,11,0
0,0,10,10,14,18,32,37,29,66,0.000333,0.11,7,2310,128.333333,330,128.361619,4,0
0,0,11,11,14,18,32,38,31,69,0.000333,0.115,7,2415,134.166667,345,128.361619,4,0
0,0,28,28,20,49,69,123,92,215,0.000333,0.437778,10,13133.32758,729.62931,1313.332758,361.559344,11,0
0,0,27,27,20,49,69,122,90,212,0.000333,0.431669,10,12950.07185,719.448436,1295.007185,361.559344,11,0
0,0,28,28,20,49,69,123,92,215,0.000333,0.437778,10,13133.32758,729.62931,1313.332758,361.559344,11,0
0,0,27,27,20,49,69,122,90,212,0.000333,0.431669,10,12950.07185,719.448436,1295.007185,361.559344,11,0
0,0,21,21,17,23,40,84,61,145,0.000333,0.257227,16,12346.87318,685.937399,771.679574,173.528793,8,0
0,0,37,37,23,50,73,163,115,278,0.000333,0.57359,22,37856.967,2103.164833,1720.771227,386.234734,14,0
0,0,36,36,23,50,73,162,113,275,0.000333,0.567401,22,37448.43858,2080.46881,1702.201754,386.234734,14,0
0,0,37,37,23,50,73,163,115,278,0.000333,0.57359,22,37856.967,2103.164833,1720.771227,386.234734,14,0
0,0,36,36,23,50,73,162,113,275,0.000333,0.567401,22,37448.43858,2080.46881,1702.201754,386.234734,14,0
0,0,21,21,17,23,40,84,61,145,0.000333,0.257227,16,12346.87318,685.937399,771.679574,173.528793,8,0
0,0,15,15,14,21,35,56,52,108,0.000333,0.184654,14,7755.475922,430.859773,553.962566,145.541635,2,0
0,0,15,15,15,22,37,56,52,108,0.000333,0.18754,14,7876.693489,437.594083,562.620963,156.710855,2,0
0,0,15,15,11,20,31,58,58,116,0.000333,0.191562,10,5746.86772,319.270429,574.686772,124.49231,1,0
0,0,18,18,15,23,38,70,67,137,0.000333,0.239655,14,10065.52497,559.195832,718.966069,162.645284,2,0
0,0,15,15,13,20,33,47,55,102,0.000333,0.171509,12,6174.338402,343.0188,514.5282,134.544278,2,0
0,0,15,15,14,21,35,47,57,104,0.000333,0.177815,14,7468.236073,414.902004,533.445434,145.541635,2,0
0,0,15,15,10,19,29,49,63,112,0.000333,0.181365,15,8161.408072,453.41156,544.093871,113.929904,1,0
0,0,18,18,14,22,36,61,72,133,0.000333,0.2292,21,14439.60053,802.200029,687.600025,151.410465,2,0
0,0,26,26,19,45,64,113,87,200,0.000333,0.4,9,10800,600,1200,327.844012,9,0
0,0,6,6,6,10,16,13,17,30,0.000333,0.04,3,360,20,120,48.729056,1,0
0,0,7,7,7,12,19,16,19,35,0.000333,0.049559,3,446.032389,24.779577,148.677463,62.671034,1,0
0,0,6,6,7,12,19,14,17,31,0.000333,0.043895,3,395.057259,21.947625,131.685753,62.671034,1,0
0,0,14,14,12,18,30,41,45,86,0.000333,0.140664,12,5063.911095,281.328394,421.992591,118.0782,2,0
0,0,14,14,14,19,33,46,46,92,0.000333,0.154695,14,6497.179626,360.954424,464.084259,134.013592,3,0
0,0,30,30,22,49,71,133,103,236,0.000333,0.48378,22,31929.48704,1773.860391,1451.34032,373.228278,11,0
0,0,29,29,22,49,71,132,101,233,0.000333,0.47763,22,31523.60374,1751.311319,1432.891079,373.228278,11,0
0,0,30,30,22,49,71,133,103,236,0.000333,0.48378,22,31929.48704,1773.860391,1451.34032,373.228278,11,0
0,0,29,29,22,49,71,132,101,233,0.000333,0.47763,22,31523.60374,1751.311319,1432.891079,373.228278,11,0
0,0,12,12,16,18,34,59,41,100,0.000333,0.169582,16,8139.940546,452.218919,508.746284,139.05865,6,0
0,0,12,12,16,18,34,59,41,100,0.000333,0.169582,16,8139.940546,452.218919,508.746284,139.05865,6,0
0,0,6,6,9,10,19,17,15,32,0.000333,0.045311,4,543.734722,30.207485,135.93368,61.748606,2,0
0,0,6,6,9,10,19,17,15,32,0.000333,0.045311,4,543.734722,30.207485,135.93368,61.748606,2,0
0,0,20,20,16,18,34,109,72,181,0.000333,0.306944,32,29466.58478,1637.032488,920.830774,139.05865,11,0
0,0,8,8,9,10,19,25,20,45,0.000333,0.063719,8,1529.253905,84.95855,191.156738,61.748606,3,0
0,0,19,19,14,22,36,64,77,141,0.000333,0.242986,21,15308.14793,850.452663,728.959425,151.410465,2,0
0,0,19,19,15,23,38,64,83,147,0.000333,0.257148,21,16200.35223,900.019569,771.445344,162.645284,2,0
0,0,13,13,10,17,27,48,66,114,0.000333,0.180686,15,8130.857629,451.714313,542.057175,102.706149,1,0
0,0,15,15,14,20,34,56,71,127,0.000333,0.215369,21,13568.2634,753.792411,646.107781,139.741531,2,0
0,0,13,13,12,16,28,45,35,80,0.000333,0.128196,12,4615.060725,256.392263,384.588394,107.01955,3,0
0,0,16,16,15,19,34,58,43,101,0.000333,0.171278,14,7193.672458,399.64847,513.833747,139.313982,4,0
0,0,13,13,11,16,27,44,35,79,0.000333,0.125212,10,3756.361127,208.686729,375.636113,102.053748,3,0
0,0,16,16,15,19,34,57,43,100,0.000333,0.169582,14,7122.447978,395.691554,508.746284,139.313982,4,0
0,0,16,16,19,24,43,84,50,134,0.000333,0.242373,18,13088.15059,727.119477,727.119477,190.749723,7,0
0,0,5,5,11,9,20,25,17,42,0.000333,0.060507,5,907.6049,50.422494,181.52098,66.583073,2,0
0,0,11,11,15,20,35,44,32,76,0.000333,0.129942,7,2728.778565,151.598809,389.825509,145.041921,5,0
0,0,12,12,15,20,35,45,34,79,0.000333,0.135071,7,2836.493508,157.582973,405.213358,145.041921,5,0
0,0,11,11,15,20,35,44,32,76,0.000333,0.129942,7,2728.778565,151.598809,389.825509,145.041921,5,0
0,0,12,12,15,20,35,45,34,79,0.000333,0.135071,7,2836.493508,157.582973,405.213358,145.041921,5,0
0,0,11,11,15,20,35,44,32,76,0.000333,0.129942,7,2728.778565,151.598809,389.825509,145.041921,5,0
0,0,12,12,15,20,35,45,34,79,0.000333,0.135071,7,2836.493508,157.582973,405.213358,145.041921,5,0
0,0,11,11,15,20,35,44,32,76,0.000333,0.129942,7,2728.778565,151.598809,389.825509,145.041921,5,0
0,0,12,12,15,20,35,45,34,79,0.000333,0.135071,7,2836.493508,157.582973,405.213358,145.041921,5,0
0,0,19,19,16,21,37,77,53,130,0.000333,0.225743,16,10835.663,601.981278,677.228938,156.238666,7,0
0,0,19,19,16,21,37,77,53,130,0.000333,0.225743,16,10835.663,601.981278,677.228938,156.238666,7,0
0,0,20,20,16,21,37,78,55,133,0.000333,0.230952,16,11085.71676,615.873153,692.857298,156.238666,7,0
0,0,20,20,16,21,37,78,55,133,0.000333,0.230952,16,11085.71676,615.873153,692.857298,156.238666,7,0
0,0,11,11,15,21,36,44,33,77,0.000333,0.132695,7,2786.589576,154.810532,398.084225,150.842025,5,0
0,0,12,12,15,21,36,45,35,80,0.000333,0.137865,7,2895.158001,160.842111,413.594,150.842025,5,0
0,0,11,11,15,21,36,44,33,77,0.000333,0.132695,7,2786.589576,154.810532,398.084225,150.842025,5,0
0,0,12,12,15,21,36,45,35,80,0.000333,0.137865,7,2895.158001,160.842111,413.594,150.842025,5,0
0,0,12,12,13,15,28,45,31,76,0.000333,0.121786,12,4384.307689,243.572649,365.358974,106.709075,3,0
0,0,15,15,17,18,35,58,39,97,0.000333,0.165847,16,7960.647242,442.25818,497.540453,144.545518,4,0
0,0,13,13,14,18,32,49,32,81,0.000333,0.135,7,2835,157.5,405,128.361619,3,0
0,0,12,12,13,16,29,45,31,76,0.000333,0.123069,6,2215.239334,123.068852,369.206556,112.105716,3,0
0,0,15,15,17,19,36,58,39,97,0.000333,0.167161,16,8023.723602,445.762422,501.482725,150.197491,4,0
0,0,13,13,14,18,32,49,32,81,0.000333,0.135,7,2835,157.5,405,128.361619,3,0
0,0,10,10,12,15,27,41,28,69,0.000333,0.109362,6,1968.523426,109.362413,328.087238,101.622909,3,0
0,0,13,13,16,18,34,54,36,90,0.000333,0.152624,16,7325.946491,406.997027,457.871656,139.05865,4,0
0,0,11,11,13,16,29,45,29,74,0.000333,0.11983,6,2156.943562,119.830198,359.490594,112.105716,3,0
0,0,10,10,12,15,27,41,28,69,0.000333,0.109362,6,1968.523426,109.362413,328.087238,101.622909,3,0
0,0,13,13,16,18,34,54,36,90,0.000333,0.152624,16,7325.946491,406.997027,457.871656,139.05865,4,0
0,0,11,11,13,16,29,45,29,74,0.000333,0.11983,6,2156.943562,119.830198,359.490594,112.105716,3,0
0,0,7,7,11,15,26,34,28,62,0.000333,0.097142,5,1457.136313,80.952017,291.427263,96.657107,1,0
0,0,10,10,14,18,32,47,36,83,0.000333,0.138333,14,5810,322.777778,415,128.361619,2,0
0,0,7,7,10,15,25,32,31,63,0.000333,0.097521,10,2925.6294,162.534967,292.56294,91.82264,1,0
0,0,9,9,14,18,32,40,36,76,0.000333,0.126667,14,5320,295.555556,380,128.361619,2,0
0,0,11,11,10,18,28,43,42,85,0.000333,0.136208,10,4086.251684,227.013982,408.625168,108.277931,1,0
0,0,7,7,9,15,24,28,24,52,0.000333,0.079473,4,953.6722,52.981789,238.41805,87.132684,1,0
0,0,15,15,11,22,33,67,59,126,0.000333,0.211865,10,6355.93659,353.107588,635.593659,136.161243,1,0
0,0,17,17,15,25,40,75,64,139,0.000333,0.246583,14,10356.47207,575.35956,739.748005,174.699764,2,0
0,0,14,14,14,23,37,64,52,116,0.000333,0.201432,14,8460.152266,470.008459,604.29659,157.344894,2,0
0,0,7,7,12,16,28,34,32,66,0.000333,0.105762,12,3807.425098,211.523617,317.285425,107.01955,1,0
0,0,9,9,15,19,34,42,37,79,0.000333,0.13397,7,2813.366951,156.298164,401.909564,139.313982,2,0
0,0,13,13,14,21,35,57,56,113,0.000333,0.193203,14,8114.525733,450.806985,579.608981,145.541635,1,0
0,0,15,15,18,24,42,65,61,126,0.000333,0.226477,18,12229.77592,679.431995,679.431995,185.09775,2,0
0,0,12,12,11,24,35,49,53,102,0.000333,0.174396,10,5231.868677,290.659371,523.186868,148.092848,1,0
0,0,10,10,11,21,32,44,48,92,0.000333,0.153333,10,4600,255.555556,460,130.292414,1,0
0,0,13,13,13,24,37,53,55,108,0.000333,0.18754,12,6751.451562,375.080642,562.620963,158.144816,2,0
0,0,11,11,13,22,35,48,50,98,0.000333,0.167557,12,6032.036828,335.113157,502.669736,146.213212,2,0
0,0,11,11,10,20,30,46,45,91,0.000333,0.148842,10,4465.270442,248.07058,446.527044,119.657843,1,0
0,0,9,9,10,17,27,41,40,81,0.000333,0.128382,10,3851.458877,213.969938,385.145888,102.706149,1,0
0,0,12,12,12,20,32,50,47,97,0.000333,0.161667,12,5820,323.333333,485,129.458112,2,0
0,0,10,10,12,18,30,45,42,87,0.000333,0.1423,12,5122.793782,284.599655,426.899482,118.0782,2,0
0,0,68,68,18,79,97,389,161,550,0.000333,1.209984,18,65339.13714,3629.952063,3629.952063,573.057329,11,0
0,0,13,13,15,26,41,60,43,103,0.000333,0.183943,7,3862.794995,214.599722,551.827856,180.814792,3,0
0,0,12,12,15,24,39,55,40,95,0.000333,0.167371,7,3514.792476,195.266249,502.113211,168.642459,3,0
0,0,8,8,14,22,36,44,33,77,0.000333,0.132695,7,2786.589576,154.810532,398.084225,151.410465,2,0
0,0,13,13,15,26,41,60,43,103,0.000333,0.183943,7,3862.794995,214.599722,551.827856,180.814792,3,0
0,0,12,12,15,24,39,55,40,95,0.000333,0.167371,7,3514.792476,195.266249,502.113211,168.642459,3,0
0,0,8,8,14,22,36,44,33,77,0.000333,0.132695,7,2786.589576,154.810532,398.084225,151.410465,2,0
0,0,25,25,21,45,66,110,82,192,0.000333,0.386841,10,11605.23671,644.735373,1160.523671,339.372055,8,0
0,0,24,24,21,45,66,109,80,189,0.000333,0.380797,10,11423.90489,634.661383,1142.390489,339.372055,8,0
0,0,17,17,16,17,33,73,50,123,0.000333,0.20682,16,9927.367627,551.520424,620.460477,133.486868,3,0
0,0,20,20,19,20,39,86,58,144,0.000333,0.253699,18,13699.76255,761.09792,761.09792,167.149185,4,0
0,0,17,17,16,17,33,73,50,123,0.000333,0.20682,16,9927.367627,551.520424,620.460477,133.486868,3,0
0,0,20,20,19,20,39,86,58,144,0.000333,0.253699,18,13699.76255,761.09792,761.09792,167.149185,4,0
0,0,15,15,16,17,33,69,48,117,0.000333,0.196731,16,9443.105791,524.616988,590.194112,133.486868,3,0
0,0,18,18,18,20,38,82,56,138,0.000333,0.241405,18,13035.85194,724.213997,724.213997,161.497212,4,0
0,0,15,15,15,17,32,68,48,116,0.000333,0.193333,14,8120,451.111111,580,128.090227,3,0
0,0,18,18,18,20,38,81,56,137,0.000333,0.239655,18,12941.38925,718.966069,718.966069,161.497212,4,0
0,0,28,28,19,49,68,120,99,219,0.000333,0.444385,18,23996.77852,1333.154362,1333.154362,355.831405,9,0
0,0,27,27,19,49,68,119,97,216,0.000333,0.438297,9,11834.02776,657.445987,1314.891974,355.831405,9,0
0,0,29,29,21,52,73,125,102,227,0.000333,0.468363,10,14050.90175,780.605653,1405.090175,388.661531,10,0
0,0,28,28,21,52,73,124,100,224,0.000333,0.462174,10,13865.20701,770.289278,1386.520701,388.661531,10,0
0,0,30,30,19,50,69,125,109,234,0.000333,0.476465,18,25729.10501,1429.394723,1429.394723,362.903432,9,0
0,0,29,29,19,50,69,124,107,231,0.000333,0.470356,18,25399.24469,1411.06915,1411.06915,362.903432,9,0
0,0,31,31,21,53,74,130,114,244,0.000333,0.505036,20,30302.13242,1683.451801,1515.106621,395.81845,10,0
0,0,30,30,21,53,74,129,112,241,0.000333,0.498826,20,29929.56522,1662.753623,1496.478261,395.81845,10,0
0,0,15,15,16,17,33,69,48,117,0.000333,0.196731,16,9443.105791,524.616988,590.194112,133.486868,3,0
0,0,18,18,18,20,38,82,56,138,0.000333,0.241405,18,13035.85194,724.213997,724.213997,161.497212,4,0
0,0,15,15,15,17,32,68,48,116,0.000333,0.193333,14,8120,451.111111,580,128.090227,3,0
0,0,18,18,18,20,38,81,56,137,0.000333,0.239655,18,12941.38925,718.966069,718.966069,161.497212,4,0
0,0,55,55,26,60,86,222,156,378,0.000333,0.809709,26,63157.33001,3508.740556,2429.128077,476.624868,15,0
0,0,14,14,14,18,32,47,61,108,0.000333,0.18,21,11340,630,540,128.361619,2,0
0,0,54,54,26,59,85,218,163,381,0.000333,0.813993,26,63491.42661,3527.301479,2441.977947,469.287373,14,0
0,0,16,16,19,23,42,82,49,131,0.000333,0.235465,18,12715.08448,706.393582,706.393582,184.752548,7,0
0,0,3,3,9,7,16,15,11,26,0.000333,0.034667,4,416,23.111111,104,48.180809,2,0
0,0,16,16,12,17,29,59,56,115,0.000333,0.186223,18,10056.02066,558.667814,558.667814,112.506418,2,0
0,0,18,18,16,20,36,67,61,128,0.000333,0.220583,24,15882.0096,882.333867,661.7504,150.438562,3,0
0,0,10,10,15,16,31,37,28,65,0.000333,0.107341,7,2254.159321,125.231073,322.02276,122.603359,3,0
0,0,16,16,12,17,29,59,56,115,0.000333,0.186223,18,10056.02066,558.667814,558.667814,112.506418,2,0
0,0,18,18,16,20,36,67,61,128,0.000333,0.220583,24,15882.0096,882.333867,661.7504,150.438562,3,0
0,0,10,10,15,16,31,37,28,65,0.000333,0.107341,7,2254.159321,125.231073,322.02276,122.603359,3,0
0,0,14,14,14,18,32,63,47,110,0.000333,0.183333,14,7700,427.777778,550,128.361619,2,0
0,0,17,17,18,20,38,76,55,131,0.000333,0.22916,18,12374.61308,687.478504,687.478504,161.497212,3,0
0,0,12,12,14,22,36,55,42,97,0.000333,0.167161,7,3510.379076,195.02106,501.482725,151.410465,5,0
0,0,6,6,10,12,22,19,17,36,0.000333,0.053513,5,802.697691,44.594316,160.539538,76.238831,1,0
0,0,17,17,12,17,29,65,61,126,0.000333,0.204035,18,11017.9009,612.105605,612.105605,112.506418,1,0
0,0,19,19,16,20,36,73,66,139,0.000333,0.23954,24,17246.86981,958.159434,718.619575,150.438562,2,0
0,0,10,10,14,16,30,37,29,66,0.000333,0.107952,7,2266.983455,125.943525,323.854779,117.302969,2,0
0,0,66,66,36,65,101,447,313,760,0.000333,1.686747,72,364337.3323,20240.96291,5060.240727,577.571208,51,0
0,0,67,67,37,71,108,454,327,781,0.000333,1.758522,72,379840.834,21102.26856,5275.567139,629.38182,50,0
0,0,66,66,36,65,101,442,309,751,0.000333,1.666772,72,360022.8113,20001.26729,5000.316824,577.571208,50,0
0,0,5,5,12,12,24,26,17,43,0.000333,0.065718,6,1182.920325,65.717796,197.153388,86.0391,3,0
0,0,13,13,15,18,33,77,47,124,0.000333,0.208502,14,8757.068191,486.503788,625.504871,133.662009,7,0
0,0,5,5,12,12,24,26,17,43,0.000333,0.065718,6,1182.920325,65.717796,197.153388,86.0391,3,0
0,0,16,16,15,18,33,60,51,111,0.000333,0.186643,14,7838.988461,435.499359,559.927747,133.662009,3,0
0,0,16,16,15,18,33,60,51,111,0.000333,0.186643,14,7838.988461,435.499359,559.927747,133.662009,3,0
0,0,18,18,16,20,36,65,54,119,0.000333,0.205074,16,9843.537203,546.863178,615.221075,150.438562,3,0
0,0,18,18,16,19,35,65,54,119,0.000333,0.203462,16,9766.154864,542.564159,610.384679,144.710623,3,0
0,0,18,18,16,20,36,64,54,118,0.000333,0.20335,16,9760.818403,542.267689,610.05115,150.438562,3,0
0,0,18,18,16,19,35,64,54,118,0.000333,0.201752,16,9684.086336,538.004796,605.255396,144.710623,3,0
0,0,10,10,13,16,29,42,29,71,0.000333,0.114972,6,2069.499904,114.972217,344.916651,112.105716,3,0
0,0,13,13,16,19,35,55,37,92,0.000333,0.157298,8,3775.1523,209.730683,471.894038,144.710623,4,0
0,0,11,11,13,17,30,46,30,76,0.000333,0.124308,6,2237.542112,124.307895,372.923685,117.592585,3,0
0,0,10,10,12,16,28,41,29,70,0.000333,0.112172,6,2019.089067,112.171615,336.514845,107.01955,3,0
0,0,13,13,16,19,35,54,37,91,0.000333,0.155588,8,3734.118036,207.451002,466.764755,144.710623,4,0
0,0,11,11,13,17,30,45,30,75,0.000333,0.122672,6,2208.100768,122.672265,368.016795,117.592585,3,0
0,0,7,7,12,14,26,30,27,57,0.000333,0.089308,6,1607.550384,89.308355,267.925064,96.322519,3,0
0,0,7,7,12,16,28,28,26,54,0.000333,0.086532,6,1557.582995,86.532389,259.597166,107.01955,2,0
0,0,7,7,14,14,28,34,29,63,0.000333,0.100954,14,4240.087041,235.560391,302.86336,106.605938,4,0
0,0,7,7,14,16,30,32,28,60,0.000333,0.098138,7,2060.89405,114.494114,294.413436,117.302969,3,0
0,0,13,13,16,18,34,45,45,90,0.000333,0.152624,16,7325.946491,406.997027,457.871656,139.05865,3,0
0,0,13,13,16,20,36,43,44,87,0.000333,0.149928,16,7196.535602,399.807533,449.783475,150.438562,2,0
0,0,13,13,18,18,36,51,47,98,0.000333,0.168884,18,9119.747703,506.65265,506.65265,150.1173,4,0
0,0,13,13,18,20,38,49,46,95,0.000333,0.166184,18,8973.956048,498.553114,498.553114,161.497212,3,0
0,0,13,13,17,17,34,49,46,95,0.000333,0.161103,16,7732.943519,429.607973,483.30897,138.973737,4,0
0,0,13,13,17,19,36,47,45,92,0.000333,0.158544,16,7610.129602,422.784978,475.6331,150.197491,3,0
0,0,18,18,11,20,31,70,81,151,0.000333,0.249361,20,14961.67286,831.204048,748.083643,124.49231,1,0
0,0,20,20,15,23,38,78,86,164,0.000333,0.286887,21,18073.86236,1004.103464,860.660112,162.645284,2,0
0,0,4,4,8,9,17,14,14,28,0.000333,0.03815,4,457.795838,25.433102,114.44896,52.529325,1,0
0,0,7,7,9,11,20,21,20,41,0.000333,0.059066,4,708.796208,39.377567,177.199052,66.583073,1,0
0,0,6,6,8,11,19,19,18,37,0.000333,0.052391,4,628.693272,34.927404,157.173318,62.053748,1,0
0,0,7,7,10,14,24,36,28,64,0.000333,0.097813,10,2934.376,163.020889,293.4376,86.52225,1,0
0,0,10,10,14,17,31,49,36,85,0.000333,0.140369,14,5895.493609,327.527423,421.106686,122.789837,2,0
0,0,4,4,7,9,16,10,10,20,0.000333,0.026667,3,240,13.333333,80,48.180809,2,0
0,0,4,4,8,8,16,11,9,20,0.000333,0.026667,4,320,17.777778,80,48,2,0
0,0,27,27,22,49,71,143,95,238,0.000333,0.48788,11,16100.03796,894.446553,1463.639814,373.228278,11,0
0,0,15,15,16,20,36,77,48,125,0.000333,0.215414,16,10339.85,574.436111,646.240625,150.438562,5,0
0,0,4,4,8,8,16,11,9,20,0.000333,0.026667,4,320,17.777778,80,48,2,0
0,0,27,27,22,49,71,143,95,238,0.000333,0.48788,11,16100.03796,894.446553,1463.639814,373.228278,11,0
0,0,15,15,16,20,36,77,48,125,0.000333,0.215414,16,10339.85,574.436111,646.240625,150.438562,5,0
0,0,4,4,8,8,16,11,9,20,0.000333,0.026667,4,320,17.777778,80,48,2,0
0,0,9,9,11,13,24,29,22,51,0.000333,0.077944,5,1169.165438,64.953635,233.833088,86.159464,3,0
0,0,6,6,10,11,21,19,17,36,0.000333,0.052708,5,790.617136,43.923174,158.123427,71.273029,1,0
0,0,4,4,8,8,16,11,9,20,0.000333,0.026667,4,320,17.777778,80,48,2,0
0,0,9,9,11,13,24,29,22,51,0.000333,0.077944,5,1169.165438,64.953635,233.833088,86.159464,3,0
0,0,6,6,10,11,21,19,17,36,0.000333,0.052708,5,790.617136,43.923174,158.123427,71.273029,1,0
0,0,4,4,7,9,16,10,10,20,0.000333,0.026667,3,240,13.333333,80,48.180809,2,0
0,0,4,4,8,8,16,11,9,20,0.000333,0.026667,4,320,17.777778,80,48,2,0
0,0,27,27,21,47,68,143,95,238,0.000333,0.482939,20,28976.32312,1609.795729,1448.816156,353.304342,11,0
0,0,15,15,16,20,36,77,48,125,0.000333,0.215414,16,10339.85,574.436111,646.240625,150.438562,5,0
0,0,4,4,8,8,16,11,9,20,0.000333,0.026667,4,320,17.777778,80,48,2,0
0,0,9,9,11,11,22,29,22,51,0.000333,0.07581,10,2274.310126,126.350563,227.431013,76.107496,3,0
0,0,6,6,10,11,21,19,17,36,0.000333,0.052708,5,790.617136,43.923174,158.123427,71.273029,1,0
0,0,17,17,14,22,36,80,59,139,0.000333,0.23954,14,10060.67405,558.926336,718.619575,151.410465,5,0
0,0,17,17,16,24,40,83,62,145,0.000333,0.257227,16,12346.87318,685.937399,771.679574,174.0391,5,0
0,0,17,17,16,24,40,83,62,145,0.000333,0.257227,16,12346.87318,685.937399,771.679574,174.0391,5,0
0,0,8,8,10,15,25,25,29,54,0.000333,0.083589,5,1253.841171,69.657843,250.768234,91.82264,1,0
0,0,4,4,8,10,18,13,14,27,0.000333,0.037529,4,450.3519,25.01955,112.587975,57.219281,2,0
0,0,4,4,8,12,20,13,18,31,0.000333,0.04466,4,535.919084,29.773282,133.979771,67.01955,2,0
0,0,28,28,21,52,73,146,112,258,0.000333,0.532325,20,31939.49472,1774.416374,1596.974736,388.661531,10,0
0,0,4,4,8,12,20,13,18,31,0.000333,0.04466,4,535.919084,29.773282,133.979771,67.01955,2,0
0,0,28,28,21,52,73,146,112,258,0.000333,0.532325,20,31939.49472,1774.416374,1596.974736,388.661531,10,0
0,0,4,4,8,11,19,13,16,29,0.000333,0.041063,4,492.759592,27.375533,123.189898,62.053748,2,0
0,0,10,10,11,16,27,32,36,68,0.000333,0.107777,10,3233.323501,179.629083,323.33235,102.053748,2,0
0,0,3,3,6,8,14,7,9,16,0.000333,0.020306,3,182.753036,10.152946,60.917679,39.509775,1,0
0,0,3,3,7,7,14,8,8,16,0.000333,0.020306,3,182.753036,10.152946,60.917679,39.302969,1,0
0,0,11,11,11,13,24,41,32,73,0.000333,0.111567,10,3347.022626,185.945701,334.702263,86.159464,1,0
0,0,7,7,10,12,22,22,19,41,0.000333,0.060946,5,914.183482,50.787971,182.836696,76.238831,1,0
0,0,3,3,7,7,14,8,8,16,0.000333,0.020306,3,182.753036,10.152946,60.917679,39.302969,1,0
0,0,29,29,21,49,70,155,105,260,0.000333,0.531205,20,31872.27169,1770.68176,1593.613584,367.359448,9,0
0,0,16,16,16,21,37,80,50,130,0.000333,0.225743,16,10835.663,601.981278,677.228938,156.238666,5,0
0,0,5,5,11,18,29,34,25,59,0.000333,0.09554,5,1433.104394,79.616911,286.620879,113.112398,2,0
0,0,22,22,19,28,47,116,80,196,0.000333,0.3629,18,19596.58947,1088.699415,1088.699415,215.316561,12,0
0,0,23,23,21,30,51,123,85,208,0.000333,0.393288,20,23597.28942,1310.960523,1179.864471,239.445384,13,0
0,0,21,21,19,27,46,108,75,183,0.000333,0.336937,18,18194.61308,1010.811838,1010.811838,209.092585,12,0
0,0,19,19,17,25,42,94,66,160,0.000333,0.28759,16,13804.3326,766.907367,862.770788,185.583273,11,0
0,0,25,25,21,32,53,153,102,255,0.000333,0.486873,30,43818.59148,2434.366193,1460.619716,252.238666,12,0
0,0,18,18,17,26,43,87,62,149,0.000333,0.269504,16,12936.21518,718.678621,808.513448,191.698301,9,0
0,0,18,18,17,26,43,87,62,149,0.000333,0.269504,16,12936.21518,718.678621,808.513448,191.698301,9,0
0,0,18,18,18,27,45,88,63,151,0.000333,0.276423,18,14926.85672,829.269818,829.269818,203.440613,9,0
0,0,18,18,17,26,43,87,62,149,0.000333,0.269504,16,12936.21518,718.678621,808.513448,191.698301,9,0
0,0,17,17,17,25,42,79,57,136,0.000333,0.244452,16,11733.68271,651.871262,733.355169,185.583273,9,0
0,0,27,27,19,34,53,132,83,215,0.000333,0.410501,18,22167.05216,1231.502898,1231.502898,253.684359,9,0
0,0,18,18,19,28,47,130,86,216,0.000333,0.39993,27,32394.36218,1799.686788,1199.791192,215.316561,8,0
0,0,58,58,30,99,129,625,347,972,0.000333,2.271638,45,306671.0802,17037.28223,6814.912892,803.513023,11,0
0,0,54,54,30,99,129,609,330,939,0.000333,2.194514,45,296259.4077,16458.85598,6583.542393,803.513023,11,0
0,0,70,70,28,109,137,610,364,974,0.000333,2.304494,42,290366.2965,16131.46091,6913.483249,872.338029,21,0
0,0,69,69,28,108,136,609,362,971,0.000333,2.293975,42,289040.9096,16057.82831,6881.926419,864.133788,21,0
0,0,72,72,27,110,137,603,377,980,0.000333,2.31869,39,271286.7862,15071.48812,6956.071441,874.331531,24,0
0,0,71,71,27,109,136,602,375,977,0.000333,2.30815,39,270053.5966,15002.97759,6924.451196,866.114054,24,0
0,0,32,32,23,72,95,442,197,639,0.000333,1.399379,22,92359.03014,5131.05723,4198.137734,548.276525,3,0
0,0,31,31,23,71,94,441,195,636,0.000333,1.389573,22,91711.80721,5095.100401,4168.71851,540.67397,3,0
0,0,29,29,23,68,91,432,187,619,0.000333,1.342775,22,88623.14741,4923.508189,4028.324882,517.989398,3,0
0,0,18,18,14,45,59,171,94,265,0.000333,0.519633,14,21824.60571,1212.478095,1558.900408,300.436358,2,0
0,0,41,41,16,44,60,286,183,469,0.000333,0.923444,32,88650.61406,4925.034114,2770.331689,304.214991,4,0
0,0,35,35,14,42,56,270,170,440,0.000333,0.851745,28,71546.61264,3974.811813,2555.236166,279.780301,1,0
0,0,34,34,16,42,58,259,163,422,0.000333,0.824023,24,59329.63152,3296.09064,2472.06798,290.477332,2,0
0,0,34,34,16,42,58,252,161,413,0.000333,0.806449,24,58064.30762,3225.794868,2419.346151,290.477332,2,0
0,0,36,36,16,42,58,274,172,446,0.000333,0.870887,32,83605.10476,4644.728042,2612.659524,290.477332,2,0
0,0,35,35,16,42,58,263,165,428,0.000333,0.835739,24,60173.18078,3342.954488,2507.215866,290.477332,3,0
0,0,35,35,16,42,58,257,164,421,0.000333,0.82207,24,59189.03998,3288.279999,2466.209999,290.477332,3,0
0,0,37,37,16,42,58,278,174,452,0.000333,0.882602,32,84729.83711,4707.213173,2647.80741,290.477332,3,0
0,0,36,36,16,42,58,267,167,434,0.000333,0.847455,24,61016.73005,3389.818336,2542.363752,290.477332,4,0
0,0,36,36,16,42,58,261,166,427,0.000333,0.833786,24,60032.58924,3335.143847,2501.357885,290.477332,4,0
0,0,38,38,16,42,58,282,176,458,0.000333,0.894318,32,85854.56947,4769.698304,2682.955296,290.477332,4,0
0,0,18,18,14,34,48,127,82,209,0.000333,0.389086,14,16341.60028,907.866682,1167.257163,226.276706,1,0
0,0,17,17,14,34,48,126,80,206,0.000333,0.383501,14,16107.03185,894.835103,1150.502275,226.276706,1,0
0,0,18,18,14,31,45,116,78,194,0.000333,0.35514,14,14915.87301,828.659612,1065.419501,206.883055,1,0
0,0,17,17,14,31,45,115,76,191,0.000333,0.349648,14,14685.21518,815.845288,1048.943941,206.883055,1,0
0,0,19,19,14,36,50,127,82,209,0.000333,0.393189,14,16513.92321,917.440178,1179.565944,239.420269,4,0
0,0,18,18,14,36,50,126,80,206,0.000333,0.387545,14,16276.88125,904.271181,1162.634375,239.420269,4,0
0,0,10,10,13,20,33,56,40,96,0.000333,0.161421,12,5811.142026,322.841224,484.261835,134.544278,8,0
0,0,12,12,14,21,35,55,45,100,0.000333,0.170976,14,7180.996224,398.944235,512.928302,145.541635,8,0
0,0,8,8,13,17,30,40,32,72,0.000333,0.117765,6,2119.776737,117.765374,353.296123,117.592585,7,0
0,0,7,7,13,17,30,36,29,65,0.000333,0.106316,6,1913.687332,106.315963,318.947889,117.592585,6,0
0,0,6,6,14,17,31,33,26,59,0.000333,0.097433,7,2046.083076,113.671282,292.297582,122.789837,5,0
0,0,6,6,12,16,28,30,23,53,0.000333,0.08493,6,1528.738865,84.929937,254.789811,107.01955,4,0
0,0,6,6,13,16,29,31,23,54,0.000333,0.087444,6,1573.985842,87.443658,262.330974,112.105716,4,0
0,0,10,10,13,20,33,37,30,67,0.000333,0.112658,6,2027.846436,112.658135,337.974406,134.544278,4,0
0,0,11,11,13,20,33,38,32,70,0.000333,0.117703,6,2118.64553,117.702529,353.107588,134.544278,4,0
0,0,10,10,13,20,33,37,30,67,0.000333,0.112658,6,2027.846436,112.658135,337.974406,134.544278,4,0
0,0,11,11,13,20,33,38,32,70,0.000333,0.117703,6,2118.64553,117.702529,353.107588,134.544278,4,0
0,0,4,4,8,9,17,14,14,28,0.000333,0.03815,4,457.795838,25.433102,114.44896,52.529325,1,0
0,0,15,15,15,20,35,62,50,112,0.000333,0.191493,14,8042.715771,446.817543,574.479698,145.041921,2,0
0,0,14,14,15,20,35,60,48,108,0.000333,0.184654,14,7755.475922,430.859773,553.962566,145.041921,2,0
0,0,15,15,16,21,37,63,51,114,0.000333,0.197959,16,9502.042939,527.891274,593.877684,156.238666,2,0
0,0,14,14,16,21,37,61,49,110,0.000333,0.191013,16,9168.637924,509.368774,573.03987,156.238666,2,0
0,0,15,15,12,18,30,64,53,117,0.000333,0.191369,12,6889.274396,382.737466,574.1062,118.0782,1,0
0,0,18,18,16,21,37,77,61,138,0.000333,0.239635,16,11502.47303,639.02628,718.904564,156.238666,2,0
0,0,10,10,14,18,32,50,36,86,0.000333,0.143333,14,6020,334.444444,430,128.361619,2,0
0,0,15,15,14,18,32,61,56,117,0.000333,0.195,21,12285,682.5,585,128.361619,1,0
0,0,18,18,18,21,39,74,64,138,0.000333,0.243129,27,19693.40867,1094.078259,729.385506,167.297316,2,0
0,0,14,14,16,20,36,57,45,102,0.000333,0.175777,16,8437.317602,468.739867,527.33235,150.438562,2,0
0,0,13,13,16,20,36,55,43,98,0.000333,0.168884,16,8106.442402,450.357911,506.65265,150.438562,2,0
0,0,14,14,17,20,37,57,46,103,0.000333,0.178858,16,8585.179147,476.954397,536.573697,155.92543,2,0
0,0,13,13,17,20,37,55,44,99,0.000333,0.171912,16,8251.774131,458.431896,515.735883,155.92543,2,0
0,0,12,12,11,12,23,50,37,87,0.000333,0.131183,15,5903.248353,327.958242,393.54989,81.073298,1,0
0,0,15,15,15,15,30,63,45,108,0.000333,0.176648,21,11128.82787,618.268215,529.944184,117.206718,2,0
0,0,12,12,15,15,30,49,35,84,0.000333,0.137393,14,5770.50334,320.583519,412.17881,117.206718,2,0
0,0,11,11,15,15,30,47,33,80,0.000333,0.13085,14,5495.717467,305.317637,392.551248,117.206718,2,0
0,0,13,13,12,13,25,53,38,91,0.000333,0.140864,12,5071.090959,281.727276,422.590913,91.125266,2,0
0,0,16,16,15,16,31,66,46,112,0.000333,0.184957,14,7768.179815,431.565545,554.869987,122.603359,3,0
0,0,13,13,15,16,31,52,36,88,0.000333,0.145323,14,6103.569854,339.087214,435.969275,122.603359,3,0
0,0,13,13,12,12,24,53,38,91,0.000333,0.139077,18,7510.168576,417.231588,417.231588,86.0391,2,0
0,0,16,16,15,15,30,66,46,112,0.000333,0.183191,21,11541.00668,641.167038,549.571747,117.206718,3,0
0,0,13,13,15,15,30,52,36,88,0.000333,0.143935,14,6045.289214,335.849401,431.806372,117.206718,3,0
0,0,13,13,13,13,26,54,39,93,0.000333,0.145714,18,7868.536088,437.140894,437.140894,96.211433,2,0
0,0,16,16,15,16,31,67,47,114,0.000333,0.188259,14,7906.897311,439.272073,564.778379,122.603359,3,0
0,0,13,13,15,16,31,53,37,90,0.000333,0.148626,14,6242.287351,346.793742,445.877668,122.603359,3,0
0,0,13,13,12,13,25,53,39,92,0.000333,0.142412,18,7690.22585,427.234769,427.234769,91.125266,2,0
0,0,16,16,15,16,31,66,47,113,0.000333,0.186608,14,7837.538563,435.418809,559.824183,122.603359,3,0
0,0,13,13,15,16,31,52,37,89,0.000333,0.146974,14,6172.928603,342.940478,440.923472,122.603359,3,0
0,0,13,13,12,13,25,53,38,91,0.000333,0.140864,12,5071.090959,281.727276,422.590913,91.125266,2,0
0,0,16,16,15,16,31,66,46,112,0.000333,0.184957,14,7768.179815,431.565545,554.869987,122.603359,3,0
0,0,13,13,15,16,31,52,36,88,0.000333,0.145323,14,6103.569854,339.087214,435.969275,122.603359,3,0
0,0,11,11,15,15,30,47,33,80,0.000333,0.13085,14,5495.717467,305.317637,392.551248,117.206718,2,0
0,0,13,13,12,13,25,53,38,91,0.000333,0.140864,12,5071.090959,281.727276,422.590913,91.125266,2,0
0,0,16,16,15,16,31,66,46,112,0.000333,0.184957,14,7768.179815,431.565545,554.869987,122.603359,3,0
0,0,13,13,15,16,31,52,36,88,0.000333,0.145323,14,6103.569854,339.087214,435.969275,122.603359,3,0
0,0,11,11,15,15,30,47,33,80,0.000333,0.13085,14,5495.717467,305.317637,392.551248,117.206718,2,0
0,0,16,16,17,30,47,105,67,172,0.000333,0.318463,16,15286.22852,849.234918,955.389282,216.693586,10,0
0,0,23,23,19,47,66,160,99,259,0.000333,0.521833,18,28178.96538,1565.498077,1565.498077,341.776299,12,0
0,0,9,9,15,28,43,56,39,95,0.000333,0.171832,7,3608.466062,200.470337,515.495152,193.209297,4,0
0,0,22,22,22,38,60,125,81,206,0.000333,0.405606,22,26770.02818,1487.223788,1216.819463,297.528741,9,0
0,0,50,50,21,52,73,295,170,465,0.000333,0.959423,30,86348.0526,4797.114033,2878.26842,388.661531,9,0
0,0,17,17,19,21,40,92,52,144,0.000333,0.255453,18,13794.43762,766.357646,766.357646,172.949289,5,0
0,0,14,14,21,27,48,103,58,161,0.000333,0.299726,20,17983.57925,999.087736,899.178963,220.620628,10,0
0,0,19,19,16,43,59,165,95,260,0.000333,0.509829,16,24471.79509,1359.544171,1529.487193,297.329384,4,0
0,0,13,13,16,32,48,127,70,197,0.000333,0.366746,16,17603.8018,977.988989,1100.237613,224,3,0
0,0,6,6,13,19,32,37,26,63,0.000333,0.105,6,1890,105,315,128.816339,2,0
0,0,18,18,21,29,50,104,66,170,0.000333,0.319819,20,19189.11105,1066.061725,959.455552,233.120115,9,0
0,0,33,33,27,37,64,170,124,294,0.000333,0.588,39,68796,3822,1764,321.131737,9,0
0,0,70,70,29,47,76,320,227,547,0.000333,1.139205,56,191386.5156,10632.5842,3417.61635,401.947125,21,0
0,0,61,61,29,47,76,290,206,496,0.000333,1.032991,56,173542.4346,9641.246367,3098.972047,401.947125,23,0
0,0,18,18,19,27,46,87,56,143,0.000333,0.26329,18,14217.64848,789.86936,789.86936,209.092585,10,0
0,0,20,20,18,22,40,86,68,154,0.000333,0.273192,27,22128.57702,1229.36539,819.576927,173.166146,3,0
0,0,10,10,13,16,29,44,34,78,0.000333,0.126308,12,4547.070211,252.615012,378.922518,112.105716,2,0
0,0,10,10,13,24,37,55,35,90,0.000333,0.156284,6,2813.104817,156.283601,468.850803,158.144816,4,0
0,0,10,10,13,24,37,53,34,87,0.000333,0.151074,6,2719.334657,151.074148,453.222443,158.144816,4,0
0,0,14,14,15,32,47,77,50,127,0.000333,0.235144,7,4938.029489,274.334972,705.432784,218.603359,7,0
0,0,10,10,13,24,37,51,35,86,0.000333,0.149338,6,2688.077937,149.337663,448.012989,158.144816,4,0
0,0,62,62,15,75,90,500,139,639,0.000333,1.382765,7,29038.0589,1613.225494,4148.294129,525.764761,6,0
0,0,66,66,27,45,72,386,212,598,0.000333,1.229872,52,191859.9878,10658.88821,3689.615151,375.515352,43,0
0,0,41,41,29,53,82,237,154,391,0.000333,0.828601,28,69602.47935,3866.804408,2485.802834,444.461233,41,0
0,0,86,86,39,76,115,550,324,874,0.000333,1.994319,76,454704.8311,25261.37951,5982.958305,680.973178,55,0
0,0,36,36,27,44,71,202,131,333,0.000333,0.682622,26,53244.51056,2958.028364,2047.865791,368.596954,24,0
0,0,49,49,28,62,90,301,201,502,0.000333,1.086303,42,136874.2307,7604.123927,3258.910254,503.766109,27,0
0,0,36,36,28,50,78,223,146,369,0.000333,0.773104,28,64940.77573,3607.820874,2319.313419,416.798747,36,0
0,0,62,62,37,65,102,434,259,693,0.000333,1.54133,54,249695.5011,13871.97229,4623.990762,584.203682,39,0
0,0,35,35,27,44,71,200,131,331,0.000333,0.678522,26,52924.72371,2940.262428,2035.566297,368.596954,24,0
0,0,48,48,28,62,90,299,201,500,0.000333,1.081976,42,136328.915,7573.828612,3245.926548,503.766109,27,0
0,0,67,67,27,45,72,389,213,602,0.000333,1.238098,52,193143.3322,10730.18513,3714.294851,375.515352,43,0
0,0,42,42,29,53,82,240,155,395,0.000333,0.837078,28,70314.52517,3906.36251,2511.233042,444.461233,41,0
0,0,87,87,39,76,115,553,325,878,0.000333,2.003447,76,456785.8601,25376.99223,6010.340265,680.973178,55,0
0,0,37,37,27,44,71,205,132,337,0.000333,0.690822,39,80826.12639,4490.340355,2072.464779,368.596954,24,0
0,0,50,50,28,62,90,304,202,506,0.000333,1.094959,42,137964.862,7664.714556,3284.877667,503.766109,27,0
0,0,37,37,28,50,78,226,147,373,0.000333,0.781485,28,65644.74077,3646.930043,2344.455028,416.798747,36,0
0,0,63,63,37,65,102,437,260,697,0.000333,1.550227,72,334848.9934,18602.72185,4650.680463,584.203682,39,0
0,0,36,36,27,44,71,203,132,335,0.000333,0.686722,39,80346.44612,4463.691451,2060.165285,368.596954,24,0
0,0,49,49,28,62,90,302,202,504,0.000333,1.090631,42,137419.5463,7634.419241,3271.893961,503.766109,27,0
0,0,11,11,15,17,32,128,72,200,0.000333,0.333333,28,28000,1555.555556,1000,128.090227,19,0
0,0,46,46,30,42,72,292,165,457,0.000333,0.939885,45,126884.5077,7049.139314,2819.655726,373.68405,29,0
0,0,31,31,27,52,79,222,157,379,0.000333,0.796378,39,93176.18324,5176.454624,2389.132904,424.804828,37,0
0,0,79,79,37,85,122,562,353,915,0.000333,2.113875,72,456596.9758,25366.49866,6341.624664,737.548004,66,0
0,0,54,54,36,70,106,408,263,671,0.000333,1.504812,54,243779.4698,13543.30388,4514.434625,615.167111,36,0
0,0,64,64,32,76,108,397,298,695,0.000333,1.564882,48,225343.0471,12519.05817,4694.646814,634.842491,32,0
0,0,56,56,29,73,102,359,265,624,0.000333,1.387864,42,174870.9234,9715.051298,4163.593413,592.738642,30,0
0,0,20,20,22,43,65,148,90,238,0.000333,0.477775,22,31533.11787,1751.839882,1433.32354,331.43688,12,0
0,0,17,17,20,38,58,132,77,209,0.000333,0.408106,20,24486.36056,1360.353364,1224.318028,285.859807,11,0
0,0,20,20,22,41,63,149,89,238,0.000333,0.474198,22,31297.03768,1738.724316,1422.592622,317.767128,13,0
0,0,25,25,22,49,71,184,121,305,0.000333,0.625224,22,41264.80317,2292.489065,1875.672871,373.228278,16,0
0,0,30,30,22,50,72,213,140,353,0.000333,0.725995,22,47915.63756,2661.979865,2177.983526,380.300305,19,0
0,0,20,20,24,42,66,159,95,254,0.000333,0.511759,24,36846.62655,2047.034808,1535.276106,336.516432,12,0
0,0,17,17,22,37,59,143,82,225,0.000333,0.441198,22,29119.08309,1617.726839,1323.594686,290.85727,11,0
0,0,20,20,24,40,64,160,94,254,0.000333,0.508,24,36576,2032,1524,322.916224,13,0
0,0,25,25,24,48,72,195,126,321,0.000333,0.660182,24,47533.10221,2640.727901,1980.545925,378.1173,16,0
0,0,30,30,24,49,73,224,145,369,0.000333,0.761348,24,54817.08629,3045.393683,2284.045262,385.159882,19,0
0,0,3,3,10,14,24,23,18,41,0.000333,0.062661,5,939.917313,52.217628,187.983463,86.52225,2,0
0,0,13,13,20,30,50,99,76,175,0.000333,0.329225,20,19753.49666,1097.416481,987.674833,233.64528,9,0
0,0,18,18,20,32,52,128,95,223,0.000333,0.423733,20,25423.96114,1412.442286,1271.198057,246.438562,12,0
0,0,39,39,25,33,58,220,130,350,0.000333,0.683431,36,73810.56054,4100.586697,2050.293348,282.561411,21,0
0,0,7,7,18,22,40,148,44,192,0.000333,0.340603,18,18392.5835,1021.810194,1021.810194,173.166146,1,0
0,0,8,8,14,79,93,307,206,513,0.000333,1.118196,14,46964.23858,2609.124366,3354.58847,551.301648,4,0
0,0,7,7,14,83,97,326,225,551,0.000333,1.212184,14,50911.72767,2828.429315,3636.551976,582.431242,3,0
0,0,7,7,14,77,91,328,224,552,0.000333,1.197434,14,50292.23698,2794.013166,3592.302641,535.845533,3,0
0,0,7,7,14,70,84,280,183,463,0.000333,0.986548,14,41435.00153,2301.94453,2959.642967,482.35278,3,0
0,0,12,12,16,20,36,58,39,97,0.000333,0.167161,8,4011.861801,222.881211,501.482725,150.438562,4,0
0,0,4,4,9,10,19,18,13,31,0.000333,0.043895,4,526.743012,29.263501,131.685753,61.748606,1,0
0,0,5,5,9,15,24,19,18,37,0.000333,0.056548,4,678.57445,37.698581,169.643613,87.132684,5,0
0,0,21,21,17,44,61,141,83,224,0.000333,0.442828,8,10627.88131,590.43785,1328.485164,309.70186,11,0
0,0,13,13,12,16,28,45,35,80,0.000333,0.128196,12,4615.060725,256.392263,384.588394,107.01955,3,0
0,0,16,16,15,19,34,58,43,101,0.000333,0.171278,14,7193.672458,399.64847,513.833747,139.313982,4,0
0,0,13,13,11,16,27,44,35,79,0.000333,0.125212,10,3756.361127,208.686729,375.636113,102.053748,3,0
0,0,16,16,15,19,34,57,43,100,0.000333,0.169582,14,7122.447978,395.691554,508.746284,139.313982,4,0
0,0,13,13,13,17,30,54,47,101,0.000333,0.165199,12,5947.151402,330.3973,495.59595,117.592585,2,0
0,0,15,15,15,20,35,62,52,114,0.000333,0.194913,14,8186.335695,454.796428,584.738264,145.041921,3,0
0,0,13,13,12,17,29,53,47,100,0.000333,0.161933,12,5829.577194,323.8654,485.7981,112.506418,2,0
0,0,15,15,15,20,35,61,52,113,0.000333,0.193203,14,8114.525733,450.806985,579.608981,145.041921,3,0
0,0,5,5,9,13,22,19,19,38,0.000333,0.056486,4,677.833606,37.657423,169.458402,76.635041,1,0
0,0,5,5,6,10,16,13,14,27,0.000333,0.036,3,324,18,108,48.729056,1,0
0,0,5,5,6,8,14,11,13,24,0.000333,0.030459,3,274.129554,15.22942,91.376518,39.509775,1,0
0,0,5,5,6,9,15,11,13,24,0.000333,0.031255,3,281.296123,15.627562,93.765374,44.0391,1,0
0,0,12,12,9,14,23,28,32,60,0.000333,0.090471,8,2171.309739,120.628319,271.413717,81.832294,3,0
0,0,3,3,7,11,18,14,15,29,0.000333,0.040309,3,362.783475,20.154638,120.927825,57.705232,1,0
0,0,5,5,11,8,19,22,19,41,0.000333,0.058055,10,1741.650281,96.758349,174.165028,62.053748,2,0
0,0,7,7,12,19,31,51,37,88,0.000333,0.145323,6,2615.815652,145.323092,435.969275,123.730173,5,0
0,0,7,7,12,19,31,51,37,88,0.000333,0.145323,6,2615.815652,145.323092,435.969275,123.730173,5,0
0,0,2,2,7,6,13,11,8,19,0.000333,0.023436,3,210.925064,11.718059,70.308355,35.161259,2,0
0,0,15,15,12,20,32,48,44,92,0.000333,0.153333,12,5520,306.666667,460,129.458112,2,0
0,0,18,18,16,23,39,61,52,113,0.000333,0.199083,16,9556.007212,530.88929,597.250451,168.041925,3,0
0,0,10,10,14,15,29,40,29,69,0.000333,0.111734,7,2346.404821,130.355823,335.200689,111.906328,2,0
0,0,15,15,12,20,32,65,51,116,0.000333,0.193333,12,6960,386.666667,580,129.458112,1,0
0,0,18,18,16,23,39,78,59,137,0.000333,0.241367,16,11585.60166,643.644537,724.100104,168.041925,2,0
0,0,25,25,24,44,68,153,93,246,0.000333,0.499172,24,35940.38062,1996.687812,1497.515859,350.254091,10,0
0,0,26,26,19,51,70,133,98,231,0.000333,0.471955,9,12742.77939,707.932188,1415.864377,370.004315,9,0
0,0,8,8,9,16,25,22,25,47,0.000333,0.072754,4,873.044964,48.502498,218.261241,92.529325,1,0
0,0,26,26,20,53,73,134,98,232,0.000333,0.47868,10,14360.39298,797.79961,1436.039298,390.018346,9,0
0,0,11,11,9,17,26,35,38,73,0.000333,0.114377,8,2745.056795,152.503155,343.132099,98.016193,1,0
0,0,28,28,20,53,73,144,109,253,0.000333,0.522009,20,31320.51227,1740.028459,1566.025613,390.018346,9,0
0,0,29,29,22,49,71,130,94,224,0.000333,0.459181,11,15152.9769,841.83205,1377.543355,373.228278,12,0
0,0,28,28,22,49,71,129,92,221,0.000333,0.453031,11,14950.03525,830.557514,1359.094113,373.228278,12,0
0,0,29,29,22,49,71,130,94,224,0.000333,0.459181,11,15152.9769,841.83205,1377.543355,373.228278,12,0
0,0,28,28,22,49,71,129,92,221,0.000333,0.453031,11,14950.03525,830.557514,1359.094113,373.228278,12,0
0,0,12,12,14,29,43,58,53,111,0.000333,0.200772,7,4216.207714,234.233762,602.315388,194.184418,2,0
0,0,11,11,14,27,41,53,50,103,0.000333,0.183943,7,3862.794995,214.599722,551.827856,181.684931,2,0
0,0,10,10,14,27,41,50,47,97,0.000333,0.173228,7,3637.777811,202.098767,519.682544,181.684931,2,0
0,0,25,25,20,38,58,117,78,195,0.000333,0.380769,20,22846.12588,1269.229216,1142.306294,285.859807,11,0
0,0,27,27,19,37,56,125,85,210,0.000333,0.406515,18,21951.80161,1219.544534,1219.544534,273.460397,12,0
0,0,26,26,17,21,38,112,80,192,0.000333,0.335867,24,24182.44998,1343.469443,1007.602083,161.725534,9,0
0,0,31,31,19,37,56,139,97,236,0.000333,0.456845,18,24669.64371,1370.535762,1370.535762,273.460397,13,0
0,0,10,10,18,21,39,90,61,151,0.000333,0.266032,18,14365.72323,798.095735,798.095735,167.297316,4,0
0,0,8,8,18,19,37,74,50,124,0.000333,0.215324,18,11627.49991,645.972217,645.972217,155.769273,4,0
0,0,6,6,15,14,29,70,45,115,0.000333,0.186223,21,11732.0241,651.779117,558.667814,111.906328,1,0
0,0,3,3,7,10,17,16,16,32,0.000333,0.0436,3,392.396433,21.799802,130.798811,52.870765,1,0
0,0,27,27,28,39,67,167,114,281,0.000333,0.56819,28,47727.98975,2651.554986,1704.571063,340.736624,15,0
0,0,22,22,24,35,59,152,101,253,0.000333,0.496103,24,35719.4086,1984.411589,1488.308691,289.564006,13,0
0,0,52,52,37,59,96,407,270,677,0.000333,1.486007,72,320977.4121,17832.07845,4458.019613,539.825714,34,0
0,0,64,64,37,70,107,496,340,836,0.000333,1.878622,72,405782.3808,22543.4656,5635.866401,621.799586,34,0
0,0,51,51,37,59,96,398,266,664,0.000333,1.457472,72,314813.8872,17489.6604,4372.4151,539.825714,32,0
0,0,59,59,37,64,101,464,316,780,0.000333,1.731135,72,373925.1569,20773.61983,5193.404957,576.749775,34,0
0,0,69,69,30,87,117,549,356,905,0.000333,2.07256,60,373060.8043,20725.60024,6217.680071,707.742802,70,0
0,0,81,81,30,86,116,604,370,974,0.000333,2.226558,60,400780.4094,22265.5783,6679.673489,699.865487,73,0
0,0,69,69,29,78,107,550,344,894,0.000333,2.008957,56,337504.8032,18750.26685,6026.871486,631.142822,68,0
0,0,78,78,31,89,120,582,360,942,0.000333,2.168764,60,390377.4565,21687.63647,6506.290941,729.920361,71,0
0,0,66,66,30,81,111,528,334,862,0.000333,1.952262,60,351407.1886,19522.62159,5856.786477,660.734568,66,0
0,0,78,78,30,85,115,588,358,946,0.000333,2.158611,60,388550.0153,21586.11196,6475.833588,692.004947,70,0
0,0,66,66,29,77,106,534,332,866,0.000333,1.942126,56,326277.2304,18126.5128,5826.379114,623.424012,65,0
0,0,66,66,30,85,115,488,296,784,0.000333,1.788955,45,241508.889,13417.1605,5366.8642,692.004947,57,0
0,0,54,54,29,78,107,434,270,704,0.000333,1.581998,42,199331.6959,11073.9831,4745.992758,631.142822,52,0
0,0,70,70,30,88,118,562,362,924,0.000333,2.119854,60,381573.7307,21198.54059,6359.562178,715.6367,70,0
0,0,79,79,31,90,121,595,366,961,0.000333,2.216343,60,398941.6543,22163.42524,6649.027571,737.846864,71,0
0,0,67,67,30,82,112,541,340,881,0.000333,1.999093,60,359836.7812,19990.93229,5997.279686,668.525982,66,0
0,0,70,70,31,90,121,539,327,866,0.000333,1.997245,45,269628.1004,14979.33891,5991.735563,737.846864,64,0
0,0,58,58,30,83,113,485,301,786,0.000333,1.786887,45,241229.7299,13401.65166,5360.660664,676.334991,59,0
0,0,16,16,29,25,54,129,97,226,0.000333,0.433535,42,54625.39217,3034.744009,1300.604575,256.977854,14,0
0,0,7,7,11,13,24,39,37,76,0.000333,0.116152,10,3484.571501,193.587306,348.45715,86.159464,2,0
0,0,26,26,24,37,61,175,122,297,0.000333,0.587143,36,63411.44361,3522.857979,1761.428989,302.788875,14,0
0,0,13,13,22,35,57,109,74,183,0.000333,0.355806,22,23483.2152,1304.623067,1067.418873,277.632401,6,0
0,0,15,15,22,35,57,118,81,199,0.000333,0.386915,22,25536.39248,1418.688471,1160.745113,277.632401,7,0
0,0,3,3,14,12,26,33,28,61,0.000333,0.095576,14,4014.175519,223.009751,286.726823,96.322519,4,0
0,0,29,29,22,49,71,130,95,225,0.000333,0.461231,11,15220.62412,845.590229,1383.693102,373.228278,12,0
0,0,28,28,22,49,71,129,93,222,0.000333,0.455081,11,15017.68247,834.315693,1365.243861,373.228278,12,0
0,0,29,29,22,49,71,130,95,225,0.000333,0.461231,11,15220.62412,845.590229,1383.693102,373.228278,12,0
0,0,28,28,22,49,71,129,93,222,0.000333,0.455081,11,15017.68247,834.315693,1365.243861,373.228278,12,0
0,0,2,2,6,5,11,6,7,13,0.000333,0.014991,3,134.917833,7.495435,44.972611,27.119415,1,0
0,0,2,2,6,5,11,6,7,13,0.000333,0.014991,3,134.917833,7.495435,44.972611,27.119415,1,0
0,0,2,2,6,5,11,6,7,13,0.000333,0.014991,3,134.917833,7.495435,44.972611,27.119415,1,0
0,0,2,2,8,5,13,8,7,15,0.000333,0.018502,4,222.026383,12.334799,55.506596,35.60964,1,0
0,0,50,50,28,56,84,435,252,687,0.000333,1.463841,56,245925.2359,13662.51311,4391.522069,459.817813,29,0
0,0,7,7,6,12,18,15,20,35,0.000333,0.048649,3,437.842125,24.324563,145.947375,58.529325,1,0
0,0,7,7,7,13,20,16,20,36,0.000333,0.051863,3,466.768234,25.931569,155.589411,67.757201,1,0
0,0,7,7,7,14,21,16,20,36,0.000333,0.052708,3,474.370282,26.353905,158.123427,72.954453,1,0
0,0,14,14,12,17,29,41,45,86,0.000333,0.139262,12,5013.436387,278.524244,417.786366,112.506418,2,0
0,0,15,15,14,18,32,48,48,96,0.000333,0.16,14,6720,373.333333,480,128.361619,3,0
0,0,23,23,17,45,62,104,81,185,0.000333,0.367175,8,8812.210539,489.567252,1101.526317,316.620258,9,0
0,0,22,22,17,45,62,103,79,182,0.000333,0.361221,8,8669.309828,481.628324,1083.663728,316.620258,9,0
0,0,23,23,18,47,65,105,81,186,0.000333,0.373387,9,10081.44372,560.080207,1120.160413,336.124326,9,0
0,0,22,22,18,47,65,104,79,183,0.000333,0.367364,9,9918.839788,551.046655,1102.09331,336.124326,9,0
0,0,8,8,11,15,26,35,29,64,0.000333,0.100276,5,1504.14071,83.563373,300.828142,96.657107,1,0
0,0,11,11,15,18,33,48,37,85,0.000333,0.142925,14,6002.829002,333.4905,428.7735,133.662009,2,0
0,0,10,10,15,14,29,45,31,76,0.000333,0.123069,14,5168.891779,287.160654,369.206556,111.906328,2,0
0,0,14,14,12,15,27,57,48,105,0.000333,0.166421,18,8986.737379,499.263188,499.263188,101.622909,2,0
0,0,16,16,16,17,33,65,53,118,0.000333,0.198413,24,14285.72415,793.651341,595.238506,133.486868,3,0
0,0,14,14,13,17,30,58,49,107,0.000333,0.175012,12,6300.447525,350.024862,525.037294,117.592585,2,0
0,0,16,16,15,19,34,66,54,120,0.000333,0.203499,14,8546.937573,474.829865,610.495541,139.313982,3,0
0,0,14,14,12,17,29,57,49,106,0.000333,0.171649,12,6179.351826,343.297324,514.945985,112.506418,2,0
0,0,16,16,15,19,34,65,54,119,0.000333,0.201803,14,8475.713094,470.87295,605.408078,139.313982,3,0
0,0,16,16,13,18,31,61,51,112,0.000333,0.184957,12,6658.439841,369.913325,554.869987,123.164366,2,0
0,0,18,18,16,20,36,69,56,125,0.000333,0.215414,16,10339.85,574.436111,646.240625,150.438562,3,0
0,0,16,16,13,17,30,61,51,112,0.000333,0.183191,18,9892.291441,549.571747,549.571747,117.592585,2,0
0,0,18,18,16,19,35,69,56,125,0.000333,0.21372,16,10258.56603,569.920335,641.160377,144.710623,3,0
0,0,14,14,12,16,28,57,48,105,0.000333,0.168257,18,9085.900803,504.772267,504.772267,107.01955,2,0
0,0,16,16,15,18,33,65,53,118,0.000333,0.198413,14,8333.339085,462.963283,595.238506,133.662009,3,0
0,0,14,14,12,16,28,57,48,105,0.000333,0.168257,18,9085.900803,504.772267,504.772267,107.01955,2,0
0,0,16,16,15,18,33,65,53,118,0.000333,0.198413,14,8333.339085,462.963283,595.238506,133.662009,3,0
0,0,7,7,12,13,25,29,31,60,0.000333,0.092877,12,3343.576457,185.754248,278.631371,91.125266,1,0
0,0,9,9,16,17,33,37,36,73,0.000333,0.122747,16,5891.852331,327.32513,368.240771,133.486868,2,0
0,0,11,11,14,25,39,56,41,97,0.000333,0.170895,7,3588.788107,199.377117,512.684015,169.399374,3,0
0,0,10,10,14,23,37,51,38,89,0.000333,0.154547,7,3245.489447,180.304969,463.64135,157.344894,3,0
0,0,11,11,14,25,39,55,41,96,0.000333,0.169133,7,3551.790291,197.321683,507.398613,169.399374,3,0
0,0,10,10,14,23,37,50,38,88,0.000333,0.152811,7,3209.023273,178.279071,458.431896,157.344894,3,0
0,0,11,11,14,26,40,56,41,97,0.000333,0.172076,7,3613.589176,200.754954,516.227025,175.514402,3,0
0,0,10,10,14,24,38,51,38,89,0.000333,0.155689,7,3269.458841,181.636602,467.065549,163.342069,3,0
0,0,8,8,14,22,36,44,33,77,0.000333,0.132695,7,2786.589576,154.810532,398.084225,151.410465,2,0
0,0,11,11,14,26,40,55,41,96,0.000333,0.170302,7,3576.33568,198.685316,510.905097,175.514402,3,0
0,0,10,10,14,24,38,50,38,88,0.000333,0.153939,7,3232.723348,179.595742,461.817621,163.342069,3,0
0,0,8,8,14,22,36,44,33,77,0.000333,0.132695,7,2786.589576,154.810532,398.084225,151.410465,2,0
0,0,4,4,8,9,17,14,14,28,0.000333,0.03815,4,457.795838,25.433102,114.44896,52.529325,1,0
0,0,16,16,14,21,35,67,54,121,0.000333,0.206881,14,8689.005431,482.722524,620.643245,145.541635,2,0
0,0,15,15,14,21,35,65,52,117,0.000333,0.200042,14,8401.765582,466.764755,600.126113,145.541635,2,0
0,0,9,9,9,14,23,29,28,57,0.000333,0.085948,8,2062.744252,114.596903,257.843031,81.832294,1,0
0,0,16,16,15,22,37,68,55,123,0.000333,0.213588,14,8970.678696,498.371039,640.762764,156.710855,2,0
0,0,15,15,15,22,37,66,53,119,0.000333,0.206642,14,8678.949307,482.16385,619.924951,156.710855,2,0
0,0,9,9,10,16,26,30,28,58,0.000333,0.090875,5,1363.127518,75.729307,272.625504,97.219281,1,0
0,0,17,17,11,20,31,73,60,133,0.000333,0.219636,15,9883.621639,549.090091,658.908109,124.49231,1,0
0,0,20,20,15,23,38,86,68,154,0.000333,0.269394,14,11314.53172,628.585095,808.180837,162.645284,2,0
0,0,10,10,14,18,32,51,36,87,0.000333,0.145,14,6090,338.333333,435,128.361619,2,0
0,0,17,17,15,23,38,72,58,130,0.000333,0.22741,14,9551.228074,530.623782,682.230577,162.645284,2,0
0,0,2,2,6,5,11,6,7,13,0.000333,0.014991,3,134.917833,7.495435,44.972611,27.119415,1,0
0,0,2,2,6,5,11,6,7,13,0.000333,0.014991,3,134.917833,7.495435,44.972611,27.119415,1,0
0,0,2,2,6,5,11,6,7,13,0.000333,0.014991,3,134.917833,7.495435,44.972611,27.119415,1,0
0,0,2,2,8,5,13,8,7,15,0.000333,0.018502,4,222.026383,12.334799,55.506596,35.60964,1,0
0,0,8,8,14,20,34,42,28,70,0.000333,0.118707,7,2492.856792,138.492044,356.122399,139.741531,4,0
0,0,2,2,6,5,11,6,7,13,0.000333,0.014991,3,134.917833,7.495435,44.972611,27.119415,1,0
0,0,2,2,6,5,11,6,7,13,0.000333,0.014991,3,134.917833,7.495435,44.972611,27.119415,1,0
0,0,2,2,6,5,11,6,7,13,0.000333,0.014991,3,134.917833,7.495435,44.972611,27.119415,1,0
0,0,2,2,8,5,13,8,7,15,0.000333,0.018502,4,222.026383,12.334799,55.506596,35.60964,1,0
0,0,19,19,17,36,53,110,65,175,0.000333,0.334129,8,8019.088636,445.504924,1002.38608,255.604168,10,0
0,0,2,2,6,5,11,6,7,13,0.000333,0.014991,3,134.917833,7.495435,44.972611,27.119415,1,0
0,0,2,2,6,5,11,6,7,13,0.000333,0.014991,3,134.917833,7.495435,44.972611,27.119415,1,0
0,0,2,2,6,5,11,6,7,13,0.000333,0.014991,3,134.917833,7.495435,44.972611,27.119415,1,0
0,0,2,2,8,5,13,8,7,15,0.000333,0.018502,4,222.026383,12.334799,55.506596,35.60964,1,0
0,0,19,19,19,27,46,100,61,161,0.000333,0.296431,18,16007.28255,889.293475,889.293475,209.092585,14,0
0,0,18,18,19,26,45,90,57,147,0.000333,0.269101,18,14531.44329,807.302405,807.302405,202.922055,14,0
0,0,13,13,12,21,33,43,49,92,0.000333,0.154695,12,5569.011108,309.389506,464.084259,135.258216,3,0
0,0,14,14,12,21,33,44,51,95,0.000333,0.159739,12,5750.609296,319.478294,479.217441,135.258216,3,0
0,0,14,14,15,24,39,51,55,106,0.000333,0.186751,14,7843.536893,435.75205,560.252635,168.642459,4,0
0,0,15,15,15,24,39,52,57,109,0.000333,0.192036,14,8065.523786,448.084655,576.108842,168.642459,4,0
0,0,3,3,10,17,27,19,19,38,0.000333,0.060229,5,903.428625,50.190479,180.685725,102.706149,1,0
0,0,3,3,10,17,27,19,19,38,0.000333,0.060229,5,903.428625,50.190479,180.685725,102.706149,1,0
0,0,3,3,11,13,24,17,14,31,0.000333,0.047378,5,710.669188,39.481622,142.133838,86.159464,1,0
0,0,9,9,10,12,22,31,27,58,0.000333,0.086216,10,2586.470339,143.692797,258.647034,76.238831,1,0
0,0,3,3,10,17,27,19,19,38,0.000333,0.060229,5,903.428625,50.190479,180.685725,102.706149,1,0
0,0,3,3,11,13,24,17,14,31,0.000333,0.047378,5,710.669188,39.481622,142.133838,86.159464,1,0
0,0,28,28,20,51,71,122,97,219,0.000333,0.448932,10,13467.94619,748.219233,1346.794619,375.732254,9,0
0,0,27,27,20,51,71,121,95,216,0.000333,0.442782,10,13283.45378,737.969654,1328.345378,375.732254,9,0
0,0,29,29,22,53,75,127,101,228,0.000333,0.47339,11,15621.87728,867.882071,1420.170661,401.68728,10,0
0,0,28,28,22,53,75,126,99,225,0.000333,0.467161,11,15416.32626,856.46257,1401.484205,401.68728,10,0
0,0,21,21,16,23,39,84,75,159,0.000333,0.280126,24,20169.09487,1120.50527,840.378953,168.041925,2,0
0,0,10,10,13,18,31,43,37,80,0.000333,0.132112,12,4756.028458,264.223803,396.335705,123.164366,2,0
0,0,14,14,15,16,31,51,47,98,0.000333,0.161837,14,6797.157338,377.619852,485.511238,122.603359,2,0
0,0,11,11,15,16,31,40,35,75,0.000333,0.123855,14,5201.906126,288.994785,371.564723,122.603359,2,0
0,0,17,17,18,22,40,62,66,128,0.000333,0.227069,27,18392.5835,1021.810194,681.206796,173.166146,2,0
0,0,14,14,16,21,37,52,49,101,0.000333,0.175385,16,8418.476639,467.693147,526.15479,156.238666,2,0
0,0,14,14,17,21,38,52,50,102,0.000333,0.17843,16,8564.617702,475.812095,535.288606,161.725534,2,0
0,0,9,9,15,18,33,40,36,76,0.000333,0.127791,14,5367.235343,298.179741,383.373953,133.662009,2,0
0,0,7,7,8,13,21,18,25,43,0.000333,0.062957,4,755.478597,41.971033,188.869649,72.105716,1,0
0,0,7,7,9,14,23,18,24,42,0.000333,0.06333,4,759.958409,42.219912,189.989602,81.832294,1,0
0,0,10,10,14,19,33,38,39,77,0.000333,0.129473,14,5437.856861,302.103159,388.418347,134.013592,2,0
0,0,6,6,14,15,29,36,27,63,0.000333,0.102018,7,2142.369619,119.020534,306.052803,111.906328,3,0
0,0,6,6,12,12,24,25,20,45,0.000333,0.068774,6,1237.939875,68.774438,206.323313,86.0391,1,0
0,0,24,24,22,30,52,119,85,204,0.000333,0.38763,22,25583.57346,1421.309636,1162.889703,245.314213,8,0
0,0,24,24,21,31,52,136,96,232,0.000333,0.440834,30,39675.06044,2204.170024,1322.502015,245.818752,9,0
0,0,7,7,19,19,38,46,30,76,0.000333,0.132947,9,3589.582419,199.421246,398.842491,161.421246,4,0
0,0,17,17,15,23,38,70,63,133,0.000333,0.232658,14,9771.64103,542.868946,697.974359,162.645284,2,0
0,0,13,13,15,21,36,55,46,101,0.000333,0.174054,14,7310.273952,406.126331,522.162425,150.842025,2,0
0,0,14,14,12,20,32,58,53,111,0.000333,0.185,12,6660,370,555,129.458112,1,0
0,0,16,16,16,23,39,66,58,124,0.000333,0.218463,16,10486.238,582.568778,655.389875,168.041925,2,0
0,0,4,4,8,9,17,14,14,28,0.000333,0.03815,4,457.795838,25.433102,114.44896,52.529325,1,0
0,0,18,18,14,21,35,68,67,135,0.000333,0.230818,21,14541.51735,807.862075,692.453207,145.541635,2,0
0,0,17,17,14,21,35,66,65,131,0.000333,0.223979,21,14110.65758,783.925421,671.936075,145.541635,2,0
0,0,18,18,15,22,37,69,72,141,0.000333,0.244844,21,15425.19142,856.955079,734.532925,156.710855,2,0
0,0,17,17,15,22,37,67,70,137,0.000333,0.237898,21,14987.59733,832.644296,713.695111,156.710855,2,0
0,0,18,18,11,19,30,70,74,144,0.000333,0.235531,15,10598.88369,588.826871,706.592246,118.764371,1,0
0,0,21,21,15,22,37,83,82,165,0.000333,0.28652,21,18050.75591,1002.819773,859.559805,156.710855,2,0
0,0,10,10,14,17,31,49,36,85,0.000333,0.140369,14,5895.493609,327.527423,421.106686,122.789837,2,0
0,0,3,3,11,13,24,17,14,31,0.000333,0.047378,5,710.669188,39.481622,142.133838,86.159464,1,0
0,0,16,16,16,17,33,60,53,113,0.000333,0.190006,24,13680.39685,760.022047,570.016535,133.486868,2,0
0,0,12,12,15,17,32,43,37,80,0.000333,0.133333,14,5600,311.111111,400,128.090227,2,0
0,0,12,12,14,18,32,55,41,96,0.000333,0.16,14,6720,373.333333,480,128.361619,5,0
0,0,6,6,9,9,18,16,14,30,0.000333,0.041699,4,500.391,27.7995,125.09775,57.05865,1,0
0,0,12,12,15,17,32,56,40,96,0.000333,0.16,14,6720,373.333333,480,128.090227,5,0
0,0,3,3,7,9,16,10,11,21,0.000333,0.028,3,252,14,84,48.180809,1,0
0,0,3,3,7,10,17,10,12,22,0.000333,0.029975,3,269.772548,14.987364,89.924183,52.870765,1,0
0,0,3,3,9,11,20,13,15,28,0.000333,0.040338,4,484.055947,26.891997,121.013987,66.583073,1,0
0,0,3,3,7,10,17,10,12,22,0.000333,0.029975,3,269.772548,14.987364,89.924183,52.870765,1,0
0,0,3,3,10,11,21,15,15,30,0.000333,0.043923,5,658.847613,36.602645,131.769523,71.273029,1,0
0,0,20,20,22,46,68,171,103,274,0.000333,0.555988,22,36695.22601,2038.623667,1667.964819,352.191346,16,0
0,0,20,20,23,44,67,169,99,268,0.000333,0.541904,22,35765.66187,1986.981215,1625.711903,344.256916,16,0
0,0,14,14,22,42,64,149,90,239,0.000333,0.478,22,31548,1752.666667,1434,324.584827,15,0
0,0,18,18,21,34,55,123,73,196,0.000333,0.377716,20,22662.93008,1259.051671,1133.146504,265.212402,13,0
0,0,14,14,19,27,46,100,60,160,0.000333,0.29459,18,15907.85843,883.769913,883.769913,209.092585,10,0
0,0,12,12,19,25,44,96,60,156,0.000333,0.28389,18,15330.08399,851.671333,851.671333,196.807027,8,0
0,0,26,26,21,35,56,132,83,215,0.000333,0.416194,20,24971.62617,1387.312565,1248.581308,271.763571,10,0
0,0,6,6,13,11,24,31,19,50,0.000333,0.076416,6,1375.48875,76.416042,229.248125,86.159464,3,0
0,0,6,6,13,13,26,33,20,53,0.000333,0.083041,6,1494.73983,83.041102,249.123305,96.211433,2,0
0,0,9,9,14,15,29,61,35,96,0.000333,0.155455,14,6529.126457,362.729248,466.366176,111.906328,3,0
0,0,9,9,14,17,31,63,36,99,0.000333,0.163488,14,6866.516086,381.473116,490.465435,122.789837,2,0
0,0,9,9,14,15,29,61,35,96,0.000333,0.155455,14,6529.126457,362.729248,466.366176,111.906328,3,0
0,0,9,9,14,17,31,63,36,99,0.000333,0.163488,14,6866.516086,381.473116,490.465435,122.789837,2,0
0,0,4,4,12,18,30,32,24,56,0.000333,0.091595,6,1648.71524,91.595291,274.785873,118.0782,2,0
0,0,9,9,14,19,33,43,29,72,0.000333,0.121065,7,2542.374636,141.243035,363.196377,134.013592,4,0
0,0,12,12,16,23,39,55,38,93,0.000333,0.163847,8,3932.339251,218.463292,491.542406,168.041925,5,0
0,0,33,33,27,37,64,170,124,294,0.000333,0.588,39,68796,3822,1764,321.131737,9,0
0,0,70,70,29,47,76,320,227,547,0.000333,1.139205,56,191386.5156,10632.5842,3417.61635,401.947125,21,0
0,0,61,61,29,47,76,290,206,496,0.000333,1.032991,56,173542.4346,9641.246367,3098.972047,401.947125,23,0
0,0,14,14,10,12,22,53,44,97,0.000333,0.144188,15,6488.473005,360.470723,432.564867,76.238831,1,0
0,0,14,14,14,22,36,57,47,104,0.000333,0.179224,14,7527.410802,418.189489,537.6722,151.410465,4,0
0,0,15,15,14,22,36,58,49,107,0.000333,0.184394,14,7744.547652,430.252647,553.181975,151.410465,4,0
0,0,15,15,13,19,32,51,48,99,0.000333,0.165,12,5940,330,495,128.816339,2,0
0,0,18,18,16,22,38,64,56,120,0.000333,0.209917,16,10076.02083,559.778935,629.751302,162.107496,3,0
0,0,10,10,13,19,32,42,33,75,0.000333,0.125,6,2250,125,375,128.816339,2,0
0,0,15,15,14,20,34,70,48,118,0.000333,0.200107,14,8404.488614,466.916034,600.320615,139.741531,5,0
0,0,6,6,9,12,21,15,17,32,0.000333,0.046851,4,562.21663,31.234257,140.554158,71.548875,1,0
0,0,15,15,15,22,37,71,48,119,0.000333,0.206642,14,8678.949307,482.16385,619.924951,156.710855,5,0
0,0,3,3,6,8,14,7,9,16,0.000333,0.020306,3,182.753036,10.152946,60.917679,39.509775,1,0
0,0,3,3,6,9,15,7,10,17,0.000333,0.022139,3,199.25142,11.069523,66.41714,44.0391,1,0
0,0,4,4,9,13,22,13,19,32,0.000333,0.047567,4,570.807247,31.711514,142.701812,76.635041,1,0
0,0,3,3,6,9,15,7,10,17,0.000333,0.022139,3,199.25142,11.069523,66.41714,44.0391,1,0
0,0,4,4,10,13,23,15,19,34,0.000333,0.051267,5,769.005533,42.72253,153.801107,81.324997,1,0
0,0,19,19,15,24,39,95,66,161,0.000333,0.28365,14,11913.2966,661.849811,850.949757,168.642459,5,0
0,0,10,10,11,17,28,40,36,76,0.000333,0.121786,10,3653.589741,202.977208,365.358974,107.540616,1,0
0,0,19,19,17,26,43,98,67,165,0.000333,0.298445,16,14325.33895,795.852164,895.333685,191.698301,5,0
0,0,3,3,7,9,16,10,11,21,0.000333,0.028,3,252,14,84,48.180809,1,0
0,0,3,3,7,10,17,10,12,22,0.000333,0.029975,3,269.772548,14.987364,89.924183,52.870765,1,0
0,0,11,11,11,17,28,44,39,83,0.000333,0.133003,10,3990.104585,221.672477,399.010459,107.540616,1,0
0,0,3,3,7,10,17,10,12,22,0.000333,0.029975,3,269.772548,14.987364,89.924183,52.870765,1,0
0,0,29,29,21,53,74,158,112,270,0.000333,0.558851,20,33531.04817,1862.83601,1676.552409,395.81845,9,0
0,0,11,11,16,21,37,44,36,80,0.000333,0.138919,8,3334.050154,185.225009,416.756269,156.238666,4,0
0,0,12,12,16,21,37,45,38,83,0.000333,0.144128,8,3459.077035,192.170946,432.384629,156.238666,4,0
0,0,18,18,16,21,37,72,65,137,0.000333,0.237898,24,17128.68267,951.593481,713.695111,156.238666,2,0
0,0,21,21,20,23,43,85,73,158,0.000333,0.285783,30,25720.49494,1428.916385,857.349831,190.480487,3,0
0,0,19,19,17,21,38,76,66,142,0.000333,0.248402,24,17884.93697,993.607609,745.205707,161.725534,2,0
0,0,9,9,9,14,23,26,31,57,0.000333,0.085948,8,2062.744252,114.596903,257.843031,81.832294,1,0
0,0,7,7,10,15,25,32,31,63,0.000333,0.097521,10,2925.6294,162.534967,292.56294,91.82264,1,0
0,0,9,9,14,18,32,40,36,76,0.000333,0.126667,14,5320,295.555556,380,128.361619,2,0
0,0,19,19,16,21,37,77,53,130,0.000333,0.225743,16,10835.663,601.981278,677.228938,156.238666,7,0
0,0,19,19,16,21,37,77,53,130,0.000333,0.225743,16,10835.663,601.981278,677.228938,156.238666,7,0
0,0,20,20,16,21,37,78,55,133,0.000333,0.230952,16,11085.71676,615.873153,692.857298,156.238666,7,0
0,0,20,20,16,21,37,78,55,133,0.000333,0.230952,16,11085.71676,615.873153,692.857298,156.238666,7,0
0,0,18,18,18,21,39,72,60,132,0.000333,0.232558,18,12558.11567,697.673093,697.673093,167.297316,4,0
0,0,18,18,18,21,39,71,60,131,0.000333,0.230796,18,12462.97843,692.387691,692.387691,167.297316,4,0
0,0,11,11,15,20,35,44,32,76,0.000333,0.129942,7,2728.778565,151.598809,389.825509,145.041921,5,0
0,0,12,12,15,20,35,45,34,79,0.000333,0.135071,7,2836.493508,157.582973,405.213358,145.041921,5,0
0,0,11,11,15,20,35,44,32,76,0.000333,0.129942,7,2728.778565,151.598809,389.825509,145.041921,5,0
0,0,12,12,15,20,35,45,34,79,0.000333,0.135071,7,2836.493508,157.582973,405.213358,145.041921,5,0
0,0,25,25,20,44,64,110,81,191,0.000333,0.382,10,11460,636.666667,1146,326.653553,9,0
0,0,24,24,20,44,64,109,79,188,0.000333,0.376,10,11280,626.666667,1128,326.653553,9,0
0,0,25,25,20,44,64,110,81,191,0.000333,0.382,10,11460,636.666667,1146,326.653553,9,0
0,0,24,24,20,44,64,109,79,188,0.000333,0.376,10,11280,626.666667,1128,326.653553,9,0
0,0,13,13,16,21,37,49,35,84,0.000333,0.145865,8,3500.752662,194.486259,437.594083,156.238666,5,0
0,0,14,14,16,21,37,50,37,87,0.000333,0.151074,8,3625.779542,201.432197,453.222443,156.238666,5,0
0,0,13,13,16,21,37,49,35,84,0.000333,0.145865,8,3500.752662,194.486259,437.594083,156.238666,5,0
0,0,14,14,16,21,37,50,37,87,0.000333,0.151074,8,3625.779542,201.432197,453.222443,156.238666,5,0
0,0,13,13,13,16,29,65,43,108,0.000333,0.174887,12,6295.94337,349.774632,524.661947,112.105716,2,0
0,0,16,16,15,19,34,78,51,129,0.000333,0.218761,14,9187.957891,510.442105,656.282707,139.313982,3,0
0,0,13,13,12,16,28,64,43,107,0.000333,0.171462,12,6172.64372,342.924651,514.386977,107.01955,2,0
0,0,16,16,15,19,34,77,51,128,0.000333,0.217065,14,9116.733412,506.48519,651.195244,139.313982,3,0
0,0,30,30,19,52,71,128,113,241,0.000333,0.49403,18,26677.603,1482.089056,1482.089056,377.133488,10,0
0,0,29,29,19,52,71,127,111,238,0.000333,0.48788,18,26345.51666,1463.639814,1463.639814,377.133488,10,0
0,0,30,30,22,54,76,133,117,250,0.000333,0.520661,22,34363.60132,1909.088962,1561.981878,408.871421,11,0
0,0,29,29,22,54,76,132,115,247,0.000333,0.514413,22,33951.23811,1886.179895,1543.238096,408.871421,11,0
0,0,11,11,12,17,29,32,46,78,0.000333,0.126308,12,4547.070211,252.615012,378.922518,112.506418,2,0
0,0,30,30,23,52,75,135,117,252,0.000333,0.523221,22,34532.57082,1918.476157,1569.66231,400.46479,11,0
0,0,19,19,15,21,36,76,69,145,0.000333,0.24988,21,15742.42163,874.578979,749.639125,150.842025,2,0
0,0,9,9,13,16,29,37,30,67,0.000333,0.108495,6,1952.90836,108.494909,325.484727,112.105716,2,0
0,0,18,18,15,24,39,86,62,148,0.000333,0.260747,14,10951.3534,608.408522,782.239528,168.642459,6,0
0,0,17,17,16,24,40,82,61,143,0.000333,0.253679,16,12176.57148,676.476193,761.035718,174.0391,5,0
0,0,17,17,16,24,40,82,61,143,0.000333,0.253679,16,12176.57148,676.476193,761.035718,174.0391,5,0
0,0,9,9,10,16,26,31,32,63,0.000333,0.098709,10,2961.277022,164.51539,296.127702,97.219281,2,0
0,0,29,29,22,49,71,130,94,224,0.000333,0.459181,11,15152.9769,841.83205,1377.543355,373.228278,12,0
0,0,28,28,22,49,71,129,92,221,0.000333,0.453031,11,14950.03525,830.557514,1359.094113,373.228278,12,0
0,0,29,29,22,49,71,130,94,224,0.000333,0.459181,11,15152.9769,841.83205,1377.543355,373.228278,12,0
0,0,28,28,22,49,71,129,92,221,0.000333,0.453031,11,14950.03525,830.557514,1359.094113,373.228278,12,0
0,0,9,9,12,13,25,28,20,48,0.000333,0.074302,6,1337.430583,74.301699,222.905097,91.125266,4,0
0,0,9,9,12,12,24,28,20,48,0.000333,0.073359,6,1320.4692,73.3594,220.0782,86.0391,4,0
0,0,9,9,13,13,26,29,22,51,0.000333,0.079907,6,1438.334554,79.907475,239.722426,96.211433,4,0
0,0,9,9,12,13,25,28,22,50,0.000333,0.077398,6,1393.156857,77.397603,232.192809,91.125266,4,0
0,0,9,9,12,13,25,28,20,48,0.000333,0.074302,6,1337.430583,74.301699,222.905097,91.125266,4,0
0,0,9,9,12,12,24,28,20,48,0.000333,0.073359,6,1320.4692,73.3594,220.0782,86.0391,4,0
0,0,13,13,12,15,27,44,34,78,0.000333,0.123627,12,4450.574702,247.25415,370.881225,101.622909,3,0
0,0,16,16,16,18,34,57,42,99,0.000333,0.167886,16,8058.541141,447.69673,503.658821,139.05865,4,0
0,0,10,10,14,15,29,40,29,69,0.000333,0.111734,7,2346.404821,130.355823,335.200689,111.906328,2,0
0,0,13,13,12,15,27,44,34,78,0.000333,0.123627,12,4450.574702,247.25415,370.881225,101.622909,3,0
0,0,16,16,16,18,34,57,42,99,0.000333,0.167886,16,8058.541141,447.69673,503.658821,139.05865,4,0
0,0,10,10,14,15,29,40,29,69,0.000333,0.111734,7,2346.404821,130.355823,335.200689,111.906328,2,0
0,0,11,11,10,18,28,40,41,81,0.000333,0.129799,10,3893.957487,216.330971,389.395749,108.277931,1,0
0,0,11,11,12,21,33,40,38,78,0.000333,0.131154,6,2360.776448,131.154247,393.462741,135.258216,2,0
0,0,10,10,9,15,24,33,33,66,0.000333,0.100869,8,2420.8602,134.492233,302.607525,87.132684,1,0
0,0,8,8,9,15,24,24,23,47,0.000333,0.071831,4,861.97295,47.887386,215.493238,87.132684,1,0
0,0,11,11,12,20,32,43,42,85,0.000333,0.141667,12,5100,283.333333,425,129.458112,1,0
0,0,11,11,13,23,36,41,38,79,0.000333,0.136141,6,2450.544451,136.141358,408.424075,152.147641,2,0
0,0,11,11,9,16,25,37,36,73,0.000333,0.113001,8,2712.012015,150.667334,339.001502,92.529325,1,0
0,0,14,14,14,24,38,56,51,107,0.000333,0.187176,14,7861.395415,436.74419,561.528244,163.342069,2,0
0,0,11,11,11,19,30,35,43,78,0.000333,0.127579,10,3827.374665,212.631926,382.737466,118.764371,1,0
0,0,10,10,10,16,26,28,35,63,0.000333,0.098709,10,2961.277022,164.51539,296.127702,97.219281,1,0
0,0,11,11,13,21,34,38,44,82,0.000333,0.139057,12,5006.063436,278.114635,417.171953,140.344382,1,0
0,0,16,16,13,17,30,67,60,127,0.000333,0.207725,18,11217.1519,623.175106,623.175106,117.592585,2,0
0,0,18,18,16,19,35,75,65,140,0.000333,0.239367,24,17234.39094,957.466163,718.099622,144.710623,3,0
0,0,16,16,13,17,30,67,60,127,0.000333,0.207725,18,11217.1519,623.175106,623.175106,117.592585,2,0
0,0,18,18,16,19,35,75,65,140,0.000333,0.239367,24,17234.39094,957.466163,718.099622,144.710623,3,0
0,0,10,10,12,17,29,35,38,73,0.000333,0.118211,12,4255.591352,236.421742,354.632613,112.506418,2,0
0,0,18,18,15,24,39,70,65,135,0.000333,0.237843,14,9989.410194,554.967233,713.5293,168.642459,2,0
0,0,20,20,19,26,45,78,70,148,0.000333,0.270931,18,14630.29665,812.794258,812.794258,202.922055,3,0
0,0,10,10,13,15,28,36,37,73,0.000333,0.116979,12,4211.242912,233.95794,350.936909,106.709075,2,0
0,0,7,7,12,16,28,28,29,57,0.000333,0.09134,6,1644.115383,91.339744,274.019231,107.01955,2,0
0,0,17,17,14,22,36,68,66,134,0.000333,0.230923,21,14548.16895,808.231609,692.76995,151.410465,2,0
0,0,19,19,18,24,42,76,71,147,0.000333,0.264224,18,14268.0719,792.670661,792.670661,185.09775,3,0
0,0,7,7,12,17,29,28,30,58,0.000333,0.093921,6,1690.577386,93.920966,281.762898,112.506418,2,0
0,0,5,5,9,13,22,19,17,36,0.000333,0.053513,4,642.158153,35.675453,160.539538,76.635041,2,0
0,0,6,6,9,14,23,20,19,39,0.000333,0.058806,4,705.675665,39.204204,176.418916,81.832294,2,0
0,0,9,9,10,13,23,32,28,60,0.000333,0.090471,10,2714.137174,150.785399,271.413717,81.324997,2,0
0,0,9,9,10,13,23,32,30,62,0.000333,0.093487,10,2804.608413,155.811578,280.460841,81.324997,2,0
0,0,9,9,10,13,23,32,30,62,0.000333,0.093487,10,2804.608413,155.811578,280.460841,81.324997,2,0
0,0,13,13,13,19,32,43,46,89,0.000333,0.148333,12,5340,296.666667,445,128.816339,2,0
0,0,13,13,14,20,34,43,46,89,0.000333,0.150928,14,6338.9787,352.165483,452.784193,139.741531,2,0
0,0,16,16,13,19,32,55,60,115,0.000333,0.191667,18,10350,575,575,128.816339,2,0
0,0,18,18,17,22,39,63,65,128,0.000333,0.22551,16,10824.50374,601.361319,676.531484,167.594364,3,0
0,0,7,7,9,13,22,19,23,42,0.000333,0.062432,4,749.184512,41.621362,187.296128,76.635041,1,0
0,0,9,9,12,16,28,36,36,72,0.000333,0.115377,12,4153.554653,230.753036,346.129554,107.01955,2,0
0,0,11,11,16,19,35,44,41,85,0.000333,0.14533,16,6975.824903,387.545828,435.989056,144.710623,3,0
0,0,15,15,14,21,35,58,53,111,0.000333,0.189783,14,7970.905808,442.8281,569.350415,145.541635,2,0
0,0,15,15,15,22,37,58,53,111,0.000333,0.19275,14,8095.49053,449.749474,578.249324,156.710855,2,0
0,0,18,18,14,21,35,70,67,137,0.000333,0.234237,21,14756.94724,819.830402,702.711773,145.541635,2,0
0,0,20,20,18,24,42,78,72,150,0.000333,0.269616,27,21838.88556,1213.27142,808.847613,185.09775,3,0
0,0,12,12,11,15,26,54,40,94,0.000333,0.14728,10,4418.413335,245.467408,441.841334,96.657107,1,0
0,0,15,15,15,17,32,67,48,115,0.000333,0.191667,14,8050,447.222222,575,128.090227,2,0
0,0,9,9,14,15,29,38,29,67,0.000333,0.108495,7,2278.393087,126.577394,325.484727,111.906328,2,0
0,0,13,13,12,16,28,57,41,98,0.000333,0.15704,12,5653.449388,314.080522,471.120782,107.01955,2,0
0,0,16,16,16,18,34,70,49,119,0.000333,0.201803,16,9686.52925,538.140514,605.408078,139.05865,3,0
0,0,9,9,14,15,29,38,29,67,0.000333,0.108495,7,2278.393087,126.577394,325.484727,111.906328,2,0
0,0,13,13,12,16,28,57,41,98,0.000333,0.15704,12,5653.449388,314.080522,471.120782,107.01955,2,0
0,0,16,16,16,18,34,70,49,119,0.000333,0.201803,16,9686.52925,538.140514,605.408078,139.05865,3,0
0,0,9,9,14,15,29,38,29,67,0.000333,0.108495,7,2278.393087,126.577394,325.484727,111.906328,2,0
0,0,16,16,13,18,31,60,57,117,0.000333,0.193214,18,10433.53743,579.640968,579.640968,123.164366,2,0
0,0,18,18,15,21,36,68,62,130,0.000333,0.22403,14,9409.263503,522.736861,672.09025,150.842025,3,0
0,0,10,10,14,17,31,38,29,67,0.000333,0.110644,7,2323.51807,129.084337,331.931153,122.789837,3,0
0,0,16,16,12,18,30,59,57,116,0.000333,0.189733,18,10245.58756,569.199309,569.199309,118.0782,2,0
0,0,18,18,15,21,36,67,62,129,0.000333,0.222307,14,9336.884553,518.715808,666.920325,150.842025,3,0
0,0,10,10,14,17,31,37,29,66,0.000333,0.108992,7,2288.838695,127.157705,326.976956,122.789837,3,0
0,0,11,11,10,13,23,43,35,78,0.000333,0.117613,10,3528.378326,196.021018,352.837833,81.324997,1,0
0,0,14,14,14,16,30,56,43,99,0.000333,0.161927,14,6800.950366,377.830576,485.782169,117.302969,2,0
0,0,11,11,14,15,29,39,30,69,0.000333,0.111734,14,4692.809641,260.711647,335.200689,111.906328,2,0
0,0,10,10,14,15,29,37,28,65,0.000333,0.105256,7,2210.381353,122.798964,315.768765,111.906328,2,0
0,0,12,12,12,15,27,47,37,84,0.000333,0.133137,12,4792.926602,266.2737,399.41055,101.622909,2,0
0,0,15,15,14,18,32,60,45,105,0.000333,0.175,14,7350,408.333333,525,128.361619,3,0
0,0,12,12,14,17,31,43,32,75,0.000333,0.123855,7,2600.953063,144.497392,371.564723,122.789837,3,0
0,0,12,12,11,15,26,46,37,83,0.000333,0.130045,10,3901.364966,216.742498,390.136497,96.657107,2,0
0,0,15,15,14,18,32,59,45,104,0.000333,0.173333,14,7280,404.444444,520,128.361619,3,0
0,0,12,12,14,17,31,42,32,74,0.000333,0.122204,7,2566.273689,142.57076,366.610527,122.789837,3,0
0,0,15,15,15,18,33,63,51,114,0.000333,0.191687,14,8050.853014,447.269612,575.06093,133.662009,3,0
0,0,15,15,15,18,33,63,51,114,0.000333,0.191687,14,8050.853014,447.269612,575.06093,133.662009,3,0
0,0,15,15,15,18,33,63,51,114,0.000333,0.191687,14,8050.853014,447.269612,575.06093,133.662009,3,0
0,0,15,15,15,18,33,63,51,114,0.000333,0.191687,14,8050.853014,447.269612,575.06093,133.662009,3,0
0,0,10,10,10,18,28,38,36,74,0.000333,0.118581,10,3557.442642,197.635702,355.744264,108.277931,1,0
0,0,10,10,11,19,30,38,35,73,0.000333,0.119401,5,1791.015067,99.500837,358.203013,118.764371,1,0
0,0,18,18,11,22,33,75,69,144,0.000333,0.242131,15,10895.8913,605.327294,726.392753,136.161243,1,0
0,0,20,20,15,24,39,83,74,157,0.000333,0.276603,21,17425.97112,968.109506,829.808148,168.642459,2,0
0,0,17,17,15,24,39,72,62,134,0.000333,0.236081,14,9915.414563,550.856365,708.243897,168.642459,2,0
0,0,8,8,10,15,25,28,25,53,0.000333,0.082041,5,1230.62189,68.367883,246.124378,91.82264,2,0
0,0,10,10,13,18,31,37,31,68,0.000333,0.112295,6,2021.312095,112.295116,336.885349,123.164366,3,0
0,0,8,8,9,15,24,27,25,52,0.000333,0.079473,4,953.6722,52.981789,238.41805,87.132684,2,0
0,0,10,10,13,18,31,36,31,67,0.000333,0.110644,6,1991.586917,110.643718,331.931153,123.164366,3,0
0,0,8,8,9,14,23,27,24,51,0.000333,0.076901,4,922.806639,51.267036,230.70166,81.832294,2,0
0,0,10,10,13,17,30,36,30,66,0.000333,0.107952,6,1943.128676,107.951593,323.854779,117.592585,3,0
0,0,8,8,9,14,23,27,24,51,0.000333,0.076901,4,922.806639,51.267036,230.70166,81.832294,2,0
0,0,10,10,13,17,30,36,30,66,0.000333,0.107952,6,1943.128676,107.951593,323.854779,117.592585,3,0
0,0,3,3,9,10,19,12,12,24,0.000333,0.033983,4,407.801041,22.655613,101.95026,61.748606,1,0
0,0,3,3,9,11,20,12,13,25,0.000333,0.036016,4,432.192809,24.010712,108.048202,66.583073,1,0
0,0,3,3,12,12,24,17,16,33,0.000333,0.050435,6,907.822575,50.434588,151.303763,86.0391,1,0
0,0,3,3,9,11,20,12,13,25,0.000333,0.036016,4,432.192809,24.010712,108.048202,66.583073,1,0
0,0,3,3,11,12,23,15,16,31,0.000333,0.046743,5,701.152103,38.952895,140.230421,81.073298,1,0
0,0,16,16,14,19,33,50,70,120,0.000333,0.201776,21,12711.87318,706.215177,605.327294,134.013592,3,0
0,0,16,16,14,21,35,48,69,117,0.000333,0.200042,21,12602.64837,700.147132,600.126113,145.541635,2,0
0,0,16,16,16,19,35,56,72,128,0.000333,0.218849,24,15757.15743,875.397635,656.548226,144.710623,4,0
0,0,16,16,16,21,37,54,71,125,0.000333,0.217061,24,15628.3601,868.242228,651.181671,156.238666,3,0
0,0,10,10,13,20,33,37,30,67,0.000333,0.112658,6,2027.846436,112.658135,337.974406,134.544278,4,0
0,0,11,11,13,20,33,38,32,70,0.000333,0.117703,6,2118.64553,117.702529,353.107588,134.544278,4,0
0,0,10,10,13,20,33,37,30,67,0.000333,0.112658,6,2027.846436,112.658135,337.974406,134.544278,4,0
0,0,11,11,13,20,33,38,32,70,0.000333,0.117703,6,2118.64553,117.702529,353.107588,134.544278,4,0
0,0,14,14,13,17,30,60,42,102,0.000333,0.166834,12,6006.034089,333.668561,500.502841,117.592585,2,0
0,0,17,17,16,20,36,73,50,123,0.000333,0.211967,16,10174.4124,565.245133,635.900775,150.438562,3,0
0,0,14,14,13,16,29,60,42,102,0.000333,0.165171,12,5946.168738,330.342708,495.514062,112.105716,2,0
0,0,17,17,16,19,35,73,50,123,0.000333,0.210301,16,10094.42898,560.80161,630.901811,144.710623,3,0
0,0,25,25,19,48,67,114,97,211,0.000333,0.426648,18,23039.00675,1279.944819,1279.944819,348.788823,9,0
0,0,25,25,20,49,69,115,103,218,0.000333,0.443886,20,26633.16663,1479.620368,1331.658332,361.559344,9,0
0,0,47,47,28,56,84,179,149,328,0.000333,0.698893,28,58707.04321,3261.502401,2096.680115,459.817813,14,0
0,0,12,12,17,17,34,36,57,93,0.000333,0.157711,24,11355.21706,630.845392,473.134044,138.973737,2,0
0,0,9,9,10,13,23,32,30,62,0.000333,0.093487,10,2804.608413,155.811578,280.460841,81.324997,2,0
0,0,9,9,10,13,23,32,30,62,0.000333,0.093487,10,2804.608413,155.811578,280.460841,81.324997,2,0
0,0,12,12,20,24,44,50,51,101,0.000333,0.183801,20,11028.05187,612.669548,551.402593,196.477662,4,0
0,0,10,10,16,18,34,32,40,72,0.000333,0.122099,16,5860.757193,325.597622,366.297325,139.05865,2,0
0,0,10,10,13,22,35,39,35,74,0.000333,0.126522,6,2277.40166,126.522314,379.566943,146.213212,3,0
0,0,11,11,13,22,35,40,37,77,0.000333,0.131652,6,2369.728754,131.651597,394.954792,146.213212,3,0
0,0,10,10,16,24,40,44,39,83,0.000333,0.14724,8,3533.760255,196.320014,441.720032,174.0391,4,0
0,0,11,11,16,24,40,45,41,86,0.000333,0.152562,8,3661.486529,203.415918,457.685816,174.0391,4,0
0,0,22,22,17,20,37,104,68,172,0.000333,0.298675,24,21504.62349,1194.701305,896.025979,155.92543,3,0
0,0,25,25,19,22,41,117,76,193,0.000333,0.344669,27,27918.2035,1551.011305,1034.007537,178.818118,4,0
0,0,10,10,14,14,28,42,30,72,0.000333,0.115377,14,4845.813761,269.211876,346.129554,106.605938,2,0
0,0,18,18,16,18,34,74,52,126,0.000333,0.213673,16,10256.32509,569.795838,641.020318,139.05865,3,0
0,0,21,21,19,20,39,87,60,147,0.000333,0.258985,27,20977.76141,1165.431189,776.954126,167.149185,4,0
0,0,18,18,16,18,34,74,52,126,0.000333,0.213673,16,10256.32509,569.795838,641.020318,139.05865,3,0
0,0,21,21,19,20,39,87,60,147,0.000333,0.258985,27,20977.76141,1165.431189,776.954126,167.149185,4,0
0,0,13,13,13,16,29,65,43,108,0.000333,0.174887,12,6295.94337,349.774632,524.661947,112.105716,2,0
0,0,16,16,15,19,34,78,51,129,0.000333,0.218761,14,9187.957891,510.442105,656.282707,139.313982,3,0
0,0,13,13,12,16,28,64,43,107,0.000333,0.171462,12,6172.64372,342.924651,514.386977,107.01955,2,0
0,0,16,16,15,19,34,77,51,128,0.000333,0.217065,14,9116.733412,506.48519,651.195244,139.313982,3,0
0,0,12,12,13,20,33,50,44,94,0.000333,0.158058,12,5690.076567,316.115365,474.173047,134.544278,4,0
0,0,9,9,10,15,25,29,30,59,0.000333,0.091329,10,2739.875152,152.215286,273.987515,91.82264,2,0
0,0,12,12,15,22,37,53,45,98,0.000333,0.170175,14,7147.370018,397.076112,510.52643,156.710855,4,0
0,0,17,17,13,22,35,56,67,123,0.000333,0.210301,18,11356.2326,630.901811,630.901811,146.213212,2,0
0,0,17,17,14,23,37,56,71,127,0.000333,0.220534,21,13893.61213,771.86734,661.600577,157.344894,2,0
0,0,18,18,10,20,30,59,78,137,0.000333,0.224081,15,10083.66017,560.203343,672.244012,119.657843,1,0
0,0,20,20,14,23,37,67,83,150,0.000333,0.260473,21,16409.7781,911.654339,781.418005,157.344894,2,0
0,0,5,5,10,12,22,20,18,38,0.000333,0.056486,5,847.292008,47.071778,169.458402,76.238831,2,0
0,0,9,9,10,15,25,27,31,58,0.000333,0.089781,10,2693.43659,149.635366,269.343659,91.82264,2,0
0,0,5,5,10,13,23,20,19,39,0.000333,0.058806,5,882.094581,49.005255,176.418916,81.324997,2,0
0,0,9,9,11,17,28,28,32,60,0.000333,0.096147,5,1442.206477,80.122582,288.441295,107.540616,2,0
0,0,13,13,12,20,32,50,51,101,0.000333,0.168333,12,6060,336.666667,505,129.458112,4,0
0,0,10,10,9,15,24,29,39,68,0.000333,0.103926,8,2494.2196,138.567756,311.77745,87.132684,2,0
0,0,13,13,14,22,36,53,54,107,0.000333,0.184394,14,7744.547652,430.252647,553.181975,151.410465,4,0
0,0,13,13,11,15,26,44,34,78,0.000333,0.122211,10,3666.34298,203.685721,366.634298,96.657107,3,0
0,0,16,16,15,18,33,57,42,99,0.000333,0.166465,14,6991.530249,388.418347,499.395018,133.662009,4,0
0,0,13,13,11,15,26,44,34,78,0.000333,0.122211,10,3666.34298,203.685721,366.634298,96.657107,3,0
0,0,16,16,15,18,33,57,42,99,0.000333,0.166465,14,6991.530249,388.418347,499.395018,133.662009,4,0
0,0,16,16,13,18,31,56,41,97,0.000333,0.160186,12,5766.684505,320.371361,480.557042,123.164366,3,0
0,0,19,19,16,21,37,69,49,118,0.000333,0.204905,16,9835.447954,546.413775,614.715497,156.238666,4,0
0,0,25,25,22,44,66,114,83,197,0.000333,0.396915,11,13098.20206,727.677892,1190.745642,338.322487,9,0
0,0,24,24,22,44,66,113,81,194,0.000333,0.390871,11,12898.73705,716.596503,1172.612459,338.322487,9,0
0,0,13,13,11,15,26,44,34,78,0.000333,0.122211,10,3666.34298,203.685721,366.634298,96.657107,3,0
0,0,16,16,15,18,33,57,42,99,0.000333,0.166465,14,6991.530249,388.418347,499.395018,133.662009,4,0
0,0,13,13,11,15,26,44,34,78,0.000333,0.122211,10,3666.34298,203.685721,366.634298,96.657107,3,0
0,0,16,16,15,18,33,57,42,99,0.000333,0.166465,14,6991.530249,388.418347,499.395018,133.662009,4,0
0,0,13,13,12,16,28,45,35,80,0.000333,0.128196,12,4615.060725,256.392263,384.588394,107.01955,3,0
0,0,16,16,15,19,34,58,43,101,0.000333,0.171278,14,7193.672458,399.64847,513.833747,139.313982,4,0
0,0,13,13,11,16,27,44,35,79,0.000333,0.125212,10,3756.361127,208.686729,375.636113,102.053748,3,0
0,0,16,16,15,19,34,57,43,100,0.000333,0.169582,14,7122.447978,395.691554,508.746284,139.313982,4,0
0,0,13,13,12,16,28,45,35,80,0.000333,0.128196,12,4615.060725,256.392263,384.588394,107.01955,3,0
0,0,16,16,15,19,34,58,43,101,0.000333,0.171278,14,7193.672458,399.64847,513.833747,139.313982,4,0
0,0,13,13,11,16,27,44,35,79,0.000333,0.125212,10,3756.361127,208.686729,375.636113,102.053748,3,0
0,0,16,16,15,19,34,57,43,100,0.000333,0.169582,14,7122.447978,395.691554,508.746284,139.313982,4,0
0,0,4,4,10,13,23,19,19,38,0.000333,0.057298,5,859.476772,47.74871,171.895354,81.324997,2,0
0,0,4,4,10,14,24,19,21,40,0.000333,0.061133,5,916.9925,50.944028,183.3985,86.52225,2,0
0,0,23,23,19,41,60,100,77,177,0.000333,0.348507,9,9409.676719,522.759818,1045.519635,300.370255,7,0
0,0,17,17,15,20,35,70,57,127,0.000333,0.21714,14,9119.865204,506.659178,651.418943,145.041921,2,0
0,0,9,9,13,16,29,37,30,67,0.000333,0.108495,6,1952.90836,108.494909,325.484727,112.105716,2,0
0,0,16,16,15,24,39,74,59,133,0.000333,0.234319,14,9841.418932,546.745496,702.958495,168.642459,4,0
0,0,13,13,11,19,30,53,47,100,0.000333,0.163563,10,4906.890596,272.605033,490.68906,118.764371,2,0
0,0,15,15,15,24,39,70,58,128,0.000333,0.22551,14,9471.440776,526.191154,676.531484,168.642459,3,0
0,0,11,11,13,19,32,46,39,85,0.000333,0.141667,12,5100,283.333333,425,128.816339,2,0
0,0,14,14,17,22,39,59,47,106,0.000333,0.186751,16,8964.042163,498.002342,560.252635,167.594364,3,0
0,0,28,28,23,48,71,131,91,222,0.000333,0.455081,11,15017.68247,834.315693,1365.243861,372.120125,13,0
0,0,27,27,22,49,71,126,90,216,0.000333,0.442782,11,14611.79916,811.76662,1328.345378,373.228278,12,0
0,0,26,26,22,49,71,125,88,213,0.000333,0.436632,11,14408.8575,800.492083,1309.896136,373.228278,12,0
0,0,28,28,23,47,70,131,91,222,0.000333,0.453567,11,14967.70913,831.539396,1360.70083,365.107601,13,0
0,0,27,27,22,49,71,126,90,216,0.000333,0.442782,11,14611.79916,811.76662,1328.345378,373.228278,12,0
0,0,26,26,22,49,71,125,88,213,0.000333,0.436632,11,14408.8575,800.492083,1309.896136,373.228278,12,0
0,0,9,9,12,13,25,28,20,48,0.000333,0.074302,6,1337.430583,74.301699,222.905097,91.125266,4,0
0,0,9,9,12,12,24,28,20,48,0.000333,0.073359,6,1320.4692,73.3594,220.0782,86.0391,4,0
0,0,9,9,13,13,26,29,22,51,0.000333,0.079907,6,1438.334554,79.907475,239.722426,96.211433,4,0
0,0,9,9,12,13,25,28,22,50,0.000333,0.077398,6,1393.156857,77.397603,232.192809,91.125266,4,0
0,0,7,7,12,15,27,31,27,58,0.000333,0.091928,6,1654.700851,91.927825,275.783475,101.622909,2,0
0,0,19,19,14,22,36,81,73,154,0.000333,0.265389,21,16719.53746,928.863192,796.16845,151.410465,2,0
0,0,22,22,18,24,42,94,81,175,0.000333,0.314552,27,25478.69982,1415.483323,943.655549,185.09775,3,0
0,0,7,7,12,16,28,31,28,59,0.000333,0.094545,6,1701.803642,94.544647,283.63394,107.01955,2,0
0,0,12,12,16,19,35,56,42,98,0.000333,0.167557,16,8042.715771,446.817543,502.669736,144.710623,3,0
0,0,7,7,12,15,27,31,27,58,0.000333,0.091928,6,1654.700851,91.927825,275.783475,101.622909,2,0
0,0,21,21,14,23,37,87,85,172,0.000333,0.298675,21,18816.54556,1045.363642,896.025979,157.344894,2,0
0,0,24,24,18,25,43,100,93,193,0.000333,0.34909,27,28276.26564,1570.903646,1047.269098,191.155055,3,0
0,0,7,7,12,16,28,31,28,59,0.000333,0.094545,6,1701.803642,94.544647,283.63394,107.01955,2,0
0,0,12,12,16,19,35,56,42,98,0.000333,0.167557,16,8042.715771,446.817543,502.669736,144.710623,3,0
0,0,32,32,21,54,75,136,111,247,0.000333,0.512839,20,30770.36433,1709.464685,1538.518217,403.002591,11,0
0,0,31,31,21,54,75,135,109,244,0.000333,0.506611,20,30396.63521,1688.701956,1519.83176,403.002591,11,0
0,0,16,16,11,19,30,51,57,108,0.000333,0.176648,15,7949.162765,441.620154,529.944184,118.764371,2,0
0,0,19,19,15,22,37,64,65,129,0.000333,0.224006,14,9408.272778,522.681821,672.019484,156.710855,3,0
0,0,10,10,13,18,31,41,33,74,0.000333,0.122204,6,2199.663162,122.203509,366.610527,123.164366,2,0
0,0,15,15,12,18,30,49,47,96,0.000333,0.15702,12,5652.737966,314.040998,471.061497,118.0782,2,0
0,0,18,18,16,21,37,62,55,117,0.000333,0.203169,16,9752.0967,541.78315,609.506044,156.238666,3,0
0,0,22,22,20,43,63,101,76,177,0.000333,0.35266,10,10579.78547,587.765859,1057.978546,319.767946,9,0
0,0,21,21,20,43,63,100,74,174,0.000333,0.346682,10,10400.46707,577.803726,1040.046707,319.767946,9,0
0,0,31,31,21,54,75,136,104,240,0.000333,0.498305,10,14949.16486,830.509159,1494.916486,403.002591,11,0
0,0,30,30,21,54,75,135,102,237,0.000333,0.492077,10,14762.3003,820.127794,1476.23003,403.002591,11,0
0,0,15,15,13,19,32,51,48,99,0.000333,0.165,12,5940,330,495,128.816339,2,0
0,0,18,18,16,22,38,64,56,120,0.000333,0.209917,16,10076.02083,559.778935,629.751302,162.107496,3,0
0,0,10,10,13,19,32,42,33,75,0.000333,0.125,6,2250,125,375,128.816339,2,0
0,0,22,22,19,44,63,100,75,175,0.000333,0.348675,9,9414.21588,523.011993,1046.023987,320.925614,9,0
0,0,21,21,19,44,63,99,73,172,0.000333,0.342697,9,9252.829322,514.046073,1028.092147,320.925614,9,0
0,0,9,9,10,15,25,36,30,66,0.000333,0.102165,10,3064.945085,170.274727,306.494509,91.82264,2,0
0,0,12,12,14,18,32,49,38,87,0.000333,0.145,14,6090,338.333333,435,128.361619,3,0
0,0,10,10,13,18,31,41,33,74,0.000333,0.122204,6,2199.663162,122.203509,366.610527,123.164366,2,0
0,0,32,32,21,56,77,137,110,247,0.000333,0.515965,10,15478.96276,859.942375,1547.896276,417.450542,11,0
0,0,31,31,21,56,77,136,108,244,0.000333,0.509699,10,15290.95916,849.497731,1529.095916,417.450542,11,0
0,0,17,17,12,21,33,53,58,111,0.000333,0.186643,12,6719.132967,373.285165,559.927747,135.258216,2,0
0,0,20,20,16,24,40,66,66,132,0.000333,0.234165,16,11239.91214,624.439563,702.494509,174.0391,3,0
0,0,10,10,13,19,32,41,35,76,0.000333,0.126667,6,2280,126.666667,380,128.816339,2,0
0,0,8,8,11,17,28,33,33,66,0.000333,0.105762,5,1586.427124,88.13484,317.285425,107.540616,1,0
0,0,10,10,15,20,35,41,38,79,0.000333,0.135071,7,2836.493508,157.582973,405.213358,145.041921,2,0
0,0,13,13,10,18,28,50,67,117,0.000333,0.187487,15,8436.907888,468.717105,562.460526,108.277931,1,0
0,0,15,15,14,21,35,58,72,130,0.000333,0.222269,21,14002.94264,777.941258,666.806792,145.541635,2,0
0,0,13,13,12,20,32,58,52,110,0.000333,0.183333,12,6600,366.666667,550,129.458112,1,0
0,0,15,15,16,23,39,66,57,123,0.000333,0.216701,16,10401.67157,577.870643,650.104473,168.041925,2,0
0,0,19,19,16,23,39,78,69,147,0.000333,0.258985,24,18646.89903,1035.938835,776.954126,168.041925,2,0
0,0,9,9,13,17,30,33,33,66,0.000333,0.107952,6,1943.128676,107.951593,323.854779,117.592585,2,0
0,0,18,18,16,22,38,69,65,134,0.000333,0.234407,16,11251.55659,625.086477,703.222287,162.107496,2,0
0,0,8,8,9,10,19,22,20,42,0.000333,0.059471,8,1427.303645,79.294647,178.412956,61.748606,1,0
0,0,9,9,12,15,27,32,29,61,0.000333,0.096683,6,1740.288826,96.682713,290.048138,101.622909,1,0
0,0,9,9,10,16,26,29,34,63,0.000333,0.098709,10,2961.277022,164.51539,296.127702,97.219281,1,0
0,0,9,9,12,18,30,32,37,69,0.000333,0.112858,12,4062.905413,225.716967,338.575451,118.0782,1,0
0,0,9,9,12,18,30,32,37,69,0.000333,0.112858,12,4062.905413,225.716967,338.575451,118.0782,1,0
0,0,8,8,9,13,22,22,26,48,0.000333,0.071351,8,1712.421742,95.134541,214.052718,76.635041,1,0
0,0,13,13,11,16,27,45,42,87,0.000333,0.137892,10,4136.752127,229.819563,413.675213,102.053748,1,0
0,0,16,16,15,19,34,58,50,108,0.000333,0.183149,14,7692.243816,427.346879,549.445987,139.313982,2,0
0,0,15,15,15,19,34,57,48,105,0.000333,0.178061,14,7478.570377,415.476132,534.183598,139.313982,2,0
0,0,11,11,12,17,29,42,41,83,0.000333,0.134404,12,4838.549071,268.808282,403.212423,112.506418,1,0
0,0,13,13,13,21,34,61,50,111,0.000333,0.188236,12,6776.500505,376.47225,564.708375,140.344382,3,0
0,0,10,10,11,17,28,40,36,76,0.000333,0.121786,10,3653.589741,202.977208,365.358974,107.540616,1,0
0,0,13,13,15,23,38,64,51,115,0.000333,0.201171,14,8449.163297,469.397961,603.511664,162.645284,3,0
0,0,3,3,7,9,16,10,11,21,0.000333,0.028,3,252,14,84,48.180809,1,0
0,0,3,3,7,10,17,10,12,22,0.000333,0.029975,3,269.772548,14.987364,89.924183,52.870765,1,0
0,0,11,11,11,17,28,44,39,83,0.000333,0.133003,10,3990.104585,221.672477,399.010459,107.540616,1,0
0,0,3,3,7,10,17,10,12,22,0.000333,0.029975,3,269.772548,14.987364,89.924183,52.870765,1,0
0,0,17,17,16,26,42,79,61,140,0.000333,0.251641,16,12078.79103,671.043946,754.924439,186.211433,4,0
0,0,9,9,12,17,29,37,30,67,0.000333,0.108495,6,1952.90836,108.494909,325.484727,112.506418,3,0
0,0,6,6,9,9,18,16,14,30,0.000333,0.041699,4,500.391,27.7995,125.09775,57.05865,1,0
0,0,9,9,13,16,29,38,29,67,0.000333,0.108495,6,1952.90836,108.494909,325.484727,112.105716,3,0
0,0,3,3,7,9,16,10,11,21,0.000333,0.028,3,252,14,84,48.180809,1,0
0,0,3,3,7,10,17,10,12,22,0.000333,0.029975,3,269.772548,14.987364,89.924183,52.870765,1,0
0,0,3,3,9,11,20,13,15,28,0.000333,0.040338,4,484.055947,26.891997,121.013987,66.583073,1,0
0,0,3,3,7,10,17,10,12,22,0.000333,0.029975,3,269.772548,14.987364,89.924183,52.870765,1,0
0,0,3,3,10,11,21,15,15,30,0.000333,0.043923,5,658.847613,36.602645,131.769523,71.273029,1,0
0,0,12,12,13,20,33,52,46,98,0.000333,0.164784,12,5932.207484,329.567082,494.350624,134.544278,3,0
0,0,9,9,11,16,27,31,32,63,0.000333,0.099853,10,2995.579126,166.421063,299.557913,102.053748,1,0
0,0,12,12,15,22,37,55,47,102,0.000333,0.177121,14,7439.099406,413.2833,531.364243,156.710855,3,0
0,0,3,3,7,9,16,11,11,22,0.000333,0.029333,3,264,14.666667,88,48.180809,1,0
0,0,3,3,7,10,17,11,12,23,0.000333,0.031337,3,282.034936,15.668608,94.011645,52.870765,1,0
0,0,10,10,11,16,27,35,35,70,0.000333,0.110947,10,3328.421252,184.912292,332.842125,102.053748,1,0
0,0,3,3,7,10,17,11,12,23,0.000333,0.031337,3,282.034936,15.668608,94.011645,52.870765,1,0
0,0,16,16,16,25,41,70,57,127,0.000333,0.226803,16,10886.54567,604.808093,680.409105,180.096405,4,0
0,0,3,3,6,8,14,7,9,16,0.000333,0.020306,3,182.753036,10.152946,60.917679,39.509775,1,0
0,0,3,3,7,7,14,8,8,16,0.000333,0.020306,3,182.753036,10.152946,60.917679,39.302969,1,0
0,0,10,10,11,15,26,33,34,67,0.000333,0.104976,10,3149.294611,174.960812,314.929461,96.657107,1,0
0,0,9,9,11,15,26,29,31,60,0.000333,0.094009,10,2820.263831,156.681324,282.026383,96.657107,1,0
0,0,3,3,7,7,14,8,8,16,0.000333,0.020306,3,182.753036,10.152946,60.917679,39.302969,1,0
0,0,16,16,16,24,40,68,56,124,0.000333,0.219973,16,10558.70534,586.594741,659.919084,174.0391,4,0
0,0,12,12,15,21,36,53,46,99,0.000333,0.170608,14,7165.516052,398.084225,511.822575,150.842025,3,0
0,0,29,29,22,50,72,130,95,225,0.000333,0.462744,11,15270.56438,848.364688,1388.233125,380.300305,12,0
0,0,28,28,22,50,72,129,93,222,0.000333,0.456574,11,15066.95685,837.053159,1369.72335,380.300305,12,0
0,0,29,29,22,50,72,130,95,225,0.000333,0.462744,11,15270.56438,848.364688,1388.233125,380.300305,12,0
0,0,28,28,22,50,72,129,93,222,0.000333,0.456574,11,15066.95685,837.053159,1369.72335,380.300305,12,0
0,0,15,15,14,20,34,70,48,118,0.000333,0.200107,14,8404.488614,466.916034,600.320615,139.741531,5,0
0,0,6,6,9,12,21,15,17,32,0.000333,0.046851,4,562.21663,31.234257,140.554158,71.548875,1,0
0,0,15,15,15,22,37,71,48,119,0.000333,0.206642,14,8678.949307,482.16385,619.924951,156.710855,5,0
0,0,7,7,10,15,25,22,26,48,0.000333,0.074302,5,1114.525486,61.918083,222.905097,91.82264,1,0
0,0,6,6,9,12,21,15,17,32,0.000333,0.046851,4,562.21663,31.234257,140.554158,71.548875,1,0
0,0,7,7,11,17,28,23,26,49,0.000333,0.07852,5,1177.801956,65.433442,235.560391,107.540616,1,0
0,0,12,12,11,14,25,43,38,81,0.000333,0.125384,10,3761.523514,208.973529,376.152351,91.356717,2,0
0,0,16,16,12,22,34,57,66,123,0.000333,0.208586,18,11263.64273,625.757929,625.757929,141.127046,2,0
0,0,15,15,10,19,29,50,64,114,0.000333,0.184603,15,8307.147502,461.508195,553.809833,113.929904,2,0
0,0,15,15,12,22,34,53,69,122,0.000333,0.20689,18,11172.0684,620.670467,620.670467,141.127046,1,0
0,0,14,14,12,21,33,51,56,107,0.000333,0.179917,12,6477.002049,359.833447,539.750171,135.258216,2,0
0,0,13,13,10,18,28,44,52,96,0.000333,0.153835,10,4615.060725,256.392263,461.506073,108.277931,2,0
0,0,13,13,12,21,33,47,57,104,0.000333,0.174872,12,6295.403861,349.744659,524.616988,135.258216,1,0
0,0,15,15,13,17,30,51,46,97,0.000333,0.158656,12,5711.620653,317.312259,475.968388,117.592585,2,0
0,0,18,18,15,20,35,63,55,118,0.000333,0.201752,14,8473.575544,470.754197,605.255396,145.041921,3,0
0,0,14,14,15,20,35,47,38,85,0.000333,0.14533,7,3051.923395,169.5513,435.989056,145.041921,3,0
0,0,14,14,15,20,35,47,38,85,0.000333,0.14533,7,3051.923395,169.5513,435.989056,145.041921,3,0
0,0,12,12,11,15,26,40,40,80,0.000333,0.125345,10,3760.351775,208.908432,376.035177,96.657107,2,0
0,0,15,15,14,18,32,52,49,101,0.000333,0.168333,14,7070,392.777778,505,128.361619,3,0
0,0,12,12,14,17,31,38,34,72,0.000333,0.118901,14,4993.829881,277.434993,356.702134,122.789837,3,0
0,0,12,12,11,15,26,40,40,80,0.000333,0.125345,10,3760.351775,208.908432,376.035177,96.657107,2,0
0,0,15,15,14,18,32,52,49,101,0.000333,0.168333,14,7070,392.777778,505,128.361619,3,0
0,0,12,12,14,17,31,38,34,72,0.000333,0.118901,14,4993.829881,277.434993,356.702134,122.789837,3,0
0,0,12,12,11,15,26,40,40,80,0.000333,0.125345,10,3760.351775,208.908432,376.035177,96.657107,2,0
0,0,15,15,14,18,32,52,49,101,0.000333,0.168333,14,7070,392.777778,505,128.361619,3,0
0,0,12,12,14,17,31,38,34,72,0.000333,0.118901,14,4993.829881,277.434993,356.702134,122.789837,3,0
0,0,12,12,11,15,26,40,40,80,0.000333,0.125345,10,3760.351775,208.908432,376.035177,96.657107,2,0
0,0,15,15,14,18,32,52,49,101,0.000333,0.168333,14,7070,392.777778,505,128.361619,3,0
0,0,12,12,14,17,31,38,34,72,0.000333,0.118901,14,4993.829881,277.434993,356.702134,122.789837,3,0
0,0,12,12,12,16,28,41,41,82,0.000333,0.131401,12,4730.437243,262.802069,394.203104,107.01955,2,0
0,0,15,15,14,19,33,53,50,103,0.000333,0.173191,14,7274.01632,404.112018,519.572594,134.013592,3,0
0,0,12,12,14,18,32,39,35,74,0.000333,0.123333,7,2590,143.888889,370,128.361619,3,0
0,0,12,12,11,16,27,40,41,81,0.000333,0.128382,10,3851.458877,213.969938,385.145888,102.053748,2,0
0,0,15,15,14,19,33,52,50,102,0.000333,0.171509,14,7203.394802,400.1886,514.5282,134.013592,3,0
0,0,12,12,14,18,32,38,35,73,0.000333,0.121667,7,2555,141.944444,365,128.361619,3,0
0,0,16,16,13,19,32,60,51,111,0.000333,0.185,12,6660,370,555,128.816339,2,0
0,0,18,18,16,21,37,68,56,124,0.000333,0.215324,16,10335.55548,574.197527,645.972217,156.238666,3,0
0,0,16,16,13,18,31,60,51,111,0.000333,0.183305,12,6598.989485,366.610527,549.91579,123.164366,2,0
0,0,18,18,16,20,36,68,56,124,0.000333,0.21369,16,10257.1312,569.840622,641.0707,150.438562,3,0
0,0,20,20,15,21,36,86,74,160,0.000333,0.275729,21,17370.94801,965.052667,827.188,150.842025,2,0
0,0,10,10,14,16,30,47,35,82,0.000333,0.134122,14,5633.110404,312.950578,402.365029,117.302969,2,0
0,0,15,15,13,20,33,56,49,105,0.000333,0.176554,12,6355.93659,353.107588,529.661383,134.544278,2,0
0,0,14,14,13,20,33,54,47,101,0.000333,0.169828,12,6113.805673,339.655871,509.483806,134.544278,2,0
0,0,9,9,9,15,24,30,29,59,0.000333,0.090171,4,1082.05115,60.113953,270.512788,87.132684,1,0
0,0,15,15,14,21,35,56,49,105,0.000333,0.179525,14,7540.046035,418.891446,538.574717,145.541635,2,0
0,0,14,14,14,21,35,54,47,101,0.000333,0.172686,14,7252.806186,402.933677,518.057585,145.541635,2,0
0,0,9,9,10,16,26,30,28,58,0.000333,0.090875,5,1363.127518,75.729307,272.625504,97.219281,1,0
0,0,16,16,10,19,29,64,57,121,0.000333,0.195939,15,8817.235506,489.846417,587.8157,113.929904,1,0
0,0,19,19,14,22,36,77,65,142,0.000333,0.24471,14,10277.8109,570.989495,734.12935,151.410465,2,0
0,0,9,9,13,18,31,42,33,75,0.000333,0.123855,6,2229.38834,123.854908,371.564723,123.164366,2,0
0,0,16,16,14,22,36,60,52,112,0.000333,0.193011,14,8106.442402,450.357911,579.0316,151.410465,2,0
0,0,14,14,14,19,33,51,45,96,0.000333,0.161421,14,6779.665696,376.648094,484.261835,134.013592,2,0
0,0,13,13,14,19,33,49,43,92,0.000333,0.154695,14,6497.179626,360.954424,464.084259,134.013592,2,0
0,0,14,14,15,20,35,51,45,96,0.000333,0.164137,14,6893.756375,382.986465,492.41117,145.041921,2,0
0,0,13,13,15,20,35,49,43,92,0.000333,0.157298,14,6606.516526,367.028696,471.894038,145.041921,2,0
0,0,14,14,11,18,29,55,50,105,0.000333,0.170029,10,5100.880045,283.382225,510.088004,113.112398,1,0
0,0,17,17,15,21,36,68,58,126,0.000333,0.217137,14,9119.747703,506.65265,651.41055,150.842025,2,0
0,0,9,9,13,18,31,41,33,74,0.000333,0.122204,6,2199.663162,122.203509,366.610527,123.164366,2,0
0,0,14,14,13,24,37,54,47,101,0.000333,0.175385,6,3156.92874,175.38493,526.15479,158.144816,4,0
0,0,8,8,9,16,25,22,25,47,0.000333,0.072754,4,873.044964,48.502498,218.261241,92.529325,1,0
0,0,14,14,14,26,40,55,47,102,0.000333,0.180946,7,3799.85666,211.103148,542.836666,175.514402,4,0
0,0,11,11,9,17,26,35,38,73,0.000333,0.114377,8,2745.056795,152.503155,343.132099,98.016193,1,0
0,0,16,16,14,26,40,65,58,123,0.000333,0.218199,14,9164.360179,509.131121,654.597156,175.514402,4,0
0,0,5,5,9,13,22,18,19,37,0.000333,0.055,4,659.99588,36.666438,164.99897,76.635041,2,0
0,0,6,6,9,14,23,19,21,40,0.000333,0.060314,4,723.769913,40.20944,180.942478,81.832294,2,0
0,0,5,5,10,15,25,19,19,38,0.000333,0.058822,5,882.332676,49.018482,176.466535,91.82264,2,0
0,0,6,6,10,16,26,20,21,41,0.000333,0.064239,5,963.590142,53.532786,192.718028,97.219281,2,0
0,0,13,13,13,22,35,51,46,97,0.000333,0.165847,12,5970.485432,331.693635,497.540453,146.213212,3,0
0,0,14,14,13,22,35,52,48,100,0.000333,0.170976,12,6155.13962,341.952201,512.928302,146.213212,3,0
0,0,14,14,16,25,41,59,50,109,0.000333,0.194658,16,9343.570696,519.087261,583.973169,180.096405,4,0
0,0,15,15,16,25,41,60,52,112,0.000333,0.200015,16,9600.733192,533.374066,600.045825,180.096405,4,0
0,0,18,18,16,23,39,81,69,150,0.000333,0.26427,24,19027.44799,1057.080444,792.810333,168.041925,2,0
0,0,15,15,14,20,34,56,71,127,0.000333,0.215369,21,13568.2634,753.792411,646.107781,139.741531,2,0
0,0,17,17,16,22,38,72,65,137,0.000333,0.239655,16,11503.45711,639.080951,718.966069,162.107496,2,0
0,0,20,20,15,23,38,78,86,164,0.000333,0.286887,21,18073.86236,1004.103464,860.660112,162.645284,2,0
0,0,10,10,15,19,34,39,37,76,0.000333,0.128882,7,2706.530232,150.362791,386.647176,139.313982,2,0
0,0,6,6,8,11,19,14,13,27,0.000333,0.038231,4,458.776171,25.487565,114.694043,62.053748,2,0
0,0,6,6,9,10,19,15,12,27,0.000333,0.038231,4,458.776171,25.487565,114.694043,61.748606,2,0
0,0,28,28,22,45,67,138,91,229,0.000333,0.463045,22,30560.95734,1697.830963,1389.134425,345.240885,9,0
0,0,6,6,9,10,19,15,12,27,0.000333,0.038231,4,458.776171,25.487565,114.694043,61.748606,2,0
0,0,28,28,22,44,66,138,91,229,0.000333,0.461389,22,30451.65757,1691.758754,1384.166253,338.322487,9,0
0,0,6,6,9,10,19,15,12,27,0.000333,0.038231,4,458.776171,25.487565,114.694043,61.748606,2,0
0,0,13,13,12,15,27,37,28,65,0.000333,0.103023,6,1854.406126,103.022563,309.067688,101.622909,3,0
0,0,6,6,9,10,19,15,12,27,0.000333,0.038231,4,458.776171,25.487565,114.694043,61.748606,2,0
0,0,13,13,12,13,25,37,28,65,0.000333,0.100617,12,3622.207828,201.233768,301.850652,91.125266,3,0
0,0,14,14,12,16,28,49,44,93,0.000333,0.149028,12,5365.008093,298.056005,447.084008,107.01955,1,0
0,0,17,17,16,19,35,62,52,114,0.000333,0.194913,16,9355.812223,519.767346,584.738264,144.710623,2,0
0,0,16,16,16,19,35,61,50,111,0.000333,0.189783,16,9109.606638,506.089258,569.350415,144.710623,2,0
0,0,5,5,12,12,24,22,17,39,0.000333,0.059605,6,1072.881225,59.604513,178.813538,86.0391,1,0
0,0,8,8,15,15,30,35,25,60,0.000333,0.098138,7,2060.89405,114.494114,294.413436,117.206718,2,0
0,0,20,20,17,22,39,94,65,159,0.000333,0.280126,16,13446.06325,747.003514,840.378953,167.594364,5,0
0,0,19,19,15,24,39,93,64,157,0.000333,0.276603,14,11617.31408,645.406338,829.808148,168.642459,6,0
0,0,10,10,10,16,26,38,34,72,0.000333,0.112811,10,3384.316597,188.017589,338.43166,97.219281,2,0
0,0,19,19,17,26,43,96,65,161,0.000333,0.29121,16,13978.05801,776.558778,873.628626,191.698301,6,0
0,0,28,28,21,50,71,123,92,215,0.000333,0.440732,10,13221.95631,734.553128,1322.195631,374.431475,11,0
0,0,27,27,21,50,71,122,90,212,0.000333,0.434582,10,13037.46389,724.30355,1303.746389,374.431475,11,0
0,0,28,28,21,50,71,123,92,215,0.000333,0.440732,10,13221.95631,734.553128,1322.195631,374.431475,11,0
0,0,27,27,21,50,71,122,90,212,0.000333,0.434582,10,13037.46389,724.30355,1303.746389,374.431475,11,0
0,0,10,10,10,13,23,34,29,63,0.000333,0.094995,10,2849.844032,158.324668,284.984403,81.324997,1,0
0,0,12,12,11,13,24,42,37,79,0.000333,0.120737,10,3622.120376,201.22891,362.212038,86.159464,1,0
0,0,15,15,14,20,34,72,47,119,0.000333,0.201803,14,8475.713094,470.87295,605.408078,139.741531,5,0
0,0,7,7,12,14,26,36,28,64,0.000333,0.100276,12,3609.937704,200.552095,300.828142,96.322519,1,0
0,0,10,10,15,17,32,49,36,85,0.000333,0.141667,14,5950,330.555556,425,128.090227,2,0
0,0,7,7,9,13,22,19,23,42,0.000333,0.062432,4,749.184512,41.621362,187.296128,76.635041,1,0
0,0,7,7,9,15,24,28,30,58,0.000333,0.088643,8,2127.4226,118.190144,265.927825,87.132684,1,0
0,0,9,9,13,18,31,36,35,71,0.000333,0.117249,6,2110.487628,117.249313,351.747938,123.164366,2,0
0,0,15,15,14,20,34,56,71,127,0.000333,0.215369,21,13568.2634,753.792411,646.107781,139.741531,2,0
0,0,17,17,16,22,38,72,65,137,0.000333,0.239655,16,11503.45711,639.080951,718.966069,162.107496,2,0
0,0,13,13,13,20,33,44,47,91,0.000333,0.153013,12,5508.478378,306.026577,459.039865,134.544278,2,0
0,0,13,13,14,21,35,44,47,91,0.000333,0.155588,14,6534.706564,363.039254,466.764755,145.541635,2,0
0,0,14,14,10,18,28,47,54,101,0.000333,0.161848,15,7283.142707,404.619039,485.542847,108.277931,1,0
0,0,16,16,14,21,35,55,59,114,0.000333,0.194913,14,8186.335695,454.796428,584.738264,145.541635,2,0
0,0,19,19,13,23,36,62,77,139,0.000333,0.23954,18,12935.15235,718.619575,718.619575,152.147641,2,0
0,0,19,19,14,24,38,62,83,145,0.000333,0.25365,21,15979.93928,887.774404,760.949489,163.342069,2,0
0,0,13,13,9,18,27,46,66,112,0.000333,0.177516,12,6390.568803,355.0316,532.5474,103.587975,1,0
0,0,15,15,13,21,34,54,71,125,0.000333,0.211978,18,11446.79139,635.932855,635.932855,140.344382,2,0
0,0,16,16,12,19,31,64,61,125,0.000333,0.206425,18,11146.9417,619.274539,619.274539,123.730173,1,0
0,0,18,18,16,21,37,72,66,138,0.000333,0.239635,24,17253.70955,958.539419,718.904564,156.238666,2,0
0,0,14,14,12,17,29,55,48,103,0.000333,0.166791,12,6004.46451,333.581362,500.372042,112.506418,2,0
0,0,16,16,15,19,34,63,53,116,0.000333,0.196715,14,8262.039654,459.002203,590.14569,139.313982,3,0
0,0,14,14,12,16,28,55,48,103,0.000333,0.165053,18,8912.836025,495.157557,495.157557,107.01955,2,0
0,0,16,16,15,18,33,63,53,116,0.000333,0.19505,14,8192.09605,455.116447,585.149718,133.662009,3,0
0,0,5,5,9,14,23,21,18,39,0.000333,0.058806,4,705.675665,39.204204,176.418916,81.832294,2,0
0,0,6,6,9,14,23,22,20,42,0.000333,0.06333,4,759.958409,42.219912,189.989602,81.832294,2,0
0,0,9,9,10,15,25,36,30,66,0.000333,0.102165,10,3064.945085,170.274727,306.494509,91.82264,2,0
0,0,12,12,14,18,32,49,38,87,0.000333,0.145,14,6090,338.333333,435,128.361619,3,0
0,0,10,10,13,18,31,41,33,74,0.000333,0.122204,6,2199.663162,122.203509,366.610527,123.164366,2,0
0,0,20,20,18,29,47,83,77,160,0.000333,0.296245,18,15997.21589,888.734216,888.734216,215.940099,4,0
0,0,17,17,16,26,42,62,64,126,0.000333,0.226477,16,10870.91192,603.939551,679.431995,186.211433,2,0
0,0,15,15,15,26,41,61,63,124,0.000333,0.221445,14,9300.71028,516.706127,664.336449,180.814792,3,0
0,0,16,16,12,23,35,51,63,114,0.000333,0.194913,12,7016.859167,389.825509,584.738264,147.061475,1,0
0,0,19,19,16,26,42,64,71,135,0.000333,0.242654,16,11647.40563,647.078091,727.962852,186.211433,2,0
0,0,5,5,12,12,24,22,17,39,0.000333,0.059605,6,1072.881225,59.604513,178.813538,86.0391,1,0
0,0,8,8,15,15,30,35,25,60,0.000333,0.098138,7,2060.89405,114.494114,294.413436,117.206718,2,0
0,0,12,12,16,18,34,53,41,94,0.000333,0.159407,16,7651.544113,425.085784,478.221507,139.05865,3,0
0,0,10,10,13,16,29,44,34,78,0.000333,0.126308,12,4547.070211,252.615012,378.922518,112.105716,2,0
0,0,17,17,11,20,31,70,74,144,0.000333,0.237801,15,10701.06403,594.503557,713.404269,124.49231,1,0
0,0,20,20,15,23,38,83,82,165,0.000333,0.288636,21,18184.06883,1010.226046,865.90804,162.645284,2,0
0,0,9,9,13,17,30,40,33,73,0.000333,0.119401,6,2149.218081,119.401004,358.203013,117.592585,2,0
0,0,13,13,11,15,26,58,44,102,0.000333,0.159815,10,4794.448513,266.358251,479.444851,96.657107,1,0
0,0,16,16,15,18,33,71,52,123,0.000333,0.20682,14,8686.446674,482.580371,620.460477,133.662009,2,0
0,0,20,20,16,25,41,93,68,161,0.000333,0.287522,16,13801.05396,766.72522,862.565873,180.096405,6,0
0,0,11,11,10,17,27,38,40,78,0.000333,0.123627,10,3708.812252,206.045125,370.881225,102.706149,2,0
0,0,19,19,16,25,41,89,67,156,0.000333,0.278593,16,13372.4498,742.913878,835.778113,180.096405,5,0
0,0,17,17,16,23,39,77,63,140,0.000333,0.246652,16,11839.30097,657.738943,739.956311,168.041925,6,0
0,0,11,11,10,17,27,38,40,78,0.000333,0.123627,10,3708.812252,206.045125,370.881225,102.706149,2,0
0,0,16,16,16,23,39,73,62,135,0.000333,0.237843,16,11416.46879,634.248266,713.5293,168.041925,5,0
0,0,9,9,14,16,30,32,40,72,0.000333,0.117765,14,4946.14572,274.785873,353.296123,117.302969,4,0
0,0,9,9,14,16,30,32,40,72,0.000333,0.117765,14,4946.14572,274.785873,353.296123,117.302969,4,0
0,0,10,10,12,17,29,30,37,67,0.000333,0.108495,12,3905.81672,216.989818,325.484727,112.506418,3,0
0,0,8,8,14,11,25,28,24,52,0.000333,0.080494,14,3380.727306,187.818184,241.480522,91.356717,3,0
0,0,7,7,9,13,22,19,23,42,0.000333,0.062432,4,749.184512,41.621362,187.296128,76.635041,1,0
0,0,7,7,10,11,21,19,21,40,0.000333,0.058564,5,878.463485,48.803527,175.692697,71.273029,1,0
0,0,16,16,14,20,34,52,57,109,0.000333,0.184844,14,7763.468296,431.303794,554.53345,139.741531,2,0
0,0,13,13,14,20,34,41,45,86,0.000333,0.145841,14,6125.305261,340.294737,437.521804,139.741531,2,0
0,0,18,18,15,17,32,80,56,136,0.000333,0.226667,21,14280,793.333333,680,128.090227,2,0
0,0,10,10,15,14,29,45,31,76,0.000333,0.123069,14,5168.891779,287.160654,369.206556,111.906328,2,0
0,0,27,27,19,48,67,113,98,211,0.000333,0.426648,18,23039.00675,1279.944819,1279.944819,348.788823,7,0
0,0,26,26,19,48,67,112,96,208,0.000333,0.420582,18,22711.43793,1261.746552,1261.746552,348.788823,7,0
0,0,28,28,21,51,72,118,101,219,0.000333,0.450405,10,13512.13575,750.674209,1351.213575,381.532358,8,0
0,0,27,27,21,51,72,117,99,216,0.000333,0.444235,10,13327.038,740.391,1332.7038,381.532358,8,0
0,0,20,20,17,41,58,92,69,161,0.000333,0.314378,8,7545.079522,419.171085,943.13494,289.1465,7,0
0,0,19,19,17,41,58,91,67,158,0.000333,0.30852,8,7404.487978,411.360443,925.560997,289.1465,7,0
0,0,5,5,12,13,25,22,18,40,0.000333,0.061918,6,1114.525486,61.918083,185.754248,91.125266,1,0
0,0,8,8,15,16,31,35,26,61,0.000333,0.100735,7,2115.441825,117.524546,302.205975,122.603359,2,0
0,0,11,11,14,18,32,49,41,90,0.000333,0.15,14,6300,350,450,128.361619,3,0
0,0,5,5,12,13,25,22,18,40,0.000333,0.061918,6,1114.525486,61.918083,185.754248,91.125266,1,0
0,0,8,8,15,16,31,35,26,61,0.000333,0.100735,7,2115.441825,117.524546,302.205975,122.603359,2,0
0,0,11,11,14,18,32,49,41,90,0.000333,0.15,14,6300,350,450,128.361619,3,0
0,0,17,17,13,19,32,54,44,98,0.000333,0.163333,12,5880,326.666667,490,128.816339,3,0
0,0,20,20,16,22,38,67,52,119,0.000333,0.208168,16,9992.053986,555.11411,624.503374,162.107496,4,0
0,0,13,13,15,18,33,50,42,92,0.000333,0.154695,14,6497.179626,360.954424,464.084259,133.662009,2,0
0,0,17,17,13,17,30,54,44,98,0.000333,0.160292,12,5770.50334,320.583519,480.875278,117.592585,3,0
0,0,20,20,16,20,36,67,52,119,0.000333,0.205074,16,9843.537203,546.863178,615.221075,150.438562,4,0
0,0,13,13,15,18,33,50,42,92,0.000333,0.154695,14,6497.179626,360.954424,464.084259,133.662009,2,0
0,0,13,13,13,17,30,45,40,85,0.000333,0.139029,12,5005.028408,278.057134,417.085701,117.592585,3,0
0,0,16,16,15,20,35,58,48,106,0.000333,0.181235,14,7611.855997,422.880889,543.704,145.041921,4,0
0,0,13,13,12,17,29,44,40,84,0.000333,0.136023,12,4896.844843,272.046936,408.070404,112.506418,3,0
0,0,16,16,15,20,35,57,48,105,0.000333,0.179525,14,7540.046035,418.891446,538.574717,145.041921,4,0
0,0,13,13,12,16,28,44,38,82,0.000333,0.131401,12,4730.437243,262.802069,394.203104,107.01955,3,0
0,0,16,16,15,19,34,57,46,103,0.000333,0.17467,14,7336.121417,407.562301,524.008673,139.313982,4,0
0,0,13,13,12,15,27,44,38,82,0.000333,0.129967,12,4678.809302,259.93385,389.900775,101.622909,3,0
0,0,16,16,15,18,33,57,46,103,0.000333,0.173191,14,7274.01632,404.112018,519.572594,133.662009,4,0
0,0,11,11,11,15,26,38,34,72,0.000333,0.112811,10,3384.316597,188.017589,338.43166,96.657107,1,0
0,0,14,14,15,18,33,51,42,93,0.000333,0.156376,14,6567.801143,364.877841,469.128653,133.662009,2,0
0,0,13,13,15,18,33,50,40,90,0.000333,0.151332,14,6355.93659,353.107588,453.995471,133.662009,2,0
0,0,11,11,14,18,32,49,39,88,0.000333,0.146667,14,6160,342.222222,440,128.361619,3,0
0,0,15,15,13,17,30,69,45,114,0.000333,0.186462,12,6712.626335,372.923685,559.385528,117.592585,2,0
0,0,18,18,16,20,36,82,53,135,0.000333,0.232647,16,11167.038,620.391,697.939875,150.438562,3,0
0,0,15,15,13,16,29,69,45,114,0.000333,0.184603,12,6645.718001,369.206556,553.809833,112.105716,2,0
0,0,18,18,16,19,35,82,53,135,0.000333,0.230818,16,11079.25132,615.513962,692.453207,144.710623,3,0
0,0,13,13,12,15,27,64,42,106,0.000333,0.168006,12,6048.216903,336.01205,504.018075,101.622909,2,0
0,0,16,16,15,18,33,77,50,127,0.000333,0.213546,14,8968.932744,498.274041,640.638053,133.662009,3,0
0,0,13,13,12,15,27,64,42,106,0.000333,0.168006,12,6048.216903,336.01205,504.018075,101.622909,2,0
0,0,16,16,15,18,33,77,50,127,0.000333,0.213546,14,8968.932744,498.274041,640.638053,133.662009,3,0
0,0,13,13,14,19,33,46,47,93,0.000333,0.156376,14,6567.801143,364.877841,469.128653,134.013592,2,0
0,0,13,13,15,20,35,46,47,93,0.000333,0.159008,14,6678.326488,371.018138,477.023321,145.041921,2,0
0,0,14,14,11,17,28,49,54,103,0.000333,0.165053,15,7427.363355,412.631297,495.157557,107.540616,1,0
0,0,16,16,15,20,35,57,59,116,0.000333,0.198332,14,8329.95562,462.775312,594.99683,145.041921,2,0
0,0,16,16,13,17,30,69,46,115,0.000333,0.188097,12,6771.509022,376.194946,564.292418,117.592585,2,0
0,0,19,19,16,19,35,82,54,136,0.000333,0.232527,16,11161.31985,620.073325,697.58249,144.710623,3,0
0,0,10,10,15,14,29,45,31,76,0.000333,0.123069,14,5168.891779,287.160654,369.206556,111.906328,2,0
0,0,16,16,13,16,29,69,46,115,0.000333,0.186223,12,6704.013773,372.44521,558.667814,112.105716,2,0
0,0,19,19,16,18,34,82,54,136,0.000333,0.230632,24,16605.47871,922.526595,691.894946,139.05865,3,0
0,0,10,10,15,14,29,45,31,76,0.000333,0.123069,14,5168.891779,287.160654,369.206556,111.906328,2,0
0,0,23,23,17,46,63,105,80,185,0.000333,0.368599,8,8846.374287,491.465238,1105.796786,323.570718,9,0
0,0,22,22,17,46,63,104,78,182,0.000333,0.362622,8,8702.919569,483.495532,1087.864946,323.570718,9,0
0,0,4,4,11,9,20,18,14,32,0.000333,0.046101,5,691.508495,38.417139,138.301699,66.583073,2,0
0,0,15,15,15,18,33,58,49,107,0.000333,0.179917,14,7556.502391,419.805688,539.750171,133.662009,3,0
0,0,15,15,15,18,33,58,49,107,0.000333,0.179917,14,7556.502391,419.805688,539.750171,133.662009,3,0
0,0,22,22,19,26,45,82,71,153,0.000333,0.280085,18,15124.56343,840.253524,840.253524,202.922055,5,0
0,0,11,11,13,14,27,31,47,78,0.000333,0.123627,18,6675.862053,370.881225,370.881225,101.408685,1,0
0,0,22,22,20,27,47,85,80,165,0.000333,0.305502,20,18330.14321,1018.341289,916.507161,214.820524,5,0
0,0,30,30,19,47,66,121,111,232,0.000333,0.467433,18,25241.38984,1402.299436,1402.299436,341.776299,8,0
0,0,29,29,19,47,66,120,109,229,0.000333,0.461389,18,24914.99256,1384.166253,1384.166253,341.776299,8,0
0,0,31,31,22,50,72,129,119,248,0.000333,0.510047,22,33663.11081,1870.172823,1530.1414,380.300305,9,0
0,0,30,30,22,50,72,128,117,245,0.000333,0.503877,22,33255.89576,1847.549764,1511.631625,380.300305,9,0
0,0,27,27,19,48,67,120,98,218,0.000333,0.440802,18,23803.33398,1322.407444,1322.407444,348.788823,8,0
0,0,26,26,19,48,67,119,96,215,0.000333,0.434736,18,23475.76517,1304.209176,1304.209176,348.788823,8,0
0,0,23,23,17,44,61,102,81,183,0.000333,0.361775,8,8682.599462,482.366637,1085.324933,309.70186,7,0
0,0,7,7,8,15,23,17,21,38,0.000333,0.057298,4,687.581417,38.198968,171.895354,82.603359,1,0
0,0,27,27,22,50,72,125,100,225,0.000333,0.462744,22,30541.12876,1696.729375,1388.233125,380.300305,9,0
0,0,26,26,22,50,72,124,98,222,0.000333,0.456574,11,15066.95685,837.053159,1369.72335,380.300305,9,0
0,0,23,23,18,46,64,103,80,183,0.000333,0.366,9,9882,549,1098,329.1425,7,0
0,0,12,12,12,19,31,40,42,82,0.000333,0.135415,12,4874.929169,270.829398,406.244097,123.730173,2,0
0,0,28,28,23,49,72,130,103,233,0.000333,0.479198,22,31627.03556,1757.057531,1437.592525,379.162707,9,0
0,0,13,13,12,20,32,41,44,85,0.000333,0.141667,12,5100,283.333333,425,129.458112,2,0
0,0,29,29,22,51,73,131,105,236,0.000333,0.486933,22,32137.56911,1785.420506,1460.798596,387.401188,9,0
0,0,31,31,19,50,69,125,127,252,0.000333,0.513116,18,27708.26694,1539.348163,1539.348163,362.903432,8,0
0,0,30,30,19,50,69,124,125,249,0.000333,0.507008,18,27378.40662,1521.02259,1521.02259,362.903432,8,0
0,0,31,31,22,52,74,130,135,265,0.000333,0.548502,22,36201.11312,2011.172951,1645.505142,394.530361,9,0
0,0,30,30,22,52,74,129,133,262,0.000333,0.542292,22,35791.2892,1988.404956,1626.876782,394.530361,9,0
0,0,10,10,10,15,25,32,59,91,0.000333,0.140864,15,6338.863699,352.159094,422.590913,91.82264,2,0
0,0,10,10,12,15,27,36,61,97,0.000333,0.153741,24,11069.37811,614.96545,461.224088,101.622909,3,0
0,0,20,20,17,42,59,92,70,162,0.000333,0.317663,8,7623.905392,423.5503,952.988174,295.9642,7,0
0,0,19,19,17,42,59,91,68,159,0.000333,0.31178,8,7482.721959,415.706775,935.340245,295.9642,7,0
0,0,4,4,10,12,22,17,17,34,0.000333,0.05054,5,758.103375,42.116854,151.620675,76.238831,2,0
0,0,4,4,12,12,24,21,19,40,0.000333,0.061133,6,1100.391,61.132833,183.3985,86.0391,3,0
0,0,14,14,14,22,36,57,47,104,0.000333,0.179224,14,7527.410802,418.189489,537.6722,151.410465,4,0
0,0,15,15,14,22,36,58,49,107,0.000333,0.184394,14,7744.547652,430.252647,553.181975,151.410465,4,0
0,0,15,15,13,19,32,51,48,99,0.000333,0.165,12,5940,330,495,128.816339,2,0
0,0,18,18,16,22,38,64,56,120,0.000333,0.209917,16,10076.02083,559.778935,629.751302,162.107496,3,0
0,0,10,10,13,19,32,42,33,75,0.000333,0.125,6,2250,125,375,128.816339,2,0
0,0,33,33,24,51,75,150,103,253,0.000333,0.525297,24,37821.38709,2101.188172,1575.891129,399.332792,13,0
0,0,8,8,12,16,28,30,23,53,0.000333,0.08493,6,1528.738865,84.929937,254.789811,107.01955,2,0
0,0,8,8,13,14,27,31,21,52,0.000333,0.082418,6,1483.524901,82.41805,247.25415,101.408685,2,0
0,0,52,52,25,48,73,250,170,420,0.000333,0.866575,36,93590.14733,5199.452629,2599.726315,384.174605,21,0
0,0,52,52,25,48,73,250,170,420,0.000333,0.866575,36,93590.14733,5199.452629,2599.726315,384.174605,21,0
0,0,8,8,13,14,27,31,21,52,0.000333,0.082418,6,1483.524901,82.41805,247.25415,101.408685,2,0
0,0,17,17,16,23,39,76,53,129,0.000333,0.227272,16,10909.07018,606.059454,681.816886,168.041925,8,0
0,0,33,33,23,50,73,155,107,262,0.000333,0.540578,22,35678.14876,1982.119375,1621.734034,386.234734,14,0
0,0,32,32,23,50,73,154,105,259,0.000333,0.534388,22,35269.62034,1959.423352,1603.164561,386.234734,14,0
0,0,33,33,23,50,73,155,107,262,0.000333,0.540578,22,35678.14876,1982.119375,1621.734034,386.234734,14,0
0,0,32,32,23,50,73,154,105,259,0.000333,0.534388,22,35269.62034,1959.423352,1603.164561,386.234734,14,0
0,0,17,17,16,23,39,76,53,129,0.000333,0.227272,16,10909.07018,606.059454,681.816886,168.041925,8,0
0,0,8,8,13,14,27,31,21,52,0.000333,0.082418,6,1483.524901,82.41805,247.25415,101.408685,2,0
0,0,14,14,14,14,28,48,30,78,0.000333,0.124991,14,5249.631575,291.646199,374.973684,106.605938,4,0
0,0,14,14,14,14,28,48,30,78,0.000333,0.124991,14,5249.631575,291.646199,374.973684,106.605938,4,0
0,0,8,8,13,14,27,31,21,52,0.000333,0.082418,6,1483.524901,82.41805,247.25415,101.408685,2,0
0,0,15,15,16,18,34,60,51,111,0.000333,0.188236,16,9035.334006,501.963,564.708375,139.05865,3,0
0,0,15,15,16,18,34,60,51,111,0.000333,0.188236,16,9035.334006,501.963,564.708375,139.05865,3,0
0,0,15,15,12,20,32,62,60,122,0.000333,0.203333,18,10980,610,610,129.458112,1,0
0,0,17,17,16,23,39,70,65,135,0.000333,0.237843,16,11416.46879,634.248266,713.5293,168.041925,2,0
0,0,9,9,15,16,31,36,31,67,0.000333,0.110644,7,2323.51807,129.084337,331.931153,122.603359,2,0
0,0,20,20,19,21,40,79,78,157,0.000333,0.278514,27,22559.65319,1253.314066,835.542711,172.949289,2,0
0,0,19,19,18,18,36,83,57,140,0.000333,0.241263,27,19542.31651,1085.68425,723.7895,150.1173,4,0
0,0,19,19,18,18,36,83,57,140,0.000333,0.241263,27,19542.31651,1085.68425,723.7895,150.1173,4,0
0,0,7,7,12,11,23,22,18,40,0.000333,0.060314,6,1085.654869,60.314159,180.942478,81.073298,2,0
0,0,28,28,23,48,71,132,93,225,0.000333,0.461231,11,15220.62412,845.590229,1383.693102,372.120125,13,0
0,0,27,27,22,50,72,126,91,217,0.000333,0.446291,11,14727.61098,818.20061,1338.873725,380.300305,12,0
0,0,26,26,22,50,72,125,89,214,0.000333,0.440121,11,14524.00345,806.889081,1320.36395,380.300305,12,0
0,0,28,28,23,48,71,131,93,224,0.000333,0.459181,11,15152.9769,841.83205,1377.543355,372.120125,13,0
0,0,27,27,22,50,72,126,91,217,0.000333,0.446291,11,14727.61098,818.20061,1338.873725,380.300305,12,0
0,0,26,26,22,50,72,125,89,214,0.000333,0.440121,11,14524.00345,806.889081,1320.36395,380.300305,12,0
0,0,9,9,13,13,26,29,22,51,0.000333,0.079907,6,1438.334554,79.907475,239.722426,96.211433,4,0
0,0,9,9,12,13,25,28,22,50,0.000333,0.077398,6,1393.156857,77.397603,232.192809,91.125266,4,0
0,0,16,16,15,19,34,66,54,120,0.000333,0.203499,14,8546.937573,474.829865,610.495541,139.313982,3,0
0,0,16,16,15,19,34,65,54,119,0.000333,0.201803,14,8475.713094,470.87295,605.408078,139.313982,3,0
0,0,7,7,9,13,22,19,23,42,0.000333,0.062432,4,749.184512,41.621362,187.296128,76.635041,1,0
0,0,7,7,11,12,23,31,28,59,0.000333,0.088963,10,2668.901554,148.272309,266.890155,81.073298,1,0
0,0,9,9,15,15,30,39,33,72,0.000333,0.117765,14,4946.14572,274.785873,353.296123,117.206718,2,0
0,0,20,20,21,25,46,79,77,156,0.000333,0.287225,30,25850.26995,1436.126109,861.675665,208.335071,3,0
0,0,17,17,16,21,37,57,66,123,0.000333,0.213588,24,15378.30634,854.350352,640.762764,156.238666,2,0
0,0,20,20,17,22,39,71,85,156,0.000333,0.274841,24,19788.54591,1099.363662,824.522746,167.594364,2,0
0,0,22,22,21,24,45,79,90,169,0.000333,0.309374,30,27843.6952,1546.871955,928.123173,202.277766,3,0
0,0,17,17,17,21,38,58,75,133,0.000333,0.232658,24,16751.38462,930.632479,697.974359,161.725534,2,0
0,0,16,16,15,18,33,66,54,120,0.000333,0.201776,21,12711.87318,706.215177,605.327294,133.662009,3,0
0,0,16,16,15,18,33,65,54,119,0.000333,0.200094,21,12605.9409,700.33005,600.2829,133.662009,3,0
0,0,6,6,11,16,27,26,28,54,0.000333,0.085588,5,1283.819626,71.323313,256.763925,102.053748,1,0
0,0,9,9,14,19,33,38,37,75,0.000333,0.12611,7,2648.306913,147.128162,378.329559,134.013592,2,0
0,0,12,12,12,15,27,49,43,92,0.000333,0.145817,12,5249.395802,291.6331,437.44965,101.622909,2,0
0,0,15,15,16,18,34,61,52,113,0.000333,0.191628,16,9198.132817,511.007379,574.883301,139.05865,3,0
0,0,11,11,15,20,35,44,32,76,0.000333,0.129942,7,2728.778565,151.598809,389.825509,145.041921,5,0
0,0,12,12,15,20,35,45,34,79,0.000333,0.135071,7,2836.493508,157.582973,405.213358,145.041921,5,0
0,0,11,11,15,20,35,44,32,76,0.000333,0.129942,7,2728.778565,151.598809,389.825509,145.041921,5,0
0,0,12,12,15,20,35,45,34,79,0.000333,0.135071,7,2836.493508,157.582973,405.213358,145.041921,5,0
0,0,11,11,15,20,35,44,33,77,0.000333,0.131652,7,2764.683546,153.59353,394.954792,145.041921,5,0
0,0,12,12,15,20,35,45,35,80,0.000333,0.136781,7,2872.398489,159.577694,410.342641,145.041921,5,0
0,0,11,11,15,20,35,44,33,77,0.000333,0.131652,7,2764.683546,153.59353,394.954792,145.041921,5,0
0,0,12,12,15,20,35,45,35,80,0.000333,0.136781,7,2872.398489,159.577694,410.342641,145.041921,5,0
0,0,22,22,19,43,62,100,83,183,0.000333,0.363206,9,9806.561323,544.808962,1089.617925,314.040007,7,0
0,0,22,22,20,44,64,101,89,190,0.000333,0.38,20,22800,1266.666667,1140,326.653553,7,0
0,0,6,6,6,11,17,13,18,31,0.000333,0.042237,3,380.134044,21.118558,126.711348,53.563523,1,0
0,0,7,7,8,13,21,17,20,37,0.000333,0.054172,4,650.062979,36.11461,162.515745,72.105716,1,0
0,0,6,6,7,13,20,14,18,32,0.000333,0.046101,3,414.905097,23.050283,138.301699,67.757201,1,0
0,0,25,25,19,46,65,110,91,201,0.000333,0.403499,9,10894.46337,605.247965,1210.49593,334.794473,8,0
0,0,24,24,19,46,65,109,89,198,0.000333,0.397476,9,10731.85944,596.214413,1192.428827,334.794473,8,0
0,0,25,25,22,49,71,115,93,208,0.000333,0.426382,11,14070.62141,781.701189,1279.147401,373.228278,9,0
0,0,24,24,22,49,71,114,91,205,0.000333,0.420233,11,13867.67975,770.426653,1260.698159,373.228278,9,0
0,0,9,9,12,16,28,27,32,59,0.000333,0.094545,12,3403.607285,189.089294,283.63394,107.01955,2,0
0,0,25,25,23,47,70,117,93,210,0.000333,0.42905,11,14158.64377,786.591321,1287.149434,365.107601,9,0
0,0,18,18,18,23,41,70,71,141,0.000333,0.251805,27,20396.20048,1133.122249,755.414833,179.100575,2,0
0,0,15,15,11,16,27,56,55,111,0.000333,0.175931,15,7916.887691,439.827094,527.792513,102.053748,1,0
0,0,17,17,15,19,34,64,60,124,0.000333,0.210282,21,13247.75324,735.986291,630.845392,139.313982,2,0
0,0,9,9,14,15,29,34,27,61,0.000333,0.098779,7,2074.357885,115.242105,296.336841,111.906328,2,0
0,0,16,16,13,17,30,60,57,117,0.000333,0.191369,18,10333.91159,574.1062,574.1062,117.592585,2,0
0,0,18,18,15,20,35,68,62,130,0.000333,0.222269,21,14002.94264,777.941258,666.806792,145.041921,3,0
0,0,10,10,14,16,30,38,29,67,0.000333,0.109587,7,2301.331689,127.851761,328.76167,117.302969,3,0
0,0,16,16,12,17,29,59,57,116,0.000333,0.187842,18,10143.46432,563.525795,563.525795,112.506418,2,0
0,0,18,18,15,20,35,67,62,129,0.000333,0.220559,21,13895.22769,771.957094,661.677509,145.041921,3,0
0,0,10,10,14,16,30,37,29,66,0.000333,0.107952,7,2266.983455,125.943525,323.854779,117.302969,3,0
0,0,16,16,13,18,31,60,57,117,0.000333,0.193214,18,10433.53743,579.640968,579.640968,123.164366,2,0
0,0,18,18,15,21,36,68,62,130,0.000333,0.22403,14,9409.263503,522.736861,672.09025,150.842025,3,0
0,0,10,10,14,17,31,38,29,67,0.000333,0.110644,7,2323.51807,129.084337,331.931153,122.789837,3,0
0,0,16,16,12,18,30,59,57,116,0.000333,0.189733,18,10245.58756,569.199309,569.199309,118.0782,2,0
0,0,18,18,15,21,36,67,62,129,0.000333,0.222307,14,9336.884553,518.715808,666.920325,150.842025,3,0
0,0,10,10,14,17,31,37,29,66,0.000333,0.108992,7,2288.838695,127.157705,326.976956,122.789837,3,0
0,0,15,15,12,15,27,50,43,93,0.000333,0.147402,12,5306.454452,294.803025,442.204538,101.622909,2,0
0,0,18,18,16,18,34,63,51,114,0.000333,0.193324,16,9279.532222,515.529568,579.970764,139.05865,3,0
0,0,10,10,14,15,29,40,29,69,0.000333,0.111734,7,2346.404821,130.355823,335.200689,111.906328,2,0
0,0,16,16,12,17,29,59,56,115,0.000333,0.186223,18,10056.02066,558.667814,558.667814,112.506418,2,0
0,0,18,18,15,20,35,67,61,128,0.000333,0.218849,21,13787.51275,765.972931,656.548226,145.041921,3,0
0,0,10,10,14,16,30,37,28,65,0.000333,0.106316,7,2232.635221,124.03529,318.947889,117.302969,3,0
0,0,16,16,12,17,29,59,56,115,0.000333,0.186223,18,10056.02066,558.667814,558.667814,112.506418,2,0
0,0,18,18,15,20,35,67,61,128,0.000333,0.218849,21,13787.51275,765.972931,656.548226,145.041921,3,0
0,0,10,10,14,16,30,37,28,65,0.000333,0.106316,7,2232.635221,124.03529,318.947889,117.302969,3,0
0,0,14,14,13,15,28,48,39,87,0.000333,0.139413,12,5018.878539,278.826585,418.239878,106.709075,2,0
0,0,17,17,16,18,34,61,47,108,0.000333,0.183149,16,8791.13579,488.396433,549.445987,139.05865,3,0
0,0,14,14,13,16,29,50,40,90,0.000333,0.145739,12,5246.619475,291.47886,437.21829,112.105716,3,0
0,0,17,17,17,19,36,63,48,111,0.000333,0.191287,16,9181.786803,510.099267,573.861675,150.197491,4,0
0,0,19,19,13,24,37,67,74,141,0.000333,0.244844,18,13221.59264,734.532925,734.532925,158.144816,4,0
0,0,20,20,13,24,37,68,76,144,0.000333,0.250054,18,13502.90312,750.161285,750.161285,158.144816,4,0
0,0,15,15,10,18,28,51,66,117,0.000333,0.187487,15,8436.907888,468.717105,562.460526,108.277931,2,0
0,0,18,18,14,21,35,64,74,138,0.000333,0.235947,21,14864.66218,825.814566,707.841056,145.541635,3,0
0,0,10,10,13,18,31,41,33,74,0.000333,0.122204,6,2199.663162,122.203509,366.610527,123.164366,2,0
0,0,4,4,8,9,17,14,14,28,0.000333,0.03815,4,457.795838,25.433102,114.44896,52.529325,1,0
0,0,15,15,14,19,33,57,48,105,0.000333,0.176554,14,7415.259355,411.958853,529.661383,134.013592,2,0
0,0,14,14,14,19,33,55,46,101,0.000333,0.169828,14,7132.773285,396.265182,509.483806,134.013592,2,0
0,0,15,15,15,20,35,58,49,107,0.000333,0.182944,14,7683.665959,426.870331,548.833283,145.041921,2,0
0,0,14,14,15,20,35,56,47,103,0.000333,0.176105,14,7396.42611,410.912562,528.316151,145.041921,2,0
0,0,7,7,12,15,27,32,27,59,0.000333,0.093513,6,1683.230176,93.512788,280.538363,101.622909,2,0
0,0,18,18,14,21,35,73,62,135,0.000333,0.230818,14,9694.344902,538.574717,692.453207,145.541635,2,0
0,0,21,21,18,24,42,86,70,156,0.000333,0.280401,18,15141.62732,841.201518,841.201518,185.09775,3,0
0,0,7,7,12,16,28,32,28,60,0.000333,0.096147,6,1730.647772,96.147098,288.441295,107.01955,2,0
0,0,12,12,16,20,36,57,42,99,0.000333,0.170608,16,8189.161202,454.9534,511.822575,150.438562,3,0
0,0,7,7,11,14,25,28,25,53,0.000333,0.082041,5,1230.62189,68.367883,246.124378,91.356717,2,0
0,0,15,15,14,17,31,70,50,120,0.000333,0.198168,14,8323.049801,462.391656,594.503557,122.789837,2,0
0,0,18,18,18,20,38,83,58,141,0.000333,0.246653,18,13319.24003,739.957779,739.957779,161.497212,3,0
0,0,7,7,11,14,25,28,25,53,0.000333,0.082041,5,1230.62189,68.367883,246.124378,91.356717,2,0
0,0,16,16,15,17,32,73,51,124,0.000333,0.206667,21,13020,723.333333,620,128.090227,3,0
0,0,19,19,19,20,39,86,59,145,0.000333,0.255461,18,13794.89979,766.383322,766.383322,167.149185,4,0
0,0,7,7,11,14,25,28,25,53,0.000333,0.082041,5,1230.62189,68.367883,246.124378,91.356717,2,0
0,0,16,16,15,18,33,73,51,124,0.000333,0.208502,14,8757.068191,486.503788,625.504871,133.662009,3,0
0,0,19,19,19,21,40,86,59,145,0.000333,0.257227,18,13890.23233,771.679574,771.679574,172.949289,4,0
0,0,16,16,15,18,33,73,51,124,0.000333,0.208502,14,8757.068191,486.503788,625.504871,133.662009,3,0
0,0,19,19,19,21,40,86,59,145,0.000333,0.257227,18,13890.23233,771.679574,771.679574,172.949289,4,0
0,0,20,20,18,22,40,71,60,131,0.000333,0.232391,18,12549.10645,697.17258,697.17258,173.166146,4,0
0,0,14,14,15,20,35,49,39,88,0.000333,0.150459,7,3159.638338,175.535463,451.376905,145.041921,3,0
0,0,14,14,15,20,35,49,39,88,0.000333,0.150459,7,3159.638338,175.535463,451.376905,145.041921,3,0
0,0,7,7,11,14,25,28,25,53,0.000333,0.082041,5,1230.62189,68.367883,246.124378,91.356717,2,0
0,0,17,17,15,18,33,79,56,135,0.000333,0.226998,21,14300.85733,794.492074,680.993206,133.662009,2,0
0,0,20,20,19,21,40,92,64,156,0.000333,0.27674,27,22415.96114,1245.331174,830.220783,172.949289,3,0
0,0,17,17,17,19,36,60,54,114,0.000333,0.196457,16,9429.943203,523.885733,589.37145,150.197491,4,0
0,0,12,12,14,17,31,40,35,75,0.000333,0.123855,14,5201.906126,288.994785,371.564723,122.789837,3,0
0,0,17,17,17,19,36,60,54,114,0.000333,0.196457,16,9429.943203,523.885733,589.37145,150.197491,4,0
0,0,12,12,14,17,31,40,35,75,0.000333,0.123855,14,5201.906126,288.994785,371.564723,122.789837,3,0
0,0,15,15,11,19,30,56,48,104,0.000333,0.170106,10,5103.166219,283.509234,510.316622,118.764371,1,0
0,0,18,18,15,22,37,69,56,125,0.000333,0.217061,14,9116.54339,506.474633,651.181671,156.710855,2,0
0,0,10,10,14,15,29,43,31,74,0.000333,0.11983,14,5032.868311,279.603795,359.490594,111.906328,2,0
0,0,14,14,15,19,34,54,42,96,0.000333,0.162799,14,6837.550059,379.863892,488.396433,139.313982,2,0
0,0,13,13,15,19,34,52,40,92,0.000333,0.156016,14,6552.65214,364.03623,468.046581,139.313982,2,0
0,0,14,14,13,19,32,53,47,100,0.000333,0.166667,12,6000,333.333333,500,128.816339,2,0
0,0,13,13,13,19,32,51,45,96,0.000333,0.16,12,5760,320,480,128.816339,2,0
0,0,14,14,14,20,34,53,47,100,0.000333,0.169582,14,7122.447978,395.691554,508.746284,139.741531,2,0
0,0,13,13,14,20,34,51,45,96,0.000333,0.162799,14,6837.550059,379.863892,488.396433,139.741531,2,0
0,0,14,14,10,17,27,54,49,103,0.000333,0.163251,10,4897.534127,272.085229,489.753413,102.706149,1,0
0,0,17,17,14,20,34,67,57,124,0.000333,0.210282,14,8831.835492,490.657527,630.845392,139.741531,2,0
0,0,10,10,13,17,30,45,35,80,0.000333,0.13085,12,4710.614972,261.700832,392.551248,117.592585,2,0
0,0,7,7,9,12,21,21,23,44,0.000333,0.064421,4,773.047866,42.947104,193.261967,71.548875,1,0
0,0,6,6,8,12,20,19,21,40,0.000333,0.057626,4,691.508495,38.417139,172.877124,67.01955,1,0
0,0,8,8,10,16,26,33,29,62,0.000333,0.097142,5,1457.136313,80.952017,291.427263,97.219281,1,0
0,0,11,11,14,19,33,46,37,83,0.000333,0.139562,7,2930.792983,162.821832,418.684712,134.013592,2,0
0,0,10,10,14,15,29,43,31,74,0.000333,0.11983,14,5032.868311,279.603795,359.490594,111.906328,2,0
0,0,7,7,10,13,23,21,22,43,0.000333,0.064838,5,972.565821,54.031434,194.513164,81.324997,1,0
0,0,6,6,9,13,22,19,20,39,0.000333,0.057973,4,695.671333,38.648407,173.917833,76.635041,1,0
0,0,21,21,14,23,37,78,89,167,0.000333,0.289993,21,18269.55295,1014.975164,869.978712,157.344894,2,0
0,0,23,23,18,25,43,86,94,180,0.000333,0.325576,27,26371.64671,1465.091484,976.727656,191.155055,3,0
0,0,19,19,14,22,36,72,77,149,0.000333,0.256773,21,16176.69533,898.705296,770.318825,151.410465,2,0
0,0,21,21,18,24,42,80,82,162,0.000333,0.291185,27,23585.99641,1310.333134,873.555422,185.09775,3,0
0,0,17,17,14,21,35,66,65,131,0.000333,0.223979,21,14110.65758,783.925421,671.936075,145.541635,2,0
0,0,19,19,18,23,41,74,70,144,0.000333,0.257162,27,20830.16219,1157.231233,771.487489,179.100575,3,0
0,0,9,9,13,14,27,37,34,71,0.000333,0.112532,12,4051.164152,225.064675,337.597013,101.408685,2,0
0,0,11,11,17,17,34,45,39,84,0.000333,0.142449,16,6837.550059,379.863892,427.346879,138.973737,3,0
0,0,13,13,12,15,27,64,42,106,0.000333,0.168006,12,6048.216903,336.01205,504.018075,101.622909,2,0
0,0,16,16,15,18,33,77,50,127,0.000333,0.213546,14,8968.932744,498.274041,640.638053,133.662009,3,0
0,0,13,13,12,14,26,64,42,106,0.000333,0.166082,18,8968.438982,498.24661,498.24661,96.322519,2,0
0,0,16,16,15,17,32,77,50,127,0.000333,0.211667,14,8890,493.888889,635,128.090227,3,0
0,0,6,6,9,10,19,17,15,32,0.000333,0.045311,4,543.734722,30.207485,135.93368,61.748606,2,0
0,0,7,7,12,15,27,27,24,51,0.000333,0.080833,6,1454.995576,80.833088,242.499263,101.622909,2,0
0,0,7,7,13,18,31,30,31,61,0.000333,0.100735,6,1813.23585,100.735325,302.205975,123.164366,1,0
0,0,10,10,16,21,37,43,39,82,0.000333,0.142392,8,3417.401408,189.855634,427.175176,156.238666,2,0
0,0,30,30,19,54,73,129,111,240,0.000333,0.495186,18,26740.04209,1485.557894,1485.557894,391.474548,10,0
0,0,29,29,19,54,73,128,109,237,0.000333,0.488996,18,26405.79157,1466.98842,1466.98842,391.474548,10,0
0,0,30,30,22,56,78,134,113,247,0.000333,0.517498,22,34154.87566,1897.493092,1552.494348,423.319371,11,0
0,0,29,29,22,56,78,133,111,244,0.000333,0.511213,11,16870.01956,937.223309,1533.638141,423.319371,11,0
0,0,12,12,13,19,32,34,47,81,0.000333,0.135,12,4860,270,405,128.816339,2,0
0,0,31,31,23,54,77,137,118,255,0.000333,0.532677,22,35156.67249,1953.148472,1598.030568,414.80585,11,0
0,0,23,23,17,46,63,104,83,187,0.000333,0.372584,8,8942.010766,496.778376,1117.751346,323.570718,9,0
0,0,22,22,17,46,63,103,81,184,0.000333,0.366607,8,8798.556047,488.808669,1099.819506,323.570718,9,0
0,0,23,23,18,48,66,105,82,187,0.000333,0.376767,9,10172.7153,565.15085,1130.3017,343.13685,9,0
0,0,22,22,18,48,66,104,80,184,0.000333,0.370723,9,10009.51666,556.084259,1112.168518,343.13685,9,0
0,0,5,5,10,14,24,17,22,39,0.000333,0.059605,5,894.067688,49.670427,178.813538,86.52225,2,0
0,0,5,5,12,14,26,21,24,45,0.000333,0.070507,6,1269.118724,70.506596,211.519787,96.322519,3,0
0,0,9,9,13,11,24,28,20,48,0.000333,0.073359,6,1320.4692,73.3594,220.0782,86.159464,4,0
0,0,10,10,12,13,25,31,28,59,0.000333,0.091329,12,3287.850182,182.658343,273.987515,91.125266,3,0
0,0,7,7,10,15,25,23,24,47,0.000333,0.072754,5,1091.306205,60.628122,218.261241,91.82264,1,0
0,0,7,7,11,14,25,24,23,47,0.000333,0.072754,5,1091.306205,60.628122,218.261241,91.356717,1,0
0,0,17,17,16,19,35,58,51,109,0.000333,0.186364,16,8945.469582,496.970532,559.091849,144.710623,3,0
0,0,14,14,16,19,35,47,39,86,0.000333,0.147039,16,7057.893431,392.105191,441.118339,144.710623,3,0
0,0,17,17,16,18,34,58,51,109,0.000333,0.184844,16,8872.535195,492.918622,554.53345,139.05865,3,0
0,0,14,14,16,18,34,47,39,86,0.000333,0.145841,16,7000.34887,388.908271,437.521804,139.05865,3,0
0,0,15,15,13,17,30,64,44,108,0.000333,0.176648,12,6359.330212,353.296123,529.944184,117.592585,2,0
0,0,18,18,16,20,36,77,52,129,0.000333,0.222307,16,10670.7252,592.818067,666.920325,150.438562,3,0
0,0,15,15,13,16,29,64,44,108,0.000333,0.174887,12,6295.94337,349.774632,524.661947,112.105716,2,0
0,0,18,18,16,19,35,77,52,129,0.000333,0.220559,16,10586.84015,588.157786,661.677509,144.710623,3,0
0,0,13,13,13,16,29,61,42,103,0.000333,0.166791,12,6004.46451,333.581362,500.372042,112.105716,2,0
0,0,16,16,15,19,34,74,50,124,0.000333,0.210282,14,8831.835492,490.657527,630.845392,139.313982,3,0
0,0,13,13,12,16,28,60,42,102,0.000333,0.16345,12,5884.202425,326.900135,490.350202,107.01955,2,0
0,0,16,16,15,19,34,73,50,123,0.000333,0.208586,14,8760.611013,486.700612,625.757929,139.313982,3,0
0,0,15,15,15,18,33,60,51,111,0.000333,0.186643,14,7838.988461,435.499359,559.927747,133.662009,3,0
0,0,15,15,15,18,33,60,51,111,0.000333,0.186643,14,7838.988461,435.499359,559.927747,133.662009,3,0
0,0,15,15,15,18,33,60,51,111,0.000333,0.186643,14,7838.988461,435.499359,559.927747,133.662009,3,0
0,0,15,15,15,18,33,60,51,111,0.000333,0.186643,14,7838.988461,435.499359,559.927747,133.662009,3,0
0,0,9,9,14,12,26,29,24,53,0.000333,0.083041,14,3487.726271,193.762571,249.123305,96.322519,2,0
0,0,15,15,12,20,32,65,60,125,0.000333,0.208333,18,11250,625,625,129.458112,1,0
0,0,17,17,16,22,38,73,65,138,0.000333,0.241405,16,11587.42395,643.745775,724.213997,162.107496,2,0
0,0,13,13,13,17,30,45,40,85,0.000333,0.139029,12,5005.028408,278.057134,417.085701,117.592585,3,0
0,0,16,16,15,20,35,58,48,106,0.000333,0.181235,14,7611.855997,422.880889,543.704,145.041921,4,0
0,0,13,13,12,17,29,44,40,84,0.000333,0.136023,12,4896.844843,272.046936,408.070404,112.506418,3,0
0,0,16,16,15,20,35,57,48,105,0.000333,0.179525,14,7540.046035,418.891446,538.574717,145.041921,4,0
0,0,7,7,11,13,24,33,29,62,0.000333,0.094756,10,2842.67675,157.926486,284.267675,86.159464,1,0
0,0,9,9,15,16,31,41,34,75,0.000333,0.123855,14,5201.906126,288.994785,371.564723,122.603359,2,0
0,0,18,18,11,21,32,71,81,152,0.000333,0.253333,15,11400,633.333333,760,130.292414,1,0
0,0,20,20,15,23,38,79,86,165,0.000333,0.288636,21,18184.06883,1010.226046,865.90804,162.645284,2,0
0,0,6,6,13,14,27,25,21,46,0.000333,0.072908,6,1312.348951,72.908275,218.724825,101.408685,2,0
0,0,9,9,15,17,32,38,29,67,0.000333,0.111667,7,2345,130.277778,335,128.090227,3,0
0,0,11,11,14,18,32,49,41,90,0.000333,0.15,14,6300,350,450,128.361619,3,0
0,0,6,6,13,14,27,25,21,46,0.000333,0.072908,6,1312.348951,72.908275,218.724825,101.408685,2,0
0,0,9,9,15,17,32,38,29,67,0.000333,0.111667,7,2345,130.277778,335,128.090227,3,0
0,0,11,11,14,18,32,49,41,90,0.000333,0.15,14,6300,350,450,128.361619,3,0
0,0,12,12,12,16,28,41,36,77,0.000333,0.123389,12,4441.995948,246.777553,370.166329,107.01955,2,0
0,0,15,15,15,19,34,54,44,98,0.000333,0.16619,14,6979.999018,387.777723,498.571358,139.313982,3,0
0,0,13,13,15,18,33,50,40,90,0.000333,0.151332,14,6355.93659,353.107588,453.995471,133.662009,2,0
0,0,14,14,12,16,28,49,44,93,0.000333,0.149028,12,5365.008093,298.056005,447.084008,107.01955,1,0
0,0,17,17,16,19,35,62,52,114,0.000333,0.194913,16,9355.812223,519.767346,584.738264,144.710623,2,0
0,0,16,16,16,19,35,61,50,111,0.000333,0.189783,16,9109.606638,506.089258,569.350415,144.710623,2,0
0,0,5,5,12,12,24,22,17,39,0.000333,0.059605,6,1072.881225,59.604513,178.813538,86.0391,1,0
0,0,8,8,15,15,30,35,25,60,0.000333,0.098138,7,2060.89405,114.494114,294.413436,117.206718,2,0
0,0,14,14,15,19,34,60,49,109,0.000333,0.184844,14,7763.468296,431.303794,554.53345,139.313982,3,0
0,0,13,13,11,16,27,45,42,87,0.000333,0.137892,10,4136.752127,229.819563,413.675213,102.053748,1,0
0,0,16,16,15,19,34,58,50,108,0.000333,0.183149,14,7692.243816,427.346879,549.445987,139.313982,2,0
0,0,15,15,15,19,34,57,48,105,0.000333,0.178061,14,7478.570377,415.476132,534.183598,139.313982,2,0
0,0,13,13,14,19,33,56,47,103,0.000333,0.173191,14,7274.01632,404.112018,519.572594,134.013592,3,0
0,0,15,15,10,20,30,48,65,113,0.000333,0.184826,15,8317.17956,462.065531,554.478637,119.657843,2,0
0,0,14,14,9,17,26,41,63,104,0.000333,0.162949,12,5866.148768,325.897154,488.845731,98.016193,2,0
0,0,15,15,12,22,34,51,72,123,0.000333,0.208586,18,11263.64273,625.757929,625.757929,141.127046,2,0
0,0,26,26,19,45,64,111,91,202,0.000333,0.404,18,21816,1212,1212,327.844012,8,0
0,0,25,25,19,45,64,110,89,199,0.000333,0.398,9,10746,597,1194,327.844012,8,0
0,0,27,27,22,48,70,119,95,214,0.000333,0.437222,11,14428.33222,801.574012,1311.666566,366.185696,9,0
0,0,26,26,22,48,70,118,93,211,0.000333,0.431093,11,14226.06588,790.336993,1293.278717,366.185696,9,0
0,0,13,13,12,14,26,62,41,103,0.000333,0.161382,12,5809.743492,322.763527,484.145291,96.322519,2,0
0,0,16,16,15,17,32,75,49,124,0.000333,0.206667,14,8680,482.222222,620,128.090227,3,0
0,0,10,10,15,14,29,45,31,76,0.000333,0.123069,14,5168.891779,287.160654,369.206556,111.906328,2,0
0,0,13,13,12,14,26,62,41,103,0.000333,0.161382,12,5809.743492,322.763527,484.145291,96.322519,2,0
0,0,16,16,15,17,32,75,49,124,0.000333,0.206667,14,8680,482.222222,620,128.090227,3,0
0,0,10,10,15,14,29,45,31,76,0.000333,0.123069,14,5168.891779,287.160654,369.206556,111.906328,2,0
0,0,45,45,24,53,77,184,130,314,0.000333,0.655924,24,47226.50337,2623.694632,1967.770974,413.618884,11,0
0,0,45,45,25,54,79,185,139,324,0.000333,0.680808,24,49018.1991,2723.233283,2042.424962,426.86033,11,0
0,0,45,45,26,54,80,190,142,332,0.000333,0.699627,26,54570.88332,3031.71574,2098.880128,432.975358,11,0
0,0,12,12,13,15,28,35,50,85,0.000333,0.136208,18,7355.253031,408.625168,408.625168,106.709075,1,0
0,0,12,12,14,16,30,38,53,91,0.000333,0.148842,21,9377.067928,520.948218,446.527044,117.302969,1,0
0,0,49,49,26,57,83,203,143,346,0.000333,0.735255,26,57349.85472,3186.10304,2205.763643,454.686163,12,0
0,0,16,16,18,20,38,54,63,117,0.000333,0.204669,27,16578.20302,921.011279,614.007519,161.497212,2,0
0,0,49,49,27,58,85,206,152,358,0.000333,0.764854,26,59658.61083,3314.367269,2294.561955,468.14486,12,0
0,0,13,13,13,13,26,36,26,62,0.000333,0.097142,12,3497.12715,194.284842,291.427263,96.211433,4,0
0,0,13,13,13,12,25,36,26,62,0.000333,0.095973,12,3455.029005,191.946056,287.919084,91.125266,4,0
0,0,16,16,17,23,40,65,43,108,0.000333,0.191589,8,4598.145874,255.452549,574.768234,173.528793,6,0
0,0,8,8,12,16,28,30,23,53,0.000333,0.08493,6,1528.738865,84.929937,254.789811,107.01955,2,0
0,0,14,14,14,14,28,48,30,78,0.000333,0.124991,14,5249.631575,291.646199,374.973684,106.605938,4,0
0,0,14,14,14,14,28,48,30,78,0.000333,0.124991,14,5249.631575,291.646199,374.973684,106.605938,4,0
0,0,9,9,12,13,25,28,20,48,0.000333,0.074302,6,1337.430583,74.301699,222.905097,91.125266,4,0
0,0,9,9,12,12,24,28,20,48,0.000333,0.073359,6,1320.4692,73.3594,220.0782,86.0391,4,0
0,0,9,9,10,13,23,26,28,54,0.000333,0.081424,10,2442.723456,135.706859,244.272346,81.324997,1,0
0,0,18,18,17,23,40,84,59,143,0.000333,0.253679,16,12176.57148,676.476193,761.035718,173.528793,5,0
0,0,8,8,10,17,27,29,32,61,0.000333,0.096683,5,1450.240688,80.568927,290.048138,102.706149,1,0
0,0,10,10,14,20,34,37,37,74,0.000333,0.125491,7,2635.305752,146.405875,376.47225,139.741531,2,0
0,0,13,13,12,15,27,44,34,78,0.000333,0.123627,12,4450.574702,247.25415,370.881225,101.622909,3,0
0,0,16,16,16,18,34,57,42,99,0.000333,0.167886,16,8058.541141,447.69673,503.658821,139.05865,4,0
0,0,10,10,14,15,29,40,29,69,0.000333,0.111734,7,2346.404821,130.355823,335.200689,111.906328,2,0
0,0,13,13,12,15,27,44,34,78,0.000333,0.123627,12,4450.574702,247.25415,370.881225,101.622909,3,0
0,0,16,16,16,18,34,57,42,99,0.000333,0.167886,16,8058.541141,447.69673,503.658821,139.05865,4,0
0,0,10,10,14,15,29,40,29,69,0.000333,0.111734,7,2346.404821,130.355823,335.200689,111.906328,2,0
0,0,13,13,13,17,30,58,42,100,0.000333,0.163563,12,5888.268715,327.12604,490.68906,117.592585,2,0
0,0,16,16,15,19,34,71,50,121,0.000333,0.205194,14,8618.162053,478.786781,615.583004,139.313982,3,0
0,0,9,9,14,15,29,38,29,67,0.000333,0.108495,7,2278.393087,126.577394,325.484727,111.906328,2,0
0,0,13,13,12,17,29,57,42,99,0.000333,0.160313,12,5771.281422,320.626746,480.940119,112.506418,2,0
0,0,16,16,15,19,34,70,50,120,0.000333,0.203499,14,8546.937573,474.829865,610.495541,139.313982,3,0
0,0,9,9,14,15,29,38,29,67,0.000333,0.108495,7,2278.393087,126.577394,325.484727,111.906328,2,0
0,0,25,25,20,49,69,120,86,206,0.000333,0.419452,10,12583.56038,699.086688,1258.356038,361.559344,10,0
0,0,24,24,20,49,69,119,84,203,0.000333,0.413343,10,12400.30465,688.905814,1240.030465,361.559344,10,0
0,0,25,25,20,49,69,120,86,206,0.000333,0.419452,10,12583.56038,699.086688,1258.356038,361.559344,10,0
0,0,24,24,20,49,69,119,84,203,0.000333,0.413343,10,12400.30465,688.905814,1240.030465,361.559344,10,0
0,0,24,24,20,48,68,117,85,202,0.000333,0.409889,10,12296.67494,683.148608,1229.667494,354.516762,9,0
0,0,23,23,20,48,68,116,83,199,0.000333,0.403802,10,12114.05105,673.002836,1211.405105,354.516762,9,0
0,0,19,19,16,17,33,82,60,142,0.000333,0.238768,24,17191.29516,955.071953,716.303965,133.486868,2,0
0,0,10,10,14,14,28,42,31,73,0.000333,0.116979,14,4913.11673,272.950929,350.936909,106.605938,2,0
0,0,18,18,15,20,35,77,62,139,0.000333,0.237657,21,14972.37713,831.798729,712.970339,145.041921,2,0
0,0,10,10,13,16,29,44,35,79,0.000333,0.127927,12,4605.365983,255.853666,383.780499,112.105716,2,0
0,0,10,10,14,14,28,45,33,78,0.000333,0.124991,14,5249.631575,291.646199,374.973684,106.605938,2,0
0,0,18,18,15,17,32,77,56,133,0.000333,0.221667,21,13965,775.833333,665,128.090227,2,0
0,0,10,10,14,14,28,42,31,73,0.000333,0.116979,14,4913.11673,272.950929,350.936909,106.605938,2,0
0,0,18,18,15,20,35,77,62,139,0.000333,0.237657,21,14972.37713,831.798729,712.970339,145.041921,2,0
0,0,10,10,13,16,29,44,35,79,0.000333,0.127927,12,4605.365983,255.853666,383.780499,112.105716,2,0
0,0,11,11,14,18,32,45,37,82,0.000333,0.136667,14,5740,318.888889,410,128.361619,2,0
0,0,10,10,14,14,28,42,31,73,0.000333,0.116979,14,4913.11673,272.950929,350.936909,106.605938,2,0
0,0,15,15,12,17,29,49,46,95,0.000333,0.153836,12,5538.098334,307.67213,461.508195,112.506418,2,0
0,0,17,17,15,20,35,57,51,108,0.000333,0.184654,14,7755.475922,430.859773,553.962566,145.041921,3,0
0,0,14,14,15,20,35,46,39,85,0.000333,0.14533,7,3051.923395,169.5513,435.989056,145.041921,3,0
0,0,15,15,12,16,28,49,46,95,0.000333,0.152233,12,5480.384611,304.465812,456.698718,107.01955,2,0
0,0,17,17,15,19,34,57,51,108,0.000333,0.183149,14,7692.243816,427.346879,549.445987,139.313982,3,0
0,0,14,14,15,19,34,46,39,85,0.000333,0.144145,14,6054.080781,336.337821,432.434342,139.313982,3,0
0,0,16,16,11,22,33,49,67,116,0.000333,0.19505,15,8777.245768,487.624765,585.149718,136.161243,2,0
0,0,17,17,11,22,33,50,69,119,0.000333,0.200094,15,9004.243503,500.23575,600.2829,136.161243,2,0
0,0,17,17,13,25,38,54,76,130,0.000333,0.22741,18,12280.15038,682.230577,682.230577,164.202121,3,0
0,0,18,18,13,25,38,55,78,133,0.000333,0.232658,18,12563.53847,697.974359,697.974359,164.202121,3,0
0,0,22,22,19,44,63,100,75,175,0.000333,0.348675,9,9414.21588,523.011993,1046.023987,320.925614,9,0
0,0,21,21,19,44,63,99,73,172,0.000333,0.342697,9,9252.829322,514.046073,1028.092147,320.925614,9,0
0,0,9,9,10,15,25,36,30,66,0.000333,0.102165,10,3064.945085,170.274727,306.494509,91.82264,2,0
0,0,12,12,14,18,32,49,38,87,0.000333,0.145,14,6090,338.333333,435,128.361619,3,0
0,0,10,10,13,18,31,41,33,74,0.000333,0.122204,6,2199.663162,122.203509,366.610527,123.164366,2,0
0,0,32,32,21,56,77,137,110,247,0.000333,0.515965,10,15478.96276,859.942375,1547.896276,417.450542,11,0
0,0,31,31,21,56,77,136,108,244,0.000333,0.509699,10,15290.95916,849.497731,1529.095916,417.450542,11,0
0,0,17,17,12,21,33,53,58,111,0.000333,0.186643,12,6719.132967,373.285165,559.927747,135.258216,2,0
0,0,20,20,16,24,40,66,66,132,0.000333,0.234165,16,11239.91214,624.439563,702.494509,174.0391,3,0
0,0,10,10,13,19,32,41,35,76,0.000333,0.126667,6,2280,126.666667,380,128.816339,2,0
0,0,7,7,6,13,19,19,24,43,0.000333,0.060887,3,547.982649,30.443481,182.660883,63.615491,1,0
0,0,7,7,8,14,22,17,22,39,0.000333,0.057973,4,695.671333,38.648407,173.917833,77.302969,1,0
0,0,7,7,7,15,22,20,24,44,0.000333,0.065405,3,588.644974,32.702499,196.214991,78.254843,1,0
0,0,13,13,10,19,29,38,48,86,0.000333,0.139262,10,4177.863656,232.103536,417.786366,113.929904,1,0
0,0,14,14,12,20,32,45,52,97,0.000333,0.161667,12,5820,323.333333,485,129.458112,2,0
0,0,12,12,11,18,29,44,48,92,0.000333,0.148978,10,4469.342516,248.296806,446.934252,113.112398,2,0
0,0,21,21,14,25,39,73,75,148,0.000333,0.260747,21,16427.0301,912.612783,782.239528,169.399374,2,0
0,0,23,23,18,28,46,81,80,161,0.000333,0.296431,18,16007.28255,889.293475,889.293475,209.664588,3,0
0,0,12,12,12,17,29,45,47,92,0.000333,0.148978,12,5363.211019,297.956168,446.934252,112.506418,2,0
0,0,11,11,14,17,31,36,32,68,0.000333,0.112295,7,2358.197444,131.010969,336.885349,122.789837,2,0
0,0,12,12,17,21,38,45,43,88,0.000333,0.153939,16,7389.081939,410.504552,461.817621,161.725534,3,0
0,0,21,21,18,24,42,80,82,162,0.000333,0.291185,27,23585.99641,1310.333134,873.555422,185.09775,3,0
0,0,13,13,11,15,26,44,34,78,0.000333,0.122211,10,3666.34298,203.685721,366.634298,96.657107,3,0
0,0,16,16,15,18,33,57,42,99,0.000333,0.166465,14,6991.530249,388.418347,499.395018,133.662009,4,0
0,0,13,13,11,15,26,44,34,78,0.000333,0.122211,10,3666.34298,203.685721,366.634298,96.657107,3,0
0,0,16,16,15,18,33,57,42,99,0.000333,0.166465,14,6991.530249,388.418347,499.395018,133.662009,4,0
0,0,13,13,12,16,28,45,35,80,0.000333,0.128196,12,4615.060725,256.392263,384.588394,107.01955,3,0
0,0,16,16,15,19,34,58,43,101,0.000333,0.171278,14,7193.672458,399.64847,513.833747,139.313982,4,0
0,0,10,10,14,15,29,40,29,69,0.000333,0.111734,7,2346.404821,130.355823,335.200689,111.906328,2,0
0,0,13,13,11,16,27,44,35,79,0.000333,0.125212,10,3756.361127,208.686729,375.636113,102.053748,3,0
0,0,16,16,15,19,34,57,43,100,0.000333,0.169582,14,7122.447978,395.691554,508.746284,139.313982,4,0
0,0,10,10,14,15,29,40,29,69,0.000333,0.111734,7,2346.404821,130.355823,335.200689,111.906328,2,0
0,0,28,28,19,46,65,116,101,217,0.000333,0.435618,18,23523.36868,1306.853815,1306.853815,334.794473,8,0
0,0,27,27,19,46,65,115,99,214,0.000333,0.429596,18,23198.16082,1288.786712,1288.786712,334.794473,8,0
0,0,29,29,22,49,71,124,107,231,0.000333,0.473531,22,31253.01486,1736.278603,1420.591585,373.228278,9,0
0,0,28,28,22,49,71,123,105,228,0.000333,0.467381,22,30847.13155,1713.729531,1402.142343,373.228278,9,0
0,0,9,9,12,13,25,28,20,48,0.000333,0.074302,6,1337.430583,74.301699,222.905097,91.125266,4,0
0,0,9,9,12,12,24,28,20,48,0.000333,0.073359,6,1320.4692,73.3594,220.0782,86.0391,4,0
0,0,9,9,12,13,25,28,20,48,0.000333,0.074302,6,1337.430583,74.301699,222.905097,91.125266,4,0
0,0,9,9,12,12,24,28,20,48,0.000333,0.073359,6,1320.4692,73.3594,220.0782,86.0391,4,0
0,0,11,11,10,18,28,38,47,85,0.000333,0.136208,10,4086.251684,227.013982,408.625168,108.277931,1,0
0,0,10,10,10,16,26,31,41,72,0.000333,0.112811,10,3384.316597,188.017589,338.43166,97.219281,1,0
0,0,11,11,12,20,32,41,50,91,0.000333,0.151667,12,5460,303.333333,455,129.458112,1,0
0,0,3,3,7,9,16,10,11,21,0.000333,0.028,3,252,14,84,48.180809,1,0
0,0,3,3,7,10,17,10,12,22,0.000333,0.029975,3,269.772548,14.987364,89.924183,52.870765,1,0
0,0,11,11,10,16,26,35,44,79,0.000333,0.123778,10,3713.347377,206.297077,371.334738,97.219281,1,0
0,0,3,3,7,10,17,10,12,22,0.000333,0.029975,3,269.772548,14.987364,89.924183,52.870765,1,0
0,0,14,14,14,23,37,54,59,113,0.000333,0.196223,14,8241.355224,457.853068,588.66823,157.344894,2,0
0,0,10,10,11,18,29,38,40,78,0.000333,0.126308,10,3789.225176,210.51251,378.922518,113.112398,1,0
0,0,9,9,11,16,27,31,32,63,0.000333,0.099853,10,2995.579126,166.421063,299.557913,102.053748,1,0
0,0,10,10,13,20,33,41,41,82,0.000333,0.13788,12,4963.683813,275.760212,413.640318,134.544278,1,0
0,0,3,3,7,9,16,11,11,22,0.000333,0.029333,3,264,14.666667,88,48.180809,1,0
0,0,3,3,7,10,17,11,12,23,0.000333,0.031337,3,282.034936,15.668608,94.011645,52.870765,1,0
0,0,10,10,11,16,27,35,35,70,0.000333,0.110947,10,3328.421252,184.912292,332.842125,102.053748,1,0
0,0,3,3,7,10,17,11,12,23,0.000333,0.031337,3,282.034936,15.668608,94.011645,52.870765,1,0
0,0,13,13,15,23,38,54,50,104,0.000333,0.181928,14,7640.98246,424.499026,545.784461,162.645284,2,0
0,0,7,7,10,15,25,23,24,47,0.000333,0.072754,5,1091.306205,60.628122,218.261241,91.82264,1,0
0,0,7,7,11,14,25,24,23,47,0.000333,0.072754,5,1091.306205,60.628122,218.261241,91.356717,1,0
0,0,3,3,7,9,16,10,11,21,0.000333,0.028,3,252,14,84,48.180809,1,0
0,0,3,3,7,10,17,10,12,22,0.000333,0.029975,3,269.772548,14.987364,89.924183,52.870765,1,0
0,0,3,3,9,11,20,13,15,28,0.000333,0.040338,4,484.055947,26.891997,121.013987,66.583073,1,0
0,0,3,3,7,10,17,10,12,22,0.000333,0.029975,3,269.772548,14.987364,89.924183,52.870765,1,0
0,0,3,3,10,11,21,15,15,30,0.000333,0.043923,5,658.847613,36.602645,131.769523,71.273029,1,0
0,0,13,13,10,17,27,54,64,118,0.000333,0.187026,15,8416.150879,467.563938,561.076725,102.706149,1,0
0,0,16,16,14,20,34,67,72,139,0.000333,0.235719,21,14850.30403,825.016891,707.157335,139.741531,2,0
0,0,10,10,14,17,31,49,36,85,0.000333,0.140369,14,5895.493609,327.527423,421.106686,122.789837,2,0
0,0,18,18,11,19,30,77,76,153,0.000333,0.250251,20,15015.08522,834.171401,750.754261,118.764371,1,0
0,0,21,21,15,22,37,90,84,174,0.000333,0.302148,21,19035.3426,1057.519033,906.444886,156.710855,2,0
0,0,10,10,14,16,30,47,35,82,0.000333,0.134122,14,5633.110404,312.950578,402.365029,117.302969,2,0
0,0,5,5,9,13,22,19,17,36,0.000333,0.053513,4,642.158153,35.675453,160.539538,76.635041,2,0
0,0,6,6,9,14,23,20,19,39,0.000333,0.058806,4,705.675665,39.204204,176.418916,81.832294,2,0
0,0,5,5,10,12,22,20,16,36,0.000333,0.053513,5,802.697691,44.594316,160.539538,76.238831,2,0
0,0,6,6,10,13,23,21,18,39,0.000333,0.058806,5,882.094581,49.005255,176.418916,81.324997,2,0
0,0,12,12,11,18,29,44,48,92,0.000333,0.148978,10,4469.342516,248.296806,446.934252,113.112398,2,0
0,0,19,19,15,21,36,69,66,135,0.000333,0.232647,21,14656.73738,814.263188,697.939875,150.842025,3,0
0,0,21,21,17,24,41,77,71,148,0.000333,0.264306,16,12686.68315,704.81573,792.917697,179.525968,4,0
0,0,12,12,12,17,29,45,47,92,0.000333,0.148978,12,5363.211019,297.956168,446.934252,112.506418,2,0
0,0,10,10,13,16,29,33,27,60,0.000333,0.09716,6,1748.873158,97.15962,291.47886,112.105716,3,0
0,0,19,19,14,21,35,68,66,134,0.000333,0.229108,21,14433.80241,801.877912,687.323924,145.541635,3,0
0,0,21,21,17,24,41,76,71,147,0.000333,0.26252,16,12600.96232,700.053462,787.560145,179.525968,4,0
0,0,12,12,12,17,29,45,47,92,0.000333,0.148978,12,5363.211019,297.956168,446.934252,112.506418,2,0
0,0,10,10,13,16,29,32,27,59,0.000333,0.09554,6,1719.725272,95.540293,286.620879,112.105716,3,0
0,0,11,11,13,18,31,38,39,77,0.000333,0.127158,12,4577.677391,254.315411,381.473116,123.164366,3,0
0,0,16,16,15,19,34,65,55,120,0.000333,0.203499,14,8546.937573,474.829865,610.495541,139.313982,3,0
0,0,18,18,18,21,39,73,60,133,0.000333,0.234319,18,12653.25291,702.958495,702.958495,167.297316,4,0
0,0,11,11,14,16,30,39,38,77,0.000333,0.125944,14,5289.628062,293.868226,377.830576,117.302969,3,0
0,0,16,16,15,19,34,65,55,120,0.000333,0.203499,14,8546.937573,474.829865,610.495541,139.313982,3,0
0,0,18,18,18,21,39,73,60,133,0.000333,0.234319,18,12653.25291,702.958495,702.958495,167.297316,4,0
0,0,11,11,14,16,30,39,38,77,0.000333,0.125944,14,5289.628062,293.868226,377.830576,117.302969,3,0
0,0,11,11,13,18,31,38,39,77,0.000333,0.127158,12,4577.677391,254.315411,381.473116,123.164366,3,0
0,0,16,16,15,19,34,65,55,120,0.000333,0.203499,14,8546.937573,474.829865,610.495541,139.313982,3,0
0,0,18,18,18,21,39,73,60,133,0.000333,0.234319,18,12653.25291,702.958495,702.958495,167.297316,4,0
0,0,11,11,14,16,30,39,38,77,0.000333,0.125944,14,5289.628062,293.868226,377.830576,117.302969,3,0
0,0,16,16,15,19,34,65,55,120,0.000333,0.203499,14,8546.937573,474.829865,610.495541,139.313982,3,0
0,0,18,18,18,21,39,73,60,133,0.000333,0.234319,18,12653.25291,702.958495,702.958495,167.297316,4,0
0,0,11,11,14,16,30,39,38,77,0.000333,0.125944,14,5289.628062,293.868226,377.830576,117.302969,3,0
0,0,11,11,13,19,32,38,40,78,0.000333,0.13,12,4680,260,390,128.816339,3,0
0,0,16,16,16,20,36,66,56,122,0.000333,0.210244,16,10091.6936,560.649645,630.73085,150.438562,3,0
0,0,18,18,18,22,40,74,61,135,0.000333,0.239487,18,12932.28527,718.460293,718.460293,173.166146,4,0
0,0,11,11,15,17,32,40,39,79,0.000333,0.131667,14,5530,307.222222,395,128.090227,3,0
0,0,16,16,15,20,35,65,56,121,0.000333,0.206881,14,8689.005431,482.722524,620.643245,145.041921,3,0
0,0,18,18,18,22,40,73,61,134,0.000333,0.237713,18,12836.49057,713.138365,713.138365,173.166146,4,0
0,0,11,11,14,17,31,39,39,78,0.000333,0.128809,14,5409.982371,300.554576,386.427312,122.789837,3,0
0,0,11,11,13,18,31,38,40,78,0.000333,0.128809,12,4637.127747,257.618208,386.427312,123.164366,3,0
0,0,16,16,16,19,35,66,56,122,0.000333,0.208591,16,10012.36045,556.242247,625.772528,144.710623,3,0
0,0,18,18,18,21,39,74,61,135,0.000333,0.237843,18,12843.52739,713.5293,713.5293,167.297316,4,0
0,0,11,11,15,16,31,40,39,79,0.000333,0.130461,14,5479.341119,304.40784,391.381509,122.603359,3,0
0,0,16,16,15,19,34,65,56,121,0.000333,0.205194,14,8618.162053,478.786781,615.583004,139.313982,3,0
0,0,18,18,18,21,39,73,61,134,0.000333,0.236081,18,12748.39015,708.243897,708.243897,167.297316,4,0
0,0,11,11,14,16,30,39,39,78,0.000333,0.127579,14,5358.32453,297.684696,382.737466,117.302969,3,0
0,0,14,14,13,16,29,58,49,107,0.000333,0.173268,18,9356.471397,519.803966,519.803966,112.105716,2,0
0,0,16,16,15,18,33,66,54,120,0.000333,0.201776,21,12711.87318,706.215177,605.327294,133.662009,3,0
0,0,14,14,12,16,28,57,49,106,0.000333,0.16986,18,9172.433191,509.579622,509.579622,107.01955,2,0
0,0,16,16,15,18,33,65,54,119,0.000333,0.200094,21,12605.9409,700.33005,600.2829,133.662009,3,0
0,0,13,13,11,15,26,54,47,101,0.000333,0.158248,15,7121.166173,395.620343,474.744412,96.657107,1,0
0,0,15,15,15,17,32,62,52,114,0.000333,0.19,21,11970,665,570,128.090227,2,0
0,0,14,14,12,20,32,48,50,98,0.000333,0.163333,12,5880,326.666667,490,129.458112,1,0
0,0,17,17,16,23,39,61,58,119,0.000333,0.209654,16,10063.40583,559.078101,628.962864,168.041925,2,0
0,0,16,16,16,23,39,60,56,116,0.000333,0.204369,16,9809.706518,544.983695,613.106657,168.041925,2,0
0,0,17,17,17,24,41,77,66,143,0.000333,0.255377,16,12258.07899,681.004388,766.129937,179.525968,5,0
0,0,23,23,18,28,46,101,90,191,0.000333,0.351667,27,28485.00901,1582.5005,1055.000334,209.664588,6,0
0,0,17,17,15,24,39,62,68,130,0.000333,0.229034,14,9619.432038,534.412891,687.102288,168.642459,2,0
0,0,18,18,16,25,41,79,78,157,0.000333,0.280379,24,20187.25595,1121.51422,841.135665,180.096405,5,0
0,0,15,15,11,21,32,50,62,112,0.000333,0.186667,10,5600,311.111111,560,130.292414,1,0
0,0,18,18,15,24,39,63,70,133,0.000333,0.234319,14,9841.418932,546.745496,702.958495,168.642459,2,0
0,0,13,13,11,16,27,45,42,87,0.000333,0.137892,10,4136.752127,229.819563,413.675213,102.053748,1,0
0,0,16,16,15,19,34,58,50,108,0.000333,0.183149,14,7692.243816,427.346879,549.445987,139.313982,2,0
0,0,15,15,15,19,34,57,48,105,0.000333,0.178061,14,7478.570377,415.476132,534.183598,139.313982,2,0
0,0,5,5,12,12,24,22,17,39,0.000333,0.059605,6,1072.881225,59.604513,178.813538,86.0391,1,0
0,0,8,8,15,15,30,35,25,60,0.000333,0.098138,7,2060.89405,114.494114,294.413436,117.206718,2,0
0,0,16,16,16,20,36,74,58,132,0.000333,0.227477,16,10918.8816,606.604534,682.4301,150.438562,5,0
0,0,14,14,11,21,32,44,57,101,0.000333,0.168333,10,5050,280.555556,505,130.292414,2,0
0,0,15,15,11,21,32,45,59,104,0.000333,0.173333,10,5200,288.888889,520,130.292414,2,0
0,0,15,15,13,24,37,49,64,113,0.000333,0.196223,12,7064.018764,392.445487,588.66823,158.144816,3,0
0,0,16,16,13,24,37,50,66,116,0.000333,0.201432,12,7251.559085,402.864394,604.29659,158.144816,3,0
0,0,14,14,11,20,31,44,57,101,0.000333,0.166791,10,5003.738273,277.98546,500.373827,124.49231,2,0
0,0,15,15,11,20,31,45,59,104,0.000333,0.171745,10,5152.364163,286.242453,515.236416,124.49231,2,0
0,0,15,15,13,27,40,59,69,128,0.000333,0.227069,12,8174.481554,454.137864,681.206796,176.487679,4,0
0,0,16,16,13,27,40,60,71,131,0.000333,0.232391,12,8366.070965,464.78172,697.17258,176.487679,4,0
0,0,20,20,15,23,38,80,73,153,0.000333,0.267644,21,16861.5911,936.755061,802.93291,162.645284,2,0
0,0,23,23,19,25,44,93,81,174,0.000333,0.316647,27,25648.40974,1424.911652,949.941102,196.807027,3,0
0,0,10,10,13,18,31,43,36,79,0.000333,0.130461,12,4696.578102,260.921006,391.381509,123.164366,2,0
0,0,7,7,12,16,28,28,29,57,0.000333,0.09134,6,1644.115383,91.339744,274.019231,107.01955,2,0
0,0,17,17,14,23,37,67,70,137,0.000333,0.237898,21,14987.59733,832.644296,713.695111,157.344894,2,0
0,0,19,19,18,26,44,75,75,150,0.000333,0.272972,18,14740.46537,818.914743,818.914743,197.270083,3,0
0,0,7,7,12,17,29,28,30,58,0.000333,0.093921,6,1690.577386,93.920966,281.762898,112.506418,2,0
0,0,12,12,19,17,36,41,59,100,0.000333,0.172331,27,13958.7975,775.48875,516.9925,150.197491,3,0
0,0,12,12,17,17,34,36,57,93,0.000333,0.157711,24,11355.21706,630.845392,473.134044,138.973737,2,0
0,0,4,4,14,11,25,21,21,42,0.000333,0.065014,7,1365.29372,75.849651,195.04196,91.356717,3,0
0,0,4,4,12,11,23,17,19,36,0.000333,0.054283,6,977.089383,54.282743,162.84823,81.073298,2,0
0,0,10,10,10,17,27,41,34,75,0.000333,0.118872,10,3566.165627,198.120313,356.616563,102.706149,1,0
0,0,10,10,11,18,29,41,33,74,0.000333,0.11983,5,1797.452968,99.858498,359.490594,113.112398,1,0
0,0,20,20,14,23,37,88,70,158,0.000333,0.274365,21,17284.96627,960.275904,823.093632,157.344894,2,0
0,0,23,23,18,25,43,101,78,179,0.000333,0.323767,27,26225.13756,1456.952087,971.301391,191.155055,3,0
0,0,10,10,13,17,30,46,34,80,0.000333,0.13085,12,4710.614972,261.700832,392.551248,117.592585,2,0
0,0,18,18,15,23,38,78,61,139,0.000333,0.243154,14,10212.46694,567.359275,729.461924,162.645284,2,0
0,0,7,7,7,12,19,17,22,39,0.000333,0.055223,3,497.007519,27.611529,165.669173,62.671034,1,0
0,0,7,7,8,15,23,17,21,38,0.000333,0.057298,4,687.581417,38.198968,171.895354,82.603359,1,0
0,0,7,7,8,14,22,18,21,39,0.000333,0.057973,4,695.671333,38.648407,173.917833,77.302969,1,0
0,0,12,12,12,19,31,40,42,82,0.000333,0.135415,12,4874.929169,270.829398,406.244097,123.730173,2,0
0,0,12,12,14,18,32,45,44,89,0.000333,0.148333,14,6230,346.111111,445,128.361619,3,0
0,0,13,13,12,20,32,41,44,85,0.000333,0.141667,12,5100,283.333333,425,129.458112,2,0
0,0,13,13,14,20,34,46,46,92,0.000333,0.156016,14,6552.65214,364.03623,468.046581,139.741531,3,0
0,0,5,5,10,14,24,17,22,39,0.000333,0.059605,5,894.067688,49.670427,178.813538,86.52225,2,0
0,0,5,5,12,14,26,21,24,45,0.000333,0.070507,6,1269.118724,70.506596,211.519787,96.322519,3,0
0,0,16,16,15,18,33,63,54,117,0.000333,0.196731,21,12394.07635,688.559797,590.194112,133.662009,3,0
0,0,18,18,18,20,38,71,59,130,0.000333,0.22741,18,12280.15038,682.230577,682.230577,161.497212,4,0
0,0,16,16,15,18,33,63,54,117,0.000333,0.196731,21,12394.07635,688.559797,590.194112,133.662009,3,0
0,0,18,18,18,20,38,71,59,130,0.000333,0.22741,18,12280.15038,682.230577,682.230577,161.497212,4,0
0,0,16,16,16,19,35,64,55,119,0.000333,0.203462,16,9766.154864,542.564159,610.384679,144.710623,3,0
0,0,18,18,18,21,39,72,60,132,0.000333,0.232558,18,12558.11567,697.673093,697.673093,167.297316,4,0
0,0,16,16,15,19,34,63,55,118,0.000333,0.200107,14,8404.488614,466.916034,600.320615,139.313982,3,0
0,0,18,18,18,21,39,71,60,131,0.000333,0.230796,18,12462.97843,692.387691,692.387691,167.297316,4,0
0,0,10,10,13,18,31,29,30,59,0.000333,0.097433,6,1753.785494,97.432527,292.297582,123.164366,2,0
0,0,9,9,15,17,32,31,30,61,0.000333,0.101667,7,2135,118.611111,305,128.090227,3,0
0,0,9,9,10,12,22,31,27,58,0.000333,0.086216,10,2586.470339,143.692797,258.647034,76.238831,1,0
0,0,9,9,10,12,22,31,27,58,0.000333,0.086216,10,2586.470339,143.692797,258.647034,76.238831,1,0
0,0,11,11,13,21,34,42,42,84,0.000333,0.142449,12,5128.162544,284.897919,427.346879,140.344382,3,0
0,0,12,12,13,21,34,43,44,87,0.000333,0.147536,12,5311.311206,295.072845,442.609267,140.344382,3,0
0,0,11,11,16,24,40,47,44,91,0.000333,0.161432,8,3874.363653,215.242425,484.295457,174.0391,4,0
0,0,12,12,16,24,40,48,46,94,0.000333,0.166754,8,4002.089927,222.338329,500.261241,174.0391,4,0
0,0,10,10,14,17,31,32,35,67,0.000333,0.110644,14,4647.036139,258.168674,331.931153,122.789837,2,0
0,0,12,12,18,23,41,50,46,96,0.000333,0.171442,18,9257.849864,514.324992,514.324992,179.100575,4,0
0,0,26,26,22,45,67,117,84,201,0.000333,0.406428,11,13412.1232,745.117956,1219.283927,345.240885,10,0
0,0,25,25,22,45,67,116,82,198,0.000333,0.400362,11,13211.94226,733.996792,1201.08566,345.240885,10,0
0,0,26,26,22,45,67,117,84,201,0.000333,0.406428,11,13412.1232,745.117956,1219.283927,345.240885,10,0
0,0,25,25,22,45,67,116,82,198,0.000333,0.400362,11,13211.94226,733.996792,1201.08566,345.240885,10,0
0,0,26,26,22,45,67,117,84,201,0.000333,0.406428,11,13412.1232,745.117956,1219.283927,345.240885,10,0
0,0,25,25,22,45,67,116,82,198,0.000333,0.400362,11,13211.94226,733.996792,1201.08566,345.240885,10,0
0,0,26,26,22,45,67,117,84,201,0.000333,0.406428,11,13412.1232,745.117956,1219.283927,345.240885,10,0
0,0,25,25,22,45,67,116,82,198,0.000333,0.400362,11,13211.94226,733.996792,1201.08566,345.240885,10,0
0,0,7,7,11,11,22,35,25,60,0.000333,0.089189,10,2675.658971,148.647721,267.565897,76.107496,1,0
0,0,10,10,15,14,29,48,33,81,0.000333,0.131165,14,5508.950448,306.052803,393.496461,111.906328,2,0
0,0,14,14,11,14,25,65,46,111,0.000333,0.171823,15,7732.020556,429.556698,515.468037,91.356717,1,0
0,0,17,17,15,17,32,78,54,132,0.000333,0.22,21,13860,770,660,128.090227,2,0
0,0,10,10,15,14,29,45,31,76,0.000333,0.123069,14,5168.891779,287.160654,369.206556,111.906328,2,0
0,0,17,17,15,18,33,78,52,130,0.000333,0.21859,14,9180.797297,510.044294,655.771236,133.662009,3,0
0,0,10,10,15,14,29,45,31,76,0.000333,0.123069,14,5168.891779,287.160654,369.206556,111.906328,2,0
0,0,17,17,15,18,33,77,52,129,0.000333,0.216909,14,9110.17578,506.120877,650.726841,133.662009,3,0
0,0,10,10,15,14,29,45,31,76,0.000333,0.123069,14,5168.891779,287.160654,369.206556,111.906328,2,0
0,0,17,17,15,17,32,77,51,128,0.000333,0.213333,21,13440,746.666667,640,128.090227,3,0
0,0,17,17,15,17,32,77,51,128,0.000333,0.213333,21,13440,746.666667,640,128.090227,3,0
0,0,13,13,12,17,29,44,38,82,0.000333,0.132785,12,4780.253299,265.569628,398.354442,112.506418,3,0
0,0,16,16,15,20,35,57,46,103,0.000333,0.176105,14,7396.42611,410.912562,528.316151,145.041921,4,0
0,0,13,13,12,16,28,44,38,82,0.000333,0.131401,12,4730.437243,262.802069,394.203104,107.01955,3,0
0,0,16,16,15,19,34,57,46,103,0.000333,0.17467,14,7336.121417,407.562301,524.008673,139.313982,4,0
0,0,13,13,13,16,29,45,40,85,0.000333,0.137643,12,4955.140615,275.28559,412.928385,112.105716,3,0
0,0,16,16,15,19,34,58,48,106,0.000333,0.179757,14,7549.794856,419.433048,539.271061,139.313982,4,0
0,0,13,13,12,16,28,44,40,84,0.000333,0.134606,12,4845.813761,269.211876,403.817813,107.01955,3,0
0,0,16,16,15,19,34,57,48,105,0.000333,0.178061,14,7478.570377,415.476132,534.183598,139.313982,4,0
0,0,17,17,13,19,32,52,44,96,0.000333,0.16,12,5760,320,480,128.816339,3,0
0,0,20,20,16,22,38,65,52,117,0.000333,0.204669,16,9824.120305,545.784461,614.007519,162.107496,4,0
0,0,17,17,13,17,30,52,44,96,0.000333,0.15702,12,5652.737966,314.040998,471.061497,117.592585,3,0
0,0,20,20,16,20,36,65,52,117,0.000333,0.201627,16,9678.099603,537.6722,604.881225,150.438562,4,0
0,0,12,12,13,21,34,48,44,92,0.000333,0.156016,12,5616.558977,312.031054,468.046581,140.344382,3,0
0,0,8,8,9,16,25,22,25,47,0.000333,0.072754,4,873.044964,48.502498,218.261241,92.529325,1,0
0,0,12,12,14,23,37,49,44,93,0.000333,0.161493,7,3391.354141,188.408563,484.479163,157.344894,3,0
0,0,14,14,10,20,30,50,51,101,0.000333,0.165199,10,4955.959502,275.331083,495.59595,119.657843,1,0
0,0,17,17,15,26,41,73,67,140,0.000333,0.250019,14,10500.80193,583.377885,750.057281,180.814792,3,0
0,0,9,9,12,16,28,29,28,57,0.000333,0.09134,6,1644.115383,91.339744,274.019231,107.01955,2,0
0,0,10,10,13,12,25,31,28,59,0.000333,0.091329,12,3287.850182,182.658343,273.987515,91.125266,2,0
0,0,5,5,9,14,23,18,21,39,0.000333,0.058806,4,705.675665,39.204204,176.418916,81.832294,2,0
0,0,6,6,9,15,24,19,23,42,0.000333,0.064189,4,770.2737,42.792983,192.568425,87.132684,2,0
0,0,5,5,11,14,25,18,19,37,0.000333,0.057274,5,859.113395,47.728522,171.822679,91.356717,2,0
0,0,5,5,13,14,27,22,21,43,0.000333,0.068153,6,1226.760976,68.153388,204.460163,101.408685,3,0
0,0,5,5,10,16,26,19,20,39,0.000333,0.061106,5,916.585745,50.92143,183.317149,97.219281,2,0
0,0,6,6,10,17,27,20,22,42,0.000333,0.066568,5,998.526375,55.473688,199.705275,102.706149,2,0
0,0,8,8,9,13,22,31,21,52,0.000333,0.077297,4,927.561777,51.53121,231.890444,76.635041,2,0
0,0,11,11,14,16,30,44,29,73,0.000333,0.119401,7,2507.421094,139.301172,358.203013,117.302969,3,0
0,0,17,17,16,18,34,68,58,126,0.000333,0.213673,24,15384.48763,854.693757,641.020318,139.05865,2,0
0,0,10,10,13,16,29,42,38,80,0.000333,0.129546,12,4663.661755,259.09232,388.63848,112.105716,2,0
0,0,12,12,17,19,36,50,43,93,0.000333,0.160268,16,7692.848402,427.380467,480.803025,150.197491,3,0
0,0,7,7,13,15,28,29,28,57,0.000333,0.09134,6,1644.115383,91.339744,274.019231,106.709075,2,0
0,0,7,7,12,16,28,29,29,58,0.000333,0.092942,6,1672.959513,92.942195,278.826585,107.01955,2,0
0,0,16,16,15,23,38,67,61,128,0.000333,0.223912,14,9404.286104,522.460339,671.734722,162.645284,2,0
0,0,18,18,19,26,45,75,66,141,0.000333,0.258117,18,13938.32316,774.351287,774.351287,202.922055,3,0
0,0,7,7,12,17,29,29,30,59,0.000333,0.09554,6,1719.725272,95.540293,286.620879,112.506418,2,0
0,0,10,10,14,17,31,46,36,82,0.000333,0.135415,14,5687.417364,315.967631,406.244097,122.789837,2,0
0,0,10,10,10,15,25,32,59,91,0.000333,0.140864,15,6338.863699,352.159094,422.590913,91.82264,2,0
0,0,10,10,12,15,27,36,61,97,0.000333,0.153741,24,11069.37811,614.96545,461.224088,101.622909,3,0
0,0,10,10,14,17,31,32,35,67,0.000333,0.110644,14,4647.036139,258.168674,331.931153,122.789837,2,0
0,0,10,10,16,17,33,38,37,75,0.000333,0.12611,16,6053.272943,336.292941,378.329559,133.486868,3,0
0,0,13,13,12,16,28,56,46,102,0.000333,0.16345,12,5884.202425,326.900135,490.350202,107.01955,2,0
0,0,15,15,15,18,33,64,51,115,0.000333,0.193368,14,8121.474532,451.19303,580.105324,133.662009,3,0
0,0,13,13,12,15,27,56,46,102,0.000333,0.161666,18,8729.973454,484.998525,484.998525,101.622909,2,0
0,0,15,15,15,17,32,64,51,115,0.000333,0.191667,21,12075,670.833333,575,128.090227,3,0
0,0,18,18,17,22,39,63,65,128,0.000333,0.22551,16,10824.50374,601.361319,676.531484,167.594364,3,0
0,0,14,14,14,20,34,47,50,97,0.000333,0.164495,14,6908.774538,383.820808,493.483896,139.741531,2,0
0,0,19,19,19,25,44,74,67,141,0.000333,0.256593,18,13856.03745,769.779858,769.779858,196.807027,3,0
0,0,18,18,18,21,39,75,63,138,0.000333,0.243129,27,19693.40867,1094.078259,729.385506,167.297316,4,0
0,0,18,18,19,20,39,75,62,137,0.000333,0.241367,27,19550.70281,1086.150156,724.100104,167.149185,3,0
0,0,12,12,13,21,34,48,44,92,0.000333,0.156016,12,5616.558977,312.031054,468.046581,140.344382,3,0
0,0,8,8,9,16,25,22,25,47,0.000333,0.072754,4,873.044964,48.502498,218.261241,92.529325,1,0
0,0,12,12,14,23,37,49,44,93,0.000333,0.161493,7,3391.354141,188.408563,484.479163,157.344894,3,0
0,0,14,14,10,21,31,51,52,103,0.000333,0.170094,10,5102.8222,283.490122,510.28222,125.457947,2,0
0,0,17,17,15,26,41,73,67,140,0.000333,0.250019,14,10500.80193,583.377885,750.057281,180.814792,3,0
0,0,10,10,13,16,29,30,34,64,0.000333,0.103637,12,3730.929404,207.273856,310.910784,112.105716,2,0
0,0,10,10,15,16,31,36,36,72,0.000333,0.118901,14,4993.829881,277.434993,356.702134,122.603359,3,0
0,0,4,4,10,12,22,17,17,34,0.000333,0.05054,5,758.103375,42.116854,151.620675,76.238831,2,0
0,0,4,4,12,12,24,21,19,40,0.000333,0.061133,6,1100.391,61.132833,183.3985,86.0391,3,0
0,0,7,7,7,13,20,18,22,40,0.000333,0.057626,3,518.631371,28.812854,172.877124,67.757201,1,0
0,0,7,7,8,15,23,17,21,38,0.000333,0.057298,4,687.581417,38.198968,171.895354,82.603359,1,0
0,0,7,7,8,15,23,19,21,40,0.000333,0.060314,4,723.769913,40.20944,180.942478,82.603359,1,0
0,0,12,12,12,19,31,40,42,82,0.000333,0.135415,12,4874.929169,270.829398,406.244097,123.730173,2,0
0,0,12,12,14,19,33,46,44,90,0.000333,0.151332,14,6355.93659,353.107588,453.995471,134.013592,3,0
0,0,13,13,12,20,32,41,44,85,0.000333,0.141667,12,5100,283.333333,425,129.458112,2,0
0,0,13,13,14,21,35,47,46,93,0.000333,0.159008,14,6678.326488,371.018138,477.023321,145.541635,3,0
0,0,15,15,13,21,34,52,52,104,0.000333,0.176365,12,6349.153626,352.730757,529.096135,140.344382,2,0
0,0,9,9,9,16,25,27,31,58,0.000333,0.089781,4,1077.374636,59.854146,269.343659,92.529325,1,0
0,0,15,15,14,22,36,52,52,104,0.000333,0.179224,14,7527.410802,418.189489,537.6722,151.410465,2,0
0,0,9,9,10,17,27,27,30,57,0.000333,0.090343,5,1355.142938,75.285719,271.028588,102.706149,1,0
0,0,19,19,14,23,37,67,67,134,0.000333,0.232689,14,9772.934514,542.940806,698.066751,157.344894,2,0
0,0,16,16,14,23,37,56,55,111,0.000333,0.19275,14,8095.49053,449.749474,578.249324,157.344894,2,0
0,0,25,25,19,47,66,113,93,206,0.000333,0.415048,9,11206.3067,622.572594,1245.145189,341.776299,9,0
0,0,25,25,20,48,68,114,99,213,0.000333,0.43221,20,25932.5917,1440.699539,1296.629585,354.516762,9,0
0,0,21,21,18,44,62,104,79,183,0.000333,0.363206,9,9806.561323,544.808962,1089.617925,315.273641,9,0
0,0,21,21,18,45,63,104,81,185,0.000333,0.368599,9,9952.171073,552.898393,1105.796786,322.192039,9,0
0,0,17,17,15,22,37,66,62,128,0.000333,0.22227,14,9335.340431,518.630024,666.810031,156.710855,2,0
0,0,19,19,19,25,44,74,67,141,0.000333,0.256593,18,13856.03745,769.779858,769.779858,196.807027,3,0
0,0,15,15,15,17,32,61,52,113,0.000333,0.188333,21,11865,659.166667,565,128.090227,3,0
0,0,17,17,19,20,39,69,57,126,0.000333,0.221987,18,11987.29223,665.96068,665.96068,167.149185,4,0
0,0,15,15,15,17,32,61,52,113,0.000333,0.188333,21,11865,659.166667,565,128.090227,3,0
0,0,17,17,19,20,39,69,57,126,0.000333,0.221987,18,11987.29223,665.96068,665.96068,167.149185,4,0
0,0,26,26,20,49,69,121,91,212,0.000333,0.431669,10,12950.07185,719.448436,1295.007185,361.559344,9,0
0,0,25,25,20,49,69,120,89,209,0.000333,0.425561,10,12766.81612,709.267562,1276.681611,361.559344,9,0
0,0,20,20,17,41,58,92,69,161,0.000333,0.314378,8,7545.079522,419.171085,943.13494,289.1465,7,0
0,0,19,19,17,41,58,91,67,158,0.000333,0.30852,8,7404.487978,411.360443,925.560997,289.1465,7,0
0,0,20,20,18,40,58,93,68,161,0.000333,0.314378,9,8488.214462,471.56747,943.13494,287.935774,7,0
0,0,19,19,18,40,58,92,66,158,0.000333,0.30852,9,8330.048975,462.780499,925.560997,287.935774,7,0
0,0,16,16,15,17,32,70,49,119,0.000333,0.198333,14,8330,462.777778,595,128.090227,3,0
0,0,19,19,19,19,38,83,57,140,0.000333,0.244903,27,19837.166,1102.064778,734.709852,161.421246,4,0
0,0,10,10,14,14,28,42,30,72,0.000333,0.115377,14,4845.813761,269.211876,346.129554,106.605938,2,0
0,0,16,16,15,17,32,70,49,119,0.000333,0.198333,14,8330,462.777778,595,128.090227,3,0
0,0,19,19,19,19,38,83,57,140,0.000333,0.244903,27,19837.166,1102.064778,734.709852,161.421246,4,0
0,0,10,10,14,14,28,42,30,72,0.000333,0.115377,14,4845.813761,269.211876,346.129554,106.605938,2,0
0,0,17,17,15,17,32,76,54,130,0.000333,0.216667,21,13650,758.333333,650,128.090227,2,0
0,0,20,20,19,19,38,89,62,151,0.000333,0.264146,27,21395.80047,1188.655582,792.437055,161.421246,3,0
0,0,10,10,14,14,28,42,30,72,0.000333,0.115377,14,4845.813761,269.211876,346.129554,106.605938,2,0
0,0,12,12,16,18,34,59,41,100,0.000333,0.169582,16,8139.940546,452.218919,508.746284,139.05865,6,0
0,0,6,6,9,10,19,17,15,32,0.000333,0.045311,4,543.734722,30.207485,135.93368,61.748606,2,0
0,0,9,9,12,12,24,26,24,50,0.000333,0.076416,12,2750.9775,152.832083,229.248125,86.0391,2,0
0,0,9,9,14,12,26,29,24,53,0.000333,0.083041,14,3487.726271,193.762571,249.123305,96.322519,2,0
0,0,9,9,16,12,28,34,26,60,0.000333,0.096147,16,4615.060725,256.392263,288.441295,107.01955,3,0
0,0,21,21,19,20,39,83,81,164,0.000333,0.288935,36,31205.0147,1733.611928,866.805964,167.149185,2,0
0,0,9,9,15,12,27,34,24,58,0.000333,0.091928,14,3860.968652,214.498258,275.783475,101.622909,5,0
0,0,9,9,14,12,26,33,24,57,0.000333,0.089308,14,3750.950895,208.386161,267.925064,96.322519,5,0
0,0,31,31,19,49,68,125,127,252,0.000333,0.511347,18,27612.73145,1534.040636,1534.040636,355.831405,8,0
0,0,30,30,19,49,68,124,125,249,0.000333,0.505259,18,27284.00845,1515.778247,1515.778247,355.831405,8,0
0,0,31,31,22,52,74,130,135,265,0.000333,0.548502,22,36201.11312,2011.172951,1645.505142,394.530361,9,0
0,0,30,30,22,52,74,129,133,262,0.000333,0.542292,22,35791.2892,1988.404956,1626.876782,394.530361,9,0
0,0,10,10,10,15,25,32,59,91,0.000333,0.140864,15,6338.863699,352.159094,422.590913,91.82264,2,0
0,0,10,10,12,15,27,36,61,97,0.000333,0.153741,24,11069.37811,614.96545,461.224088,101.622909,3,0
0,0,8,8,9,10,19,22,20,42,0.000333,0.059471,8,1427.303645,79.294647,178.412956,61.748606,1,0
0,0,11,11,14,17,31,46,35,81,0.000333,0.133763,14,5618.058616,312.114368,401.289901,122.789837,3,0
0,0,7,7,9,10,19,19,16,35,0.000333,0.049559,4,594.709852,33.039436,148.677463,61.748606,1,0
0,0,10,10,14,17,31,43,31,74,0.000333,0.122204,7,2566.273689,142.57076,366.610527,122.789837,3,0
0,0,11,11,12,18,30,43,40,83,0.000333,0.135757,12,4887.263033,271.514613,407.271919,118.0782,3,0
0,0,8,8,9,13,22,22,26,48,0.000333,0.071351,8,1712.421742,95.134541,214.052718,76.635041,1,0
0,0,11,11,14,20,34,46,41,87,0.000333,0.147536,14,6196.529741,344.251652,442.609267,139.741531,3,0
0,0,21,21,19,22,41,90,70,160,0.000333,0.285736,27,23144.62466,1285.812481,857.208321,178.818118,3,0
0,0,10,10,14,14,28,42,30,72,0.000333,0.115377,14,4845.813761,269.211876,346.129554,106.605938,2,0
0,0,30,30,19,33,52,129,119,248,0.000333,0.471236,27,38170.14435,2120.563575,1413.70905,247.175629,6,0
0,0,21,21,15,26,41,74,96,170,0.000333,0.303595,21,19126.46066,1062.581148,910.783841,180.814792,2,0
0,0,25,25,16,29,45,107,111,218,0.000333,0.399075,24,28733.3754,1596.298633,1197.223975,204.881449,5,0
0,0,11,11,11,19,30,40,58,98,0.000333,0.160292,15,7213.129176,400.729399,480.875278,118.764371,1,0
0,0,14,14,15,22,37,53,66,119,0.000333,0.206642,21,13018.42396,723.245776,619.924951,156.710855,2,0
0,0,28,28,19,32,51,123,107,230,0.000333,0.434886,27,35225.76137,1956.986743,1304.657829,240.710623,6,0
0,0,19,19,15,25,40,68,82,150,0.000333,0.266096,21,16764.0735,931.337417,798.289214,174.699764,2,0
0,0,23,23,16,28,44,101,97,198,0.000333,0.360322,24,25943.21905,1441.289947,1080.96746,198.605938,5,0
0,0,11,11,11,19,30,40,58,98,0.000333,0.160292,15,7213.129176,400.729399,480.875278,118.764371,1,0
0,0,14,14,15,22,37,53,66,119,0.000333,0.206642,21,13018.42396,723.245776,619.924951,156.710855,2,0
0,0,17,17,18,20,38,71,59,130,0.000333,0.22741,18,12280.15038,682.230577,682.230577,161.497212,3,0
0,0,15,15,11,20,31,58,59,117,0.000333,0.193214,10,5796.409683,322.02276,579.640968,124.49231,1,0
0,0,17,17,15,22,37,66,64,130,0.000333,0.225743,14,9481.205125,526.733618,677.228938,156.710855,2,0
0,0,7,7,10,13,23,29,28,57,0.000333,0.085948,10,2578.430315,143.246129,257.843031,81.324997,1,0
0,0,9,9,14,16,30,37,33,70,0.000333,0.114494,14,4808.752784,267.152932,343.482342,117.302969,2,0
0,0,10,10,11,16,27,33,29,62,0.000333,0.098268,5,1474.015126,81.889729,294.803025,102.053748,3,0
0,0,16,16,12,16,28,53,48,101,0.000333,0.161848,18,8739.771248,485.542847,485.542847,107.01955,3,0
0,0,19,19,16,19,35,66,56,122,0.000333,0.208591,16,10012.36045,556.242247,625.772528,144.710623,4,0
0,0,10,10,14,15,29,40,29,69,0.000333,0.111734,7,2346.404821,130.355823,335.200689,111.906328,2,0
0,0,16,16,12,16,28,53,48,101,0.000333,0.161848,18,8739.771248,485.542847,485.542847,107.01955,3,0
0,0,19,19,16,19,35,66,56,122,0.000333,0.208591,16,10012.36045,556.242247,625.772528,144.710623,4,0
0,0,10,10,14,15,29,40,29,69,0.000333,0.111734,7,2346.404821,130.355823,335.200689,111.906328,2,0
0,0,14,14,13,16,29,50,40,90,0.000333,0.145739,12,5246.619475,291.47886,437.21829,112.105716,3,0
0,0,17,17,17,19,36,63,48,111,0.000333,0.191287,16,9181.786803,510.099267,573.861675,150.197491,4,0
0,0,10,10,14,15,29,40,29,69,0.000333,0.111734,7,2346.404821,130.355823,335.200689,111.906328,2,0
0,0,12,12,11,14,25,41,33,74,0.000333,0.114548,10,3436.45358,190.914088,343.645358,91.356717,2,0
0,0,15,15,15,17,32,54,41,95,0.000333,0.158333,14,6650,369.444444,475,128.090227,3,0
0,0,10,10,14,15,29,40,29,69,0.000333,0.111734,7,2346.404821,130.355823,335.200689,111.906328,2,0
0,0,13,13,12,16,28,45,35,80,0.000333,0.128196,12,4615.060725,256.392263,384.588394,107.01955,3,0
0,0,16,16,15,19,34,58,43,101,0.000333,0.171278,14,7193.672458,399.64847,513.833747,139.313982,4,0
0,0,10,10,14,15,29,40,29,69,0.000333,0.111734,7,2346.404821,130.355823,335.200689,111.906328,2,0
0,0,13,13,11,16,27,44,35,79,0.000333,0.125212,10,3756.361127,208.686729,375.636113,102.053748,3,0
0,0,16,16,15,19,34,57,43,100,0.000333,0.169582,14,7122.447978,395.691554,508.746284,139.313982,4,0
0,0,10,10,14,15,29,40,29,69,0.000333,0.111734,7,2346.404821,130.355823,335.200689,111.906328,2,0
0,0,13,13,11,15,26,44,34,78,0.000333,0.122211,10,3666.34298,203.685721,366.634298,96.657107,3,0
0,0,16,16,15,18,33,57,42,99,0.000333,0.166465,14,6991.530249,388.418347,499.395018,133.662009,4,0
0,0,13,13,11,15,26,44,34,78,0.000333,0.122211,10,3666.34298,203.685721,366.634298,96.657107,3,0
0,0,16,16,15,18,33,57,42,99,0.000333,0.166465,14,6991.530249,388.418347,499.395018,133.662009,4,0
0,0,32,32,23,55,78,146,107,253,0.000333,0.530069,11,17492.27438,971.793021,1590.206761,422.016709,11,0
0,0,31,31,23,55,78,145,105,250,0.000333,0.523784,11,17284.8561,960.269783,1571.350555,422.016709,11,0
0,0,13,13,13,14,27,47,44,91,0.000333,0.144232,18,7788.505729,432.694763,432.694763,101.408685,2,0
0,0,15,15,15,17,32,55,49,104,0.000333,0.173333,14,7280,404.444444,520,128.090227,3,0
0,0,12,12,15,17,32,44,37,81,0.000333,0.135,14,5670,315,405,128.090227,3,0
0,0,13,13,12,14,26,46,44,90,0.000333,0.141013,18,7614.712343,423.039575,423.039575,96.322519,2,0
0,0,15,15,15,17,32,54,49,103,0.000333,0.171667,14,7210,400.555556,515,128.090227,3,0
0,0,12,12,15,17,32,43,37,80,0.000333,0.133333,14,5600,311.111111,400,128.090227,3,0
0,0,19,19,14,23,37,88,63,151,0.000333,0.262209,14,11012.78442,611.821356,786.627458,157.344894,5,0
0,0,23,23,19,45,64,122,86,208,0.000333,0.416,9,11232,624,1248,327.844012,7,0
0,0,10,10,9,15,24,33,33,66,0.000333,0.100869,8,2420.8602,134.492233,302.607525,87.132684,1,0
0,0,8,8,9,15,24,24,23,47,0.000333,0.071831,4,861.97295,47.887386,215.493238,87.132684,1,0
0,0,19,19,16,25,41,91,64,155,0.000333,0.276807,16,13286.72897,738.15161,830.420561,180.096405,5,0
0,0,23,23,20,47,67,123,86,209,0.000333,0.422604,10,12678.12641,704.340356,1267.812641,347.504238,7,0
0,0,11,11,9,16,25,37,36,73,0.000333,0.113001,8,2712.012015,150.667334,339.001502,92.529325,1,0
0,0,26,26,21,48,69,138,99,237,0.000333,0.482573,20,28954.40593,1608.578107,1447.720296,360.316866,7,0
0,0,19,19,15,24,39,83,65,148,0.000333,0.260747,14,10951.3534,608.408522,782.239528,168.642459,5,0
0,0,10,10,10,16,26,28,35,63,0.000333,0.098709,10,2961.277022,164.51539,296.127702,97.219281,1,0
0,0,19,19,17,26,43,86,66,152,0.000333,0.274931,16,13196.67588,733.14866,824.792243,191.698301,5,0
0,0,13,13,10,17,27,54,64,118,0.000333,0.187026,15,8416.150879,467.563938,561.076725,102.706149,1,0
0,0,16,16,14,20,34,67,72,139,0.000333,0.235719,21,14850.30403,825.016891,707.157335,139.741531,2,0
0,0,10,10,14,17,31,49,36,85,0.000333,0.140369,14,5895.493609,327.527423,421.106686,122.789837,2,0
0,0,15,15,12,19,31,73,56,129,0.000333,0.21303,12,7669.095888,426.060883,639.091324,123.730173,1,0
0,0,18,18,16,22,38,86,64,150,0.000333,0.262396,16,12595.02603,699.723668,787.189127,162.107496,2,0
0,0,10,10,14,18,32,50,36,86,0.000333,0.143333,14,6020,334.444444,430,128.361619,2,0
0,0,9,9,14,16,30,42,34,76,0.000333,0.124308,14,5220.931594,290.051755,372.923685,117.302969,2,0
0,0,12,12,17,19,36,55,42,97,0.000333,0.167161,16,8023.723602,445.762422,501.482725,150.197491,3,0
0,0,10,10,14,17,31,46,35,81,0.000333,0.133763,14,5618.058616,312.114368,401.289901,122.789837,2,0
0,0,15,15,13,16,29,67,44,111,0.000333,0.179745,12,6470.830686,359.490594,539.23589,112.105716,2,0
0,0,18,18,16,19,35,80,52,132,0.000333,0.225688,16,10833.04573,601.835874,677.065358,144.710623,3,0
0,0,10,10,15,14,29,45,31,76,0.000333,0.123069,14,5168.891779,287.160654,369.206556,111.906328,2,0
0,0,15,15,13,15,28,67,44,111,0.000333,0.177872,12,6403.396756,355.744264,533.616396,106.709075,2,0
0,0,18,18,16,18,34,80,52,132,0.000333,0.223848,16,10744.72152,596.928973,671.545095,139.05865,3,0
0,0,10,10,15,14,29,45,31,76,0.000333,0.123069,14,5168.891779,287.160654,369.206556,111.906328,2,0
0,0,22,22,17,27,44,98,76,174,0.000333,0.316647,16,15199.05763,844.39209,949.941102,197.868831,5,0
0,0,13,13,11,19,30,43,48,91,0.000333,0.148842,10,4465.270442,248.07058,446.527044,118.764371,1,0
0,0,21,21,17,28,45,95,76,171,0.000333,0.313036,16,15025.71007,834.761671,939.106879,204.092806,5,0
0,0,20,20,18,26,44,94,65,159,0.000333,0.28935,18,15624.89329,868.049627,868.049627,197.270083,5,0
0,0,11,11,12,17,29,39,38,77,0.000333,0.124688,12,4488.774439,249.376358,374.064537,112.506418,1,0
0,0,19,19,18,26,44,91,66,157,0.000333,0.28571,18,15428.35375,857.130764,857.130764,197.270083,5,0
0,0,15,15,14,21,35,70,50,120,0.000333,0.205171,14,8617.195468,478.733082,615.513962,145.541635,5,0
0,0,8,8,11,18,29,29,32,61,0.000333,0.098779,5,1481.684204,82.315789,296.336841,113.112398,1,0
0,0,11,11,15,21,36,42,40,82,0.000333,0.141311,7,2967.536951,164.863164,423.93385,150.842025,2,0
0,0,6,6,9,13,22,15,18,33,0.000333,0.049054,4,588.644974,32.702499,147.161243,76.635041,1,0
0,0,15,15,15,23,38,71,49,120,0.000333,0.209917,14,8816.518223,489.806568,629.751302,162.645284,5,0
0,0,24,24,19,30,49,111,83,194,0.000333,0.363085,18,19606.56678,1089.25371,1089.25371,227.917341,6,0
0,0,15,15,15,23,38,56,54,110,0.000333,0.192424,14,8081.808371,448.989354,577.272026,162.645284,2,0
0,0,19,19,16,26,42,89,69,158,0.000333,0.283995,16,13631.77845,757.321025,851.986153,186.211433,5,0
0,0,13,13,11,20,31,44,48,92,0.000333,0.151929,10,4557.860606,253.214478,455.786061,124.49231,1,0
0,0,16,16,15,23,38,57,56,113,0.000333,0.197672,14,8302.221326,461.234518,593.015809,162.645284,2,0
0,0,14,14,12,22,34,46,46,92,0.000333,0.156016,12,5616.558977,312.031054,468.046581,141.127046,1,0
0,0,17,17,16,25,41,59,54,113,0.000333,0.201801,16,9686.454024,538.136335,605.403377,180.096405,2,0
0,0,15,15,16,21,37,57,47,104,0.000333,0.180594,16,8668.5304,481.585022,541.78315,156.238666,2,0
0,0,5,5,12,12,24,22,17,39,0.000333,0.059605,6,1072.881225,59.604513,178.813538,86.0391,1,0
0,0,8,8,15,15,30,35,25,60,0.000333,0.098138,7,2060.89405,114.494114,294.413436,117.206718,2,0
0,0,19,19,17,24,41,90,62,152,0.000333,0.271449,16,13029.56648,723.864804,814.347905,179.525968,5,0
0,0,14,14,12,16,28,49,44,93,0.000333,0.149028,12,5365.008093,298.056005,447.084008,107.01955,1,0
0,0,17,17,16,19,35,62,52,114,0.000333,0.194913,16,9355.812223,519.767346,584.738264,144.710623,2,0
0,0,16,16,16,19,35,61,50,111,0.000333,0.189783,16,9109.606638,506.089258,569.350415,144.710623,2,0
0,0,5,5,12,12,24,22,17,39,0.000333,0.059605,6,1072.881225,59.604513,178.813538,86.0391,1,0
0,0,8,8,15,15,30,35,25,60,0.000333,0.098138,7,2060.89405,114.494114,294.413436,117.206718,2,0
0,0,20,20,17,22,39,94,65,159,0.000333,0.280126,16,13446.06325,747.003514,840.378953,167.594364,5,0
0,0,7,7,6,11,17,15,19,34,0.000333,0.046325,3,416.92121,23.162289,138.973737,53.563523,1,0
0,0,7,7,8,12,20,17,19,36,0.000333,0.051863,4,622.357646,34.575425,155.589411,67.01955,1,0
0,0,7,7,7,13,20,16,19,35,0.000333,0.050422,3,453.80245,25.211247,151.267483,67.757201,1,0
0,0,14,14,13,18,31,42,45,87,0.000333,0.143672,12,5172.180948,287.343386,431.015079,123.164366,2,0
0,0,15,15,14,19,33,48,48,96,0.000333,0.161421,14,6779.665696,376.648094,484.261835,134.013592,3,0
0,0,17,17,15,16,31,63,47,110,0.000333,0.181654,14,7629.462318,423.859018,544.961594,122.603359,3,0
0,0,20,20,18,19,37,76,55,131,0.000333,0.227479,18,12283.89104,682.438391,682.438391,155.769273,4,0
0,0,15,15,15,18,33,53,38,91,0.000333,0.153013,14,6426.558108,357.031006,459.039865,133.662009,3,0
0,0,17,17,15,16,31,63,47,110,0.000333,0.181654,14,7629.462318,423.859018,544.961594,122.603359,3,0
0,0,20,20,18,19,37,76,55,131,0.000333,0.227479,18,12283.89104,682.438391,682.438391,155.769273,4,0
0,0,15,15,15,17,32,53,38,91,0.000333,0.151667,14,6370,353.888889,455,128.090227,3,0
0,0,18,18,16,18,34,70,50,120,0.000333,0.203499,16,9767.928655,542.662703,610.495541,139.05865,3,0
0,0,21,21,18,21,39,83,58,141,0.000333,0.248414,18,13414.35083,745.241713,745.241713,167.297316,4,0
0,0,15,15,15,19,34,58,39,97,0.000333,0.164495,14,6908.774538,383.820808,493.483896,139.313982,3,0
0,0,15,15,15,19,34,58,39,97,0.000333,0.164495,14,6908.774538,383.820808,493.483896,139.313982,3,0
0,0,12,12,14,15,29,46,34,80,0.000333,0.129546,14,5440.938715,302.274373,388.63848,111.906328,2,0
0,0,15,15,15,16,31,60,45,105,0.000333,0.173397,14,7282.668576,404.592699,520.190613,122.603359,3,0
0,0,18,18,17,19,36,73,53,126,0.000333,0.217137,16,10422.5688,579.0316,651.41055,150.197491,4,0
0,0,13,13,14,17,31,50,36,86,0.000333,0.14202,14,5964.852358,331.380687,426.060883,122.789837,3,0
0,0,15,15,14,16,30,59,45,104,0.000333,0.170106,14,7144.432707,396.912928,510.316622,117.302969,3,0
0,0,18,18,17,19,36,72,53,125,0.000333,0.215414,16,10339.85,574.436111,646.240625,150.197491,4,0
0,0,13,13,14,17,31,49,36,85,0.000333,0.140369,14,5895.493609,327.527423,421.106686,122.789837,3,0
0,0,15,15,14,15,29,59,44,103,0.000333,0.166791,14,7005.208595,389.178255,500.372042,111.906328,3,0
0,0,18,18,18,18,36,72,52,124,0.000333,0.21369,18,11539.2726,641.0707,641.0707,150.1173,4,0
0,0,13,13,15,16,31,49,35,84,0.000333,0.138717,14,5826.134861,323.674159,416.15249,122.603359,3,0
0,0,11,11,14,15,29,44,32,76,0.000333,0.123069,14,5168.891779,287.160654,369.206556,111.906328,2,0
0,0,15,15,14,15,29,59,44,103,0.000333,0.166791,14,7005.208595,389.178255,500.372042,111.906328,3,0
0,0,18,18,18,18,36,72,52,124,0.000333,0.21369,18,11539.2726,641.0707,641.0707,150.1173,4,0
0,0,13,13,15,16,31,49,35,84,0.000333,0.138717,14,5826.134861,323.674159,416.15249,122.603359,3,0
0,0,11,11,14,15,29,44,32,76,0.000333,0.123069,14,5168.891779,287.160654,369.206556,111.906328,2,0
0,0,11,11,17,20,37,46,42,88,0.000333,0.152811,16,7334.910339,407.495019,458.431896,155.92543,3,0
0,0,11,11,11,18,29,41,45,86,0.000333,0.139262,10,4177.863656,232.103536,417.786366,113.112398,2,0
0,0,18,18,15,21,36,74,65,139,0.000333,0.23954,21,15091.01108,838.389504,718.619575,150.842025,3,0
0,0,20,20,18,24,42,82,70,152,0.000333,0.273211,18,14753.38047,819.632248,819.632248,185.09775,4,0
0,0,11,11,12,17,29,42,44,86,0.000333,0.139262,12,5013.436387,278.524244,417.786366,112.506418,2,0
0,0,18,18,15,21,36,74,65,139,0.000333,0.23954,21,15091.01108,838.389504,718.619575,150.842025,3,0
0,0,20,20,18,24,42,82,70,152,0.000333,0.273211,18,14753.38047,819.632248,819.632248,185.09775,4,0
0,0,11,11,12,17,29,42,44,86,0.000333,0.139262,12,5013.436387,278.524244,417.786366,112.506418,2,0
0,0,26,26,26,49,75,122,101,223,0.000333,0.463009,26,36114.69077,2006.371709,1389.026568,397.332215,9,0
0,0,10,10,16,18,34,32,40,72,0.000333,0.122099,16,5860.757193,325.597622,366.297325,139.05865,2,0
0,0,25,25,21,48,69,112,87,199,0.000333,0.405199,10,12155.96367,675.331315,1215.596367,360.316866,8,0
0,0,24,24,21,48,69,111,85,196,0.000333,0.39909,10,11972.70794,665.150441,1197.270794,360.316866,8,0
0,0,25,25,24,50,74,117,91,208,0.000333,0.430522,12,15498.7956,861.0442,1291.5663,392.23191,9,0
0,0,24,24,24,50,74,116,89,205,0.000333,0.424313,12,15275.25528,848.625293,1272.93794,392.23191,9,0
0,0,19,19,16,21,37,86,65,151,0.000333,0.262209,24,18879.059,1048.836611,786.627458,156.238666,2,0
0,0,10,10,14,17,31,48,35,83,0.000333,0.137066,14,5756.776113,319.820895,411.198294,122.789837,2,0
0,0,15,15,13,16,29,50,46,96,0.000333,0.155455,12,5596.394106,310.910784,466.366176,112.105716,2,0
0,0,17,17,16,19,35,58,51,109,0.000333,0.186364,16,8945.469582,496.970532,559.091849,144.710623,3,0
0,0,14,14,16,19,35,47,39,86,0.000333,0.147039,16,7057.893431,392.105191,441.118339,144.710623,3,0
0,0,15,15,13,15,28,50,46,96,0.000333,0.153835,18,8307.109305,461.506073,461.506073,106.709075,2,0
0,0,17,17,16,18,34,58,51,109,0.000333,0.184844,16,8872.535195,492.918622,554.53345,139.05865,3,0
0,0,14,14,16,18,34,47,39,86,0.000333,0.145841,16,7000.34887,388.908271,437.521804,139.05865,3,0
0,0,14,14,14,16,30,58,51,109,0.000333,0.178284,21,11231.87257,623.992921,534.851075,117.302969,2,0
0,0,16,16,18,19,37,66,56,122,0.000333,0.211851,18,11439.95959,635.553311,635.553311,155.769273,3,0
0,0,14,14,14,21,35,57,61,118,0.000333,0.201752,14,8473.575544,470.754197,605.255396,145.541635,1,0
0,0,17,17,18,24,42,69,70,139,0.000333,0.249844,18,13491.57819,749.532122,749.532122,185.09775,2,0
0,0,20,20,18,27,45,95,66,161,0.000333,0.294729,18,15915.39027,884.188349,884.188349,203.440613,6,0
0,0,11,11,12,18,30,40,39,79,0.000333,0.129215,12,4651.732285,258.429571,387.644357,118.0782,2,0
0,0,19,19,18,26,44,91,66,157,0.000333,0.28571,18,15428.35375,857.130764,857.130764,197.270083,5,0
0,0,7,7,12,14,26,26,23,49,0.000333,0.076774,6,1381.929277,76.773849,230.321546,96.322519,1,0
0,0,6,6,9,9,18,16,14,30,0.000333,0.041699,4,500.391,27.7995,125.09775,57.05865,1,0
0,0,18,18,14,22,36,76,74,150,0.000333,0.258496,21,16285.26376,904.736875,775.48875,151.410465,5,0
0,0,12,12,10,17,27,37,53,90,0.000333,0.142647,15,6419.098128,356.616563,427.939875,102.706149,1,0
0,0,18,18,16,24,40,79,79,158,0.000333,0.280288,24,20180.75134,1121.152852,840.864639,174.0391,5,0
0,0,3,3,7,9,16,10,11,21,0.000333,0.028,3,252,14,84,48.180809,1,0
0,0,3,3,7,10,17,10,12,22,0.000333,0.029975,3,269.772548,14.987364,89.924183,52.870765,1,0
0,0,13,13,10,17,27,41,56,97,0.000333,0.153741,15,6918.361316,384.353406,461.224088,102.706149,1,0
0,0,3,3,7,10,17,10,12,22,0.000333,0.029975,3,269.772548,14.987364,89.924183,52.870765,1,0
0,0,16,16,15,23,38,66,71,137,0.000333,0.239655,21,15098.28746,838.793748,718.966069,162.645284,3,0
0,0,14,14,14,20,34,64,54,118,0.000333,0.200107,14,8404.488614,466.916034,600.320615,139.741531,5,0
0,0,8,8,10,15,25,25,29,54,0.000333,0.083589,5,1253.841171,69.657843,250.768234,91.82264,1,0
0,0,14,14,16,22,38,67,55,122,0.000333,0.213416,16,10243.95451,569.108584,640.247157,162.107496,5,0
0,0,3,3,7,9,16,10,11,21,0.000333,0.028,3,252,14,84,48.180809,1,0
0,0,3,3,7,10,17,10,12,22,0.000333,0.029975,3,269.772548,14.987364,89.924183,52.870765,1,0
0,0,9,9,10,15,25,29,32,61,0.000333,0.094425,10,2832.752276,157.375126,283.275228,91.82264,1,0
0,0,3,3,7,10,17,10,12,22,0.000333,0.029975,3,269.772548,14.987364,89.924183,52.870765,1,0
0,0,12,12,15,21,36,54,47,101,0.000333,0.174054,14,7310.273952,406.126331,522.162425,150.842025,3,0
0,0,20,20,14,23,37,82,84,166,0.000333,0.288256,21,18160.15443,1008.897468,864.769259,157.344894,5,0
0,0,14,14,10,18,28,43,65,108,0.000333,0.173065,15,7787.914974,432.661943,519.194332,108.277931,1,0
0,0,20,20,16,25,41,85,91,176,0.000333,0.31431,24,22630.29967,1257.23887,942.929153,180.096405,5,0
0,0,3,3,7,9,16,10,11,21,0.000333,0.028,3,252,14,84,48.180809,1,0
0,0,3,3,7,10,17,10,12,22,0.000333,0.029975,3,269.772548,14.987364,89.924183,52.870765,1,0
0,0,9,9,9,14,23,31,51,82,0.000333,0.123644,12,4451.184965,247.288054,370.93208,81.832294,1,0
0,0,3,3,7,10,17,10,12,22,0.000333,0.029975,3,269.772548,14.987364,89.924183,52.870765,1,0
0,0,9,9,10,14,24,33,51,84,0.000333,0.128379,15,5777.052751,320.947375,385.13685,86.52225,1,0
0,0,14,14,16,23,39,60,49,109,0.000333,0.192036,16,9217.74147,512.096748,576.108842,168.041925,3,0
0,0,11,11,12,17,29,39,38,77,0.000333,0.124688,12,4488.774439,249.376358,374.064537,112.506418,1,0
0,0,13,13,16,23,39,57,50,107,0.000333,0.188513,16,9048.608599,502.700478,565.538037,168.041925,3,0
0,0,4,4,8,9,17,14,14,28,0.000333,0.03815,4,457.795838,25.433102,114.44896,52.529325,1,0
0,0,15,15,12,19,31,60,49,109,0.000333,0.180002,12,6480.088774,360.004932,540.007398,123.730173,1,0
0,0,18,18,16,22,38,73,57,130,0.000333,0.22741,16,10915.68923,606.427179,682.230577,162.107496,2,0
0,0,14,14,16,19,35,58,43,101,0.000333,0.172686,16,8288.921355,460.495631,518.057585,144.710623,2,0
0,0,13,13,16,19,35,56,41,97,0.000333,0.165847,16,7960.647242,442.25818,497.540453,144.710623,2,0
0,0,15,15,14,17,31,49,46,95,0.000333,0.156883,14,6589.081093,366.060061,470.648649,122.789837,3,0
0,0,12,12,14,17,31,38,34,72,0.000333,0.118901,14,4993.829881,277.434993,356.702134,122.789837,3,0
0,0,15,15,14,17,31,49,46,95,0.000333,0.156883,14,6589.081093,366.060061,470.648649,122.789837,3,0
0,0,12,12,14,17,31,38,34,72,0.000333,0.118901,14,4993.829881,277.434993,356.702134,122.789837,3,0
0,0,4,4,8,9,17,14,14,28,0.000333,0.03815,4,457.795838,25.433102,114.44896,52.529325,1,0
0,0,13,13,12,14,26,55,39,94,0.000333,0.14728,12,5302.096002,294.560889,441.841334,96.322519,2,0
0,0,16,16,16,17,33,68,47,115,0.000333,0.193368,16,9281.68518,515.649177,580.105324,133.486868,3,0
0,0,13,13,16,17,33,54,37,91,0.000333,0.153013,16,7344.637838,408.035435,459.039865,133.486868,3,0
0,0,11,11,15,16,31,49,34,83,0.000333,0.137066,14,5756.776113,319.820895,411.198294,122.603359,2,0
0,0,13,13,12,14,26,55,39,94,0.000333,0.14728,12,5302.096002,294.560889,441.841334,96.322519,2,0
0,0,16,16,16,17,33,68,47,115,0.000333,0.193368,16,9281.68518,515.649177,580.105324,133.486868,3,0
0,0,13,13,16,17,33,54,37,91,0.000333,0.153013,16,7344.637838,408.035435,459.039865,133.486868,3,0
0,0,11,11,15,16,31,49,34,83,0.000333,0.137066,14,5756.776113,319.820895,411.198294,122.603359,2,0
0,0,8,8,12,14,26,28,25,53,0.000333,0.083041,6,1494.73983,83.041102,249.123305,96.322519,3,0
0,0,6,6,10,10,20,17,15,32,0.000333,0.046101,5,691.508495,38.417139,138.301699,66.438562,1,0
0,0,4,4,8,9,17,14,14,28,0.000333,0.03815,4,457.795838,25.433102,114.44896,52.529325,1,0
0,0,14,14,11,17,28,58,50,108,0.000333,0.173065,10,5191.943316,288.441295,519.194332,107.540616,1,0
0,0,17,17,15,20,35,71,58,129,0.000333,0.220559,14,9263.485129,514.638063,661.677509,145.041921,2,0
0,0,10,10,14,17,31,49,36,85,0.000333,0.140369,14,5895.493609,327.527423,421.106686,122.789837,2,0
0,0,14,14,15,20,35,57,48,105,0.000333,0.179525,14,7540.046035,418.891446,538.574717,145.041921,2,0
0,0,13,13,15,20,35,55,46,101,0.000333,0.172686,14,7252.806186,402.933677,518.057585,145.041921,2,0
0,0,4,4,8,9,17,14,14,28,0.000333,0.03815,4,457.795838,25.433102,114.44896,52.529325,1,0
0,0,7,7,9,11,20,21,20,41,0.000333,0.059066,4,708.796208,39.377567,177.199052,66.583073,1,0
0,0,6,6,8,11,19,19,18,37,0.000333,0.052391,4,628.693272,34.927404,157.173318,62.053748,1,0
0,0,17,17,18,19,37,69,57,126,0.000333,0.218797,27,17722.56035,984.586686,656.391124,155.769273,4,0
0,0,17,17,18,19,37,69,57,126,0.000333,0.218797,27,17722.56035,984.586686,656.391124,155.769273,4,0
0,0,7,7,13,17,30,27,32,59,0.000333,0.096502,6,1737.039271,96.502182,289.506545,117.592585,1,0
0,0,10,10,17,20,37,40,40,80,0.000333,0.138919,16,6668.100308,370.450017,416.756269,155.92543,2,0
0,0,9,9,10,17,27,36,34,70,0.000333,0.110947,10,3328.421252,184.912292,332.842125,102.706149,1,0
0,0,9,9,11,18,29,36,33,69,0.000333,0.111734,5,1676.003443,93.111302,335.200689,113.112398,1,0
0,0,19,19,15,24,39,76,70,146,0.000333,0.257223,14,10803.36214,600.186785,771.668724,168.642459,2,0
0,0,16,16,15,24,39,65,58,123,0.000333,0.216701,14,9101.462621,505.636812,650.104473,168.642459,2,0
0,0,11,11,11,18,29,41,45,86,0.000333,0.139262,10,4177.863656,232.103536,417.786366,113.112398,2,0
0,0,18,18,16,22,38,75,66,141,0.000333,0.246653,24,17758.98671,986.610373,739.957779,162.107496,3,0
0,0,20,20,18,25,43,83,71,154,0.000333,0.278548,18,15041.6059,835.644772,835.644772,191.155055,4,0
0,0,11,11,12,17,29,42,44,86,0.000333,0.139262,12,5013.436387,278.524244,417.786366,112.506418,2,0
0,0,18,18,15,22,37,74,66,140,0.000333,0.243108,21,15315.7929,850.877383,729.323471,156.710855,3,0
0,0,20,20,18,25,43,82,71,153,0.000333,0.27674,18,14943.93313,830.218507,830.218507,191.155055,4,0
0,0,11,11,12,17,29,42,44,86,0.000333,0.139262,12,5013.436387,278.524244,417.786366,112.506418,2,0
0,0,7,7,6,12,18,15,20,35,0.000333,0.048649,3,437.842125,24.324563,145.947375,58.529325,1,0
0,0,7,7,8,13,21,17,20,37,0.000333,0.054172,4,650.062979,36.11461,162.515745,72.105716,1,0
0,0,7,7,7,14,21,16,20,36,0.000333,0.052708,3,474.370282,26.353905,158.123427,72.954453,1,0
0,0,7,7,12,15,27,32,31,63,0.000333,0.099853,12,3594.694952,199.705275,299.557913,101.622909,1,0
0,0,9,9,15,18,33,40,36,76,0.000333,0.127791,14,5367.235343,298.179741,383.373953,133.662009,2,0
0,0,19,19,14,23,37,67,76,143,0.000333,0.248317,21,15643.98846,869.11047,744.951831,157.344894,2,0
0,0,15,15,14,21,35,52,63,115,0.000333,0.196623,21,12387.21849,688.178805,589.867547,145.541635,2,0
0,0,16,16,11,20,31,55,70,125,0.000333,0.206425,15,9289.118082,516.062116,619.274539,124.49231,1,0
0,0,18,18,15,23,38,63,75,138,0.000333,0.241405,21,15208.49393,844.91633,724.213997,162.645284,2,0
0,0,7,7,12,14,26,26,23,49,0.000333,0.076774,6,1381.929277,76.773849,230.321546,96.322519,1,0
0,0,7,7,12,14,26,26,23,49,0.000333,0.076774,6,1381.929277,76.773849,230.321546,96.322519,1,0
0,0,6,6,9,9,18,16,14,30,0.000333,0.041699,4,500.391,27.7995,125.09775,57.05865,1,0
0,0,6,6,9,9,18,16,14,30,0.000333,0.041699,4,500.391,27.7995,125.09775,57.05865,1,0
0,0,3,3,7,6,13,8,7,15,0.000333,0.018502,3,166.519787,9.251099,55.506596,35.161259,1,0
0,0,12,12,14,18,32,54,43,97,0.000333,0.161667,14,6790,377.222222,485,128.361619,5,0
0,0,3,3,7,7,14,8,8,16,0.000333,0.020306,3,182.753036,10.152946,60.917679,39.302969,1,0
0,0,4,4,10,13,23,14,17,31,0.000333,0.046743,5,701.152103,38.952895,140.230421,81.324997,1,0
0,0,6,6,9,12,21,15,17,32,0.000333,0.046851,4,562.21663,31.234257,140.554158,71.548875,1,0
0,0,3,3,7,7,14,8,8,16,0.000333,0.020306,3,182.753036,10.152946,60.917679,39.302969,1,0
0,0,4,4,11,13,24,16,17,33,0.000333,0.050435,5,756.518813,42.028823,151.303763,86.159464,1,0
0,0,12,12,15,20,35,55,43,98,0.000333,0.167557,14,7037.376299,390.96535,502.669736,145.041921,5,0
0,0,10,10,12,17,29,40,37,77,0.000333,0.124688,12,4488.774439,249.376358,374.064537,112.506418,2,0
0,0,13,13,16,20,36,53,45,98,0.000333,0.168884,16,8106.442402,450.357911,506.65265,150.438562,3,0
0,0,10,10,13,16,29,41,32,73,0.000333,0.118211,12,4255.591352,236.421742,354.632613,112.105716,2,0
0,0,14,14,13,19,32,47,50,97,0.000333,0.161667,12,5820,323.333333,485,128.816339,2,0
0,0,14,14,14,20,34,47,50,97,0.000333,0.164495,14,6908.774538,383.820808,493.483896,139.741531,2,0
0,0,18,18,17,22,39,63,65,128,0.000333,0.22551,16,10824.50374,601.361319,676.531484,167.594364,3,0
0,0,16,16,13,20,33,53,60,113,0.000333,0.190006,18,10260.29764,570.016535,570.016535,134.544278,2,0
0,0,16,16,14,21,35,53,62,115,0.000333,0.196623,14,8258.145657,458.78587,589.867547,145.541635,2,0
0,0,20,20,17,23,40,69,77,146,0.000333,0.259001,24,18648.03604,1036.002002,777.001502,173.528793,3,0
0,0,12,12,11,14,25,41,33,74,0.000333,0.114548,10,3436.45358,190.914088,343.645358,91.356717,2,0
0,0,15,15,15,17,32,54,41,95,0.000333,0.158333,14,6650,369.444444,475,128.090227,3,0
0,0,10,10,14,15,29,40,29,69,0.000333,0.111734,7,2346.404821,130.355823,335.200689,111.906328,2,0
0,0,18,18,16,18,34,73,62,135,0.000333,0.228936,24,16483.37961,915.743311,686.807484,139.05865,2,0
0,0,3,3,8,7,15,11,9,20,0.000333,0.026046,4,312.551248,17.363958,78.137812,43.651484,1,0
0,0,7,7,10,15,25,23,24,47,0.000333,0.072754,5,1091.306205,60.628122,218.261241,91.82264,1,0
0,0,3,3,8,8,16,11,10,21,0.000333,0.028,4,336,18.666667,84,48,1,0
0,0,3,3,10,9,19,14,13,27,0.000333,0.038231,5,573.470214,31.859456,114.694043,61.748606,1,0
0,0,6,6,9,9,18,16,14,30,0.000333,0.041699,4,500.391,27.7995,125.09775,57.05865,1,0
0,0,3,3,8,8,16,11,10,21,0.000333,0.028,4,336,18.666667,84,48,1,0
0,0,3,3,11,9,20,16,13,29,0.000333,0.041779,5,626.679574,34.815532,125.335915,66.583073,1,0
0,0,7,7,11,14,25,24,23,47,0.000333,0.072754,5,1091.306205,60.628122,218.261241,91.356717,1,0
0,0,3,3,6,8,14,7,9,16,0.000333,0.020306,3,182.753036,10.152946,60.917679,39.509775,1,0
0,0,3,3,7,7,14,8,8,16,0.000333,0.020306,3,182.753036,10.152946,60.917679,39.302969,1,0
0,0,9,9,10,12,22,29,26,55,0.000333,0.081756,10,2452.68739,136.260411,245.268739,76.238831,1,0
0,0,8,8,10,12,22,25,23,48,0.000333,0.071351,5,1070.263588,59.459088,214.052718,76.238831,1,0
0,0,3,3,7,7,14,8,8,16,0.000333,0.020306,3,182.753036,10.152946,60.917679,39.302969,1,0
0,0,12,12,14,19,33,48,41,89,0.000333,0.14965,14,6285.315073,349.184171,448.951077,134.013592,2,0
0,0,9,9,12,16,28,35,32,67,0.000333,0.107364,12,3865.113357,214.72852,322.09278,107.01955,1,0
0,0,3,3,6,8,14,7,9,16,0.000333,0.020306,3,182.753036,10.152946,60.917679,39.509775,1,0
0,0,3,3,7,7,14,8,8,16,0.000333,0.020306,3,182.753036,10.152946,60.917679,39.302969,1,0
0,0,10,10,11,17,28,31,31,62,0.000333,0.099352,5,1490.280026,82.793335,298.056005,107.540616,1,0
0,0,8,8,11,14,25,26,24,50,0.000333,0.077398,5,1160.964047,64.498003,232.192809,91.356717,1,0
0,0,3,3,7,7,14,8,8,16,0.000333,0.020306,3,182.753036,10.152946,60.917679,39.302969,1,0
0,0,13,13,15,24,39,50,46,96,0.000333,0.169133,7,3551.790291,197.321683,507.398613,168.642459,2,0
0,0,9,9,13,18,31,36,33,69,0.000333,0.113947,6,2051.037273,113.946515,341.839545,123.164366,1,0
0,0,9,9,10,17,27,32,37,69,0.000333,0.109362,10,3280.872376,182.270688,328.087238,102.706149,1,0
0,0,8,8,10,15,25,25,29,54,0.000333,0.083589,5,1253.841171,69.657843,250.768234,91.82264,1,0
0,0,9,9,12,19,31,35,38,73,0.000333,0.120552,12,4339.875968,241.10422,361.656331,123.730173,1,0
0,0,3,3,7,9,16,10,11,21,0.000333,0.028,3,252,14,84,48.180809,1,0
0,0,3,3,7,10,17,10,12,22,0.000333,0.029975,3,269.772548,14.987364,89.924183,52.870765,1,0
0,0,9,9,10,15,25,29,32,61,0.000333,0.094425,10,2832.752276,157.375126,283.275228,91.82264,1,0
0,0,3,3,7,10,17,10,12,22,0.000333,0.029975,3,269.772548,14.987364,89.924183,52.870765,1,0
0,0,12,12,14,22,36,48,47,95,0.000333,0.163714,14,6876.000252,382.000014,491.142875,151.410465,2,0
0,0,8,8,11,15,26,35,29,64,0.000333,0.100276,5,1504.14071,83.563373,300.828142,96.657107,1,0
0,0,11,11,15,18,33,48,37,85,0.000333,0.142925,14,6002.829002,333.4905,428.7735,133.662009,2,0
0,0,10,10,15,14,29,45,31,76,0.000333,0.123069,14,5168.891779,287.160654,369.206556,111.906328,2,0
0,0,19,19,11,20,31,79,78,157,0.000333,0.25927,15,11667.13231,648.174017,777.808821,124.49231,1,0
0,0,22,22,15,22,37,92,86,178,0.000333,0.309094,21,19472.93668,1081.829816,927.282699,156.710855,2,0
0,0,10,10,14,16,30,47,35,82,0.000333,0.134122,14,5633.110404,312.950578,402.365029,117.302969,2,0
0,0,16,16,12,19,31,73,57,130,0.000333,0.214682,18,11592.81937,644.04552,644.04552,123.730173,1,0
0,0,19,19,16,21,37,86,65,151,0.000333,0.262209,24,18879.059,1048.836611,786.627458,156.238666,2,0
0,0,10,10,14,17,31,48,35,83,0.000333,0.137066,14,5756.776113,319.820895,411.198294,122.789837,2,0
0,0,9,9,14,11,25,33,22,55,0.000333,0.085137,14,3575.769266,198.653848,255.41209,91.356717,5,0
0,0,9,9,14,11,25,33,22,55,0.000333,0.085137,14,3575.769266,198.653848,255.41209,91.356717,5,0
0,0,26,26,22,46,68,117,85,202,0.000333,0.409889,11,13526.34243,751.463469,1229.667494,352.191346,10,0
0,0,25,25,22,46,68,116,83,199,0.000333,0.403802,11,13325.45616,740.30312,1211.405105,352.191346,10,0
0,0,26,26,22,46,68,117,85,202,0.000333,0.409889,11,13526.34243,751.463469,1229.667494,352.191346,10,0
0,0,25,25,22,46,68,116,83,199,0.000333,0.403802,11,13325.45616,740.30312,1211.405105,352.191346,10,0
0,0,28,28,23,45,68,122,87,209,0.000333,0.424093,11,13995.07707,777.504282,1272.279734,351.175314,10,0
0,0,27,27,23,45,68,121,85,206,0.000333,0.418006,11,13794.1908,766.343933,1254.017345,351.175314,10,0
0,0,28,28,23,45,68,122,87,209,0.000333,0.424093,11,13995.07707,777.504282,1272.279734,351.175314,10,0
0,0,27,27,23,45,68,121,85,206,0.000333,0.418006,11,13794.1908,766.343933,1254.017345,351.175314,10,0
0,0,12,12,11,14,25,52,45,97,0.000333,0.150151,15,6756.810756,375.378375,450.45405,91.356717,1,0
0,0,14,14,15,17,32,60,50,110,0.000333,0.183333,14,7700,427.777778,550,128.090227,2,0
0,0,13,13,13,17,30,54,47,101,0.000333,0.165199,12,5947.151402,330.3973,495.59595,117.592585,2,0
0,0,15,15,15,20,35,62,52,114,0.000333,0.194913,14,8186.335695,454.796428,584.738264,145.041921,3,0
0,0,13,13,12,17,29,53,47,100,0.000333,0.161933,12,5829.577194,323.8654,485.7981,112.506418,2,0
0,0,15,15,15,20,35,61,52,113,0.000333,0.193203,14,8114.525733,450.806985,579.608981,145.041921,3,0
0,0,15,15,15,21,36,68,55,123,0.000333,0.211967,14,8902.610852,494.589492,635.900775,150.842025,6,0
0,0,9,9,10,15,25,29,30,59,0.000333,0.091329,10,2739.875152,152.215286,273.987515,91.82264,2,0
0,0,15,15,17,23,40,71,56,127,0.000333,0.225295,16,10814.15789,600.786549,675.884868,173.528793,6,0
0,0,12,12,14,18,32,54,43,97,0.000333,0.161667,14,6790,377.222222,485,128.361619,5,0
0,0,6,6,9,12,21,15,17,32,0.000333,0.046851,4,562.21663,31.234257,140.554158,71.548875,1,0
0,0,12,12,15,20,35,55,43,98,0.000333,0.167557,14,7037.376299,390.96535,502.669736,145.041921,5,0
0,0,16,16,15,23,38,68,61,129,0.000333,0.225661,14,9477.757089,526.542061,676.982649,162.645284,6,0
0,0,10,10,10,17,27,29,36,65,0.000333,0.103023,10,3090.676876,171.704271,309.067688,102.706149,2,0
0,0,16,16,17,25,42,71,62,133,0.000333,0.239059,16,11474.85148,637.491749,717.178217,185.583273,6,0
0,0,16,16,14,22,36,73,59,132,0.000333,0.227477,14,9554.021403,530.778967,682.4301,151.410465,6,0
0,0,11,11,13,20,33,46,38,84,0.000333,0.141243,6,2542.374636,141.243035,423.729106,134.544278,3,0
0,0,10,10,9,16,25,34,34,68,0.000333,0.105261,8,2526.257767,140.347654,315.782221,92.529325,2,0
0,0,8,8,9,15,24,24,23,47,0.000333,0.071831,4,861.97295,47.887386,215.493238,87.132684,1,0
0,0,16,16,16,24,40,76,60,136,0.000333,0.241261,16,11580.51553,643.361974,723.782221,174.0391,6,0
0,0,11,11,14,22,36,47,38,85,0.000333,0.146481,7,3076.105376,170.894743,439.443625,151.410465,3,0
0,0,11,11,9,17,26,38,37,75,0.000333,0.117511,8,2820.263831,156.681324,352.532979,98.016193,2,0
0,0,14,14,15,24,39,63,52,115,0.000333,0.202607,14,8509.497572,472.749865,607.821255,168.642459,4,0
0,0,13,13,12,15,27,55,46,101,0.000333,0.160081,18,8644.385479,480.243638,480.243638,101.622909,2,0
0,0,15,15,15,18,33,63,51,114,0.000333,0.191687,14,8050.853014,447.269612,575.06093,133.662009,3,0
0,0,13,13,12,15,27,55,46,101,0.000333,0.160081,18,8644.385479,480.243638,480.243638,101.622909,2,0
0,0,15,15,15,18,33,63,51,114,0.000333,0.191687,14,8050.853014,447.269612,575.06093,133.662009,3,0
0,0,9,9,14,16,30,40,29,69,0.000333,0.112858,7,2370.028158,131.668231,338.575451,117.302969,3,0
0,0,9,9,14,16,30,40,29,69,0.000333,0.112858,7,2370.028158,131.668231,338.575451,117.302969,3,0
0,0,6,6,9,9,18,16,14,30,0.000333,0.041699,4,500.391,27.7995,125.09775,57.05865,1,0
0,0,6,6,9,9,18,16,14,30,0.000333,0.041699,4,500.391,27.7995,125.09775,57.05865,1,0
0,0,23,23,14,24,38,95,86,181,0.000333,0.316625,21,19947.37248,1108.18736,949.87488,163.342069,5,0
0,0,14,14,9,16,25,40,62,102,0.000333,0.157891,12,5684.079976,315.782221,473.673331,92.529325,1,0
0,0,23,23,16,26,42,98,93,191,0.000333,0.343311,24,24718.38307,1373.243504,1029.932628,186.211433,5,0
0,0,15,15,14,20,34,70,48,118,0.000333,0.200107,14,8404.488614,466.916034,600.320615,139.741531,5,0
0,0,6,6,9,12,21,15,17,32,0.000333,0.046851,4,562.21663,31.234257,140.554158,71.548875,1,0
0,0,15,15,15,22,37,71,48,119,0.000333,0.206642,14,8678.949307,482.16385,619.924951,156.710855,5,0
0,0,14,14,11,18,29,46,45,91,0.000333,0.147359,10,4420.762706,245.597928,442.076271,113.112398,2,0
0,0,17,17,15,21,36,59,53,112,0.000333,0.193011,14,8106.442402,450.357911,579.0316,150.842025,3,0
0,0,10,10,13,18,31,41,33,74,0.000333,0.122204,6,2199.663162,122.203509,366.610527,123.164366,2,0
0,0,7,7,12,12,24,33,28,61,0.000333,0.093228,12,3356.192551,186.455142,279.682713,86.0391,1,0
0,0,10,10,16,16,32,46,36,82,0.000333,0.136667,16,6560,364.444444,410,128,2,0
0,0,15,15,12,21,33,61,56,117,0.000333,0.196731,12,7082.329344,393.462741,590.194112,135.258216,1,0
0,0,17,17,16,23,39,69,61,130,0.000333,0.229034,16,10993.63662,610.75759,687.102288,168.041925,2,0
0,0,7,7,12,15,27,31,27,58,0.000333,0.091928,6,1654.700851,91.927825,275.783475,101.622909,2,0
0,0,4,4,8,9,17,14,14,28,0.000333,0.03815,4,457.795838,25.433102,114.44896,52.529325,1,0
0,0,17,17,13,20,33,67,59,126,0.000333,0.211865,12,7627.123908,423.729106,635.593659,134.544278,2,0
0,0,20,20,17,23,40,80,67,147,0.000333,0.260774,16,12517.17488,695.398604,782.32343,173.528793,3,0
0,0,7,7,12,16,28,31,28,59,0.000333,0.094545,6,1701.803642,94.544647,283.63394,107.01955,2,0
0,0,12,12,16,19,35,56,42,98,0.000333,0.167557,16,8042.715771,446.817543,502.669736,144.710623,3,0
0,0,14,14,14,19,33,52,46,98,0.000333,0.164784,14,6920.908732,384.49493,494.350624,134.013592,2,0
0,0,13,13,14,19,33,50,44,94,0.000333,0.158058,14,6638.422661,368.801259,474.173047,134.013592,2,0
0,0,4,4,9,8,17,15,13,28,0.000333,0.03815,4,457.795838,25.433102,114.44896,52.529325,1,0
0,0,14,14,11,16,27,59,51,110,0.000333,0.174346,15,7845.564379,435.864688,523.037625,102.053748,1,0
0,0,16,16,15,18,33,67,56,123,0.000333,0.20682,21,13029.67001,723.870556,620.460477,133.662009,2,0
0,0,10,10,11,16,27,33,29,62,0.000333,0.098268,5,1474.015126,81.889729,294.803025,102.053748,3,0
0,0,3,3,8,7,15,11,9,20,0.000333,0.026046,4,312.551248,17.363958,78.137812,43.651484,1,0
0,0,3,3,8,8,16,11,10,21,0.000333,0.028,4,336,18.666667,84,48,1,0
0,0,9,9,10,12,22,30,28,58,0.000333,0.086216,10,2586.470339,143.692797,258.647034,76.238831,1,0
0,0,8,8,10,12,22,26,25,51,0.000333,0.07581,10,2274.310126,126.350563,227.431013,76.238831,1,0
0,0,3,3,8,8,16,11,10,21,0.000333,0.028,4,336,18.666667,84,48,1,0
0,0,12,12,15,18,33,55,43,98,0.000333,0.164784,14,6920.908732,384.49493,494.350624,133.662009,3,0
0,0,14,14,16,19,35,68,51,119,0.000333,0.203462,16,9766.154864,542.564159,610.384679,144.710623,5,0
0,0,11,11,14,20,34,45,38,83,0.000333,0.140753,7,2955.815911,164.211995,422.259416,139.741531,3,0
0,0,8,8,11,14,25,24,25,49,0.000333,0.07585,5,1137.744766,63.208043,227.548953,91.356717,1,0
0,0,11,11,16,21,37,48,40,88,0.000333,0.152811,8,3667.455169,203.747509,458.431896,156.238666,3,0
0,0,3,3,6,8,14,7,9,16,0.000333,0.020306,3,182.753036,10.152946,60.917679,39.509775,1,0
0,0,3,3,7,7,14,8,8,16,0.000333,0.020306,3,182.753036,10.152946,60.917679,39.302969,1,0
0,0,7,7,10,11,21,23,20,43,0.000333,0.062957,5,944.348246,52.463791,188.869649,71.273029,1,0
0,0,6,6,10,11,21,19,17,36,0.000333,0.052708,5,790.617136,43.923174,158.123427,71.273029,1,0
0,0,3,3,7,7,14,8,8,16,0.000333,0.020306,3,182.753036,10.152946,60.917679,39.302969,1,0
0,0,13,13,15,20,35,58,42,100,0.000333,0.170976,14,7180.996224,398.944235,512.928302,145.041921,4,0
0,0,9,9,14,17,31,43,32,75,0.000333,0.123855,7,2600.953063,144.497392,371.564723,122.789837,3,0
0,0,12,12,17,19,36,55,42,97,0.000333,0.167161,16,8023.723602,445.762422,501.482725,150.197491,3,0
0,0,10,10,14,17,31,46,35,81,0.000333,0.133763,14,5618.058616,312.114368,401.289901,122.789837,2,0
0,0,29,29,20,53,73,136,103,239,0.000333,0.493123,10,14793.6807,821.87115,1479.36807,390.018346,11,0
0,0,28,28,20,53,73,135,101,236,0.000333,0.486933,10,14607.98596,811.554775,1460.798596,390.018346,11,0
0,0,12,12,11,14,25,43,38,81,0.000333,0.125384,10,3761.523514,208.973529,376.152351,91.356717,2,0
0,0,13,13,13,14,27,54,39,93,0.000333,0.147402,12,5306.454452,294.803025,442.204538,101.408685,2,0
0,0,16,16,15,17,32,67,47,114,0.000333,0.19,14,7980,443.333333,570,128.090227,3,0
0,0,13,13,15,17,32,53,37,90,0.000333,0.15,14,6300,350,450,128.090227,3,0
0,0,13,13,12,14,26,53,39,92,0.000333,0.144147,12,5189.285449,288.293636,432.440454,96.322519,2,0
0,0,16,16,15,17,32,66,47,113,0.000333,0.188333,14,7910,439.444444,565,128.090227,3,0
0,0,13,13,15,17,32,52,37,89,0.000333,0.148333,14,6230,346.111111,445,128.090227,3,0
0,0,7,7,10,14,24,27,31,58,0.000333,0.088643,10,2659.27825,147.737681,265.927825,86.52225,1,0
0,0,9,9,15,18,33,35,36,71,0.000333,0.119384,14,5014.127755,278.562653,358.151982,133.662009,2,0
0,0,16,16,12,16,28,65,57,122,0.000333,0.195499,18,10556.95141,586.4973,586.4973,107.01955,1,0
0,0,18,18,16,18,34,73,62,135,0.000333,0.228936,24,16483.37961,915.743311,686.807484,139.05865,2,0
0,0,8,8,11,14,25,31,25,56,0.000333,0.086685,5,1300.279733,72.237763,260.055947,91.356717,2,0
0,0,10,10,15,17,32,40,31,71,0.000333,0.118333,7,2485,138.055556,355,128.090227,3,0
0,0,7,7,11,14,25,28,25,53,0.000333,0.082041,5,1230.62189,68.367883,246.124378,91.356717,2,0
0,0,15,15,14,17,31,70,50,120,0.000333,0.198168,14,8323.049801,462.391656,594.503557,122.789837,2,0
0,0,18,18,18,20,38,83,58,141,0.000333,0.246653,18,13319.24003,739.957779,739.957779,161.497212,3,0
0,0,10,10,13,17,30,41,35,76,0.000333,0.124308,12,4475.084223,248.61579,372.923685,117.592585,2,0
0,0,13,13,17,20,37,54,43,97,0.000333,0.168439,16,8085.071623,449.170646,505.316976,155.92543,3,0
0,0,10,10,14,14,28,42,30,72,0.000333,0.115377,14,4845.813761,269.211876,346.129554,106.605938,2,0
0,0,10,10,10,17,27,41,34,75,0.000333,0.118872,10,3566.165627,198.120313,356.616563,102.706149,1,0
0,0,10,10,11,18,29,41,33,74,0.000333,0.11983,5,1797.452968,99.858498,359.490594,113.112398,1,0
0,0,21,21,15,23,38,95,72,167,0.000333,0.292135,21,18404.48179,1022.471211,876.403895,162.645284,2,0
0,0,10,10,14,17,31,49,35,84,0.000333,0.138717,14,5826.134861,323.674159,416.15249,122.789837,2,0
0,0,18,18,15,23,38,81,62,143,0.000333,0.250151,14,10506.35088,583.68616,750.453634,162.645284,2,0
0,0,20,20,16,23,39,77,70,147,0.000333,0.258985,24,18646.89903,1035.938835,776.954126,168.041925,2,0
0,0,9,9,13,18,31,36,32,68,0.000333,0.112295,6,2021.312095,112.295116,336.885349,123.164366,2,0
0,0,14,14,10,12,22,53,44,97,0.000333,0.144188,15,6488.473005,360.470723,432.564867,76.238831,1,0
0,0,9,9,14,18,32,37,36,73,0.000333,0.121667,14,5110,283.888889,365,128.361619,2,0
0,0,10,10,13,19,32,35,39,74,0.000333,0.123333,12,4440,246.666667,370,128.816339,2,0
0,0,14,14,14,16,30,46,45,91,0.000333,0.148842,14,6251.378619,347.298812,446.527044,117.302969,2,0
0,0,11,11,14,16,30,35,33,68,0.000333,0.111223,14,4671.359847,259.519992,333.668561,117.302969,2,0
0,0,8,8,10,12,22,23,21,44,0.000333,0.065405,5,981.074956,54.504164,196.214991,76.238831,1,0
0,0,17,17,17,22,39,81,52,133,0.000333,0.234319,16,11247.33592,624.851996,702.958495,167.594364,5,0
0,0,9,9,14,17,31,38,35,73,0.000333,0.120552,14,5063.188629,281.288257,361.656331,122.789837,2,0
0,0,19,19,16,23,39,83,71,154,0.000333,0.271317,24,19534.8466,1085.269256,813.951942,168.041925,2,0
0,0,19,19,15,22,37,74,76,150,0.000333,0.260473,21,16409.7781,911.654339,781.418005,156.710855,2,0
0,0,17,17,15,21,36,68,64,132,0.000333,0.227477,21,14331.0321,796.16845,682.4301,150.842025,2,0
0,0,17,17,16,20,36,81,55,136,0.000333,0.23437,16,11249.7568,624.986489,703.1098,150.438562,5,0
0,0,17,17,16,20,36,81,55,136,0.000333,0.23437,16,11249.7568,624.986489,703.1098,150.438562,5,0
0,0,8,8,9,10,19,23,22,45,0.000333,0.063719,8,1529.253905,84.95855,191.156738,61.748606,1,0
0,0,15,15,14,20,34,56,71,127,0.000333,0.215369,21,13568.2634,753.792411,646.107781,139.741531,2,0
0,0,13,13,12,20,32,58,52,110,0.000333,0.183333,12,6600,366.666667,550,129.458112,1,0
0,0,15,15,16,23,39,66,57,123,0.000333,0.216701,16,10401.67157,577.870643,650.104473,168.041925,2,0
0,0,9,9,15,12,27,33,24,57,0.000333,0.090343,14,3794.400227,210.800013,271.028588,101.622909,5,0
0,0,9,9,14,12,26,32,24,56,0.000333,0.087742,14,3685.144739,204.730263,263.224624,96.322519,5,0
0,0,17,17,12,23,35,70,66,136,0.000333,0.232527,12,8370.989884,465.054994,697.58249,147.061475,1,0
0,0,19,19,16,26,42,78,71,149,0.000333,0.267818,16,12855.28474,714.182485,803.455296,186.211433,2,0
0,0,9,9,14,12,26,32,22,54,0.000333,0.084608,7,1776.766213,98.709234,253.823745,96.322519,5,0
0,0,9,9,14,11,25,32,22,54,0.000333,0.083589,14,3510.755279,195.04196,250.768234,91.356717,5,0
0,0,17,17,15,18,33,75,52,127,0.000333,0.213546,14,8968.932744,498.274041,640.638053,133.662009,3,0
0,0,10,10,14,14,28,42,31,73,0.000333,0.116979,14,4913.11673,272.950929,350.936909,106.605938,2,0
0,0,17,17,15,18,33,74,52,126,0.000333,0.211865,14,8898.311227,494.350624,635.593659,133.662009,3,0
0,0,10,10,14,14,28,42,31,73,0.000333,0.116979,14,4913.11673,272.950929,350.936909,106.605938,2,0
0,0,17,17,15,17,32,74,51,125,0.000333,0.208333,21,13125,729.166667,625,128.090227,3,0
0,0,17,17,15,17,32,74,51,125,0.000333,0.208333,21,13125,729.166667,625,128.090227,3,0
0,0,17,17,15,17,32,74,51,125,0.000333,0.208333,21,13125,729.166667,625,128.090227,3,0
0,0,10,10,14,14,28,42,31,73,0.000333,0.116979,14,4913.11673,272.950929,350.936909,106.605938,2,0
0,0,17,17,15,17,32,74,51,125,0.000333,0.208333,21,13125,729.166667,625,128.090227,3,0
0,0,10,10,14,14,28,42,31,73,0.000333,0.116979,14,4913.11673,272.950929,350.936909,106.605938,2,0
0,0,17,17,15,17,32,75,52,127,0.000333,0.211667,21,13335,740.833333,635,128.090227,3,0
0,0,17,17,15,17,32,74,52,126,0.000333,0.21,21,13230,735,630,128.090227,3,0
0,0,16,16,16,18,34,64,54,118,0.000333,0.200107,24,14407.69477,800.427487,600.320615,139.05865,2,0
0,0,19,19,14,23,37,84,67,151,0.000333,0.262209,14,11012.78442,611.821356,786.627458,157.344894,6,0
0,0,10,10,9,15,24,29,39,68,0.000333,0.103926,8,2494.2196,138.567756,311.77745,87.132684,2,0
0,0,19,19,16,25,41,87,70,157,0.000333,0.280379,16,13458.17064,747.676146,841.135665,180.096405,6,0
0,0,11,11,15,21,36,44,33,77,0.000333,0.132695,7,2786.589576,154.810532,398.084225,150.842025,5,0
0,0,12,12,15,21,36,45,35,80,0.000333,0.137865,7,2895.158001,160.842111,413.594,150.842025,5,0
0,0,11,11,15,21,36,44,33,77,0.000333,0.132695,7,2786.589576,154.810532,398.084225,150.842025,5,0
0,0,12,12,15,21,36,45,35,80,0.000333,0.137865,7,2895.158001,160.842111,413.594,150.842025,5,0
0,0,18,18,16,18,34,68,60,128,0.000333,0.217065,24,15628.68585,868.260325,651.195244,139.05865,2,0
0,0,9,9,10,11,21,28,25,53,0.000333,0.077598,10,2327.928234,129.329346,232.792823,71.273029,2,0
0,0,10,10,13,16,29,38,34,72,0.000333,0.116592,12,4197.29558,233.183088,349.774632,112.105716,2,0
0,0,7,7,12,15,27,27,24,51,0.000333,0.080833,6,1454.995576,80.833088,242.499263,101.622909,2,0
0,0,6,6,9,10,19,17,15,32,0.000333,0.045311,4,543.734722,30.207485,135.93368,61.748606,2,0
0,0,8,8,9,11,20,23,21,44,0.000333,0.063388,4,760.659345,42.258852,190.164836,66.583073,2,0
0,0,9,9,12,16,28,33,30,63,0.000333,0.100954,6,1817.180161,100.954453,302.86336,107.01955,2,0
0,0,7,7,9,11,20,20,17,37,0.000333,0.053304,4,639.645358,35.535853,159.91134,66.583073,2,0
0,0,8,8,12,16,28,30,26,56,0.000333,0.089737,6,1615.271254,89.737292,269.211876,107.01955,2,0
0,0,23,23,16,20,36,111,70,181,0.000333,0.311919,24,22458.15421,1247.675234,935.756425,150.438562,3,0
0,0,10,10,15,14,29,45,31,76,0.000333,0.123069,14,5168.891779,287.160654,369.206556,111.906328,2,0
0,0,15,15,15,19,34,59,50,109,0.000333,0.184844,14,7763.468296,431.303794,554.53345,139.313982,3,0
0,0,15,15,15,19,34,58,50,108,0.000333,0.183149,14,7692.243816,427.346879,549.445987,139.313982,3,0
0,0,15,15,16,18,34,58,49,107,0.000333,0.181453,16,8709.736384,483.874244,544.358524,139.05865,3,0
0,0,15,15,16,18,34,58,49,107,0.000333,0.181453,16,8709.736384,483.874244,544.358524,139.05865,3,0
0,0,16,16,18,20,38,64,55,119,0.000333,0.208168,18,11241.06073,624.503374,624.503374,161.497212,3,0
0,0,14,14,15,17,32,55,48,103,0.000333,0.171667,14,7210,400.555556,515,128.090227,2,0
0,0,17,17,17,26,43,69,64,133,0.000333,0.240564,16,11547.0914,641.505078,721.693212,191.698301,2,0
0,0,16,16,16,24,40,62,57,119,0.000333,0.211103,16,10132.95109,562.941727,633.309443,174.0391,2,0
0,0,12,12,13,22,35,47,50,97,0.000333,0.165847,12,5970.485432,331.693635,497.540453,146.213212,1,0
0,0,14,14,12,21,33,50,51,101,0.000333,0.169828,12,6113.805673,339.655871,509.483806,135.258216,1,0
0,0,17,17,16,24,40,63,59,122,0.000333,0.216425,16,10388.40364,577.133536,649.275228,174.0391,2,0
0,0,5,5,12,12,24,22,17,39,0.000333,0.059605,6,1072.881225,59.604513,178.813538,86.0391,1,0
0,0,8,8,15,15,30,35,25,60,0.000333,0.098138,7,2060.89405,114.494114,294.413436,117.206718,2,0
0,0,30,30,22,51,73,133,100,233,0.000333,0.480743,11,15864.52034,881.362241,1442.229122,387.401188,11,0
0,0,29,29,22,51,73,132,98,230,0.000333,0.474553,11,15660.25613,870.01423,1423.659649,387.401188,11,0
0,0,20,20,16,27,43,75,85,160,0.000333,0.289401,24,20836.85666,1157.603148,868.202361,192.381963,2,0
0,0,19,19,15,25,40,68,82,150,0.000333,0.266096,21,16764.0735,931.337417,798.289214,174.699764,2,0
0,0,15,15,12,23,35,53,75,128,0.000333,0.218849,18,11817.86807,656.548226,656.548226,147.061475,1,0
0,0,11,11,11,19,30,40,58,98,0.000333,0.160292,15,7213.129176,400.729399,480.875278,118.764371,1,0
0,0,14,14,15,22,37,53,66,119,0.000333,0.206642,21,13018.42396,723.245776,619.924951,156.710855,2,0
0,0,29,29,22,48,70,130,94,224,0.000333,0.457653,11,15102.55335,839.030742,1372.959396,366.185696,12,0
0,0,28,28,22,48,70,129,92,221,0.000333,0.451524,11,14900.28701,827.793723,1354.571547,366.185696,12,0
0,0,17,17,15,18,33,78,52,130,0.000333,0.21859,14,9180.797297,510.044294,655.771236,133.662009,3,0
0,0,17,17,15,18,33,77,52,129,0.000333,0.216909,14,9110.17578,506.120877,650.726841,133.662009,3,0
0,0,9,9,14,17,31,38,35,73,0.000333,0.120552,14,5063.188629,281.288257,361.656331,122.789837,2,0
0,0,11,11,10,22,32,45,56,101,0.000333,0.168333,10,5050,280.555556,505,131.326777,1,0
0,0,11,11,11,24,35,46,56,102,0.000333,0.174396,10,5231.868677,290.659371,523.186868,148.092848,1,0
0,0,12,12,13,25,38,50,58,108,0.000333,0.188925,12,6801.314057,377.850781,566.776171,164.202121,2,0
0,0,14,14,11,27,38,52,66,118,0.000333,0.206418,10,6192.554466,344.030804,619.255447,166.43571,1,0
0,0,15,15,13,27,40,56,68,124,0.000333,0.219973,12,7919.029005,439.946056,659.919084,176.487679,2,0
0,0,6,6,8,12,20,12,20,32,0.000333,0.046101,4,553.206796,30.733711,138.301699,67.01955,1,0
0,0,6,6,9,14,23,13,19,32,0.000333,0.048251,4,579.01593,32.167552,144.753983,81.832294,1,0
0,0,6,6,9,14,23,13,19,32,0.000333,0.048251,4,579.01593,32.167552,144.753983,81.832294,1,0
0,0,6,6,9,20,29,31,37,68,0.000333,0.110114,4,1321.370831,73.409491,330.342708,114.967887,1,0
0,0,7,7,11,20,31,35,39,74,0.000333,0.122204,5,1833.052635,101.836257,366.610527,124.49231,2,0
0,0,22,22,19,44,63,100,75,175,0.000333,0.348675,9,9414.21588,523.011993,1046.023987,320.925614,9,0
0,0,21,21,19,44,63,99,73,172,0.000333,0.342697,9,9252.829322,514.046073,1028.092147,320.925614,9,0
0,0,9,9,11,13,24,37,28,65,0.000333,0.099341,10,2980.225625,165.56809,298.022563,86.159464,2,0
0,0,12,12,15,16,31,50,36,86,0.000333,0.14202,14,5964.852358,331.380687,426.060883,122.603359,3,0
0,0,10,10,14,16,30,42,31,73,0.000333,0.119401,7,2507.421094,139.301172,358.203013,117.302969,2,0
0,0,25,25,19,47,66,113,93,206,0.000333,0.415048,9,11206.3067,622.572594,1245.145189,341.776299,9,0
0,0,25,25,20,48,68,114,99,213,0.000333,0.43221,20,25932.5917,1440.699539,1296.629585,354.516762,9,0
0,0,27,27,20,52,72,130,95,225,0.000333,0.462744,10,13882.33125,771.240625,1388.233125,382.861427,11,0
0,0,26,26,20,52,72,129,93,222,0.000333,0.456574,10,13697.2335,760.957417,1369.72335,382.861427,11,0
0,0,7,7,6,11,17,19,20,39,0.000333,0.053137,3,478.233152,26.568508,159.411051,53.563523,1,0
0,0,7,7,8,12,20,17,19,36,0.000333,0.051863,4,622.357646,34.575425,155.589411,67.01955,1,0
0,0,7,7,7,13,20,20,20,40,0.000333,0.057626,3,518.631371,28.812854,172.877124,67.757201,1,0
0,0,14,14,13,18,31,42,45,87,0.000333,0.143672,12,5172.180948,287.343386,431.015079,123.164366,2,0
0,0,15,15,14,20,34,52,49,101,0.000333,0.171278,14,7193.672458,399.64847,513.833747,139.741531,3,0
0,0,17,17,14,21,35,77,56,133,0.000333,0.227398,14,9550.724978,530.595832,682.194641,145.541635,5,0
0,0,17,17,16,23,39,80,59,139,0.000333,0.24489,16,11754.73454,653.040807,734.670908,168.041925,5,0
0,0,17,17,16,23,39,80,59,139,0.000333,0.24489,16,11754.73454,653.040807,734.670908,168.041925,5,0
0,0,8,8,9,13,22,22,26,48,0.000333,0.071351,8,1712.421742,95.134541,214.052718,76.635041,1,0
0,0,17,17,16,20,36,81,55,136,0.000333,0.23437,16,11249.7568,624.986489,703.1098,150.438562,5,0
0,0,17,17,16,20,36,81,55,136,0.000333,0.23437,16,11249.7568,624.986489,703.1098,150.438562,5,0
0,0,8,8,9,10,19,23,22,45,0.000333,0.063719,8,1529.253905,84.95855,191.156738,61.748606,1,0
0,0,17,17,15,19,34,55,51,106,0.000333,0.179757,14,7549.794856,419.433048,539.271061,139.313982,3,0
0,0,14,14,15,19,34,44,39,83,0.000333,0.140753,14,5911.631822,328.42399,422.259416,139.313982,3,0
0,0,17,17,15,18,33,55,51,106,0.000333,0.178235,14,7485.880873,415.882271,534.705777,133.662009,3,0
0,0,14,14,15,18,33,44,39,83,0.000333,0.139562,14,5861.585967,325.643665,418.684712,133.662009,3,0
0,0,16,16,13,21,34,57,47,104,0.000333,0.176365,12,6349.153626,352.730757,529.096135,140.344382,4,0
0,0,16,16,13,20,33,57,47,104,0.000333,0.174872,12,6295.403861,349.744659,524.616988,134.544278,4,0
0,0,15,15,12,21,33,53,45,98,0.000333,0.164784,12,5932.207484,329.567082,494.350624,135.258216,3,0
0,0,15,15,12,20,32,53,45,98,0.000333,0.163333,12,5880,326.666667,490,129.458112,3,0
0,0,8,8,14,11,25,30,26,56,0.000333,0.086685,14,3640.783253,202.265736,260.055947,91.356717,3,0
0,0,8,8,10,17,27,32,35,67,0.000333,0.106192,10,3185.774626,176.987479,318.577463,102.706149,1,0
0,0,10,10,14,20,34,40,40,80,0.000333,0.135666,14,5697.958382,316.553243,406.997027,139.741531,2,0
0,0,9,9,10,16,26,34,32,66,0.000333,0.10341,10,3102.290214,172.349456,310.229021,97.219281,1,0
0,0,9,9,11,18,29,35,32,67,0.000333,0.108495,5,1627.423633,90.412424,325.484727,113.112398,1,0
0,0,17,17,11,22,33,74,67,141,0.000333,0.237087,15,10668.89356,592.716309,711.259571,136.161243,1,0
0,0,19,19,15,24,39,82,72,154,0.000333,0.271317,21,17092.99078,949.610599,813.951942,168.642459,2,0
0,0,17,17,15,25,40,74,62,136,0.000333,0.241261,14,10132.95109,562.941727,723.782221,174.699764,2,0
0,0,7,7,10,15,25,32,31,63,0.000333,0.097521,10,2925.6294,162.534967,292.56294,91.82264,1,0
0,0,9,9,14,18,32,40,36,76,0.000333,0.126667,14,5320,295.555556,380,128.361619,2,0
0,0,7,7,10,15,25,24,25,49,0.000333,0.07585,5,1137.744766,63.208043,227.548953,91.82264,1,0
0,0,9,9,15,11,26,31,22,53,0.000333,0.083041,14,3487.726271,193.762571,249.123305,96.657107,4,0
0,0,9,9,15,11,26,31,22,53,0.000333,0.083041,14,3487.726271,193.762571,249.123305,96.657107,4,0
0,0,13,13,15,16,31,49,32,81,0.000333,0.133763,14,5618.058616,312.114368,401.289901,122.603359,5,0
0,0,8,8,12,16,28,30,23,53,0.000333,0.08493,6,1528.738865,84.929937,254.789811,107.01955,2,0
0,0,9,9,16,13,29,36,23,59,0.000333,0.09554,8,2292.96703,127.387057,286.620879,112.105716,4,0
0,0,9,9,16,13,29,36,23,59,0.000333,0.09554,8,2292.96703,127.387057,286.620879,112.105716,4,0
0,0,10,10,13,21,34,36,35,71,0.000333,0.120403,6,2167.25917,120.403287,361.209862,140.344382,2,0
0,0,11,11,13,21,34,37,37,74,0.000333,0.125491,6,2258.833502,125.49075,376.47225,140.344382,2,0
0,0,11,11,15,23,38,41,39,80,0.000333,0.139945,7,2938.839408,163.268856,419.834201,162.645284,3,0
0,0,12,12,15,23,38,42,41,83,0.000333,0.145193,7,3049.045885,169.391438,435.577984,162.645284,3,0
0,0,15,15,12,20,32,60,56,116,0.000333,0.193333,12,6960,386.666667,580,129.458112,1,0
0,0,17,17,16,23,39,68,61,129,0.000333,0.227272,16,10909.07018,606.059454,681.816886,168.041925,2,0
0,0,13,13,13,16,29,56,47,103,0.000333,0.166791,12,6004.46451,333.581362,500.372042,112.105716,2,0
0,0,15,15,15,19,34,64,52,116,0.000333,0.196715,14,8262.039654,459.002203,590.14569,139.313982,3,0
0,0,13,13,12,16,28,55,47,102,0.000333,0.16345,12,5884.202425,326.900135,490.350202,107.01955,2,0
0,0,15,15,15,19,34,63,52,115,0.000333,0.195019,14,8190.815174,455.045287,585.058227,139.313982,3,0
0,0,12,12,16,17,33,58,40,98,0.000333,0.164784,16,7909.609979,439.422777,494.350624,133.486868,5,0
0,0,12,12,16,17,33,58,40,98,0.000333,0.164784,16,7909.609979,439.422777,494.350624,133.486868,5,0
0,0,6,6,9,9,18,16,14,30,0.000333,0.041699,4,500.391,27.7995,125.09775,57.05865,1,0
0,0,6,6,9,9,18,16,14,30,0.000333,0.041699,4,500.391,27.7995,125.09775,57.05865,1,0
0,0,9,9,12,17,29,36,32,68,0.000333,0.110114,6,1982.056246,110.114236,330.342708,112.506418,3,0
0,0,6,6,9,12,21,15,17,32,0.000333,0.046851,4,562.21663,31.234257,140.554158,71.548875,1,0
0,0,9,9,13,19,32,37,32,69,0.000333,0.115,6,2070,115,345,128.816339,3,0
0,0,7,7,9,12,21,21,23,44,0.000333,0.064421,4,773.047866,42.947104,193.261967,71.548875,1,0
0,0,6,6,8,12,20,19,21,40,0.000333,0.057626,4,691.508495,38.417139,172.877124,67.01955,1,0
0,0,7,7,10,13,23,21,22,43,0.000333,0.064838,5,972.565821,54.031434,194.513164,81.324997,1,0
0,0,6,6,9,13,22,19,20,39,0.000333,0.057973,4,695.671333,38.648407,173.917833,76.635041,1,0
0,0,10,10,12,17,29,40,37,77,0.000333,0.124688,12,4488.774439,249.376358,374.064537,112.506418,2,0
0,0,13,13,16,20,36,53,45,98,0.000333,0.168884,16,8106.442402,450.357911,506.65265,150.438562,3,0
0,0,10,10,13,16,29,41,32,73,0.000333,0.118211,12,4255.591352,236.421742,354.632613,112.105716,2,0
0,0,16,16,14,20,34,67,53,120,0.000333,0.203499,14,8546.937573,474.829865,610.495541,139.741531,2,0
0,0,15,15,14,20,34,65,51,116,0.000333,0.196715,14,8262.039654,459.002203,590.14569,139.741531,2,0
0,0,16,16,15,21,36,67,53,120,0.000333,0.206797,14,8685.474002,482.526333,620.391,150.842025,2,0
0,0,15,15,15,21,36,65,51,116,0.000333,0.199904,14,8395.958202,466.442122,599.7113,150.842025,2,0
0,0,18,18,14,20,34,77,62,139,0.000333,0.235719,21,14850.30403,825.016891,707.157335,139.741531,2,0
0,0,21,21,18,23,41,90,70,160,0.000333,0.285736,27,23144.62466,1285.812481,857.208321,179.100575,3,0
0,0,10,10,13,17,30,44,34,78,0.000333,0.127579,12,4592.849597,255.158311,382.737466,117.592585,2,0
0,0,4,4,7,10,17,10,11,21,0.000333,0.028612,3,257.510159,14.30612,85.83672,52.870765,2,0
0,0,4,4,9,9,18,12,10,22,0.000333,0.030579,4,366.9534,20.3863,91.73835,57.05865,2,0
0,0,27,27,21,49,70,144,97,241,0.000333,0.492386,10,14771.57207,820.642893,1477.157207,367.359448,11,0
0,0,4,4,8,9,17,11,10,21,0.000333,0.028612,4,343.346879,19.074827,85.83672,52.529325,2,0
0,0,27,27,21,49,70,143,97,240,0.000333,0.490343,10,14710.27924,817.237736,1471.027924,367.359448,11,0
0,0,4,4,8,9,17,11,10,21,0.000333,0.028612,4,343.346879,19.074827,85.83672,52.529325,2,0
0,0,9,9,12,13,25,30,24,54,0.000333,0.083589,6,1504.609405,83.589411,250.768234,91.125266,3,0
0,0,4,4,8,9,17,11,10,21,0.000333,0.028612,4,343.346879,19.074827,85.83672,52.529325,2,0
0,0,9,9,11,13,24,29,24,53,0.000333,0.081001,5,1215.015063,67.500837,243.003013,86.159464,3,0
0,0,13,13,11,14,25,44,34,78,0.000333,0.12074,10,3622.207828,201.233768,362.220783,91.356717,3,0
0,0,16,16,15,17,32,57,42,99,0.000333,0.165,14,6930,385,495,128.090227,4,0
0,0,13,13,11,14,25,44,34,78,0.000333,0.12074,10,3622.207828,201.233768,362.220783,91.356717,3,0
0,0,16,16,15,17,32,57,42,99,0.000333,0.165,14,6930,385,495,128.090227,4,0
0,0,8,8,11,13,24,35,22,57,0.000333,0.087114,5,1306.714313,72.59524,261.342863,86.159464,2,0
0,0,11,11,14,16,30,48,30,78,0.000333,0.127579,7,2679.162265,148.842348,382.737466,117.302969,3,0
0,0,8,8,11,13,24,35,22,57,0.000333,0.087114,5,1306.714313,72.59524,261.342863,86.159464,2,0
0,0,11,11,14,16,30,48,30,78,0.000333,0.127579,7,2679.162265,148.842348,382.737466,117.302969,3,0
0,0,6,6,8,11,19,14,13,27,0.000333,0.038231,4,458.776171,25.487565,114.694043,62.053748,2,0
0,0,6,6,9,10,19,15,12,27,0.000333,0.038231,4,458.776171,25.487565,114.694043,61.748606,2,0
0,0,31,31,22,49,71,151,101,252,0.000333,0.516579,22,34094.19803,1894.122113,1549.736274,373.228278,11,0
0,0,15,15,16,20,36,77,48,125,0.000333,0.215414,16,10339.85,574.436111,646.240625,150.438562,5,0
0,0,6,6,9,10,19,15,12,27,0.000333,0.038231,4,458.776171,25.487565,114.694043,61.748606,2,0
0,0,31,31,22,48,70,151,101,252,0.000333,0.51486,22,33980.74505,1887.819169,1544.57932,366.185696,11,0
0,0,15,15,16,20,36,77,48,125,0.000333,0.215414,16,10339.85,574.436111,646.240625,150.438562,5,0
0,0,6,6,9,10,19,15,12,27,0.000333,0.038231,4,458.776171,25.487565,114.694043,61.748606,2,0
0,0,13,13,12,15,27,37,28,65,0.000333,0.103023,6,1854.406126,103.022563,309.067688,101.622909,3,0
0,0,6,6,10,11,21,19,17,36,0.000333,0.052708,5,790.617136,43.923174,158.123427,71.273029,1,0
0,0,6,6,9,10,19,15,12,27,0.000333,0.038231,4,458.776171,25.487565,114.694043,61.748606,2,0
0,0,13,13,12,13,25,37,28,65,0.000333,0.100617,12,3622.207828,201.233768,301.850652,91.125266,3,0
0,0,6,6,10,11,21,19,17,36,0.000333,0.052708,5,790.617136,43.923174,158.123427,71.273029,1,0
0,0,8,8,11,13,24,35,22,57,0.000333,0.087114,5,1306.714313,72.59524,261.342863,86.159464,2,0
0,0,11,11,15,16,31,48,30,78,0.000333,0.128809,7,2704.991185,150.277288,386.427312,122.603359,3,0
0,0,8,8,11,13,24,35,22,57,0.000333,0.087114,5,1306.714313,72.59524,261.342863,86.159464,2,0
0,0,11,11,15,16,31,48,30,78,0.000333,0.128809,7,2704.991185,150.277288,386.427312,122.603359,3,0
0,0,10,10,12,15,27,40,25,65,0.000333,0.103023,6,1854.406126,103.022563,309.067688,101.622909,2,0
0,0,13,13,15,18,33,53,33,86,0.000333,0.144606,7,3036.72526,168.706959,433.817894,133.662009,3,0
0,0,10,10,12,15,27,40,25,65,0.000333,0.103023,6,1854.406126,103.022563,309.067688,101.622909,2,0
0,0,13,13,15,18,33,53,33,86,0.000333,0.144606,7,3036.72526,168.706959,433.817894,133.662009,3,0
0,0,7,7,6,15,21,18,28,46,0.000333,0.067349,3,606.139804,33.674434,202.046601,74.113134,1,0
0,0,7,7,8,16,24,16,25,41,0.000333,0.062661,4,751.93385,41.774103,187.983463,88,1,0
0,0,7,7,7,17,24,19,27,46,0.000333,0.070303,3,632.724825,35.151379,210.908275,89.138353,1,0
0,0,14,14,13,20,33,41,55,96,0.000333,0.161421,12,5811.142026,322.841224,484.261835,134.544278,2,0
0,0,15,15,14,22,36,51,60,111,0.000333,0.191287,14,8034.063452,446.336858,573.861675,151.410465,3,0
0,0,16,16,15,16,31,74,50,124,0.000333,0.204773,21,12900.72719,716.707066,614.320342,122.603359,2,0
0,0,10,10,15,14,29,45,31,76,0.000333,0.123069,14,5168.891779,287.160654,369.206556,111.906328,2,0
0,0,16,16,14,20,34,67,61,128,0.000333,0.217065,21,13675.10012,759.727784,651.195244,139.741531,5,0
0,0,10,10,9,14,23,28,38,66,0.000333,0.099518,8,2388.440713,132.691151,298.555089,81.832294,1,0
0,0,16,16,16,22,38,70,64,134,0.000333,0.234407,16,11251.55659,625.086477,703.222287,162.107496,5,0
0,0,17,17,13,20,33,67,68,135,0.000333,0.226998,18,12257.87771,680.993206,680.993206,134.544278,2,0
0,0,19,19,16,22,38,75,73,148,0.000333,0.258898,24,18640.63853,1035.591029,776.693272,162.107496,3,0
0,0,17,17,13,20,33,67,68,135,0.000333,0.226998,18,12257.87771,680.993206,680.993206,134.544278,2,0
0,0,19,19,16,22,38,75,73,148,0.000333,0.258898,24,18640.63853,1035.591029,776.693272,162.107496,3,0
0,0,15,15,11,16,27,60,53,113,0.000333,0.179101,15,8059.534316,447.751906,537.302288,102.053748,1,0
0,0,17,17,15,18,33,68,58,126,0.000333,0.211865,21,13347.46684,741.525936,635.593659,133.662009,2,0
0,0,20,20,18,21,39,66,81,147,0.000333,0.258985,27,20977.76141,1165.431189,776.954126,167.297316,2,0
0,0,9,9,15,17,32,32,34,66,0.000333,0.11,14,4620,256.666667,330,128.090227,2,0
0,0,6,6,6,14,20,12,24,36,0.000333,0.051863,3,466.768234,25.931569,155.589411,68.812744,1,0
0,0,7,7,7,16,23,15,25,40,0.000333,0.060314,3,542.827435,30.15708,180.942478,83.651484,1,0
0,0,6,6,7,16,23,13,23,36,0.000333,0.054283,3,488.544691,27.141372,162.84823,83.651484,1,0
0,0,13,13,10,20,30,36,53,89,0.000333,0.145571,10,4367.13263,242.618479,436.713263,119.657843,1,0
0,0,13,13,12,25,37,48,58,106,0.000333,0.184067,12,6626.424681,368.134705,552.202057,159.115955,3,0
0,0,13,13,13,17,30,52,46,98,0.000333,0.160292,12,5770.50334,320.583519,480.875278,117.592585,2,0
0,0,16,16,15,19,34,64,55,119,0.000333,0.201803,14,8475.713094,470.87295,605.408078,139.313982,3,0
0,0,13,13,12,17,29,51,46,97,0.000333,0.157075,12,5654.689878,314.149438,471.224157,112.506418,2,0
0,0,16,16,15,19,34,63,55,118,0.000333,0.200107,14,8404.488614,466.916034,600.320615,139.313982,3,0
0,0,13,13,13,18,31,52,46,98,0.000333,0.161837,12,5826.134861,323.674159,485.511238,123.164366,2,0
0,0,16,16,15,20,35,64,55,119,0.000333,0.203462,14,8545.385506,474.743639,610.384679,145.041921,3,0
0,0,13,13,12,18,30,51,46,97,0.000333,0.158656,12,5711.620653,317.312259,475.968388,118.0782,2,0
0,0,16,16,15,20,35,63,55,118,0.000333,0.201752,14,8473.575544,470.754197,605.255396,145.041921,3,0
0,0,22,22,16,25,41,98,77,175,0.000333,0.312524,24,22501.71842,1250.095468,937.571601,180.096405,5,0
0,0,13,13,10,17,27,43,51,94,0.000333,0.148986,15,6704.391378,372.466188,446.959425,102.706149,1,0
0,0,21,21,16,26,42,95,79,174,0.000333,0.312754,24,22518.31756,1251.017642,938.263232,186.211433,5,0
0,0,26,26,16,27,43,110,97,207,0.000333,0.374412,24,26957.6833,1497.649072,1123.236804,192.381963,5,0
0,0,17,17,10,19,29,55,75,130,0.000333,0.210513,15,9473.06294,526.281274,631.537529,113.929904,1,0
0,0,25,25,16,28,44,107,103,210,0.000333,0.38216,24,27515.53536,1528.640853,1146.48064,198.605938,5,0
0,0,22,22,17,27,44,98,76,174,0.000333,0.316647,16,15199.05763,844.39209,949.941102,197.868831,5,0
0,0,13,13,11,19,30,43,48,91,0.000333,0.148842,10,4465.270442,248.07058,446.527044,118.764371,1,0
0,0,21,21,17,28,45,95,76,171,0.000333,0.313036,16,15025.71007,834.761671,939.106879,204.092806,5,0
0,0,20,20,17,41,58,91,71,162,0.000333,0.316331,8,7591.94337,421.774632,948.992921,289.1465,7,0
0,0,19,19,17,41,58,90,69,159,0.000333,0.310473,8,7451.351826,413.96399,931.418978,289.1465,7,0
0,0,20,20,18,43,61,92,71,163,0.000333,0.322237,9,8700.391674,483.355093,966.710186,308.388034,7,0
0,0,19,19,18,43,61,91,69,160,0.000333,0.316306,9,8540.261766,474.458987,948.917974,308.388034,7,0
0,0,20,20,14,18,32,98,62,160,0.000333,0.266667,21,16800,933.333333,800,128.361619,2,0
0,0,23,23,16,20,36,111,70,181,0.000333,0.311919,24,22458.15421,1247.675234,935.756425,150.438562,3,0
0,0,10,10,15,14,29,45,31,76,0.000333,0.123069,14,5168.891779,287.160654,369.206556,111.906328,2,0
0,0,13,13,12,13,25,53,38,91,0.000333,0.140864,12,5071.090959,281.727276,422.590913,91.125266,2,0
0,0,16,16,15,16,31,66,46,112,0.000333,0.184957,14,7768.179815,431.565545,554.869987,122.603359,3,0
0,0,13,13,15,16,31,52,36,88,0.000333,0.145323,14,6103.569854,339.087214,435.969275,122.603359,3,0
0,0,11,11,15,15,30,47,33,80,0.000333,0.13085,14,5495.717467,305.317637,392.551248,117.206718,2,0
0,0,13,13,12,13,25,53,38,91,0.000333,0.140864,12,5071.090959,281.727276,422.590913,91.125266,2,0
0,0,16,16,15,16,31,66,46,112,0.000333,0.184957,14,7768.179815,431.565545,554.869987,122.603359,3,0
0,0,13,13,15,16,31,52,36,88,0.000333,0.145323,14,6103.569854,339.087214,435.969275,122.603359,3,0
0,0,11,11,15,15,30,47,33,80,0.000333,0.13085,14,5495.717467,305.317637,392.551248,117.206718,2,0
0,0,16,16,15,19,34,66,54,120,0.000333,0.203499,14,8546.937573,474.829865,610.495541,139.313982,3,0
0,0,16,16,15,19,34,65,54,119,0.000333,0.201803,14,8475.713094,470.87295,605.408078,139.313982,3,0
0,0,16,16,15,19,34,66,54,120,0.000333,0.203499,14,8546.937573,474.829865,610.495541,139.313982,3,0
0,0,16,16,15,19,34,65,54,119,0.000333,0.201803,14,8475.713094,470.87295,605.408078,139.313982,3,0
0,0,16,16,16,17,33,65,53,118,0.000333,0.198413,24,14285.72415,793.651341,595.238506,133.486868,3,0
0,0,16,16,16,18,34,65,53,118,0.000333,0.200107,16,9605.129844,533.618325,600.320615,139.05865,3,0
0,0,16,16,16,18,34,65,53,118,0.000333,0.200107,16,9605.129844,533.618325,600.320615,139.05865,3,0
0,0,17,17,18,20,38,71,59,130,0.000333,0.22741,18,12280.15038,682.230577,682.230577,161.497212,3,0
0,0,15,15,13,19,32,66,57,123,0.000333,0.205,18,11070,615,615,128.816339,2,0
0,0,17,17,15,22,37,74,62,136,0.000333,0.236162,14,9918.799208,551.0444,708.485658,156.710855,3,0
0,0,15,15,12,19,31,65,57,122,0.000333,0.201471,18,10879.4151,604.41195,604.41195,123.730173,2,0
0,0,17,17,15,22,37,73,62,135,0.000333,0.234425,14,9845.866861,546.992603,703.276204,156.710855,3,0
0,0,8,8,11,14,25,25,28,53,0.000333,0.082041,10,2461.243781,136.735766,246.124378,91.356717,2,0
0,0,10,10,12,17,29,36,39,75,0.000333,0.12145,12,4372.182896,242.89905,364.348575,112.506418,4,0
0,0,8,8,11,14,25,25,28,53,0.000333,0.082041,10,2461.243781,136.735766,246.124378,91.356717,2,0
0,0,8,8,11,16,27,27,27,54,0.000333,0.085588,5,1283.819626,71.323313,256.763925,102.053748,3,0
0,0,6,6,9,9,18,16,14,30,0.000333,0.041699,4,500.391,27.7995,125.09775,57.05865,1,0
0,0,10,10,14,17,31,32,35,67,0.000333,0.110644,14,4647.036139,258.168674,331.931153,122.789837,2,0
0,0,9,9,16,16,32,34,35,69,0.000333,0.115,16,5520,306.666667,345,128,3,0
0,0,6,6,7,12,19,14,20,34,0.000333,0.048143,3,433.288606,24.071589,144.429535,62.671034,1,0
0,0,7,7,8,15,23,17,21,38,0.000333,0.057298,4,687.581417,38.198968,171.895354,82.603359,1,0
0,0,6,6,8,14,22,15,19,34,0.000333,0.05054,4,606.4827,33.693483,151.620675,77.302969,1,0
0,0,12,12,12,19,31,40,42,82,0.000333,0.135415,12,4874.929169,270.829398,406.244097,123.730173,2,0
0,0,11,11,14,18,32,42,42,84,0.000333,0.14,14,5880,326.666667,420,128.361619,3,0
0,0,13,13,12,20,32,41,44,85,0.000333,0.141667,12,5100,283.333333,425,129.458112,2,0
0,0,12,12,14,20,34,43,44,87,0.000333,0.147536,14,6196.529741,344.251652,442.609267,139.741531,3,0
0,0,4,4,10,13,23,21,20,41,0.000333,0.061822,5,927.330201,51.518344,185.46604,81.324997,2,0
0,0,9,9,12,13,25,36,31,67,0.000333,0.103713,12,3733.660377,207.425576,311.138365,91.125266,2,0
0,0,12,12,16,17,33,49,39,88,0.000333,0.147969,16,7102.50692,394.583718,443.906683,133.486868,3,0
0,0,10,10,15,17,32,41,34,75,0.000333,0.125,14,5250,291.666667,375,128.090227,2,0
0,0,16,16,13,20,33,53,61,114,0.000333,0.191687,18,10351.09673,575.06093,575.06093,134.544278,2,0
0,0,16,16,14,21,35,53,63,116,0.000333,0.198332,21,12494.93343,694.162968,594.99683,145.541635,2,0
0,0,18,18,14,21,35,60,71,131,0.000333,0.223979,21,14110.65758,783.925421,671.936075,145.541635,2,0
0,0,20,20,13,22,35,65,81,146,0.000333,0.249625,18,13479.75577,748.87532,748.87532,146.213212,2,0
0,0,20,20,14,23,37,65,87,152,0.000333,0.263946,21,16628.57514,923.80973,791.836912,157.344894,2,0
0,0,15,15,13,20,33,53,71,124,0.000333,0.208502,18,11259.08767,625.504871,625.504871,134.544278,2,0
0,0,19,19,18,19,37,83,57,140,0.000333,0.243108,27,19691.73372,1093.985207,729.323471,155.769273,4,0
0,0,10,10,14,14,28,42,30,72,0.000333,0.115377,14,4845.813761,269.211876,346.129554,106.605938,2,0
0,0,19,19,18,19,37,83,57,140,0.000333,0.243108,27,19691.73372,1093.985207,729.323471,155.769273,4,0
0,0,10,10,14,14,28,42,30,72,0.000333,0.115377,14,4845.813761,269.211876,346.129554,106.605938,2,0
0,0,4,4,10,12,22,17,17,34,0.000333,0.05054,5,758.103375,42.116854,151.620675,76.238831,2,0
0,0,4,4,12,12,24,21,19,40,0.000333,0.061133,6,1100.391,61.132833,183.3985,86.0391,3,0
0,0,10,10,14,16,30,34,42,76,0.000333,0.124308,14,5220.931594,290.051755,372.923685,117.302969,4,0
0,0,10,10,14,16,30,34,42,76,0.000333,0.124308,14,5220.931594,290.051755,372.923685,117.302969,4,0
0,0,10,10,12,17,29,30,37,67,0.000333,0.108495,12,3905.81672,216.989818,325.484727,112.506418,3,0
0,0,5,5,12,13,25,22,18,40,0.000333,0.061918,6,1114.525486,61.918083,185.754248,91.125266,1,0
0,0,8,8,15,16,31,35,26,61,0.000333,0.100735,7,2115.441825,117.524546,302.205975,122.603359,2,0
0,0,9,9,12,16,28,35,35,70,0.000333,0.112172,12,4038.178135,224.34323,336.514845,107.01955,1,0
0,0,5,5,12,13,25,22,18,40,0.000333,0.061918,6,1114.525486,61.918083,185.754248,91.125266,1,0
0,0,8,8,15,16,31,35,26,61,0.000333,0.100735,7,2115.441825,117.524546,302.205975,122.603359,2,0
0,0,9,9,12,16,28,35,35,70,0.000333,0.112172,12,4038.178135,224.34323,336.514845,107.01955,1,0
0,0,13,13,13,17,30,45,40,85,0.000333,0.139029,12,5005.028408,278.057134,417.085701,117.592585,3,0
0,0,16,16,15,20,35,58,48,106,0.000333,0.181235,14,7611.855997,422.880889,543.704,145.041921,4,0
0,0,13,13,15,18,33,50,42,92,0.000333,0.154695,14,6497.179626,360.954424,464.084259,133.662009,2,0
0,0,13,13,12,17,29,44,40,84,0.000333,0.136023,12,4896.844843,272.046936,408.070404,112.506418,3,0
0,0,16,16,15,20,35,57,48,105,0.000333,0.179525,14,7540.046035,418.891446,538.574717,145.041921,4,0
0,0,13,13,15,18,33,50,42,92,0.000333,0.154695,14,6497.179626,360.954424,464.084259,133.662009,2,0
0,0,5,5,12,13,25,22,18,40,0.000333,0.061918,6,1114.525486,61.918083,185.754248,91.125266,1,0
0,0,8,8,15,16,31,35,26,61,0.000333,0.100735,7,2115.441825,117.524546,302.205975,122.603359,2,0
0,0,9,9,12,16,28,35,35,70,0.000333,0.112172,12,4038.178135,224.34323,336.514845,107.01955,1,0
0,0,5,5,12,13,25,22,18,40,0.000333,0.061918,6,1114.525486,61.918083,185.754248,91.125266,1,0
0,0,8,8,15,16,31,35,26,61,0.000333,0.100735,7,2115.441825,117.524546,302.205975,122.603359,2,0
0,0,9,9,12,16,28,35,35,70,0.000333,0.112172,12,4038.178135,224.34323,336.514845,107.01955,1,0
0,0,17,17,13,19,32,54,44,98,0.000333,0.163333,12,5880,326.666667,490,128.816339,3,0
0,0,20,20,16,22,38,67,52,119,0.000333,0.208168,16,9992.053986,555.11411,624.503374,162.107496,4,0
0,0,13,13,15,18,33,50,42,92,0.000333,0.154695,14,6497.179626,360.954424,464.084259,133.662009,2,0
0,0,17,17,13,17,30,54,44,98,0.000333,0.160292,12,5770.50334,320.583519,480.875278,117.592585,3,0
0,0,20,20,16,20,36,67,52,119,0.000333,0.205074,16,9843.537203,546.863178,615.221075,150.438562,4,0
0,0,13,13,15,18,33,50,42,92,0.000333,0.154695,14,6497.179626,360.954424,464.084259,133.662009,2,0
0,0,20,20,14,22,36,68,81,149,0.000333,0.256773,21,16176.69533,898.705296,770.318825,151.410465,2,0
0,0,20,20,15,23,38,68,87,155,0.000333,0.271143,21,17082.00406,949.000225,813.428765,162.645284,2,0
0,0,15,15,14,20,34,56,71,127,0.000333,0.215369,21,13568.2634,753.792411,646.107781,139.741531,2,0
0,0,7,7,8,13,21,18,25,43,0.000333,0.062957,4,755.478597,41.971033,188.869649,72.105716,1,0
0,0,10,10,15,19,34,39,37,76,0.000333,0.128882,7,2706.530232,150.362791,386.647176,139.313982,2,0
0,0,7,7,9,14,23,18,24,42,0.000333,0.06333,4,759.958409,42.219912,189.989602,81.832294,1,0
0,0,15,15,15,21,36,61,54,115,0.000333,0.19818,14,8323.579252,462.42107,594.541375,150.842025,2,0
0,0,15,15,16,22,38,61,54,115,0.000333,0.201171,16,9656.186625,536.454812,603.511664,162.107496,2,0
0,0,18,18,16,22,38,72,66,138,0.000333,0.241405,24,17381.13593,965.618662,724.213997,162.107496,2,0
0,0,15,15,12,21,33,62,51,113,0.000333,0.190006,12,6840.198426,380.011024,570.016535,135.258216,1,0
0,0,18,18,16,23,39,75,59,134,0.000333,0.236081,16,11331.90236,629.550131,708.243897,168.041925,2,0
0,0,9,9,14,15,29,38,29,67,0.000333,0.108495,7,2278.393087,126.577394,325.484727,111.906328,2,0
0,0,13,13,20,19,39,51,52,103,0.000333,0.181465,20,10887.92857,604.884921,544.396429,167.149185,4,0
0,0,13,13,20,21,41,49,51,100,0.000333,0.178585,20,10715.10401,595.283556,535.7552,178.677228,3,0
0,0,13,13,18,19,37,45,50,95,0.000333,0.164966,18,8908.165255,494.89807,494.89807,155.769273,3,0
0,0,13,13,18,21,39,43,49,92,0.000333,0.162086,18,8752.626074,486.257004,486.257004,167.297316,2,0
0,0,8,8,12,16,28,30,32,62,0.000333,0.099352,12,3576.672062,198.704003,298.056005,107.01955,3,0
0,0,8,8,12,18,30,28,31,59,0.000333,0.096502,6,1737.039271,96.502182,289.506545,118.0782,2,0
0,0,8,8,14,16,30,34,34,68,0.000333,0.111223,14,4671.359847,259.519992,333.668561,117.302969,4,0
0,0,8,8,14,18,32,32,33,65,0.000333,0.108333,7,2275,126.388889,325,128.361619,3,0
0,0,18,18,14,18,32,89,68,157,0.000333,0.261667,21,16485,915.833333,785,128.361619,5,0
0,0,14,14,10,13,23,55,46,101,0.000333,0.152293,15,6853.196363,380.733131,456.879758,81.324997,3,0
0,0,23,23,14,25,39,98,89,187,0.000333,0.329457,21,20755.77451,1153.098584,988.370215,169.399374,5,0
0,0,14,14,10,18,28,43,65,108,0.000333,0.173065,15,7787.914974,432.661943,519.194332,108.277931,1,0
0,0,23,23,16,27,43,101,96,197,0.000333,0.356325,24,25655.37976,1425.298876,1068.974157,192.381963,5,0
0,0,3,3,7,9,16,10,11,21,0.000333,0.028,3,252,14,84,48.180809,1,0
0,0,3,3,7,10,17,10,12,22,0.000333,0.029975,3,269.772548,14.987364,89.924183,52.870765,1,0
0,0,9,9,9,14,23,31,51,82,0.000333,0.123644,12,4451.184965,247.288054,370.93208,81.832294,1,0
0,0,3,3,7,10,17,10,12,22,0.000333,0.029975,3,269.772548,14.987364,89.924183,52.870765,1,0
0,0,9,9,10,14,24,33,51,84,0.000333,0.128379,15,5777.052751,320.947375,385.13685,86.52225,1,0
0,0,10,10,13,20,33,37,30,67,0.000333,0.112658,6,2027.846436,112.658135,337.974406,134.544278,4,0
0,0,11,11,13,20,33,38,32,70,0.000333,0.117703,6,2118.64553,117.702529,353.107588,134.544278,4,0
0,0,10,10,13,20,33,37,30,67,0.000333,0.112658,6,2027.846436,112.658135,337.974406,134.544278,4,0
0,0,11,11,13,20,33,38,32,70,0.000333,0.117703,6,2118.64553,117.702529,353.107588,134.544278,4,0
0,0,4,4,8,9,17,14,14,28,0.000333,0.03815,4,457.795838,25.433102,114.44896,52.529325,1,0
0,0,15,15,12,19,31,60,49,109,0.000333,0.180002,12,6480.088774,360.004932,540.007398,123.730173,1,0
0,0,18,18,16,22,38,73,57,130,0.000333,0.22741,16,10915.68923,606.427179,682.230577,162.107496,2,0
0,0,14,14,16,19,35,58,43,101,0.000333,0.172686,16,8288.921355,460.495631,518.057585,144.710623,2,0
0,0,13,13,16,19,35,56,41,97,0.000333,0.165847,16,7960.647242,442.25818,497.540453,144.710623,2,0
0,0,4,4,9,8,17,15,13,28,0.000333,0.03815,4,457.795838,25.433102,114.44896,52.529325,1,0
0,0,4,4,8,9,17,14,14,28,0.000333,0.03815,4,457.795838,25.433102,114.44896,52.529325,1,0
0,0,14,14,11,17,28,58,50,108,0.000333,0.173065,10,5191.943316,288.441295,519.194332,107.540616,1,0
0,0,17,17,15,20,35,71,58,129,0.000333,0.220559,14,9263.485129,514.638063,661.677509,145.041921,2,0
0,0,10,10,14,17,31,49,36,85,0.000333,0.140369,14,5895.493609,327.527423,421.106686,122.789837,2,0
0,0,14,14,15,20,35,57,48,105,0.000333,0.179525,14,7540.046035,418.891446,538.574717,145.041921,2,0
0,0,13,13,15,20,35,55,46,101,0.000333,0.172686,14,7252.806186,402.933677,518.057585,145.041921,2,0
0,0,4,4,9,8,17,15,13,28,0.000333,0.03815,4,457.795838,25.433102,114.44896,52.529325,1,0
0,0,12,12,11,12,23,50,37,87,0.000333,0.131183,15,5903.248353,327.958242,393.54989,81.073298,1,0
0,0,15,15,15,15,30,63,45,108,0.000333,0.176648,21,11128.82787,618.268215,529.944184,117.206718,2,0
0,0,12,12,15,15,30,49,35,84,0.000333,0.137393,14,5770.50334,320.583519,412.17881,117.206718,2,0
0,0,11,11,15,15,30,47,33,80,0.000333,0.13085,14,5495.717467,305.317637,392.551248,117.206718,2,0
0,0,13,13,12,13,25,53,38,91,0.000333,0.140864,12,5071.090959,281.727276,422.590913,91.125266,2,0
0,0,16,16,16,16,32,66,46,112,0.000333,0.186667,16,8960,497.777778,560,128,3,0
0,0,13,13,16,16,32,52,36,88,0.000333,0.146667,16,7040,391.111111,440,128,3,0
0,0,11,11,15,15,30,47,33,80,0.000333,0.13085,14,5495.717467,305.317637,392.551248,117.206718,2,0
0,0,13,13,12,13,25,53,38,91,0.000333,0.140864,12,5071.090959,281.727276,422.590913,91.125266,2,0
0,0,16,16,16,16,32,66,46,112,0.000333,0.186667,16,8960,497.777778,560,128,3,0
0,0,13,13,16,16,32,52,36,88,0.000333,0.146667,16,7040,391.111111,440,128,3,0
0,0,11,11,15,15,30,47,33,80,0.000333,0.13085,14,5495.717467,305.317637,392.551248,117.206718,2,0
0,0,16,16,14,16,30,64,44,108,0.000333,0.176648,14,7419.218581,412.17881,529.944184,117.302969,2,0
0,0,19,19,16,19,35,77,52,129,0.000333,0.220559,16,10586.84015,588.157786,661.677509,144.710623,3,0
0,0,15,15,16,19,35,61,40,101,0.000333,0.172686,16,8288.921355,460.495631,518.057585,144.710623,3,0
0,0,15,15,16,19,35,61,40,101,0.000333,0.172686,16,8288.921355,460.495631,518.057585,144.710623,3,0
0,0,12,12,15,15,30,49,35,84,0.000333,0.137393,14,5770.50334,320.583519,412.17881,117.206718,2,0
0,0,15,15,13,15,28,57,41,98,0.000333,0.15704,12,5653.449388,314.080522,471.120782,106.709075,2,0
0,0,18,18,16,18,34,70,49,119,0.000333,0.201803,16,9686.52925,538.140514,605.408078,139.05865,3,0
0,0,15,15,16,18,34,56,39,95,0.000333,0.161103,16,7732.943519,429.607973,483.30897,139.05865,3,0
0,0,15,15,13,14,27,57,41,98,0.000333,0.155326,12,5591.747703,310.65265,465.978975,101.408685,2,0
0,0,18,18,16,17,33,70,49,119,0.000333,0.200094,16,9604.526403,533.5848,600.2829,133.486868,3,0
0,0,15,15,16,17,33,56,39,95,0.000333,0.159739,16,7667.479061,425.971059,479.217441,133.486868,3,0
0,0,13,13,12,13,25,53,38,91,0.000333,0.140864,12,5071.090959,281.727276,422.590913,91.125266,2,0
0,0,16,16,15,16,31,66,46,112,0.000333,0.184957,14,7768.179815,431.565545,554.869987,122.603359,3,0
0,0,13,13,15,16,31,52,36,88,0.000333,0.145323,14,6103.569854,339.087214,435.969275,122.603359,3,0
0,0,13,13,12,13,25,53,38,91,0.000333,0.140864,12,5071.090959,281.727276,422.590913,91.125266,2,0
0,0,16,16,15,16,31,66,46,112,0.000333,0.184957,14,7768.179815,431.565545,554.869987,122.603359,3,0
0,0,13,13,15,16,31,52,36,88,0.000333,0.145323,14,6103.569854,339.087214,435.969275,122.603359,3,0
0,0,6,6,9,11,20,15,13,28,0.000333,0.040338,4,484.055947,26.891997,121.013987,66.583073,2,0
0,0,6,6,9,10,19,16,12,28,0.000333,0.039647,4,475.767882,26.431549,118.94197,61.748606,2,0
0,0,16,16,16,20,36,64,43,107,0.000333,0.184394,16,8850.911602,491.717311,553.181975,150.438562,5,0
0,0,12,12,16,18,34,61,43,104,0.000333,0.176365,16,8465.538168,470.307676,529.096135,139.05865,5,0
0,0,6,6,9,10,19,16,12,28,0.000333,0.039647,4,475.767882,26.431549,118.94197,61.748606,2,0
0,0,16,16,16,18,34,64,43,107,0.000333,0.181453,16,8709.736384,483.874244,544.358524,139.05865,5,0
0,0,12,12,16,18,34,61,43,104,0.000333,0.176365,16,8465.538168,470.307676,529.096135,139.05865,5,0
0,0,6,6,9,10,19,16,12,28,0.000333,0.039647,4,475.767882,26.431549,118.94197,61.748606,2,0
0,0,13,13,12,15,27,39,28,67,0.000333,0.106192,6,1911.464776,106.192488,318.577463,101.622909,3,0
0,0,6,6,10,11,21,19,17,36,0.000333,0.052708,5,790.617136,43.923174,158.123427,71.273029,1,0
0,0,6,6,9,10,19,16,12,28,0.000333,0.039647,4,475.767882,26.431549,118.94197,61.748606,2,0
0,0,13,13,12,13,25,39,28,67,0.000333,0.103713,12,3733.660377,207.425576,311.138365,91.125266,3,0
0,0,6,6,10,11,21,19,17,36,0.000333,0.052708,5,790.617136,43.923174,158.123427,71.273029,1,0
0,0,6,6,6,14,20,12,24,36,0.000333,0.051863,3,466.768234,25.931569,155.589411,68.812744,1,0
0,0,7,7,8,16,24,16,25,41,0.000333,0.062661,4,751.93385,41.774103,187.983463,88,1,0
0,0,6,6,7,16,23,13,23,36,0.000333,0.054283,3,488.544691,27.141372,162.84823,83.651484,1,0
0,0,13,13,10,21,31,37,53,90,0.000333,0.148626,10,4458.776679,247.709816,445.877668,125.457947,1,0
0,0,13,13,12,22,34,38,53,91,0.000333,0.15432,12,5555.509423,308.639412,462.959119,141.127046,2,0
0,0,30,30,18,50,68,130,106,236,0.000333,0.47888,18,25859.54215,1436.641231,1436.641231,357.25146,9,0
0,0,29,29,18,50,68,129,104,233,0.000333,0.472793,18,25530.81916,1418.378842,1418.378842,357.25146,9,0
0,0,26,26,17,47,64,114,89,203,0.000333,0.406,8,9744,541.333333,1218,330.552544,9,0
0,0,7,7,8,13,21,17,20,37,0.000333,0.054172,4,650.062979,36.11461,162.515745,72.105716,1,0
0,0,31,31,20,53,73,135,109,244,0.000333,0.503439,20,30206.34385,1678.130214,1510.317192,390.018346,10,0
0,0,30,30,20,53,73,134,107,241,0.000333,0.497249,20,29834.95437,1657.497465,1491.747719,390.018346,10,0
0,0,26,26,18,49,67,115,89,204,0.000333,0.412494,9,11137.33975,618.741097,1237.482195,350.179432,9,0
0,0,13,13,10,18,28,38,43,81,0.000333,0.129799,10,3893.957487,216.330971,389.395749,108.277931,1,0
0,0,33,33,20,54,74,140,114,254,0.000333,0.525734,20,31544.0231,1752.445728,1577.201155,397.202487,10,0
0,0,12,12,14,18,32,54,43,97,0.000333,0.161667,14,6790,377.222222,485,128.361619,5,0
0,0,6,6,9,12,21,15,17,32,0.000333,0.046851,4,562.21663,31.234257,140.554158,71.548875,1,0
0,0,12,12,15,20,35,55,43,98,0.000333,0.167557,14,7037.376299,390.96535,502.669736,145.041921,5,0
0,0,8,8,10,15,25,28,25,53,0.000333,0.082041,5,1230.62189,68.367883,246.124378,91.82264,2,0
0,0,10,10,13,18,31,37,31,68,0.000333,0.112295,6,2021.312095,112.295116,336.885349,123.164366,3,0
0,0,8,8,9,15,24,27,25,52,0.000333,0.079473,4,953.6722,52.981789,238.41805,87.132684,2,0
0,0,10,10,13,18,31,36,31,67,0.000333,0.110644,6,1991.586917,110.643718,331.931153,123.164366,3,0
0,0,18,18,17,22,39,64,69,133,0.000333,0.234319,24,16871.00388,937.277993,702.958495,167.594364,2,0
0,0,10,10,13,19,32,37,30,67,0.000333,0.111667,6,2010,111.666667,335,128.816339,4,0
0,0,11,11,13,19,32,38,32,70,0.000333,0.116667,6,2100,116.666667,350,128.816339,4,0
0,0,10,10,13,19,32,37,30,67,0.000333,0.111667,6,2010,111.666667,335,128.816339,4,0
0,0,11,11,13,19,32,38,32,70,0.000333,0.116667,6,2100,116.666667,350,128.816339,4,0
0,0,10,10,13,19,32,37,29,66,0.000333,0.11,6,1980,110,330,128.816339,4,0
0,0,11,11,13,19,32,38,31,69,0.000333,0.115,6,2070,115,345,128.816339,4,0
0,0,10,10,13,19,32,37,29,66,0.000333,0.11,6,1980,110,330,128.816339,4,0
0,0,11,11,13,19,32,38,31,69,0.000333,0.115,6,2070,115,345,128.816339,4,0
0,0,9,9,13,18,31,34,28,62,0.000333,0.102387,6,1842.961027,102.386724,307.160171,123.164366,3,0
0,0,10,10,13,18,31,35,30,65,0.000333,0.107341,6,1932.136561,107.34092,322.02276,123.164366,3,0
0,0,7,7,6,12,18,15,20,35,0.000333,0.048649,3,437.842125,24.324563,145.947375,58.529325,1,0
0,0,7,7,7,13,20,16,20,36,0.000333,0.051863,3,466.768234,25.931569,155.589411,67.757201,1,0
0,0,7,7,7,14,21,16,20,36,0.000333,0.052708,3,474.370282,26.353905,158.123427,72.954453,1,0
0,0,13,13,10,18,28,37,43,80,0.000333,0.128196,10,3845.883938,213.660219,384.588394,108.277931,1,0
0,0,14,14,12,23,35,51,50,101,0.000333,0.172686,12,6216.691017,345.371723,518.057585,147.061475,3,0
0,0,6,6,11,9,20,19,14,33,0.000333,0.047541,5,713.118136,39.617674,142.623627,66.583073,2,0
0,0,6,6,11,9,20,19,14,33,0.000333,0.047541,5,713.118136,39.617674,142.623627,66.583073,2,0
0,0,31,31,19,50,69,134,108,242,0.000333,0.492754,18,26608.73253,1478.262919,1478.262919,362.903432,10,0
0,0,30,30,19,50,69,133,106,239,0.000333,0.486646,18,26278.87221,1459.937345,1459.937345,362.903432,10,0
0,0,26,26,17,47,64,114,89,203,0.000333,0.406,8,9744,541.333333,1218,330.552544,9,0
0,0,7,7,8,13,21,17,20,37,0.000333,0.054172,4,650.062979,36.11461,162.515745,72.105716,1,0
0,0,32,32,22,53,75,142,112,254,0.000333,0.527373,22,34806.63884,1933.702158,1582.119947,401.68728,11,0
0,0,31,31,22,53,75,141,110,251,0.000333,0.521144,22,34395.53681,1910.863156,1563.433491,401.68728,11,0
0,0,26,26,18,49,67,115,89,204,0.000333,0.412494,9,11137.33975,618.741097,1237.482195,350.179432,9,0
0,0,14,14,13,17,30,42,45,87,0.000333,0.1423,12,5122.793782,284.599655,426.899482,117.592585,2,0
0,0,34,34,22,54,76,147,117,264,0.000333,0.549818,22,36287.963,2015.997944,1649.452864,408.871421,11,0
0,0,23,23,17,45,62,104,81,185,0.000333,0.367175,8,8812.210539,489.567252,1101.526317,316.620258,9,0
0,0,22,22,17,45,62,103,79,182,0.000333,0.361221,8,8669.309828,481.628324,1083.663728,316.620258,9,0
0,0,23,23,18,47,65,105,81,186,0.000333,0.373387,9,10081.44372,560.080207,1120.160413,336.124326,9,0
0,0,22,22,18,47,65,104,79,183,0.000333,0.367364,9,9918.839788,551.046655,1102.09331,336.124326,9,0
0,0,13,13,12,15,27,60,41,101,0.000333,0.160081,12,5762.923653,320.162425,480.243638,101.622909,2,0
0,0,16,16,15,18,33,73,49,122,0.000333,0.205139,14,8615.825156,478.656953,615.416083,133.662009,3,0
0,0,13,13,12,15,27,60,41,101,0.000333,0.160081,12,5762.923653,320.162425,480.243638,101.622909,2,0
0,0,16,16,15,18,33,73,49,122,0.000333,0.205139,14,8615.825156,478.656953,615.416083,133.662009,3,0
0,0,11,11,14,18,32,49,41,90,0.000333,0.15,14,6300,350,450,128.361619,3,0
0,0,11,11,14,18,32,49,41,90,0.000333,0.15,14,6300,350,450,128.361619,3,0
0,0,9,9,10,13,23,32,30,62,0.000333,0.093487,10,2804.608413,155.811578,280.460841,81.324997,2,0
0,0,9,9,10,13,23,32,30,62,0.000333,0.093487,10,2804.608413,155.811578,280.460841,81.324997,2,0
0,0,27,27,22,47,69,120,90,210,0.000333,0.427597,11,14110.6915,783.927305,1282.790136,359.173172,9,0
0,0,26,26,22,47,69,119,88,207,0.000333,0.421488,11,13909.11019,772.728344,1264.464563,359.173172,9,0
0,0,13,13,13,16,29,57,47,104,0.000333,0.16841,12,6062.760282,336.820016,505.230023,112.105716,2,0
0,0,15,15,15,18,33,65,52,117,0.000333,0.196731,14,8262.717568,459.039865,590.194112,133.662009,3,0
0,0,13,13,12,16,28,56,47,103,0.000333,0.165053,12,5941.890684,330.105038,495.157557,107.01955,2,0
0,0,15,15,15,18,33,64,52,116,0.000333,0.19505,14,8192.09605,455.116447,585.149718,133.662009,3,0
0,0,15,15,16,23,39,59,60,119,0.000333,0.209654,16,10063.40583,559.078101,628.962864,168.041925,2,0
0,0,18,18,17,24,41,73,73,146,0.000333,0.260734,24,18772.86222,1042.93679,782.202593,179.525968,2,0
0,0,20,20,21,26,47,81,78,159,0.000333,0.294393,30,26495.38882,1471.966046,883.179627,214.450099,3,0
0,0,15,15,17,23,40,60,63,123,0.000333,0.218199,16,10473.55449,581.864138,654.597156,173.528793,2,0
0,0,12,12,11,15,26,53,45,98,0.000333,0.153548,15,6909.646386,383.869244,460.643092,96.657107,1,0
0,0,14,14,15,17,32,61,50,111,0.000333,0.185,14,7770,431.666667,555,128.090227,2,0
0,0,31,31,18,48,66,122,119,241,0.000333,0.485566,18,26220.58169,1456.698983,1456.698983,343.13685,7,0
0,0,30,30,18,48,66,121,117,238,0.000333,0.479522,18,25894.18441,1438.5658,1438.5658,343.13685,7,0
0,0,32,32,20,55,75,137,133,270,0.000333,0.560594,20,33635.62093,1868.645607,1681.781046,404.413346,9,0
0,0,31,31,20,55,75,136,131,267,0.000333,0.554365,20,33261.89181,1847.882878,1663.09459,404.413346,9,0
0,0,27,27,18,48,66,113,98,211,0.000333,0.425122,18,22956.60887,1275.367159,1275.367159,343.13685,7,0
0,0,26,26,18,48,66,112,96,208,0.000333,0.419078,18,22630.21158,1257.233977,1257.233977,343.13685,7,0
0,0,28,28,20,55,75,128,106,234,0.000333,0.485848,10,14575.43574,809.74643,1457.543574,404.413346,9,0
0,0,27,27,20,55,75,127,104,231,0.000333,0.479619,10,14388.57118,799.365065,1438.857118,404.413346,9,0
0,0,7,7,9,12,21,22,21,43,0.000333,0.062957,4,755.478597,41.971033,188.869649,71.548875,1,0
0,0,6,6,8,12,20,20,19,39,0.000333,0.056185,4,674.220783,37.45671,168.555196,67.01955,1,0
0,0,7,7,10,13,23,34,27,61,0.000333,0.091979,10,2759.372793,153.298489,275.937279,81.324997,1,0
0,0,10,10,14,16,30,47,35,82,0.000333,0.134122,14,5633.110404,312.950578,402.365029,117.302969,2,0
0,0,4,4,7,10,17,10,11,21,0.000333,0.028612,3,257.510159,14.30612,85.83672,52.870765,2,0
0,0,4,4,9,9,18,12,10,22,0.000333,0.030579,4,366.9534,20.3863,91.73835,57.05865,2,0
0,0,12,12,15,19,34,55,39,94,0.000333,0.159407,14,6695.101099,371.950061,478.221507,139.313982,5,0
0,0,12,12,16,18,34,61,43,104,0.000333,0.176365,16,8465.538168,470.307676,529.096135,139.05865,5,0
0,0,4,4,8,9,17,11,10,21,0.000333,0.028612,4,343.346879,19.074827,85.83672,52.529325,2,0
0,0,12,12,15,19,34,54,39,93,0.000333,0.157711,14,6623.876619,367.993146,473.134044,139.313982,5,0
0,0,12,12,16,18,34,61,43,104,0.000333,0.176365,16,8465.538168,470.307676,529.096135,139.05865,5,0
0,0,4,4,8,9,17,11,10,21,0.000333,0.028612,4,343.346879,19.074827,85.83672,52.529325,2,0
0,0,9,9,12,13,25,30,24,54,0.000333,0.083589,6,1504.609405,83.589411,250.768234,91.125266,3,0
0,0,6,6,10,11,21,19,17,36,0.000333,0.052708,5,790.617136,43.923174,158.123427,71.273029,1,0
0,0,4,4,8,9,17,11,10,21,0.000333,0.028612,4,343.346879,19.074827,85.83672,52.529325,2,0
0,0,9,9,11,13,24,29,24,53,0.000333,0.081001,5,1215.015063,67.500837,243.003013,86.159464,3,0
0,0,6,6,10,11,21,19,17,36,0.000333,0.052708,5,790.617136,43.923174,158.123427,71.273029,1,0
0,0,4,4,7,9,16,10,10,20,0.000333,0.026667,3,240,13.333333,80,48.180809,2,0
0,0,4,4,8,8,16,11,9,20,0.000333,0.026667,4,320,17.777778,80,48,2,0
0,0,12,12,15,18,33,54,37,91,0.000333,0.153013,14,6426.558108,357.031006,459.039865,133.662009,5,0
0,0,12,12,16,18,34,61,43,104,0.000333,0.176365,16,8465.538168,470.307676,529.096135,139.05865,5,0
0,0,4,4,8,8,16,11,9,20,0.000333,0.026667,4,320,17.777778,80,48,2,0
0,0,12,12,15,17,32,54,37,91,0.000333,0.151667,14,6370,353.888889,455,128.090227,5,0
0,0,12,12,16,18,34,61,43,104,0.000333,0.176365,16,8465.538168,470.307676,529.096135,139.05865,5,0
0,0,4,4,8,8,16,11,9,20,0.000333,0.026667,4,320,17.777778,80,48,2,0
0,0,9,9,11,12,23,29,22,51,0.000333,0.076901,5,1153.508299,64.083794,230.70166,81.073298,3,0
0,0,4,4,8,8,16,11,9,20,0.000333,0.026667,4,320,17.777778,80,48,2,0
0,0,9,9,11,11,22,29,22,51,0.000333,0.07581,10,2274.310126,126.350563,227.431013,76.107496,3,0
0,0,14,14,12,14,26,52,48,100,0.000333,0.156681,18,8460.791493,470.043972,470.043972,96.322519,1,0
0,0,16,16,16,17,33,60,53,113,0.000333,0.190006,24,13680.39685,760.022047,570.016535,133.486868,2,0
0,0,12,12,15,17,32,43,37,80,0.000333,0.133333,14,5600,311.111111,400,128.090227,2,0
0,0,11,11,11,17,28,43,37,80,0.000333,0.128196,10,3845.883938,213.660219,384.588394,107.540616,3,0
0,0,13,13,16,20,36,52,43,95,0.000333,0.163714,16,7858.286002,436.571445,491.142875,150.438562,4,0
0,0,10,10,13,17,30,38,32,70,0.000333,0.114494,6,2060.89405,114.494114,343.482342,117.592585,3,0
0,0,12,12,16,20,36,47,38,85,0.000333,0.146481,8,3515.549001,195.308278,439.443625,150.438562,4,0
0,0,10,10,12,17,29,37,32,69,0.000333,0.111734,6,2011.204132,111.733563,335.200689,112.506418,3,0
0,0,12,12,16,20,36,46,38,84,0.000333,0.144758,8,3474.189601,193.010533,434.2737,150.438562,4,0
0,0,19,19,16,19,35,81,54,135,0.000333,0.230818,16,11079.25132,615.513962,692.453207,144.710623,3,0
0,0,19,19,16,18,34,81,54,135,0.000333,0.228936,24,16483.37961,915.743311,686.807484,139.05865,3,0
0,0,28,28,20,49,69,123,91,214,0.000333,0.435741,10,13072.24234,726.235685,1307.224234,361.559344,11,0
0,0,27,27,20,49,69,122,89,211,0.000333,0.429633,10,12888.9866,716.054811,1288.89866,361.559344,11,0
0,0,28,28,20,49,69,123,91,214,0.000333,0.435741,10,13072.24234,726.235685,1307.224234,361.559344,11,0
0,0,27,27,20,49,69,122,89,211,0.000333,0.429633,10,12888.9866,716.054811,1288.89866,361.559344,11,0
0,0,28,28,21,49,70,123,91,214,0.000333,0.437222,10,13116.66566,728.703648,1311.666566,367.359448,11,0
0,0,27,27,21,49,70,122,89,211,0.000333,0.431093,10,12932.78717,718.488176,1293.278717,367.359448,11,0
0,0,28,28,21,49,70,123,91,214,0.000333,0.437222,10,13116.66566,728.703648,1311.666566,367.359448,11,0
0,0,27,27,21,49,70,122,89,211,0.000333,0.431093,10,12932.78717,718.488176,1293.278717,367.359448,11,0
0,0,15,15,16,20,36,75,46,121,0.000333,0.20852,16,10008.9748,556.054156,625.560925,150.438562,6,0
0,0,15,15,16,20,36,75,46,121,0.000333,0.20852,16,10008.9748,556.054156,625.560925,150.438562,6,0
0,0,6,6,9,10,19,17,15,32,0.000333,0.045311,4,543.734722,30.207485,135.93368,61.748606,2,0
0,0,6,6,9,10,19,17,15,32,0.000333,0.045311,4,543.734722,30.207485,135.93368,61.748606,2,0
0,0,23,23,17,45,62,105,79,184,0.000333,0.365191,8,8764.576969,486.920943,1095.572121,316.620258,9,0
0,0,22,22,17,45,62,104,77,181,0.000333,0.359237,8,8621.676257,478.982014,1077.709532,316.620258,9,0
0,0,15,15,15,21,36,59,54,113,0.000333,0.194734,14,8178.821352,454.378964,584.201525,150.842025,2,0
0,0,18,18,16,22,38,74,66,140,0.000333,0.244903,24,17633.03645,979.613136,734.709852,162.107496,2,0
0,0,21,21,20,24,44,87,74,161,0.000333,0.292989,30,26369.05472,1464.947484,878.968491,196.477662,3,0
0,0,15,15,16,21,37,60,57,117,0.000333,0.203169,16,9752.0967,541.78315,609.506044,156.238666,2,0
0,0,20,20,20,23,43,85,71,156,0.000333,0.282166,30,25394.91905,1410.828836,846.497302,190.480487,3,0
0,0,7,7,13,13,26,30,27,57,0.000333,0.089308,12,3215.100767,178.616709,267.925064,96.211433,2,0
0,0,10,10,13,16,29,44,38,82,0.000333,0.132785,12,4780.253299,265.569628,398.354442,112.105716,2,0
0,0,13,13,18,20,38,57,46,103,0.000333,0.180179,18,9729.65761,540.536534,540.536534,161.497212,3,0
0,0,7,7,13,14,27,30,29,59,0.000333,0.093513,12,3366.460352,187.025575,280.538363,101.408685,2,0
0,0,12,12,18,19,37,55,43,98,0.000333,0.170175,18,9189.475737,510.52643,510.52643,155.769273,3,0
0,0,7,7,11,14,25,28,25,53,0.000333,0.082041,5,1230.62189,68.367883,246.124378,91.356717,2,0
0,0,4,4,8,9,17,14,14,28,0.000333,0.03815,4,457.795838,25.433102,114.44896,52.529325,1,0
0,0,16,16,15,17,32,65,49,114,0.000333,0.19,14,7980,443.333333,570,128.090227,3,0
0,0,19,19,17,20,37,78,57,135,0.000333,0.234425,16,11252.41927,625.134404,703.276204,155.92543,4,0
0,0,13,13,14,16,30,50,36,86,0.000333,0.140664,14,5907.896277,328.21646,421.992591,117.302969,3,0
0,0,16,16,14,17,31,64,49,113,0.000333,0.186608,14,7837.538563,435.418809,559.824183,122.789837,3,0
0,0,19,19,17,20,37,77,57,134,0.000333,0.232689,16,11169.06802,620.503779,698.066751,155.92543,4,0
0,0,13,13,14,16,30,49,36,85,0.000333,0.139029,14,5839.199809,324.399989,417.085701,117.302969,3,0
0,0,15,15,12,18,30,65,56,121,0.000333,0.197911,18,10687.20772,593.733762,593.733762,118.0782,2,0
0,0,17,17,15,21,36,73,61,134,0.000333,0.230923,14,9698.779303,538.821072,692.76995,150.842025,3,0
0,0,15,15,12,18,30,65,56,121,0.000333,0.197911,18,10687.20772,593.733762,593.733762,118.0782,2,0
0,0,17,17,15,21,36,73,61,134,0.000333,0.230923,14,9698.779303,538.821072,692.76995,150.842025,3,0
0,0,17,17,13,20,33,70,59,129,0.000333,0.216909,12,7808.722097,433.817894,650.726841,134.544278,2,0
0,0,19,19,16,23,39,78,64,142,0.000333,0.250176,16,12008.43384,667.135213,750.527115,168.041925,3,0
0,0,17,17,13,19,32,70,59,129,0.000333,0.215,18,11610,645,645,128.816339,2,0
0,0,19,19,16,22,38,78,64,142,0.000333,0.248402,16,11923.29131,662.405073,745.205707,162.107496,3,0
0,0,15,15,12,18,30,65,56,121,0.000333,0.197911,18,10687.20772,593.733762,593.733762,118.0782,2,0
0,0,17,17,15,21,36,73,61,134,0.000333,0.230923,14,9698.779303,538.821072,692.76995,150.842025,3,0
0,0,15,15,12,18,30,65,56,121,0.000333,0.197911,18,10687.20772,593.733762,593.733762,118.0782,2,0
0,0,17,17,15,21,36,73,61,134,0.000333,0.230923,14,9698.779303,538.821072,692.76995,150.842025,3,0
0,0,12,12,12,16,28,41,41,82,0.000333,0.131401,12,4730.437243,262.802069,394.203104,107.01955,2,0
0,0,15,15,14,19,33,53,50,103,0.000333,0.173191,14,7274.01632,404.112018,519.572594,134.013592,3,0
0,0,12,12,14,18,32,39,35,74,0.000333,0.123333,7,2590,143.888889,370,128.361619,3,0
0,0,12,12,11,16,27,40,41,81,0.000333,0.128382,10,3851.458877,213.969938,385.145888,102.053748,2,0
0,0,15,15,14,19,33,52,50,102,0.000333,0.171509,14,7203.394802,400.1886,514.5282,134.013592,3,0
0,0,12,12,14,18,32,38,35,73,0.000333,0.121667,7,2555,141.944444,365,128.361619,3,0
0,0,12,12,11,14,25,40,40,80,0.000333,0.123836,10,3715.084952,206.393608,371.508495,91.356717,2,0
0,0,15,15,15,17,32,52,49,101,0.000333,0.168333,14,7070,392.777778,505,128.090227,3,0
0,0,12,12,15,16,31,38,34,72,0.000333,0.118901,14,4993.829881,277.434993,356.702134,122.603359,3,0
0,0,30,30,19,51,70,133,106,239,0.000333,0.4883,18,26368.17554,1464.898641,1464.898641,370.004315,9,0
0,0,29,29,19,51,70,132,104,236,0.000333,0.48217,18,26037.19426,1446.510792,1446.510792,370.004315,9,0
0,0,31,31,21,54,75,138,109,247,0.000333,0.512839,20,30770.36433,1709.464685,1538.518217,403.002591,10,0
0,0,30,30,21,54,75,137,107,244,0.000333,0.506611,10,15198.31761,844.350978,1519.83176,403.002591,10,0
0,0,12,12,14,17,31,40,42,82,0.000333,0.135415,14,5687.417364,315.967631,406.244097,122.789837,3,0
0,0,12,12,14,19,33,38,41,79,0.000333,0.132836,14,5579.099896,309.949994,398.507135,134.013592,2,0
0,0,12,12,16,17,33,46,44,90,0.000333,0.151332,16,7263.927532,403.55153,453.995471,133.486868,4,0
0,0,12,12,16,19,35,44,43,87,0.000333,0.148749,16,7139.96196,396.664553,446.247622,144.710623,3,0
0,0,16,16,15,18,33,66,56,122,0.000333,0.205139,21,12923.73773,717.98543,615.416083,133.662009,2,0
0,0,14,14,15,17,32,60,50,110,0.000333,0.183333,14,7700,427.777778,550,128.090227,2,0
0,0,8,8,11,16,27,31,32,63,0.000333,0.099853,10,2995.579126,166.421063,299.557913,102.053748,1,0
0,0,10,10,15,19,34,39,37,76,0.000333,0.128882,7,2706.530232,150.362791,386.647176,139.313982,2,0
0,0,19,19,11,21,32,72,83,155,0.000333,0.258333,15,11625,645.833333,775,130.292414,1,0
0,0,21,21,15,23,38,80,88,168,0.000333,0.293884,21,18514.68827,1028.593793,881.651822,162.645284,2,0
0,0,8,8,13,16,29,31,29,60,0.000333,0.09716,6,1748.873158,97.15962,291.47886,112.105716,3,0
0,0,8,8,13,18,31,29,28,57,0.000333,0.09413,6,1694.335138,94.12973,282.38919,123.164366,2,0
0,0,8,8,15,16,31,35,31,66,0.000333,0.108992,7,2288.838695,127.157705,326.976956,122.603359,4,0
0,0,8,8,15,18,33,33,30,63,0.000333,0.105932,7,2224.577807,123.587656,317.79683,133.662009,3,0
0,0,7,7,8,13,21,24,23,47,0.000333,0.068813,4,825.755675,45.875315,206.438919,72.105716,1,0
0,0,9,9,13,16,29,33,29,62,0.000333,0.100398,6,1807.16893,100.398274,301.194822,112.105716,2,0
0,0,9,9,11,17,28,33,30,63,0.000333,0.100954,5,1514.3168,84.128711,302.86336,107.540616,2,0
0,0,11,11,16,20,36,42,36,78,0.000333,0.134418,8,3226.033201,179.224067,403.25415,150.438562,3,0
0,0,8,8,9,14,23,27,24,51,0.000333,0.076901,4,922.806639,51.267036,230.70166,81.832294,2,0
0,0,10,10,14,17,31,36,30,66,0.000333,0.108992,7,2288.838695,127.157705,326.976956,122.789837,3,0
0,0,7,7,11,14,25,28,25,53,0.000333,0.082041,5,1230.62189,68.367883,246.124378,91.356717,2,0
0,0,16,16,15,17,32,72,50,122,0.000333,0.203333,14,8540,474.444444,610,128.090227,3,0
0,0,19,19,18,19,37,85,58,143,0.000333,0.248317,27,20113.69945,1117.427747,744.951831,155.769273,4,0
0,0,7,7,12,13,25,29,24,53,0.000333,0.082041,6,1476.746268,82.041459,246.124378,91.125266,2,0
0,0,12,12,17,17,34,54,38,92,0.000333,0.156016,16,7488.745302,416.041406,468.046581,138.973737,3,0
0,0,16,16,15,17,32,72,50,122,0.000333,0.203333,14,8540,474.444444,610,128.090227,3,0
0,0,19,19,18,19,37,85,58,143,0.000333,0.248317,27,20113.69945,1117.427747,744.951831,155.769273,4,0
0,0,7,7,12,13,25,29,24,53,0.000333,0.082041,6,1476.746268,82.041459,246.124378,91.125266,2,0
0,0,12,12,17,17,34,54,38,92,0.000333,0.156016,16,7488.745302,416.041406,468.046581,138.973737,3,0
0,0,7,7,11,14,25,28,25,53,0.000333,0.082041,5,1230.62189,68.367883,246.124378,91.356717,2,0
0,0,15,15,14,17,31,69,49,118,0.000333,0.194865,14,8184.332305,454.685128,584.595165,122.789837,2,0
0,0,18,18,18,19,37,82,57,139,0.000333,0.241371,27,19551.07848,1086.171027,724.114018,155.769273,3,0
0,0,7,7,12,13,25,29,24,53,0.000333,0.082041,6,1476.746268,82.041459,246.124378,91.125266,2,0
0,0,12,12,17,17,34,54,38,92,0.000333,0.156016,16,7488.745302,416.041406,468.046581,138.973737,3,0
0,0,3,3,6,8,14,7,9,16,0.000333,0.020306,3,182.753036,10.152946,60.917679,39.509775,1,0
0,0,3,3,7,7,14,8,8,16,0.000333,0.020306,3,182.753036,10.152946,60.917679,39.302969,1,0
0,0,10,10,11,17,28,31,31,62,0.000333,0.099352,5,1490.280026,82.793335,298.056005,107.540616,1,0
0,0,8,8,11,14,25,26,24,50,0.000333,0.077398,5,1160.964047,64.498003,232.192809,91.356717,1,0
0,0,3,3,7,7,14,8,8,16,0.000333,0.020306,3,182.753036,10.152946,60.917679,39.302969,1,0
0,0,13,13,16,23,39,56,46,102,0.000333,0.179704,16,8625.776421,479.209801,539.111026,168.041925,3,0
0,0,14,14,17,21,38,68,50,118,0.000333,0.206418,16,9908.087145,550.449286,619.255447,161.725534,5,0
0,0,14,14,14,20,34,64,54,118,0.000333,0.200107,14,8404.488614,466.916034,600.320615,139.741531,5,0
0,0,14,14,16,22,38,67,57,124,0.000333,0.216914,16,10411.88819,578.438233,650.743012,162.107496,5,0
0,0,14,14,16,22,38,67,57,124,0.000333,0.216914,16,10411.88819,578.438233,650.743012,162.107496,5,0
0,0,8,8,10,15,25,25,29,54,0.000333,0.083589,5,1253.841171,69.657843,250.768234,91.82264,1,0
0,0,4,4,8,10,18,13,14,27,0.000333,0.037529,4,450.3519,25.01955,112.587975,57.219281,2,0
0,0,4,4,8,12,20,13,18,31,0.000333,0.04466,4,535.919084,29.773282,133.979771,67.01955,2,0
0,0,13,13,15,22,37,57,54,111,0.000333,0.19275,14,8095.49053,449.749474,578.249324,156.710855,4,0
0,0,4,4,8,12,20,13,18,31,0.000333,0.04466,4,535.919084,29.773282,133.979771,67.01955,2,0
0,0,13,13,15,22,37,57,54,111,0.000333,0.19275,14,8095.49053,449.749474,578.249324,156.710855,4,0
0,0,4,4,8,11,19,13,16,29,0.000333,0.041063,4,492.759592,27.375533,123.189898,62.053748,2,0
0,0,10,10,11,16,27,32,36,68,0.000333,0.107777,10,3233.323501,179.629083,323.33235,102.053748,2,0
0,0,3,3,6,8,14,7,9,16,0.000333,0.020306,3,182.753036,10.152946,60.917679,39.509775,1,0
0,0,3,3,7,7,14,8,8,16,0.000333,0.020306,3,182.753036,10.152946,60.917679,39.302969,1,0
0,0,11,11,11,13,24,41,32,73,0.000333,0.111567,10,3347.022626,185.945701,334.702263,86.159464,1,0
0,0,7,7,10,12,22,22,19,41,0.000333,0.060946,5,914.183482,50.787971,182.836696,76.238831,1,0
0,0,3,3,7,7,14,8,8,16,0.000333,0.020306,3,182.753036,10.152946,60.917679,39.302969,1,0
0,0,14,14,16,19,35,66,47,113,0.000333,0.193203,16,9273.743695,515.207983,579.608981,144.710623,3,0
0,0,13,13,16,19,35,64,45,109,0.000333,0.186364,16,8945.469582,496.970532,559.091849,144.710623,5,0
0,0,17,17,11,20,31,71,66,137,0.000333,0.226242,15,10180.87342,565.604079,678.724895,124.49231,1,0
0,0,20,20,15,22,37,84,74,158,0.000333,0.274365,21,17284.96627,960.275904,823.093632,156.710855,2,0
0,0,10,10,13,17,30,45,35,80,0.000333,0.13085,12,4710.614972,261.700832,392.551248,117.592585,2,0
0,0,19,19,11,21,32,77,78,155,0.000333,0.258333,15,11625,645.833333,775,130.292414,1,0
0,0,22,22,15,23,38,90,86,176,0.000333,0.307878,21,19396.34009,1077.574449,923.635242,162.645284,2,0
0,0,10,10,13,17,30,45,35,80,0.000333,0.13085,12,4710.614972,261.700832,392.551248,117.592585,2,0
0,0,15,15,15,20,35,51,52,103,0.000333,0.176105,14,7396.42611,410.912562,528.316151,145.041921,2,0
0,0,18,18,18,23,41,64,60,124,0.000333,0.221445,18,11958.05607,664.336449,664.336449,179.100575,3,0
0,0,16,16,17,23,40,56,55,111,0.000333,0.196911,16,9451.744297,525.096905,590.734019,173.528793,2,0
0,0,13,13,15,23,38,54,42,96,0.000333,0.167934,7,3526.607289,195.922627,503.801041,162.645284,4,0
0,0,14,14,15,23,38,55,44,99,0.000333,0.173182,7,3636.813767,202.045209,519.544824,162.645284,4,0
0,0,9,9,12,16,28,38,31,69,0.000333,0.110569,6,1990.244938,110.569163,331.70749,107.01955,2,0
0,0,12,12,15,19,34,51,39,90,0.000333,0.152624,14,6410.20318,356.122399,457.871656,139.313982,3,0
0,0,10,10,14,19,33,43,34,77,0.000333,0.129473,7,2718.92843,151.051579,388.418347,134.013592,2,0
0,0,6,6,9,9,18,16,14,30,0.000333,0.041699,4,500.391,27.7995,125.09775,57.05865,1,0
0,0,15,15,16,19,35,74,45,119,0.000333,0.203462,16,9766.154864,542.564159,610.384679,144.710623,5,0
0,0,10,10,15,17,32,49,36,85,0.000333,0.141667,14,5950,330.555556,425,128.090227,2,0
0,0,7,7,10,15,25,22,26,48,0.000333,0.074302,5,1114.525486,61.918083,222.905097,91.82264,1,0
0,0,6,6,9,12,21,15,17,32,0.000333,0.046851,4,562.21663,31.234257,140.554158,71.548875,1,0
0,0,7,7,11,17,28,23,26,49,0.000333,0.07852,5,1177.801956,65.433442,235.560391,107.540616,1,0
0,0,7,7,8,13,21,18,25,43,0.000333,0.062957,4,755.478597,41.971033,188.869649,72.105716,1,0
0,0,10,10,15,19,34,39,37,76,0.000333,0.128882,7,2706.530232,150.362791,386.647176,139.313982,2,0
0,0,7,7,9,14,23,18,24,42,0.000333,0.06333,4,759.958409,42.219912,189.989602,81.832294,1,0
0,0,16,16,14,20,34,56,61,117,0.000333,0.198411,21,12499.8962,694.438678,595.233152,139.741531,2,0
0,0,16,16,15,21,36,56,63,119,0.000333,0.205074,21,12919.64258,717.757921,615.221075,150.842025,2,0
0,0,18,18,15,21,36,63,71,134,0.000333,0.230923,21,14548.16895,808.231609,692.76995,150.842025,2,0
0,0,14,14,15,20,35,52,50,102,0.000333,0.174396,14,7324.616148,406.923119,523.186868,145.041921,2,0
0,0,14,14,16,21,37,52,50,102,0.000333,0.177121,16,8501.827893,472.323772,531.364243,156.238666,2,0
0,0,17,17,16,21,37,63,62,125,0.000333,0.217061,16,10418.90673,578.828152,651.181671,156.238666,2,0
0,0,16,16,12,17,29,59,56,115,0.000333,0.186223,18,10056.02066,558.667814,558.667814,112.506418,2,0
0,0,18,18,15,20,35,67,61,128,0.000333,0.218849,21,13787.51275,765.972931,656.548226,145.041921,3,0
0,0,10,10,14,16,30,37,28,65,0.000333,0.106316,7,2232.635221,124.03529,318.947889,117.302969,3,0
0,0,16,16,12,17,29,59,56,115,0.000333,0.186223,18,10056.02066,558.667814,558.667814,112.506418,2,0
0,0,18,18,15,20,35,67,61,128,0.000333,0.218849,21,13787.51275,765.972931,656.548226,145.041921,3,0
0,0,10,10,14,16,30,37,28,65,0.000333,0.106316,7,2232.635221,124.03529,318.947889,117.302969,3,0
0,0,16,16,12,17,29,59,56,115,0.000333,0.186223,18,10056.02066,558.667814,558.667814,112.506418,2,0
0,0,18,18,15,20,35,67,61,128,0.000333,0.218849,21,13787.51275,765.972931,656.548226,145.041921,3,0
0,0,10,10,14,16,30,37,28,65,0.000333,0.106316,7,2232.635221,124.03529,318.947889,117.302969,3,0
0,0,16,16,12,17,29,59,56,115,0.000333,0.186223,18,10056.02066,558.667814,558.667814,112.506418,2,0
0,0,18,18,15,20,35,67,61,128,0.000333,0.218849,21,13787.51275,765.972931,656.548226,145.041921,3,0
0,0,10,10,14,16,30,37,28,65,0.000333,0.106316,7,2232.635221,124.03529,318.947889,117.302969,3,0
0,0,12,12,11,18,29,44,48,92,0.000333,0.148978,10,4469.342516,248.296806,446.934252,113.112398,2,0
0,0,19,19,15,21,36,69,66,135,0.000333,0.232647,21,14656.73738,814.263188,697.939875,150.842025,3,0
0,0,21,21,17,24,41,77,71,148,0.000333,0.264306,16,12686.68315,704.81573,792.917697,179.525968,4,0
0,0,12,12,12,17,29,45,47,92,0.000333,0.148978,12,5363.211019,297.956168,446.934252,112.506418,2,0
0,0,10,10,13,16,29,33,27,60,0.000333,0.09716,6,1748.873158,97.15962,291.47886,112.105716,3,0
0,0,19,19,14,21,35,68,66,134,0.000333,0.229108,21,14433.80241,801.877912,687.323924,145.541635,3,0
0,0,21,21,17,24,41,76,71,147,0.000333,0.26252,16,12600.96232,700.053462,787.560145,179.525968,4,0
0,0,12,12,12,17,29,45,47,92,0.000333,0.148978,12,5363.211019,297.956168,446.934252,112.506418,2,0
0,0,10,10,13,16,29,32,27,59,0.000333,0.09554,6,1719.725272,95.540293,286.620879,112.105716,3,0
0,0,7,7,8,13,21,18,25,43,0.000333,0.062957,4,755.478597,41.971033,188.869649,72.105716,1,0
0,0,7,7,9,14,23,18,24,42,0.000333,0.06333,4,759.958409,42.219912,189.989602,81.832294,1,0
0,0,8,8,9,17,26,28,34,62,0.000333,0.097142,8,2331.4181,129.523228,291.427263,98.016193,1,0
0,0,10,10,13,20,33,36,39,75,0.000333,0.12611,6,2269.977354,126.109853,378.329559,134.544278,2,0
0,0,7,7,11,14,25,28,25,53,0.000333,0.082041,5,1230.62189,68.367883,246.124378,91.356717,2,0
0,0,4,4,8,9,17,14,14,28,0.000333,0.03815,4,457.795838,25.433102,114.44896,52.529325,1,0
0,0,18,18,15,18,33,68,51,119,0.000333,0.200094,14,8403.960603,466.8867,600.2829,133.662009,3,0
0,0,21,21,18,21,39,81,59,140,0.000333,0.246652,18,13319.21359,739.956311,739.956311,167.297316,4,0
0,0,15,15,15,18,33,53,38,91,0.000333,0.153013,14,6426.558108,357.031006,459.039865,133.662009,3,0
0,0,18,18,15,18,33,68,51,119,0.000333,0.200094,14,8403.960603,466.8867,600.2829,133.662009,3,0
0,0,21,21,18,21,39,81,59,140,0.000333,0.246652,18,13319.21359,739.956311,739.956311,167.297316,4,0
0,0,15,15,15,17,32,53,38,91,0.000333,0.151667,14,6370,353.888889,455,128.090227,3,0
0,0,13,13,12,14,26,64,42,106,0.000333,0.166082,18,8968.438982,498.24661,498.24661,96.322519,2,0
0,0,16,16,16,17,33,77,50,127,0.000333,0.213546,16,10250.20885,569.456047,640.638053,133.486868,3,0
0,0,15,15,13,19,32,55,66,121,0.000333,0.201667,18,10890,605,605,128.816339,2,0
0,0,9,9,13,16,29,37,30,67,0.000333,0.108495,6,1952.90836,108.494909,325.484727,112.105716,2,0
0,0,19,19,16,22,38,85,64,149,0.000333,0.260647,16,12511.05919,695.058844,781.9412,162.107496,2,0
0,0,9,9,13,17,30,37,30,67,0.000333,0.109587,6,1972.570019,109.587223,328.76167,117.592585,2,0
0,0,10,10,10,17,27,41,34,75,0.000333,0.118872,10,3566.165627,198.120313,356.616563,102.706149,1,0
0,0,10,10,11,18,29,41,33,74,0.000333,0.11983,5,1797.452968,99.858498,359.490594,113.112398,1,0
0,0,20,20,15,23,38,85,67,152,0.000333,0.265895,14,11167.58975,620.421653,797.684982,162.645284,2,0
0,0,9,9,13,17,30,39,30,69,0.000333,0.112858,6,2031.452707,112.858484,338.575451,117.592585,2,0
0,0,17,17,15,23,38,71,57,128,0.000333,0.223912,14,9404.286104,522.460339,671.734722,162.645284,2,0
0,0,13,13,12,16,28,45,35,80,0.000333,0.128196,12,4615.060725,256.392263,384.588394,107.01955,3,0
0,0,16,16,15,19,34,58,43,101,0.000333,0.171278,14,7193.672458,399.64847,513.833747,139.313982,4,0
0,0,13,13,11,16,27,44,35,79,0.000333,0.125212,10,3756.361127,208.686729,375.636113,102.053748,3,0
0,0,16,16,15,19,34,57,43,100,0.000333,0.169582,14,7122.447978,395.691554,508.746284,139.313982,4,0
0,0,7,7,11,11,22,35,25,60,0.000333,0.089189,10,2675.658971,148.647721,267.565897,76.107496,1,0
0,0,10,10,15,14,29,48,33,81,0.000333,0.131165,14,5508.950448,306.052803,393.496461,111.906328,2,0
0,0,13,13,10,17,27,48,66,114,0.000333,0.180686,15,8130.857629,451.714313,542.057175,102.706149,1,0
0,0,15,15,14,20,34,56,71,127,0.000333,0.215369,21,13568.2634,753.792411,646.107781,139.741531,2,0
0,0,9,9,16,17,33,40,29,69,0.000333,0.116021,8,2784.505554,154.694753,348.063194,133.486868,4,0
0,0,8,8,14,18,32,37,27,64,0.000333,0.106667,7,2240,124.444444,320,128.361619,4,0
0,0,9,9,14,18,32,38,29,67,0.000333,0.111667,7,2345,130.277778,335,128.361619,4,0
0,0,7,7,12,11,23,22,18,40,0.000333,0.060314,6,1085.654869,60.314159,180.942478,81.073298,2,0
0,0,10,10,11,20,31,37,39,76,0.000333,0.125506,5,1882.594598,104.588589,376.51892,124.49231,3,0
0,0,11,11,11,20,31,38,41,79,0.000333,0.130461,10,3913.815085,217.434171,391.381509,124.49231,3,0
0,0,10,10,14,23,37,42,43,85,0.000333,0.147601,7,3099.624753,172.201375,442.803536,157.344894,4,0
0,0,11,11,14,23,37,43,45,88,0.000333,0.152811,7,3209.023273,178.279071,458.431896,157.344894,4,0
0,0,10,10,14,23,37,42,43,85,0.000333,0.147601,7,3099.624753,172.201375,442.803536,157.344894,4,0
0,0,11,11,14,23,37,43,45,88,0.000333,0.152811,7,3209.023273,178.279071,458.431896,157.344894,4,0
0,0,12,12,16,23,39,48,51,99,0.000333,0.174418,16,8372.077115,465.115395,523.25482,168.041925,5,0
0,0,12,12,16,23,39,48,51,99,0.000333,0.174418,16,8372.077115,465.115395,523.25482,168.041925,5,0
0,0,10,10,12,17,29,30,37,67,0.000333,0.108495,12,3905.81672,216.989818,325.484727,112.506418,3,0
0,0,12,12,16,19,35,49,42,91,0.000333,0.155588,16,7468.236073,414.902004,466.764755,144.710623,5,0
0,0,10,10,14,19,33,43,37,80,0.000333,0.134517,7,2824.860707,156.936706,403.55153,134.013592,4,0
0,0,11,11,14,19,33,44,39,83,0.000333,0.139562,14,5861.585967,325.643665,418.684712,134.013592,4,0
0,0,12,12,16,19,35,49,42,91,0.000333,0.155588,16,7468.236073,414.902004,466.764755,144.710623,5,0
0,0,10,10,14,19,33,43,37,80,0.000333,0.134517,7,2824.860707,156.936706,403.55153,134.013592,4,0
0,0,11,11,14,19,33,44,39,83,0.000333,0.139562,14,5861.585967,325.643665,418.684712,134.013592,4,0
0,0,10,10,12,13,25,31,28,59,0.000333,0.091329,12,3287.850182,182.658343,273.987515,91.125266,3,0
0,0,12,12,12,22,34,40,46,86,0.000333,0.145841,12,5250.261652,291.681203,437.521804,141.127046,2,0
0,0,13,13,12,22,34,41,48,89,0.000333,0.150928,12,5433.410314,301.856129,452.784193,141.127046,2,0
0,0,13,13,14,25,39,45,49,94,0.000333,0.165609,7,3477.79466,193.210814,496.827809,169.399374,3,0
0,0,14,14,14,25,39,46,51,97,0.000333,0.170895,14,7177.576213,398.754234,512.684015,169.399374,3,0
0,0,36,36,21,56,77,146,131,277,0.000333,0.578633,20,34717.99744,1928.777635,1735.899872,417.450542,11,0
0,0,35,35,21,56,77,145,129,274,0.000333,0.572367,20,34341.99024,1907.888347,1717.099512,417.450542,11,0
0,0,15,15,10,18,28,51,66,117,0.000333,0.187487,15,8436.907888,468.717105,562.460526,108.277931,2,0
0,0,18,18,14,21,35,64,74,138,0.000333,0.235947,21,14864.66218,825.814566,707.841056,145.541635,3,0
0,0,10,10,13,18,31,41,33,74,0.000333,0.122204,6,2199.663162,122.203509,366.610527,123.164366,2,0
0,0,15,15,12,18,30,49,47,96,0.000333,0.15702,12,5652.737966,314.040998,471.061497,118.0782,2,0
0,0,18,18,16,21,37,62,55,117,0.000333,0.203169,16,9752.0967,541.78315,609.506044,156.238666,3,0
0,0,22,22,20,43,63,101,76,177,0.000333,0.35266,10,10579.78547,587.765859,1057.978546,319.767946,9,0
0,0,21,21,20,43,63,100,74,174,0.000333,0.346682,10,10400.46707,577.803726,1040.046707,319.767946,9,0
0,0,32,32,21,54,75,136,111,247,0.000333,0.512839,20,30770.36433,1709.464685,1538.518217,403.002591,11,0
0,0,31,31,21,54,75,135,109,244,0.000333,0.506611,20,30396.63521,1688.701956,1519.83176,403.002591,11,0
0,0,16,16,11,19,30,51,57,108,0.000333,0.176648,15,7949.162765,441.620154,529.944184,118.764371,2,0
0,0,19,19,15,22,37,64,65,129,0.000333,0.224006,14,9408.272778,522.681821,672.019484,156.710855,3,0
0,0,10,10,13,18,31,41,33,74,0.000333,0.122204,6,2199.663162,122.203509,366.610527,123.164366,2,0
0,0,34,34,21,55,76,141,121,262,0.000333,0.545652,20,32739.14017,1818.841121,1636.957009,410.21345,11,0
0,0,33,33,21,55,76,140,119,259,0.000333,0.539404,20,32364.26452,1798.014696,1618.213226,410.21345,11,0
0,0,18,18,11,20,31,56,69,125,0.000333,0.206425,15,9289.118082,516.062116,619.274539,124.49231,2,0
0,0,21,21,15,23,38,69,77,146,0.000333,0.255399,21,16090.14576,893.896986,766.197417,162.645284,3,0
0,0,10,10,13,18,31,41,33,74,0.000333,0.122204,6,2199.663162,122.203509,366.610527,123.164366,2,0
0,0,32,32,21,55,76,144,108,252,0.000333,0.524826,10,15744.77733,874.709852,1574.477733,410.21345,11,0
0,0,31,31,21,55,76,143,106,249,0.000333,0.518578,10,15557.33951,864.296639,1555.733951,410.21345,11,0
0,0,16,16,13,20,33,59,52,111,0.000333,0.186643,12,6719.132967,373.285165,559.927747,134.544278,2,0
0,0,19,19,16,23,39,72,60,132,0.000333,0.232558,16,11162.76949,620.15386,697.673093,168.041925,3,0
0,0,10,10,13,18,31,42,33,75,0.000333,0.123855,6,2229.38834,123.854908,371.564723,123.164366,2,0
0,0,22,22,19,44,63,100,75,175,0.000333,0.348675,9,9414.21588,523.011993,1046.023987,320.925614,9,0
0,0,21,21,19,44,63,99,73,172,0.000333,0.342697,9,9252.829322,514.046073,1028.092147,320.925614,9,0
0,0,9,9,10,15,25,36,30,66,0.000333,0.102165,10,3064.945085,170.274727,306.494509,91.82264,2,0
0,0,12,12,14,18,32,49,38,87,0.000333,0.145,14,6090,338.333333,435,128.361619,3,0
0,0,10,10,13,18,31,41,33,74,0.000333,0.122204,6,2199.663162,122.203509,366.610527,123.164366,2,0
0,0,15,15,16,17,33,69,48,117,0.000333,0.196731,16,9443.105791,524.616988,590.194112,133.486868,3,0
0,0,18,18,18,20,38,82,56,138,0.000333,0.241405,18,13035.85194,724.213997,724.213997,161.497212,4,0
0,0,15,15,15,17,32,68,48,116,0.000333,0.193333,14,8120,451.111111,580,128.090227,3,0
0,0,18,18,18,20,38,81,56,137,0.000333,0.239655,18,12941.38925,718.966069,718.966069,161.497212,4,0
0,0,7,7,13,13,26,32,25,57,0.000333,0.089308,6,1607.550384,89.308355,267.925064,96.211433,2,0
0,0,10,10,13,15,28,46,35,81,0.000333,0.129799,12,4672.748984,259.597166,389.395749,106.709075,2,0
0,0,13,13,17,18,35,59,43,102,0.000333,0.174396,16,8370.989884,465.054994,523.186868,144.545518,3,0
0,0,7,7,13,14,27,32,26,58,0.000333,0.091928,6,1654.700851,91.927825,275.783475,101.408685,2,0
0,0,12,12,17,17,34,57,40,97,0.000333,0.164495,16,7895.74233,438.652352,493.483896,138.973737,3,0
0,0,7,7,10,15,25,23,24,47,0.000333,0.072754,5,1091.306205,60.628122,218.261241,91.82264,1,0
0,0,6,6,9,9,18,16,14,30,0.000333,0.041699,4,500.391,27.7995,125.09775,57.05865,1,0
0,0,7,7,11,14,25,24,23,47,0.000333,0.072754,5,1091.306205,60.628122,218.261241,91.356717,1,0
0,0,17,17,15,18,33,69,71,140,0.000333,0.235405,21,14830.51871,823.917706,706.215177,133.662009,1,0
0,0,20,20,19,20,39,82,79,161,0.000333,0.28365,27,22975.64345,1276.424636,850.949757,167.149185,2,0
0,0,23,23,17,45,62,105,79,184,0.000333,0.365191,8,8764.576969,486.920943,1095.572121,316.620258,9,0
0,0,22,22,17,45,62,104,77,181,0.000333,0.359237,8,8621.676257,478.982014,1077.709532,316.620258,9,0
0,0,23,23,18,44,62,106,78,184,0.000333,0.365191,9,9860.14909,547.786061,1095.572121,315.273641,9,0
0,0,22,22,18,44,62,105,76,181,0.000333,0.359237,9,9699.38579,538.854766,1077.709532,315.273641,9,0
0,0,10,10,15,19,34,41,31,72,0.000333,0.122099,7,2564.081272,142.44896,366.297325,139.313982,4,0
0,0,11,11,15,19,34,42,33,75,0.000333,0.127187,7,2670.917992,148.384333,381.559713,139.313982,4,0
0,0,8,8,12,17,29,28,33,61,0.000333,0.098779,6,1778.021044,98.778947,296.336841,112.506418,2,0
0,0,8,8,13,18,31,29,39,68,0.000333,0.112295,12,4042.624189,224.590233,336.885349,123.164366,2,0
0,0,10,10,13,21,34,36,35,71,0.000333,0.120403,6,2167.25917,120.403287,361.209862,140.344382,2,0
0,0,11,11,13,21,34,37,37,74,0.000333,0.125491,6,2258.833502,125.49075,376.47225,140.344382,2,0
0,0,11,11,15,23,38,41,39,80,0.000333,0.139945,7,2938.839408,163.268856,419.834201,162.645284,3,0
0,0,12,12,15,23,38,42,41,83,0.000333,0.145193,7,3049.045885,169.391438,435.577984,162.645284,3,0
0,0,16,16,16,18,34,71,50,121,0.000333,0.205194,16,9849.328061,547.184892,615.583004,139.05865,3,0
0,0,19,19,18,20,38,84,58,142,0.000333,0.248402,18,13413.70272,745.205707,745.205707,161.497212,4,0
0,0,10,10,14,14,28,42,30,72,0.000333,0.115377,14,4845.813761,269.211876,346.129554,106.605938,2,0
0,0,16,16,15,18,33,70,50,120,0.000333,0.201776,14,8474.582121,470.810118,605.327294,133.662009,3,0
0,0,19,19,18,20,38,83,58,141,0.000333,0.246653,18,13319.24003,739.957779,739.957779,161.497212,4,0
0,0,10,10,14,14,28,42,30,72,0.000333,0.115377,14,4845.813761,269.211876,346.129554,106.605938,2,0
0,0,15,15,15,19,34,64,52,116,0.000333,0.196715,14,8262.039654,459.002203,590.14569,139.313982,3,0
0,0,15,15,15,19,34,63,52,115,0.000333,0.195019,14,8190.815174,455.045287,585.058227,139.313982,3,0
0,0,27,27,21,48,69,120,90,210,0.000333,0.427597,10,12827.90136,712.661187,1282.790136,360.316866,10,0
0,0,26,26,21,48,69,119,88,207,0.000333,0.421488,10,12644.64563,702.480313,1264.464563,360.316866,10,0
0,0,17,17,12,22,34,62,71,133,0.000333,0.225544,18,12179.38604,676.632558,676.632558,141.127046,4,0
0,0,14,14,9,17,26,41,63,104,0.000333,0.162949,12,5866.148768,325.897154,488.845731,98.016193,2,0
0,0,17,17,14,24,38,65,78,143,0.000333,0.250151,21,15759.52632,875.52924,750.453634,163.342069,4,0
0,0,17,17,13,19,32,74,63,137,0.000333,0.228333,18,12330,685,685,128.816339,2,0
0,0,20,20,16,21,37,87,71,158,0.000333,0.274365,24,19754.24716,1097.458176,823.093632,156.238666,3,0
0,0,10,10,15,14,29,45,31,76,0.000333,0.123069,14,5168.891779,287.160654,369.206556,111.906328,2,0
0,0,17,17,13,19,32,74,63,137,0.000333,0.228333,18,12330,685,685,128.816339,2,0
0,0,20,20,16,21,37,87,71,158,0.000333,0.274365,24,19754.24716,1097.458176,823.093632,156.238666,3,0
0,0,10,10,15,14,29,45,31,76,0.000333,0.123069,14,5168.891779,287.160654,369.206556,111.906328,2,0
0,0,6,6,9,10,19,17,15,32,0.000333,0.045311,4,543.734722,30.207485,135.93368,61.748606,2,0
0,0,12,12,16,18,34,59,41,100,0.000333,0.169582,16,8139.940546,452.218919,508.746284,139.05865,6,0
0,0,13,13,11,14,25,52,41,93,0.000333,0.14396,10,4318.786256,239.93257,431.878626,91.356717,1,0
0,0,16,16,15,17,32,65,49,114,0.000333,0.19,14,7980,443.333333,570,128.090227,2,0
0,0,12,12,14,16,30,42,32,74,0.000333,0.121037,14,5083.538657,282.418814,363.109904,117.302969,2,0
0,0,11,11,14,16,30,40,30,70,0.000333,0.114494,7,2404.376392,133.576466,343.482342,117.302969,2,0
0,0,13,13,10,14,24,49,41,90,0.000333,0.137549,10,4126.466251,229.248125,412.646625,86.52225,1,0
0,0,16,16,14,17,31,62,49,111,0.000333,0.183305,14,7698.821066,427.712281,549.91579,122.789837,2,0
0,0,9,9,14,15,29,38,29,67,0.000333,0.108495,7,2278.393087,126.577394,325.484727,111.906328,2,0
0,0,13,13,14,16,30,45,36,81,0.000333,0.132486,14,5564.413935,309.134108,397.458138,117.302969,2,0
0,0,12,12,14,16,30,43,34,77,0.000333,0.125944,14,5289.628062,293.868226,377.830576,117.302969,2,0
0,0,14,14,11,19,30,51,46,97,0.000333,0.158656,10,4759.683878,264.426882,475.968388,118.764371,1,0
0,0,17,17,15,22,37,64,54,118,0.000333,0.204905,14,8606.01696,478.112053,614.715497,156.710855,2,0
0,0,9,9,14,15,29,38,29,67,0.000333,0.108495,7,2278.393087,126.577394,325.484727,111.906328,2,0
0,0,13,13,15,18,33,46,37,83,0.000333,0.139562,14,5861.585967,325.643665,418.684712,133.662009,2,0
0,0,12,12,15,18,33,44,35,79,0.000333,0.132836,7,2789.549948,154.974997,398.507135,133.662009,2,0
0,0,16,16,12,20,32,69,53,122,0.000333,0.203333,12,7320,406.666667,610,129.458112,1,0
0,0,19,19,16,22,38,82,61,143,0.000333,0.250151,16,12007.25815,667.069897,750.453634,162.107496,2,0
0,0,10,10,15,14,29,45,31,76,0.000333,0.123069,14,5168.891779,287.160654,369.206556,111.906328,2,0
0,0,12,12,15,20,35,47,39,86,0.000333,0.147039,7,3087.828376,171.546021,441.118339,145.041921,4,0
0,0,13,13,15,20,35,48,41,89,0.000333,0.152169,14,6391.086639,355.060369,456.506189,145.041921,4,0
0,0,12,12,16,22,38,47,38,85,0.000333,0.148691,8,3568.590709,198.255039,446.073839,162.107496,4,0
0,0,13,13,16,22,38,48,40,88,0.000333,0.153939,8,3694.540969,205.252276,461.817621,162.107496,4,0
0,0,11,11,15,20,35,44,33,77,0.000333,0.131652,7,2764.683546,153.59353,394.954792,145.041921,4,0
0,0,12,12,15,20,35,45,35,80,0.000333,0.136781,7,2872.398489,159.577694,410.342641,145.041921,4,0
0,0,10,10,14,19,33,38,39,77,0.000333,0.129473,14,5437.856861,302.103159,388.418347,134.013592,2,0
0,0,15,15,15,23,38,65,55,120,0.000333,0.209917,14,8816.518223,489.806568,629.751302,162.645284,4,0
0,0,12,12,11,18,29,44,43,87,0.000333,0.140881,10,4226.443466,234.802415,422.644347,113.112398,2,0
0,0,14,14,15,23,38,61,54,115,0.000333,0.201171,14,8449.163297,469.397961,603.511664,162.645284,3,0
0,0,14,14,12,16,28,57,48,105,0.000333,0.168257,18,9085.900803,504.772267,504.772267,107.01955,2,0
0,0,16,16,15,18,33,65,53,118,0.000333,0.198413,14,8333.339085,462.963283,595.238506,133.662009,3,0
0,0,14,14,12,16,28,57,48,105,0.000333,0.168257,18,9085.900803,504.772267,504.772267,107.01955,2,0
0,0,16,16,15,18,33,65,53,118,0.000333,0.198413,14,8333.339085,462.963283,595.238506,133.662009,3,0
0,0,16,16,13,18,31,62,51,113,0.000333,0.186608,12,6717.890197,373.216122,559.824183,123.164366,2,0
0,0,18,18,16,20,36,70,56,126,0.000333,0.217137,16,10422.5688,579.0316,651.41055,150.438562,3,0
0,0,16,16,13,17,30,62,51,113,0.000333,0.184826,18,9980.615471,554.478637,554.478637,117.592585,2,0
0,0,18,18,16,19,35,70,56,126,0.000333,0.21543,16,10340.63456,574.479698,646.28966,144.710623,3,0
0,0,14,14,13,17,30,58,49,107,0.000333,0.175012,12,6300.447525,350.024862,525.037294,117.592585,2,0
0,0,16,16,15,19,34,66,54,120,0.000333,0.203499,14,8546.937573,474.829865,610.495541,139.313982,3,0
0,0,14,14,12,17,29,57,49,106,0.000333,0.171649,12,6179.351826,343.297324,514.945985,112.506418,2,0
0,0,16,16,15,19,34,65,54,119,0.000333,0.201803,14,8475.713094,470.87295,605.408078,139.313982,3,0
0,0,4,4,8,9,17,14,14,28,0.000333,0.03815,4,457.795838,25.433102,114.44896,52.529325,1,0
0,0,7,7,9,11,20,20,22,42,0.000333,0.060507,8,1452.16784,80.675991,181.52098,66.583073,1,0
0,0,6,6,8,11,19,18,20,38,0.000333,0.053807,4,645.684982,35.871388,161.421246,62.053748,1,0
0,0,7,7,10,13,23,21,22,43,0.000333,0.064838,5,972.565821,54.031434,194.513164,81.324997,1,0
0,0,6,6,9,13,22,19,20,39,0.000333,0.057973,4,695.671333,38.648407,173.917833,76.635041,1,0
0,0,8,8,10,16,26,36,32,68,0.000333,0.106543,10,3196.299008,177.572167,319.629901,97.219281,1,0
0,0,11,11,14,19,33,49,40,89,0.000333,0.14965,14,6285.315073,349.184171,448.951077,134.013592,2,0
0,0,10,10,14,17,31,46,34,80,0.000333,0.132112,14,5548.699868,308.261104,396.335705,122.789837,2,0
0,0,3,3,8,7,15,9,11,20,0.000333,0.026046,4,312.551248,17.363958,78.137812,43.651484,1,0
0,0,3,3,8,8,16,9,13,22,0.000333,0.029333,4,352,19.555556,88,48,1,0
0,0,3,3,11,10,21,14,16,30,0.000333,0.043923,5,658.847613,36.602645,131.769523,71.273029,1,0
0,0,3,3,8,8,16,9,13,22,0.000333,0.029333,4,352,19.555556,88,48,1,0
0,0,3,3,10,10,20,12,16,28,0.000333,0.040338,5,605.069933,33.614996,121.013987,66.438562,1,0
0,0,19,19,18,22,40,77,68,145,0.000333,0.257227,27,20835.34849,1157.519361,771.679574,173.166146,5,0
0,0,19,19,19,23,42,78,77,155,0.000333,0.278603,27,22566.84841,1253.713801,835.809201,184.752548,5,0
0,0,19,19,20,24,44,83,80,163,0.000333,0.296629,30,26696.62062,1483.14559,889.887354,196.477662,5,0
0,0,12,12,13,15,28,35,50,85,0.000333,0.136208,18,7355.253031,408.625168,408.625168,106.709075,1,0
0,0,12,12,14,16,30,38,53,91,0.000333,0.148842,21,9377.067928,520.948218,446.527044,117.302969,1,0
0,0,26,26,20,25,45,109,89,198,0.000333,0.362462,30,32621.60739,1812.311522,1087.386913,202.534967,7,0
0,0,16,16,18,20,38,54,63,117,0.000333,0.204669,27,16578.20302,921.011279,614.007519,161.497212,2,0
0,0,26,26,21,26,47,112,98,210,0.000333,0.388821,30,34993.90977,1944.106098,1166.463659,214.450099,7,0
0,0,15,15,12,20,32,48,44,92,0.000333,0.153333,12,5520,306.666667,460,129.458112,2,0
0,0,18,18,16,23,39,61,52,113,0.000333,0.199083,16,9556.007212,530.88929,597.250451,168.041925,3,0
0,0,10,10,14,15,29,40,29,69,0.000333,0.111734,7,2346.404821,130.355823,335.200689,111.906328,2,0
0,0,14,14,13,15,28,48,39,87,0.000333,0.139413,12,5018.878539,278.826585,418.239878,106.709075,2,0
0,0,17,17,16,18,34,61,47,108,0.000333,0.183149,16,8791.13579,488.396433,549.445987,139.05865,3,0
0,0,10,10,14,15,29,40,29,69,0.000333,0.111734,7,2346.404821,130.355823,335.200689,111.906328,2,0
0,0,5,5,9,14,23,21,18,39,0.000333,0.058806,4,705.675665,39.204204,176.418916,81.832294,2,0
0,0,6,6,9,14,23,22,20,42,0.000333,0.06333,4,759.958409,42.219912,189.989602,81.832294,2,0
0,0,9,9,11,13,24,37,28,65,0.000333,0.099341,10,2980.225625,165.56809,298.022563,86.159464,2,0
0,0,12,12,15,16,31,50,36,86,0.000333,0.14202,14,5964.852358,331.380687,426.060883,122.603359,3,0
0,0,10,10,14,16,30,42,31,73,0.000333,0.119401,7,2507.421094,139.301172,358.203013,117.302969,2,0
0,0,11,11,14,22,36,40,37,77,0.000333,0.132695,7,2786.589576,154.810532,398.084225,151.410465,3,0
0,0,12,12,14,22,36,41,39,80,0.000333,0.137865,7,2895.158001,160.842111,413.594,151.410465,3,0
0,0,12,12,17,24,41,48,42,90,0.000333,0.160727,8,3857.437443,214.30208,482.17968,179.525968,4,0
0,0,13,13,17,24,41,49,44,93,0.000333,0.166084,8,3986.018691,221.445483,498.252336,179.525968,4,0
0,0,15,15,15,18,33,55,49,104,0.000333,0.174872,14,7344.637838,408.035435,524.616988,133.662009,3,0
0,0,12,12,15,18,33,44,37,81,0.000333,0.136199,14,5720.342931,317.79683,408.595924,133.662009,3,0
0,0,15,15,15,18,33,54,49,103,0.000333,0.173191,14,7274.01632,404.112018,519.572594,133.662009,3,0
0,0,12,12,15,18,33,43,37,80,0.000333,0.134517,14,5649.721414,313.873412,403.55153,133.662009,3,0
0,0,28,28,22,49,71,123,91,214,0.000333,0.438682,11,14476.50472,804.250262,1316.045884,373.228278,11,0
0,0,27,27,22,49,71,122,89,211,0.000333,0.432532,11,14273.56306,792.975726,1297.596642,373.228278,11,0
0,0,28,28,22,49,71,123,91,214,0.000333,0.438682,11,14476.50472,804.250262,1316.045884,373.228278,11,0
0,0,27,27,22,49,71,122,89,211,0.000333,0.432532,11,14273.56306,792.975726,1297.596642,373.228278,11,0
0,0,18,18,17,19,36,79,53,132,0.000333,0.227477,16,10918.8816,606.604534,682.4301,150.197491,3,0
0,0,21,21,19,22,41,92,61,153,0.000333,0.273235,18,14754.69822,819.705457,819.705457,178.818118,4,0
0,0,10,10,14,14,28,42,30,72,0.000333,0.115377,14,4845.813761,269.211876,346.129554,106.605938,2,0
0,0,15,15,15,16,31,68,47,115,0.000333,0.189911,14,7976.25606,443.125337,569.732576,122.603359,3,0
0,0,18,18,18,19,37,81,55,136,0.000333,0.236162,18,12752.74184,708.485658,708.485658,155.769273,4,0
0,0,15,15,15,16,31,68,47,115,0.000333,0.189911,14,7976.25606,443.125337,569.732576,122.603359,3,0
0,0,18,18,18,19,37,81,55,136,0.000333,0.236162,18,12752.74184,708.485658,708.485658,155.769273,4,0
0,0,9,9,10,12,22,31,29,60,0.000333,0.089189,10,2675.658971,148.647721,267.565897,76.238831,1,0
0,0,9,9,10,12,22,31,29,60,0.000333,0.089189,10,2675.658971,148.647721,267.565897,76.238831,1,0
0,0,17,17,16,19,35,58,51,109,0.000333,0.186364,16,8945.469582,496.970532,559.091849,144.710623,3,0
0,0,14,14,16,19,35,47,39,86,0.000333,0.147039,16,7057.893431,392.105191,441.118339,144.710623,3,0
0,0,17,17,16,18,34,58,51,109,0.000333,0.184844,16,8872.535195,492.918622,554.53345,139.05865,3,0
0,0,14,14,16,18,34,47,39,86,0.000333,0.145841,16,7000.34887,388.908271,437.521804,139.05865,3,0
0,0,15,15,15,18,33,55,49,104,0.000333,0.174872,14,7344.637838,408.035435,524.616988,133.662009,3,0
0,0,12,12,15,18,33,44,37,81,0.000333,0.136199,14,5720.342931,317.79683,408.595924,133.662009,3,0
0,0,15,15,15,18,33,54,49,103,0.000333,0.173191,14,7274.01632,404.112018,519.572594,133.662009,3,0
0,0,12,12,15,18,33,43,37,80,0.000333,0.134517,14,5649.721414,313.873412,403.55153,133.662009,3,0
0,0,17,17,16,19,35,59,51,110,0.000333,0.188074,16,9027.53811,501.529895,564.221132,144.710623,3,0
0,0,14,14,16,19,35,48,39,87,0.000333,0.148749,16,7139.96196,396.664553,446.247622,144.710623,3,0
0,0,17,17,16,18,34,59,51,110,0.000333,0.18654,16,8953.934601,497.440811,559.620913,139.05865,3,0
0,0,14,14,16,18,34,48,39,87,0.000333,0.147536,16,7081.748275,393.43046,442.609267,139.05865,3,0
0,0,17,17,14,22,36,61,66,127,0.000333,0.21886,21,13788.18998,766.010554,656.580475,151.410465,2,0
0,0,13,13,14,20,34,46,51,97,0.000333,0.164495,14,6908.774538,383.820808,493.483896,139.741531,2,0
0,0,14,14,11,19,30,49,58,107,0.000333,0.175012,15,7875.559406,437.531078,525.037294,118.764371,1,0
0,0,16,16,15,22,37,57,63,120,0.000333,0.208378,14,8751.881654,486.215647,625.134404,156.710855,2,0
0,0,9,9,8,14,22,25,33,58,0.000333,0.086216,8,2069.176271,114.954237,258.647034,77.302969,1,0
0,0,8,8,11,17,28,33,33,66,0.000333,0.105762,5,1586.427124,88.13484,317.285425,107.540616,1,0
0,0,10,10,15,20,35,41,38,79,0.000333,0.135071,7,2836.493508,157.582973,405.213358,145.041921,2,0
0,0,5,5,6,11,17,10,15,25,0.000333,0.034062,3,306.559713,17.031095,102.186571,53.563523,1,0
0,0,18,18,12,22,34,64,66,130,0.000333,0.220457,18,11904.66305,661.370169,661.370169,141.127046,1,0
0,0,20,20,16,25,41,72,71,143,0.000333,0.255377,16,12258.07899,681.004388,766.129937,180.096405,2,0
0,0,11,11,15,18,33,41,34,75,0.000333,0.12611,7,2648.306913,147.128162,378.329559,133.662009,2,0
0,0,15,15,13,18,31,61,44,105,0.000333,0.173397,12,6242.287351,346.793742,520.190613,123.164366,2,0
0,0,18,18,16,20,36,74,52,126,0.000333,0.217137,16,10422.5688,579.0316,651.41055,150.438562,3,0
0,0,15,15,13,17,30,61,44,105,0.000333,0.171741,12,6182.68215,343.482342,515.223513,117.592585,2,0
0,0,18,18,16,19,35,74,52,126,0.000333,0.21543,16,10340.63456,574.479698,646.28966,144.710623,3,0
0,0,19,19,14,18,32,91,60,151,0.000333,0.251667,21,15855,880.833333,755,128.361619,2,0
0,0,22,22,16,20,36,104,68,172,0.000333,0.296409,24,21341.45041,1185.636134,889.2271,150.438562,3,0
0,0,9,9,14,15,29,38,29,67,0.000333,0.108495,7,2278.393087,126.577394,325.484727,111.906328,2,0
0,0,15,15,15,19,34,64,52,116,0.000333,0.196715,14,8262.039654,459.002203,590.14569,139.313982,3,0
0,0,15,15,15,19,34,63,52,115,0.000333,0.195019,14,8190.815174,455.045287,585.058227,139.313982,3,0
0,0,16,16,18,20,38,69,57,126,0.000333,0.220413,18,11902.2996,661.238867,661.238867,161.497212,3,0
0,0,12,12,12,16,28,49,43,92,0.000333,0.147426,12,5307.319834,294.851102,442.276653,107.01955,2,0
0,0,15,15,15,19,34,61,52,113,0.000333,0.191628,14,8048.366215,447.131456,574.883301,139.313982,3,0
0,0,12,12,12,15,27,49,43,92,0.000333,0.145817,12,5249.395802,291.6331,437.44965,101.622909,2,0
0,0,15,15,15,18,33,61,52,113,0.000333,0.190006,14,7980.231497,443.346194,570.016535,133.662009,3,0
0,0,18,18,12,22,34,67,72,139,0.000333,0.235719,18,12728.83203,707.157335,707.157335,141.127046,1,0
0,0,20,20,16,24,40,75,77,152,0.000333,0.269644,24,19414.39369,1078.577427,808.93307,174.0391,2,0
0,0,7,7,10,14,24,27,31,58,0.000333,0.088643,10,2659.27825,147.737681,265.927825,86.52225,1,0
0,0,9,9,15,18,33,35,36,71,0.000333,0.119384,14,5014.127755,278.562653,358.151982,133.662009,2,0
0,0,7,7,11,16,27,30,31,61,0.000333,0.096683,5,1450.240688,80.568927,290.048138,102.053748,1,0
0,0,9,9,14,19,33,38,36,74,0.000333,0.124428,7,2612.996154,145.166453,373.285165,134.013592,2,0
0,0,12,12,14,18,32,56,42,98,0.000333,0.163333,14,6860,381.111111,490,128.361619,5,0
0,0,14,14,15,17,32,60,50,110,0.000333,0.183333,14,7700,427.777778,550,128.090227,2,0
0,0,17,17,15,17,32,77,51,128,0.000333,0.213333,21,13440,746.666667,640,128.090227,3,0
0,0,10,10,15,14,29,45,31,76,0.000333,0.123069,14,5168.891779,287.160654,369.206556,111.906328,2,0
0,0,17,17,15,17,32,77,51,128,0.000333,0.213333,21,13440,746.666667,640,128.090227,3,0
0,0,10,10,15,14,29,45,31,76,0.000333,0.123069,14,5168.891779,287.160654,369.206556,111.906328,2,0
0,0,5,5,9,14,23,21,18,39,0.000333,0.058806,4,705.675665,39.204204,176.418916,81.832294,2,0
0,0,6,6,9,14,23,22,20,42,0.000333,0.06333,4,759.958409,42.219912,189.989602,81.832294,2,0
0,0,9,9,11,13,24,37,28,65,0.000333,0.099341,10,2980.225625,165.56809,298.022563,86.159464,2,0
0,0,12,12,15,16,31,50,36,86,0.000333,0.14202,14,5964.852358,331.380687,426.060883,122.603359,3,0
0,0,10,10,14,16,30,42,31,73,0.000333,0.119401,7,2507.421094,139.301172,358.203013,117.302969,2,0
0,0,11,11,10,13,23,38,35,73,0.000333,0.110073,10,3302.200228,183.455568,330.220023,81.324997,1,0
0,0,13,13,14,19,33,56,47,103,0.000333,0.173191,14,7274.01632,404.112018,519.572594,134.013592,3,0
0,0,15,15,12,16,28,48,37,85,0.000333,0.136208,12,4903.50202,272.416779,408.625168,107.01955,3,0
0,0,18,18,16,19,35,61,45,106,0.000333,0.181235,16,8699.263997,483.292444,543.704,144.710623,4,0
0,0,15,15,12,16,28,48,37,85,0.000333,0.136208,12,4903.50202,272.416779,408.625168,107.01955,3,0
0,0,18,18,16,19,35,61,45,106,0.000333,0.181235,16,8699.263997,483.292444,543.704,144.710623,4,0
0,0,14,14,13,15,28,49,48,97,0.000333,0.155438,18,8393.641694,466.313427,466.313427,106.709075,2,0
0,0,16,16,17,18,35,57,53,110,0.000333,0.188074,16,9027.53811,501.529895,564.221132,144.545518,3,0
0,0,11,11,14,16,30,37,34,71,0.000333,0.11613,14,4877.449252,270.969403,348.389232,117.302969,2,0
0,0,15,15,14,15,29,52,49,101,0.000333,0.163552,21,10303.77769,572.432094,490.656081,111.906328,3,0
0,0,17,17,17,18,35,60,54,114,0.000333,0.194913,24,14033.71833,779.651019,584.738264,144.545518,4,0
0,0,12,12,14,17,31,40,35,75,0.000333,0.123855,14,5201.906126,288.994785,371.564723,122.789837,3,0
0,0,15,15,14,15,29,52,49,101,0.000333,0.163552,21,10303.77769,572.432094,490.656081,111.906328,3,0
0,0,17,17,17,18,35,60,54,114,0.000333,0.194913,24,14033.71833,779.651019,584.738264,144.545518,4,0
0,0,12,12,14,16,30,40,35,75,0.000333,0.122672,14,5152.235125,286.235285,368.016795,117.302969,3,0
0,0,13,13,14,17,31,61,45,106,0.000333,0.175048,14,7352.027325,408.445962,525.144809,122.789837,2,0
0,0,16,16,18,20,38,74,53,127,0.000333,0.222162,18,11996.7623,666.486794,666.486794,161.497212,3,0
0,0,12,12,13,16,29,56,40,96,0.000333,0.155455,12,5596.394106,310.910784,466.366176,112.105716,2,0
0,0,15,15,15,19,34,69,48,117,0.000333,0.198411,14,8333.264134,462.959119,595.233152,139.313982,3,0
0,0,12,12,12,16,28,55,40,95,0.000333,0.152233,12,5480.384611,304.465812,456.698718,107.01955,2,0
0,0,15,15,15,19,34,68,48,116,0.000333,0.196715,14,8262.039654,459.002203,590.14569,139.313982,3,0
0,0,17,17,16,21,37,83,57,140,0.000333,0.243108,16,11669.17554,648.28753,729.323471,156.238666,5,0
0,0,17,17,16,21,37,83,57,140,0.000333,0.243108,16,11669.17554,648.28753,729.323471,156.238666,5,0
0,0,9,9,10,13,23,32,30,62,0.000333,0.093487,10,2804.608413,155.811578,280.460841,81.324997,2,0
0,0,9,9,10,13,23,32,30,62,0.000333,0.093487,10,2804.608413,155.811578,280.460841,81.324997,2,0
0,0,7,7,8,13,21,18,25,43,0.000333,0.062957,4,755.478597,41.971033,188.869649,72.105716,1,0
0,0,7,7,9,14,23,18,24,42,0.000333,0.06333,4,759.958409,42.219912,189.989602,81.832294,1,0
0,0,7,7,9,17,26,24,31,55,0.000333,0.086175,4,1034.096738,57.449819,258.524184,98.016193,1,0
0,0,10,10,13,20,33,36,40,76,0.000333,0.127791,12,4600.487437,255.582635,383.373953,134.544278,2,0
0,0,15,15,14,22,36,47,54,101,0.000333,0.174054,14,7310.273952,406.126331,522.162425,151.410465,2,0
0,0,15,15,15,23,38,47,54,101,0.000333,0.17668,14,7420.569504,412.253861,530.040679,162.645284,2,0
0,0,16,16,11,21,32,50,64,114,0.000333,0.19,15,8550,475,570,130.292414,1,0
0,0,19,19,15,24,39,62,73,135,0.000333,0.237843,21,14984.11529,832.450849,713.5293,168.642459,2,0
0,0,15,15,14,16,30,67,48,115,0.000333,0.188097,21,11850.14079,658.341155,564.292418,117.302969,2,0
0,0,18,18,18,18,36,80,56,136,0.000333,0.23437,27,18983.96461,1054.6647,703.1098,150.1173,3,0
0,0,10,10,14,14,28,42,30,72,0.000333,0.115377,14,4845.813761,269.211876,346.129554,106.605938,2,0
0,0,20,20,17,42,59,91,73,164,0.000333,0.321584,8,7718.027681,428.779316,964.75346,295.9642,7,0
0,0,19,19,17,42,59,90,71,161,0.000333,0.315702,8,7576.844248,420.935792,947.105531,295.9642,7,0
0,0,5,5,11,14,25,18,19,37,0.000333,0.057274,5,859.113395,47.728522,171.822679,91.356717,2,0
0,0,5,5,13,14,27,22,21,43,0.000333,0.068153,6,1226.760976,68.153388,204.460163,101.408685,3,0
0,0,20,20,18,44,62,92,72,164,0.000333,0.325496,9,8788.393754,488.244097,976.488195,315.273641,7,0
0,0,19,19,18,44,62,91,70,161,0.000333,0.319542,9,8627.630454,479.312803,958.625606,315.273641,7,0
0,0,13,13,12,18,30,37,60,97,0.000333,0.158656,18,8567.43098,475.968388,475.968388,118.0782,2,0
0,0,12,12,14,17,31,39,60,99,0.000333,0.163488,21,10299.77413,572.209674,490.465435,122.789837,3,0
0,0,28,28,19,49,68,120,99,219,0.000333,0.444385,18,23996.77852,1333.154362,1333.154362,355.831405,9,0
0,0,27,27,19,49,68,119,97,216,0.000333,0.438297,9,11834.02776,657.445987,1314.891974,355.831405,9,0
0,0,29,29,21,52,73,125,104,229,0.000333,0.47249,20,28349.39648,1574.966471,1417.469824,388.661531,10,0
0,0,28,28,21,52,73,124,102,226,0.000333,0.4663,10,13989.0035,777.166861,1398.90035,388.661531,10,0
0,0,29,29,21,52,73,125,104,229,0.000333,0.47249,20,28349.39648,1574.966471,1417.469824,388.661531,10,0
0,0,28,28,21,52,73,124,102,226,0.000333,0.4663,10,13989.0035,777.166861,1398.90035,388.661531,10,0
0,0,9,9,12,17,29,37,30,67,0.000333,0.108495,6,1952.90836,108.494909,325.484727,112.506418,3,0
0,0,6,6,9,9,18,16,14,30,0.000333,0.041699,4,500.391,27.7995,125.09775,57.05865,1,0
0,0,9,9,13,16,29,38,29,67,0.000333,0.108495,6,1952.90836,108.494909,325.484727,112.105716,3,0
0,0,16,16,12,20,32,71,57,128,0.000333,0.213333,12,7680,426.666667,640,129.458112,1,0
0,0,19,19,16,22,38,84,65,149,0.000333,0.260647,16,12511.05919,695.058844,781.9412,162.107496,2,0
0,0,10,10,13,18,31,46,35,81,0.000333,0.133763,6,2407.739407,133.7633,401.289901,123.164366,2,0
0,0,15,15,12,16,28,49,37,86,0.000333,0.137811,12,4961.19028,275.621682,413.432523,107.01955,3,0
0,0,18,18,16,19,35,62,45,107,0.000333,0.182944,16,8781.332525,487.851807,548.833283,144.710623,4,0
0,0,10,10,14,15,29,40,29,69,0.000333,0.111734,7,2346.404821,130.355823,335.200689,111.906328,2,0
0,0,15,15,12,16,28,49,37,86,0.000333,0.137811,12,4961.19028,275.621682,413.432523,107.01955,3,0
0,0,18,18,16,19,35,62,45,107,0.000333,0.182944,16,8781.332525,487.851807,548.833283,144.710623,4,0
0,0,10,10,14,15,29,40,29,69,0.000333,0.111734,7,2346.404821,130.355823,335.200689,111.906328,2,0
0,0,19,19,16,18,34,78,60,138,0.000333,0.234023,24,16849.67693,936.093163,702.069872,139.05865,3,0
0,0,9,9,14,14,28,35,26,61,0.000333,0.09775,7,2052.740552,114.041142,293.24865,106.605938,2,0
0,0,19,19,16,18,34,78,60,138,0.000333,0.234023,24,16849.67693,936.093163,702.069872,139.05865,3,0
0,0,9,9,14,14,28,35,26,61,0.000333,0.09775,7,2052.740552,114.041142,293.24865,106.605938,2,0
0,0,20,20,17,41,58,91,71,162,0.000333,0.316331,8,7591.94337,421.774632,948.992921,289.1465,7,0
0,0,19,19,17,41,58,90,69,159,0.000333,0.310473,8,7451.351826,413.96399,931.418978,289.1465,7,0
0,0,20,20,18,43,61,92,71,163,0.000333,0.322237,9,8700.391674,483.355093,966.710186,308.388034,7,0
0,0,19,19,18,43,61,91,69,160,0.000333,0.316306,9,8540.261766,474.458987,948.917974,308.388034,7,0
0,0,4,4,8,9,17,14,14,28,0.000333,0.03815,4,457.795838,25.433102,114.44896,52.529325,1,0
0,0,13,13,12,14,26,55,39,94,0.000333,0.14728,12,5302.096002,294.560889,441.841334,96.322519,2,0
0,0,16,16,15,17,32,68,47,115,0.000333,0.191667,14,8050,447.222222,575,128.090227,3,0
0,0,13,13,15,17,32,54,37,91,0.000333,0.151667,14,6370,353.888889,455,128.090227,3,0
0,0,13,13,12,14,26,55,39,94,0.000333,0.14728,12,5302.096002,294.560889,441.841334,96.322519,2,0
0,0,16,16,15,17,32,68,47,115,0.000333,0.191667,14,8050,447.222222,575,128.090227,3,0
0,0,13,13,15,17,32,54,37,91,0.000333,0.151667,14,6370,353.888889,455,128.090227,3,0
0,0,10,10,18,17,35,36,42,78,0.000333,0.133361,18,7201.513356,400.084075,400.084075,144.545518,3,0
0,0,10,10,16,18,34,32,40,72,0.000333,0.122099,16,5860.757193,325.597622,366.297325,139.05865,2,0
0,0,7,7,12,15,27,38,29,67,0.000333,0.106192,6,1911.464776,106.192488,318.577463,101.622909,1,0
0,0,10,10,15,18,33,51,37,88,0.000333,0.147969,14,6214.693555,345.260753,443.906683,133.662009,2,0
0,0,7,7,10,10,20,22,19,41,0.000333,0.059066,5,885.995259,49.221959,177.199052,66.438562,1,0
0,0,6,6,9,10,19,20,17,37,0.000333,0.052391,4,628.693272,34.927404,157.173318,61.748606,1,0
0,0,7,7,11,11,22,23,20,43,0.000333,0.063919,5,958.777798,53.265433,191.75556,76.107496,1,0
0,0,6,6,10,11,21,21,18,39,0.000333,0.0571,5,856.501897,47.583439,171.300379,71.273029,1,0
0,0,4,4,9,8,17,15,13,28,0.000333,0.03815,4,457.795838,25.433102,114.44896,52.529325,1,0
0,0,10,10,12,15,27,41,28,69,0.000333,0.109362,6,1968.523426,109.362413,328.087238,101.622909,3,0
0,0,13,13,16,18,34,54,36,90,0.000333,0.152624,16,7325.946491,406.997027,457.871656,139.05865,4,0
0,0,11,11,13,16,29,45,29,74,0.000333,0.11983,6,2156.943562,119.830198,359.490594,112.105716,3,0
0,0,10,10,12,15,27,41,28,69,0.000333,0.109362,6,1968.523426,109.362413,328.087238,101.622909,3,0
0,0,13,13,16,18,34,54,36,90,0.000333,0.152624,16,7325.946491,406.997027,457.871656,139.05865,4,0
0,0,11,11,13,16,29,45,29,74,0.000333,0.11983,6,2156.943562,119.830198,359.490594,112.105716,3,0
0,0,13,13,9,17,26,50,63,113,0.000333,0.17705,12,6373.796258,354.099792,531.149688,98.016193,1,0
0,0,16,16,13,20,33,63,71,134,0.000333,0.225316,18,12167.07862,675.948812,675.948812,134.544278,2,0
0,0,10,10,13,17,30,45,35,80,0.000333,0.13085,12,4710.614972,261.700832,392.551248,117.592585,2,0
0,0,12,12,19,16,35,40,59,99,0.000333,0.169266,27,13710.5735,761.698528,507.799019,144.710623,3,0
0,0,12,12,17,17,34,36,57,93,0.000333,0.157711,24,11355.21706,630.845392,473.134044,138.973737,2,0
0,0,5,5,9,13,22,18,19,37,0.000333,0.055,4,659.99588,36.666438,164.99897,76.635041,2,0
0,0,6,6,9,14,23,19,21,40,0.000333,0.060314,4,723.769913,40.20944,180.942478,81.832294,2,0
0,0,5,5,10,15,25,19,19,38,0.000333,0.058822,5,882.332676,49.018482,176.466535,91.82264,2,0
0,0,6,6,10,16,26,20,21,41,0.000333,0.064239,5,963.590142,53.532786,192.718028,97.219281,2,0
0,0,11,11,12,20,32,38,39,77,0.000333,0.128333,6,2310,128.333333,385,129.458112,3,0
0,0,12,12,12,20,32,39,41,80,0.000333,0.133333,12,4800,266.666667,400,129.458112,3,0
0,0,12,12,15,23,38,46,43,89,0.000333,0.155689,7,3269.458841,181.636602,467.065549,162.645284,4,0
0,0,13,13,15,23,38,47,45,92,0.000333,0.160936,7,3379.665319,187.759184,482.809331,162.645284,4,0
0,0,7,7,12,12,24,33,28,61,0.000333,0.093228,12,3356.192551,186.455142,279.682713,86.0391,1,0
0,0,10,10,16,16,32,46,36,82,0.000333,0.136667,16,6560,364.444444,410,128,2,0
0,0,12,12,12,15,27,55,39,94,0.000333,0.148986,12,5363.513102,297.97295,446.959425,101.622909,2,0
0,0,15,15,15,18,33,68,47,115,0.000333,0.193368,14,8121.474532,451.19303,580.105324,133.662009,3,0
0,0,12,12,12,15,27,55,39,94,0.000333,0.148986,12,5363.513102,297.97295,446.959425,101.622909,2,0
0,0,15,15,15,18,33,68,47,115,0.000333,0.193368,14,8121.474532,451.19303,580.105324,133.662009,3,0
0,0,12,12,12,15,27,47,37,84,0.000333,0.133137,12,4792.926602,266.2737,399.41055,101.622909,2,0
0,0,15,15,14,18,32,60,45,105,0.000333,0.175,14,7350,408.333333,525,128.361619,3,0
0,0,9,9,14,15,29,38,29,67,0.000333,0.108495,7,2278.393087,126.577394,325.484727,111.906328,2,0
0,0,12,12,14,17,31,43,32,75,0.000333,0.123855,7,2600.953063,144.497392,371.564723,122.789837,3,0
0,0,10,10,14,15,29,37,28,65,0.000333,0.105256,7,2210.381353,122.798964,315.768765,111.906328,2,0
0,0,12,12,11,15,26,46,37,83,0.000333,0.130045,10,3901.364966,216.742498,390.136497,96.657107,2,0
0,0,15,15,14,18,32,59,45,104,0.000333,0.173333,14,7280,404.444444,520,128.361619,3,0
0,0,9,9,14,15,29,38,29,67,0.000333,0.108495,7,2278.393087,126.577394,325.484727,111.906328,2,0
0,0,12,12,14,17,31,42,32,74,0.000333,0.122204,7,2566.273689,142.57076,366.610527,122.789837,3,0
0,0,10,10,14,15,29,37,28,65,0.000333,0.105256,7,2210.381353,122.798964,315.768765,111.906328,2,0
0,0,9,9,12,16,28,38,31,69,0.000333,0.110569,6,1990.244938,110.569163,331.70749,107.01955,2,0
0,0,12,12,15,19,34,51,39,90,0.000333,0.152624,14,6410.20318,356.122399,457.871656,139.313982,3,0
0,0,10,10,14,19,33,43,34,77,0.000333,0.129473,7,2718.92843,151.051579,388.418347,134.013592,2,0
0,0,4,4,7,9,16,10,10,20,0.000333,0.026667,3,240,13.333333,80,48.180809,2,0
0,0,4,4,8,8,16,11,9,20,0.000333,0.026667,4,320,17.777778,80,48,2,0
0,0,12,12,14,20,34,48,37,85,0.000333,0.144145,7,3027.040391,168.168911,432.434342,139.741531,4,0
0,0,4,4,8,8,16,11,9,20,0.000333,0.026667,4,320,17.777778,80,48,2,0
0,0,12,12,14,19,33,48,37,85,0.000333,0.142925,7,3001.414501,166.74525,428.7735,134.013592,4,0
0,0,4,4,8,8,16,11,9,20,0.000333,0.026667,4,320,17.777778,80,48,2,0
0,0,9,9,11,13,24,29,22,51,0.000333,0.077944,5,1169.165438,64.953635,233.833088,86.159464,3,0
0,0,4,4,8,8,16,11,9,20,0.000333,0.026667,4,320,17.777778,80,48,2,0
0,0,9,9,11,12,23,29,22,51,0.000333,0.076901,5,1153.508299,64.083794,230.70166,81.073298,3,0
0,0,13,13,12,17,29,44,38,82,0.000333,0.132785,12,4780.253299,265.569628,398.354442,112.506418,3,0
0,0,16,16,15,20,35,57,46,103,0.000333,0.176105,14,7396.42611,410.912562,528.316151,145.041921,4,0
0,0,13,13,12,16,28,44,38,82,0.000333,0.131401,12,4730.437243,262.802069,394.203104,107.01955,3,0
0,0,16,16,15,19,34,57,46,103,0.000333,0.17467,14,7336.121417,407.562301,524.008673,139.313982,4,0
0,0,16,16,14,21,35,65,66,131,0.000333,0.223979,21,14110.65758,783.925421,671.936075,145.541635,1,0
0,0,18,18,18,23,41,73,71,144,0.000333,0.257162,27,20830.16219,1157.231233,771.487489,179.100575,2,0
0,0,12,12,16,22,38,47,38,85,0.000333,0.148691,8,3568.590709,198.255039,446.073839,162.107496,4,0
0,0,13,13,16,22,38,48,40,88,0.000333,0.153939,8,3694.540969,205.252276,461.817621,162.107496,4,0
0,0,12,12,17,22,39,51,39,90,0.000333,0.158562,8,3805.489598,211.416089,475.6862,167.594364,5,0
0,0,13,13,17,22,39,52,41,93,0.000333,0.163847,8,3932.339251,218.463292,491.542406,167.594364,5,0
0,0,21,21,18,44,62,104,79,183,0.000333,0.363206,9,9806.561323,544.808962,1089.617925,315.273641,9,0
0,0,21,21,18,45,63,104,81,185,0.000333,0.368599,9,9952.171073,552.898393,1105.796786,322.192039,9,0
0,0,11,11,12,22,34,39,39,78,0.000333,0.132274,6,2380.93261,132.274034,396.822102,141.127046,2,0
0,0,8,8,9,16,25,22,25,47,0.000333,0.072754,4,873.044964,48.502498,218.261241,92.529325,1,0
0,0,11,11,13,24,37,40,39,79,0.000333,0.137182,6,2469.280895,137.182272,411.546816,158.144816,2,0
0,0,14,14,10,20,30,50,51,101,0.000333,0.165199,10,4955.959502,275.331083,495.59595,119.657843,1,0
0,0,16,16,14,27,41,64,62,126,0.000333,0.225017,14,9450.721736,525.040096,675.051553,181.684931,2,0
0,0,22,22,19,44,63,99,77,176,0.000333,0.350667,9,9468.011399,526.000633,1052.001267,320.925614,9,0
0,0,21,21,19,44,63,98,75,173,0.000333,0.34469,9,9306.624841,517.034713,1034.069427,320.925614,9,0
0,0,10,10,11,17,28,37,32,69,0.000333,0.110569,5,1658.537448,92.140969,331.70749,107.540616,2,0
0,0,13,13,15,20,35,50,40,90,0.000333,0.153878,14,6462.896601,359.049811,461.635472,145.041921,3,0
0,0,10,10,14,15,29,40,29,69,0.000333,0.111734,7,2346.404821,130.355823,335.200689,111.906328,2,0
0,0,17,17,14,22,36,80,59,139,0.000333,0.23954,14,10060.67405,558.926336,718.619575,151.410465,5,0
0,0,17,17,16,24,40,83,62,145,0.000333,0.257227,16,12346.87318,685.937399,771.679574,174.0391,5,0
0,0,17,17,16,24,40,83,62,145,0.000333,0.257227,16,12346.87318,685.937399,771.679574,174.0391,5,0
0,0,8,8,10,15,25,25,29,54,0.000333,0.083589,5,1253.841171,69.657843,250.768234,91.82264,1,0
0,0,4,4,8,10,18,13,14,27,0.000333,0.037529,4,450.3519,25.01955,112.587975,57.219281,2,0
0,0,4,4,8,12,20,13,18,31,0.000333,0.04466,4,535.919084,29.773282,133.979771,67.01955,2,0
0,0,25,25,21,48,69,133,102,235,0.000333,0.478501,20,28710.06495,1595.003608,1435.503247,360.316866,8,0
0,0,4,4,8,12,20,13,18,31,0.000333,0.04466,4,535.919084,29.773282,133.979771,67.01955,2,0
0,0,25,25,21,48,69,133,102,235,0.000333,0.478501,20,28710.06495,1595.003608,1435.503247,360.316866,8,0
0,0,4,4,8,11,19,13,16,29,0.000333,0.041063,4,492.759592,27.375533,123.189898,62.053748,2,0
0,0,10,10,11,16,27,32,36,68,0.000333,0.107777,10,3233.323501,179.629083,323.33235,102.053748,2,0
0,0,15,15,14,19,33,65,57,122,0.000333,0.205139,21,12923.73773,717.98543,615.416083,134.013592,1,0
0,0,18,18,18,21,39,78,65,143,0.000333,0.251938,27,20406.93797,1133.718776,755.812517,167.297316,2,0
0,0,11,11,13,22,35,50,41,91,0.000333,0.155588,6,2800.588527,155.588252,466.764755,146.213212,4,0
0,0,12,12,13,22,35,51,43,94,0.000333,0.160718,6,2892.915622,160.717535,482.152604,146.213212,4,0
0,0,10,10,11,18,29,34,37,71,0.000333,0.114972,10,3449.166507,191.620361,344.916651,113.112398,2,0
0,0,11,11,11,18,29,35,39,74,0.000333,0.11983,10,3594.905936,199.716996,359.490594,113.112398,2,0
0,0,11,11,13,25,38,49,47,96,0.000333,0.167934,6,3022.806248,167.93368,503.801041,164.202121,4,0
0,0,12,12,13,25,38,50,49,99,0.000333,0.173182,6,3117.268943,173.181608,519.544824,164.202121,4,0
0,0,11,11,13,25,38,49,47,96,0.000333,0.167934,6,3022.806248,167.93368,503.801041,164.202121,4,0
0,0,12,12,13,25,38,50,49,99,0.000333,0.173182,6,3117.268943,173.181608,519.544824,164.202121,4,0
0,0,11,11,16,25,41,54,41,95,0.000333,0.169656,8,4071.739524,226.207751,508.96744,180.096405,5,0
0,0,12,12,16,25,41,55,43,98,0.000333,0.175013,8,4200.320772,233.351154,525.040096,180.096405,5,0
0,0,10,10,13,22,35,47,35,82,0.000333,0.1402,6,2523.607244,140.200402,420.601207,146.213212,4,0
0,0,11,11,13,22,35,48,37,85,0.000333,0.14533,6,2615.934339,145.329685,435.989056,146.213212,4,0
0,0,11,11,13,22,35,48,39,87,0.000333,0.148749,6,2677.485735,148.749207,446.247622,146.213212,4,0
0,0,12,12,13,22,35,49,41,90,0.000333,0.153878,6,2769.812829,153.878491,461.635472,146.213212,4,0
0,0,7,7,11,14,25,28,25,53,0.000333,0.082041,5,1230.62189,68.367883,246.124378,91.356717,2,0
0,0,4,4,8,9,17,14,14,28,0.000333,0.03815,4,457.795838,25.433102,114.44896,52.529325,1,0
0,0,17,17,13,18,31,70,54,124,0.000333,0.204773,18,11057.76617,614.320342,614.320342,123.164366,3,0
0,0,20,20,17,21,38,83,62,145,0.000333,0.25365,16,12175.19183,676.399546,760.949489,161.725534,4,0
0,0,14,14,17,18,35,55,41,96,0.000333,0.164137,16,7878.578714,437.698817,492.41117,144.545518,3,0
0,0,11,11,14,15,29,44,32,76,0.000333,0.123069,14,5168.891779,287.160654,369.206556,111.906328,2,0
0,0,4,4,9,8,17,15,13,28,0.000333,0.03815,4,457.795838,25.433102,114.44896,52.529325,1,0
0,0,13,13,12,15,27,63,41,104,0.000333,0.164836,12,5934.099603,329.6722,494.5083,101.622909,2,0
0,0,16,16,16,17,33,76,49,125,0.000333,0.210183,16,10088.78824,560.488235,630.549265,133.486868,3,0
0,0,10,10,15,15,30,47,32,79,0.000333,0.129215,14,5427.020999,301.501167,387.644357,117.206718,2,0
0,0,13,13,12,15,27,63,41,104,0.000333,0.164836,12,5934.099603,329.6722,494.5083,101.622909,2,0
0,0,16,16,16,17,33,76,49,125,0.000333,0.210183,16,10088.78824,560.488235,630.549265,133.486868,3,0
0,0,10,10,15,15,30,47,32,79,0.000333,0.129215,14,5427.020999,301.501167,387.644357,117.206718,2,0
0,0,23,23,19,30,49,101,88,189,0.000333,0.353727,18,19101.24289,1061.180161,1061.180161,227.917341,6,0
0,0,17,17,16,26,42,62,64,126,0.000333,0.226477,16,10870.91192,603.939551,679.431995,186.211433,2,0
0,0,18,18,17,27,44,79,74,153,0.000333,0.278431,16,13364.6886,742.4827,835.293038,197.868831,5,0
0,0,16,16,12,23,35,51,63,114,0.000333,0.194913,12,7016.859167,389.825509,584.738264,147.061475,1,0
0,0,19,19,16,26,42,64,71,135,0.000333,0.242654,16,11647.40563,647.078091,727.962852,186.211433,2,0
0,0,5,5,12,12,24,22,17,39,0.000333,0.059605,6,1072.881225,59.604513,178.813538,86.0391,1,0
0,0,8,8,15,15,30,35,25,60,0.000333,0.098138,7,2060.89405,114.494114,294.413436,117.206718,2,0
0,0,23,23,18,29,47,106,85,191,0.000333,0.353642,18,19096.67647,1060.926471,1060.926471,215.940099,6,0
0,0,11,11,13,21,34,46,40,86,0.000333,0.145841,6,2625.130826,145.840601,437.521804,140.344382,3,0
0,0,17,17,15,25,40,67,61,128,0.000333,0.227069,14,9536.895146,529.827508,681.206796,174.699764,2,0
0,0,8,8,9,16,25,24,24,48,0.000333,0.074302,4,891.620388,49.534466,222.905097,92.529325,1,0
0,0,18,18,16,26,42,84,71,155,0.000333,0.278603,16,13372.94721,742.941512,835.809201,186.211433,5,0
0,0,11,11,14,23,37,47,39,86,0.000333,0.149338,7,3136.090926,174.227274,448.012989,157.344894,3,0
0,0,16,16,11,23,34,59,58,117,0.000333,0.198411,10,5952.331524,330.685085,595.233152,142.095673,1,0
0,0,19,19,15,26,41,72,66,138,0.000333,0.246447,14,10350.79047,575.043915,739.342177,180.814792,2,0
0,0,5,5,12,12,24,22,17,39,0.000333,0.059605,6,1072.881225,59.604513,178.813538,86.0391,1,0
0,0,8,8,15,15,30,35,25,60,0.000333,0.098138,7,2060.89405,114.494114,294.413436,117.206718,2,0
0,0,18,18,15,26,41,71,64,135,0.000333,0.24109,14,10125.77329,562.54296,723.269521,180.814792,2,0
0,0,16,16,15,26,41,71,63,134,0.000333,0.239304,14,10050.76756,558.375976,717.911969,180.814792,3,0
0,0,22,22,19,28,47,101,81,182,0.000333,0.336978,18,18196.83308,1010.935171,1010.935171,215.316561,6,0
0,0,16,16,16,24,40,62,57,119,0.000333,0.211103,16,10132.95109,562.941727,633.309443,174.0391,2,0
0,0,17,17,17,25,42,79,67,146,0.000333,0.262426,16,12596.4535,699.802972,787.278344,185.583273,5,0
0,0,14,14,12,21,33,50,51,101,0.000333,0.169828,12,6113.805673,339.655871,509.483806,135.258216,1,0
0,0,17,17,16,24,40,63,59,122,0.000333,0.216425,16,10388.40364,577.133536,649.275228,174.0391,2,0
0,0,5,5,12,12,24,22,17,39,0.000333,0.059605,6,1072.881225,59.604513,178.813538,86.0391,1,0
0,0,8,8,15,15,30,35,25,60,0.000333,0.098138,7,2060.89405,114.494114,294.413436,117.206718,2,0
0,0,12,12,14,19,33,56,43,99,0.000333,0.166465,14,6991.530249,388.418347,499.395018,134.013592,5,0
0,0,5,5,10,15,25,20,21,41,0.000333,0.063466,5,951.990519,52.888362,190.398104,91.82264,1,0
0,0,8,8,14,18,32,33,29,62,0.000333,0.103333,7,2170,120.555556,310,128.361619,2,0
0,0,5,5,11,15,26,21,20,41,0.000333,0.064239,5,963.590142,53.532786,192.718028,96.657107,1,0
0,0,8,8,14,18,32,34,28,62,0.000333,0.103333,7,2170,120.555556,310,128.361619,2,0
0,0,15,15,15,17,32,53,50,103,0.000333,0.171667,14,7210,400.555556,515,128.090227,3,0
0,0,17,17,17,20,37,61,55,116,0.000333,0.201432,16,9668.745447,537.152525,604.29659,155.92543,4,0
0,0,12,12,14,18,32,41,36,77,0.000333,0.128333,14,5390,299.444444,385,128.361619,3,0
0,0,15,15,14,17,31,52,50,102,0.000333,0.168443,14,7074.592331,393.032907,505.328024,122.789837,3,0
0,0,17,17,17,20,37,60,55,115,0.000333,0.199696,16,9585.394193,532.5219,599.087137,155.92543,4,0
0,0,12,12,14,18,32,40,36,76,0.000333,0.126667,14,5320,295.555556,380,128.361619,3,0
0,0,15,15,15,17,32,53,50,103,0.000333,0.171667,14,7210,400.555556,515,128.090227,3,0
0,0,17,17,17,20,37,61,55,116,0.000333,0.201432,16,9668.745447,537.152525,604.29659,155.92543,4,0
0,0,12,12,14,18,32,41,36,77,0.000333,0.128333,14,5390,299.444444,385,128.361619,3,0
0,0,15,15,14,17,31,52,50,102,0.000333,0.168443,14,7074.592331,393.032907,505.328024,122.789837,3,0
0,0,17,17,17,20,37,60,55,115,0.000333,0.199696,16,9585.394193,532.5219,599.087137,155.92543,4,0
0,0,12,12,14,18,32,40,36,76,0.000333,0.126667,14,5320,295.555556,380,128.361619,3,0
0,0,16,16,13,17,30,58,55,113,0.000333,0.184826,18,9980.615471,554.478637,554.478637,117.592585,3,0
0,0,18,18,17,20,37,66,60,126,0.000333,0.218797,24,15753.38698,875.188165,656.391124,155.92543,4,0
0,0,13,13,17,19,36,46,41,87,0.000333,0.149928,16,7196.535602,399.807533,449.783475,150.197491,3,0
0,0,8,8,11,16,27,27,27,54,0.000333,0.085588,5,1283.819626,71.323313,256.763925,102.053748,3,0
0,0,6,6,9,9,18,16,14,30,0.000333,0.041699,4,500.391,27.7995,125.09775,57.05865,1,0
0,0,12,12,12,19,31,47,46,93,0.000333,0.15358,12,5528.883082,307.160171,460.740257,123.730173,4,0
0,0,25,25,17,47,64,113,88,201,0.000333,0.402,8,9648,536,1206,330.552544,9,0
0,0,10,10,11,16,27,36,35,71,0.000333,0.112532,10,3375.970127,187.553896,337.597013,102.053748,2,0
0,0,8,8,9,16,25,24,24,48,0.000333,0.074302,4,891.620388,49.534466,222.905097,92.529325,1,0
0,0,11,11,11,17,28,40,38,78,0.000333,0.124991,10,3749.736839,208.318713,374.973684,107.540616,2,0
0,0,13,13,13,16,29,61,42,103,0.000333,0.166791,12,6004.46451,333.581362,500.372042,112.105716,2,0
0,0,16,16,15,19,34,74,50,124,0.000333,0.210282,14,8831.835492,490.657527,630.845392,139.313982,3,0
0,0,10,10,14,15,29,43,31,74,0.000333,0.11983,14,5032.868311,279.603795,359.490594,111.906328,2,0
0,0,13,13,12,16,28,60,42,102,0.000333,0.16345,12,5884.202425,326.900135,490.350202,107.01955,2,0
0,0,16,16,15,19,34,73,50,123,0.000333,0.208586,14,8760.611013,486.700612,625.757929,139.313982,3,0
0,0,10,10,14,15,29,43,31,74,0.000333,0.11983,14,5032.868311,279.603795,359.490594,111.906328,2,0
0,0,15,15,14,19,33,70,59,129,0.000333,0.216909,21,13665.26367,759.181315,650.726841,134.013592,1,0
0,0,18,18,18,22,40,83,67,150,0.000333,0.266096,27,21553.80878,1197.433821,798.289214,173.166146,2,0
0,0,32,32,24,48,72,139,97,236,0.000333,0.485367,24,34946.45521,1941.469734,1456.1023,378.1173,13,0
0,0,29,29,23,49,72,130,93,223,0.000333,0.458631,11,15134.82603,840.823668,1375.893275,379.162707,12,0
0,0,28,28,23,49,72,129,91,220,0.000333,0.452461,11,14931.2185,829.512139,1357.3835,379.162707,12,0
0,0,32,32,24,47,71,139,97,236,0.000333,0.48378,24,34832.16769,1935.120427,1451.34032,371.104776,13,0
0,0,29,29,23,49,72,130,93,223,0.000333,0.458631,11,15134.82603,840.823668,1375.893275,379.162707,12,0
0,0,28,28,23,49,72,129,91,220,0.000333,0.452461,11,14931.2185,829.512139,1357.3835,379.162707,12,0
0,0,13,13,13,13,26,36,26,62,0.000333,0.097142,12,3497.12715,194.284842,291.427263,96.211433,4,0
0,0,13,13,13,12,25,36,26,62,0.000333,0.095973,12,3455.029005,191.946056,287.919084,91.125266,4,0
0,0,15,15,13,17,30,65,44,109,0.000333,0.178284,12,6418.212899,356.567383,534.851075,117.592585,2,0
0,0,18,18,16,20,36,78,52,130,0.000333,0.22403,16,10753.444,597.413556,672.09025,150.438562,3,0
0,0,10,10,14,15,29,43,31,74,0.000333,0.11983,14,5032.868311,279.603795,359.490594,111.906328,2,0
0,0,15,15,13,16,29,65,44,109,0.000333,0.176507,12,6354.239142,353.013286,529.519928,112.105716,2,0
0,0,18,18,16,19,35,78,52,130,0.000333,0.222269,16,10668.90868,592.717149,666.806792,144.710623,3,0
0,0,10,10,14,15,29,43,31,74,0.000333,0.11983,14,5032.868311,279.603795,359.490594,111.906328,2,0
0,0,28,28,19,50,69,123,101,224,0.000333,0.456103,18,24629.57061,1368.309478,1368.309478,362.903432,10,0
0,0,27,27,19,50,69,122,99,221,0.000333,0.449995,9,12149.85515,674.991952,1349.983905,362.903432,10,0
0,0,28,28,22,53,75,128,105,233,0.000333,0.483772,11,15964.4623,886.914572,1451.314755,401.68728,11,0
0,0,27,27,22,53,75,127,103,230,0.000333,0.477543,11,15758.91129,875.495071,1432.628299,401.68728,11,0
0,0,28,28,22,53,75,128,105,233,0.000333,0.483772,11,15964.4623,886.914572,1451.314755,401.68728,11,0
0,0,27,27,22,53,75,127,103,230,0.000333,0.477543,11,15758.91129,875.495071,1432.628299,401.68728,11,0
0,0,29,29,23,52,75,133,111,244,0.000333,0.506611,22,33436.29873,1857.572152,1519.83176,400.46479,12,0
0,0,29,29,23,52,75,133,111,244,0.000333,0.506611,22,33436.29873,1857.572152,1519.83176,400.46479,12,0
0,0,10,10,12,17,29,30,37,67,0.000333,0.108495,12,3905.81672,216.989818,325.484727,112.506418,3,0
0,0,10,10,12,13,25,31,28,59,0.000333,0.091329,12,3287.850182,182.658343,273.987515,91.125266,3,0
0,0,16,16,16,18,34,66,56,122,0.000333,0.20689,24,14896.0912,827.560622,620.670467,139.05865,2,0
0,0,28,28,24,48,72,131,91,222,0.000333,0.456574,12,16436.6802,913.1489,1369.72335,378.1173,13,0
0,0,27,27,23,49,72,126,90,216,0.000333,0.444235,11,14659.7418,814.4301,1332.7038,379.162707,12,0
0,0,26,26,23,49,72,125,88,213,0.000333,0.438065,11,14456.13428,803.118571,1314.194025,379.162707,12,0
0,0,28,28,24,48,72,131,91,222,0.000333,0.456574,12,16436.6802,913.1489,1369.72335,378.1173,13,0
0,0,27,27,23,49,72,126,90,216,0.000333,0.444235,11,14659.7418,814.4301,1332.7038,379.162707,12,0
0,0,26,26,23,49,72,125,88,213,0.000333,0.438065,11,14456.13428,803.118571,1314.194025,379.162707,12,0
0,0,9,9,13,12,25,28,20,48,0.000333,0.074302,6,1337.430583,74.301699,222.905097,91.125266,4,0
0,0,9,9,13,12,25,28,20,48,0.000333,0.074302,6,1337.430583,74.301699,222.905097,91.125266,4,0
0,0,16,16,18,20,38,66,57,123,0.000333,0.215165,18,11618.91152,645.495084,645.495084,161.497212,3,0
0,0,15,15,11,19,30,60,59,119,0.000333,0.19464,15,8758.799713,486.599984,583.919981,118.764371,1,0
0,0,17,17,15,21,36,68,64,132,0.000333,0.227477,21,14331.0321,796.16845,682.4301,150.842025,2,0
0,0,17,17,13,20,33,67,68,135,0.000333,0.226998,18,12257.87771,680.993206,680.993206,134.544278,2,0
0,0,19,19,16,22,38,75,73,148,0.000333,0.258898,24,18640.63853,1035.591029,776.693272,162.107496,3,0
0,0,17,17,13,20,33,67,68,135,0.000333,0.226998,18,12257.87771,680.993206,680.993206,134.544278,2,0
0,0,19,19,16,22,38,75,73,148,0.000333,0.258898,24,18640.63853,1035.591029,776.693272,162.107496,3,0
0,0,10,10,11,16,27,33,29,62,0.000333,0.098268,5,1474.015126,81.889729,294.803025,102.053748,3,0
0,0,16,16,12,16,28,53,48,101,0.000333,0.161848,18,8739.771248,485.542847,485.542847,107.01955,3,0
0,0,19,19,16,19,35,66,56,122,0.000333,0.208591,16,10012.36045,556.242247,625.772528,144.710623,4,0
0,0,10,10,14,15,29,40,29,69,0.000333,0.111734,7,2346.404821,130.355823,335.200689,111.906328,2,0
0,0,16,16,12,16,28,53,48,101,0.000333,0.161848,18,8739.771248,485.542847,485.542847,107.01955,3,0
0,0,19,19,16,19,35,66,56,122,0.000333,0.208591,16,10012.36045,556.242247,625.772528,144.710623,4,0
0,0,10,10,14,15,29,40,29,69,0.000333,0.111734,7,2346.404821,130.355823,335.200689,111.906328,2,0
0,0,14,14,13,15,28,48,39,87,0.000333,0.139413,12,5018.878539,278.826585,418.239878,106.709075,2,0
0,0,17,17,16,18,34,61,47,108,0.000333,0.183149,16,8791.13579,488.396433,549.445987,139.05865,3,0
0,0,10,10,14,15,29,40,29,69,0.000333,0.111734,7,2346.404821,130.355823,335.200689,111.906328,2,0
0,0,13,13,11,15,26,44,34,78,0.000333,0.122211,10,3666.34298,203.685721,366.634298,96.657107,3,0
0,0,16,16,15,18,33,57,42,99,0.000333,0.166465,14,6991.530249,388.418347,499.395018,133.662009,4,0
0,0,13,13,11,15,26,44,34,78,0.000333,0.122211,10,3666.34298,203.685721,366.634298,96.657107,3,0
0,0,16,16,15,18,33,57,42,99,0.000333,0.166465,14,6991.530249,388.418347,499.395018,133.662009,4,0
0,0,15,15,16,20,36,75,46,121,0.000333,0.20852,16,10008.9748,556.054156,625.560925,150.438562,6,0
0,0,15,15,16,20,36,75,46,121,0.000333,0.20852,16,10008.9748,556.054156,625.560925,150.438562,6,0
0,0,6,6,9,10,19,17,15,32,0.000333,0.045311,4,543.734722,30.207485,135.93368,61.748606,2,0
0,0,6,6,9,10,19,17,15,32,0.000333,0.045311,4,543.734722,30.207485,135.93368,61.748606,2,0
0,0,9,9,12,12,24,28,26,54,0.000333,0.082529,12,2971.0557,165.05865,247.587975,86.0391,2,0
0,0,15,15,16,20,36,75,46,121,0.000333,0.20852,16,10008.9748,556.054156,625.560925,150.438562,6,0
0,0,15,15,16,20,36,75,46,121,0.000333,0.20852,16,10008.9748,556.054156,625.560925,150.438562,6,0
0,0,6,6,9,10,19,17,15,32,0.000333,0.045311,4,543.734722,30.207485,135.93368,61.748606,2,0
0,0,6,6,9,10,19,17,15,32,0.000333,0.045311,4,543.734722,30.207485,135.93368,61.748606,2,0
0,0,7,7,13,14,27,29,27,56,0.000333,0.088758,6,1597.642201,88.7579,266.2737,101.408685,2,0
0,0,10,10,13,16,29,42,38,80,0.000333,0.129546,12,4663.661755,259.09232,388.63848,112.105716,2,0
0,0,12,12,17,19,36,50,43,93,0.000333,0.160268,16,7692.848402,427.380467,480.803025,150.197491,3,0
0,0,7,7,13,15,28,29,28,57,0.000333,0.09134,6,1644.115383,91.339744,274.019231,106.709075,2,0
0,0,15,15,12,20,32,48,44,92,0.000333,0.153333,12,5520,306.666667,460,129.458112,2,0
0,0,18,18,16,23,39,61,52,113,0.000333,0.199083,16,9556.007212,530.88929,597.250451,168.041925,3,0
0,0,10,10,14,15,29,40,29,69,0.000333,0.111734,7,2346.404821,130.355823,335.200689,111.906328,2,0
0,0,15,15,14,20,34,70,48,118,0.000333,0.200107,14,8404.488614,466.916034,600.320615,139.741531,5,0
0,0,6,6,9,12,21,15,17,32,0.000333,0.046851,4,562.21663,31.234257,140.554158,71.548875,1,0
0,0,15,15,15,22,37,71,48,119,0.000333,0.206642,14,8678.949307,482.16385,619.924951,156.710855,5,0
0,0,19,19,15,24,39,95,66,161,0.000333,0.28365,14,11913.2966,661.849811,850.949757,168.642459,5,0
0,0,10,10,11,17,28,40,36,76,0.000333,0.121786,10,3653.589741,202.977208,365.358974,107.540616,1,0
0,0,19,19,17,26,43,98,67,165,0.000333,0.298445,16,14325.33895,795.852164,895.333685,191.698301,5,0
0,0,3,3,7,9,16,10,11,21,0.000333,0.028,3,252,14,84,48.180809,1,0
0,0,3,3,7,10,17,10,12,22,0.000333,0.029975,3,269.772548,14.987364,89.924183,52.870765,1,0
0,0,11,11,11,17,28,44,39,83,0.000333,0.133003,10,3990.104585,221.672477,399.010459,107.540616,1,0
0,0,3,3,7,10,17,10,12,22,0.000333,0.029975,3,269.772548,14.987364,89.924183,52.870765,1,0
0,0,26,26,21,49,70,145,102,247,0.000333,0.504644,20,30278.6581,1682.147672,1513.932905,367.359448,7,0
0,0,14,14,16,19,35,67,52,119,0.000333,0.203462,16,9766.154864,542.564159,610.384679,144.710623,5,0
0,0,14,14,16,19,35,67,52,119,0.000333,0.203462,16,9766.154864,542.564159,610.384679,144.710623,5,0
0,0,9,9,10,13,23,32,28,60,0.000333,0.090471,10,2714.137174,150.785399,271.413717,81.324997,2,0
0,0,25,25,23,43,66,119,83,202,0.000333,0.406989,11,13430.64373,746.146874,1220.967612,337.371309,11,0
0,0,24,24,22,45,67,113,81,194,0.000333,0.392274,11,12945.03433,719.168574,1176.821303,345.240885,10,0
0,0,23,23,22,45,67,112,79,191,0.000333,0.386208,11,12744.85339,708.047411,1158.623035,345.240885,10,0
0,0,25,25,23,43,66,118,83,201,0.000333,0.404974,11,13364.1554,742.453078,1214.923218,337.371309,11,0
0,0,24,24,22,45,67,113,81,194,0.000333,0.392274,11,12945.03433,719.168574,1176.821303,345.240885,10,0
0,0,23,23,22,45,67,112,79,191,0.000333,0.386208,11,12744.85339,708.047411,1158.623035,345.240885,10,0
0,0,9,9,13,12,25,29,22,51,0.000333,0.078946,6,1421.019994,78.945555,236.836666,91.125266,4,0
0,0,9,9,12,12,24,28,22,50,0.000333,0.076416,6,1375.48875,76.416042,229.248125,86.0391,4,0
0,0,20,20,14,20,34,86,69,155,0.000333,0.262852,21,16559.69155,919.982864,788.55674,139.741531,2,0
0,0,22,22,16,22,38,94,74,168,0.000333,0.293884,24,21159.64373,1175.535763,881.651822,162.107496,3,0
0,0,13,13,11,16,27,52,47,99,0.000333,0.156911,10,4707.338627,261.518813,470.733863,102.053748,1,0
0,0,15,15,15,18,33,60,52,112,0.000333,0.188324,14,7909.609979,439.422777,564.972141,133.662009,2,0
0,0,20,20,17,25,42,73,66,139,0.000333,0.249844,16,11992.51395,666.250775,749.532122,185.583273,4,0
0,0,20,20,18,26,44,74,75,149,0.000333,0.271152,18,14642.1956,813.455311,813.455311,197.270083,4,0
0,0,20,20,19,27,46,79,78,157,0.000333,0.289066,18,15609.58609,867.199227,867.199227,209.092585,4,0
0,0,12,12,13,15,28,35,50,85,0.000333,0.136208,18,7355.253031,408.625168,408.625168,106.709075,1,0
0,0,12,12,14,16,30,38,53,91,0.000333,0.148842,21,9377.067928,520.948218,446.527044,117.302969,1,0
0,0,27,27,19,28,47,105,87,192,0.000333,0.355494,27,28794.98861,1599.721589,1066.48106,215.316561,6,0
0,0,16,16,18,20,38,54,63,117,0.000333,0.204669,27,16578.20302,921.011279,614.007519,161.497212,2,0
0,0,27,27,20,29,49,108,96,204,0.000333,0.3818,30,34362.02425,1909.001347,1145.400808,227.320011,6,0
0,0,25,25,19,45,64,107,89,196,0.000333,0.392,9,10584,588,1176,327.844012,7,0
0,0,24,24,19,45,64,106,87,193,0.000333,0.386,9,10422,579,1158,327.844012,7,0
0,0,26,26,21,48,69,112,92,204,0.000333,0.41538,10,12461.38989,692.299438,1246.138989,360.316866,8,0
0,0,25,25,21,48,69,111,90,201,0.000333,0.409271,10,12278.13416,682.118564,1227.813416,360.316866,8,0
0,0,25,25,20,46,66,110,82,192,0.000333,0.386841,10,11605.23671,644.735373,1160.523671,340.522412,9,0
0,0,24,24,20,46,66,109,80,189,0.000333,0.380797,10,11423.90489,634.661383,1142.390489,340.522412,9,0
0,0,25,25,20,46,66,110,82,192,0.000333,0.386841,10,11605.23671,644.735373,1160.523671,340.522412,9,0
0,0,24,24,20,46,66,109,80,189,0.000333,0.380797,10,11423.90489,634.661383,1142.390489,340.522412,9,0
0,0,7,7,12,15,27,32,31,63,0.000333,0.099853,12,3594.694952,199.705275,299.557913,101.622909,1,0
0,0,9,9,15,18,33,40,36,76,0.000333,0.127791,14,5367.235343,298.179741,383.373953,133.662009,2,0
0,0,29,29,26,53,79,135,111,246,0.000333,0.51691,26,40318.98167,2239.943426,1550.730064,425.791217,11,0
0,0,10,10,16,18,34,32,40,72,0.000333,0.122099,16,5860.757193,325.597622,366.297325,139.05865,2,0
0,0,28,28,21,53,74,125,97,222,0.000333,0.4595,10,13784.98647,765.832582,1378.498647,395.81845,10,0
0,0,27,27,21,53,74,124,95,219,0.000333,0.45329,10,13598.70287,755.483493,1359.870287,395.81845,10,0
0,0,28,28,24,54,78,130,101,231,0.000333,0.483976,12,17423.13495,967.951942,1451.927913,420.803025,11,0
0,0,27,27,24,54,78,129,99,228,0.000333,0.477691,12,17196.86047,955.381137,1433.071706,420.803025,11,0
0,0,13,13,11,14,25,61,42,103,0.000333,0.159439,15,7174.757813,398.597656,478.317188,91.356717,1,0
0,0,16,16,15,16,31,74,50,124,0.000333,0.204773,21,12900.72719,716.707066,614.320342,122.603359,2,0
0,0,10,10,15,14,29,45,31,76,0.000333,0.123069,14,5168.891779,287.160654,369.206556,111.906328,2,0
0,0,14,14,12,15,27,64,43,107,0.000333,0.169591,12,6105.275553,339.181975,508.772963,101.622909,2,0
0,0,17,17,16,17,33,77,51,128,0.000333,0.215227,24,15496.37874,860.90993,645.682447,133.486868,3,0
0,0,10,10,15,14,29,45,31,76,0.000333,0.123069,14,5168.891779,287.160654,369.206556,111.906328,2,0
0,0,14,14,12,15,27,64,43,107,0.000333,0.169591,12,6105.275553,339.181975,508.772963,101.622909,2,0
0,0,17,17,16,17,33,77,51,128,0.000333,0.215227,24,15496.37874,860.90993,645.682447,133.486868,3,0
0,0,10,10,15,14,29,45,31,76,0.000333,0.123069,14,5168.891779,287.160654,369.206556,111.906328,2,0
0,0,14,14,12,14,26,64,43,107,0.000333,0.167649,18,9053.046897,502.94705,502.94705,96.322519,2,0
0,0,17,17,16,16,32,77,51,128,0.000333,0.213333,24,15360,853.333333,640,128,3,0
0,0,10,10,15,14,29,45,31,76,0.000333,0.123069,14,5168.891779,287.160654,369.206556,111.906328,2,0
0,0,16,16,13,17,30,68,46,114,0.000333,0.186462,12,6712.626335,372.923685,559.385528,117.592585,2,0
0,0,19,19,16,19,35,81,54,135,0.000333,0.230818,16,11079.25132,615.513962,692.453207,144.710623,3,0
0,0,10,10,15,14,29,45,31,76,0.000333,0.123069,14,5168.891779,287.160654,369.206556,111.906328,2,0
0,0,16,16,13,16,29,68,46,114,0.000333,0.184603,12,6645.718001,369.206556,553.809833,112.105716,2,0
0,0,19,19,16,18,34,81,54,135,0.000333,0.228936,24,16483.37961,915.743311,686.807484,139.05865,3,0
0,0,10,10,15,14,29,45,31,76,0.000333,0.123069,14,5168.891779,287.160654,369.206556,111.906328,2,0
0,0,20,20,14,18,32,98,62,160,0.000333,0.266667,21,16800,933.333333,800,128.361619,2,0
0,0,23,23,16,20,36,111,70,181,0.000333,0.311919,24,22458.15421,1247.675234,935.756425,150.438562,3,0
0,0,10,10,15,14,29,45,31,76,0.000333,0.123069,14,5168.891779,287.160654,369.206556,111.906328,2,0
0,0,9,9,10,13,23,32,30,62,0.000333,0.093487,10,2804.608413,155.811578,280.460841,81.324997,2,0
0,0,9,9,10,13,23,32,30,62,0.000333,0.093487,10,2804.608413,155.811578,280.460841,81.324997,2,0
0,0,9,9,10,13,23,32,30,62,0.000333,0.093487,10,2804.608413,155.811578,280.460841,81.324997,2,0
0,0,9,9,10,13,23,32,30,62,0.000333,0.093487,10,2804.608413,155.811578,280.460841,81.324997,2,0
0,0,7,7,11,16,27,30,31,61,0.000333,0.096683,5,1450.240688,80.568927,290.048138,102.053748,1,0
0,0,9,9,14,19,33,38,36,74,0.000333,0.124428,7,2612.996154,145.166453,373.285165,134.013592,2,0
0,0,14,14,16,19,35,67,52,119,0.000333,0.203462,16,9766.154864,542.564159,610.384679,144.710623,5,0
0,0,14,14,16,19,35,67,52,119,0.000333,0.203462,16,9766.154864,542.564159,610.384679,144.710623,5,0
0,0,9,9,10,12,22,31,29,60,0.000333,0.089189,10,2675.658971,148.647721,267.565897,76.238831,1,0
0,0,9,9,10,12,22,31,29,60,0.000333,0.089189,10,2675.658971,148.647721,267.565897,76.238831,1,0
0,0,14,14,16,19,35,67,52,119,0.000333,0.203462,16,9766.154864,542.564159,610.384679,144.710623,5,0
0,0,14,14,16,19,35,67,52,119,0.000333,0.203462,16,9766.154864,542.564159,610.384679,144.710623,5,0
0,0,9,9,10,12,22,31,29,60,0.000333,0.089189,10,2675.658971,148.647721,267.565897,76.238831,1,0
0,0,9,9,10,12,22,31,29,60,0.000333,0.089189,10,2675.658971,148.647721,267.565897,76.238831,1,0
0,0,24,24,16,19,35,125,90,215,0.000333,0.367599,32,35289.46716,1960.525953,1102.795849,144.710623,9,0
0,0,14,14,10,12,22,53,44,97,0.000333,0.144188,15,6488.473005,360.470723,432.564867,76.238831,1,0
0,0,26,26,19,51,70,133,98,231,0.000333,0.471955,9,12742.77939,707.932188,1415.864377,370.004315,9,0
0,0,8,8,9,16,25,22,25,47,0.000333,0.072754,4,873.044964,48.502498,218.261241,92.529325,1,0
0,0,26,26,20,53,73,134,98,232,0.000333,0.47868,10,14360.39298,797.79961,1436.039298,390.018346,9,0
0,0,11,11,10,19,29,38,41,79,0.000333,0.127927,10,3837.804986,213.211388,383.780499,113.929904,1,0
0,0,28,28,20,53,73,144,109,253,0.000333,0.522009,20,31320.51227,1740.028459,1566.025613,390.018346,9,0
0,0,21,21,17,26,43,99,71,170,0.000333,0.307488,16,14759.44013,819.968896,922.465008,191.698301,6,0
0,0,12,12,11,18,29,44,43,87,0.000333,0.140881,10,4226.443466,234.802415,422.644347,113.112398,2,0
0,0,20,20,17,26,43,95,70,165,0.000333,0.298445,16,14325.33895,795.852164,895.333685,191.698301,5,0
0,0,11,11,12,19,31,46,43,89,0.000333,0.146974,12,5291.081659,293.948981,440.923472,123.730173,3,0
0,0,8,8,10,15,25,25,29,54,0.000333,0.083589,5,1253.841171,69.657843,250.768234,91.82264,1,0
0,0,11,11,14,21,35,49,44,93,0.000333,0.159008,14,6678.326488,371.018138,477.023321,145.541635,3,0
0,0,3,3,7,9,16,10,11,21,0.000333,0.028,3,252,14,84,48.180809,1,0
0,0,3,3,7,10,17,10,12,22,0.000333,0.029975,3,269.772548,14.987364,89.924183,52.870765,1,0
0,0,9,9,10,15,25,29,32,61,0.000333,0.094425,10,2832.752276,157.375126,283.275228,91.82264,1,0
0,0,3,3,7,10,17,10,12,22,0.000333,0.029975,3,269.772548,14.987364,89.924183,52.870765,1,0
0,0,15,15,15,24,39,64,54,118,0.000333,0.207892,14,8731.484466,485.08247,623.677462,168.642459,4,0
0,0,13,13,12,20,32,52,53,105,0.000333,0.175,12,6300,350,525,129.458112,3,0
0,0,10,10,10,16,26,31,41,72,0.000333,0.112811,10,3384.316597,188.017589,338.43166,97.219281,1,0
0,0,13,13,14,22,36,55,56,111,0.000333,0.191287,14,8034.063452,446.336858,573.861675,151.410465,3,0
0,0,3,3,7,9,16,10,11,21,0.000333,0.028,3,252,14,84,48.180809,1,0
0,0,3,3,7,10,17,10,12,22,0.000333,0.029975,3,269.772548,14.987364,89.924183,52.870765,1,0
0,0,11,11,10,16,26,35,44,79,0.000333,0.123778,10,3713.347377,206.297077,371.334738,97.219281,1,0
0,0,3,3,7,10,17,10,12,22,0.000333,0.029975,3,269.772548,14.987364,89.924183,52.870765,1,0
0,0,17,17,15,25,40,70,66,136,0.000333,0.241261,14,10132.95109,562.941727,723.782221,174.699764,4,0
0,0,12,12,11,18,29,44,48,92,0.000333,0.148978,10,4469.342516,248.296806,446.934252,113.112398,2,0
0,0,20,20,13,20,33,71,70,141,0.000333,0.237087,18,12802.67228,711.259571,711.259571,134.544278,2,0
0,0,22,22,17,23,40,79,75,154,0.000333,0.273192,24,19669.84624,1092.769235,819.576927,173.528793,3,0
0,0,12,12,12,17,29,45,47,92,0.000333,0.148978,12,5363.211019,297.956168,446.934252,112.506418,2,0
0,0,11,11,13,15,28,35,31,66,0.000333,0.105762,12,3807.425098,211.523617,317.285425,106.709075,2,0
0,0,13,13,11,15,26,44,34,78,0.000333,0.122211,10,3666.34298,203.685721,366.634298,96.657107,3,0
0,0,16,16,15,18,33,57,42,99,0.000333,0.166465,14,6991.530249,388.418347,499.395018,133.662009,4,0
0,0,13,13,11,15,26,44,34,78,0.000333,0.122211,10,3666.34298,203.685721,366.634298,96.657107,3,0
0,0,16,16,15,18,33,57,42,99,0.000333,0.166465,14,6991.530249,388.418347,499.395018,133.662009,4,0
0,0,22,22,19,44,63,101,87,188,0.000333,0.374576,9,10113.55763,561.864313,1123.728626,320.925614,7,0
0,0,22,22,20,45,65,102,93,195,0.000333,0.391454,20,23487.23447,1304.846359,1174.361724,333.571951,7,0
0,0,39,39,28,52,80,153,132,285,0.000333,0.600583,28,50448.9862,2802.721455,1801.749507,431.028803,11,0
0,0,12,12,17,17,34,36,57,93,0.000333,0.157711,24,11355.21706,630.845392,473.134044,138.973737,2,0
0,0,12,12,17,19,36,55,42,97,0.000333,0.167161,16,8023.723602,445.762422,501.482725,150.197491,3,0
0,0,10,10,14,17,31,46,35,81,0.000333,0.133763,14,5618.058616,312.114368,401.289901,122.789837,2,0
0,0,29,29,22,49,71,130,94,224,0.000333,0.459181,11,15152.9769,841.83205,1377.543355,373.228278,12,0
0,0,28,28,22,49,71,129,92,221,0.000333,0.453031,11,14950.03525,830.557514,1359.094113,373.228278,12,0
0,0,29,29,22,49,71,130,94,224,0.000333,0.459181,11,15152.9769,841.83205,1377.543355,373.228278,12,0
0,0,28,28,22,49,71,129,92,221,0.000333,0.453031,11,14950.03525,830.557514,1359.094113,373.228278,12,0
0,0,13,13,13,17,30,57,47,104,0.000333,0.170106,12,6123.799463,340.211081,510.316622,117.592585,2,0
0,0,15,15,15,19,34,65,52,117,0.000333,0.198411,14,8333.264134,462.959119,595.233152,139.313982,3,0
0,0,13,13,12,17,29,56,47,103,0.000333,0.166791,12,6004.46451,333.581362,500.372042,112.506418,2,0
0,0,15,15,15,19,34,64,52,116,0.000333,0.196715,14,8262.039654,459.002203,590.14569,139.313982,3,0
0,0,18,18,14,19,33,84,64,148,0.000333,0.248857,21,15677.97692,870.998718,746.57033,134.013592,2,0
0,0,20,20,16,21,37,92,69,161,0.000333,0.279574,24,20129.32781,1118.295989,838.721992,156.238666,3,0
0,0,10,10,13,22,35,47,34,81,0.000333,0.138491,6,2492.831546,138.490641,415.471924,146.213212,5,0
0,0,11,11,13,22,35,48,36,84,0.000333,0.14362,6,2585.158641,143.619924,430.859773,146.213212,5,0
0,0,10,10,13,22,35,47,34,81,0.000333,0.138491,6,2492.831546,138.490641,415.471924,146.213212,5,0
0,0,11,11,13,22,35,48,36,84,0.000333,0.14362,6,2585.158641,143.619924,430.859773,146.213212,5,0
0,0,10,10,13,22,35,47,35,82,0.000333,0.1402,6,2523.607244,140.200402,420.601207,146.213212,5,0
0,0,11,11,13,22,35,48,37,85,0.000333,0.14533,6,2615.934339,145.329685,435.989056,146.213212,5,0
0,0,10,10,13,22,35,47,35,82,0.000333,0.1402,6,2523.607244,140.200402,420.601207,146.213212,5,0
0,0,11,11,13,22,35,48,37,85,0.000333,0.14533,6,2615.934339,145.329685,435.989056,146.213212,5,0
0,0,17,17,16,22,38,59,58,117,0.000333,0.204669,16,9824.120305,545.784461,614.007519,162.107496,2,0
0,0,13,13,16,19,35,47,42,89,0.000333,0.152169,16,7304.099016,405.783279,456.506189,144.710623,2,0
0,0,16,16,14,24,38,70,59,129,0.000333,0.225661,14,9477.757089,526.542061,676.982649,163.342069,4,0
0,0,14,14,13,23,36,56,45,101,0.000333,0.174054,6,3132.974551,174.054142,522.162425,152.147641,4,0
0,0,13,13,10,19,29,49,47,96,0.000333,0.155455,10,4663.661755,259.09232,466.366176,113.929904,2,0
0,0,8,8,9,15,24,24,23,47,0.000333,0.071831,4,861.97295,47.887386,215.493238,87.132684,1,0
0,0,15,15,14,24,38,66,58,124,0.000333,0.216914,14,9110.402163,506.133454,650.743012,163.342069,3,0
0,0,14,14,14,25,39,57,45,102,0.000333,0.179704,7,3773.777184,209.654288,539.111026,169.399374,4,0
0,0,14,14,10,20,30,53,50,103,0.000333,0.16847,10,5054.097313,280.783184,505.409731,119.657843,2,0
0,0,19,19,15,28,43,81,68,149,0.000333,0.269504,14,11319.18828,628.843793,808.513448,193.209297,4,0
0,0,16,16,18,19,37,60,54,114,0.000333,0.197959,18,10689.79831,593.877684,593.877684,155.769273,3,0
0,0,13,13,18,19,37,49,42,91,0.000333,0.15802,18,8533.084613,474.060256,474.060256,155.769273,3,0
0,0,9,9,10,12,22,31,29,60,0.000333,0.089189,10,2675.658971,148.647721,267.565897,76.238831,1,0
0,0,9,9,10,12,22,31,29,60,0.000333,0.089189,10,2675.658971,148.647721,267.565897,76.238831,1,0
0,0,14,14,12,16,28,61,56,117,0.000333,0.187487,18,10124.28947,562.460526,562.460526,107.01955,1,0
0,0,14,14,10,12,22,53,44,97,0.000333,0.144188,15,6488.473005,360.470723,432.564867,76.238831,1,0
0,0,15,15,14,22,36,49,55,104,0.000333,0.179224,14,7527.410802,418.189489,537.6722,151.410465,2,0
0,0,15,15,15,23,38,49,55,104,0.000333,0.181928,14,7640.98246,424.499026,545.784461,162.645284,2,0
0,0,19,19,14,22,36,62,73,135,0.000333,0.232647,21,14656.73738,814.263188,697.939875,151.410465,2,0
0,0,21,21,18,25,43,70,78,148,0.000333,0.267696,27,21683.35396,1204.630776,803.087184,191.155055,3,0
0,0,9,9,14,17,31,38,37,75,0.000333,0.123855,14,5201.906126,288.994785,371.564723,122.789837,2,0
0,0,11,11,17,20,37,46,42,88,0.000333,0.152811,16,7334.910339,407.495019,458.431896,155.92543,3,0
0,0,17,17,16,21,37,60,67,127,0.000333,0.220534,24,15878.41386,882.134103,661.600577,156.238666,2,0
0,0,19,19,20,24,44,68,72,140,0.000333,0.254773,30,22929.6128,1273.867378,764.320427,196.477662,3,0
0,0,13,13,15,21,36,45,44,89,0.000333,0.153374,14,6441.726552,357.873697,460.123325,150.842025,2,0
0,0,13,13,16,21,37,45,45,90,0.000333,0.156284,16,7501.612847,416.756269,468.850803,156.238666,2,0
0,0,9,9,14,17,31,41,30,71,0.000333,0.117249,7,2462.235566,136.790865,351.747938,122.789837,4,0
0,0,9,9,14,17,31,41,30,71,0.000333,0.117249,7,2462.235566,136.790865,351.747938,122.789837,4,0
0,0,6,6,9,10,19,17,15,32,0.000333,0.045311,4,543.734722,30.207485,135.93368,61.748606,2,0
0,0,6,6,9,10,19,17,15,32,0.000333,0.045311,4,543.734722,30.207485,135.93368,61.748606,2,0
0,0,9,9,13,13,26,29,22,51,0.000333,0.079907,6,1438.334554,79.907475,239.722426,96.211433,4,0
0,0,9,9,12,13,25,28,22,50,0.000333,0.077398,6,1393.156857,77.397603,232.192809,91.125266,4,0
0,0,15,15,12,16,28,48,37,85,0.000333,0.136208,12,4903.50202,272.416779,408.625168,107.01955,3,0
0,0,18,18,16,19,35,61,45,106,0.000333,0.181235,16,8699.263997,483.292444,543.704,144.710623,4,0
0,0,15,15,12,16,28,48,37,85,0.000333,0.136208,12,4903.50202,272.416779,408.625168,107.01955,3,0
0,0,18,18,16,19,35,61,45,106,0.000333,0.181235,16,8699.263997,483.292444,543.704,144.710623,4,0
0,0,12,12,12,21,33,40,46,86,0.000333,0.144606,12,5205.814731,289.21193,433.817894,135.258216,2,0
0,0,13,13,12,21,33,41,48,89,0.000333,0.14965,12,5387.412919,299.300718,448.951077,135.258216,2,0
0,0,13,13,14,28,42,55,54,109,0.000333,0.195921,7,4114.338194,228.574344,587.762599,187.908907,4,0
0,0,14,14,14,28,42,56,56,112,0.000333,0.201313,14,8455.153719,469.730762,603.939551,187.908907,4,0
0,0,18,18,18,22,40,67,69,136,0.000333,0.241261,27,19542.11996,1085.673331,723.782221,173.166146,2,0
0,0,17,17,17,20,37,61,55,116,0.000333,0.201432,16,9668.745447,537.152525,604.29659,155.92543,4,0
0,0,12,12,14,18,32,41,36,77,0.000333,0.128333,14,5390,299.444444,385,128.361619,3,0
0,0,17,17,17,20,37,60,55,115,0.000333,0.199696,16,9585.394193,532.5219,599.087137,155.92543,4,0
0,0,12,12,14,18,32,40,36,76,0.000333,0.126667,14,5320,295.555556,380,128.361619,3,0
0,0,17,17,15,18,33,69,59,128,0.000333,0.215227,21,13559.33139,753.296188,645.682447,133.662009,2,0
0,0,19,19,19,20,39,77,64,141,0.000333,0.248414,27,20121.52625,1117.862569,745.241713,167.149185,3,0
0,0,19,19,16,19,35,74,68,142,0.000333,0.242786,24,17480.59652,971.144251,728.358188,144.710623,3,0
0,0,21,21,19,21,40,82,73,155,0.000333,0.274966,27,22272.26908,1237.348282,824.898855,172.949289,4,0
0,0,19,19,16,19,35,74,68,142,0.000333,0.242786,24,17480.59652,971.144251,728.358188,144.710623,3,0
0,0,21,21,19,21,40,82,73,155,0.000333,0.274966,27,22272.26908,1237.348282,824.898855,172.949289,4,0
0,0,5,5,12,13,25,22,18,40,0.000333,0.061918,6,1114.525486,61.918083,185.754248,91.125266,1,0
0,0,8,8,15,16,31,35,26,61,0.000333,0.100735,7,2115.441825,117.524546,302.205975,122.603359,2,0
0,0,14,14,16,19,35,67,52,119,0.000333,0.203462,16,9766.154864,542.564159,610.384679,144.710623,5,0
0,0,5,5,12,13,25,22,18,40,0.000333,0.061918,6,1114.525486,61.918083,185.754248,91.125266,1,0
0,0,8,8,15,16,31,35,26,61,0.000333,0.100735,7,2115.441825,117.524546,302.205975,122.603359,2,0
0,0,14,14,16,19,35,67,52,119,0.000333,0.203462,16,9766.154864,542.564159,610.384679,144.710623,5,0
0,0,13,13,12,17,29,44,38,82,0.000333,0.132785,12,4780.253299,265.569628,398.354442,112.506418,3,0
0,0,16,16,16,20,36,57,46,103,0.000333,0.177501,16,8520.036402,473.335356,532.502275,150.438562,4,0
0,0,13,13,15,18,33,50,42,92,0.000333,0.154695,14,6497.179626,360.954424,464.084259,133.662009,2,0
0,0,13,13,12,17,29,44,38,82,0.000333,0.132785,12,4780.253299,265.569628,398.354442,112.506418,3,0
0,0,16,16,16,20,36,57,46,103,0.000333,0.177501,16,8520.036402,473.335356,532.502275,150.438562,4,0
0,0,13,13,15,18,33,50,42,92,0.000333,0.154695,14,6497.179626,360.954424,464.084259,133.662009,2,0
0,0,14,14,12,22,34,46,46,92,0.000333,0.156016,12,5616.558977,312.031054,468.046581,141.127046,1,0
0,0,17,17,16,25,41,59,54,113,0.000333,0.201801,16,9686.454024,538.136335,605.403377,180.096405,2,0
0,0,15,15,16,21,37,57,47,104,0.000333,0.180594,16,8668.5304,481.585022,541.78315,156.238666,2,0
0,0,5,5,12,12,24,22,17,39,0.000333,0.059605,6,1072.881225,59.604513,178.813538,86.0391,1,0
0,0,8,8,15,15,30,35,25,60,0.000333,0.098138,7,2060.89405,114.494114,294.413436,117.206718,2,0
0,0,16,16,17,22,39,74,57,131,0.000333,0.230796,16,11078.20305,615.455725,692.387691,167.594364,5,0
0,0,10,10,13,20,33,36,35,71,0.000333,0.119384,6,2148.911895,119.383994,358.151982,134.544278,2,0
0,0,11,11,13,20,33,37,37,74,0.000333,0.124428,6,2239.710989,124.428388,373.285165,134.544278,2,0
0,0,11,11,15,26,41,51,44,95,0.000333,0.169656,7,3562.772083,197.931782,508.96744,180.814792,4,0
0,0,12,12,15,26,41,52,46,98,0.000333,0.175013,7,3675.280675,204.18226,525.040096,180.814792,4,0
0,0,14,14,12,16,28,59,51,110,0.000333,0.17627,18,9518.562746,528.809041,528.809041,107.01955,1,0
0,0,16,16,16,19,35,67,56,123,0.000333,0.210301,16,10094.42898,560.80161,630.901811,144.710623,2,0
0,0,7,7,9,11,20,20,17,37,0.000333,0.053304,4,639.645358,35.535853,159.91134,66.583073,2,0
0,0,16,16,16,21,37,78,48,126,0.000333,0.218797,16,10502.25799,583.458777,656.391124,156.238666,6,0
0,0,7,7,10,13,23,34,27,61,0.000333,0.091979,10,2759.372793,153.298489,275.937279,81.324997,1,0
0,0,10,10,14,16,30,47,35,82,0.000333,0.134122,14,5633.110404,312.950578,402.365029,117.302969,2,0
0,0,16,16,12,19,31,80,59,139,0.000333,0.229544,18,12395.39917,688.633287,688.633287,123.730173,1,0
0,0,19,19,16,22,38,93,67,160,0.000333,0.279889,24,20152.04165,1119.55787,839.668402,162.107496,2,0
0,0,10,10,14,17,31,47,35,82,0.000333,0.135415,14,5687.417364,315.967631,406.244097,122.789837,2,0
0,0,13,13,10,16,26,52,63,115,0.000333,0.180184,15,8108.258514,450.458806,540.550568,97.219281,1,0
0,0,16,16,14,19,33,65,71,136,0.000333,0.228679,21,14406.78961,800.3772,686.0376,134.013592,2,0
0,0,10,10,14,16,30,47,35,82,0.000333,0.134122,14,5633.110404,312.950578,402.365029,117.302969,2,0
0,0,11,11,10,14,24,39,36,75,0.000333,0.114624,10,3438.721876,191.040104,343.872188,86.52225,2,0
0,0,19,19,16,22,38,90,63,153,0.000333,0.267644,16,12846.92655,713.718142,802.93291,162.107496,5,0
0,0,17,17,16,21,37,83,55,138,0.000333,0.239635,16,11502.47303,639.02628,718.904564,156.238666,5,0
0,0,9,9,10,13,23,32,28,60,0.000333,0.090471,10,2714.137174,150.785399,271.413717,81.324997,2,0
0,0,30,30,19,51,70,128,113,241,0.000333,0.492386,18,26588.82973,1477.157207,1477.157207,370.004315,10,0
0,0,29,29,19,51,70,127,111,238,0.000333,0.486256,18,26257.84845,1458.769358,1458.769358,370.004315,10,0
0,0,30,30,22,54,76,133,117,250,0.000333,0.520661,22,34363.60132,1909.088962,1561.981878,408.871421,11,0
0,0,29,29,22,54,76,132,115,247,0.000333,0.514413,22,33951.23811,1886.179895,1543.238096,408.871421,11,0
0,0,11,11,12,17,29,32,46,78,0.000333,0.126308,12,4547.070211,252.615012,378.922518,112.506418,2,0
0,0,30,30,23,52,75,135,117,252,0.000333,0.523221,22,34532.57082,1918.476157,1569.66231,400.46479,11,0
0,0,12,12,11,18,29,44,48,92,0.000333,0.148978,10,4469.342516,248.296806,446.934252,113.112398,2,0
0,0,19,19,14,20,34,68,65,133,0.000333,0.225544,21,14209.28372,789.404651,676.632558,139.741531,3,0
0,0,21,21,18,23,41,76,70,146,0.000333,0.260734,27,21119.47,1173.303889,782.202593,179.100575,4,0
0,0,12,12,12,17,29,45,47,92,0.000333,0.148978,12,5363.211019,297.956168,446.934252,112.506418,2,0
0,0,10,10,14,15,29,32,26,58,0.000333,0.093921,7,1972.340284,109.57446,281.762898,111.906328,3,0
0,0,19,19,14,20,34,68,65,133,0.000333,0.225544,21,14209.28372,789.404651,676.632558,139.741531,3,0
0,0,21,21,18,23,41,76,70,146,0.000333,0.260734,27,21119.47,1173.303889,782.202593,179.100575,4,0
0,0,12,12,12,17,29,45,47,92,0.000333,0.148978,12,5363.211019,297.956168,446.934252,112.506418,2,0
0,0,10,10,14,15,29,32,26,58,0.000333,0.093921,7,1972.340284,109.57446,281.762898,111.906328,3,0
0,0,12,12,11,18,29,44,48,92,0.000333,0.148978,10,4469.342516,248.296806,446.934252,113.112398,2,0
0,0,18,18,13,19,32,65,64,129,0.000333,0.215,18,11610,645,645,128.816339,2,0
0,0,20,20,17,22,39,73,69,142,0.000333,0.250176,24,18012.65076,1000.70282,750.527115,167.594364,3,0
0,0,12,12,12,17,29,45,47,92,0.000333,0.148978,12,5363.211019,297.956168,446.934252,112.506418,2,0
0,0,9,9,13,14,27,29,25,54,0.000333,0.085588,6,1540.583551,85.587975,256.763925,101.408685,2,0
0,0,19,19,13,21,34,63,72,135,0.000333,0.228936,18,12362.5347,686.807484,686.807484,140.344382,2,0
0,0,18,18,13,21,34,61,70,131,0.000333,0.222153,18,11996.23738,666.457632,666.457632,140.344382,2,0
0,0,19,19,14,22,36,63,78,141,0.000333,0.242986,21,15308.14793,850.452663,728.959425,151.410465,2,0
0,0,18,18,14,22,36,61,76,137,0.000333,0.236093,21,14873.87423,826.326346,708.279725,151.410465,2,0
0,0,12,12,9,17,26,45,61,106,0.000333,0.166082,12,5978.959321,332.164407,498.24661,98.016193,1,0
0,0,15,15,13,20,33,58,69,127,0.000333,0.213546,18,11531.48496,640.638053,640.638053,134.544278,2,0
0,0,9,9,13,17,30,40,33,73,0.000333,0.119401,6,2149.218081,119.401004,358.203013,117.592585,2,0
0,0,15,15,15,16,31,64,45,109,0.000333,0.180002,14,7560.10357,420.005754,540.007398,122.603359,2,0
0,0,9,9,14,14,28,35,26,61,0.000333,0.09775,7,2052.740552,114.041142,293.24865,106.605938,2,0
0,0,18,18,18,23,41,68,69,137,0.000333,0.244662,27,19817.58487,1100.976937,733.984625,179.100575,2,0
0,0,9,9,14,18,32,35,34,69,0.000333,0.115,7,2415,134.166667,345,128.361619,2,0
0,0,6,6,6,11,17,13,18,31,0.000333,0.042237,3,380.134044,21.118558,126.711348,53.563523,1,0
0,0,7,7,8,13,21,17,20,37,0.000333,0.054172,4,650.062979,36.11461,162.515745,72.105716,1,0
0,0,6,6,7,13,20,14,18,32,0.000333,0.046101,3,414.905097,23.050283,138.301699,67.757201,1,0
0,0,13,13,12,14,26,64,42,106,0.000333,0.166082,18,8968.438982,498.24661,498.24661,96.322519,2,0
0,0,16,16,16,17,33,77,50,127,0.000333,0.213546,16,10250.20885,569.456047,640.638053,133.486868,3,0
0,0,18,18,17,20,37,66,60,126,0.000333,0.218797,24,15753.38698,875.188165,656.391124,155.92543,4,0
0,0,13,13,17,19,36,46,41,87,0.000333,0.149928,16,7196.535602,399.807533,449.783475,150.197491,3,0
0,0,13,13,12,15,27,64,42,106,0.000333,0.168006,12,6048.216903,336.01205,504.018075,101.622909,2,0
0,0,16,16,16,18,34,77,50,127,0.000333,0.215369,16,10337.72449,574.318027,646.107781,139.05865,3,0
0,0,10,10,15,15,30,47,32,79,0.000333,0.129215,14,5427.020999,301.501167,387.644357,117.206718,2,0
0,0,13,13,12,15,27,64,42,106,0.000333,0.168006,12,6048.216903,336.01205,504.018075,101.622909,2,0
0,0,16,16,16,18,34,77,50,127,0.000333,0.215369,16,10337.72449,574.318027,646.107781,139.05865,3,0
0,0,10,10,15,15,30,47,32,79,0.000333,0.129215,14,5427.020999,301.501167,387.644357,117.206718,2,0
0,0,14,14,12,15,27,70,47,117,0.000333,0.185441,18,10013.79308,556.321838,556.321838,101.622909,1,0
0,0,17,17,16,18,34,83,55,138,0.000333,0.234023,24,16849.67693,936.093163,702.069872,139.05865,2,0
0,0,22,22,17,27,44,108,75,183,0.000333,0.333025,16,15985.21578,888.067543,999.075986,197.868831,6,0
0,0,13,13,11,19,30,53,47,100,0.000333,0.163563,10,4906.890596,272.605033,490.68906,118.764371,2,0
0,0,21,21,17,27,44,104,74,178,0.000333,0.323926,16,15548.46125,863.803403,971.778828,197.868831,5,0
0,0,12,12,12,18,30,42,51,93,0.000333,0.152114,12,5476.089905,304.227217,456.340825,118.0782,4,0
0,0,10,10,11,15,26,31,42,73,0.000333,0.114377,10,3431.320994,190.628944,343.132099,96.657107,2,0
0,0,22,22,19,44,63,99,77,176,0.000333,0.350667,9,9468.011399,526.000633,1052.001267,320.925614,9,0
0,0,21,21,19,44,63,98,75,173,0.000333,0.34469,9,9306.624841,517.034713,1034.069427,320.925614,9,0
0,0,10,10,10,17,27,36,34,70,0.000333,0.110947,10,3328.421252,184.912292,332.842125,102.706149,2,0
0,0,13,13,14,20,34,49,42,91,0.000333,0.15432,14,6481.42766,360.079314,462.959119,139.741531,3,0
0,0,10,10,13,17,30,39,31,70,0.000333,0.114494,6,2060.89405,114.494114,343.482342,117.592585,2,0
0,0,15,15,14,21,35,61,64,125,0.000333,0.21372,21,13464.36792,748.02044,641.160377,145.541635,1,0
0,0,17,17,18,24,42,69,69,138,0.000333,0.248047,18,13394.51648,744.139804,744.139804,185.09775,2,0
0,0,7,7,6,12,18,15,22,37,0.000333,0.051429,3,462.861675,25.714538,154.287225,58.529325,1,0
0,0,7,7,8,14,22,17,22,39,0.000333,0.057973,4,695.671333,38.648407,173.917833,77.302969,1,0
0,0,7,7,7,14,21,16,22,38,0.000333,0.055636,3,500.724186,27.81801,166.908062,72.954453,1,0
0,0,13,13,10,19,29,38,48,86,0.000333,0.139262,10,4177.863656,232.103536,417.786366,113.929904,1,0
0,0,14,14,12,19,31,41,50,91,0.000333,0.150277,12,5409.982371,300.554576,450.831864,123.730173,2,0
0,0,13,13,12,15,27,64,42,106,0.000333,0.168006,12,6048.216903,336.01205,504.018075,101.622909,2,0
0,0,16,16,15,18,33,77,50,127,0.000333,0.213546,14,8968.932744,498.274041,640.638053,133.662009,3,0
0,0,13,13,12,15,27,64,42,106,0.000333,0.168006,12,6048.216903,336.01205,504.018075,101.622909,2,0
0,0,16,16,15,18,33,77,50,127,0.000333,0.213546,14,8968.932744,498.274041,640.638053,133.662009,3,0
0,0,19,19,18,20,38,84,58,142,0.000333,0.248402,18,13413.70272,745.205707,745.205707,161.497212,4,0
0,0,10,10,14,14,28,42,30,72,0.000333,0.115377,14,4845.813761,269.211876,346.129554,106.605938,2,0
0,0,19,19,18,20,38,83,58,141,0.000333,0.246653,18,13319.24003,739.957779,739.957779,161.497212,4,0
0,0,10,10,14,14,28,42,30,72,0.000333,0.115377,14,4845.813761,269.211876,346.129554,106.605938,2,0
0,0,14,14,13,18,31,56,49,105,0.000333,0.173397,12,6242.287351,346.793742,520.190613,123.164366,2,0
0,0,16,16,15,20,35,64,54,118,0.000333,0.201752,14,8473.575544,470.754197,605.255396,145.041921,3,0
0,0,14,14,12,18,30,55,49,104,0.000333,0.170106,12,6123.799463,340.211081,510.316622,118.0782,2,0
0,0,16,16,15,20,35,63,54,117,0.000333,0.200042,14,8401.765582,466.764755,600.126113,145.041921,3,0
0,0,5,5,12,12,24,22,17,39,0.000333,0.059605,6,1072.881225,59.604513,178.813538,86.0391,1,0
0,0,8,8,15,15,30,35,25,60,0.000333,0.098138,7,2060.89405,114.494114,294.413436,117.206718,2,0
0,0,14,14,16,19,35,67,50,117,0.000333,0.200042,16,9602.017808,533.445434,600.126113,144.710623,5,0
0,0,14,14,14,19,33,56,47,103,0.000333,0.173191,14,7274.01632,404.112018,519.572594,134.013592,3,0
0,0,17,17,18,22,40,69,55,124,0.000333,0.219973,18,11878.54351,659.919084,659.919084,173.166146,4,0
0,0,13,13,15,18,33,50,40,90,0.000333,0.151332,14,6355.93659,353.107588,453.995471,133.662009,2,0
0,0,5,5,12,12,24,22,17,39,0.000333,0.059605,6,1072.881225,59.604513,178.813538,86.0391,1,0
0,0,8,8,15,15,30,35,25,60,0.000333,0.098138,7,2060.89405,114.494114,294.413436,117.206718,2,0
0,0,9,9,12,16,28,35,33,68,0.000333,0.108967,12,3922.801616,217.933423,326.900135,107.01955,1,0
0,0,13,13,12,15,27,44,36,80,0.000333,0.126797,12,4564.692002,253.594,380.391,101.622909,3,0
0,0,16,16,16,18,34,57,44,101,0.000333,0.171278,16,8221.339951,456.741108,513.833747,139.05865,4,0
0,0,13,13,15,18,33,50,40,90,0.000333,0.151332,14,6355.93659,353.107588,453.995471,133.662009,2,0
0,0,11,11,16,20,36,44,32,76,0.000333,0.130971,8,3143.314401,174.628578,392.9143,150.438562,5,0
0,0,12,12,16,20,36,45,34,79,0.000333,0.136141,8,3267.392601,181.521811,408.424075,150.438562,5,0
0,0,11,11,16,20,36,44,32,76,0.000333,0.130971,8,3143.314401,174.628578,392.9143,150.438562,5,0
0,0,12,12,16,20,36,45,34,79,0.000333,0.136141,8,3267.392601,181.521811,408.424075,150.438562,5,0
0,0,27,27,19,48,67,123,98,221,0.000333,0.446869,18,24130.9028,1340.605711,1340.605711,348.788823,8,0
0,0,26,26,19,48,67,122,96,218,0.000333,0.440802,18,23803.33398,1322.407444,1322.407444,348.788823,8,0
0,0,27,27,22,51,73,128,100,228,0.000333,0.470427,11,15524.07999,862.448889,1411.279999,387.401188,9,0
0,0,26,26,22,51,73,127,98,225,0.000333,0.464237,11,15319.81578,851.100877,1392.710526,387.401188,9,0
0,0,11,11,14,18,32,40,39,79,0.000333,0.131667,14,5530,307.222222,395,128.361619,2,0
0,0,27,27,23,49,72,130,100,230,0.000333,0.473028,22,31219.82051,1734.434473,1419.08275,379.162707,9,0
0,0,14,14,12,22,34,56,53,109,0.000333,0.184844,12,6654.401396,369.688966,554.53345,141.127046,2,0
0,0,11,11,12,21,33,40,38,78,0.000333,0.131154,6,2360.776448,131.154247,393.462741,135.258216,2,0
0,0,13,13,10,19,29,49,47,96,0.000333,0.155455,10,4663.661755,259.09232,466.366176,113.929904,2,0
0,0,8,8,9,15,24,24,23,47,0.000333,0.071831,4,861.97295,47.887386,215.493238,87.132684,1,0
0,0,13,13,12,22,34,52,52,104,0.000333,0.176365,12,6349.153626,352.730757,529.096135,141.127046,1,0
0,0,11,11,13,23,36,41,38,79,0.000333,0.136141,6,2450.544451,136.141358,408.424075,152.147641,2,0
0,0,14,14,10,20,30,53,50,103,0.000333,0.16847,10,5054.097313,280.783184,505.409731,119.657843,2,0
0,0,16,16,14,26,40,65,61,126,0.000333,0.223521,14,9387.881159,521.548953,670.56294,175.514402,2,0
0,0,18,18,16,21,37,69,66,135,0.000333,0.234425,24,16878.62891,937.701606,703.276204,156.238666,2,0
0,0,18,18,16,22,38,71,67,138,0.000333,0.241405,24,17381.13593,965.618662,724.213997,162.107496,2,0
0,0,10,10,10,18,28,38,36,74,0.000333,0.118581,10,3557.442642,197.635702,355.744264,108.277931,1,0
0,0,10,10,11,19,30,38,35,73,0.000333,0.119401,5,1791.015067,99.500837,358.203013,118.764371,1,0
0,0,20,20,15,24,39,80,74,154,0.000333,0.271317,21,17092.99078,949.610599,813.951942,168.642459,2,0
0,0,17,17,15,24,39,69,62,131,0.000333,0.230796,14,9693.427669,538.523759,692.387691,168.642459,2,0
0,0,13,13,11,15,26,44,34,78,0.000333,0.122211,10,3666.34298,203.685721,366.634298,96.657107,3,0
0,0,16,16,15,18,33,57,42,99,0.000333,0.166465,14,6991.530249,388.418347,499.395018,133.662009,4,0
0,0,13,13,11,15,26,44,34,78,0.000333,0.122211,10,3666.34298,203.685721,366.634298,96.657107,3,0
0,0,16,16,15,18,33,57,42,99,0.000333,0.166465,14,6991.530249,388.418347,499.395018,133.662009,4,0
0,0,32,32,21,54,75,136,111,247,0.000333,0.512839,20,30770.36433,1709.464685,1538.518217,403.002591,11,0
0,0,31,31,21,54,75,135,109,244,0.000333,0.506611,20,30396.63521,1688.701956,1519.83176,403.002591,11,0
0,0,16,16,11,19,30,51,57,108,0.000333,0.176648,15,7949.162765,441.620154,529.944184,118.764371,2,0
0,0,19,19,15,22,37,64,65,129,0.000333,0.224006,14,9408.272778,522.681821,672.019484,156.710855,3,0
0,0,10,10,13,18,31,41,33,74,0.000333,0.122204,6,2199.663162,122.203509,366.610527,123.164366,2,0
0,0,13,13,13,17,30,45,40,85,0.000333,0.139029,12,5005.028408,278.057134,417.085701,117.592585,3,0
0,0,16,16,15,20,35,58,48,106,0.000333,0.181235,14,7611.855997,422.880889,543.704,145.041921,4,0
0,0,13,13,12,17,29,44,40,84,0.000333,0.136023,12,4896.844843,272.046936,408.070404,112.506418,3,0
0,0,16,16,15,20,35,57,48,105,0.000333,0.179525,14,7540.046035,418.891446,538.574717,145.041921,4,0
0,0,13,13,13,15,28,47,44,91,0.000333,0.145823,12,5249.631575,291.646199,437.469298,106.709075,2,0
0,0,15,15,15,18,33,55,49,104,0.000333,0.174872,14,7344.637838,408.035435,524.616988,133.662009,3,0
0,0,12,12,15,18,33,44,37,81,0.000333,0.136199,14,5720.342931,317.79683,408.595924,133.662009,3,0
0,0,13,13,12,15,27,46,44,90,0.000333,0.142647,12,5135.278502,285.29325,427.939875,101.622909,2,0
0,0,15,15,15,18,33,54,49,103,0.000333,0.173191,14,7274.01632,404.112018,519.572594,133.662009,3,0
0,0,12,12,15,18,33,43,37,80,0.000333,0.134517,14,5649.721414,313.873412,403.55153,133.662009,3,0
0,0,17,17,14,23,37,56,63,119,0.000333,0.206642,14,8678.949307,482.16385,619.924951,157.344894,2,0
0,0,13,13,14,21,35,41,46,87,0.000333,0.148749,14,6247.466715,347.081484,446.247622,145.541635,2,0
0,0,7,7,11,17,28,27,31,58,0.000333,0.092942,5,1394.132927,77.451829,278.826585,107.540616,2,0
0,0,18,18,14,24,38,59,68,127,0.000333,0.222162,14,9330.815119,518.378618,666.486794,163.342069,2,0
0,0,20,20,18,27,45,67,73,140,0.000333,0.256286,18,13839.4698,768.859433,768.859433,203.440613,3,0
0,0,7,7,11,18,29,27,32,59,0.000333,0.09554,5,1433.104394,79.616911,286.620879,113.112398,2,0
0,0,17,17,13,22,35,61,61,122,0.000333,0.208591,12,7509.270337,417.181685,625.772528,146.213212,2,0
0,0,11,11,9,17,26,34,39,73,0.000333,0.114377,8,2745.056795,152.503155,343.132099,98.016193,1,0
0,0,13,13,13,20,33,46,44,90,0.000333,0.151332,12,5447.945649,302.663647,453.995471,134.544278,2,0
0,0,7,7,8,14,22,19,21,40,0.000333,0.059459,4,713.509059,39.639392,178.377265,77.302969,1,0
0,0,7,7,12,16,28,30,29,59,0.000333,0.094545,6,1701.803642,94.544647,283.63394,107.01955,2,0
0,0,18,18,13,24,37,67,65,132,0.000333,0.229216,12,8251.774131,458.431896,687.647844,158.144816,2,0
0,0,20,20,17,27,44,75,70,145,0.000333,0.263873,16,12665.88136,703.660075,791.617585,197.868831,3,0
0,0,7,7,12,17,29,30,30,60,0.000333,0.09716,6,1748.873158,97.15962,291.47886,112.506418,2,0
0,0,14,14,13,21,34,50,47,97,0.000333,0.164495,12,5921.806747,328.989264,493.483896,140.344382,2,0
0,0,15,15,15,17,32,61,52,113,0.000333,0.188333,21,11865,659.166667,565,128.090227,3,0
0,0,17,17,18,20,38,69,57,126,0.000333,0.220413,18,11902.2996,661.238867,661.238867,161.497212,4,0
0,0,15,15,15,17,32,61,52,113,0.000333,0.188333,21,11865,659.166667,565,128.090227,3,0
0,0,17,17,18,20,38,69,57,126,0.000333,0.220413,18,11902.2996,661.238867,661.238867,161.497212,4,0
0,0,15,15,16,17,33,62,53,115,0.000333,0.193368,24,13922.52777,773.473765,580.105324,133.486868,3,0
0,0,17,17,18,20,38,70,58,128,0.000333,0.223912,18,12091.22499,671.734722,671.734722,161.497212,4,0
0,0,15,15,15,17,32,61,53,114,0.000333,0.19,21,11970,665,570,128.090227,3,0
0,0,17,17,18,20,38,69,58,127,0.000333,0.222162,18,11996.7623,666.486794,666.486794,161.497212,4,0
0,0,17,17,16,21,37,83,57,140,0.000333,0.243108,16,11669.17554,648.28753,729.323471,156.238666,5,0
0,0,17,17,16,21,37,83,57,140,0.000333,0.243108,16,11669.17554,648.28753,729.323471,156.238666,5,0
0,0,9,9,10,12,22,31,29,60,0.000333,0.089189,10,2675.658971,148.647721,267.565897,76.238831,1,0
0,0,9,9,10,12,22,31,29,60,0.000333,0.089189,10,2675.658971,148.647721,267.565897,76.238831,1,0
0,0,16,16,15,18,33,68,47,115,0.000333,0.193368,14,8121.474532,451.19303,580.105324,133.662009,3,0
0,0,9,9,14,14,28,35,26,61,0.000333,0.09775,7,2052.740552,114.041142,293.24865,106.605938,2,0
0,0,16,16,15,18,33,67,47,114,0.000333,0.191687,14,8050.853014,447.269612,575.06093,133.662009,3,0
0,0,9,9,14,14,28,35,26,61,0.000333,0.09775,7,2052.740552,114.041142,293.24865,106.605938,2,0
0,0,15,15,12,16,28,55,41,96,0.000333,0.153835,12,5538.07287,307.670715,461.506073,107.01955,2,0
0,0,18,18,15,19,34,68,49,117,0.000333,0.198411,14,8333.264134,462.959119,595.233152,139.313982,3,0
0,0,15,15,15,19,34,54,39,93,0.000333,0.157711,14,6623.876619,367.993146,473.134044,139.313982,3,0
0,0,15,15,12,15,27,55,41,96,0.000333,0.152156,12,5477.630402,304.3128,456.4692,101.622909,2,0
0,0,18,18,15,18,33,68,49,117,0.000333,0.196731,14,8262.717568,459.039865,590.194112,133.662009,3,0
0,0,15,15,15,18,33,54,39,93,0.000333,0.156376,14,6567.801143,364.877841,469.128653,133.662009,3,0
0,0,13,13,11,14,25,51,38,89,0.000333,0.137768,10,4133.032009,229.612889,413.303201,91.356717,2,0
0,0,16,16,14,17,31,64,46,110,0.000333,0.181654,14,7629.462318,423.859018,544.961594,122.789837,3,0
0,0,13,13,14,17,31,50,36,86,0.000333,0.14202,14,5964.852358,331.380687,426.060883,122.789837,3,0
0,0,13,13,11,14,25,51,38,89,0.000333,0.137768,10,4133.032009,229.612889,413.303201,91.356717,2,0
0,0,16,16,14,17,31,64,46,110,0.000333,0.181654,14,7629.462318,423.859018,544.961594,122.789837,3,0
0,0,13,13,14,17,31,50,36,86,0.000333,0.14202,14,5964.852358,331.380687,426.060883,122.789837,3,0
0,0,14,14,13,16,29,57,44,101,0.000333,0.163552,12,5887.872966,327.104054,490.656081,112.105716,2,0
0,0,17,17,17,19,36,70,52,122,0.000333,0.210244,16,10091.6936,560.649645,630.73085,150.197491,3,0
0,0,10,10,14,15,29,43,31,74,0.000333,0.11983,14,5032.868311,279.603795,359.490594,111.906328,2,0
0,0,14,14,17,19,36,56,42,98,0.000333,0.168884,16,8106.442402,450.357911,506.65265,150.197491,3,0
0,0,11,11,14,16,30,45,33,78,0.000333,0.127579,14,5358.32453,297.684696,382.737466,117.302969,2,0
0,0,9,9,14,12,26,29,24,53,0.000333,0.083041,14,3487.726271,193.762571,249.123305,96.322519,2,0
0,0,25,25,23,43,66,119,85,204,0.000333,0.411019,11,13563.6204,753.534467,1233.0564,337.371309,9,0
0,0,24,24,22,45,67,113,81,194,0.000333,0.392274,11,12945.03433,719.168574,1176.821303,345.240885,9,0
0,0,23,23,22,45,67,112,79,191,0.000333,0.386208,11,12744.85339,708.047411,1158.623035,345.240885,9,0
0,0,15,15,16,22,38,51,56,107,0.000333,0.187176,16,8984.451903,499.136217,561.528244,162.107496,2,0
0,0,15,15,17,23,40,52,65,117,0.000333,0.207555,16,9962.649394,553.480522,622.665587,173.528793,2,0
0,0,15,15,18,23,41,57,68,125,0.000333,0.223231,18,12054.49201,669.694001,669.694001,179.100575,2,0
0,0,12,12,13,15,28,35,50,85,0.000333,0.136208,18,7355.253031,408.625168,408.625168,106.709075,1,0
0,0,12,12,14,16,30,38,53,91,0.000333,0.148842,21,9377.067928,520.948218,446.527044,117.302969,1,0
0,0,19,19,18,25,43,70,69,139,0.000333,0.251417,18,13576.51442,754.250801,754.250801,191.155055,3,0
0,0,16,16,18,20,38,54,63,117,0.000333,0.204669,27,16578.20302,921.011279,614.007519,161.497212,2,0
0,0,19,19,19,26,45,73,78,151,0.000333,0.276423,27,22390.28507,1243.904726,829.269818,202.922055,3,0
0,0,14,14,13,15,28,65,44,109,0.000333,0.174667,12,6288.020238,349.334458,524.001687,106.709075,2,0
0,0,17,17,15,17,32,78,52,130,0.000333,0.216667,21,13650,758.333333,650,128.090227,3,0
0,0,14,14,12,15,27,64,44,108,0.000333,0.171176,12,6162.334203,342.3519,513.52785,101.622909,2,0
0,0,17,17,15,17,32,77,52,129,0.000333,0.215,21,13545,752.5,645,128.090227,3,0
0,0,9,9,14,16,30,42,34,76,0.000333,0.124308,14,5220.931594,290.051755,372.923685,117.302969,2,0
0,0,12,12,17,19,36,55,42,97,0.000333,0.167161,16,8023.723602,445.762422,501.482725,150.197491,3,0
0,0,10,10,14,17,31,46,35,81,0.000333,0.133763,14,5618.058616,312.114368,401.289901,122.789837,2,0
0,0,13,13,12,15,27,55,46,101,0.000333,0.160081,18,8644.385479,480.243638,480.243638,101.622909,2,0
0,0,15,15,15,18,33,63,51,114,0.000333,0.191687,14,8050.853014,447.269612,575.06093,133.662009,3,0
0,0,13,13,12,14,26,55,46,101,0.000333,0.158248,18,8545.399408,474.744412,474.744412,96.322519,2,0
0,0,15,15,15,17,32,63,51,114,0.000333,0.19,21,11970,665,570,128.090227,3,0
0,0,16,16,12,19,31,52,54,106,0.000333,0.175048,12,6301.737707,350.096539,525.144809,123.730173,3,0
0,0,19,19,16,22,38,65,62,127,0.000333,0.222162,16,10663.78871,592.432706,666.486794,162.107496,4,0
0,0,16,16,12,19,31,52,54,106,0.000333,0.175048,12,6301.737707,350.096539,525.144809,123.730173,3,0
0,0,19,19,16,22,38,65,62,127,0.000333,0.222162,16,10663.78871,592.432706,666.486794,162.107496,4,0
0,0,23,23,20,44,64,104,79,183,0.000333,0.366,10,10980,610,1098,326.653553,10,0
0,0,22,22,20,44,64,103,77,180,0.000333,0.36,10,10800,600,1080,326.653553,10,0
0,0,14,14,14,18,32,62,52,114,0.000333,0.19,14,7980,443.333333,570,128.361619,2,0
0,0,16,16,18,20,38,70,57,127,0.000333,0.222162,18,11996.7623,666.486794,666.486794,161.497212,3,0
0,0,10,10,12,17,29,35,38,73,0.000333,0.118211,12,4255.591352,236.421742,354.632613,112.506418,2,0
0,0,17,17,15,19,34,71,60,131,0.000333,0.222153,21,13995.61028,777.533904,666.457632,139.313982,2,0
0,0,19,19,19,21,40,79,65,144,0.000333,0.255453,27,20691.65643,1149.536468,766.357646,172.949289,3,0
0,0,10,10,13,15,28,36,37,73,0.000333,0.116979,12,4211.242912,233.95794,350.936909,106.709075,2,0
0,0,25,25,21,46,67,110,82,192,0.000333,0.38823,10,11646.89125,647.049514,1164.689125,346.322516,9,0
0,0,24,24,21,46,67,109,80,189,0.000333,0.382164,10,11464.90857,636.939365,1146.490857,346.322516,9,0
0,0,25,25,21,46,67,110,82,192,0.000333,0.38823,10,11646.89125,647.049514,1164.689125,346.322516,9,0
0,0,24,24,21,46,67,109,80,189,0.000333,0.382164,10,11464.90857,636.939365,1146.490857,346.322516,9,0
0,0,14,14,15,17,32,52,34,86,0.000333,0.143333,14,6020,334.444444,430,128.090227,5,0
0,0,8,8,12,16,28,30,23,53,0.000333,0.08493,6,1528.738865,84.929937,254.789811,107.01955,2,0
0,0,14,14,16,14,30,54,32,86,0.000333,0.140664,16,6751.88146,375.104526,421.992591,117.302969,5,0
0,0,14,14,16,14,30,54,32,86,0.000333,0.140664,16,6751.88146,375.104526,421.992591,117.302969,5,0
0,0,14,14,14,14,28,48,30,78,0.000333,0.124991,14,5249.631575,291.646199,374.973684,106.605938,4,0
0,0,14,14,14,14,28,48,30,78,0.000333,0.124991,14,5249.631575,291.646199,374.973684,106.605938,4,0
0,0,9,9,15,12,27,34,24,58,0.000333,0.091928,14,3860.968652,214.498258,275.783475,101.622909,5,0
0,0,9,9,14,12,26,33,24,57,0.000333,0.089308,14,3750.950895,208.386161,267.925064,96.322519,5,0
0,0,9,9,13,13,26,29,22,51,0.000333,0.079907,6,1438.334554,79.907475,239.722426,96.211433,4,0
0,0,9,9,12,13,25,28,22,50,0.000333,0.077398,6,1393.156857,77.397603,232.192809,91.125266,4,0
0,0,10,10,10,18,28,38,36,74,0.000333,0.118581,10,3557.442642,197.635702,355.744264,108.277931,1,0
0,0,10,10,11,19,30,38,35,73,0.000333,0.119401,5,1791.015067,99.500837,358.203013,118.764371,1,0
0,0,20,20,14,24,38,81,75,156,0.000333,0.272892,21,17192.21053,955.122807,818.676692,163.342069,2,0
0,0,22,22,18,26,44,89,80,169,0.000333,0.307548,27,24911.38648,1383.965915,922.643944,197.270083,3,0
0,0,17,17,15,24,39,69,61,130,0.000333,0.229034,14,9619.432038,534.412891,687.102288,168.642459,2,0
0,0,9,9,12,16,28,36,36,72,0.000333,0.115377,12,4153.554653,230.753036,346.129554,107.01955,2,0
0,0,11,11,16,19,35,44,41,85,0.000333,0.14533,16,6975.824903,387.545828,435.989056,144.710623,3,0
0,0,9,9,14,13,27,33,22,55,0.000333,0.087173,7,1830.631688,101.70176,261.518813,101.408685,5,0
0,0,9,9,14,12,26,33,22,55,0.000333,0.086175,7,1809.669291,100.537183,258.524184,96.322519,5,0
0,0,13,13,12,14,26,62,41,103,0.000333,0.161382,12,5809.743492,322.763527,484.145291,96.322519,2,0
0,0,16,16,15,17,32,75,49,124,0.000333,0.206667,14,8680,482.222222,620,128.090227,3,0
0,0,13,13,12,14,26,62,41,103,0.000333,0.161382,12,5809.743492,322.763527,484.145291,96.322519,2,0
0,0,16,16,15,17,32,75,49,124,0.000333,0.206667,14,8680,482.222222,620,128.090227,3,0
0,0,22,22,19,20,39,94,71,165,0.000333,0.290697,27,23546.46689,1308.137049,872.091366,167.149185,4,0
0,0,10,10,14,14,28,42,30,72,0.000333,0.115377,14,4845.813761,269.211876,346.129554,106.605938,2,0
0,0,22,22,19,20,39,94,71,165,0.000333,0.290697,27,23546.46689,1308.137049,872.091366,167.149185,4,0
0,0,10,10,14,14,28,42,30,72,0.000333,0.115377,14,4845.813761,269.211876,346.129554,106.605938,2,0
0,0,19,19,19,18,37,83,57,140,0.000333,0.243108,27,19691.73372,1093.985207,729.323471,155.769273,4,0
0,0,19,19,19,19,38,83,57,140,0.000333,0.244903,27,19837.166,1102.064778,734.709852,161.421246,4,0
0,0,10,10,14,14,28,42,30,72,0.000333,0.115377,14,4845.813761,269.211876,346.129554,106.605938,2,0
0,0,19,19,19,19,38,83,57,140,0.000333,0.244903,27,19837.166,1102.064778,734.709852,161.421246,4,0
0,0,10,10,14,14,28,42,30,72,0.000333,0.115377,14,4845.813761,269.211876,346.129554,106.605938,2,0
0,0,21,21,19,24,43,88,67,155,0.000333,0.280357,18,15139.27867,841.071037,841.071037,190.749723,3,0
0,0,10,10,14,14,28,42,30,72,0.000333,0.115377,14,4845.813761,269.211876,346.129554,106.605938,2,0
0,0,9,9,14,16,30,40,29,69,0.000333,0.112858,7,2370.028158,131.668231,338.575451,117.302969,3,0
0,0,6,6,9,9,18,16,14,30,0.000333,0.041699,4,500.391,27.7995,125.09775,57.05865,1,0
0,0,9,9,14,16,30,40,29,69,0.000333,0.112858,7,2370.028158,131.668231,338.575451,117.302969,3,0
0,0,6,6,9,9,18,16,14,30,0.000333,0.041699,4,500.391,27.7995,125.09775,57.05865,1,0
0,0,11,11,10,13,23,43,35,78,0.000333,0.117613,10,3528.378326,196.021018,352.837833,81.324997,1,0
0,0,14,14,14,16,30,56,43,99,0.000333,0.161927,14,6800.950366,377.830576,485.782169,117.302969,2,0
0,0,9,9,14,15,29,38,29,67,0.000333,0.108495,7,2278.393087,126.577394,325.484727,111.906328,2,0
0,0,11,11,14,15,29,39,30,69,0.000333,0.111734,14,4692.809641,260.711647,335.200689,111.906328,2,0
0,0,10,10,14,15,29,37,28,65,0.000333,0.105256,7,2210.381353,122.798964,315.768765,111.906328,2,0
0,0,12,12,11,14,25,46,36,82,0.000333,0.126932,10,3807.962076,211.553449,380.796208,91.356717,2,0
0,0,15,15,14,17,31,59,44,103,0.000333,0.170094,14,7143.95108,396.886171,510.28222,122.789837,3,0
0,0,9,9,14,15,29,38,29,67,0.000333,0.108495,7,2278.393087,126.577394,325.484727,111.906328,2,0
0,0,12,12,14,16,30,42,31,73,0.000333,0.119401,7,2507.421094,139.301172,358.203013,117.302969,3,0
0,0,10,10,14,15,29,37,28,65,0.000333,0.105256,7,2210.381353,122.798964,315.768765,111.906328,2,0
0,0,12,12,11,14,25,46,36,82,0.000333,0.126932,10,3807.962076,211.553449,380.796208,91.356717,2,0
0,0,15,15,14,17,31,59,44,103,0.000333,0.170094,14,7143.95108,396.886171,510.28222,122.789837,3,0
0,0,9,9,14,15,29,38,29,67,0.000333,0.108495,7,2278.393087,126.577394,325.484727,111.906328,2,0
0,0,12,12,14,16,30,42,31,73,0.000333,0.119401,7,2507.421094,139.301172,358.203013,117.302969,3,0
0,0,10,10,14,15,29,37,28,65,0.000333,0.105256,7,2210.381353,122.798964,315.768765,111.906328,2,0
0,0,23,23,17,45,62,104,81,185,0.000333,0.367175,8,8812.210539,489.567252,1101.526317,316.620258,9,0
0,0,22,22,17,45,62,103,79,182,0.000333,0.361221,8,8669.309828,481.628324,1083.663728,316.620258,9,0
0,0,23,23,18,47,65,105,81,186,0.000333,0.373387,9,10081.44372,560.080207,1120.160413,336.124326,9,0
0,0,22,22,18,47,65,104,79,183,0.000333,0.367364,9,9918.839788,551.046655,1102.09331,336.124326,9,0
0,0,30,30,18,51,69,133,106,239,0.000333,0.486646,18,26278.87221,1459.937345,1459.937345,364.352342,9,0
0,0,29,29,18,51,69,132,104,236,0.000333,0.480537,18,25949.01189,1441.611772,1441.611772,364.352342,9,0
0,0,31,31,20,54,74,138,109,247,0.000333,0.511245,20,30674.69963,1704.149979,1533.734981,397.202487,10,0
0,0,30,30,20,54,74,137,107,244,0.000333,0.505036,10,15151.06621,841.725901,1515.106621,397.202487,10,0
0,0,11,11,16,19,35,47,33,80,0.000333,0.136781,8,3282.741131,182.374507,410.342641,144.710623,6,0
0,0,9,9,14,20,34,40,29,69,0.000333,0.117012,7,2457.244552,136.513586,351.034936,139.741531,5,0
0,0,10,10,14,20,34,41,31,72,0.000333,0.122099,7,2564.081272,142.44896,366.297325,139.741531,5,0
0,0,11,11,16,19,35,46,33,79,0.000333,0.135071,8,3241.706867,180.094826,405.213358,144.710623,6,0
0,0,9,9,14,20,34,40,29,69,0.000333,0.117012,7,2457.244552,136.513586,351.034936,139.741531,5,0
0,0,10,10,14,20,34,41,31,72,0.000333,0.122099,7,2564.081272,142.44896,366.297325,139.741531,5,0
0,0,9,9,13,13,26,29,22,51,0.000333,0.079907,6,1438.334554,79.907475,239.722426,96.211433,4,0
0,0,9,9,12,13,25,28,22,50,0.000333,0.077398,6,1393.156857,77.397603,232.192809,91.125266,4,0
0,0,6,6,11,16,27,26,28,54,0.000333,0.085588,5,1283.819626,71.323313,256.763925,102.053748,1,0
0,0,9,9,14,19,33,38,37,75,0.000333,0.12611,7,2648.306913,147.128162,378.329559,134.013592,2,0
0,0,7,7,12,15,27,38,29,67,0.000333,0.106192,6,1911.464776,106.192488,318.577463,101.622909,1,0
0,0,10,10,15,18,33,51,37,88,0.000333,0.147969,14,6214.693555,345.260753,443.906683,133.662009,2,0
0,0,15,15,14,20,34,71,46,117,0.000333,0.198411,14,8333.264134,462.959119,595.233152,139.741531,5,0
0,0,13,13,13,17,30,45,40,85,0.000333,0.139029,12,5005.028408,278.057134,417.085701,117.592585,3,0
0,0,16,16,15,20,35,58,48,106,0.000333,0.181235,14,7611.855997,422.880889,543.704,145.041921,4,0
0,0,13,13,12,17,29,44,40,84,0.000333,0.136023,12,4896.844843,272.046936,408.070404,112.506418,3,0
0,0,16,16,15,20,35,57,48,105,0.000333,0.179525,14,7540.046035,418.891446,538.574717,145.041921,4,0
0,0,5,5,12,12,24,22,17,39,0.000333,0.059605,6,1072.881225,59.604513,178.813538,86.0391,1,0
0,0,8,8,15,15,30,35,25,60,0.000333,0.098138,7,2060.89405,114.494114,294.413436,117.206718,2,0
0,0,11,11,14,18,32,49,39,88,0.000333,0.146667,14,6160,342.222222,440,128.361619,3,0
0,0,13,13,12,15,27,44,36,80,0.000333,0.126797,12,4564.692002,253.594,380.391,101.622909,3,0
0,0,16,16,16,18,34,57,44,101,0.000333,0.171278,16,8221.339951,456.741108,513.833747,139.05865,4,0
0,0,13,13,15,18,33,50,40,90,0.000333,0.151332,14,6355.93659,353.107588,453.995471,133.662009,2,0
0,0,15,15,12,20,32,68,51,119,0.000333,0.198333,12,7140,396.666667,595,129.458112,1,0
0,0,18,18,16,22,38,81,59,140,0.000333,0.244903,16,11755.35763,653.075424,734.709852,162.107496,2,0
0,0,10,10,15,15,30,47,32,79,0.000333,0.129215,14,5427.020999,301.501167,387.644357,117.206718,2,0
0,0,13,13,15,13,28,42,28,70,0.000333,0.112172,14,4711.207824,261.733768,336.514845,106.709075,5,0
0,0,13,13,15,12,27,42,28,70,0.000333,0.110947,14,4659.789752,258.877208,332.842125,101.622909,5,0
0,0,13,13,13,13,26,36,26,62,0.000333,0.097142,12,3497.12715,194.284842,291.427263,96.211433,4,0
0,0,13,13,13,12,25,36,26,62,0.000333,0.095973,12,3455.029005,191.946056,287.919084,91.125266,4,0
0,0,10,10,13,19,32,37,29,66,0.000333,0.11,6,1980,110,330,128.816339,4,0
0,0,11,11,13,19,32,38,31,69,0.000333,0.115,6,2070,115,345,128.816339,4,0
0,0,10,10,13,19,32,37,29,66,0.000333,0.11,6,1980,110,330,128.816339,4,0
0,0,11,11,13,19,32,38,31,69,0.000333,0.115,6,2070,115,345,128.816339,4,0
0,0,22,22,18,25,43,84,92,176,0.000333,0.318341,27,25785.61011,1432.533895,955.022597,191.155055,3,0
0,0,9,9,10,12,22,31,27,58,0.000333,0.086216,10,2586.470339,143.692797,258.647034,76.238831,1,0
0,0,17,17,16,21,37,83,55,138,0.000333,0.239635,16,11502.47303,639.02628,718.904564,156.238666,5,0
0,0,16,16,15,24,39,70,55,125,0.000333,0.220225,14,9249.453883,513.858549,660.675277,168.642459,4,0
0,0,17,17,15,24,39,71,57,128,0.000333,0.22551,14,9471.440776,526.191154,676.531484,168.642459,4,0
0,0,5,5,9,14,23,21,18,39,0.000333,0.058806,4,705.675665,39.204204,176.418916,81.832294,2,0
0,0,6,6,9,14,23,22,20,42,0.000333,0.06333,4,759.958409,42.219912,189.989602,81.832294,2,0
0,0,26,26,26,49,75,122,101,223,0.000333,0.463009,26,36114.69077,2006.371709,1389.026568,397.332215,9,0
0,0,10,10,16,18,34,32,40,72,0.000333,0.122099,16,5860.757193,325.597622,366.297325,139.05865,2,0
0,0,25,25,21,49,70,112,87,199,0.000333,0.406576,10,12197.2732,677.626289,1219.72732,367.359448,8,0
0,0,24,24,21,49,70,111,85,196,0.000333,0.400446,10,12013.39471,667.410817,1201.339471,367.359448,8,0
0,0,25,25,24,50,74,117,91,208,0.000333,0.430522,12,15498.7956,861.0442,1291.5663,392.23191,9,0
0,0,24,24,24,50,74,116,89,205,0.000333,0.424313,12,15275.25528,848.625293,1272.93794,392.23191,9,0
0,0,4,4,7,9,16,10,10,20,0.000333,0.026667,3,240,13.333333,80,48.180809,2,0
0,0,4,4,8,8,16,11,9,20,0.000333,0.026667,4,320,17.777778,80,48,2,0
0,0,24,24,21,43,64,130,85,215,0.000333,0.43,10,12900,716.666667,1290,325.56805,9,0
0,0,15,15,16,20,36,77,48,125,0.000333,0.215414,16,10339.85,574.436111,646.240625,150.438562,5,0
0,0,4,4,8,8,16,11,9,20,0.000333,0.026667,4,320,17.777778,80,48,2,0
0,0,24,24,21,43,64,130,85,215,0.000333,0.43,10,12900,716.666667,1290,325.56805,9,0
0,0,15,15,16,20,36,77,48,125,0.000333,0.215414,16,10339.85,574.436111,646.240625,150.438562,5,0
0,0,4,4,8,8,16,11,9,20,0.000333,0.026667,4,320,17.777778,80,48,2,0
0,0,9,9,11,12,23,29,22,51,0.000333,0.076901,5,1153.508299,64.083794,230.70166,81.073298,3,0
0,0,6,6,10,11,21,19,17,36,0.000333,0.052708,5,790.617136,43.923174,158.123427,71.273029,1,0
0,0,4,4,8,8,16,11,9,20,0.000333,0.026667,4,320,17.777778,80,48,2,0
0,0,9,9,11,11,22,29,22,51,0.000333,0.07581,10,2274.310126,126.350563,227.431013,76.107496,3,0
0,0,6,6,10,11,21,19,17,36,0.000333,0.052708,5,790.617136,43.923174,158.123427,71.273029,1,0
0,0,13,13,11,19,30,52,54,106,0.000333,0.173377,10,5201.304031,288.961335,520.130403,118.764371,1,0
0,0,16,16,15,22,37,64,63,127,0.000333,0.220534,14,9262.408084,514.578227,661.600577,156.710855,2,0
0,0,7,7,15,10,25,27,19,46,0.000333,0.071206,7,1495.321693,83.073427,213.617385,91.82264,4,0
0,0,26,26,22,45,67,117,85,202,0.000333,0.40845,11,13478.85018,748.82501,1225.350016,345.240885,9,0
0,0,25,25,22,45,67,116,83,199,0.000333,0.402384,11,13278.66924,737.703847,1207.151749,345.240885,9,0
0,0,27,27,22,47,69,120,90,210,0.000333,0.427597,11,14110.6915,783.927305,1282.790136,359.173172,9,0
0,0,26,26,22,47,69,119,88,207,0.000333,0.421488,11,13909.11019,772.728344,1264.464563,359.173172,9,0
0,0,23,23,19,41,60,100,77,177,0.000333,0.348507,9,9409.676719,522.759818,1045.519635,300.370255,7,0
0,0,23,23,19,40,59,101,78,179,0.000333,0.350998,9,9476.937953,526.496553,1052.993106,293.587747,7,0
0,0,19,19,19,38,57,93,67,160,0.000333,0.311087,9,8399.36162,466.631201,933.262402,280.131868,7,0
0,0,20,20,17,41,58,92,69,161,0.000333,0.314378,8,7545.079522,419.171085,943.13494,289.1465,7,0
0,0,19,19,17,41,58,91,67,158,0.000333,0.30852,8,7404.487978,411.360443,925.560997,289.1465,7,0
0,0,20,20,18,40,58,93,68,161,0.000333,0.314378,9,8488.214462,471.56747,943.13494,287.935774,7,0
0,0,19,19,18,40,58,92,66,158,0.000333,0.30852,9,8330.048975,462.780499,925.560997,287.935774,7,0
0,0,12,12,10,14,24,41,42,83,0.000333,0.126851,15,5708.278313,317.126573,380.551888,86.52225,1,0
0,0,14,14,14,17,31,49,47,96,0.000333,0.158534,14,6658.439841,369.913325,475.602846,122.789837,2,0
0,0,11,11,14,17,31,38,35,73,0.000333,0.120552,14,5063.188629,281.288257,361.656331,122.789837,2,0
0,0,4,4,8,9,17,14,14,28,0.000333,0.03815,4,457.795838,25.433102,114.44896,52.529325,1,0
0,0,13,13,12,14,26,55,39,94,0.000333,0.14728,12,5302.096002,294.560889,441.841334,96.322519,2,0
0,0,16,16,15,17,32,68,47,115,0.000333,0.191667,14,8050,447.222222,575,128.090227,3,0
0,0,13,13,15,17,32,54,37,91,0.000333,0.151667,14,6370,353.888889,455,128.090227,3,0
0,0,13,13,12,14,26,55,39,94,0.000333,0.14728,12,5302.096002,294.560889,441.841334,96.322519,2,0
0,0,16,16,15,17,32,68,47,115,0.000333,0.191667,14,8050,447.222222,575,128.090227,3,0
0,0,13,13,15,17,32,54,37,91,0.000333,0.151667,14,6370,353.888889,455,128.090227,3,0
0,0,4,4,8,9,17,14,14,28,0.000333,0.03815,4,457.795838,25.433102,114.44896,52.529325,1,0
0,0,13,13,13,15,28,56,40,96,0.000333,0.153835,12,5538.07287,307.670715,461.506073,106.709075,2,0
0,0,16,16,15,18,33,69,48,117,0.000333,0.196731,14,8262.717568,459.039865,590.194112,133.662009,3,0
0,0,10,10,15,15,30,47,32,79,0.000333,0.129215,14,5427.020999,301.501167,387.644357,117.206718,2,0
0,0,13,13,15,18,33,55,38,93,0.000333,0.156376,14,6567.801143,364.877841,469.128653,133.662009,3,0
0,0,11,11,15,16,31,49,34,83,0.000333,0.137066,14,5756.776113,319.820895,411.198294,122.603359,2,0
0,0,4,4,9,8,17,15,13,28,0.000333,0.03815,4,457.795838,25.433102,114.44896,52.529325,1,0
0,0,13,13,12,15,27,55,40,95,0.000333,0.150571,12,5420.571752,301.142875,451.714313,101.622909,2,0
0,0,16,16,15,18,33,68,48,116,0.000333,0.19505,14,8192.09605,455.116447,585.149718,133.662009,3,0
0,0,10,10,15,15,30,47,32,79,0.000333,0.129215,14,5427.020999,301.501167,387.644357,117.206718,2,0
0,0,13,13,15,18,33,54,38,92,0.000333,0.154695,14,6497.179626,360.954424,464.084259,133.662009,3,0
0,0,11,11,15,16,31,49,34,83,0.000333,0.137066,14,5756.776113,319.820895,411.198294,122.603359,2,0
0,0,4,4,9,8,17,15,13,28,0.000333,0.03815,4,457.795838,25.433102,114.44896,52.529325,1,0
0,0,4,4,8,9,17,14,14,28,0.000333,0.03815,4,457.795838,25.433102,114.44896,52.529325,1,0
0,0,13,13,13,15,28,56,40,96,0.000333,0.153835,12,5538.07287,307.670715,461.506073,106.709075,2,0
0,0,16,16,15,18,33,69,48,117,0.000333,0.196731,14,8262.717568,459.039865,590.194112,133.662009,3,0
0,0,13,13,15,18,33,55,38,93,0.000333,0.156376,14,6567.801143,364.877841,469.128653,133.662009,3,0
0,0,13,13,12,15,27,55,40,95,0.000333,0.150571,12,5420.571752,301.142875,451.714313,101.622909,2,0
0,0,16,16,15,18,33,68,48,116,0.000333,0.19505,14,8192.09605,455.116447,585.149718,133.662009,3,0
0,0,13,13,15,18,33,54,38,92,0.000333,0.154695,14,6497.179626,360.954424,464.084259,133.662009,3,0
0,0,13,13,12,16,28,45,44,89,0.000333,0.142618,12,5134.255057,285.236392,427.854588,107.01955,2,0
0,0,15,15,14,19,33,53,49,102,0.000333,0.171509,14,7203.394802,400.1886,514.5282,134.013592,3,0
0,0,12,12,14,19,33,42,37,79,0.000333,0.132836,7,2789.549948,154.974997,398.507135,134.013592,3,0
0,0,13,13,11,16,27,44,44,88,0.000333,0.139477,10,4184.301002,232.461167,418.4301,102.053748,2,0
0,0,15,15,14,19,33,52,49,101,0.000333,0.169828,14,7132.773285,396.265182,509.483806,134.013592,3,0
0,0,12,12,14,19,33,41,37,78,0.000333,0.131154,7,2754.239189,153.013288,393.462741,134.013592,3,0
0,0,16,16,14,23,37,65,62,127,0.000333,0.220534,14,9262.408084,514.578227,661.600577,157.344894,4,0
0,0,13,13,10,18,28,44,52,96,0.000333,0.153835,10,4615.060725,256.392263,461.506073,108.277931,2,0
0,0,15,15,14,23,37,61,63,124,0.000333,0.215324,14,9043.611043,502.422836,645.972217,157.344894,3,0
0,0,13,13,13,22,35,51,46,97,0.000333,0.165847,12,5970.485432,331.693635,497.540453,146.213212,3,0
0,0,14,14,13,22,35,52,48,100,0.000333,0.170976,12,6155.13962,341.952201,512.928302,146.213212,3,0
0,0,14,14,16,25,41,59,50,109,0.000333,0.194658,16,9343.570696,519.087261,583.973169,180.096405,4,0
0,0,15,15,16,25,41,60,52,112,0.000333,0.200015,16,9600.733192,533.374066,600.045825,180.096405,4,0
0,0,15,15,12,21,33,58,56,114,0.000333,0.191687,12,6900.731155,383.373953,575.06093,135.258216,1,0
0,0,17,17,16,24,40,66,61,127,0.000333,0.225295,16,10814.15789,600.786549,675.884868,174.0391,2,0
0,0,17,17,11,17,28,62,61,123,0.000333,0.197102,15,8869.569831,492.75388,591.304655,107.540616,1,0
0,0,19,19,15,20,35,70,66,136,0.000333,0.232527,21,14649.2323,813.846239,697.58249,145.041921,2,0
0,0,11,11,14,16,30,40,33,73,0.000333,0.119401,14,5014.842189,278.602344,358.203013,117.302969,2,0
0,0,15,15,11,16,27,56,55,111,0.000333,0.175931,15,7916.887691,439.827094,527.792513,102.053748,1,0
0,0,17,17,15,19,34,64,60,124,0.000333,0.210282,21,13247.75324,735.986291,630.845392,139.313982,2,0
0,0,9,9,14,15,29,34,27,61,0.000333,0.098779,7,2074.357885,115.242105,296.336841,111.906328,2,0
0,0,13,13,12,16,28,45,35,80,0.000333,0.128196,12,4615.060725,256.392263,384.588394,107.01955,3,0
0,0,16,16,15,19,34,58,43,101,0.000333,0.171278,14,7193.672458,399.64847,513.833747,139.313982,4,0
0,0,13,13,11,16,27,44,35,79,0.000333,0.125212,10,3756.361127,208.686729,375.636113,102.053748,3,0
0,0,16,16,15,19,34,57,43,100,0.000333,0.169582,14,7122.447978,395.691554,508.746284,139.313982,4,0
0,0,13,13,12,16,28,45,44,89,0.000333,0.142618,12,5134.255057,285.236392,427.854588,107.01955,2,0
0,0,15,15,14,19,33,53,49,102,0.000333,0.171509,14,7203.394802,400.1886,514.5282,134.013592,3,0
0,0,12,12,14,19,33,42,37,79,0.000333,0.132836,7,2789.549948,154.974997,398.507135,134.013592,3,0
0,0,13,13,11,16,27,44,44,88,0.000333,0.139477,10,4184.301002,232.461167,418.4301,102.053748,2,0
0,0,15,15,14,19,33,52,49,101,0.000333,0.169828,14,7132.773285,396.265182,509.483806,134.013592,3,0
0,0,12,12,14,19,33,41,37,78,0.000333,0.131154,7,2754.239189,153.013288,393.462741,134.013592,3,0
0,0,16,16,15,19,34,66,54,120,0.000333,0.203499,14,8546.937573,474.829865,610.495541,139.313982,3,0
0,0,16,16,15,19,34,65,54,119,0.000333,0.201803,14,8475.713094,470.87295,605.408078,139.313982,3,0
0,0,14,14,12,13,25,59,43,102,0.000333,0.157891,18,8526.119964,473.673331,473.673331,91.125266,1,0
0,0,17,17,16,16,32,72,51,123,0.000333,0.205,24,14760,820,615,128,2,0
0,0,10,10,15,14,29,45,31,76,0.000333,0.123069,14,5168.891779,287.160654,369.206556,111.906328,2,0
0,0,13,13,15,16,31,52,37,89,0.000333,0.146974,14,6172.928603,342.940478,440.923472,122.603359,2,0
0,0,12,12,15,16,31,50,35,85,0.000333,0.140369,14,5895.493609,327.527423,421.106686,122.603359,2,0
0,0,12,12,12,16,28,49,43,92,0.000333,0.147426,12,5307.319834,294.851102,442.276653,107.01955,2,0
0,0,15,15,15,19,34,61,52,113,0.000333,0.191628,14,8048.366215,447.131456,574.883301,139.313982,3,0
0,0,12,12,12,16,28,49,43,92,0.000333,0.147426,12,5307.319834,294.851102,442.276653,107.01955,2,0
0,0,15,15,15,19,34,61,52,113,0.000333,0.191628,14,8048.366215,447.131456,574.883301,139.313982,3,0
0,0,7,7,11,14,25,28,25,53,0.000333,0.082041,5,1230.62189,68.367883,246.124378,91.356717,2,0
0,0,16,16,16,19,35,74,52,126,0.000333,0.21543,16,10340.63456,574.479698,646.28966,144.710623,3,0
0,0,19,19,18,22,40,87,60,147,0.000333,0.260774,18,14081.82174,782.32343,782.32343,173.166146,4,0
0,0,16,16,15,19,34,73,52,125,0.000333,0.211978,14,8903.059972,494.614443,635.932855,139.313982,3,0
0,0,19,19,18,22,40,86,60,146,0.000333,0.259001,18,13986.02703,777.001502,777.001502,173.166146,4,0
0,0,18,18,17,19,36,63,59,122,0.000333,0.210244,24,15137.5404,840.974467,630.73085,150.197491,3,0
0,0,13,13,14,17,31,43,40,83,0.000333,0.137066,14,5756.776113,319.820895,411.198294,122.789837,2,0
0,0,17,17,17,20,37,61,55,116,0.000333,0.201432,16,9668.745447,537.152525,604.29659,155.92543,4,0
0,0,12,12,14,18,32,41,36,77,0.000333,0.128333,14,5390,299.444444,385,128.361619,3,0
0,0,17,17,17,20,37,60,55,115,0.000333,0.199696,16,9585.394193,532.5219,599.087137,155.92543,4,0
0,0,12,12,14,18,32,40,36,76,0.000333,0.126667,14,5320,295.555556,380,128.361619,3,0
0,0,20,20,13,22,35,71,77,148,0.000333,0.253045,18,13664.40996,759.133887,759.133887,146.213212,2,0
0,0,19,19,13,22,35,69,75,144,0.000333,0.246206,18,13295.10158,738.616754,738.616754,146.213212,2,0
0,0,20,20,14,23,37,71,83,154,0.000333,0.267419,21,16847.37218,935.965121,802.255818,157.344894,2,0
0,0,19,19,14,23,37,69,81,150,0.000333,0.260473,21,16409.7781,911.654339,781.418005,157.344894,2,0
0,0,13,13,9,17,26,50,63,113,0.000333,0.17705,12,6373.796258,354.099792,531.149688,98.016193,1,0
0,0,16,16,13,20,33,63,71,134,0.000333,0.225316,18,12167.07862,675.948812,675.948812,134.544278,2,0
0,0,10,10,13,17,30,45,35,80,0.000333,0.13085,12,4710.614972,261.700832,392.551248,117.592585,2,0
0,0,15,15,14,20,34,59,50,109,0.000333,0.184844,14,7763.468296,431.303794,554.53345,139.741531,2,0
0,0,14,14,14,20,34,57,48,105,0.000333,0.178061,14,7478.570377,415.476132,534.183598,139.741531,2,0
0,0,15,15,15,21,36,59,50,109,0.000333,0.187841,14,7889.305552,438.294753,563.521825,150.842025,2,0
0,0,14,14,15,21,36,57,48,105,0.000333,0.180947,14,7599.789752,422.210542,542.842125,150.842025,2,0
0,0,15,15,11,18,29,60,52,112,0.000333,0.181365,10,5440.938715,302.274373,544.093871,113.112398,1,0
0,0,18,18,15,21,36,73,60,133,0.000333,0.2292,14,9626.400353,534.80002,687.600025,150.842025,2,0
0,0,10,10,13,18,31,46,35,81,0.000333,0.133763,6,2407.739407,133.7633,401.289901,123.164366,2,0
0,0,16,16,14,21,35,68,54,122,0.000333,0.208591,14,8760.815393,486.711966,625.772528,145.541635,2,0
0,0,15,15,14,21,35,66,52,118,0.000333,0.201752,14,8473.575544,470.754197,605.255396,145.541635,2,0
0,0,16,16,15,22,37,68,54,122,0.000333,0.211851,14,8897.746348,494.319242,635.553311,156.710855,2,0
0,0,15,15,15,22,37,66,52,118,0.000333,0.204905,14,8606.01696,478.112053,614.715497,156.710855,2,0
0,0,16,16,11,19,30,69,56,125,0.000333,0.204454,10,6133.613245,340.756291,613.361324,118.764371,1,0
0,0,19,19,15,22,37,82,64,146,0.000333,0.253527,14,10648.12268,591.562371,760.580191,156.710855,2,0
0,0,10,10,13,18,31,45,35,80,0.000333,0.132112,6,2378.014229,132.111902,396.335705,123.164366,2,0
0,0,27,27,24,46,70,124,91,215,0.000333,0.439265,12,15813.55018,878.530566,1317.795849,364.12295,10,0
0,0,26,26,24,46,70,123,89,212,0.000333,0.433136,12,15592.896,866.272,1299.408,364.12295,10,0
0,0,26,26,22,46,68,117,85,202,0.000333,0.409889,11,13526.34243,751.463469,1229.667494,352.191346,10,0
0,0,25,25,22,46,68,116,83,199,0.000333,0.403802,11,13325.45616,740.30312,1211.405105,352.191346,10,0
0,0,26,26,22,46,68,117,85,202,0.000333,0.409889,11,13526.34243,751.463469,1229.667494,352.191346,10,0
0,0,25,25,22,46,68,116,83,199,0.000333,0.403802,11,13325.45616,740.30312,1211.405105,352.191346,10,0
0,0,8,8,12,16,28,30,27,57,0.000333,0.09134,6,1644.115383,91.339744,274.019231,107.01955,4,0
0,0,6,6,11,9,20,19,14,33,0.000333,0.047541,5,713.118136,39.617674,142.623627,66.583073,2,0
0,0,9,9,12,17,29,36,32,68,0.000333,0.110114,6,1982.056246,110.114236,330.342708,112.506418,3,0
0,0,6,6,9,12,21,15,17,32,0.000333,0.046851,4,562.21663,31.234257,140.554158,71.548875,1,0
0,0,9,9,13,19,32,37,32,69,0.000333,0.115,6,2070,115,345,128.816339,3,0
0,0,13,13,11,14,25,44,34,78,0.000333,0.12074,10,3622.207828,201.233768,362.220783,91.356717,3,0
0,0,16,16,15,17,32,57,42,99,0.000333,0.165,14,6930,385,495,128.090227,4,0
0,0,10,10,14,15,29,40,29,69,0.000333,0.111734,7,2346.404821,130.355823,335.200689,111.906328,2,0
0,0,13,13,11,14,25,44,34,78,0.000333,0.12074,10,3622.207828,201.233768,362.220783,91.356717,3,0
0,0,16,16,15,17,32,57,42,99,0.000333,0.165,14,6930,385,495,128.090227,4,0
0,0,10,10,14,15,29,40,29,69,0.000333,0.111734,7,2346.404821,130.355823,335.200689,111.906328,2,0
0,0,15,15,12,17,29,59,54,113,0.000333,0.182984,18,9881.133344,548.951852,548.951852,112.506418,1,0
0,0,18,18,16,19,35,71,63,134,0.000333,0.229108,24,16495.77418,916.431899,687.323924,144.710623,2,0
0,0,6,6,11,13,24,26,26,52,0.000333,0.079473,10,2384.1805,132.454472,238.41805,86.159464,1,0
0,0,9,9,15,17,32,39,34,73,0.000333,0.121667,14,5110,283.888889,365,128.090227,2,0
0,0,17,17,15,19,34,75,73,148,0.000333,0.250982,21,15811.83451,878.435251,752.944501,139.313982,1,0
0,0,20,20,19,21,40,88,81,169,0.000333,0.299802,27,24283.9579,1349.108772,899.405848,172.949289,2,0
0,0,7,7,12,15,27,38,29,67,0.000333,0.106192,6,1911.464776,106.192488,318.577463,101.622909,1,0
0,0,10,10,15,18,33,51,37,88,0.000333,0.147969,14,6214.693555,345.260753,443.906683,133.662009,2,0
0,0,13,13,12,15,27,52,39,91,0.000333,0.144232,12,5192.337152,288.463175,432.694763,101.622909,2,0
0,0,16,16,14,18,32,65,47,112,0.000333,0.186667,14,7840,435.555556,560,128.361619,3,0
0,0,10,10,14,15,29,43,31,74,0.000333,0.11983,14,5032.868311,279.603795,359.490594,111.906328,2,0
0,0,13,13,14,18,32,51,37,88,0.000333,0.146667,14,6160,342.222222,440,128.361619,3,0
0,0,11,11,14,16,30,45,33,78,0.000333,0.127579,14,5358.32453,297.684696,382.737466,117.302969,2,0
0,0,13,13,11,15,26,51,39,90,0.000333,0.141013,10,4230.395746,235.021986,423.039575,96.657107,2,0
0,0,16,16,14,18,32,64,47,111,0.000333,0.185,14,7770,431.666667,555,128.361619,3,0
0,0,10,10,14,15,29,43,31,74,0.000333,0.11983,14,5032.868311,279.603795,359.490594,111.906328,2,0
0,0,13,13,14,18,32,50,37,87,0.000333,0.145,14,6090,338.333333,435,128.361619,3,0
0,0,11,11,14,16,30,45,33,78,0.000333,0.127579,14,5358.32453,297.684696,382.737466,117.302969,2,0
0,0,16,16,11,21,32,60,68,128,0.000333,0.213333,15,9600,533.333333,640,130.292414,1,0
0,0,19,19,15,23,38,72,77,149,0.000333,0.260647,21,16420.76519,912.264733,781.9412,162.645284,2,0
0,0,18,18,11,22,33,66,80,146,0.000333,0.245494,15,11047.22312,613.734618,736.481541,136.161243,1,0
0,0,21,21,15,24,39,78,89,167,0.000333,0.294221,21,18535.90558,1029.772532,882.662171,168.642459,2,0
0,0,17,17,12,22,34,66,70,136,0.000333,0.230632,18,12454.10904,691.894946,691.894946,141.127046,1,0
0,0,19,19,16,24,40,74,75,149,0.000333,0.264322,24,19031.21487,1057.289715,792.967286,174.0391,2,0
0,0,16,16,12,21,33,74,64,138,0.000333,0.232042,18,12530.27499,696.126388,696.126388,135.258216,1,0
0,0,18,18,16,23,39,82,69,151,0.000333,0.266032,24,19154.29764,1064.127647,798.095735,168.041925,2,0
0,0,22,22,19,28,47,83,72,155,0.000333,0.286987,18,15497.3029,860.961272,860.961272,215.316561,6,0
0,0,11,11,13,15,28,32,48,80,0.000333,0.128196,18,6922.591088,384.588394,384.588394,106.709075,2,0
0,0,22,22,20,29,49,86,81,167,0.000333,0.312552,20,18753.13088,1041.840604,937.656544,227.320011,6,0
0,0,12,12,12,23,35,43,49,92,0.000333,0.157298,12,5662.728451,314.596025,471.894038,147.061475,3,0
0,0,13,13,12,23,35,44,51,95,0.000333,0.162427,12,5847.382639,324.854591,487.281887,147.061475,3,0
0,0,12,12,15,26,41,48,51,99,0.000333,0.176799,7,3712.783539,206.265752,530.397648,180.814792,4,0
0,0,13,13,15,26,41,49,53,102,0.000333,0.182157,14,7650.584263,425.032459,546.470304,180.814792,4,0
0,0,12,12,13,19,32,34,47,81,0.000333,0.135,12,4860,270,405,128.816339,2,0
0,0,14,14,17,25,42,52,58,110,0.000333,0.197718,16,9490.478664,527.248815,593.154917,185.583273,4,0
0,0,12,12,11,22,33,47,46,93,0.000333,0.156376,10,4691.286531,260.62703,469.128653,136.161243,3,0
0,0,13,13,11,22,33,48,48,96,0.000333,0.161421,10,4842.618355,269.034353,484.261835,136.161243,3,0
0,0,9,9,10,19,29,30,31,61,0.000333,0.098779,5,1481.684204,82.315789,296.336841,113.929904,2,0
0,0,7,7,8,15,23,17,21,38,0.000333,0.057298,4,687.581417,38.198968,171.895354,82.603359,1,0
0,0,12,12,14,25,39,52,48,100,0.000333,0.17618,7,3699.781553,205.54342,528.540222,169.399374,4,0
0,0,13,13,14,25,39,53,50,103,0.000333,0.181465,14,7621.55,423.419444,544.396429,169.399374,4,0
0,0,9,9,11,21,32,31,30,61,0.000333,0.101667,5,1525,84.722222,305,130.292414,2,0
0,0,12,12,12,19,31,40,42,82,0.000333,0.135415,12,4874.929169,270.829398,406.244097,123.730173,2,0
0,0,14,14,16,25,41,58,53,111,0.000333,0.198229,16,9515.01236,528.611798,594.688273,180.096405,4,0
0,0,13,13,12,20,32,41,44,85,0.000333,0.141667,12,5100,283.333333,425,129.458112,2,0
0,0,15,15,15,27,42,59,55,114,0.000333,0.204908,14,8606.138607,478.118811,614.724186,186.985321,4,0
0,0,5,5,9,14,23,19,18,37,0.000333,0.055791,4,669.487169,37.193732,167.371792,81.832294,2,0
0,0,6,6,9,15,24,20,20,40,0.000333,0.061133,4,733.594,40.755222,183.3985,87.132684,2,0
0,0,4,4,10,12,22,17,17,34,0.000333,0.05054,5,758.103375,42.116854,151.620675,76.238831,2,0
0,0,4,4,12,12,24,21,19,40,0.000333,0.061133,6,1100.391,61.132833,183.3985,86.0391,3,0
0,0,12,12,13,22,35,50,46,96,0.000333,0.164137,12,5908.934036,328.274113,492.41117,146.213212,3,0
0,0,13,13,13,22,35,51,48,99,0.000333,0.169266,12,6093.588224,338.532679,507.799019,146.213212,3,0
0,0,12,12,16,25,41,55,48,103,0.000333,0.183943,8,4414.622852,245.256825,551.827856,180.096405,4,0
0,0,13,13,16,25,41,56,50,106,0.000333,0.1893,16,9086.4082,504.800456,567.900512,180.096405,4,0
0,0,11,11,14,18,32,40,39,79,0.000333,0.131667,14,5530,307.222222,395,128.361619,2,0
0,0,13,13,18,24,42,58,50,108,0.000333,0.194123,18,10482.66507,582.370282,582.370282,185.09775,4,0
0,0,9,9,12,16,28,38,31,69,0.000333,0.110569,6,1990.244938,110.569163,331.70749,107.01955,2,0
0,0,12,12,15,19,34,51,39,90,0.000333,0.152624,14,6410.20318,356.122399,457.871656,139.313982,3,0
0,0,10,10,14,19,33,43,34,77,0.000333,0.129473,7,2718.92843,151.051579,388.418347,134.013592,2,0
0,0,22,22,19,43,62,101,74,175,0.000333,0.347328,9,9377.859189,520.992177,1041.984354,314.040007,9,0
0,0,21,21,19,43,62,100,72,172,0.000333,0.341374,9,9217.095888,512.060883,1024.121765,314.040007,9,0
0,0,13,13,11,15,26,44,34,78,0.000333,0.122211,10,3666.34298,203.685721,366.634298,96.657107,3,0
0,0,16,16,15,18,33,57,42,99,0.000333,0.166465,14,6991.530249,388.418347,499.395018,133.662009,4,0
0,0,13,13,11,15,26,44,34,78,0.000333,0.122211,10,3666.34298,203.685721,366.634298,96.657107,3,0
0,0,16,16,15,18,33,57,42,99,0.000333,0.166465,14,6991.530249,388.418347,499.395018,133.662009,4,0
0,0,4,4,7,9,16,10,10,20,0.000333,0.026667,3,240,13.333333,80,48.180809,2,0
0,0,4,4,8,8,16,11,9,20,0.000333,0.026667,4,320,17.777778,80,48,2,0
0,0,24,24,21,45,66,130,85,215,0.000333,0.433182,10,12995.44736,721.969298,1299.544736,339.372055,9,0
0,0,15,15,16,20,36,77,48,125,0.000333,0.215414,16,10339.85,574.436111,646.240625,150.438562,5,0
0,0,4,4,8,8,16,11,9,20,0.000333,0.026667,4,320,17.777778,80,48,2,0
0,0,24,24,21,44,65,130,85,215,0.000333,0.431603,10,12948.0908,719.338378,1294.80908,332.453657,9,0
0,0,15,15,16,20,36,77,48,125,0.000333,0.215414,16,10339.85,574.436111,646.240625,150.438562,5,0
0,0,4,4,8,8,16,11,9,20,0.000333,0.026667,4,320,17.777778,80,48,2,0
0,0,9,9,11,13,24,29,22,51,0.000333,0.077944,5,1169.165438,64.953635,233.833088,86.159464,3,0
0,0,6,6,10,11,21,19,17,36,0.000333,0.052708,5,790.617136,43.923174,158.123427,71.273029,1,0
0,0,4,4,8,8,16,11,9,20,0.000333,0.026667,4,320,17.777778,80,48,2,0
0,0,9,9,11,12,23,29,22,51,0.000333,0.076901,5,1153.508299,64.083794,230.70166,81.073298,3,0
0,0,6,6,10,11,21,19,17,36,0.000333,0.052708,5,790.617136,43.923174,158.123427,71.273029,1,0
0,0,18,18,18,19,37,80,57,137,0.000333,0.237898,27,19269.768,1070.542667,713.695111,155.769273,3,0
0,0,17,17,15,18,33,75,52,127,0.000333,0.213546,14,8968.932744,498.274041,640.638053,133.662009,3,0
0,0,17,17,15,18,33,74,52,126,0.000333,0.211865,14,8898.311227,494.350624,635.593659,133.662009,3,0
0,0,19,19,16,19,35,78,54,132,0.000333,0.225688,16,10833.04573,601.835874,677.065358,144.710623,3,0
0,0,10,10,14,14,28,42,31,73,0.000333,0.116979,14,4913.11673,272.950929,350.936909,106.605938,2,0
0,0,19,19,16,18,34,78,54,132,0.000333,0.223848,24,16117.08228,895.39346,671.545095,139.05865,3,0
0,0,10,10,14,14,28,42,31,73,0.000333,0.116979,14,4913.11673,272.950929,350.936909,106.605938,2,0
0,0,23,23,19,47,66,120,88,208,0.000333,0.419078,9,11315.10579,628.616988,1257.233977,341.776299,7,0
0,0,8,8,9,16,25,22,25,47,0.000333,0.072754,4,873.044964,48.502498,218.261241,92.529325,1,0
0,0,23,23,20,49,69,121,88,209,0.000333,0.425561,10,12766.81612,709.267562,1276.681611,361.559344,7,0
0,0,14,14,10,20,30,50,51,101,0.000333,0.165199,10,4955.959502,275.331083,495.59595,119.657843,1,0
0,0,28,28,21,52,73,145,111,256,0.000333,0.528198,20,31691.90174,1760.661208,1584.595087,388.661531,7,0
0,0,5,5,11,14,25,18,19,37,0.000333,0.057274,5,859.113395,47.728522,171.822679,91.356717,2,0
0,0,5,5,13,14,27,22,21,43,0.000333,0.068153,6,1226.760976,68.153388,204.460163,101.408685,3,0
0,0,10,10,13,12,25,31,28,59,0.000333,0.091329,12,3287.850182,182.658343,273.987515,91.125266,2,0
0,0,10,10,15,12,27,37,30,67,0.000333,0.106192,14,4460.084477,247.782471,318.577463,101.622909,3,0
0,0,14,14,11,18,29,66,52,118,0.000333,0.191081,10,5732.417574,318.467643,573.241757,113.112398,1,0
0,0,17,17,15,20,35,79,60,139,0.000333,0.237657,21,14972.37713,831.798729,712.970339,145.041921,2,0
0,0,10,10,14,17,31,49,36,85,0.000333,0.140369,14,5895.493609,327.527423,421.106686,122.789837,2,0
0,0,10,10,13,18,31,29,30,59,0.000333,0.097433,6,1753.785494,97.432527,292.297582,123.164366,2,0
0,0,10,10,15,18,33,35,32,67,0.000333,0.112658,7,2365.820842,131.434491,337.974406,133.662009,3,0
0,0,12,12,13,17,30,50,44,94,0.000333,0.153749,12,5534.972592,307.498477,461.247716,117.592585,2,0
0,0,15,15,15,20,35,62,53,115,0.000333,0.196623,14,8258.145657,458.78587,589.867547,145.041921,3,0
0,0,12,12,12,17,29,49,44,93,0.000333,0.150597,12,5421.506791,301.194822,451.792233,112.506418,2,0
0,0,15,15,15,20,35,61,53,114,0.000333,0.194913,14,8186.335695,454.796428,584.738264,145.041921,3,0
0,0,12,12,13,16,29,50,44,94,0.000333,0.152217,12,5479.802563,304.433476,456.650214,112.105716,2,0
0,0,15,15,15,19,34,62,53,115,0.000333,0.195019,14,8190.815174,455.045287,585.058227,139.313982,3,0
0,0,12,12,12,16,28,49,44,93,0.000333,0.149028,12,5365.008093,298.056005,447.084008,107.01955,2,0
0,0,15,15,15,19,34,61,53,114,0.000333,0.193324,14,8119.590695,451.088372,579.970764,139.313982,3,0
0,0,13,13,13,17,30,45,40,85,0.000333,0.139029,12,5005.028408,278.057134,417.085701,117.592585,3,0
0,0,16,16,15,20,35,58,48,106,0.000333,0.181235,14,7611.855997,422.880889,543.704,145.041921,4,0
0,0,13,13,12,17,29,44,40,84,0.000333,0.136023,12,4896.844843,272.046936,408.070404,112.506418,3,0
0,0,16,16,15,20,35,57,48,105,0.000333,0.179525,14,7540.046035,418.891446,538.574717,145.041921,4,0
0,0,5,5,12,13,25,22,18,40,0.000333,0.061918,6,1114.525486,61.918083,185.754248,91.125266,1,0
0,0,8,8,15,16,31,35,26,61,0.000333,0.100735,7,2115.441825,117.524546,302.205975,122.603359,2,0
0,0,17,17,16,21,37,83,57,140,0.000333,0.243108,16,11669.17554,648.28753,729.323471,156.238666,5,0
0,0,5,5,12,13,25,22,18,40,0.000333,0.061918,6,1114.525486,61.918083,185.754248,91.125266,1,0
0,0,8,8,15,16,31,35,26,61,0.000333,0.100735,7,2115.441825,117.524546,302.205975,122.603359,2,0
0,0,17,17,16,21,37,83,57,140,0.000333,0.243108,16,11669.17554,648.28753,729.323471,156.238666,5,0
0,0,13,13,13,17,30,45,40,85,0.000333,0.139029,12,5005.028408,278.057134,417.085701,117.592585,3,0
0,0,16,16,15,20,35,58,48,106,0.000333,0.181235,14,7611.855997,422.880889,543.704,145.041921,4,0
0,0,13,13,15,18,33,50,42,92,0.000333,0.154695,14,6497.179626,360.954424,464.084259,133.662009,2,0
0,0,13,13,12,17,29,44,40,84,0.000333,0.136023,12,4896.844843,272.046936,408.070404,112.506418,3,0
0,0,16,16,15,20,35,57,48,105,0.000333,0.179525,14,7540.046035,418.891446,538.574717,145.041921,4,0
0,0,13,13,15,18,33,50,42,92,0.000333,0.154695,14,6497.179626,360.954424,464.084259,133.662009,2,0
0,0,17,17,16,21,37,83,55,138,0.000333,0.239635,16,11502.47303,639.02628,718.904564,156.238666,5,0
0,0,9,9,10,13,23,32,28,60,0.000333,0.090471,10,2714.137174,150.785399,271.413717,81.324997,2,0
0,0,17,17,18,20,38,69,57,126,0.000333,0.220413,18,11902.2996,661.238867,661.238867,161.497212,4,0
0,0,17,17,18,20,38,69,57,126,0.000333,0.220413,18,11902.2996,661.238867,661.238867,161.497212,4,0
0,0,9,9,12,12,24,28,26,54,0.000333,0.082529,12,2971.0557,165.05865,247.587975,86.0391,2,0
0,0,9,9,14,12,26,34,28,62,0.000333,0.097142,14,4079.981675,226.665649,291.427263,96.322519,3,0
0,0,16,16,15,17,32,63,54,117,0.000333,0.195,21,12285,682.5,585,128.090227,3,0
0,0,18,18,18,19,37,71,59,130,0.000333,0.225743,27,18285.18131,1015.843406,677.228938,155.769273,4,0
0,0,16,16,15,17,32,63,54,117,0.000333,0.195,21,12285,682.5,585,128.090227,3,0
0,0,18,18,18,19,37,71,59,130,0.000333,0.225743,27,18285.18131,1015.843406,677.228938,155.769273,4,0
0,0,16,16,11,23,34,52,75,127,0.000333,0.215369,15,9691.616713,538.423151,646.107781,142.095673,3,0
0,0,17,17,11,23,34,53,77,130,0.000333,0.220457,15,9920.55254,551.141808,661.370169,142.095673,3,0
0,0,16,16,14,26,40,57,83,140,0.000333,0.248357,21,15646.4686,869.248255,745.069933,175.514402,4,0
0,0,17,17,14,26,40,58,85,143,0.000333,0.253679,21,15981.75007,887.875004,761.035718,175.514402,4,0
0,0,10,10,10,15,25,32,59,91,0.000333,0.140864,15,6338.863699,352.159094,422.590913,91.82264,2,0
0,0,10,10,12,15,27,36,61,97,0.000333,0.153741,24,11069.37811,614.96545,461.224088,101.622909,3,0
0,0,10,10,13,16,29,30,34,64,0.000333,0.103637,12,3730.929404,207.273856,310.910784,112.105716,2,0
0,0,12,12,17,22,39,48,45,93,0.000333,0.163847,16,7864.678502,436.926583,491.542406,167.594364,4,0
0,0,5,5,10,13,23,20,19,39,0.000333,0.058806,5,882.094581,49.005255,176.418916,81.324997,2,0
0,0,9,9,11,16,27,28,34,62,0.000333,0.098268,10,2948.030251,163.779458,294.803025,102.053748,2,0
0,0,5,5,10,14,24,20,20,40,0.000333,0.061133,5,916.9925,50.944028,183.3985,86.52225,2,0
0,0,9,9,12,18,30,29,34,63,0.000333,0.103045,6,1854.804645,103.044703,309.134108,118.0782,2,0
0,0,9,9,15,18,33,40,36,76,0.000333,0.127791,14,5367.235343,298.179741,383.373953,133.662009,2,0
0,0,18,18,18,23,41,73,71,144,0.000333,0.257162,27,20830.16219,1157.231233,771.487489,179.100575,2,0
0,0,10,10,10,18,28,38,36,74,0.000333,0.118581,10,3557.442642,197.635702,355.744264,108.277931,1,0
0,0,10,10,11,19,30,38,35,73,0.000333,0.119401,5,1791.015067,99.500837,358.203013,118.764371,1,0
0,0,20,20,15,24,39,83,74,157,0.000333,0.276603,21,17425.97112,968.109506,829.808148,168.642459,2,0
0,0,17,17,15,24,39,72,62,134,0.000333,0.236081,14,9915.414563,550.856365,708.243897,168.642459,2,0
0,0,20,20,16,24,40,75,77,152,0.000333,0.269644,24,19414.39369,1078.577427,808.93307,174.0391,2,0
0,0,17,17,15,19,34,62,76,138,0.000333,0.234023,28,19657.95642,1092.10869,702.069872,139.313982,1,0
0,0,19,19,19,21,40,70,81,151,0.000333,0.26787,27,21697.50084,1205.416713,803.611142,172.949289,2,0
0,0,7,7,12,16,28,34,32,66,0.000333,0.105762,12,3807.425098,211.523617,317.285425,107.01955,1,0
0,0,9,9,15,19,34,42,37,79,0.000333,0.13397,7,2813.366951,156.298164,401.909564,139.313982,2,0
0,0,19,19,14,21,35,79,72,151,0.000333,0.258174,21,16264.95645,903.608691,774.521736,145.541635,2,0
0,0,22,22,18,23,41,92,80,172,0.000333,0.307166,27,24880.47151,1382.248417,921.498945,179.100575,3,0
0,0,10,10,13,16,29,44,34,78,0.000333,0.126308,12,4547.070211,252.615012,378.922518,112.105716,2,0
0,0,10,10,15,14,29,48,33,81,0.000333,0.131165,14,5508.950448,306.052803,393.496461,111.906328,2,0
0,0,20,20,16,21,37,87,71,158,0.000333,0.274365,24,19754.24716,1097.458176,823.093632,156.238666,3,0
0,0,10,10,15,14,29,45,31,76,0.000333,0.123069,14,5168.891779,287.160654,369.206556,111.906328,2,0
0,0,20,20,16,21,37,87,71,158,0.000333,0.274365,24,19754.24716,1097.458176,823.093632,156.238666,3,0
0,0,10,10,15,14,29,45,31,76,0.000333,0.123069,14,5168.891779,287.160654,369.206556,111.906328,2,0
0,0,18,18,15,20,35,80,62,142,0.000333,0.242786,21,15295.52196,849.75122,728.358188,145.041921,2,0
0,0,10,10,14,16,30,47,35,82,0.000333,0.134122,14,5633.110404,312.950578,402.365029,117.302969,2,0
0,0,9,9,13,13,26,41,31,72,0.000333,0.112811,12,4061.179916,225.621106,338.43166,96.211433,2,0
0,0,12,12,17,16,33,54,39,93,0.000333,0.156376,16,7506.05845,417.003247,469.128653,133.486868,3,0
0,0,10,10,14,14,28,45,32,77,0.000333,0.123389,14,5182.328606,287.907145,370.166329,106.605938,2,0
0,0,18,18,15,20,35,77,62,139,0.000333,0.237657,21,14972.37713,831.798729,712.970339,145.041921,2,0
0,0,21,21,19,22,41,90,70,160,0.000333,0.285736,27,23144.62466,1285.812481,857.208321,178.818118,3,0
0,0,10,10,14,14,28,42,30,72,0.000333,0.115377,14,4845.813761,269.211876,346.129554,106.605938,2,0
0,0,20,20,19,21,40,76,62,138,0.000333,0.244809,18,13219.66939,734.426077,734.426077,172.949289,4,0
0,0,20,20,19,21,40,76,62,138,0.000333,0.244809,18,13219.66939,734.426077,734.426077,172.949289,4,0
0,0,14,14,13,24,37,54,47,101,0.000333,0.175385,6,3156.92874,175.38493,526.15479,158.144816,4,0
0,0,8,8,9,16,25,22,25,47,0.000333,0.072754,4,873.044964,48.502498,218.261241,92.529325,1,0
0,0,14,14,14,26,40,55,47,102,0.000333,0.180946,7,3799.85666,211.103148,542.836666,175.514402,4,0
0,0,14,14,10,21,31,51,52,103,0.000333,0.170094,10,5102.8222,283.490122,510.28222,125.457947,2,0
0,0,19,19,15,29,44,79,70,149,0.000333,0.271152,14,11388.37436,632.687464,813.455311,199.484808,4,0
0,0,20,20,14,24,38,76,81,157,0.000333,0.274642,21,17302.41701,961.24539,823.92462,163.342069,3,0
0,0,17,17,10,19,29,55,75,130,0.000333,0.210513,15,9473.06294,526.281274,631.537529,113.929904,1,0
0,0,19,19,14,25,39,73,87,160,0.000333,0.281888,21,17758.95146,986.608414,845.664355,169.399374,3,0
0,0,9,9,12,17,29,38,31,69,0.000333,0.111734,6,2011.204132,111.733563,335.200689,112.506418,3,0
0,0,6,6,9,9,18,16,14,30,0.000333,0.041699,4,500.391,27.7995,125.09775,57.05865,1,0
0,0,9,9,13,16,29,38,29,67,0.000333,0.108495,6,1952.90836,108.494909,325.484727,112.105716,3,0
0,0,9,9,12,17,29,36,32,68,0.000333,0.110114,6,1982.056246,110.114236,330.342708,112.506418,3,0
0,0,6,6,9,12,21,15,17,32,0.000333,0.046851,4,562.21663,31.234257,140.554158,71.548875,1,0
0,0,9,9,13,19,32,37,32,69,0.000333,0.115,6,2070,115,345,128.816339,3,0
0,0,9,9,15,12,27,33,24,57,0.000333,0.090343,14,3794.400227,210.800013,271.028588,101.622909,5,0
0,0,9,9,14,12,26,32,24,56,0.000333,0.087742,14,3685.144739,204.730263,263.224624,96.322519,5,0
0,0,9,9,13,13,26,29,22,51,0.000333,0.079907,6,1438.334554,79.907475,239.722426,96.211433,4,0
0,0,9,9,12,13,25,28,22,50,0.000333,0.077398,6,1393.156857,77.397603,232.192809,91.125266,4,0
0,0,9,9,15,10,25,32,22,54,0.000333,0.083589,14,3510.755279,195.04196,250.768234,91.82264,5,0
0,0,9,9,13,11,24,28,20,48,0.000333,0.073359,6,1320.4692,73.3594,220.0782,86.159464,4,0
0,0,9,9,15,12,27,32,22,54,0.000333,0.085588,7,1797.347476,99.852638,256.763925,101.622909,5,0
0,0,9,9,15,12,27,32,22,54,0.000333,0.085588,7,1797.347476,99.852638,256.763925,101.622909,5,0
0,0,9,9,13,12,25,28,20,48,0.000333,0.074302,6,1337.430583,74.301699,222.905097,91.125266,4,0
0,0,9,9,13,12,25,28,20,48,0.000333,0.074302,6,1337.430583,74.301699,222.905097,91.125266,4,0
0,0,9,9,14,12,26,32,22,54,0.000333,0.084608,7,1776.766213,98.709234,253.823745,96.322519,5,0
0,0,9,9,14,11,25,32,22,54,0.000333,0.083589,14,3510.755279,195.04196,250.768234,91.356717,5,0
0,0,9,9,12,13,25,28,20,48,0.000333,0.074302,6,1337.430583,74.301699,222.905097,91.125266,4,0
0,0,9,9,12,12,24,28,20,48,0.000333,0.073359,6,1320.4692,73.3594,220.0782,86.0391,4,0
0,0,14,14,15,16,31,51,34,85,0.000333,0.140369,14,5895.493609,327.527423,421.106686,122.603359,5,0
0,0,8,8,12,16,28,30,23,53,0.000333,0.08493,6,1528.738865,84.929937,254.789811,107.01955,2,0
0,0,8,8,13,14,27,31,21,52,0.000333,0.082418,6,1483.524901,82.41805,247.25415,101.408685,2,0
0,0,14,14,16,13,29,52,32,84,0.000333,0.136023,16,6529.126457,362.729248,408.070404,112.105716,5,0
0,0,14,14,16,13,29,52,32,84,0.000333,0.136023,16,6529.126457,362.729248,408.070404,112.105716,5,0
0,0,8,8,13,14,27,31,21,52,0.000333,0.082418,6,1483.524901,82.41805,247.25415,101.408685,2,0
0,0,8,8,13,14,27,31,21,52,0.000333,0.082418,6,1483.524901,82.41805,247.25415,101.408685,2,0
0,0,14,14,14,14,28,48,30,78,0.000333,0.124991,14,5249.631575,291.646199,374.973684,106.605938,4,0
0,0,14,14,14,14,28,48,30,78,0.000333,0.124991,14,5249.631575,291.646199,374.973684,106.605938,4,0
0,0,8,8,13,14,27,31,21,52,0.000333,0.082418,6,1483.524901,82.41805,247.25415,101.408685,2,0
0,0,7,7,14,10,24,26,20,46,0.000333,0.070303,14,2952.71585,164.039769,210.908275,86.52225,3,0
0,0,7,7,12,11,23,22,18,40,0.000333,0.060314,6,1085.654869,60.314159,180.942478,81.073298,2,0
0,0,18,18,16,21,37,69,55,124,0.000333,0.215324,16,10335.55548,574.197527,645.972217,156.238666,3,0
0,0,18,18,16,27,43,74,68,142,0.000333,0.256843,16,12328.47352,684.915196,770.529595,192.381963,2,0
0,0,11,11,12,22,34,40,40,80,0.000333,0.135666,6,2441.982164,135.665676,406.997027,141.127046,2,0
0,0,17,17,15,25,40,67,61,128,0.000333,0.227069,14,9536.895146,529.827508,681.206796,174.699764,2,0
0,0,8,8,9,16,25,24,24,48,0.000333,0.074302,4,891.620388,49.534466,222.905097,92.529325,1,0
0,0,13,13,12,23,35,52,54,106,0.000333,0.181235,12,6524.447998,362.469333,543.704,147.061475,1,0
0,0,11,11,13,24,37,41,39,80,0.000333,0.138919,6,2500.537616,138.918756,416.756269,158.144816,2,0
0,0,16,16,11,23,34,59,58,117,0.000333,0.198411,10,5952.331524,330.685085,595.233152,142.095673,1,0
0,0,19,19,15,26,41,72,66,138,0.000333,0.246447,14,10350.79047,575.043915,739.342177,180.814792,2,0
0,0,5,5,12,12,24,22,17,39,0.000333,0.059605,6,1072.881225,59.604513,178.813538,86.0391,1,0
0,0,8,8,15,15,30,35,25,60,0.000333,0.098138,7,2060.89405,114.494114,294.413436,117.206718,2,0
0,0,18,18,15,26,41,71,64,135,0.000333,0.24109,14,10125.77329,562.54296,723.269521,180.814792,2,0
0,0,16,16,14,27,41,65,63,128,0.000333,0.228589,14,9600.733192,533.374066,685.766657,181.684931,2,0
0,0,18,18,17,27,44,78,68,146,0.000333,0.265692,16,12753.23226,708.512903,797.077016,197.868831,2,0
0,0,17,17,16,25,41,71,61,132,0.000333,0.235732,16,11315.14983,628.619435,707.196865,180.096405,2,0
0,0,13,13,13,23,36,56,54,110,0.000333,0.189564,12,6824.301002,379.127833,568.69175,152.147641,1,0
0,0,15,15,12,22,34,59,55,114,0.000333,0.193324,12,6959.649167,386.647176,579.970764,141.127046,1,0
0,0,18,18,16,25,41,72,63,135,0.000333,0.24109,16,11572.31233,642.906241,723.269521,180.096405,2,0
0,0,5,5,12,12,24,22,17,39,0.000333,0.059605,6,1072.881225,59.604513,178.813538,86.0391,1,0
0,0,8,8,15,15,30,35,25,60,0.000333,0.098138,7,2060.89405,114.494114,294.413436,117.206718,2,0
0,0,23,23,16,25,41,94,92,186,0.000333,0.332168,24,23916.11215,1328.672897,996.504673,180.096405,5,0
0,0,17,17,10,19,29,55,75,130,0.000333,0.210513,15,9473.06294,526.281274,631.537529,113.929904,1,0
0,0,22,22,16,26,42,91,98,189,0.000333,0.339716,24,24459.55183,1358.863991,1019.147993,186.211433,5,0
0,0,7,7,12,14,26,31,32,63,0.000333,0.098709,12,3553.532427,197.418468,296.127702,96.322519,1,0
0,0,9,9,16,18,34,39,37,76,0.000333,0.128882,16,6186.354815,343.686379,386.647176,139.05865,2,0
0,0,7,7,14,11,25,27,19,46,0.000333,0.071206,7,1495.321693,83.073427,213.617385,91.356717,4,0
0,0,7,7,14,11,25,27,19,46,0.000333,0.071206,7,1495.321693,83.073427,213.617385,91.356717,4,0
0,0,11,11,18,19,37,43,42,85,0.000333,0.147601,18,7970.463649,442.803536,442.803536,155.769273,3,0
0,0,11,11,17,20,37,46,42,88,0.000333,0.152811,16,7334.910339,407.495019,458.431896,155.92543,3,0
0,0,5,5,10,13,23,17,17,34,0.000333,0.051267,5,769.005533,42.72253,153.801107,81.324997,2,0
0,0,5,5,11,12,23,18,16,34,0.000333,0.051267,5,769.005533,42.72253,153.801107,81.073298,2,0
0,0,13,13,17,22,39,60,48,108,0.000333,0.190274,16,9133.175034,507.398613,570.82344,167.594364,4,0
0,0,7,7,12,15,27,29,26,55,0.000333,0.087173,6,1569.112876,87.172938,261.518813,101.622909,1,0
0,0,5,5,11,12,23,18,16,34,0.000333,0.051267,5,769.005533,42.72253,153.801107,81.073298,2,0
0,0,10,10,13,15,28,41,33,74,0.000333,0.118581,12,4268.931171,237.162843,355.744264,106.709075,3,0
0,0,6,6,10,11,21,19,17,36,0.000333,0.052708,5,790.617136,43.923174,158.123427,71.273029,1,0
0,0,13,13,13,17,30,57,47,104,0.000333,0.170106,12,6123.799463,340.211081,510.316622,117.592585,2,0
0,0,15,15,15,19,34,65,52,117,0.000333,0.198411,14,8333.264134,462.959119,595.233152,139.313982,3,0
0,0,13,13,12,17,29,56,47,103,0.000333,0.166791,12,6004.46451,333.581362,500.372042,112.506418,2,0
0,0,15,15,15,19,34,64,52,116,0.000333,0.196715,14,8262.039654,459.002203,590.14569,139.313982,3,0
0,0,9,9,10,17,27,32,37,69,0.000333,0.109362,10,3280.872376,182.270688,328.087238,102.706149,1,0
0,0,9,9,12,19,31,35,40,75,0.000333,0.123855,12,4458.776679,247.709816,371.564723,123.730173,1,0
0,0,9,9,12,19,31,35,40,75,0.000333,0.123855,12,4458.776679,247.709816,371.564723,123.730173,1,0
0,0,8,8,10,15,25,25,29,54,0.000333,0.083589,5,1253.841171,69.657843,250.768234,91.82264,1,0
0,0,4,4,8,10,18,13,14,27,0.000333,0.037529,4,450.3519,25.01955,112.587975,57.219281,2,0
0,0,4,4,8,12,20,13,18,31,0.000333,0.04466,4,535.919084,29.773282,133.979771,67.01955,2,0
0,0,13,13,14,23,37,51,54,105,0.000333,0.182331,14,7657.896447,425.438692,546.992603,157.344894,3,0
0,0,4,4,8,12,20,13,18,31,0.000333,0.04466,4,535.919084,29.773282,133.979771,67.01955,2,0
0,0,13,13,14,23,37,51,54,105,0.000333,0.182331,14,7657.896447,425.438692,546.992603,157.344894,3,0
0,0,4,4,8,11,19,13,16,29,0.000333,0.041063,4,492.759592,27.375533,123.189898,62.053748,2,0
0,0,10,10,11,16,27,32,36,68,0.000333,0.107777,10,3233.323501,179.629083,323.33235,102.053748,2,0
0,0,13,13,13,16,29,56,47,103,0.000333,0.166791,12,6004.46451,333.581362,500.372042,112.105716,2,0
0,0,15,15,15,19,34,64,52,116,0.000333,0.196715,14,8262.039654,459.002203,590.14569,139.313982,3,0
0,0,13,13,12,16,28,55,47,102,0.000333,0.16345,12,5884.202425,326.900135,490.350202,107.01955,2,0
0,0,15,15,15,19,34,63,52,115,0.000333,0.195019,14,8190.815174,455.045287,585.058227,139.313982,3,0
0,0,6,6,9,9,18,16,14,30,0.000333,0.041699,4,500.391,27.7995,125.09775,57.05865,1,0
0,0,12,12,16,17,33,58,40,98,0.000333,0.164784,16,7909.609979,439.422777,494.350624,133.486868,5,0
0,0,8,8,10,14,24,32,22,54,0.000333,0.082529,5,1237.939875,68.774438,247.587975,86.52225,2,0
0,0,11,11,13,17,30,45,30,75,0.000333,0.122672,6,2208.100768,122.672265,368.016795,117.592585,3,0
0,0,8,8,9,14,23,31,22,53,0.000333,0.079916,4,958.995135,53.277507,239.748784,81.832294,2,0
0,0,11,11,13,17,30,44,30,74,0.000333,0.121037,6,2178.659424,121.036635,363.109904,117.592585,3,0
0,0,10,10,10,15,25,36,24,60,0.000333,0.092877,5,1393.156857,77.397603,278.631371,91.82264,2,0
0,0,13,13,14,18,32,49,32,81,0.000333,0.135,7,2835,157.5,405,128.361619,3,0
0,0,10,10,10,15,25,36,24,60,0.000333,0.092877,5,1393.156857,77.397603,278.631371,91.82264,2,0
0,0,13,13,14,18,32,49,32,81,0.000333,0.135,7,2835,157.5,405,128.361619,3,0
0,0,8,8,10,14,24,32,22,54,0.000333,0.082529,5,1237.939875,68.774438,247.587975,86.52225,2,0
0,0,11,11,13,17,30,45,30,75,0.000333,0.122672,6,2208.100768,122.672265,368.016795,117.592585,3,0
0,0,8,8,9,14,23,31,22,53,0.000333,0.079916,4,958.995135,53.277507,239.748784,81.832294,2,0
0,0,11,11,13,17,30,44,30,74,0.000333,0.121037,6,2178.659424,121.036635,363.109904,117.592585,3,0
0,0,8,8,10,13,23,32,22,54,0.000333,0.081424,5,1221.361728,67.853429,244.272346,81.324997,2,0
0,0,11,11,13,16,29,45,30,75,0.000333,0.12145,6,2186.091448,121.449525,364.348575,112.105716,3,0
0,0,8,8,9,13,22,31,22,53,0.000333,0.078783,4,945.399503,52.522195,236.349876,76.635041,2,0
0,0,11,11,13,16,29,44,30,74,0.000333,0.11983,6,2156.943562,119.830198,359.490594,112.105716,3,0
0,0,7,7,10,12,22,32,21,53,0.000333,0.078783,5,1181.749379,65.652743,236.349876,76.238831,1,0
0,0,10,10,14,15,29,45,29,74,0.000333,0.11983,7,2516.434155,139.801898,359.490594,111.906328,2,0
0,0,9,9,15,13,28,35,24,59,0.000333,0.094545,7,1985.437583,110.302088,283.63394,106.709075,5,0
0,0,9,9,14,13,27,34,24,58,0.000333,0.091928,7,1930.484326,107.249129,275.783475,101.408685,5,0
0,0,9,9,13,13,26,29,22,51,0.000333,0.079907,6,1438.334554,79.907475,239.722426,96.211433,4,0
0,0,9,9,12,13,25,28,22,50,0.000333,0.077398,6,1393.156857,77.397603,232.192809,91.125266,4,0
0,0,18,18,12,22,34,62,75,137,0.000333,0.232327,18,12545.68337,696.982409,696.982409,141.127046,1,0
0,0,17,17,10,19,29,55,75,130,0.000333,0.210513,15,9473.06294,526.281274,631.537529,113.929904,1,0
0,0,17,17,12,23,35,59,81,140,0.000333,0.239367,18,12925.7932,718.099622,718.099622,147.061475,1,0
0,0,18,18,16,23,39,65,61,126,0.000333,0.221987,16,10655.37087,591.965049,665.96068,168.041925,2,0
0,0,17,17,16,16,32,77,51,128,0.000333,0.213333,24,15360,853.333333,640,128,3,0
0,0,10,10,15,14,29,45,31,76,0.000333,0.123069,14,5168.891779,287.160654,369.206556,111.906328,2,0
0,0,4,4,7,9,16,10,10,20,0.000333,0.026667,3,240,13.333333,80,48.180809,2,0
0,0,4,4,8,8,16,11,9,20,0.000333,0.026667,4,320,17.777778,80,48,2,0
0,0,15,15,15,22,37,64,44,108,0.000333,0.18754,14,7876.693489,437.594083,562.620963,156.710855,6,0
0,0,4,4,8,8,16,11,9,20,0.000333,0.026667,4,320,17.777778,80,48,2,0
0,0,15,15,15,21,36,64,44,108,0.000333,0.186117,14,7816.926602,434.2737,558.3519,150.842025,6,0
0,0,4,4,8,8,16,11,9,20,0.000333,0.026667,4,320,17.777778,80,48,2,0
0,0,9,9,11,13,24,29,22,51,0.000333,0.077944,5,1169.165438,64.953635,233.833088,86.159464,3,0
0,0,4,4,8,8,16,11,9,20,0.000333,0.026667,4,320,17.777778,80,48,2,0
0,0,9,9,11,12,23,29,22,51,0.000333,0.076901,5,1153.508299,64.083794,230.70166,81.073298,3,0
0,0,25,25,20,31,51,117,86,203,0.000333,0.383834,20,23030.04689,1279.447049,1151.502344,240.018648,6,0
0,0,16,16,16,24,40,62,57,119,0.000333,0.211103,16,10132.95109,562.941727,633.309443,174.0391,2,0
0,0,20,20,17,27,44,95,72,167,0.000333,0.303908,16,14587.60129,810.422294,911.72508,197.868831,5,0
0,0,14,14,12,21,33,50,51,101,0.000333,0.169828,12,6113.805673,339.655871,509.483806,135.258216,1,0
0,0,17,17,16,24,40,63,59,122,0.000333,0.216425,16,10388.40364,577.133536,649.275228,174.0391,2,0
0,0,5,5,12,12,24,22,17,39,0.000333,0.059605,6,1072.881225,59.604513,178.813538,86.0391,1,0
0,0,8,8,15,15,30,35,25,60,0.000333,0.098138,7,2060.89405,114.494114,294.413436,117.206718,2,0
0,0,26,26,19,32,51,122,90,212,0.000333,0.400851,18,21645.97511,1202.554172,1202.554172,240.710623,6,0
0,0,23,23,19,46,65,122,88,210,0.000333,0.421566,9,11382.27517,632.34862,1264.697241,334.794473,7,0
0,0,17,17,15,25,40,67,61,128,0.000333,0.227069,14,9536.895146,529.827508,681.206796,174.699764,2,0
0,0,8,8,9,16,25,24,24,48,0.000333,0.074302,4,891.620388,49.534466,222.905097,92.529325,1,0
0,0,21,21,16,28,44,100,76,176,0.000333,0.320287,16,15373.75944,854.097747,960.859965,198.605938,5,0
0,0,23,23,20,48,68,123,87,210,0.000333,0.426122,10,12783.67197,710.203998,1278.367197,354.516762,7,0
0,0,16,16,11,23,34,59,58,117,0.000333,0.198411,10,5952.331524,330.685085,595.233152,142.095673,1,0
0,0,19,19,15,26,41,72,66,138,0.000333,0.246447,14,10350.79047,575.043915,739.342177,180.814792,2,0
0,0,5,5,12,12,24,22,17,39,0.000333,0.059605,6,1072.881225,59.604513,178.813538,86.0391,1,0
0,0,8,8,15,15,30,35,25,60,0.000333,0.098138,7,2060.89405,114.494114,294.413436,117.206718,2,0
0,0,18,18,15,26,41,71,64,135,0.000333,0.24109,14,10125.77329,562.54296,723.269521,180.814792,2,0
0,0,28,28,21,51,72,147,111,258,0.000333,0.530614,20,31836.81301,1768.711834,1591.84065,381.532358,7,0
0,0,15,15,14,21,35,72,48,120,0.000333,0.205171,14,8617.195468,478.733082,615.513962,145.541635,5,0
0,0,6,6,9,9,18,16,14,30,0.000333,0.041699,4,500.391,27.7995,125.09775,57.05865,1,0
0,0,15,15,15,19,34,72,45,117,0.000333,0.198411,14,8333.264134,462.959119,595.233152,139.313982,5,0
0,0,5,5,10,15,25,20,21,41,0.000333,0.063466,5,951.990519,52.888362,190.398104,91.82264,1,0
0,0,8,8,14,18,32,33,29,62,0.000333,0.103333,7,2170,120.555556,310,128.361619,2,0
0,0,5,5,11,15,26,21,20,41,0.000333,0.064239,5,963.590142,53.532786,192.718028,96.657107,1,0
0,0,8,8,14,18,32,34,28,62,0.000333,0.103333,7,2170,120.555556,310,128.361619,2,0
0,0,26,26,20,32,52,126,90,216,0.000333,0.410432,20,24625.89958,1368.105532,1231.294979,246.438562,6,0
0,0,17,17,16,25,41,71,61,132,0.000333,0.235732,16,11315.14983,628.619435,707.196865,180.096405,2,0
0,0,21,21,17,28,45,104,76,180,0.000333,0.329511,16,15816.53692,878.696495,988.533557,204.092806,5,0
0,0,15,15,12,22,34,59,55,114,0.000333,0.193324,12,6959.649167,386.647176,579.970764,141.127046,1,0
0,0,18,18,16,25,41,72,63,135,0.000333,0.24109,16,11572.31233,642.906241,723.269521,180.096405,2,0
0,0,5,5,12,12,24,22,17,39,0.000333,0.059605,6,1072.881225,59.604513,178.813538,86.0391,1,0
0,0,8,8,15,15,30,35,25,60,0.000333,0.098138,7,2060.89405,114.494114,294.413436,117.206718,2,0
0,0,4,4,14,13,27,23,20,43,0.000333,0.068153,7,1431.221138,79.512285,204.460163,101.408685,3,0
0,0,4,4,12,13,25,19,18,37,0.000333,0.057274,6,1030.936074,57.274226,171.822679,91.125266,2,0
0,0,26,26,23,46,69,117,88,205,0.000333,0.417416,11,13774.72265,765.262369,1252.247514,358.125775,9,0
0,0,25,25,23,46,69,116,86,202,0.000333,0.411307,11,13573.14134,754.063408,1233.92194,358.125775,9,0
0,0,15,15,15,16,31,60,45,105,0.000333,0.173397,14,7282.668576,404.592699,520.190613,122.603359,3,0
0,0,18,18,17,19,36,73,53,126,0.000333,0.217137,16,10422.5688,579.0316,651.41055,150.197491,4,0
0,0,10,10,14,14,28,42,30,72,0.000333,0.115377,14,4845.813761,269.211876,346.129554,106.605938,2,0
0,0,13,13,14,17,31,50,36,86,0.000333,0.14202,14,5964.852358,331.380687,426.060883,122.789837,3,0
0,0,11,11,14,15,29,44,32,76,0.000333,0.123069,14,5168.891779,287.160654,369.206556,111.906328,2,0
0,0,15,15,14,16,30,59,45,104,0.000333,0.170106,14,7144.432707,396.912928,510.316622,117.302969,3,0
0,0,18,18,17,19,36,72,53,125,0.000333,0.215414,16,10339.85,574.436111,646.240625,150.197491,4,0
0,0,10,10,14,14,28,42,30,72,0.000333,0.115377,14,4845.813761,269.211876,346.129554,106.605938,2,0
0,0,13,13,14,17,31,49,36,85,0.000333,0.140369,14,5895.493609,327.527423,421.106686,122.789837,3,0
0,0,11,11,14,15,29,44,32,76,0.000333,0.123069,14,5168.891779,287.160654,369.206556,111.906328,2,0
0,0,15,15,15,16,31,60,45,105,0.000333,0.173397,14,7282.668576,404.592699,520.190613,122.603359,3,0
0,0,18,18,17,19,36,73,53,126,0.000333,0.217137,16,10422.5688,579.0316,651.41055,150.197491,4,0
0,0,10,10,14,14,28,42,30,72,0.000333,0.115377,14,4845.813761,269.211876,346.129554,106.605938,2,0
0,0,13,13,14,17,31,50,36,86,0.000333,0.14202,14,5964.852358,331.380687,426.060883,122.789837,3,0
0,0,11,11,14,15,29,44,32,76,0.000333,0.123069,14,5168.891779,287.160654,369.206556,111.906328,2,0
0,0,15,15,14,16,30,59,45,104,0.000333,0.170106,14,7144.432707,396.912928,510.316622,117.302969,3,0
0,0,18,18,17,19,36,72,53,125,0.000333,0.215414,16,10339.85,574.436111,646.240625,150.197491,4,0
0,0,10,10,14,14,28,42,30,72,0.000333,0.115377,14,4845.813761,269.211876,346.129554,106.605938,2,0
0,0,13,13,14,17,31,49,36,85,0.000333,0.140369,14,5895.493609,327.527423,421.106686,122.789837,3,0
0,0,11,11,14,15,29,44,32,76,0.000333,0.123069,14,5168.891779,287.160654,369.206556,111.906328,2,0
0,0,14,14,13,14,27,56,43,99,0.000333,0.156911,18,8473.209529,470.733863,470.733863,101.408685,2,0
0,0,17,17,17,17,34,69,51,120,0.000333,0.203499,24,14651.89298,813.994055,610.495541,138.973737,3,0
0,0,10,10,14,14,28,42,30,72,0.000333,0.115377,14,4845.813761,269.211876,346.129554,106.605938,2,0
0,0,12,12,14,15,29,46,34,80,0.000333,0.129546,14,5440.938715,302.274373,388.63848,111.906328,2,0
0,0,11,11,14,15,29,44,32,76,0.000333,0.123069,14,5168.891779,287.160654,369.206556,111.906328,2,0
0,0,26,26,20,45,65,113,90,203,0.000333,0.407514,20,24450.81332,1358.378518,1222.540666,333.571951,8,0
0,0,25,25,20,45,65,112,88,200,0.000333,0.401491,10,12044.73563,669.151979,1204.473563,333.571951,8,0
0,0,26,26,20,45,65,113,90,203,0.000333,0.407514,20,24450.81332,1358.378518,1222.540666,333.571951,8,0
0,0,25,25,20,45,65,112,88,200,0.000333,0.401491,10,12044.73563,669.151979,1204.473563,333.571951,8,0
0,0,22,22,21,41,62,102,74,176,0.000333,0.349313,10,10479.38551,582.188084,1047.938551,311.898298,9,0
0,0,21,21,21,41,62,101,72,173,0.000333,0.343359,10,10300.75962,572.264423,1030.075962,311.898298,9,0
0,0,15,15,12,15,27,50,43,93,0.000333,0.147402,12,5306.454452,294.803025,442.204538,101.622909,2,0
0,0,18,18,16,18,34,63,51,114,0.000333,0.193324,16,9279.532222,515.529568,579.970764,139.05865,3,0
0,0,10,10,14,15,29,40,29,69,0.000333,0.111734,7,2346.404821,130.355823,335.200689,111.906328,2,0
0,0,11,11,11,18,29,41,45,86,0.000333,0.139262,10,4177.863656,232.103536,417.786366,113.112398,2,0
0,0,19,19,14,21,35,77,70,147,0.000333,0.251335,21,15834.09667,879.672037,754.004603,145.541635,2,0
0,0,21,21,18,24,42,85,75,160,0.000333,0.28759,27,23294.81127,1294.156181,862.770788,185.09775,3,0
0,0,11,11,12,17,29,42,44,86,0.000333,0.139262,12,5013.436387,278.524244,417.786366,112.506418,2,0
0,0,11,11,11,18,29,41,45,86,0.000333,0.139262,10,4177.863656,232.103536,417.786366,113.112398,2,0
0,0,19,19,15,21,36,80,70,150,0.000333,0.258496,21,16285.26376,904.736875,775.48875,150.842025,2,0
0,0,21,21,19,24,43,88,75,163,0.000333,0.294827,27,23880.99119,1326.721733,884.481155,190.749723,3,0
0,0,11,11,12,17,29,42,44,86,0.000333,0.139262,12,5013.436387,278.524244,417.786366,112.506418,2,0
0,0,16,16,13,19,32,62,71,133,0.000333,0.221667,18,11970,665,665,128.816339,2,0
0,0,10,10,13,16,29,44,35,79,0.000333,0.127927,12,4605.365983,255.853666,383.780499,112.105716,2,0
0,0,16,16,12,20,32,81,59,140,0.000333,0.233333,12,8400,466.666667,700,129.458112,1,0
0,0,19,19,16,22,38,94,67,161,0.000333,0.281639,24,20277.99191,1126.555106,844.91633,162.107496,2,0
0,0,10,10,14,18,32,49,36,85,0.000333,0.141667,14,5950,330.555556,425,128.361619,2,0
0,0,18,18,11,20,31,78,76,154,0.000333,0.254315,15,11444.19348,635.788526,762.946232,124.49231,1,0
0,0,21,21,15,22,37,91,84,175,0.000333,0.303885,21,19144.74112,1063.596729,911.654339,156.710855,2,0
0,0,10,10,14,17,31,49,36,85,0.000333,0.140369,14,5895.493609,327.527423,421.106686,122.789837,2,0
0,0,13,13,10,17,27,54,64,118,0.000333,0.187026,15,8416.150879,467.563938,561.076725,102.706149,1,0
0,0,16,16,14,20,34,67,72,139,0.000333,0.235719,21,14850.30403,825.016891,707.157335,139.741531,2,0
0,0,10,10,14,17,31,49,36,85,0.000333,0.140369,14,5895.493609,327.527423,421.106686,122.789837,2,0
0,0,15,15,16,19,35,74,45,119,0.000333,0.203462,16,9766.154864,542.564159,610.384679,144.710623,5,0
0,0,15,15,16,19,35,74,45,119,0.000333,0.203462,16,9766.154864,542.564159,610.384679,144.710623,5,0
0,0,6,6,9,9,18,16,14,30,0.000333,0.041699,4,500.391,27.7995,125.09775,57.05865,1,0
0,0,6,6,9,9,18,16,14,30,0.000333,0.041699,4,500.391,27.7995,125.09775,57.05865,1,0
0,0,14,14,11,17,28,54,50,104,0.000333,0.166655,10,4999.649119,277.758284,499.964912,107.540616,1,0
0,0,17,17,15,19,34,66,59,125,0.000333,0.211978,21,13354.58996,741.921664,635.932855,139.313982,2,0
0,0,13,13,13,18,31,52,46,98,0.000333,0.161837,12,5826.134861,323.674159,485.511238,123.164366,2,0
0,0,16,16,15,20,35,64,55,119,0.000333,0.203462,14,8545.385506,474.743639,610.384679,145.041921,3,0
0,0,13,13,12,18,30,51,46,97,0.000333,0.158656,12,5711.620653,317.312259,475.968388,118.0782,2,0
0,0,16,16,15,20,35,63,55,118,0.000333,0.201752,14,8473.575544,470.754197,605.255396,145.041921,3,0
0,0,13,13,12,16,28,51,45,96,0.000333,0.153835,12,5538.07287,307.670715,461.506073,107.01955,2,0
0,0,16,16,16,18,34,63,54,117,0.000333,0.198411,24,14285.59566,793.644203,595.233152,139.05865,3,0
0,0,14,14,14,19,33,57,51,108,0.000333,0.181598,14,7627.123908,423.729106,544.794565,134.013592,2,0
0,0,17,17,18,21,39,69,60,129,0.000333,0.227272,18,12272.70395,681.816886,681.816886,167.297316,3,0
0,0,15,15,14,18,32,50,47,97,0.000333,0.161667,14,6790,377.222222,485,128.361619,3,0
0,0,12,12,14,18,32,39,35,74,0.000333,0.123333,7,2590,143.888889,370,128.361619,3,0
0,0,15,15,14,18,32,49,47,96,0.000333,0.16,14,6720,373.333333,480,128.361619,3,0
0,0,12,12,14,18,32,38,35,73,0.000333,0.121667,7,2555,141.944444,365,128.361619,3,0
0,0,6,6,10,10,20,17,15,32,0.000333,0.046101,5,691.508495,38.417139,138.301699,66.438562,1,0
0,0,15,15,14,20,34,70,48,118,0.000333,0.200107,14,8404.488614,466.916034,600.320615,139.741531,5,0
0,0,6,6,9,12,21,15,17,32,0.000333,0.046851,4,562.21663,31.234257,140.554158,71.548875,1,0
0,0,15,15,15,22,37,71,48,119,0.000333,0.206642,14,8678.949307,482.16385,619.924951,156.710855,5,0
0,0,7,7,6,15,21,18,28,46,0.000333,0.067349,3,606.139804,33.674434,202.046601,74.113134,1,0
0,0,7,7,7,16,23,15,25,40,0.000333,0.060314,3,542.827435,30.15708,180.942478,83.651484,1,0
0,0,7,7,7,17,24,19,27,46,0.000333,0.070303,3,632.724825,35.151379,210.908275,89.138353,1,0
0,0,14,14,12,20,32,40,55,95,0.000333,0.158333,12,5700,316.666667,475,129.458112,2,0
0,0,15,15,14,22,36,51,60,111,0.000333,0.191287,14,8034.063452,446.336858,573.861675,151.410465,3,0
0,0,10,10,14,19,33,34,35,69,0.000333,0.116021,7,2436.44236,135.357909,348.063194,134.013592,2,0
0,0,15,15,13,20,33,51,69,120,0.000333,0.201776,18,10895.8913,605.327294,605.327294,134.544278,2,0
0,0,19,19,16,22,38,75,73,148,0.000333,0.258898,24,18640.63853,1035.591029,776.693272,162.107496,3,0
0,0,19,19,16,22,38,75,73,148,0.000333,0.258898,24,18640.63853,1035.591029,776.693272,162.107496,3,0
0,0,17,17,15,18,33,68,58,126,0.000333,0.211865,21,13347.46684,741.525936,635.593659,133.662009,2,0
0,0,15,15,13,19,32,66,57,123,0.000333,0.205,18,11070,615,615,128.816339,2,0
0,0,17,17,15,22,37,74,62,136,0.000333,0.236162,14,9918.799208,551.0444,708.485658,156.710855,3,0
0,0,15,15,12,19,31,65,57,122,0.000333,0.201471,18,10879.4151,604.41195,604.41195,123.730173,2,0
0,0,17,17,15,22,37,73,62,135,0.000333,0.234425,14,9845.866861,546.992603,703.276204,156.710855,3,0
0,0,18,18,14,21,35,76,62,138,0.000333,0.235947,14,9909.774789,550.543044,707.841056,145.541635,2,0
0,0,20,20,16,24,40,84,67,151,0.000333,0.26787,16,12857.77828,714.321015,803.611142,174.0391,3,0
0,0,28,28,23,48,71,131,91,222,0.000333,0.455081,11,15017.68247,834.315693,1365.243861,372.120125,13,0
0,0,27,27,22,49,71,126,90,216,0.000333,0.442782,11,14611.79916,811.76662,1328.345378,373.228278,12,0
0,0,26,26,22,49,71,125,88,213,0.000333,0.436632,11,14408.8575,800.492083,1309.896136,373.228278,12,0
0,0,28,28,23,47,70,131,91,222,0.000333,0.453567,11,14967.70913,831.539396,1360.70083,365.107601,13,0
0,0,27,27,22,49,71,126,90,216,0.000333,0.442782,11,14611.79916,811.76662,1328.345378,373.228278,12,0
0,0,26,26,22,49,71,125,88,213,0.000333,0.436632,11,14408.8575,800.492083,1309.896136,373.228278,12,0
0,0,9,9,12,13,25,28,20,48,0.000333,0.074302,6,1337.430583,74.301699,222.905097,91.125266,4,0
0,0,9,9,12,12,24,28,20,48,0.000333,0.073359,6,1320.4692,73.3594,220.0782,86.0391,4,0
0,0,28,28,23,47,70,132,93,225,0.000333,0.459696,11,15169.97547,842.776415,1379.088679,365.107601,13,0
0,0,27,27,22,49,71,126,91,217,0.000333,0.444832,11,14679.44637,815.524799,1334.495125,373.228278,12,0
0,0,26,26,22,49,71,125,89,214,0.000333,0.438682,11,14476.50472,804.250262,1316.045884,373.228278,12,0
0,0,28,28,23,47,70,131,93,224,0.000333,0.457653,11,15102.55335,839.030742,1372.959396,365.107601,13,0
0,0,27,27,22,49,71,126,91,217,0.000333,0.444832,11,14679.44637,815.524799,1334.495125,373.228278,12,0
0,0,26,26,22,49,71,125,89,214,0.000333,0.438682,11,14476.50472,804.250262,1316.045884,373.228278,12,0
0,0,9,9,13,12,25,29,22,51,0.000333,0.078946,6,1421.019994,78.945555,236.836666,91.125266,4,0
0,0,9,9,12,12,24,28,22,50,0.000333,0.076416,6,1375.48875,76.416042,229.248125,86.0391,4,0
0,0,15,15,13,17,30,68,44,112,0.000333,0.183191,12,6594.86096,366.381164,549.571747,117.592585,2,0
0,0,18,18,16,19,35,81,52,133,0.000333,0.227398,16,10915.11426,606.395237,682.194641,144.710623,3,0
0,0,10,10,15,15,30,47,32,79,0.000333,0.129215,14,5427.020999,301.501167,387.644357,117.206718,2,0
0,0,15,15,13,16,29,68,44,112,0.000333,0.181365,12,6529.126457,362.729248,544.093871,112.105716,2,0
0,0,18,18,16,18,34,81,52,133,0.000333,0.225544,16,10826.12093,601.451163,676.632558,139.05865,3,0
0,0,10,10,15,15,30,47,32,79,0.000333,0.129215,14,5427.020999,301.501167,387.644357,117.206718,2,0
0,0,10,10,10,17,27,41,34,75,0.000333,0.118872,10,3566.165627,198.120313,356.616563,102.706149,1,0
0,0,10,10,11,18,29,41,33,74,0.000333,0.11983,5,1797.452968,99.858498,359.490594,113.112398,1,0
0,0,21,21,15,23,38,95,72,167,0.000333,0.292135,21,18404.48179,1022.471211,876.403895,162.645284,2,0
0,0,10,10,14,17,31,49,35,84,0.000333,0.138717,14,5826.134861,323.674159,416.15249,122.789837,2,0
0,0,18,18,15,23,38,81,62,143,0.000333,0.250151,14,10506.35088,583.68616,750.453634,162.645284,2,0
0,0,21,21,16,23,39,87,75,162,0.000333,0.285412,24,20549.64383,1141.646879,856.235159,168.041925,2,0
0,0,10,10,14,18,32,46,37,83,0.000333,0.138333,14,5810,322.777778,415,128.361619,2,0
0,0,11,11,14,18,32,47,39,86,0.000333,0.143333,14,6020,334.444444,430,128.361619,2,0
0,0,10,10,14,16,30,44,33,77,0.000333,0.125944,14,5289.628062,293.868226,377.830576,117.302969,2,0
0,0,10,10,15,17,32,49,36,85,0.000333,0.141667,14,5950,330.555556,425,128.090227,2,0
0,0,25,25,20,48,68,120,86,206,0.000333,0.418006,10,12540.17345,696.676303,1254.017345,354.516762,10,0
0,0,24,24,20,48,68,119,84,203,0.000333,0.411918,10,12357.54957,686.530532,1235.754957,354.516762,10,0
0,0,18,18,15,17,32,78,58,136,0.000333,0.226667,21,14280,793.333333,680,128.090227,2,0
0,0,21,21,19,19,38,91,66,157,0.000333,0.274642,27,22245.96473,1235.886929,823.92462,161.421246,3,0
0,0,10,10,14,14,28,42,30,72,0.000333,0.115377,14,4845.813761,269.211876,346.129554,106.605938,2,0
0,0,5,5,11,14,25,18,19,37,0.000333,0.057274,5,859.113395,47.728522,171.822679,91.356717,2,0
0,0,5,5,13,14,27,22,21,43,0.000333,0.068153,6,1226.760976,68.153388,204.460163,101.408685,3,0
0,0,10,10,14,17,31,32,35,67,0.000333,0.110644,14,4647.036139,258.168674,331.931153,122.789837,2,0
0,0,10,10,16,16,32,36,37,73,0.000333,0.121667,16,5840,324.444444,365,128,3,0
0,0,4,4,10,12,22,17,17,34,0.000333,0.05054,5,758.103375,42.116854,151.620675,76.238831,2,0
0,0,4,4,12,12,24,21,19,40,0.000333,0.061133,6,1100.391,61.132833,183.3985,86.0391,3,0
0,0,5,5,12,12,24,22,17,39,0.000333,0.059605,6,1072.881225,59.604513,178.813538,86.0391,1,0
0,0,8,8,15,15,30,35,25,60,0.000333,0.098138,7,2060.89405,114.494114,294.413436,117.206718,2,0
0,0,9,9,12,16,28,35,33,68,0.000333,0.108967,12,3922.801616,217.933423,326.900135,107.01955,1,0
0,0,14,14,14,19,33,56,47,103,0.000333,0.173191,14,7274.01632,404.112018,519.572594,134.013592,3,0
0,0,17,17,18,22,40,69,55,124,0.000333,0.219973,18,11878.54351,659.919084,659.919084,173.166146,4,0
0,0,13,13,15,18,33,50,40,90,0.000333,0.151332,14,6355.93659,353.107588,453.995471,133.662009,2,0
0,0,13,13,11,16,27,44,40,84,0.000333,0.133137,10,3994.105502,221.89475,399.41055,102.053748,1,0
0,0,16,16,15,19,34,57,48,105,0.000333,0.178061,14,7478.570377,415.476132,534.183598,139.313982,2,0
0,0,15,15,15,19,34,56,46,102,0.000333,0.172974,14,7264.896937,403.605385,518.92121,139.313982,2,0
0,0,5,5,12,12,24,22,17,39,0.000333,0.059605,6,1072.881225,59.604513,178.813538,86.0391,1,0
0,0,8,8,15,15,30,35,25,60,0.000333,0.098138,7,2060.89405,114.494114,294.413436,117.206718,2,0
0,0,11,11,12,17,29,41,39,80,0.000333,0.129546,12,4663.661755,259.09232,388.63848,112.506418,1,0
0,0,14,14,12,22,34,46,46,92,0.000333,0.156016,12,5616.558977,312.031054,468.046581,141.127046,1,0
0,0,17,17,16,25,41,59,54,113,0.000333,0.201801,16,9686.454024,538.136335,605.403377,180.096405,2,0
0,0,15,15,16,21,37,57,47,104,0.000333,0.180594,16,8668.5304,481.585022,541.78315,156.238666,2,0
0,0,5,5,12,12,24,22,17,39,0.000333,0.059605,6,1072.881225,59.604513,178.813538,86.0391,1,0
0,0,8,8,15,15,30,35,25,60,0.000333,0.098138,7,2060.89405,114.494114,294.413436,117.206718,2,0
0,0,11,11,13,19,32,42,40,82,0.000333,0.136667,12,4920,273.333333,410,128.816339,1,0
0,0,16,16,14,20,34,64,63,127,0.000333,0.215369,21,13568.2634,753.792411,646.107781,139.741531,2,0
0,0,18,18,18,23,41,72,68,140,0.000333,0.250019,18,13501.03105,750.057281,750.057281,179.100575,3,0
0,0,18,18,14,22,36,74,72,146,0.000333,0.251603,21,15850.99005,880.610559,754.80905,151.410465,6,0
0,0,12,12,9,16,25,35,51,86,0.000333,0.133124,12,4792.459588,266.247755,399.371632,92.529325,2,0
0,0,18,18,16,24,40,77,77,154,0.000333,0.273192,24,19669.84624,1092.769235,819.576927,174.0391,6,0
0,0,12,12,14,18,32,54,43,97,0.000333,0.161667,14,6790,377.222222,485,128.361619,5,0
0,0,6,6,9,12,21,15,17,32,0.000333,0.046851,4,562.21663,31.234257,140.554158,71.548875,1,0
0,0,12,12,15,20,35,55,43,98,0.000333,0.167557,14,7037.376299,390.96535,502.669736,145.041921,5,0
0,0,15,15,12,20,32,60,56,116,0.000333,0.193333,12,6960,386.666667,580,129.458112,1,0
0,0,17,17,16,23,39,68,61,129,0.000333,0.227272,16,10909.07018,606.059454,681.816886,168.041925,2,0
0,0,9,9,10,11,21,28,25,53,0.000333,0.077598,10,2327.928234,129.329346,232.792823,71.273029,2,0
0,0,15,15,17,19,36,70,51,121,0.000333,0.20852,16,10008.9748,556.054156,625.560925,150.197491,6,0
0,0,13,13,12,15,27,55,46,101,0.000333,0.160081,18,8644.385479,480.243638,480.243638,101.622909,2,0
0,0,15,15,16,18,34,63,51,114,0.000333,0.193324,16,9279.532222,515.529568,579.970764,139.05865,3,0
0,0,13,13,12,15,27,55,46,101,0.000333,0.160081,18,8644.385479,480.243638,480.243638,101.622909,2,0
0,0,15,15,16,18,34,63,51,114,0.000333,0.193324,16,9279.532222,515.529568,579.970764,139.05865,3,0
0,0,20,20,14,23,37,80,82,162,0.000333,0.28131,21,17722.56035,984.586686,843.931445,157.344894,6,0
0,0,14,14,9,17,26,41,63,104,0.000333,0.162949,12,5866.148768,325.897154,488.845731,98.016193,2,0
0,0,20,20,16,25,41,83,89,172,0.000333,0.307166,24,22115.97468,1228.66526,921.498945,180.096405,6,0
0,0,11,11,14,21,35,46,39,85,0.000333,0.14533,7,3051.923395,169.5513,435.989056,145.541635,4,0
0,0,8,8,11,15,26,25,26,51,0.000333,0.079907,5,1198.612128,66.589563,239.722426,96.657107,2,0
0,0,11,11,16,22,38,49,41,90,0.000333,0.157438,8,3778.50781,209.917101,472.313476,162.107496,4,0
0,0,11,11,11,18,29,41,45,86,0.000333,0.139262,10,4177.863656,232.103536,417.786366,113.112398,2,0
0,0,18,18,16,22,38,75,66,141,0.000333,0.246653,24,17758.98671,986.610373,739.957779,162.107496,3,0
0,0,20,20,18,25,43,83,71,154,0.000333,0.278548,18,15041.6059,835.644772,835.644772,191.155055,4,0
0,0,11,11,12,17,29,42,44,86,0.000333,0.139262,12,5013.436387,278.524244,417.786366,112.506418,2,0
0,0,18,18,15,22,37,74,66,140,0.000333,0.243108,21,15315.7929,850.877383,729.323471,156.710855,3,0
0,0,20,20,18,25,43,82,71,153,0.000333,0.27674,18,14943.93313,830.218507,830.218507,191.155055,4,0
0,0,11,11,12,17,29,42,44,86,0.000333,0.139262,12,5013.436387,278.524244,417.786366,112.506418,2,0
0,0,30,30,21,53,74,137,99,236,0.000333,0.488477,10,14654.30994,814.12833,1465.430994,395.81845,12,0
0,0,29,29,21,53,74,136,97,233,0.000333,0.482268,10,14468.02634,803.779241,1446.802634,395.81845,12,0
0,0,30,30,21,53,74,137,99,236,0.000333,0.488477,10,14654.30994,814.12833,1465.430994,395.81845,12,0
0,0,29,29,21,53,74,136,97,233,0.000333,0.482268,10,14468.02634,803.779241,1446.802634,395.81845,12,0
0,0,19,19,15,27,42,90,65,155,0.000333,0.278603,14,11701.32881,650.073823,835.809201,186.985321,8,0
0,0,35,35,21,54,75,169,119,288,0.000333,0.597967,20,35877.99566,1993.221981,1793.899783,403.002591,14,0
0,0,34,34,21,54,75,168,117,285,0.000333,0.591738,20,35504.26654,1972.459252,1775.213327,403.002591,14,0
0,0,35,35,21,54,75,169,119,288,0.000333,0.597967,20,35877.99566,1993.221981,1793.899783,403.002591,14,0
0,0,34,34,21,54,75,168,117,285,0.000333,0.591738,20,35504.26654,1972.459252,1775.213327,403.002591,14,0
0,0,19,19,15,27,42,90,65,155,0.000333,0.278603,14,11701.32881,650.073823,835.809201,186.985321,8,0
0,0,28,28,20,53,73,133,96,229,0.000333,0.47249,10,14174.69824,787.483236,1417.469824,390.018346,12,0
0,0,27,27,20,53,73,132,94,226,0.000333,0.4663,10,13989.0035,777.166861,1398.90035,390.018346,12,0
0,0,28,28,20,53,73,133,96,229,0.000333,0.47249,10,14174.69824,787.483236,1417.469824,390.018346,12,0
0,0,27,27,20,53,73,132,94,226,0.000333,0.4663,10,13989.0035,777.166861,1398.90035,390.018346,12,0
0,0,15,15,16,19,35,74,45,119,0.000333,0.203462,16,9766.154864,542.564159,610.384679,144.710623,5,0
0,0,15,15,16,19,35,74,45,119,0.000333,0.203462,16,9766.154864,542.564159,610.384679,144.710623,5,0
0,0,6,6,9,9,18,16,14,30,0.000333,0.041699,4,500.391,27.7995,125.09775,57.05865,1,0
0,0,6,6,9,9,18,16,14,30,0.000333,0.041699,4,500.391,27.7995,125.09775,57.05865,1,0
0,0,26,26,20,47,67,113,87,200,0.000333,0.404406,10,12132.17838,674.00991,1213.217838,347.504238,8,0
0,0,25,25,20,47,67,112,85,197,0.000333,0.39834,10,11950.19571,663.899761,1195.019571,347.504238,8,0
0,0,26,26,16,19,35,139,80,219,0.000333,0.374438,32,35946.01538,1997.000855,1123.312981,144.710623,9,0
0,0,8,8,9,9,18,23,18,41,0.000333,0.056989,8,1367.7354,75.9853,170.966925,57.05865,1,0
0,0,13,13,12,18,30,37,60,97,0.000333,0.158656,18,8567.43098,475.968388,475.968388,118.0782,2,0
0,0,13,13,14,18,32,42,62,104,0.000333,0.173333,21,10920,606.666667,520,128.361619,3,0
0,0,4,4,10,12,22,17,17,34,0.000333,0.05054,5,758.103375,42.116854,151.620675,76.238831,2,0
0,0,4,4,12,12,24,21,19,40,0.000333,0.061133,6,1100.391,61.132833,183.3985,86.0391,3,0
0,0,15,15,12,20,32,66,55,121,0.000333,0.201667,12,7260,403.333333,605,129.458112,1,0
0,0,18,18,16,22,38,79,63,142,0.000333,0.248402,16,11923.29131,662.405073,745.205707,162.107496,2,0
0,0,9,9,13,18,31,41,33,74,0.000333,0.122204,6,2199.663162,122.203509,366.610527,123.164366,2,0
0,0,16,16,11,20,31,65,69,134,0.000333,0.221287,15,9957.934584,553.218588,663.862306,124.49231,1,0
0,0,18,18,15,22,37,73,74,147,0.000333,0.255263,21,16081.58254,893.421252,765.789645,156.710855,2,0
0,0,7,7,11,14,25,28,25,53,0.000333,0.082041,5,1230.62189,68.367883,246.124378,91.356717,2,0
0,0,4,4,8,9,17,14,14,28,0.000333,0.03815,4,457.795838,25.433102,114.44896,52.529325,1,0
0,0,16,16,15,18,33,65,49,114,0.000333,0.191687,14,8050.853014,447.269612,575.06093,133.662009,3,0
0,0,19,19,17,21,38,78,57,135,0.000333,0.236157,16,11335.52343,629.751302,708.470214,161.725534,4,0
0,0,7,7,12,13,25,29,24,53,0.000333,0.082041,6,1476.746268,82.041459,246.124378,91.125266,2,0
0,0,12,12,17,17,34,54,38,92,0.000333,0.156016,16,7488.745302,416.041406,468.046581,138.973737,3,0
0,0,13,13,14,17,31,50,36,86,0.000333,0.14202,14,5964.852358,331.380687,426.060883,122.789837,3,0
0,0,11,11,14,15,29,44,32,76,0.000333,0.123069,14,5168.891779,287.160654,369.206556,111.906328,2,0
0,0,4,4,9,8,17,15,13,28,0.000333,0.03815,4,457.795838,25.433102,114.44896,52.529325,1,0
0,0,16,16,14,18,32,64,49,113,0.000333,0.188333,14,7910,439.444444,565,128.361619,3,0
0,0,19,19,17,21,38,77,57,134,0.000333,0.234407,16,11251.55659,625.086477,703.222287,161.725534,4,0
0,0,7,7,12,13,25,29,24,53,0.000333,0.082041,6,1476.746268,82.041459,246.124378,91.125266,2,0
0,0,12,12,17,17,34,54,38,92,0.000333,0.156016,16,7488.745302,416.041406,468.046581,138.973737,3,0
0,0,13,13,14,17,31,49,36,85,0.000333,0.140369,14,5895.493609,327.527423,421.106686,122.789837,3,0
0,0,11,11,14,15,29,44,32,76,0.000333,0.123069,14,5168.891779,287.160654,369.206556,111.906328,2,0
0,0,4,4,9,8,17,15,13,28,0.000333,0.03815,4,457.795838,25.433102,114.44896,52.529325,1,0
0,0,13,13,11,14,25,61,42,103,0.000333,0.159439,15,7174.757813,398.597656,478.317188,91.356717,1,0
0,0,16,16,15,16,31,74,50,124,0.000333,0.204773,21,12900.72719,716.707066,614.320342,122.603359,2,0
0,0,10,10,15,14,29,45,31,76,0.000333,0.123069,14,5168.891779,287.160654,369.206556,111.906328,2,0
0,0,15,15,12,15,27,70,48,118,0.000333,0.187026,18,10099.38106,561.076725,561.076725,101.622909,1,0
0,0,18,18,16,17,33,83,56,139,0.000333,0.233724,24,16828.09878,934.894377,701.170783,133.486868,2,0
0,0,10,10,15,14,29,45,31,76,0.000333,0.123069,14,5168.891779,287.160654,369.206556,111.906328,2,0
0,0,12,12,16,17,33,58,40,98,0.000333,0.164784,16,7909.609979,439.422777,494.350624,133.486868,5,0
0,0,6,6,9,9,18,16,14,30,0.000333,0.041699,4,500.391,27.7995,125.09775,57.05865,1,0
0,0,15,15,12,20,32,55,60,115,0.000333,0.191667,18,10350,575,575,129.458112,3,0
0,0,12,12,9,15,24,34,50,84,0.000333,0.128379,12,4621.642201,256.7579,385.13685,87.132684,1,0
0,0,15,15,14,22,36,58,65,123,0.000333,0.211967,14,8902.610852,494.589492,635.900775,151.410465,3,0
0,0,9,9,10,13,23,26,28,54,0.000333,0.081424,10,2442.723456,135.706859,244.272346,81.324997,1,0
0,0,12,12,15,20,35,50,43,93,0.000333,0.159008,14,6678.326488,371.018138,477.023321,145.041921,3,0
0,0,14,14,12,22,34,46,46,92,0.000333,0.156016,12,5616.558977,312.031054,468.046581,141.127046,1,0
0,0,17,17,16,25,41,59,54,113,0.000333,0.201801,16,9686.454024,538.136335,605.403377,180.096405,2,0
0,0,15,15,16,21,37,57,47,104,0.000333,0.180594,16,8668.5304,481.585022,541.78315,156.238666,2,0
0,0,5,5,12,12,24,22,17,39,0.000333,0.059605,6,1072.881225,59.604513,178.813538,86.0391,1,0
0,0,8,8,15,15,30,35,25,60,0.000333,0.098138,7,2060.89405,114.494114,294.413436,117.206718,2,0
0,0,19,19,17,24,41,90,62,152,0.000333,0.271449,16,13029.56648,723.864804,814.347905,179.525968,5,0
0,0,13,13,16,20,36,53,45,98,0.000333,0.168884,16,8106.442402,450.357911,506.65265,150.438562,3,0
0,0,10,10,13,16,29,41,32,73,0.000333,0.118211,12,4255.591352,236.421742,354.632613,112.105716,2,0
0,0,10,10,10,17,27,41,34,75,0.000333,0.118872,10,3566.165627,198.120313,356.616563,102.706149,1,0
0,0,10,10,11,18,29,41,33,74,0.000333,0.11983,5,1797.452968,99.858498,359.490594,113.112398,1,0
0,0,23,23,18,25,43,101,78,179,0.000333,0.323767,27,26225.13756,1456.952087,971.301391,191.155055,3,0
0,0,10,10,13,17,30,46,34,80,0.000333,0.13085,12,4710.614972,261.700832,392.551248,117.592585,2,0
0,0,18,18,15,23,38,78,61,139,0.000333,0.243154,14,10212.46694,567.359275,729.461924,162.645284,2,0
0,0,4,4,14,11,25,21,21,42,0.000333,0.065014,7,1365.29372,75.849651,195.04196,91.356717,3,0
0,0,4,4,12,11,23,17,19,36,0.000333,0.054283,6,977.089383,54.282743,162.84823,81.073298,2,0
0,0,34,34,21,56,77,150,118,268,0.000333,0.559833,20,33589.97586,1866.10977,1679.498793,417.450542,11,0
0,0,33,33,21,56,77,149,116,265,0.000333,0.553566,20,33213.96867,1845.220481,1660.698433,417.450542,11,0
0,0,13,13,12,15,27,63,41,104,0.000333,0.164836,12,5934.099603,329.6722,494.5083,101.622909,2,0
0,0,16,16,15,17,32,76,49,125,0.000333,0.208333,14,8750,486.111111,625,128.090227,3,0
0,0,13,13,12,15,27,63,41,104,0.000333,0.164836,12,5934.099603,329.6722,494.5083,101.622909,2,0
0,0,16,16,15,17,32,76,49,125,0.000333,0.208333,14,8750,486.111111,625,128.090227,3,0
0,0,13,13,13,16,29,64,42,106,0.000333,0.171649,12,6179.351826,343.297324,514.945985,112.105716,2,0
0,0,16,16,15,18,33,77,50,127,0.000333,0.213546,14,8968.932744,498.274041,640.638053,133.662009,3,0
0,0,10,10,15,15,30,47,32,79,0.000333,0.129215,14,5427.020999,301.501167,387.644357,117.206718,2,0
0,0,13,13,12,16,28,63,42,105,0.000333,0.168257,12,6057.267202,336.514845,504.772267,107.01955,2,0
0,0,16,16,15,18,33,76,50,126,0.000333,0.211865,14,8898.311227,494.350624,635.593659,133.662009,3,0
0,0,10,10,15,15,30,47,32,79,0.000333,0.129215,14,5427.020999,301.501167,387.644357,117.206718,2,0
0,0,13,13,12,15,27,63,41,104,0.000333,0.164836,12,5934.099603,329.6722,494.5083,101.622909,2,0
0,0,16,16,15,17,32,76,49,125,0.000333,0.208333,14,8750,486.111111,625,128.090227,3,0
0,0,10,10,15,15,30,47,32,79,0.000333,0.129215,14,5427.020999,301.501167,387.644357,117.206718,2,0
0,0,13,13,12,15,27,63,41,104,0.000333,0.164836,12,5934.099603,329.6722,494.5083,101.622909,2,0
0,0,16,16,15,17,32,76,49,125,0.000333,0.208333,14,8750,486.111111,625,128.090227,3,0
0,0,10,10,15,15,30,47,32,79,0.000333,0.129215,14,5427.020999,301.501167,387.644357,117.206718,2,0
0,0,13,13,13,16,29,64,42,106,0.000333,0.171649,12,6179.351826,343.297324,514.945985,112.105716,2,0
0,0,16,16,15,18,33,77,50,127,0.000333,0.213546,14,8968.932744,498.274041,640.638053,133.662009,3,0
0,0,10,10,15,15,30,47,32,79,0.000333,0.129215,14,5427.020999,301.501167,387.644357,117.206718,2,0
0,0,13,13,12,16,28,63,42,105,0.000333,0.168257,12,6057.267202,336.514845,504.772267,107.01955,2,0
0,0,16,16,15,18,33,76,50,126,0.000333,0.211865,14,8898.311227,494.350624,635.593659,133.662009,3,0
0,0,10,10,15,15,30,47,32,79,0.000333,0.129215,14,5427.020999,301.501167,387.644357,117.206718,2,0
0,0,13,13,12,15,27,63,41,104,0.000333,0.164836,12,5934.099603,329.6722,494.5083,101.622909,2,0
0,0,16,16,15,17,32,76,49,125,0.000333,0.208333,14,8750,486.111111,625,128.090227,3,0
0,0,10,10,15,15,30,47,32,79,0.000333,0.129215,14,5427.020999,301.501167,387.644357,117.206718,2,0
0,0,13,13,12,15,27,63,41,104,0.000333,0.164836,12,5934.099603,329.6722,494.5083,101.622909,2,0
0,0,16,16,15,17,32,76,49,125,0.000333,0.208333,14,8750,486.111111,625,128.090227,3,0
0,0,10,10,15,15,30,47,32,79,0.000333,0.129215,14,5427.020999,301.501167,387.644357,117.206718,2,0
0,0,20,20,16,24,40,92,67,159,0.000333,0.282062,16,13538.98507,752.165837,846.186567,174.0391,5,0
0,0,11,11,10,16,26,37,39,76,0.000333,0.119078,10,3572.334186,198.46301,357.233419,97.219281,1,0
0,0,19,19,16,25,41,89,67,156,0.000333,0.278593,16,13372.4498,742.913878,835.778113,180.096405,5,0
0,0,15,15,14,18,32,50,47,97,0.000333,0.161667,14,6790,377.222222,485,128.361619,3,0
0,0,12,12,14,18,32,39,35,74,0.000333,0.123333,7,2590,143.888889,370,128.361619,3,0
0,0,15,15,14,18,32,49,47,96,0.000333,0.16,14,6720,373.333333,480,128.361619,3,0
0,0,12,12,14,18,32,38,35,73,0.000333,0.121667,7,2555,141.944444,365,128.361619,3,0
0,0,11,11,10,13,23,37,33,70,0.000333,0.10555,10,3166.493369,175.916298,316.649337,81.324997,1,0
0,0,19,19,16,22,38,89,61,150,0.000333,0.262396,16,12595.02603,699.723668,787.189127,162.107496,5,0
0,0,11,11,11,15,26,38,34,72,0.000333,0.112811,10,3384.316597,188.017589,338.43166,96.657107,1,0
0,0,19,19,17,24,41,90,62,152,0.000333,0.271449,16,13029.56648,723.864804,814.347905,179.525968,5,0
0,0,9,9,14,16,30,40,29,69,0.000333,0.112858,7,2370.028158,131.668231,338.575451,117.302969,3,0
0,0,9,9,14,16,30,40,29,69,0.000333,0.112858,7,2370.028158,131.668231,338.575451,117.302969,3,0
0,0,6,6,9,9,18,16,14,30,0.000333,0.041699,4,500.391,27.7995,125.09775,57.05865,1,0
0,0,6,6,9,9,18,16,14,30,0.000333,0.041699,4,500.391,27.7995,125.09775,57.05865,1,0
0,0,23,23,19,50,69,129,85,214,0.000333,0.435741,9,11765.0181,653.612117,1307.224234,362.903432,11,0
0,0,22,22,19,49,68,128,83,211,0.000333,0.428152,9,11560.09194,642.22733,1284.45466,355.831405,11,0
0,0,20,20,19,42,61,112,71,183,0.000333,0.361775,9,9767.924395,542.662466,1085.324933,307.187955,10,0
0,0,23,23,19,47,66,130,82,212,0.000333,0.427137,9,11532.70398,640.705777,1281.411553,341.776299,10,0
0,0,22,22,20,43,63,123,75,198,0.000333,0.3945,10,11835.01425,657.500792,1183.501425,319.767946,9,0
0,0,23,23,20,50,70,135,85,220,0.000333,0.449481,10,13484.42264,749.134591,1348.442264,368.631371,10,0
0,0,20,20,19,39,58,113,68,181,0.000333,0.353432,9,9542.651041,530.14728,1060.29456,286.841309,9,0
0,0,23,23,19,47,66,130,82,212,0.000333,0.427137,9,11532.70398,640.705777,1281.411553,341.776299,10,0
0,0,22,22,20,43,63,123,75,198,0.000333,0.3945,10,11835.01425,657.500792,1183.501425,319.767946,9,0
0,0,23,23,20,50,70,135,85,220,0.000333,0.449481,10,13484.42264,749.134591,1348.442264,368.631371,10,0
0,0,20,20,19,39,58,113,68,181,0.000333,0.353432,9,9542.651041,530.14728,1060.29456,286.841309,9,0
0,0,6,6,9,10,19,17,15,32,0.000333,0.045311,4,543.734722,30.207485,135.93368,61.748606,1,0
0,0,24,24,21,44,65,108,78,186,0.000333,0.373387,10,11201.60413,622.311341,1120.160413,332.453657,9,0
0,0,23,23,21,44,65,107,76,183,0.000333,0.367364,10,11020.9331,612.274061,1102.09331,332.453657,9,0
0,0,24,24,21,44,65,108,78,186,0.000333,0.373387,10,11201.60413,622.311341,1120.160413,332.453657,9,0
0,0,23,23,21,44,65,107,76,183,0.000333,0.367364,10,11020.9331,612.274061,1102.09331,332.453657,9,0
0,0,24,24,20,43,63,108,78,186,0.000333,0.370591,10,11117.74066,617.652259,1111.774066,319.767946,9,0
0,0,23,23,20,43,63,107,76,183,0.000333,0.364614,10,10938.42226,607.690126,1093.842226,319.767946,9,0
0,0,26,26,21,44,65,112,81,193,0.000333,0.387439,10,11623.16988,645.73166,1162.316988,332.453657,9,0
0,0,25,25,21,44,65,111,79,190,0.000333,0.381417,10,11442.49885,635.69438,1144.249884,332.453657,9,0
0,0,26,26,21,44,65,112,81,193,0.000333,0.387439,10,11623.16988,645.73166,1162.316988,332.453657,9,0
0,0,25,25,21,44,65,111,79,190,0.000333,0.381417,10,11442.49885,635.69438,1144.249884,332.453657,9,0
0,0,5,5,8,10,18,14,14,28,0.000333,0.038919,4,467.0316,25.9462,116.7579,57.219281,2,0
0,0,8,8,13,13,26,27,22,49,0.000333,0.076774,6,1381.929277,76.773849,230.321546,96.211433,3,0
0,0,5,5,10,8,18,16,12,28,0.000333,0.038919,5,583.7895,32.43275,116.7579,57.219281,2,0
0,0,8,8,14,11,25,29,20,49,0.000333,0.07585,7,1592.842673,88.49126,227.548953,91.356717,3,0
0,0,6,6,11,10,21,19,16,35,0.000333,0.051244,5,768.655549,42.703086,153.73111,71.273029,3,0
0,0,5,5,9,8,17,15,12,27,0.000333,0.036787,4,441.445987,24.524777,110.361497,52.529325,2,0
0,0,8,8,14,11,25,28,20,48,0.000333,0.074302,7,1560.33568,86.685316,222.905097,91.356717,3,0
0,0,6,6,10,10,20,18,16,34,0.000333,0.048982,5,734.727776,40.81821,146.945555,66.438562,3,0
0,0,49,49,25,93,118,280,219,499,0.000333,1.144813,24,82426.53316,4579.251842,3434.438882,724.238174,20,0
0,0,13,13,14,36,50,85,64,149,0.000333,0.280312,7,5886.542006,327.030111,840.934572,239.420269,7,0
0,0,17,17,16,19,35,55,66,121,0.000333,0.206881,24,14895.43788,827.524327,620.643245,144.710623,2,0
0,0,20,20,19,22,41,68,74,142,0.000333,0.253591,27,20540.85439,1141.158577,760.772385,178.818118,3,0
0,0,18,18,18,22,40,60,69,129,0.000333,0.228843,27,18536.27555,1029.793086,686.528724,173.166146,2,0
0,0,5,5,11,11,22,19,14,33,0.000333,0.049054,5,735.806217,40.878123,147.161243,76.107496,3,0
0,0,5,5,11,11,22,19,14,33,0.000333,0.049054,5,735.806217,40.878123,147.161243,76.107496,3,0
0,0,5,5,11,11,22,19,14,33,0.000333,0.049054,5,735.806217,40.878123,147.161243,76.107496,3,0
0,0,5,5,11,11,22,19,14,33,0.000333,0.049054,5,735.806217,40.878123,147.161243,76.107496,3,0
0,0,5,5,12,12,24,20,15,35,0.000333,0.053491,6,962.842125,53.491229,160.473688,86.0391,3,0
0,0,5,5,11,12,23,19,15,34,0.000333,0.051267,5,769.005533,42.72253,153.801107,81.073298,3,0
0,0,7,7,12,13,25,23,17,40,0.000333,0.061918,6,1114.525486,61.918083,185.754248,91.125266,3,0
0,0,7,7,12,13,25,23,17,40,0.000333,0.061918,6,1114.525486,61.918083,185.754248,91.125266,3,0
0,0,23,23,19,41,60,101,77,178,0.000333,0.350476,9,9462.838734,525.713263,1051.426526,300.370255,7,0
0,0,19,19,19,37,56,93,66,159,0.000333,0.30779,9,8310.324893,461.684716,923.369433,273.460397,7,0
0,0,23,23,19,40,59,102,78,180,0.000333,0.352959,9,9529.88174,529.437874,1058.875749,293.587747,7,0
0,0,19,19,19,38,57,93,67,160,0.000333,0.311087,9,8399.36162,466.631201,933.262402,280.131868,7,0
0,0,23,23,21,44,65,105,79,184,0.000333,0.369372,10,11081.15678,615.619821,1108.115678,332.453657,9,0
0,0,22,22,21,44,65,104,77,181,0.000333,0.36335,10,10900.48574,605.582541,1090.048574,332.453657,9,0
0,0,4,4,11,10,21,16,13,29,0.000333,0.042459,5,636.886026,35.382557,127.377205,71.273029,2,0
0,0,5,5,12,12,24,20,15,35,0.000333,0.053491,6,962.842125,53.491229,160.473688,86.0391,3,0
0,0,5,5,11,12,23,19,15,34,0.000333,0.051267,5,769.005533,42.72253,153.801107,81.073298,3,0
0,0,7,7,11,16,27,27,20,47,0.000333,0.074493,5,1117.398563,62.077698,223.479713,102.053748,3,0
0,0,8,8,12,14,26,36,23,59,0.000333,0.092442,6,1663.95566,92.441981,277.325943,96.322519,4,0
0,0,7,7,12,14,26,28,18,46,0.000333,0.072073,6,1297.321362,72.073409,216.220227,96.322519,3,0
0,0,12,12,11,13,24,42,33,75,0.000333,0.114624,10,3438.721876,191.040104,343.872188,86.159464,2,0
0,0,15,15,15,16,31,55,41,96,0.000333,0.158534,14,6658.439841,369.913325,475.602846,122.603359,3,0
0,0,10,10,14,15,29,40,29,69,0.000333,0.111734,7,2346.404821,130.355823,335.200689,111.906328,2,0
0,0,13,13,11,14,25,45,34,79,0.000333,0.122288,10,3668.64639,203.813688,366.864639,91.356717,3,0
0,0,16,16,15,17,32,58,42,100,0.000333,0.166667,14,7000,388.888889,500,128.090227,4,0
0,0,10,10,14,15,29,40,29,69,0.000333,0.111734,7,2346.404821,130.355823,335.200689,111.906328,2,0
0,0,13,13,11,14,25,45,34,79,0.000333,0.122288,10,3668.64639,203.813688,366.864639,91.356717,3,0
0,0,16,16,15,17,32,58,42,100,0.000333,0.166667,14,7000,388.888889,500,128.090227,4,0
0,0,10,10,14,15,29,40,29,69,0.000333,0.111734,7,2346.404821,130.355823,335.200689,111.906328,2,0
0,0,6,6,11,19,30,24,27,51,0.000333,0.083417,5,1251.257102,69.514283,250.25142,118.764371,2,0
0,0,7,7,13,17,30,33,34,67,0.000333,0.109587,12,3945.140039,219.174447,328.76167,117.592585,3,0
0,0,5,5,9,18,27,25,23,48,0.000333,0.076078,4,912.9384,50.7188,228.2346,103.587975,3,0
0,0,7,7,9,14,23,23,21,44,0.000333,0.066346,4,796.146904,44.230384,199.036726,81.832294,3,0
0,0,9,9,9,14,23,29,23,52,0.000333,0.078408,4,940.900887,52.272271,235.225222,81.832294,4,0
0,0,10,10,10,19,29,46,31,77,0.000333,0.124688,5,1870.322683,103.906816,374.064537,113.929904,5,0
0,0,6,6,10,13,23,16,18,34,0.000333,0.051267,5,769.005533,42.72253,153.801107,81.324997,1,0
0,0,24,24,22,55,77,156,116,272,0.000333,0.568189,22,37500.45066,2083.35837,1704.565939,416.08228,12,0
0,0,13,13,15,30,45,84,56,140,0.000333,0.256286,7,5382.016034,299.000891,768.859433,205.810077,7,0
0,0,15,15,15,23,38,71,49,120,0.000333,0.209917,14,8816.518223,489.806568,629.751302,162.645284,5,0
0,0,9,9,11,14,25,28,25,53,0.000333,0.082041,5,1230.62189,68.367883,246.124378,91.356717,1,0
0,0,14,14,11,17,28,47,45,92,0.000333,0.147426,10,4422.766528,245.709252,442.276653,107.540616,2,0
0,0,17,17,15,20,35,60,53,113,0.000333,0.193203,14,8114.525733,450.806985,579.608981,145.041921,3,0
0,0,10,10,13,18,31,41,33,74,0.000333,0.122204,6,2199.663162,122.203509,366.610527,123.164366,2,0
0,0,44,44,25,81,106,271,185,456,0.000333,1.022644,24,73630.36146,4090.575636,3067.931727,629.624255,20,0
0,0,14,14,16,32,48,88,58,146,0.000333,0.271802,8,6523.236201,362.402011,815.404525,224,8,0
0,0,44,44,25,81,106,270,185,455,0.000333,1.020401,24,73468.89136,4081.605076,3061.203807,629.624255,20,0
0,0,14,14,15,32,47,87,58,145,0.000333,0.268472,7,5637.907684,313.217094,805.415383,218.603359,8,0
0,0,44,44,25,81,106,271,185,456,0.000333,1.022644,24,73630.36146,4090.575636,3067.931727,629.624255,20,0
0,0,14,14,16,32,48,88,58,146,0.000333,0.271802,8,6523.236201,362.402011,815.404525,224,8,0
0,0,44,44,25,81,106,270,185,455,0.000333,1.020401,24,73468.89136,4081.605076,3061.203807,629.624255,20,0
0,0,14,14,15,32,47,87,58,145,0.000333,0.268472,7,5637.907684,313.217094,805.415383,218.603359,8,0
0,0,9,9,10,14,24,27,29,56,0.000333,0.085586,10,2567.579,142.643278,256.7579,86.52225,1,0
0,0,17,17,14,21,35,78,56,134,0.000333,0.229108,14,9622.53494,534.585274,687.323924,145.541635,5,0
0,0,8,8,9,14,23,23,27,50,0.000333,0.075393,4,904.712391,50.2618,226.178098,81.832294,1,0
0,0,6,6,8,11,19,14,18,32,0.000333,0.045311,4,543.734722,30.207485,135.93368,62.053748,1,0
0,0,6,6,9,13,22,15,18,33,0.000333,0.049054,4,588.644974,32.702499,147.161243,76.635041,1,0
0,0,10,10,10,15,25,35,34,69,0.000333,0.106809,10,3204.260771,178.014487,320.426077,91.82264,2,0
0,0,8,8,8,14,22,23,24,47,0.000333,0.069864,4,838.373144,46.576286,209.593286,77.302969,1,0
0,0,10,10,11,17,28,36,35,71,0.000333,0.113774,10,3413.221995,189.623444,341.322199,107.540616,2,0
0,0,8,8,9,16,25,24,24,48,0.000333,0.074302,4,891.620388,49.534466,222.905097,92.529325,1,0
0,0,11,11,11,18,29,40,38,78,0.000333,0.126308,10,3789.225176,210.51251,378.922518,113.112398,2,0
0,0,8,8,12,15,27,26,25,51,0.000333,0.080833,6,1454.995576,80.833088,242.499263,101.622909,2,0
0,0,8,8,13,16,29,27,27,54,0.000333,0.087444,6,1573.985842,87.443658,262.330974,112.105716,2,0
0,0,15,15,14,20,34,72,46,118,0.000333,0.200107,14,8404.488614,466.916034,600.320615,139.741531,5,0
0,0,6,6,9,10,19,17,15,32,0.000333,0.045311,4,543.734722,30.207485,135.93368,61.748606,1,0
0,0,9,9,12,13,25,28,25,53,0.000333,0.082041,6,1476.746268,82.041459,246.124378,91.125266,2,0
0,0,9,9,13,15,28,29,25,54,0.000333,0.086532,6,1557.582995,86.532389,259.597166,106.709075,2,0
0,0,8,8,9,14,23,23,27,50,0.000333,0.075393,4,904.712391,50.2618,226.178098,81.832294,1,0
0,0,16,16,11,18,29,52,57,109,0.000333,0.176507,15,7942.798927,441.266607,529.519928,113.112398,2,0
0,0,19,19,15,21,36,65,65,130,0.000333,0.22403,21,14113.89525,784.105292,672.09025,150.842025,3,0
0,0,10,10,13,18,31,41,33,74,0.000333,0.122204,6,2199.663162,122.203509,366.610527,123.164366,2,0
0,0,12,12,14,18,32,55,43,98,0.000333,0.163333,14,6860,381.111111,490,128.361619,5,0
0,0,6,6,9,13,22,16,18,34,0.000333,0.05054,4,606.4827,33.693483,151.620675,76.635041,1,0
0,0,12,12,15,17,32,57,40,97,0.000333,0.161667,14,6790,377.222222,485,128.090227,5,0
0,0,6,6,10,11,21,18,16,34,0.000333,0.04978,5,746.693962,41.482998,149.338792,71.273029,1,0
0,0,6,6,8,11,19,15,16,31,0.000333,0.043895,4,526.743012,29.263501,131.685753,62.053748,1,0
0,0,6,6,9,10,19,16,15,31,0.000333,0.043895,4,526.743012,29.263501,131.685753,61.748606,1,0
0,0,10,10,11,17,28,37,32,69,0.000333,0.110569,5,1658.537448,92.140969,331.70749,107.540616,2,0
0,0,13,13,15,20,35,50,40,90,0.000333,0.153878,14,6462.896601,359.049811,461.635472,145.041921,3,0
0,0,16,16,13,19,32,60,52,112,0.000333,0.186667,12,6720,373.333333,560,128.816339,2,0
0,0,19,19,16,22,38,73,60,133,0.000333,0.232658,16,11167.58975,620.421653,697.974359,162.107496,3,0
0,0,10,10,13,18,31,42,33,75,0.000333,0.123855,6,2229.38834,123.854908,371.564723,123.164366,2,0
0,0,9,9,10,15,25,36,30,66,0.000333,0.102165,10,3064.945085,170.274727,306.494509,91.82264,2,0
0,0,12,12,14,18,32,49,38,87,0.000333,0.145,14,6090,338.333333,435,128.361619,3,0
0,0,10,10,13,18,31,41,33,74,0.000333,0.122204,6,2199.663162,122.203509,366.610527,123.164366,2,0
0,0,11,11,14,22,36,41,38,79,0.000333,0.136141,7,2858.968526,158.831585,408.424075,151.410465,2,0
0,0,10,10,15,18,33,35,31,66,0.000333,0.110977,7,2330.510083,129.472782,332.930012,133.662009,2,0
0,0,16,16,11,19,30,51,57,108,0.000333,0.176648,15,7949.162765,441.620154,529.944184,118.764371,2,0
0,0,19,19,15,22,37,64,65,129,0.000333,0.224006,14,9408.272778,522.681821,672.019484,156.710855,3,0
0,0,10,10,13,18,31,41,33,74,0.000333,0.122204,6,2199.663162,122.203509,366.610527,123.164366,2,0
0,0,6,6,9,18,27,23,25,48,0.000333,0.076078,4,912.9384,50.7188,228.2346,103.587975,1,0
0,0,6,6,9,18,27,23,25,48,0.000333,0.076078,4,912.9384,50.7188,228.2346,103.587975,1,0
0,0,6,6,9,18,27,23,25,48,0.000333,0.076078,4,912.9384,50.7188,228.2346,103.587975,1,0
0,0,6,6,10,16,26,24,23,47,0.000333,0.07364,5,1104.603334,61.366852,220.920667,97.219281,1,0
0,0,7,7,13,22,35,39,31,70,0.000333,0.119683,6,2154.298867,119.68327,359.049811,146.213212,2,0
0,0,6,6,10,16,26,24,23,47,0.000333,0.07364,5,1104.603334,61.366852,220.920667,97.219281,1,0
0,0,7,7,13,22,35,39,31,70,0.000333,0.119683,6,2154.298867,119.68327,359.049811,146.213212,2,0
0,0,6,6,9,18,27,23,25,48,0.000333,0.076078,4,912.9384,50.7188,228.2346,103.587975,1,0
0,0,6,6,10,16,26,24,23,47,0.000333,0.07364,5,1104.603334,61.366852,220.920667,97.219281,1,0
0,0,7,7,13,22,35,39,31,70,0.000333,0.119683,6,2154.298867,119.68327,359.049811,146.213212,2,0
0,0,10,10,18,30,48,62,48,110,0.000333,0.204782,9,5529.112876,307.172938,614.345875,222.265368,3,0
0,0,6,6,10,16,26,24,23,47,0.000333,0.07364,5,1104.603334,61.366852,220.920667,97.219281,1,0
0,0,7,7,13,22,35,39,31,70,0.000333,0.119683,6,2154.298867,119.68327,359.049811,146.213212,2,0
0,0,10,10,18,30,48,62,48,110,0.000333,0.204782,9,5529.112876,307.172938,614.345875,222.265368,3,0
0,0,6,6,9,18,27,23,25,48,0.000333,0.076078,4,912.9384,50.7188,228.2346,103.587975,1,0
0,0,15,15,10,18,28,51,66,117,0.000333,0.187487,15,8436.907888,468.717105,562.460526,108.277931,2,0
0,0,18,18,14,21,35,64,74,138,0.000333,0.235947,21,14864.66218,825.814566,707.841056,145.541635,3,0
0,0,10,10,13,18,31,41,33,74,0.000333,0.122204,6,2199.663162,122.203509,366.610527,123.164366,2,0
0,0,15,15,13,19,32,51,48,99,0.000333,0.165,12,5940,330,495,128.816339,2,0
0,0,18,18,16,22,38,64,56,120,0.000333,0.209917,16,10076.02083,559.778935,629.751302,162.107496,3,0
0,0,10,10,13,19,32,42,33,75,0.000333,0.125,6,2250,125,375,128.816339,2,0
0,0,9,9,10,15,25,27,22,49,0.000333,0.07585,5,1137.744766,63.208043,227.548953,91.82264,2,0
0,0,12,12,15,18,33,40,30,70,0.000333,0.117703,7,2471.753118,137.319618,353.107588,133.662009,3,0
0,0,8,8,13,15,28,30,22,52,0.000333,0.083327,6,1499.894736,83.327485,249.982456,106.709075,3,0
0,0,13,13,13,22,35,48,37,85,0.000333,0.14533,6,2615.934339,145.329685,435.989056,146.213212,5,0
0,0,12,12,13,21,34,47,35,82,0.000333,0.139057,6,2503.031718,139.057318,417.171953,140.344382,5,0
0,0,11,11,13,20,33,46,33,79,0.000333,0.132836,6,2391.042813,132.835712,398.507135,134.544278,5,0
0,0,9,9,11,13,24,28,19,47,0.000333,0.071831,5,1077.466188,59.859233,215.493238,86.159464,2,0
0,0,12,12,16,16,32,41,27,68,0.000333,0.113333,8,2720,151.111111,340,128,3,0
0,0,12,12,16,18,34,50,31,81,0.000333,0.137361,8,3296.675921,183.148662,412.08449,139.05865,4,0
0,0,11,11,12,18,30,40,29,69,0.000333,0.112858,6,2031.452707,112.858484,338.575451,118.0782,4,0
0,0,11,11,12,15,27,36,26,62,0.000333,0.098268,6,1768.818151,98.267675,294.803025,101.622909,4,0
0,0,17,17,17,34,51,108,73,181,0.000333,0.342236,16,16427.34379,912.630211,1026.708987,242.460605,8,0
0,0,16,16,17,33,50,104,70,174,0.000333,0.327344,16,15712.49563,872.916424,982.030977,235.951874,8,0
0,0,19,19,19,41,60,120,84,204,0.000333,0.401669,18,21690.10227,1205.005682,1205.005682,300.370255,8,0
0,0,17,17,12,20,32,54,58,112,0.000333,0.186667,12,6720,373.333333,560,129.458112,2,0
0,0,20,20,16,23,39,67,66,133,0.000333,0.234319,16,11247.33592,624.851996,702.958495,168.041925,3,0
0,0,10,10,13,19,32,41,35,76,0.000333,0.126667,6,2280,126.666667,380,128.816339,2,0
0,0,5,5,9,13,22,18,19,37,0.000333,0.055,4,659.99588,36.666438,164.99897,76.635041,4,0
0,0,6,6,9,14,23,19,21,40,0.000333,0.060314,4,723.769913,40.20944,180.942478,81.832294,4,0
0,0,5,5,10,15,25,19,19,38,0.000333,0.058822,5,882.332676,49.018482,176.466535,91.82264,3,0
0,0,6,6,10,16,26,20,21,41,0.000333,0.064239,5,963.590142,53.532786,192.718028,97.219281,3,0
0,0,9,9,14,19,33,44,38,82,0.000333,0.13788,14,5790.964449,321.720247,413.640318,134.013592,6,0
0,0,10,10,14,19,33,45,40,85,0.000333,0.142925,14,6002.829002,333.4905,428.7735,134.013592,6,0
0,0,10,10,18,22,40,51,43,94,0.000333,0.166754,9,4502.351168,250.13062,500.261241,173.166146,7,0
0,0,11,11,18,22,40,52,45,97,0.000333,0.172076,18,9292.086454,516.227025,516.227025,173.166146,7,0
0,0,23,23,24,43,67,109,80,189,0.000333,0.382164,12,13757.89028,764.327238,1146.490857,343.368484,10,0
0,0,22,22,24,43,67,108,78,186,0.000333,0.376098,12,13539.51107,752.19506,1128.292589,343.368484,10,0
0,0,33,33,20,52,72,149,113,262,0.000333,0.53884,20,32330.40701,1796.133723,1616.52035,382.861427,11,0
0,0,32,32,20,52,72,148,111,259,0.000333,0.53267,20,31960.21151,1775.567306,1598.010575,382.861427,11,0
0,0,23,23,17,45,62,104,81,185,0.000333,0.367175,8,8812.210539,489.567252,1101.526317,316.620258,9,0
0,0,22,22,17,45,62,103,79,182,0.000333,0.361221,8,8669.309828,481.628324,1083.663728,316.620258,9,0
0,0,26,26,18,45,63,113,91,204,0.000333,0.406455,18,21948.57188,1219.365104,1219.365104,322.192039,9,0
0,0,22,22,18,43,61,105,78,183,0.000333,0.361775,9,9767.924395,542.662466,1085.324933,308.388034,9,0
0,0,32,32,18,52,70,131,120,251,0.000333,0.512817,18,27692.10067,1538.450037,1538.450037,371.481515,9,0
0,0,31,31,18,52,70,130,118,248,0.000333,0.506687,18,27361.11939,1520.062188,1520.062188,371.481515,9,0
0,0,12,12,13,19,32,50,43,93,0.000333,0.155,12,5580,310,465,128.816339,3,0
0,0,9,9,10,15,25,29,30,59,0.000333,0.091329,10,2739.875152,152.215286,273.987515,91.82264,1,0
0,0,15,15,12,20,32,56,60,116,0.000333,0.193333,18,10440,580,580,129.458112,3,0
0,0,12,12,9,16,25,35,51,86,0.000333,0.133124,12,4792.459588,266.247755,399.371632,92.529325,1,0
0,0,13,13,12,19,31,50,50,100,0.000333,0.16514,12,5945.035572,330.279754,495.419631,123.730173,3,0
0,0,10,10,9,15,24,29,39,68,0.000333,0.103926,8,2494.2196,138.567756,311.77745,87.132684,1,0
0,0,15,15,12,20,32,48,44,92,0.000333,0.153333,12,5520,306.666667,460,129.458112,2,0
0,0,18,18,16,23,39,61,52,113,0.000333,0.199083,16,9556.007212,530.88929,597.250451,168.041925,3,0
0,0,5,5,13,12,25,33,20,53,0.000333,0.082041,6,1476.746268,82.041459,246.124378,91.125266,3,0
0,0,5,5,13,12,25,32,20,52,0.000333,0.080494,6,1448.883131,80.493507,241.480522,91.125266,3,0
0,0,5,5,13,11,24,33,20,53,0.000333,0.081001,6,1458.018075,81.001004,243.003013,86.159464,3,0
0,0,5,5,13,11,24,32,20,52,0.000333,0.079473,6,1430.5083,79.472683,238.41805,86.159464,3,0
0,0,7,7,16,16,32,36,25,61,0.000333,0.101667,8,2440,135.555556,305,128,6,0
0,0,8,8,16,17,33,37,27,64,0.000333,0.107614,8,2582.729789,143.484988,322.841224,133.486868,6,0
0,0,7,7,16,16,32,36,25,61,0.000333,0.101667,8,2440,135.555556,305,128,6,0
0,0,8,8,16,17,33,37,27,64,0.000333,0.107614,8,2582.729789,143.484988,322.841224,133.486868,6,0
0,0,7,7,16,16,32,36,26,62,0.000333,0.103333,8,2480,137.777778,310,128,6,0
0,0,8,8,16,17,33,37,28,65,0.000333,0.109295,8,2623.084942,145.726941,327.885618,133.486868,6,0
0,0,7,7,16,16,32,36,26,62,0.000333,0.103333,8,2480,137.777778,310,128,6,0
0,0,8,8,16,17,33,37,28,65,0.000333,0.109295,8,2623.084942,145.726941,327.885618,133.486868,6,0
0,0,14,14,11,18,29,46,45,91,0.000333,0.147359,10,4420.762706,245.597928,442.076271,113.112398,2,0
0,0,17,17,15,21,36,59,53,112,0.000333,0.193011,14,8106.442402,450.357911,579.0316,150.842025,3,0
0,0,10,10,13,18,31,41,33,74,0.000333,0.122204,6,2199.663162,122.203509,366.610527,123.164366,2,0
0,0,16,16,12,19,31,52,54,106,0.000333,0.175048,12,6301.737707,350.096539,525.144809,123.730173,3,0
0,0,19,19,16,22,38,65,62,127,0.000333,0.222162,16,10663.78871,592.432706,666.486794,162.107496,4,0
0,0,16,16,12,19,31,52,54,106,0.000333,0.175048,12,6301.737707,350.096539,525.144809,123.730173,3,0
0,0,19,19,16,22,38,65,62,127,0.000333,0.222162,16,10663.78871,592.432706,666.486794,162.107496,4,0
0,0,14,14,11,14,25,46,39,85,0.000333,0.131576,10,3947.277761,219.293209,394.727776,91.356717,2,0
0,0,17,17,15,17,32,59,47,106,0.000333,0.176667,14,7420,412.222222,530,128.090227,3,0
0,0,10,10,14,15,29,40,29,69,0.000333,0.111734,7,2346.404821,130.355823,335.200689,111.906328,2,0
0,0,11,11,15,18,33,34,35,69,0.000333,0.116021,7,2436.44236,135.357909,348.063194,133.662009,2,0
0,0,22,22,21,43,64,102,74,176,0.000333,0.352,10,10560,586.666667,1056,325.56805,10,0
0,0,21,21,21,43,64,101,72,173,0.000333,0.346,10,10380,576.666667,1038,325.56805,10,0
0,0,22,22,21,43,64,102,74,176,0.000333,0.352,10,10560,586.666667,1056,325.56805,10,0
0,0,21,21,21,43,64,101,72,173,0.000333,0.346,10,10380,576.666667,1038,325.56805,10,0
0,0,72,72,30,97,127,342,266,608,0.000333,1.416373,30,127473.6087,7081.867149,4249.12029,787.398264,25,0
0,0,70,70,30,89,119,325,252,577,0.000333,1.326103,30,119349.2955,6630.516416,3978.309849,723.546993,23,0
0,0,22,22,17,42,59,97,79,176,0.000333,0.345115,8,8282.761414,460.153412,1035.345177,295.9642,7,0
0,0,21,21,17,42,59,96,77,173,0.000333,0.339232,8,8141.57798,452.309888,1017.697248,295.9642,7,0
0,0,23,23,21,45,66,104,86,190,0.000333,0.382812,10,11484.34883,638.019379,1148.434883,339.372055,9,0
0,0,22,22,21,45,66,103,84,187,0.000333,0.376767,10,11303.017,627.945389,1130.3017,339.372055,9,0
0,0,23,23,21,45,66,104,86,190,0.000333,0.382812,10,11484.34883,638.019379,1148.434883,339.372055,9,0
0,0,22,22,21,45,66,103,84,187,0.000333,0.376767,10,11303.017,627.945389,1130.3017,339.372055,9,0
0,0,23,23,20,56,76,147,116,263,0.000333,0.547735,20,32864.09872,1825.783262,1643.204936,411.650438,12,0
0,0,21,21,19,48,67,130,102,232,0.000333,0.469111,18,25331.98846,1407.332692,1407.332692,348.788823,10,0
0,0,8,8,10,17,27,23,26,49,0.000333,0.077663,5,1164.947438,64.719302,232.989488,102.706149,1,0
0,0,26,26,20,54,74,134,99,233,0.000333,0.482268,10,14468.02634,803.779241,1446.802634,397.202487,9,0
0,0,49,49,25,92,117,288,214,502,0.000333,1.149641,24,82774.15414,4598.564119,3448.923089,716.264105,20,0
0,0,13,13,14,35,49,88,61,149,0.000333,0.278864,7,5856.142367,325.341243,836.591767,232.827875,7,0
0,0,11,11,13,25,38,45,48,93,0.000333,0.162686,6,2928.343553,162.685753,488.057259,164.202121,3,0
0,0,37,37,25,75,100,220,167,387,0.000333,0.857057,24,61708.13629,3428.229794,2571.172345,583.257807,14,0
0,0,22,22,21,55,76,149,112,261,0.000333,0.54357,20,32614.18162,1811.898979,1630.709081,410.21345,12,0
0,0,13,13,16,36,52,88,62,150,0.000333,0.285022,8,6840.527662,380.029315,855.065958,250.1173,7,0
0,0,18,18,17,28,45,90,69,159,0.000333,0.291068,16,13971.27428,776.181904,873.204642,204.092806,7,0
0,0,9,9,14,21,35,36,38,74,0.000333,0.126522,7,2656.968603,147.609367,379.566943,145.541635,3,0
0,0,45,45,25,84,109,274,197,471,0.000333,1.062605,24,76507.55561,4250.419756,3187.814817,653.051068,18,0
0,0,13,13,15,30,45,84,56,140,0.000333,0.256286,7,5382.016034,299.000891,768.859433,205.810077,7,0
0,0,27,27,23,45,68,164,117,281,0.000333,0.570192,22,37632.69529,2090.705294,1710.577058,351.175314,10,0
0,0,10,10,13,23,36,47,43,90,0.000333,0.155098,6,2791.759501,155.09775,465.29325,152.147641,3,0
0,0,28,28,23,47,70,175,122,297,0.000333,0.606799,22,40048.73523,2224.929735,1820.397056,365.107601,10,0
0,0,46,46,25,86,111,285,202,487,0.000333,1.10296,24,79413.13265,4411.840703,3308.880527,668.755174,18,0
0,0,13,13,14,34,48,86,61,147,0.000333,0.273663,7,5746.926413,319.27369,820.989488,226.276706,7,0
0,0,16,16,16,23,39,73,54,127,0.000333,0.223749,16,10739.93731,596.663184,671.246082,168.041925,6,0
0,0,10,10,16,17,33,36,30,66,0.000333,0.110977,8,2663.440095,147.968894,332.930012,133.486868,2,0
0,0,8,8,9,14,23,30,25,55,0.000333,0.082932,4,995.18363,55.287979,248.795908,81.832294,1,0
0,0,8,8,10,16,26,31,25,56,0.000333,0.087742,5,1316.123121,73.117951,263.224624,97.219281,1,0
0,0,8,8,10,16,26,31,25,56,0.000333,0.087742,5,1316.123121,73.117951,263.224624,97.219281,1,0
0,0,10,10,9,14,23,40,35,75,0.000333,0.113089,8,2714.137174,150.785399,339.267147,81.832294,1,0
0,0,10,10,10,16,26,41,36,77,0.000333,0.120645,10,3619.338583,201.074366,361.933858,97.219281,1,0
0,0,11,11,10,17,27,44,38,82,0.000333,0.129967,10,3899.007752,216.611542,389.900775,102.706149,1,0
0,0,13,13,16,20,36,54,39,93,0.000333,0.160268,8,3846.424201,213.690233,480.803025,150.438562,8,0
0,0,29,29,23,47,70,133,93,226,0.000333,0.461739,11,15237.39758,846.522088,1385.217962,365.107601,14,0
0,0,28,28,23,47,70,132,91,223,0.000333,0.45561,11,15035.13124,835.285069,1366.830113,365.107601,14,0
0,0,29,29,23,47,70,133,93,226,0.000333,0.461739,11,15237.39758,846.522088,1385.217962,365.107601,14,0
0,0,28,28,23,47,70,132,91,223,0.000333,0.45561,11,15035.13124,835.285069,1366.830113,365.107601,14,0
0,0,13,13,16,20,36,54,39,93,0.000333,0.160268,8,3846.424201,213.690233,480.803025,150.438562,8,0
0,0,26,26,21,46,67,116,88,204,0.000333,0.412494,10,12374.82195,687.490108,1237.482195,346.322516,11,0
0,0,25,25,21,46,67,115,86,201,0.000333,0.406428,10,12192.83927,677.37996,1219.283927,346.322516,11,0
0,0,17,17,16,18,34,56,66,122,0.000333,0.20689,24,14896.0912,827.560622,620.670467,139.05865,2,0
0,0,20,20,19,21,40,69,74,143,0.000333,0.253679,27,20547.96437,1141.553576,761.035718,172.949289,3,0
0,0,18,18,18,21,39,61,69,130,0.000333,0.229034,27,18551.76179,1030.653433,687.102288,167.297316,2,0
0,0,6,6,10,15,25,24,22,46,0.000333,0.071206,5,1068.086924,59.338162,213.617385,91.82264,1,0
0,0,6,6,10,16,26,24,23,47,0.000333,0.07364,5,1104.603334,61.366852,220.920667,97.219281,1,0
0,0,7,7,13,22,35,39,31,70,0.000333,0.119683,6,2154.298867,119.68327,359.049811,146.213212,2,0
0,0,10,10,18,30,48,62,48,110,0.000333,0.204782,9,5529.112876,307.172938,614.345875,222.265368,3,0
0,0,6,6,9,19,28,26,27,53,0.000333,0.08493,4,1019.159243,56.619958,254.789811,109.239948,1,0
0,0,6,6,9,20,29,26,28,54,0.000333,0.087444,4,1049.323895,58.295772,262.330974,114.967887,1,0
0,0,7,7,12,26,38,41,36,77,0.000333,0.134697,6,2424.542511,134.696806,404.090419,165.230983,2,0
0,0,10,10,17,34,51,64,53,117,0.000333,0.221225,8,5309.39012,294.966118,663.673765,242.460605,3,0
0,0,14,14,16,27,43,66,53,119,0.000333,0.215242,8,5165.804046,286.989114,645.725506,192.381963,6,0
0,0,7,7,11,16,27,24,26,50,0.000333,0.079248,5,1188.721876,66.040104,237.744375,102.053748,2,0
0,0,23,23,21,30,51,93,83,176,0.000333,0.332782,20,19966.9372,1109.274289,998.34686,239.445384,6,0
0,0,13,13,14,20,34,40,55,95,0.000333,0.161103,14,6766.325579,375.906977,483.30897,139.741531,1,0
0,0,9,9,13,19,32,35,34,69,0.000333,0.115,6,2070,115,345,128.816339,2,0
0,0,11,11,15,22,37,44,40,84,0.000333,0.145865,7,3063.158579,170.175477,437.594083,156.710855,3,0
0,0,8,8,13,15,28,30,27,57,0.000333,0.09134,6,1644.115383,91.339744,274.019231,106.709075,2,0
0,0,25,25,19,47,66,114,93,207,0.000333,0.417063,9,11260.70624,625.594791,1251.189583,341.776299,9,0
0,0,6,6,9,12,21,15,14,29,0.000333,0.042459,4,509.508821,28.306046,127.377205,71.548875,2,0
0,0,9,9,13,17,30,31,23,54,0.000333,0.088324,6,1589.832553,88.324031,264.972092,117.592585,3,0
0,0,6,6,9,9,18,16,11,27,0.000333,0.037529,4,450.3519,25.01955,112.587975,57.05865,2,0
0,0,6,6,12,11,23,25,14,39,0.000333,0.058806,6,1058.513498,58.806305,176.418916,81.073298,3,0
0,0,9,9,13,16,29,31,23,54,0.000333,0.087444,6,1573.985842,87.443658,262.330974,112.105716,3,0
0,0,6,6,9,9,18,16,11,27,0.000333,0.037529,4,450.3519,25.01955,112.587975,57.05865,2,0
0,0,6,6,12,11,23,25,14,39,0.000333,0.058806,6,1058.513498,58.806305,176.418916,81.073298,3,0
0,0,4,4,7,11,18,10,12,22,0.000333,0.030579,3,275.21505,15.289725,91.73835,57.705232,2,0
0,0,7,7,12,17,29,27,21,48,0.000333,0.077728,6,1399.098527,77.727696,233.183088,112.506418,3,0
0,0,4,4,9,8,17,12,9,21,0.000333,0.028612,4,343.346879,19.074827,85.83672,52.529325,2,0
0,0,4,4,12,11,23,21,12,33,0.000333,0.049759,6,895.665267,49.759182,149.277545,81.073298,3,0
0,0,7,7,12,17,29,26,21,47,0.000333,0.076108,6,1369.950641,76.108369,228.325107,112.506418,3,0
0,0,4,4,8,8,16,11,9,20,0.000333,0.026667,4,320,17.777778,80,48,2,0
0,0,4,4,11,11,22,20,12,32,0.000333,0.047567,5,713.509059,39.639392,142.701812,76.107496,3,0
0,0,4,4,7,10,17,10,11,21,0.000333,0.028612,3,257.510159,14.30612,85.83672,52.870765,2,0
0,0,7,7,12,16,28,26,20,46,0.000333,0.073713,6,1326.829958,73.712775,221.138326,107.01955,3,0
0,0,4,4,8,7,15,11,8,19,0.000333,0.024744,4,296.923685,16.49576,74.230921,43.651484,2,0
0,0,4,4,11,10,21,20,11,31,0.000333,0.045387,5,680.809201,37.822733,136.16184,71.273029,3,0
0,0,7,7,12,16,28,26,20,46,0.000333,0.073713,6,1326.829958,73.712775,221.138326,107.01955,3,0
0,0,4,4,8,7,15,11,8,19,0.000333,0.024744,4,296.923685,16.49576,74.230921,43.651484,2,0
0,0,4,4,11,10,21,20,11,31,0.000333,0.045387,5,680.809201,37.822733,136.16184,71.273029,3,0
0,0,6,6,8,14,22,20,19,39,0.000333,0.057973,4,695.671333,38.648407,173.917833,77.302969,1,0
0,0,9,9,14,17,31,33,27,60,0.000333,0.099084,7,2080.76245,115.597914,297.251779,122.789837,2,0
0,0,5,5,12,13,25,23,19,42,0.000333,0.065014,6,1170.25176,65.013987,195.04196,91.125266,2,0
0,0,10,10,12,21,33,41,34,75,0.000333,0.12611,6,2269.977354,126.109853,378.329559,135.258216,4,0
0,0,9,9,12,20,32,40,32,72,0.000333,0.12,6,2160,120,360,129.458112,4,0
0,0,8,8,12,19,31,39,30,69,0.000333,0.113947,6,2051.037273,113.946515,341.839545,123.730173,4,0
0,0,9,9,13,16,29,39,29,68,0.000333,0.110114,6,1982.056246,110.114236,330.342708,112.105716,3,0
0,0,6,6,10,11,21,18,16,34,0.000333,0.04978,5,746.693962,41.482998,149.338792,71.273029,1,0
0,0,16,16,14,20,34,68,61,129,0.000333,0.218761,21,13781.93684,765.663158,656.282707,139.741531,5,0
0,0,10,10,9,15,24,29,39,68,0.000333,0.103926,8,2494.2196,138.567756,311.77745,87.132684,1,0
0,0,9,9,13,12,25,34,28,62,0.000333,0.095973,12,3455.029005,191.946056,287.919084,91.125266,8,0
0,0,9,9,13,12,25,34,28,62,0.000333,0.095973,12,3455.029005,191.946056,287.919084,91.125266,8,0
0,0,10,10,10,14,24,31,33,64,0.000333,0.097813,10,2934.376,163.020889,293.4376,86.52225,11,0
0,0,11,11,11,16,27,38,38,76,0.000333,0.120457,10,3613.714502,200.761917,361.37145,102.053748,11,0
0,0,12,12,14,17,31,46,43,89,0.000333,0.146974,14,6172.928603,342.940478,440.923472,122.789837,12,0
0,0,7,7,14,13,27,36,22,58,0.000333,0.091928,7,1930.484326,107.249129,275.783475,101.408685,3,0
0,0,7,7,14,12,26,36,22,58,0.000333,0.090875,7,1908.378526,106.021029,272.625504,96.322519,3,0
0,0,6,6,9,10,19,17,15,32,0.000333,0.045311,4,543.734722,30.207485,135.93368,61.748606,1,0
0,0,6,6,9,10,19,17,15,32,0.000333,0.045311,4,543.734722,30.207485,135.93368,61.748606,1,0
0,0,6,6,9,10,19,17,15,32,0.000333,0.045311,4,543.734722,30.207485,135.93368,61.748606,1,0
0,0,10,10,12,28,40,65,45,110,0.000333,0.195137,6,3512.472543,195.137363,585.41209,177.625488,7,0
0,0,5,5,8,15,23,14,17,31,0.000333,0.046743,4,560.921683,31.162316,140.230421,82.603359,2,0
0,0,13,13,12,33,45,77,56,133,0.000333,0.243472,6,4382.498771,243.472154,730.416462,209.484556,7,0
0,0,13,13,15,30,45,90,57,147,0.000333,0.269101,7,5651.116836,313.950935,807.302405,205.810077,8,0
0,0,15,15,15,33,48,99,65,164,0.000333,0.305311,7,6411.536951,356.196497,915.93385,225.068365,8,0
0,0,13,13,14,30,44,89,57,146,0.000333,0.265692,7,5579.539114,309.974395,797.077016,200.509687,8,0
0,0,15,15,14,33,47,98,65,163,0.000333,0.301799,7,6337.78588,352.099216,905.397983,219.767975,8,0
0,0,33,33,20,55,75,142,114,256,0.000333,0.531526,20,31891.5517,1771.752872,1594.577585,404.413346,11,0
0,0,32,32,20,55,75,141,112,253,0.000333,0.525297,20,31517.82257,1750.990143,1575.891129,404.413346,11,0
0,0,17,17,12,20,32,54,58,112,0.000333,0.186667,12,6720,373.333333,560,129.458112,2,0
0,0,20,20,16,23,39,67,66,133,0.000333,0.234319,16,11247.33592,624.851996,702.958495,168.041925,3,0
0,0,10,10,13,19,32,41,35,76,0.000333,0.126667,6,2280,126.666667,380,128.816339,2,0
0,0,23,23,18,41,59,100,81,181,0.000333,0.354919,9,9582.825527,532.379196,1064.758392,294.718282,7,0
0,0,19,19,18,39,57,92,68,160,0.000333,0.311087,9,8399.36162,466.631201,933.262402,281.189337,7,0
0,0,20,20,17,41,58,92,69,161,0.000333,0.314378,8,7545.079522,419.171085,943.13494,289.1465,7,0
0,0,19,19,17,41,58,91,67,158,0.000333,0.30852,8,7404.487978,411.360443,925.560997,289.1465,7,0
0,0,32,32,20,51,71,149,110,259,0.000333,0.530928,20,31855.69008,1769.76056,1592.784504,375.732254,9,0
0,0,31,31,20,51,71,148,108,256,0.000333,0.524778,20,31486.70525,1749.261403,1574.335263,375.732254,9,0
0,0,32,32,20,50,70,146,110,256,0.000333,0.523032,20,31381.92905,1743.440503,1569.096452,368.631371,9,0
0,0,31,31,20,50,70,145,108,253,0.000333,0.516903,20,31014.17207,1723.009559,1550.708603,368.631371,9,0
0,0,23,23,17,43,60,102,79,181,0.000333,0.356382,8,8553.177582,475.176532,1069.147198,302.816253,7,0
0,0,7,7,8,14,22,18,21,39,0.000333,0.057973,4,695.671333,38.648407,173.917833,77.302969,1,0
0,0,18,18,15,23,38,68,58,126,0.000333,0.220413,14,9257.344134,514.296896,661.238867,162.645284,3,0
0,0,14,14,13,15,28,51,40,91,0.000333,0.145823,12,5249.631575,291.646199,437.469298,106.709075,3,0
0,0,17,17,17,18,35,64,48,112,0.000333,0.191493,16,9191.675166,510.64862,574.479698,144.545518,4,0
0,0,13,13,12,15,27,46,35,81,0.000333,0.128382,12,4621.750652,256.763925,385.145888,101.622909,3,0
0,0,16,16,15,18,33,59,43,102,0.000333,0.171509,14,7203.394802,400.1886,514.5282,133.662009,4,0
0,0,13,13,11,15,26,45,35,80,0.000333,0.125345,10,3760.351775,208.908432,376.035177,96.657107,3,0
0,0,16,16,15,18,33,58,43,101,0.000333,0.169828,14,7132.773285,396.265182,509.483806,133.662009,4,0
0,0,13,13,12,15,27,46,35,81,0.000333,0.128382,12,4621.750652,256.763925,385.145888,101.622909,3,0
0,0,16,16,15,18,33,59,43,102,0.000333,0.171509,14,7203.394802,400.1886,514.5282,133.662009,4,0
0,0,13,13,11,15,26,45,35,80,0.000333,0.125345,10,3760.351775,208.908432,376.035177,96.657107,3,0
0,0,16,16,15,18,33,58,43,101,0.000333,0.169828,14,7132.773285,396.265182,509.483806,133.662009,4,0
0,0,9,9,13,13,26,34,24,58,0.000333,0.090875,6,1635.753022,90.875168,272.625504,96.211433,4,0
0,0,9,9,13,13,26,34,24,58,0.000333,0.090875,6,1635.753022,90.875168,272.625504,96.211433,4,0
0,0,7,7,9,15,24,23,21,44,0.000333,0.067246,4,806.9534,44.830744,201.73835,87.132684,2,0
0,0,10,10,14,18,32,36,29,65,0.000333,0.108333,7,2275,126.388889,325,128.361619,3,0
0,0,6,6,12,14,26,26,21,47,0.000333,0.07364,6,1325.524001,73.640222,220.920667,96.322519,3,0
0,0,11,11,12,22,34,44,36,80,0.000333,0.135666,6,2441.982164,135.665676,406.997027,141.127046,5,0
0,0,10,10,12,21,33,43,34,77,0.000333,0.129473,6,2330.510083,129.472782,388.418347,135.258216,5,0
0,0,9,9,12,20,32,42,32,74,0.000333,0.123333,6,2220,123.333333,370,129.458112,5,0
0,0,13,13,12,15,27,44,34,78,0.000333,0.123627,12,4450.574702,247.25415,370.881225,101.622909,3,0
0,0,16,16,16,18,34,57,42,99,0.000333,0.167886,16,8058.541141,447.69673,503.658821,139.05865,4,0
0,0,10,10,14,15,29,40,29,69,0.000333,0.111734,7,2346.404821,130.355823,335.200689,111.906328,2,0
0,0,13,13,12,15,27,44,34,78,0.000333,0.123627,12,4450.574702,247.25415,370.881225,101.622909,3,0
0,0,16,16,16,18,34,57,42,99,0.000333,0.167886,16,8058.541141,447.69673,503.658821,139.05865,4,0
0,0,10,10,14,15,29,40,29,69,0.000333,0.111734,7,2346.404821,130.355823,335.200689,111.906328,2,0
0,0,16,16,12,16,28,53,48,101,0.000333,0.161848,18,8739.771248,485.542847,485.542847,107.01955,3,0
0,0,19,19,16,19,35,66,56,122,0.000333,0.208591,16,10012.36045,556.242247,625.772528,144.710623,4,0
0,0,10,10,14,15,29,40,29,69,0.000333,0.111734,7,2346.404821,130.355823,335.200689,111.906328,2,0
0,0,16,16,12,16,28,53,48,101,0.000333,0.161848,18,8739.771248,485.542847,485.542847,107.01955,3,0
0,0,19,19,16,19,35,66,56,122,0.000333,0.208591,16,10012.36045,556.242247,625.772528,144.710623,4,0
0,0,10,10,14,15,29,40,29,69,0.000333,0.111734,7,2346.404821,130.355823,335.200689,111.906328,2,0
0,0,13,13,16,20,36,54,39,93,0.000333,0.160268,8,3846.424201,213.690233,480.803025,150.438562,8,0
0,0,26,26,23,43,66,120,83,203,0.000333,0.409004,11,13497.13207,749.84067,1227.012006,337.371309,12,0
0,0,25,25,23,43,66,119,81,200,0.000333,0.40296,11,13297.66706,738.759281,1208.878824,337.371309,12,0
0,0,26,26,23,43,66,120,83,203,0.000333,0.409004,11,13497.13207,749.84067,1227.012006,337.371309,12,0
0,0,25,25,23,43,66,119,81,200,0.000333,0.40296,11,13297.66706,738.759281,1208.878824,337.371309,12,0
0,0,13,13,16,20,36,54,39,93,0.000333,0.160268,8,3846.424201,213.690233,480.803025,150.438562,8,0
0,0,37,37,22,59,81,193,139,332,0.000333,0.70161,22,46306.26442,2572.570246,2104.830201,445.183436,16,0
0,0,16,16,16,33,49,92,60,152,0.000333,0.284479,8,6827.48717,379.304843,853.435896,230.465006,8,0
0,0,37,37,22,58,80,193,139,332,0.000333,0.699627,22,46175.36281,2565.297934,2098.880128,437.870393,16,0
0,0,35,35,22,50,72,176,125,301,0.000333,0.619049,22,40857.24336,2269.846853,1857.147425,380.300305,14,0
0,0,34,34,22,58,80,185,135,320,0.000333,0.674339,22,44506.37379,2472.576322,2023.01699,437.870393,15,0
0,0,16,16,16,33,49,92,60,152,0.000333,0.284479,8,6827.48717,379.304843,853.435896,230.465006,8,0
0,0,34,34,22,58,80,185,135,320,0.000333,0.674339,22,44506.37379,2472.576322,2023.01699,437.870393,15,0
0,0,16,16,16,33,49,92,60,152,0.000333,0.284479,8,6827.48717,379.304843,853.435896,230.465006,8,0
0,0,33,33,22,59,81,183,133,316,0.000333,0.667798,22,44074.63722,2448.590957,2003.392601,445.183436,16,0
0,0,14,14,15,32,47,87,57,144,0.000333,0.26662,7,5599.025562,311.056976,799.860795,218.603359,8,0
0,0,33,33,22,58,80,183,133,316,0.000333,0.66591,22,43950.04412,2441.669118,1997.729278,437.870393,16,0
0,0,14,14,15,32,47,87,57,144,0.000333,0.26662,7,5599.025562,311.056976,799.860795,218.603359,8,0
0,0,32,32,22,58,80,180,132,312,0.000333,0.657481,22,43393.71444,2410.761914,1972.441566,437.870393,15,0
0,0,14,14,15,32,47,87,57,144,0.000333,0.26662,7,5599.025562,311.056976,799.860795,218.603359,8,0
0,0,32,32,22,58,80,180,132,312,0.000333,0.657481,22,43393.71444,2410.761914,1972.441566,437.870393,15,0
0,0,14,14,15,32,47,87,57,144,0.000333,0.26662,7,5599.025562,311.056976,799.860795,218.603359,8,0
0,0,33,33,22,59,81,183,133,316,0.000333,0.667798,22,44074.63722,2448.590957,2003.392601,445.183436,16,0
0,0,31,31,22,51,73,166,119,285,0.000333,0.588033,22,38810.19998,2156.122221,1764.099999,387.401188,14,0
0,0,33,33,22,58,80,183,133,316,0.000333,0.66591,22,43950.04412,2441.669118,1997.729278,437.870393,16,0
0,0,14,14,15,32,47,87,57,144,0.000333,0.26662,7,5599.025562,311.056976,799.860795,218.603359,8,0
0,0,32,32,22,58,80,180,132,312,0.000333,0.657481,22,43393.71444,2410.761914,1972.441566,437.870393,15,0
0,0,14,14,15,32,47,87,57,144,0.000333,0.26662,7,5599.025562,311.056976,799.860795,218.603359,8,0
0,0,32,32,22,58,80,180,132,312,0.000333,0.657481,22,43393.71444,2410.761914,1972.441566,437.870393,15,0
0,0,30,30,22,50,72,163,118,281,0.000333,0.577916,22,38142.47636,2119.026464,1733.748925,380.300305,13,0
0,0,13,13,11,14,25,45,34,79,0.000333,0.122288,10,3668.64639,203.813688,366.864639,91.356717,3,0
0,0,16,16,15,17,32,58,42,100,0.000333,0.166667,14,7000,388.888889,500,128.090227,4,0
0,0,13,13,11,13,24,45,34,79,0.000333,0.120737,10,3622.120376,201.22891,362.212038,86.159464,3,0
0,0,16,16,15,16,31,58,42,100,0.000333,0.16514,14,6935.874835,385.32638,495.419631,122.603359,4,0
0,0,18,18,11,20,31,56,69,125,0.000333,0.206425,15,9289.118082,516.062116,619.274539,124.49231,2,0
0,0,21,21,15,23,38,69,77,146,0.000333,0.255399,21,16090.14576,893.896986,766.197417,162.645284,3,0
0,0,10,10,13,18,31,41,33,74,0.000333,0.122204,6,2199.663162,122.203509,366.610527,123.164366,2,0
0,0,16,16,11,19,30,51,57,108,0.000333,0.176648,15,7949.162765,441.620154,529.944184,118.764371,2,0
0,0,19,19,15,22,37,64,65,129,0.000333,0.224006,14,9408.272778,522.681821,672.019484,156.710855,3,0
0,0,10,10,13,18,31,41,33,74,0.000333,0.122204,6,2199.663162,122.203509,366.610527,123.164366,2,0
0,0,9,9,10,15,25,36,30,66,0.000333,0.102165,10,3064.945085,170.274727,306.494509,91.82264,2,0
0,0,12,12,14,18,32,49,38,87,0.000333,0.145,14,6090,338.333333,435,128.361619,3,0
0,0,10,10,13,18,31,41,33,74,0.000333,0.122204,6,2199.663162,122.203509,366.610527,123.164366,2,0
0,0,24,24,21,45,66,112,82,194,0.000333,0.390871,10,11726.12459,651.451366,1172.612459,339.372055,11,0
0,0,23,23,21,45,66,111,80,191,0.000333,0.384826,10,11544.79277,641.377376,1154.479277,339.372055,11,0
0,0,47,47,25,92,117,275,202,477,0.000333,1.092388,24,78651.93531,4369.551962,3277.163971,716.264105,20,0
0,0,45,45,25,84,109,258,188,446,0.000333,1.006203,24,72446.64501,4024.813612,3018.610209,653.051068,18,0
0,0,23,23,23,52,75,154,116,270,0.000333,0.560594,22,36999.18302,2055.510168,1681.781046,400.46479,12,0
0,0,13,13,16,32,48,85,63,148,0.000333,0.275525,8,6612.595601,367.366422,826.57445,224,7,0
0,0,23,23,22,54,76,157,115,272,0.000333,0.566479,22,37387.59824,2077.088791,1699.436284,408.871421,12,0
0,0,20,20,20,46,66,132,98,230,0.000333,0.463404,20,27804.21295,1544.678497,1390.210647,340.522412,10,0
0,0,6,6,11,10,21,18,15,33,0.000333,0.048315,5,724.732375,40.26291,144.946475,71.273029,1,0
0,0,15,15,16,20,36,73,46,119,0.000333,0.205074,16,9843.537203,546.863178,615.221075,150.438562,5,0
0,0,43,43,25,84,109,260,182,442,0.000333,0.997179,24,71796.89932,3988.716629,2991.537472,653.051068,20,0
0,0,14,14,15,32,47,87,57,144,0.000333,0.26662,7,5599.025562,311.056976,799.860795,218.603359,8,0
0,0,43,43,25,83,108,260,182,442,0.000333,0.99522,24,71655.84662,3980.880368,2985.660276,645.224678,20,0
0,0,14,14,15,32,47,87,57,144,0.000333,0.26662,7,5599.025562,311.056976,799.860795,218.603359,8,0
0,0,7,7,9,15,24,23,20,43,0.000333,0.065718,4,788.61355,43.811864,197.153388,87.132684,2,0
0,0,10,10,14,18,32,36,28,64,0.000333,0.106667,7,2240,124.444444,320,128.361619,3,0
0,0,6,6,12,14,26,26,20,46,0.000333,0.072073,6,1297.321362,72.073409,216.220227,96.322519,3,0
0,0,11,11,12,22,34,44,35,79,0.000333,0.13397,6,2411.457387,133.969855,401.909564,141.127046,5,0
0,0,10,10,12,21,33,43,33,76,0.000333,0.127791,6,2300.243718,127.791318,383.373953,135.258216,5,0
0,0,9,9,12,20,32,42,31,73,0.000333,0.121667,6,2190,121.666667,365,129.458112,5,0
0,0,7,7,7,12,19,16,20,36,0.000333,0.050975,3,458.776171,25.487565,152.92539,62.671034,1,0
0,0,7,7,8,15,23,17,21,38,0.000333,0.057298,4,687.581417,38.198968,171.895354,82.603359,1,0
0,0,17,17,11,21,32,59,55,114,0.000333,0.19,10,5700,316.666667,570,130.292414,2,0
0,0,20,20,15,24,39,72,63,135,0.000333,0.237843,14,9989.410194,554.967233,713.5293,168.642459,3,0
0,0,10,10,13,19,32,43,33,76,0.000333,0.126667,6,2280,126.666667,380,128.816339,2,0
0,0,16,16,15,23,38,54,50,104,0.000333,0.181928,14,7640.98246,424.499026,545.784461,162.645284,3,0
0,0,16,16,13,20,33,59,52,111,0.000333,0.186643,12,6719.132967,373.285165,559.927747,134.544278,2,0
0,0,19,19,16,23,39,72,60,132,0.000333,0.232558,16,11162.76949,620.15386,697.673093,168.041925,3,0
0,0,10,10,13,18,31,42,33,75,0.000333,0.123855,6,2229.38834,123.854908,371.564723,123.164366,2,0
0,0,11,11,10,14,24,37,37,74,0.000333,0.113096,10,3392.872251,188.492903,339.287225,86.52225,12,0
0,0,11,11,11,16,27,38,38,76,0.000333,0.120457,10,3613.714502,200.761917,361.37145,102.053748,11,0
0,0,13,13,14,17,31,52,47,99,0.000333,0.163488,14,6866.516086,381.473116,490.465435,122.789837,13,0
0,0,11,11,13,12,25,48,37,85,0.000333,0.131576,18,7105.09997,394.727776,394.727776,91.125266,10,0
0,0,9,9,13,12,25,34,28,62,0.000333,0.095973,12,3455.029005,191.946056,287.919084,91.125266,8,0
0,0,27,27,17,48,65,123,96,219,0.000333,0.439633,16,21102.37682,1172.354268,1318.898551,337.565068,9,0
0,0,26,26,17,48,65,122,94,216,0.000333,0.43361,8,10406.65158,578.14731,1300.831448,337.565068,9,0
0,0,28,28,21,51,72,130,101,231,0.000333,0.475084,10,14252.52675,791.807042,1425.252675,381.532358,11,0
0,0,27,27,21,51,72,129,99,228,0.000333,0.468914,10,14067.429,781.523834,1406.7429,381.532358,11,0
0,0,12,12,13,24,37,50,40,90,0.000333,0.156284,6,2813.104817,156.283601,468.850803,158.144816,9,0
0,0,9,9,12,23,35,43,34,77,0.000333,0.131652,6,2369.728754,131.651597,394.954792,147.061475,8,0
0,0,10,10,13,14,27,44,28,72,0.000333,0.114117,12,4108.222802,228.2346,342.3519,101.408685,4,0
0,0,12,12,14,21,35,51,37,88,0.000333,0.150459,7,3159.638338,175.535463,451.376905,145.541635,7,0
0,0,11,11,15,21,36,56,38,94,0.000333,0.161991,7,3401.810651,188.989481,485.97295,150.842025,6,0
0,0,10,10,13,14,27,44,28,72,0.000333,0.114117,12,4108.222802,228.2346,342.3519,101.408685,4,0
0,0,12,12,14,21,35,51,37,88,0.000333,0.150459,7,3159.638338,175.535463,451.376905,145.541635,7,0
0,0,11,11,15,21,36,56,38,94,0.000333,0.161991,7,3401.810651,188.989481,485.97295,150.842025,6,0
0,0,10,10,10,19,29,35,37,72,0.000333,0.116592,5,1748.873158,97.15962,349.774632,113.929904,2,0
0,0,11,11,10,19,29,36,39,75,0.000333,0.12145,10,3643.485746,202.415875,364.348575,113.929904,2,0
0,0,10,10,14,21,35,45,35,80,0.000333,0.136781,7,2872.398489,159.577694,410.342641,145.541635,5,0
0,0,10,10,14,21,35,45,35,80,0.000333,0.136781,7,2872.398489,159.577694,410.342641,145.541635,5,0
0,0,23,23,18,50,68,128,85,213,0.000333,0.43221,9,11669.66627,648.314793,1296.629585,357.25146,11,0
0,0,22,22,18,49,67,127,83,210,0.000333,0.424626,9,11464.90857,636.939365,1273.87873,350.179432,11,0
0,0,20,20,18,42,60,111,71,182,0.000333,0.358351,9,9675.486796,537.527044,1075.054088,301.535982,10,0
0,0,23,23,19,47,66,129,82,211,0.000333,0.425122,9,11478.30443,637.68358,1275.367159,341.776299,10,0
0,0,22,22,20,43,63,122,75,197,0.000333,0.392508,10,11775.24145,654.180081,1177.524145,319.767946,9,0
0,0,23,23,20,50,70,134,85,219,0.000333,0.447438,10,13423.12981,745.729434,1342.312981,368.631371,10,0
0,0,20,20,19,39,58,112,68,180,0.000333,0.351479,9,9489.929212,527.21829,1054.436579,286.841309,9,0
0,0,23,23,19,47,66,129,82,211,0.000333,0.425122,9,11478.30443,637.68358,1275.367159,341.776299,10,0
0,0,22,22,20,43,63,122,75,197,0.000333,0.392508,10,11775.24145,654.180081,1177.524145,319.767946,9,0
0,0,23,23,20,50,70,134,85,219,0.000333,0.447438,10,13423.12981,745.729434,1342.312981,368.631371,10,0
0,0,20,20,19,39,58,112,68,180,0.000333,0.351479,9,9489.929212,527.21829,1054.436579,286.841309,9,0
0,0,16,16,12,18,30,53,54,107,0.000333,0.175012,18,9450.671287,525.037294,525.037294,118.0782,3,0
0,0,19,19,16,21,37,66,62,128,0.000333,0.22227,16,10668.96049,592.720027,666.810031,156.238666,4,0
0,0,16,16,12,18,30,53,54,107,0.000333,0.175012,18,9450.671287,525.037294,525.037294,118.0782,3,0
0,0,19,19,16,21,37,66,62,128,0.000333,0.22227,16,10668.96049,592.720027,666.810031,156.238666,4,0
0,0,27,27,18,46,64,116,94,210,0.000333,0.42,18,22680,1260,1260,329.1425,10,0
0,0,23,23,18,44,62,108,81,189,0.000333,0.375114,9,10128.08792,562.671551,1125.343103,315.273641,10,0
0,0,26,26,18,47,65,115,94,209,0.000333,0.419558,18,22656.14771,1258.674873,1258.674873,336.124326,9,0
0,0,22,22,18,44,62,107,79,186,0.000333,0.36916,9,9967.324624,553.740257,1107.480514,315.273641,9,0
0,0,26,26,19,49,68,116,95,211,0.000333,0.428152,9,11560.09194,642.22733,1284.45466,355.831405,9,0
0,0,22,22,18,45,63,107,80,187,0.000333,0.372584,9,10059.76211,558.875673,1117.751346,322.192039,9,0
0,0,30,30,19,52,71,136,108,244,0.000333,0.500179,18,27009.68935,1500.538297,1500.538297,377.133488,9,0
0,0,29,29,19,52,71,135,106,241,0.000333,0.49403,18,26677.603,1482.089056,1482.089056,377.133488,9,0
0,0,26,26,17,49,66,117,92,209,0.000333,0.421093,8,10106.22697,561.457054,1263.278371,344.607651,9,0
0,0,7,7,8,14,22,18,24,42,0.000333,0.062432,4,749.184512,41.621362,187.296128,77.302969,1,0
0,0,31,31,21,56,77,143,112,255,0.000333,0.532677,20,31960.61136,1775.58952,1598.030568,417.450542,10,0
0,0,30,30,21,56,77,142,110,252,0.000333,0.52641,10,15792.30208,877.350116,1579.230208,417.450542,10,0
0,0,26,26,18,51,69,118,92,210,0.000333,0.427597,9,11545.11122,641.395068,1282.790136,364.352342,9,0
0,0,13,13,11,20,31,43,48,91,0.000333,0.150277,10,4508.318642,250.462147,450.831864,124.49231,1,0
0,0,33,33,21,58,79,149,119,268,0.000333,0.563138,20,33788.26481,1877.125823,1689.413241,432.001564,10,0
0,0,10,10,15,23,38,45,39,84,0.000333,0.146942,7,3085.781378,171.432299,440.825911,162.645284,3,0
0,0,7,7,11,16,27,24,26,50,0.000333,0.079248,5,1188.721876,66.040104,237.744375,102.053748,1,0
0,0,24,24,20,33,53,90,79,169,0.000333,0.322673,20,19360.37114,1075.576174,968.018557,252.903568,5,0
0,0,13,13,14,20,34,40,55,95,0.000333,0.161103,14,6766.325579,375.906977,483.30897,139.741531,1,0
0,0,9,9,10,15,25,36,30,66,0.000333,0.102165,10,3064.945085,170.274727,306.494509,91.82264,2,0
0,0,12,12,14,18,32,49,38,87,0.000333,0.145,14,6090,338.333333,435,128.361619,3,0
0,0,10,10,13,18,31,41,33,74,0.000333,0.122204,6,2199.663162,122.203509,366.610527,123.164366,2,0
0,0,25,25,19,30,49,93,82,175,0.000333,0.327525,18,17686.33601,982.574223,982.574223,227.917341,6,0
0,0,14,14,17,20,37,43,58,101,0.000333,0.175385,16,8418.476639,467.693147,526.15479,155.92543,2,0
0,0,12,12,15,23,38,50,43,93,0.000333,0.162686,7,3416.400811,189.800045,488.057259,162.645284,4,0
0,0,9,9,14,18,32,29,30,59,0.000333,0.098333,7,2065,114.722222,295,128.361619,2,0
0,0,64,64,30,94,124,316,249,565,0.000333,1.309707,30,117873.6275,6548.534859,3929.120915,763.33807,22,0
0,0,55,55,26,78,104,255,199,454,0.000333,1.014,26,79091.99043,4393.999468,3041.999632,612.472806,17,0
0,0,8,8,11,13,24,25,20,45,0.000333,0.068774,5,1031.616563,57.312031,206.323313,86.159464,2,0
0,0,8,8,11,13,24,25,20,45,0.000333,0.068774,5,1031.616563,57.312031,206.323313,86.159464,2,0
0,0,4,4,7,13,20,11,15,26,0.000333,0.037457,3,337.110391,18.728355,112.37013,67.757201,1,0
0,0,4,4,8,10,18,12,12,24,0.000333,0.033359,4,400.3128,22.2396,100.0782,57.219281,1,0
0,0,12,12,14,28,42,86,55,141,0.000333,0.253439,7,5322.217296,295.678739,760.316757,187.908907,7,0
0,0,14,14,14,31,45,95,63,158,0.000333,0.289238,14,12147.97905,674.887725,867.712789,206.883055,7,0
0,0,5,5,8,14,22,14,17,31,0.000333,0.046081,4,552.969521,30.720529,138.24238,77.302969,2,0
0,0,5,5,10,11,21,16,14,30,0.000333,0.043923,5,658.847613,36.602645,131.769523,71.273029,2,0
0,0,13,13,15,29,44,90,57,147,0.000333,0.267512,7,5617.755136,312.097508,802.536448,199.484808,8,0
0,0,15,15,15,32,47,99,65,164,0.000333,0.303651,14,12753.336,708.518667,910.952572,218.603359,8,0
0,0,5,5,9,11,20,15,14,29,0.000333,0.041779,4,501.343659,27.852426,125.335915,66.583073,2,0
0,0,13,13,14,29,43,89,57,146,0.000333,0.264078,7,5545.642579,308.091254,792.234654,194.184418,8,0
0,0,15,15,14,32,46,98,65,163,0.000333,0.300114,14,12604.76838,700.26491,900.340599,213.302969,8,0
0,0,5,5,8,14,22,14,16,30,0.000333,0.044594,4,535.131794,29.729544,133.782949,77.302969,2,0
0,0,5,5,9,11,20,15,13,28,0.000333,0.040338,4,484.055947,26.891997,121.013987,66.583073,2,0
0,0,13,13,14,29,43,89,56,145,0.000333,0.262269,7,5507.658726,305.98104,786.808389,194.184418,8,0
0,0,15,15,14,32,46,98,64,162,0.000333,0.298272,14,12527.43852,695.968806,894.817037,213.302969,8,0
0,0,5,5,9,11,20,15,13,28,0.000333,0.040338,4,484.055947,26.891997,121.013987,66.583073,2,0
0,0,13,13,14,29,43,89,56,145,0.000333,0.262269,7,5507.658726,305.98104,786.808389,194.184418,8,0
0,0,15,15,14,32,46,98,64,162,0.000333,0.298272,14,12527.43852,695.968806,894.817037,213.302969,8,0
0,0,4,4,7,13,20,11,15,26,0.000333,0.037457,3,337.110391,18.728355,112.37013,67.757201,1,0
0,0,12,12,14,28,42,86,55,141,0.000333,0.253439,7,5322.217296,295.678739,760.316757,187.908907,7,0
0,0,14,14,14,31,45,95,63,158,0.000333,0.289238,14,12147.97905,674.887725,867.712789,206.883055,7,0
0,0,5,5,8,15,23,14,17,31,0.000333,0.046743,4,560.921683,31.162316,140.230421,82.603359,2,0
0,0,5,5,10,12,22,16,14,30,0.000333,0.044594,5,668.914743,37.16193,133.782949,76.238831,2,0
0,0,13,13,15,30,45,90,57,147,0.000333,0.269101,7,5651.116836,313.950935,807.302405,205.810077,8,0
0,0,15,15,15,33,48,99,65,164,0.000333,0.305311,7,6411.536951,356.196497,915.93385,225.068365,8,0
0,0,5,5,9,12,21,15,14,29,0.000333,0.042459,4,509.508821,28.306046,127.377205,71.548875,2,0
0,0,13,13,14,30,44,89,57,146,0.000333,0.265692,7,5579.539114,309.974395,797.077016,200.509687,8,0
0,0,15,15,14,33,47,98,65,163,0.000333,0.301799,7,6337.78588,352.099216,905.397983,219.767975,8,0
0,0,9,9,12,19,31,41,38,79,0.000333,0.130461,12,4696.578102,260.921006,391.381509,123.730173,3,0
0,0,10,10,12,19,31,42,40,82,0.000333,0.135415,12,4874.929169,270.829398,406.244097,123.730173,3,0
0,0,9,9,10,18,28,30,29,59,0.000333,0.094545,5,1418.169702,78.787206,283.63394,108.277931,2,0
0,0,7,7,8,14,22,17,20,37,0.000333,0.055,4,659.99588,36.666438,164.99897,77.302969,1,0
0,0,10,10,16,22,38,48,43,91,0.000333,0.159187,8,3820.49123,212.249513,477.561404,162.107496,5,0
0,0,11,11,16,22,38,49,45,94,0.000333,0.164435,16,7892.88298,438.493499,493.305186,162.107496,5,0
0,0,9,9,11,20,31,31,29,60,0.000333,0.099084,5,1486.258893,82.569939,297.251779,124.49231,2,0
0,0,10,10,11,17,28,35,37,72,0.000333,0.115377,10,3461.295544,192.294197,346.129554,107.540616,2,0
0,0,13,13,17,24,41,55,50,105,0.000333,0.187514,16,9000.687368,500.038187,562.54296,179.525968,5,0
0,0,25,25,19,48,67,112,87,199,0.000333,0.402384,9,10864.36574,603.575874,1207.151749,348.788823,11,0
0,0,24,24,19,48,67,111,85,196,0.000333,0.396318,9,10700.58133,594.476741,1188.953481,348.788823,11,0
0,0,10,10,10,17,27,36,34,70,0.000333,0.110947,10,3328.421252,184.912292,332.842125,102.706149,2,0
0,0,13,13,14,20,34,49,42,91,0.000333,0.15432,14,6481.42766,360.079314,462.959119,139.741531,3,0
0,0,10,10,13,17,30,39,31,70,0.000333,0.114494,6,2060.89405,114.494114,343.482342,117.592585,2,0
0,0,34,34,21,57,78,149,114,263,0.000333,0.55102,20,33061.21567,1836.734204,1653.060784,424.713397,13,0
0,0,33,33,21,57,78,148,112,260,0.000333,0.544735,10,16342.04577,907.891432,1634.204577,424.713397,13,0
0,0,15,15,13,19,32,51,48,99,0.000333,0.165,12,5940,330,495,128.816339,2,0
0,0,18,18,16,22,38,64,56,120,0.000333,0.209917,16,10076.02083,559.778935,629.751302,162.107496,3,0
0,0,10,10,13,19,32,42,33,75,0.000333,0.125,6,2250,125,375,128.816339,2,0
0,0,35,35,21,58,79,157,118,275,0.000333,0.577847,20,34670.79412,1926.155229,1733.539706,432.001564,13,0
0,0,34,34,21,58,79,156,116,272,0.000333,0.571543,20,34292.56727,1905.142626,1714.628364,432.001564,13,0
0,0,16,16,13,20,33,59,52,111,0.000333,0.186643,12,6719.132967,373.285165,559.927747,134.544278,2,0
0,0,19,19,16,23,39,72,60,132,0.000333,0.232558,16,11162.76949,620.15386,697.673093,168.041925,3,0
0,0,10,10,13,18,31,42,33,75,0.000333,0.123855,6,2229.38834,123.854908,371.564723,123.164366,2,0
0,0,25,25,19,48,67,113,85,198,0.000333,0.400362,9,10809.77094,600.54283,1201.08566,348.788823,11,0
0,0,24,24,19,48,67,112,83,195,0.000333,0.394296,9,10645.98653,591.443696,1182.887392,348.788823,11,0
0,0,9,9,10,15,25,36,30,66,0.000333,0.102165,10,3064.945085,170.274727,306.494509,91.82264,2,0
0,0,12,12,14,18,32,49,38,87,0.000333,0.145,14,6090,338.333333,435,128.361619,3,0
0,0,10,10,13,18,31,41,33,74,0.000333,0.122204,6,2199.663162,122.203509,366.610527,123.164366,2,0
0,0,6,6,9,10,19,17,15,32,0.000333,0.045311,4,543.734722,30.207485,135.93368,61.748606,1,0
0,0,6,6,9,10,19,17,15,32,0.000333,0.045311,4,543.734722,30.207485,135.93368,61.748606,1,0
0,0,23,23,17,45,62,105,79,184,0.000333,0.365191,8,8764.576969,486.920943,1095.572121,316.620258,9,0
0,0,22,22,17,45,62,104,77,181,0.000333,0.359237,8,8621.676257,478.982014,1077.709532,316.620258,9,0
0,0,15,15,14,20,34,72,46,118,0.000333,0.200107,14,8404.488614,466.916034,600.320615,139.741531,5,0
0,0,6,6,9,10,19,17,15,32,0.000333,0.045311,4,543.734722,30.207485,135.93368,61.748606,1,0
0,0,17,17,14,21,35,78,56,134,0.000333,0.229108,14,9622.53494,534.585274,687.323924,145.541635,5,0
0,0,8,8,9,14,23,23,27,50,0.000333,0.075393,4,904.712391,50.2618,226.178098,81.832294,1,0
0,0,54,54,24,62,86,210,156,366,0.000333,0.784004,24,56448.30961,3136.0172,2352.0129,479.199271,21,0
0,0,13,13,14,20,34,40,55,95,0.000333,0.161103,14,6766.325579,375.906977,483.30897,139.741531,8,0
0,0,14,14,16,27,43,66,53,119,0.000333,0.215242,8,5165.804046,286.989114,645.725506,192.381963,6,0
0,0,7,7,11,16,27,24,26,50,0.000333,0.079248,5,1188.721876,66.040104,237.744375,102.053748,2,0
0,0,27,27,25,47,72,126,90,216,0.000333,0.444235,12,15992.4456,888.4692,1332.7038,377.162081,13,0
0,0,26,26,25,47,72,125,88,213,0.000333,0.438065,12,15770.3283,876.12935,1314.194025,377.162081,13,0
0,0,27,27,25,47,72,126,90,216,0.000333,0.444235,12,15992.4456,888.4692,1332.7038,377.162081,13,0
0,0,26,26,25,47,72,125,88,213,0.000333,0.438065,12,15770.3283,876.12935,1314.194025,377.162081,13,0
0,0,10,10,11,17,28,37,32,69,0.000333,0.110569,5,1658.537448,92.140969,331.70749,107.540616,2,0
0,0,13,13,15,20,35,50,40,90,0.000333,0.153878,14,6462.896601,359.049811,461.635472,145.041921,3,0
0,0,15,15,12,17,29,50,47,97,0.000333,0.157075,12,5654.689878,314.149438,471.224157,112.506418,2,0
0,0,18,18,16,20,36,63,55,118,0.000333,0.20335,16,9760.818403,542.267689,610.05115,150.438562,3,0
0,0,15,15,10,18,28,51,66,117,0.000333,0.187487,15,8436.907888,468.717105,562.460526,108.277931,2,0
0,0,18,18,14,21,35,64,74,138,0.000333,0.235947,21,14864.66218,825.814566,707.841056,145.541635,3,0
0,0,10,10,13,18,31,41,33,74,0.000333,0.122204,6,2199.663162,122.203509,366.610527,123.164366,2,0
0,0,25,25,19,47,66,114,93,207,0.000333,0.417063,9,11260.70624,625.594791,1251.189583,341.776299,9,0
0,0,25,25,20,48,68,115,99,214,0.000333,0.434239,20,26054.34096,1447.463387,1302.717048,354.516762,9,0
0,0,46,46,25,87,112,273,192,465,0.000333,1.05514,24,75970.08093,4220.560052,3165.420039,676.632489,22,0
0,0,14,14,15,32,47,87,57,144,0.000333,0.26662,7,5599.025562,311.056976,799.860795,218.603359,8,0
0,0,46,46,25,86,111,273,192,465,0.000333,1.053134,24,75825.68107,4212.537837,3159.403378,668.755174,22,0
0,0,14,14,15,32,47,87,57,144,0.000333,0.26662,7,5599.025562,311.056976,799.860795,218.603359,8,0
0,0,33,33,22,51,73,176,131,307,0.000333,0.633425,22,41806.07507,2322.559726,1900.27614,387.401188,12,0
0,0,13,13,15,31,46,88,58,146,0.000333,0.268813,7,5645.080319,313.615573,806.440046,212.183445,7,0
0,0,34,34,22,58,80,188,141,329,0.000333,0.693305,22,45758.11555,2542.117531,2079.914343,437.870393,14,0
0,0,13,13,15,31,46,84,56,140,0.000333,0.257766,7,5413.090717,300.727262,773.298674,212.183445,7,0
0,0,30,30,22,51,73,165,119,284,0.000333,0.58597,22,38674.02384,2148.55688,1757.910175,387.401188,12,0
0,0,13,13,15,31,46,84,56,140,0.000333,0.257766,7,5413.090717,300.727262,773.298674,212.183445,7,0
0,0,22,22,21,51,72,148,108,256,0.000333,0.5265,20,31590.01601,1755.000889,1579.5008,381.532358,12,0
0,0,13,13,15,32,47,87,58,145,0.000333,0.268472,7,5637.907684,313.217094,805.415383,218.603359,7,0
0,0,6,6,9,12,21,19,18,37,0.000333,0.054172,4,650.062979,36.11461,162.515745,71.548875,2,0
0,0,13,13,16,21,37,51,40,91,0.000333,0.15802,8,3792.48205,210.693447,474.060256,156.238666,3,0
0,0,6,6,10,10,20,20,16,36,0.000333,0.051863,5,777.947057,43.219281,155.589411,66.438562,2,0
0,0,13,13,17,19,36,52,38,90,0.000333,0.155098,16,7444.692002,413.594,465.29325,150.197491,3,0
0,0,13,13,12,16,28,45,35,80,0.000333,0.128196,12,4615.060725,256.392263,384.588394,107.01955,3,0
0,0,16,16,15,19,34,58,43,101,0.000333,0.171278,14,7193.672458,399.64847,513.833747,139.313982,4,0
0,0,13,13,11,16,27,44,35,79,0.000333,0.125212,10,3756.361127,208.686729,375.636113,102.053748,3,0
0,0,16,16,15,19,34,57,43,100,0.000333,0.169582,14,7122.447978,395.691554,508.746284,139.313982,4,0
0,0,13,13,12,15,27,44,34,78,0.000333,0.123627,12,4450.574702,247.25415,370.881225,101.622909,3,0
0,0,16,16,16,18,34,57,42,99,0.000333,0.167886,16,8058.541141,447.69673,503.658821,139.05865,4,0
0,0,13,13,12,15,27,44,34,78,0.000333,0.123627,12,4450.574702,247.25415,370.881225,101.622909,3,0
0,0,16,16,16,18,34,57,42,99,0.000333,0.167886,16,8058.541141,447.69673,503.658821,139.05865,4,0
0,0,24,24,20,31,51,91,78,169,0.000333,0.319547,20,19172.79766,1065.155425,958.639883,240.018648,12,0
0,0,13,13,14,18,32,41,54,95,0.000333,0.158333,21,9975,554.166667,475,128.361619,8,0
0,0,43,43,25,84,109,261,184,445,0.000333,1.003947,24,72284.20859,4015.789366,3011.842025,653.051068,20,0
0,0,14,14,16,33,49,88,58,146,0.000333,0.273249,8,6557.981098,364.332283,819.747637,230.465006,8,0
0,0,43,43,25,84,109,260,184,444,0.000333,1.001691,24,72121.77217,4006.76512,3005.07384,653.051068,20,0
0,0,14,14,15,33,48,87,58,145,0.000333,0.26994,7,5668.736938,314.92983,809.819563,225.068365,8,0
0,0,43,43,26,84,110,260,182,442,0.000333,0.99912,26,77931.38583,4329.521435,2997.360993,659.166096,20,0
0,0,14,14,16,32,48,87,57,144,0.000333,0.268078,8,6433.876801,357.4376,804.2346,224,8,0
0,0,43,43,26,84,110,260,182,442,0.000333,0.99912,26,77931.38583,4329.521435,2997.360993,659.166096,20,0
0,0,14,14,16,32,48,87,57,144,0.000333,0.268078,8,6433.876801,357.4376,804.2346,224,8,0
0,0,20,20,21,40,61,119,93,212,0.000333,0.419105,20,25146.32631,1397.018128,1257.316316,305.11579,7,0
0,0,33,33,23,59,82,187,140,327,0.000333,0.692973,22,45736.22912,2540.901618,2078.919506,451.117865,13,0
0,0,13,13,15,30,45,84,56,140,0.000333,0.256286,7,5382.016034,299.000891,768.859433,205.810077,7,0
0,0,20,20,21,40,61,119,93,212,0.000333,0.419105,20,25146.32631,1397.018128,1257.316316,305.11579,7,0
0,0,32,32,23,52,75,175,130,305,0.000333,0.633263,22,41795.37341,2321.96519,1899.789701,400.46479,11,0
0,0,13,13,14,33,47,87,61,148,0.000333,0.274026,7,5754.55405,319.697447,822.07915,219.767975,7,0
0,0,13,13,11,14,25,45,34,79,0.000333,0.122288,10,3668.64639,203.813688,366.864639,91.356717,3,0
0,0,16,16,15,17,32,58,42,100,0.000333,0.166667,14,7000,388.888889,500,128.090227,4,0
0,0,13,13,11,14,25,45,34,79,0.000333,0.122288,10,3668.64639,203.813688,366.864639,91.356717,3,0
0,0,16,16,15,17,32,58,42,100,0.000333,0.166667,14,7000,388.888889,500,128.090227,4,0
0,0,13,13,12,14,26,46,35,81,0.000333,0.126912,12,4568.827406,253.823745,380.735617,96.322519,3,0
0,0,16,16,15,17,32,59,43,102,0.000333,0.17,14,7140,396.666667,510,128.090227,4,0
0,0,13,13,11,14,25,45,35,80,0.000333,0.123836,10,3715.084952,206.393608,371.508495,91.356717,3,0
0,0,16,16,15,17,32,58,43,101,0.000333,0.168333,14,7070,392.777778,505,128.090227,4,0
0,0,13,13,11,14,25,45,34,79,0.000333,0.122288,10,3668.64639,203.813688,366.864639,91.356717,3,0
0,0,16,16,15,17,32,58,42,100,0.000333,0.166667,14,7000,388.888889,500,128.090227,4,0
0,0,13,13,11,13,24,45,34,79,0.000333,0.120737,10,3622.120376,201.22891,362.212038,86.159464,3,0
0,0,16,16,15,16,31,58,42,100,0.000333,0.16514,14,6935.874835,385.32638,495.419631,122.603359,4,0
0,0,15,15,12,15,27,50,37,87,0.000333,0.137892,12,4964.102552,275.783475,413.675213,101.622909,3,0
0,0,18,18,16,18,34,63,45,108,0.000333,0.183149,16,8791.13579,488.396433,549.445987,139.05865,4,0
0,0,10,10,14,15,29,40,29,69,0.000333,0.111734,7,2346.404821,130.355823,335.200689,111.906328,2,0
0,0,15,15,12,14,26,50,37,87,0.000333,0.136313,12,4907.259066,272.625504,408.938255,96.322519,3,0
0,0,18,18,16,17,33,63,45,108,0.000333,0.181598,16,8716.713038,484.261835,544.794565,133.486868,4,0
0,0,10,10,14,15,29,40,29,69,0.000333,0.111734,7,2346.404821,130.355823,335.200689,111.906328,2,0
0,0,25,25,19,48,67,112,87,199,0.000333,0.402384,9,10864.36574,603.575874,1207.151749,348.788823,11,0
0,0,24,24,19,48,67,111,85,196,0.000333,0.396318,9,10700.58133,594.476741,1188.953481,348.788823,11,0
0,0,10,10,11,17,28,37,32,69,0.000333,0.110569,5,1658.537448,92.140969,331.70749,107.540616,2,0
0,0,13,13,15,20,35,50,40,90,0.000333,0.153878,14,6462.896601,359.049811,461.635472,145.041921,3,0
0,0,10,10,14,15,29,40,29,69,0.000333,0.111734,7,2346.404821,130.355823,335.200689,111.906328,2,0
0,0,14,14,11,18,29,46,45,91,0.000333,0.147359,10,4420.762706,245.597928,442.076271,113.112398,2,0
0,0,17,17,15,21,36,59,53,112,0.000333,0.193011,14,8106.442402,450.357911,579.0316,150.842025,3,0
0,0,10,10,13,18,31,41,33,74,0.000333,0.122204,6,2199.663162,122.203509,366.610527,123.164366,2,0
0,0,22,22,20,43,63,104,83,187,0.000333,0.372584,10,11177.51346,620.97297,1117.751346,319.767946,11,0
0,0,21,21,20,43,63,103,81,184,0.000333,0.366607,10,10998.19506,611.010837,1099.819506,319.767946,11,0
0,0,23,23,24,46,70,111,90,201,0.000333,0.410662,12,14783.83064,821.323924,1231.985886,364.12295,12,0
0,0,22,22,24,46,70,110,88,198,0.000333,0.404533,12,14563.17645,809.065358,1213.598037,364.12295,12,0
0,0,23,23,24,46,70,111,90,201,0.000333,0.410662,12,14783.83064,821.323924,1231.985886,364.12295,12,0
0,0,22,22,24,46,70,110,88,198,0.000333,0.404533,12,14563.17645,809.065358,1213.598037,364.12295,12,0
0,0,4,4,7,11,18,10,12,22,0.000333,0.030579,3,275.21505,15.289725,91.73835,57.705232,2,0
0,0,7,7,12,17,29,27,21,48,0.000333,0.077728,6,1399.098527,77.727696,233.183088,112.506418,3,0
0,0,4,4,9,8,17,12,9,21,0.000333,0.028612,4,343.346879,19.074827,85.83672,52.529325,2,0
0,0,4,4,12,11,23,21,12,33,0.000333,0.049759,6,895.665267,49.759182,149.277545,81.073298,3,0
0,0,7,7,12,17,29,26,21,47,0.000333,0.076108,6,1369.950641,76.108369,228.325107,112.506418,3,0
0,0,4,4,8,8,16,11,9,20,0.000333,0.026667,4,320,17.777778,80,48,2,0
0,0,4,4,11,11,22,20,12,32,0.000333,0.047567,5,713.509059,39.639392,142.701812,76.107496,3,0
0,0,6,6,8,12,20,14,14,28,0.000333,0.040338,4,484.055947,26.891997,121.013987,67.01955,2,0
0,0,9,9,13,17,30,30,23,53,0.000333,0.086688,6,1560.391209,86.688401,260.065202,117.592585,3,0
0,0,6,6,9,9,18,15,11,26,0.000333,0.036139,4,433.6722,24.0929,108.41805,57.05865,2,0
0,0,6,6,12,11,23,24,14,38,0.000333,0.057298,6,1031.372126,57.298451,171.895354,81.073298,3,0
0,0,9,9,13,16,29,30,23,53,0.000333,0.085824,6,1544.837956,85.824331,257.472993,112.105716,3,0
0,0,6,6,9,9,18,15,11,26,0.000333,0.036139,4,433.6722,24.0929,108.41805,57.05865,2,0
0,0,6,6,12,11,23,24,14,38,0.000333,0.057298,6,1031.372126,57.298451,171.895354,81.073298,3,0
0,0,5,5,14,11,25,25,17,42,0.000333,0.065014,7,1365.29372,75.849651,195.04196,91.356717,3,0
0,0,24,24,24,46,70,119,86,205,0.000333,0.418834,12,15078.03622,837.668679,1256.503018,364.12295,12,0
0,0,23,23,24,46,70,118,84,202,0.000333,0.412705,12,14857.38203,825.410113,1238.115169,364.12295,12,0
0,0,25,25,24,48,72,122,88,210,0.000333,0.431895,12,15548.211,863.7895,1295.68425,378.1173,13,0
0,0,24,24,24,48,72,121,86,207,0.000333,0.425725,12,15326.0937,851.44965,1277.174475,378.1173,13,0
0,0,25,25,24,48,72,122,88,210,0.000333,0.431895,12,15548.211,863.7895,1295.68425,378.1173,13,0
0,0,24,24,24,48,72,121,86,207,0.000333,0.425725,12,15326.0937,851.44965,1277.174475,378.1173,13,0
0,0,28,28,21,52,73,131,95,226,0.000333,0.4663,10,13989.0035,777.166861,1398.90035,388.661531,10,0
0,0,27,27,21,52,73,130,93,223,0.000333,0.46011,10,13803.30877,766.850487,1380.330877,388.661531,10,0
0,0,19,19,18,30,48,92,64,156,0.000333,0.290418,18,15682.5747,871.25415,871.25415,222.265368,6,0
0,0,10,10,16,22,38,38,35,73,0.000333,0.1277,8,3064.789668,170.266093,383.098708,162.107496,2,0
0,0,6,6,9,10,19,17,15,32,0.000333,0.045311,4,543.734722,30.207485,135.93368,61.748606,1,0
0,0,6,6,9,10,19,17,15,32,0.000333,0.045311,4,543.734722,30.207485,135.93368,61.748606,1,0
0,0,29,29,20,50,70,128,98,226,0.000333,0.461739,10,13852.17962,769.565534,1385.217962,368.631371,9,0
0,0,28,28,20,50,70,127,96,223,0.000333,0.45561,10,13668.30113,759.350063,1366.830113,368.631371,9,0
0,0,15,15,13,18,31,52,48,100,0.000333,0.16514,12,5945.035572,330.279754,495.419631,123.164366,2,0
0,0,18,18,16,21,37,65,56,121,0.000333,0.210115,16,10085.50172,560.305651,630.343857,156.238666,3,0
0,0,10,10,13,19,32,42,33,75,0.000333,0.125,6,2250,125,375,128.816339,2,0
0,0,20,20,17,41,58,92,69,161,0.000333,0.314378,8,7545.079522,419.171085,943.13494,289.1465,7,0
0,0,19,19,17,41,58,91,67,158,0.000333,0.30852,8,7404.487978,411.360443,925.560997,289.1465,7,0
0,0,9,9,10,15,25,36,30,66,0.000333,0.102165,10,3064.945085,170.274727,306.494509,91.82264,2,0
0,0,12,12,14,18,32,49,38,87,0.000333,0.145,14,6090,338.333333,435,128.361619,3,0
0,0,10,10,13,18,31,41,33,74,0.000333,0.122204,6,2199.663162,122.203509,366.610527,123.164366,2,0
0,0,11,11,13,23,36,47,39,86,0.000333,0.148205,6,2667.681301,148.204517,444.61355,152.147641,8,0
0,0,8,8,12,22,34,40,33,73,0.000333,0.123795,6,2228.308724,123.794929,371.384787,141.127046,7,0
0,0,9,9,13,13,26,41,27,68,0.000333,0.106543,12,3835.55881,213.086601,319.629901,96.211433,3,0
0,0,11,11,14,20,34,48,36,84,0.000333,0.142449,7,2991.428151,166.190453,427.346879,139.741531,6,0
0,0,10,10,15,20,35,53,37,90,0.000333,0.153878,7,3231.448301,179.524906,461.635472,145.041921,5,0
0,0,12,12,14,23,37,50,40,90,0.000333,0.156284,7,3281.95562,182.330868,468.850803,157.344894,9,0
0,0,9,9,13,22,35,43,34,77,0.000333,0.131652,6,2369.728754,131.651597,394.954792,146.213212,8,0
0,0,10,10,14,13,27,44,28,72,0.000333,0.114117,14,4792.926602,266.2737,342.3519,101.408685,4,0
0,0,12,12,15,20,35,51,37,88,0.000333,0.150459,7,3159.638338,175.535463,451.376905,145.041921,7,0
0,0,11,11,16,20,36,56,38,94,0.000333,0.161991,8,3887.783601,215.987978,485.97295,150.438562,6,0
0,0,47,47,25,63,88,198,148,346,0.000333,0.744988,24,53639.12016,2979.95112,2234.96334,492.66504,12,0
0,0,14,14,17,26,43,50,68,118,0.000333,0.213433,16,10244.78786,569.154881,640.299241,191.698301,2,0
0,0,13,13,12,15,27,46,35,81,0.000333,0.128382,12,4621.750652,256.763925,385.145888,101.622909,3,0
0,0,16,16,15,18,33,59,43,102,0.000333,0.171509,14,7203.394802,400.1886,514.5282,133.662009,4,0
0,0,10,10,14,15,29,40,29,69,0.000333,0.111734,7,2346.404821,130.355823,335.200689,111.906328,2,0
0,0,13,13,11,15,26,45,35,80,0.000333,0.125345,10,3760.351775,208.908432,376.035177,96.657107,3,0
0,0,16,16,15,18,33,58,43,101,0.000333,0.169828,14,7132.773285,396.265182,509.483806,133.662009,4,0
0,0,10,10,14,15,29,40,29,69,0.000333,0.111734,7,2346.404821,130.355823,335.200689,111.906328,2,0
0,0,13,13,11,14,25,45,34,79,0.000333,0.122288,10,3668.64639,203.813688,366.864639,91.356717,3,0
0,0,16,16,15,17,32,58,42,100,0.000333,0.166667,14,7000,388.888889,500,128.090227,4,0
0,0,10,10,14,15,29,40,29,69,0.000333,0.111734,7,2346.404821,130.355823,335.200689,111.906328,2,0
0,0,13,13,11,14,25,45,34,79,0.000333,0.122288,10,3668.64639,203.813688,366.864639,91.356717,3,0
0,0,16,16,15,17,32,58,42,100,0.000333,0.166667,14,7000,388.888889,500,128.090227,4,0
0,0,10,10,14,15,29,40,29,69,0.000333,0.111734,7,2346.404821,130.355823,335.200689,111.906328,2,0
0,0,15,15,15,19,34,52,52,104,0.000333,0.176365,14,7407.345897,411.519216,529.096135,139.313982,2,0
0,0,18,18,18,22,40,65,60,125,0.000333,0.221747,18,11974.33821,665.241012,665.241012,173.166146,3,0
0,0,16,16,17,22,39,57,55,112,0.000333,0.197322,16,9471.440776,526.191154,591.965049,167.594364,2,0
0,0,13,13,15,23,38,52,41,93,0.000333,0.162686,7,3416.400811,189.800045,488.057259,162.645284,4,0
0,0,14,14,15,23,38,53,43,96,0.000333,0.167934,7,3526.607289,195.922627,503.801041,162.645284,4,0
0,0,5,5,8,14,22,14,16,30,0.000333,0.044594,4,535.131794,29.729544,133.782949,77.302969,2,0
0,0,13,13,14,29,43,89,56,145,0.000333,0.262269,7,5507.658726,305.98104,786.808389,194.184418,8,0
0,0,15,15,14,32,46,98,64,162,0.000333,0.298272,14,12527.43852,695.968806,894.817037,213.302969,8,0
0,0,15,15,14,32,46,98,64,162,0.000333,0.298272,14,12527.43852,695.968806,894.817037,213.302969,8,0
0,0,5,5,12,11,23,19,14,33,0.000333,0.049759,6,895.665267,49.759182,149.277545,81.073298,3,0
0,0,5,5,11,11,22,18,14,32,0.000333,0.047567,5,713.509059,39.639392,142.701812,76.107496,3,0
0,0,7,7,12,12,24,22,16,38,0.000333,0.058076,6,1045.37145,58.076192,174.228575,86.0391,3,0
0,0,7,7,12,12,24,22,16,38,0.000333,0.058076,6,1045.37145,58.076192,174.228575,86.0391,3,0
0,0,5,5,11,10,21,18,13,31,0.000333,0.045387,5,680.809201,37.822733,136.16184,71.273029,3,0
0,0,5,5,11,10,21,18,13,31,0.000333,0.045387,5,680.809201,37.822733,136.16184,71.273029,3,0
0,0,5,5,11,10,21,18,13,31,0.000333,0.045387,5,680.809201,37.822733,136.16184,71.273029,3,0
0,0,5,5,11,10,21,18,13,31,0.000333,0.045387,5,680.809201,37.822733,136.16184,71.273029,3,0
0,0,7,7,12,12,24,23,16,39,0.000333,0.059605,6,1072.881225,59.604513,178.813538,86.0391,3,0
0,0,7,7,12,12,24,23,16,39,0.000333,0.059605,6,1072.881225,59.604513,178.813538,86.0391,3,0
0,0,35,35,20,54,74,146,125,271,0.000333,0.560921,20,33655.23724,1869.735402,1682.761862,397.202487,11,0
0,0,34,34,20,54,74,145,123,268,0.000333,0.554711,20,33282.67004,1849.037224,1664.133502,397.202487,11,0
0,0,18,18,11,19,30,57,69,126,0.000333,0.206089,15,9274.023226,515.223513,618.268215,118.764371,2,0
0,0,21,21,15,22,37,70,77,147,0.000333,0.255263,21,16081.58254,893.421252,765.789645,156.710855,3,0
0,0,10,10,13,18,31,41,33,74,0.000333,0.122204,6,2199.663162,122.203509,366.610527,123.164366,2,0
0,0,37,37,20,55,75,151,135,286,0.000333,0.593814,20,35628.84291,1979.380162,1781.442145,404.413346,11,0
0,0,36,36,20,55,75,150,133,283,0.000333,0.587585,20,35255.11379,1958.617433,1762.755689,404.413346,11,0
0,0,15,15,10,18,28,51,66,117,0.000333,0.187487,15,8436.907888,468.717105,562.460526,108.277931,2,0
0,0,18,18,14,21,35,64,74,138,0.000333,0.235947,21,14864.66218,825.814566,707.841056,145.541635,3,0
0,0,10,10,13,18,31,41,33,74,0.000333,0.122204,6,2199.663162,122.203509,366.610527,123.164366,2,0
0,0,23,23,17,45,62,105,79,184,0.000333,0.365191,8,8764.576969,486.920943,1095.572121,316.620258,9,0
0,0,22,22,17,45,62,104,77,181,0.000333,0.359237,8,8621.676257,478.982014,1077.709532,316.620258,9,0
0,0,9,9,10,15,25,36,30,66,0.000333,0.102165,10,3064.945085,170.274727,306.494509,91.82264,2,0
0,0,12,12,14,18,32,49,38,87,0.000333,0.145,14,6090,338.333333,435,128.361619,3,0
0,0,10,10,13,18,31,41,33,74,0.000333,0.122204,6,2199.663162,122.203509,366.610527,123.164366,2,0
0,0,17,17,14,23,37,87,56,143,0.000333,0.248317,14,10429.32564,579.40698,744.951831,157.344894,8,0
0,0,13,13,11,18,29,49,35,84,0.000333,0.136023,5,2040.352018,113.35289,408.070404,113.112398,2,0
0,0,16,16,15,21,36,62,43,105,0.000333,0.180947,14,7599.789752,422.210542,542.842125,150.842025,3,0
0,0,13,13,15,22,37,53,39,92,0.000333,0.159757,7,3354.887967,186.382665,479.26971,156.710855,3,0
0,0,16,16,17,25,42,71,47,118,0.000333,0.212098,8,5090.347647,282.797092,636.293456,185.583273,4,0
0,0,13,13,15,21,36,54,37,91,0.000333,0.156821,7,3293.242226,182.957901,470.463175,150.842025,3,0
0,0,9,9,11,18,29,32,24,56,0.000333,0.090682,5,1360.234679,75.568593,272.046936,113.112398,2,0
0,0,20,20,17,27,44,96,60,156,0.000333,0.28389,16,13626.74132,757.041184,851.671333,197.868831,6,0
0,0,8,8,14,17,31,35,24,59,0.000333,0.097433,7,2046.083076,113.671282,292.297582,122.789837,3,0
0,0,13,13,16,26,42,66,42,108,0.000333,0.194123,8,4658.962253,258.831236,582.370282,186.211433,5,0
0,0,16,16,14,25,39,58,46,104,0.000333,0.183227,7,3847.772815,213.765156,549.681831,169.399374,5,0
0,0,14,14,14,24,38,56,42,98,0.000333,0.171432,7,3600.078274,200.004349,514.296896,163.342069,5,0
0,0,12,12,14,23,37,54,38,92,0.000333,0.159757,7,3354.887967,186.382665,479.26971,157.344894,5,0
0,0,11,11,12,24,36,44,34,78,0.000333,0.134418,6,2419.524901,134.41805,403.25415,153.05865,4,0
0,0,11,11,12,21,33,40,31,71,0.000333,0.119384,6,2148.911895,119.383994,358.151982,135.258216,4,0
0,0,12,12,14,24,38,52,37,89,0.000333,0.155689,7,3269.458841,181.636602,467.065549,163.342069,5,0
0,0,11,11,14,23,37,51,35,86,0.000333,0.149338,7,3136.090926,174.227274,448.012989,157.344894,5,0
0,0,11,11,14,23,37,51,35,86,0.000333,0.149338,7,3136.090926,174.227274,448.012989,157.344894,5,0
0,0,6,6,9,14,23,21,20,41,0.000333,0.061822,4,741.864161,41.214676,185.46604,81.832294,2,0
0,0,5,5,9,14,23,20,18,38,0.000333,0.057298,4,687.581417,38.198968,171.895354,81.832294,2,0
0,0,6,6,10,13,23,22,19,41,0.000333,0.061822,5,927.330201,51.518344,185.46604,81.324997,2,0
0,0,5,5,10,13,23,21,17,38,0.000333,0.057298,5,859.476772,47.74871,171.895354,81.324997,2,0
0,0,7,7,6,12,18,19,21,40,0.000333,0.055599,3,500.391,27.7995,166.797,58.529325,1,0
0,0,7,7,8,15,23,17,21,38,0.000333,0.057298,4,687.581417,38.198968,171.895354,82.603359,1,0
0,0,17,17,11,21,32,59,55,114,0.000333,0.19,10,5700,316.666667,570,130.292414,2,0
0,0,20,20,15,24,39,72,63,135,0.000333,0.237843,14,9989.410194,554.967233,713.5293,168.642459,3,0
0,0,10,10,13,19,32,43,33,76,0.000333,0.126667,6,2280,126.666667,380,128.816339,2,0
0,0,16,16,15,23,38,54,50,104,0.000333,0.181928,14,7640.98246,424.499026,545.784461,162.645284,3,0
0,0,9,9,12,16,28,30,30,60,0.000333,0.096147,6,1730.647772,96.147098,288.441295,107.01955,2,0
0,0,5,5,11,10,21,22,17,39,0.000333,0.0571,5,856.501897,47.583439,171.300379,71.273029,2,0
0,0,9,9,12,15,27,31,31,62,0.000333,0.098268,12,3537.636302,196.53535,294.803025,101.622909,2,0
0,0,5,5,11,11,22,22,18,40,0.000333,0.059459,5,891.886324,49.54924,178.377265,76.107496,2,0
0,0,12,12,13,21,34,48,41,89,0.000333,0.150928,6,2716.705157,150.928064,452.784193,140.344382,3,0
0,0,11,11,13,21,34,47,39,86,0.000333,0.145841,6,2625.130826,145.840601,437.521804,140.344382,3,0
0,0,46,46,24,56,80,189,134,323,0.000333,0.680661,24,49007.58659,2722.6437,2041.982775,435.250976,11,0
0,0,13,13,14,18,32,41,54,95,0.000333,0.158333,21,9975,554.166667,475,128.361619,1,0
0,0,14,14,14,28,42,66,56,122,0.000333,0.219288,14,9210.078158,511.671009,657.862726,187.908907,5,0
0,0,8,8,13,12,25,31,23,54,0.000333,0.083589,6,1504.609405,83.589411,250.768234,91.125266,3,0
0,0,13,13,11,14,25,44,34,78,0.000333,0.12074,10,3622.207828,201.233768,362.220783,91.356717,3,0
0,0,16,16,15,17,32,57,42,99,0.000333,0.165,14,6930,385,495,128.090227,4,0
0,0,13,13,11,14,25,44,34,78,0.000333,0.12074,10,3622.207828,201.233768,362.220783,91.356717,3,0
0,0,16,16,15,17,32,57,42,99,0.000333,0.165,14,6930,385,495,128.090227,4,0
0,0,12,12,11,14,25,41,33,74,0.000333,0.114548,10,3436.45358,190.914088,343.645358,91.356717,2,0
0,0,15,15,15,17,32,54,41,95,0.000333,0.158333,14,6650,369.444444,475,128.090227,3,0
0,0,45,45,25,88,113,266,208,474,0.000333,1.077588,24,77586.35588,4310.353104,3232.764828,684.526387,18,0
0,0,13,13,14,35,49,86,61,147,0.000333,0.275121,7,5777.53643,320.974246,825.362347,232.827875,7,0
0,0,47,47,25,89,114,272,222,494,0.000333,1.125149,24,81010.74401,4500.596889,3375.447667,692.43668,18,0
0,0,13,13,14,35,49,86,61,147,0.000333,0.275121,7,5777.53643,320.974246,825.362347,232.827875,7,0
0,0,28,28,20,57,77,165,153,318,0.000333,0.664279,20,39856.7624,2214.264578,1992.83812,418.913293,12,0
0,0,13,13,14,35,49,86,61,147,0.000333,0.275121,7,5777.53643,320.974246,825.362347,232.827875,7,0
0,0,13,13,11,14,25,45,34,79,0.000333,0.122288,10,3668.64639,203.813688,366.864639,91.356717,3,0
0,0,16,16,15,17,32,58,42,100,0.000333,0.166667,14,7000,388.888889,500,128.090227,4,0
0,0,13,13,11,14,25,45,34,79,0.000333,0.122288,10,3668.64639,203.813688,366.864639,91.356717,3,0
0,0,16,16,15,17,32,58,42,100,0.000333,0.166667,14,7000,388.888889,500,128.090227,4,0
0,0,24,24,20,48,68,113,87,200,0.000333,0.405831,10,12174.92568,676.38476,1217.492568,354.516762,11,0
0,0,23,23,20,48,68,112,85,197,0.000333,0.399743,10,11992.3018,666.238989,1199.23018,354.516762,11,0
0,0,9,9,12,13,25,36,31,67,0.000333,0.103713,12,3733.660377,207.425576,311.138365,91.125266,2,0
0,0,12,12,16,17,33,49,39,88,0.000333,0.147969,16,7102.50692,394.583718,443.906683,133.486868,3,0
0,0,10,10,15,17,32,41,34,75,0.000333,0.125,14,5250,291.666667,375,128.090227,2,0
0,0,46,46,24,55,79,189,133,322,0.000333,0.676606,24,48715.61762,2706.423201,2029.817401,428.013884,11,0
0,0,13,13,15,17,32,42,53,95,0.000333,0.158333,21,9975,554.166667,475,128.090227,1,0
0,0,6,6,7,11,18,14,18,32,0.000333,0.044479,3,400.3128,22.2396,133.4376,57.705232,1,0
0,0,7,7,8,14,22,17,20,37,0.000333,0.055,4,659.99588,36.666438,164.99897,77.302969,1,0
0,0,6,6,8,13,21,15,18,33,0.000333,0.048315,4,579.7859,32.210328,144.946475,72.105716,1,0
0,0,12,12,11,18,29,36,40,76,0.000333,0.123069,10,3692.065556,205.114753,369.206556,113.112398,1,0
0,0,12,12,13,18,31,38,40,78,0.000333,0.128809,12,4637.127747,257.618208,386.427312,123.164366,2,0
0,0,25,25,20,47,67,117,93,210,0.000333,0.424626,10,12738.7873,707.710406,1273.87873,347.504238,13,0
0,0,24,24,20,47,67,116,91,207,0.000333,0.41856,10,12556.80462,697.600257,1255.680462,347.504238,13,0
0,0,26,26,24,50,74,124,100,224,0.000333,0.463639,24,33382.02129,1854.556739,1390.917554,392.23191,14,0
0,0,25,25,24,50,74,123,98,221,0.000333,0.45743,12,16467.47033,914.859463,1372.289194,392.23191,14,0
0,0,26,26,24,50,74,124,100,224,0.000333,0.463639,24,33382.02129,1854.556739,1390.917554,392.23191,14,0
0,0,25,25,24,50,74,123,98,221,0.000333,0.45743,12,16467.47033,914.859463,1372.289194,392.23191,14,0
0,0,26,26,24,47,71,123,92,215,0.000333,0.440732,12,15866.34757,881.463754,1322.195631,371.104776,12,0
0,0,25,25,24,47,71,122,90,212,0.000333,0.434582,12,15644.95667,869.16426,1303.746389,371.104776,12,0
0,0,34,34,21,54,75,167,111,278,0.000333,0.577204,20,34632.23192,1924.012884,1731.611596,403.002591,12,0
0,0,19,19,17,26,43,89,59,148,0.000333,0.267696,16,12849.39494,713.855274,803.087184,191.698301,6,0
0,0,10,10,16,17,33,36,30,66,0.000333,0.110977,8,2663.440095,147.968894,332.930012,133.486868,2,0
0,0,55,55,24,59,83,219,152,371,0.000333,0.78838,24,56763.3511,3153.519505,2365.139629,457.11504,15,0
0,0,14,14,18,18,36,46,55,101,0.000333,0.174054,27,14098.38548,783.243638,522.162425,150.1173,2,0
0,0,16,16,13,16,29,57,41,98,0.000333,0.158694,12,5712.98565,317.388092,476.082138,112.105716,3,0
0,0,19,19,16,19,35,70,49,119,0.000333,0.203462,16,9766.154864,542.564159,610.384679,144.710623,4,0
0,0,13,13,11,14,25,45,34,79,0.000333,0.122288,10,3668.64639,203.813688,366.864639,91.356717,3,0
0,0,16,16,15,17,32,58,42,100,0.000333,0.166667,14,7000,388.888889,500,128.090227,4,0
0,0,13,13,11,14,25,45,34,79,0.000333,0.122288,10,3668.64639,203.813688,366.864639,91.356717,3,0
0,0,16,16,15,17,32,58,42,100,0.000333,0.166667,14,7000,388.888889,500,128.090227,4,0
0,0,23,23,17,45,62,104,81,185,0.000333,0.367175,8,8812.210539,489.567252,1101.526317,316.620258,11,0
0,0,22,22,17,45,62,103,79,182,0.000333,0.361221,8,8669.309828,481.628324,1083.663728,316.620258,11,0
0,0,23,23,18,47,65,105,81,186,0.000333,0.373387,9,10081.44372,560.080207,1120.160413,336.124326,10,0
0,0,22,22,18,47,65,104,79,183,0.000333,0.367364,9,9918.839788,551.046655,1102.09331,336.124326,10,0
0,0,13,13,13,21,34,50,43,93,0.000333,0.157711,12,5677.608531,315.422696,473.134044,140.344382,4,0
0,0,14,14,13,21,34,51,45,96,0.000333,0.162799,12,5860.757193,325.597622,488.396433,140.344382,4,0
0,0,14,14,11,17,28,47,45,92,0.000333,0.147426,10,4422.766528,245.709252,442.276653,107.540616,2,0
0,0,17,17,15,20,35,60,53,113,0.000333,0.193203,14,8114.525733,450.806985,579.608981,145.041921,3,0
0,0,10,10,13,18,31,41,33,74,0.000333,0.122204,6,2199.663162,122.203509,366.610527,123.164366,2,0
0,0,15,15,13,22,35,55,53,108,0.000333,0.184654,12,6647.55079,369.308377,553.962566,146.213212,4,0
0,0,16,16,13,22,35,56,55,111,0.000333,0.189783,12,6832.204979,379.566943,569.350415,146.213212,4,0
0,0,16,16,11,18,29,52,57,109,0.000333,0.176507,15,7942.798927,441.266607,529.519928,113.112398,2,0
0,0,19,19,15,21,36,65,65,130,0.000333,0.22403,21,14113.89525,784.105292,672.09025,150.842025,3,0
0,0,10,10,13,18,31,41,33,74,0.000333,0.122204,6,2199.663162,122.203509,366.610527,123.164366,2,0
0,0,14,14,11,17,28,47,45,92,0.000333,0.147426,10,4422.766528,245.709252,442.276653,107.540616,2,0
0,0,17,17,15,20,35,60,53,113,0.000333,0.193203,14,8114.525733,450.806985,579.608981,145.041921,3,0
0,0,10,10,13,18,31,41,33,74,0.000333,0.122204,6,2199.663162,122.203509,366.610527,123.164366,2,0
0,0,19,19,13,24,37,65,73,138,0.000333,0.239635,18,12940.28216,718.904564,718.904564,158.144816,4,0
0,0,20,20,13,24,37,66,75,141,0.000333,0.244844,18,13221.59264,734.532925,734.532925,158.144816,4,0
0,0,15,15,10,18,28,51,66,117,0.000333,0.187487,15,8436.907888,468.717105,562.460526,108.277931,2,0
0,0,18,18,14,21,35,64,74,138,0.000333,0.235947,21,14864.66218,825.814566,707.841056,145.541635,3,0
0,0,10,10,13,18,31,41,33,74,0.000333,0.122204,6,2199.663162,122.203509,366.610527,123.164366,2,0
0,0,24,24,21,30,51,100,84,184,0.000333,0.347909,20,20874.52526,1159.695848,1043.726263,239.445384,7,0
0,0,14,14,19,22,41,47,58,105,0.000333,0.187514,18,10125.77329,562.54296,562.54296,178.818118,2,0
0,0,11,11,11,19,30,36,43,79,0.000333,0.129215,10,3876.443571,215.357976,387.644357,118.764371,1,0
0,0,10,10,10,17,27,29,36,65,0.000333,0.103023,10,3090.676876,171.704271,309.067688,102.706149,1,0
0,0,11,11,10,18,28,41,41,82,0.000333,0.131401,10,3942.031036,219.001724,394.203104,108.277931,1,0
0,0,11,11,12,21,33,41,38,79,0.000333,0.132836,6,2391.042813,132.835712,398.507135,135.258216,2,0
0,0,10,10,9,16,25,34,34,68,0.000333,0.105261,8,2526.257767,140.347654,315.782221,92.529325,1,0
0,0,8,8,9,16,25,25,24,49,0.000333,0.07585,4,910.195813,50.566434,227.548953,92.529325,1,0
0,0,11,11,9,17,26,38,37,75,0.000333,0.117511,8,2820.263831,156.681324,352.532979,98.016193,1,0
0,0,55,55,25,63,88,220,156,376,0.000333,0.809582,24,58289.91093,3238.328385,2428.746289,492.66504,15,0
0,0,14,14,18,23,41,46,59,105,0.000333,0.187514,18,10125.77329,562.54296,562.54296,179.100575,2,0
0,0,5,5,14,13,27,26,18,44,0.000333,0.069738,7,1464.505351,81.361408,209.21505,101.408685,3,0
0,0,5,5,13,13,26,25,18,43,0.000333,0.067373,6,1212.713447,67.372969,202.118908,96.211433,3,0
0,0,5,5,13,12,25,25,17,42,0.000333,0.065014,6,1170.25176,65.013987,195.04196,91.125266,3,0
0,0,5,5,13,12,25,25,17,42,0.000333,0.065014,6,1170.25176,65.013987,195.04196,91.125266,3,0
0,0,14,14,16,21,37,48,53,101,0.000333,0.175385,16,8418.476639,467.693147,526.15479,156.238666,2,0
0,0,11,11,13,15,28,32,48,80,0.000333,0.128196,18,6922.591088,384.588394,384.588394,106.709075,1,0
0,0,15,15,15,20,35,51,52,103,0.000333,0.176105,14,7396.42611,410.912562,528.316151,145.041921,2,0
0,0,18,18,18,23,41,64,60,124,0.000333,0.221445,18,11958.05607,664.336449,664.336449,179.100575,3,0
0,0,16,16,17,23,40,56,55,111,0.000333,0.196911,16,9451.744297,525.096905,590.734019,173.528793,2,0
0,0,33,33,23,58,81,146,109,255,0.000333,0.538887,11,17783.27926,987.959959,1616.661751,443.804823,13,0
0,0,32,32,23,58,81,145,107,252,0.000333,0.532547,11,17574.06421,976.3369,1597.642201,443.804823,13,0
0,0,17,17,16,18,34,56,66,122,0.000333,0.20689,24,14896.0912,827.560622,620.670467,139.05865,2,0
0,0,20,20,19,21,40,69,74,143,0.000333,0.253679,27,20547.96437,1141.553576,761.035718,172.949289,3,0
0,0,18,18,18,21,39,61,69,130,0.000333,0.229034,27,18551.76179,1030.653433,687.102288,167.297316,2,0
0,0,25,25,19,48,67,113,85,198,0.000333,0.400362,9,10809.77094,600.54283,1201.08566,348.788823,11,0
0,0,24,24,19,48,67,112,83,195,0.000333,0.394296,9,10645.98653,591.443696,1182.887392,348.788823,11,0
0,0,26,26,20,48,68,117,89,206,0.000333,0.418006,10,12540.17345,696.676303,1254.017345,354.516762,12,0
0,0,25,25,20,48,68,116,87,203,0.000333,0.411918,10,12357.54957,686.530532,1235.754957,354.516762,12,0
0,0,32,32,20,53,73,141,108,249,0.000333,0.513755,20,30825.3263,1712.518128,1541.266315,390.018346,11,0
0,0,31,31,20,53,73,140,106,246,0.000333,0.507566,20,30453.93683,1691.885379,1522.696841,390.018346,11,0
0,0,15,15,13,18,31,52,48,100,0.000333,0.16514,12,5945.035572,330.279754,495.419631,123.164366,2,0
0,0,18,18,16,21,37,65,56,121,0.000333,0.210115,16,10085.50172,560.305651,630.343857,156.238666,3,0
0,0,10,10,13,19,32,42,33,75,0.000333,0.125,6,2250,125,375,128.816339,2,0
0,0,23,23,24,43,67,116,84,200,0.000333,0.404406,12,14558.61406,808.811892,1213.217838,343.368484,11,0
0,0,22,22,24,43,67,115,82,197,0.000333,0.39834,12,14340.23485,796.679714,1195.019571,343.368484,11,0
0,0,21,21,24,42,66,106,76,182,0.000333,0.366693,12,13200.95676,733.386486,1100.07973,336.516432,10,0
0,0,20,20,24,42,66,105,74,179,0.000333,0.360649,12,12983.35857,721.297698,1081.946547,336.516432,10,0
0,0,22,22,24,44,68,109,78,187,0.000333,0.379452,12,13660.26662,758.903701,1138.355551,350.254091,11,0
0,0,21,21,24,44,68,108,76,184,0.000333,0.373364,12,13441.11795,746.728775,1120.093163,350.254091,11,0
0,0,22,22,24,44,68,109,78,187,0.000333,0.379452,12,13660.26662,758.903701,1138.355551,350.254091,11,0
0,0,21,21,24,44,68,108,76,184,0.000333,0.373364,12,13441.11795,746.728775,1120.093163,350.254091,11,0
0,0,23,23,24,43,67,110,82,192,0.000333,0.38823,12,13976.2695,776.459416,1164.689125,343.368484,10,0
0,0,22,22,24,43,67,109,80,189,0.000333,0.382164,12,13757.89028,764.327238,1146.490857,343.368484,10,0
0,0,17,17,12,21,33,53,58,111,0.000333,0.186643,12,6719.132967,373.285165,559.927747,135.258216,2,0
0,0,20,20,16,24,40,66,66,132,0.000333,0.234165,16,11239.91214,624.439563,702.494509,174.0391,3,0
0,0,10,10,13,19,32,41,35,76,0.000333,0.126667,6,2280,126.666667,380,128.816339,2,0
0,0,6,6,6,11,17,13,18,31,0.000333,0.042237,3,380.134044,21.118558,126.711348,53.563523,1,0
0,0,7,7,8,15,23,17,21,38,0.000333,0.057298,4,687.581417,38.198968,171.895354,82.603359,1,0
0,0,17,17,11,21,32,59,55,114,0.000333,0.19,10,5700,316.666667,570,130.292414,2,0
0,0,20,20,15,24,39,72,63,135,0.000333,0.237843,14,9989.410194,554.967233,713.5293,168.642459,3,0
0,0,10,10,13,19,32,43,33,76,0.000333,0.126667,6,2280,126.666667,380,128.816339,2,0
0,0,16,16,15,23,38,54,50,104,0.000333,0.181928,14,7640.98246,424.499026,545.784461,162.645284,3,0
0,0,25,25,20,48,68,110,88,198,0.000333,0.401773,10,12053.17643,669.620913,1205.317643,354.516762,7,0
0,0,24,24,20,48,68,109,86,195,0.000333,0.395685,10,11870.55254,659.475141,1187.055254,354.516762,7,0
0,0,7,7,14,13,27,30,20,50,0.000333,0.079248,7,1664.210626,92.456146,237.744375,101.408685,3,0
0,0,7,7,14,13,27,30,20,50,0.000333,0.079248,7,1664.210626,92.456146,237.744375,101.408685,3,0
0,0,5,5,13,12,25,25,17,42,0.000333,0.065014,6,1170.25176,65.013987,195.04196,91.125266,3,0
0,0,5,5,13,12,25,25,17,42,0.000333,0.065014,6,1170.25176,65.013987,195.04196,91.125266,3,0
0,0,5,5,13,12,25,25,17,42,0.000333,0.065014,6,1170.25176,65.013987,195.04196,91.125266,3,0
0,0,5,5,13,12,25,25,17,42,0.000333,0.065014,6,1170.25176,65.013987,195.04196,91.125266,3,0
0,0,4,4,11,9,20,15,12,27,0.000333,0.038897,5,583.460293,32.414461,116.692059,66.583073,2,0
0,0,27,27,18,49,67,118,96,214,0.000333,0.432714,9,11683.28778,649.071543,1298.143087,350.179432,9,0
0,0,26,26,18,49,67,117,94,211,0.000333,0.426648,9,11519.50337,639.97241,1279.944819,350.179432,9,0
0,0,28,28,19,51,70,123,99,222,0.000333,0.453567,9,12246.30747,680.350415,1360.70083,370.004315,10,0
0,0,27,27,19,51,70,122,97,219,0.000333,0.447438,9,12080.81683,671.15649,1342.312981,370.004315,10,0
0,0,13,13,14,27,41,57,52,109,0.000333,0.194658,7,4087.81218,227.100677,583.973169,181.684931,5,0
0,0,14,14,15,29,44,57,59,116,0.000333,0.211098,14,8866.116949,492.562053,633.294068,199.484808,5,0
0,0,22,22,24,43,67,109,78,187,0.000333,0.37812,12,13612.30414,756.239119,1134.358679,343.368484,10,0
0,0,21,21,24,43,67,108,76,184,0.000333,0.372053,12,13393.92493,744.106941,1116.160411,343.368484,10,0
0,0,28,28,19,50,69,124,94,218,0.000333,0.443886,9,11984.92498,665.829166,1331.658332,362.903432,10,0
0,0,27,27,19,50,69,123,92,215,0.000333,0.437778,9,11819.99482,656.666379,1313.332758,362.903432,10,0
0,0,5,5,8,10,18,14,13,27,0.000333,0.037529,4,450.3519,25.01955,112.587975,57.219281,2,0
0,0,8,8,13,13,26,27,21,48,0.000333,0.075207,6,1353.726639,75.207035,225.621106,96.211433,3,0
0,0,5,5,9,8,17,15,11,26,0.000333,0.035425,4,425.096135,23.616452,106.274034,52.529325,2,0
0,0,8,8,14,11,25,28,19,47,0.000333,0.072754,7,1527.828686,84.879371,218.261241,91.356717,3,0
0,0,6,6,10,10,20,18,15,33,0.000333,0.047541,5,713.118136,39.617674,142.623627,66.438562,3,0
0,0,5,5,9,8,17,15,11,26,0.000333,0.035425,4,425.096135,23.616452,106.274034,52.529325,2,0
0,0,8,8,14,11,25,28,19,47,0.000333,0.072754,7,1527.828686,84.879371,218.261241,91.356717,3,0
0,0,6,6,10,10,20,18,15,33,0.000333,0.047541,5,713.118136,39.617674,142.623627,66.438562,3,0
0,0,8,8,9,17,26,29,34,63,0.000333,0.098709,8,2369.021618,131.612312,296.127702,98.016193,1,0
0,0,8,8,9,19,28,30,33,63,0.000333,0.100954,4,1211.45344,67.302969,302.86336,109.239948,1,0
0,0,8,8,10,19,29,30,33,63,0.000333,0.102018,5,1530.264013,85.014667,306.052803,113.929904,1,0
0,0,10,10,9,17,26,39,47,86,0.000333,0.134746,8,3233.902526,179.661251,404.237816,98.016193,1,0
0,0,10,10,9,19,28,40,47,87,0.000333,0.139413,8,3345.919026,185.88439,418.239878,109.239948,1,0
0,0,11,11,10,20,30,43,49,92,0.000333,0.150478,10,4514.339348,250.79663,451.433935,119.657843,1,0
0,0,18,18,18,41,59,93,70,163,0.000333,0.319624,9,8629.837353,479.435409,958.870817,294.718282,7,0
0,0,18,18,18,42,60,93,72,165,0.000333,0.324879,9,8771.732534,487.318474,974.636948,301.535982,7,0
0,0,28,28,19,50,69,123,99,222,0.000333,0.452031,9,12204.83187,678.046215,1356.092429,362.903432,9,0
0,0,27,27,19,50,69,122,97,219,0.000333,0.445922,9,12039.9017,668.883428,1337.766856,362.903432,9,0
0,0,29,29,20,52,72,128,102,230,0.000333,0.473028,10,14190.8275,788.379306,1419.08275,382.861427,10,0
0,0,28,28,20,52,72,127,100,227,0.000333,0.466858,10,14005.72975,778.096097,1400.572975,382.861427,10,0
0,0,25,25,19,48,67,112,87,199,0.000333,0.402384,9,10864.36574,603.575874,1207.151749,348.788823,11,0
0,0,24,24,19,48,67,111,85,196,0.000333,0.396318,9,10700.58133,594.476741,1188.953481,348.788823,11,0
0,0,37,37,21,57,78,167,126,293,0.000333,0.613874,20,36832.457,2046.247611,1841.62285,424.713397,13,0
0,0,36,36,21,57,78,166,124,290,0.000333,0.607589,20,36455.33287,2025.296271,1822.766643,424.713397,13,0
0,0,30,30,19,51,70,126,99,225,0.000333,0.459696,9,12411.79811,689.544339,1379.088679,370.004315,11,0
0,0,7,7,8,15,23,17,21,38,0.000333,0.057298,4,687.581417,38.198968,171.895354,82.603359,1,0
0,0,18,18,15,24,39,67,58,125,0.000333,0.220225,14,9249.453883,513.858549,660.675277,168.642459,3,0
0,0,13,13,11,14,25,45,34,79,0.000333,0.122288,10,3668.64639,203.813688,366.864639,91.356717,3,0
0,0,16,16,15,17,32,58,42,100,0.000333,0.166667,14,7000,388.888889,500,128.090227,4,0
0,0,13,13,11,14,25,45,34,79,0.000333,0.122288,10,3668.64639,203.813688,366.864639,91.356717,3,0
0,0,16,16,15,17,32,58,42,100,0.000333,0.166667,14,7000,388.888889,500,128.090227,4,0
0,0,5,5,8,14,22,14,16,30,0.000333,0.044594,4,535.131794,29.729544,133.782949,77.302969,2,0
0,0,5,5,9,11,20,15,13,28,0.000333,0.040338,4,484.055947,26.891997,121.013987,66.583073,2,0
0,0,13,13,14,29,43,89,56,145,0.000333,0.262269,7,5507.658726,305.98104,786.808389,194.184418,8,0
0,0,15,15,14,32,46,98,64,162,0.000333,0.298272,14,12527.43852,695.968806,894.817037,213.302969,8,0
0,0,5,5,9,11,20,15,13,28,0.000333,0.040338,4,484.055947,26.891997,121.013987,66.583073,2,0
0,0,13,13,14,29,43,89,56,145,0.000333,0.262269,7,5507.658726,305.98104,786.808389,194.184418,8,0
0,0,15,15,14,32,46,98,64,162,0.000333,0.298272,14,12527.43852,695.968806,894.817037,213.302969,8,0
0,0,12,12,13,24,37,50,40,90,0.000333,0.156284,6,2813.104817,156.283601,468.850803,158.144816,9,0
0,0,9,9,12,23,35,43,34,77,0.000333,0.131652,6,2369.728754,131.651597,394.954792,147.061475,8,0
0,0,10,10,13,14,27,44,28,72,0.000333,0.114117,12,4108.222802,228.2346,342.3519,101.408685,4,0
0,0,12,12,14,21,35,51,37,88,0.000333,0.150459,7,3159.638338,175.535463,451.376905,145.541635,7,0
0,0,11,11,15,21,36,56,38,94,0.000333,0.161991,7,3401.810651,188.989481,485.97295,150.842025,6,0
0,0,10,10,13,14,27,44,28,72,0.000333,0.114117,12,4108.222802,228.2346,342.3519,101.408685,4,0
0,0,12,12,14,21,35,51,37,88,0.000333,0.150459,7,3159.638338,175.535463,451.376905,145.541635,7,0
0,0,11,11,15,21,36,56,38,94,0.000333,0.161991,7,3401.810651,188.989481,485.97295,150.842025,6,0
0,0,13,13,12,15,27,46,35,81,0.000333,0.128382,12,4621.750652,256.763925,385.145888,101.622909,3,0
0,0,16,16,15,18,33,59,43,102,0.000333,0.171509,14,7203.394802,400.1886,514.5282,133.662009,4,0
0,0,13,13,11,15,26,45,35,80,0.000333,0.125345,10,3760.351775,208.908432,376.035177,96.657107,3,0
0,0,16,16,15,18,33,58,43,101,0.000333,0.169828,14,7132.773285,396.265182,509.483806,133.662009,4,0
0,0,27,27,20,49,69,130,100,230,0.000333,0.46832,20,28099.2125,1561.067361,1404.960625,361.559344,10,0
0,0,26,26,20,49,69,129,98,227,0.000333,0.462212,20,27732.70103,1540.705613,1386.635052,361.559344,10,0
0,0,28,28,24,52,76,137,105,242,0.000333,0.503999,24,36287.963,2015.997944,1511.998458,406.461965,12,0
0,0,27,27,24,52,76,136,103,239,0.000333,0.497752,12,17919.05611,995.503117,1493.254676,406.461965,12,0
0,0,6,6,14,14,28,25,20,45,0.000333,0.07211,7,1514.3168,84.128711,216.330971,106.605938,3,0
0,0,12,12,11,20,31,58,38,96,0.000333,0.158534,5,2378.014229,132.111902,475.602846,124.49231,7,0
0,0,6,6,9,13,22,24,18,42,0.000333,0.062432,4,749.184512,41.621362,187.296128,76.635041,4,0
0,0,6,6,10,11,21,25,16,41,0.000333,0.060028,5,900.425072,50.023615,180.085014,71.273029,4,0
0,0,12,12,12,18,30,59,36,95,0.000333,0.155385,12,5593.855279,310.769738,466.154607,118.0782,7,0
0,0,6,6,10,11,21,25,16,41,0.000333,0.060028,5,900.425072,50.023615,180.085014,71.273029,4,0
0,0,12,12,12,18,30,59,36,95,0.000333,0.155385,12,5593.855279,310.769738,466.154607,118.0782,7,0
0,0,14,14,13,21,34,63,41,104,0.000333,0.176365,6,3174.576813,176.365378,529.096135,140.344382,7,0
0,0,8,8,11,15,26,29,21,50,0.000333,0.078341,5,1175.10993,65.283885,235.021986,96.657107,4,0
0,0,8,8,11,12,23,30,19,49,0.000333,0.073885,5,1108.272679,61.570704,221.654536,81.073298,4,0
0,0,14,14,13,19,32,64,39,103,0.000333,0.171667,12,6180,343.333333,515,128.816339,7,0
0,0,8,8,11,13,24,30,19,49,0.000333,0.074888,5,1123.315813,62.406434,224.663163,86.159464,4,0
0,0,14,14,13,19,32,64,39,103,0.000333,0.171667,12,6180,343.333333,515,128.816339,7,0
0,0,24,24,19,42,61,104,78,182,0.000333,0.359798,9,9714.547759,539.697098,1079.394195,307.187955,8,0
0,0,12,12,13,17,30,41,28,69,0.000333,0.112858,6,2031.452707,112.858484,338.575451,117.592585,3,0
0,0,12,12,14,16,30,43,27,70,0.000333,0.114494,7,2404.376392,133.576466,343.482342,117.302969,3,0
0,0,13,13,14,16,30,45,29,74,0.000333,0.121037,7,2541.769329,141.209407,363.109904,117.302969,3,0
0,0,13,13,14,16,30,45,29,74,0.000333,0.121037,7,2541.769329,141.209407,363.109904,117.302969,3,0
0,0,12,12,14,16,30,43,27,70,0.000333,0.114494,7,2404.376392,133.576466,343.482342,117.302969,3,0
0,0,4,4,11,10,21,16,13,29,0.000333,0.042459,5,636.886026,35.382557,127.377205,71.273029,2,0
0,0,12,12,11,13,24,42,33,75,0.000333,0.114624,10,3438.721876,191.040104,343.872188,86.159464,2,0
0,0,15,15,15,16,31,55,41,96,0.000333,0.158534,14,6658.439841,369.913325,475.602846,122.603359,3,0
0,0,10,10,14,15,29,40,29,69,0.000333,0.111734,7,2346.404821,130.355823,335.200689,111.906328,2,0
0,0,16,16,12,18,30,53,54,107,0.000333,0.175012,18,9450.671287,525.037294,525.037294,118.0782,3,0
0,0,19,19,16,21,37,66,62,128,0.000333,0.22227,16,10668.96049,592.720027,666.810031,156.238666,4,0
0,0,16,16,12,18,30,53,54,107,0.000333,0.175012,18,9450.671287,525.037294,525.037294,118.0782,3,0
0,0,19,19,16,21,37,66,62,128,0.000333,0.22227,16,10668.96049,592.720027,666.810031,156.238666,4,0
0,0,6,6,10,13,23,23,21,44,0.000333,0.066346,5,995.18363,55.287979,199.036726,81.324997,3,0
0,0,10,10,11,16,27,31,34,65,0.000333,0.103023,10,3090.676876,171.704271,309.067688,102.053748,3,0
0,0,13,13,12,15,27,46,35,81,0.000333,0.128382,12,4621.750652,256.763925,385.145888,101.622909,3,0
0,0,16,16,15,18,33,59,43,102,0.000333,0.171509,14,7203.394802,400.1886,514.5282,133.662009,4,0
0,0,13,13,11,15,26,45,35,80,0.000333,0.125345,10,3760.351775,208.908432,376.035177,96.657107,3,0
0,0,16,16,15,18,33,58,43,101,0.000333,0.169828,14,7132.773285,396.265182,509.483806,133.662009,4,0
0,0,5,5,11,11,22,19,14,33,0.000333,0.049054,5,735.806217,40.878123,147.161243,76.107496,3,0
0,0,5,5,11,11,22,19,14,33,0.000333,0.049054,5,735.806217,40.878123,147.161243,76.107496,3,0
0,0,9,9,11,18,29,35,26,61,0.000333,0.098779,5,1481.684204,82.315789,296.336841,113.112398,4,0
0,0,10,10,11,18,29,36,28,64,0.000333,0.103637,5,1554.553918,86.364107,310.910784,113.112398,4,0
0,0,9,9,11,18,29,35,26,61,0.000333,0.098779,5,1481.684204,82.315789,296.336841,113.112398,4,0
0,0,10,10,11,18,29,36,28,64,0.000333,0.103637,5,1554.553918,86.364107,310.910784,113.112398,4,0
0,0,9,9,11,19,30,35,27,62,0.000333,0.101409,5,1521.136085,84.50756,304.227217,118.764371,4,0
0,0,10,10,11,19,30,36,29,65,0.000333,0.106316,5,1594.739444,88.596636,318.947889,118.764371,4,0
0,0,9,9,11,19,30,35,27,62,0.000333,0.101409,5,1521.136085,84.50756,304.227217,118.764371,4,0
0,0,10,10,11,19,30,36,29,65,0.000333,0.106316,5,1594.739444,88.596636,318.947889,118.764371,4,0
0,0,28,28,20,46,66,119,113,232,0.000333,0.467433,20,28045.98871,1558.110484,1402.299436,340.522412,8,0
0,0,27,27,20,46,66,118,111,229,0.000333,0.461389,20,27683.32507,1537.962504,1384.166253,340.522412,8,0
0,0,29,29,24,49,73,126,124,250,0.000333,0.515819,24,37138.94735,2063.274853,1547.45614,385.159882,10,0
0,0,28,28,24,49,73,125,122,247,0.000333,0.509629,24,36693.27999,2038.515555,1528.886666,385.159882,10,0
0,0,13,13,12,15,27,46,35,81,0.000333,0.128382,12,4621.750652,256.763925,385.145888,101.622909,3,0
0,0,16,16,15,18,33,59,43,102,0.000333,0.171509,14,7203.394802,400.1886,514.5282,133.662009,4,0
0,0,13,13,11,15,26,45,35,80,0.000333,0.125345,10,3760.351775,208.908432,376.035177,96.657107,3,0
0,0,16,16,15,18,33,58,43,101,0.000333,0.169828,14,7132.773285,396.265182,509.483806,133.662009,4,0
0,0,10,10,15,20,35,42,33,75,0.000333,0.128232,7,2692.873584,149.604088,384.696226,145.041921,4,0
0,0,11,11,15,20,35,43,35,78,0.000333,0.133361,7,2800.588527,155.588252,400.084075,145.041921,4,0
0,0,6,6,8,11,19,14,18,32,0.000333,0.045311,4,543.734722,30.207485,135.93368,62.053748,1,0
0,0,6,6,9,13,22,15,18,33,0.000333,0.049054,4,588.644974,32.702499,147.161243,76.635041,1,0
0,0,11,11,11,16,27,36,34,70,0.000333,0.110947,10,3328.421252,184.912292,332.842125,102.053748,2,0
0,0,11,11,12,18,30,37,35,72,0.000333,0.117765,6,2119.776737,117.765374,353.296123,118.0782,2,0
0,0,12,12,11,21,32,58,39,97,0.000333,0.161667,5,2425,134.722222,485,130.292414,7,0
0,0,6,6,9,14,23,24,19,43,0.000333,0.064838,4,778.052656,43.225148,194.513164,81.832294,4,0
0,0,6,6,11,12,23,26,17,43,0.000333,0.064838,5,972.565821,54.031434,194.513164,81.073298,4,0
0,0,12,12,12,19,31,60,37,97,0.000333,0.160186,6,2883.342253,160.185681,480.557042,123.730173,7,0
0,0,6,6,10,12,22,25,17,42,0.000333,0.062432,5,936.48064,52.026702,187.296128,76.238831,4,0
0,0,12,12,12,19,31,59,37,96,0.000333,0.158534,6,2853.617075,158.534282,475.602846,123.730173,7,0
0,0,15,15,12,17,29,50,47,97,0.000333,0.157075,12,5654.689878,314.149438,471.224157,112.506418,2,0
0,0,18,18,16,20,36,63,55,118,0.000333,0.20335,16,9760.818403,542.267689,610.05115,150.438562,3,0
0,0,14,14,11,17,28,47,45,92,0.000333,0.147426,10,4422.766528,245.709252,442.276653,107.540616,2,0
0,0,17,17,15,20,35,60,53,113,0.000333,0.193203,14,8114.525733,450.806985,579.608981,145.041921,3,0
0,0,10,10,13,18,31,41,33,74,0.000333,0.122204,6,2199.663162,122.203509,366.610527,123.164366,2,0
0,0,18,18,11,19,30,57,69,126,0.000333,0.206089,15,9274.023226,515.223513,618.268215,118.764371,2,0
0,0,21,21,15,22,37,70,77,147,0.000333,0.255263,21,16081.58254,893.421252,765.789645,156.710855,3,0
0,0,10,10,13,18,31,41,33,74,0.000333,0.122204,6,2199.663162,122.203509,366.610527,123.164366,2,0
0,0,13,13,12,16,28,45,35,80,0.000333,0.128196,12,4615.060725,256.392263,384.588394,107.01955,3,0
0,0,16,16,15,19,34,58,43,101,0.000333,0.171278,14,7193.672458,399.64847,513.833747,139.313982,4,0
0,0,13,13,11,16,27,44,35,79,0.000333,0.125212,10,3756.361127,208.686729,375.636113,102.053748,3,0
0,0,16,16,15,19,34,57,43,100,0.000333,0.169582,14,7122.447978,395.691554,508.746284,139.313982,4,0
0,0,13,13,12,16,28,45,35,80,0.000333,0.128196,12,4615.060725,256.392263,384.588394,107.01955,3,0
0,0,16,16,15,19,34,58,43,101,0.000333,0.171278,14,7193.672458,399.64847,513.833747,139.313982,4,0
0,0,13,13,11,16,27,44,35,79,0.000333,0.125212,10,3756.361127,208.686729,375.636113,102.053748,3,0
0,0,16,16,15,19,34,57,43,100,0.000333,0.169582,14,7122.447978,395.691554,508.746284,139.313982,4,0
0,0,5,5,11,10,21,18,13,31,0.000333,0.045387,5,680.809201,37.822733,136.16184,71.273029,3,0
0,0,5,5,11,10,21,18,13,31,0.000333,0.045387,5,680.809201,37.822733,136.16184,71.273029,3,0
0,0,29,29,18,50,68,123,106,229,0.000333,0.464676,18,25092.52183,1394.028991,1394.028991,357.25146,9,0
0,0,28,28,18,50,68,122,104,226,0.000333,0.458589,18,24763.79884,1375.766602,1375.766602,357.25146,9,0
0,0,30,30,19,52,71,128,111,239,0.000333,0.48993,18,26456.21211,1469.789562,1469.789562,377.133488,10,0
0,0,29,29,19,52,71,127,109,236,0.000333,0.48378,18,26124.12576,1451.34032,1451.34032,377.133488,10,0
0,0,31,31,18,51,69,128,116,244,0.000333,0.496827,18,26828.63941,1490.479967,1490.479967,364.352342,9,0
0,0,30,30,18,51,69,127,114,241,0.000333,0.490718,18,26498.77909,1472.154394,1472.154394,364.352342,9,0
0,0,32,32,19,53,72,133,123,256,0.000333,0.5265,18,28431.01441,1579.5008,1579.5008,384.290407,10,0
0,0,31,31,19,53,72,132,121,253,0.000333,0.52033,18,28097.83846,1560.991025,1560.991025,384.290407,10,0
0,0,25,25,19,28,47,95,80,175,0.000333,0.324018,18,17496.95488,972.053049,972.053049,215.316561,6,0
0,0,14,14,17,19,36,45,56,101,0.000333,0.174054,16,8354.598802,464.144378,522.162425,150.197491,2,0
0,0,4,4,10,13,23,19,19,38,0.000333,0.057298,5,859.476772,47.74871,171.895354,81.324997,2,0
0,0,9,9,12,13,25,36,31,67,0.000333,0.103713,12,3733.660377,207.425576,311.138365,91.125266,2,0
0,0,12,12,16,17,33,49,39,88,0.000333,0.147969,16,7102.50692,394.583718,443.906683,133.486868,3,0
0,0,10,10,15,17,32,41,34,75,0.000333,0.125,14,5250,291.666667,375,128.090227,2,0
0,0,25,25,19,47,66,113,91,204,0.000333,0.411019,9,11097.5076,616.5282,1233.0564,341.776299,7,0
0,0,24,24,19,47,66,112,89,201,0.000333,0.404974,9,10934.30896,607.461609,1214.923218,341.776299,7,0
0,0,26,26,21,51,72,120,95,215,0.000333,0.442178,10,13265.33875,736.963264,1326.533875,381.532358,8,0
0,0,25,25,21,51,72,119,93,212,0.000333,0.436008,10,13080.241,726.680056,1308.0241,381.532358,8,0
0,0,20,20,17,42,59,94,70,164,0.000333,0.321584,8,7718.027681,428.779316,964.75346,295.9642,7,0
0,0,19,19,17,42,59,93,68,161,0.000333,0.315702,8,7576.844248,420.935792,947.105531,295.9642,7,0
0,0,20,20,18,41,59,95,69,164,0.000333,0.321584,9,8682.781141,482.37673,964.75346,294.718282,7,0
0,0,19,19,18,41,59,94,67,161,0.000333,0.315702,9,8523.949779,473.552765,947.105531,294.718282,7,0
0,0,22,22,21,55,76,149,112,261,0.000333,0.54357,20,32614.18162,1811.898979,1630.709081,410.21345,12,0
0,0,13,13,16,36,52,88,62,150,0.000333,0.285022,8,6840.527662,380.029315,855.065958,250.1173,7,0
0,0,31,31,22,52,74,169,124,293,0.000333,0.606457,22,40026.1364,2223.674244,1819.369836,394.530361,12,0
0,0,13,13,15,31,46,84,56,140,0.000333,0.257766,7,5413.090717,300.727262,773.298674,212.183445,7,0
0,0,10,10,14,21,35,45,35,80,0.000333,0.136781,7,2872.398489,159.577694,410.342641,145.541635,5,0
0,0,5,5,9,13,22,19,17,36,0.000333,0.053513,4,642.158153,35.675453,160.539538,76.635041,2,0
0,0,6,6,9,14,23,20,19,39,0.000333,0.058806,4,705.675665,39.204204,176.418916,81.832294,2,0
0,0,5,5,10,12,22,20,16,36,0.000333,0.053513,5,802.697691,44.594316,160.539538,76.238831,2,0
0,0,6,6,10,13,23,21,18,39,0.000333,0.058806,5,882.094581,49.005255,176.418916,81.324997,2,0
0,0,22,22,24,42,66,109,77,186,0.000333,0.374752,12,13491.08767,749.504871,1124.257306,336.516432,11,0
0,0,21,21,24,42,66,108,75,183,0.000333,0.368708,12,13273.48949,737.416083,1106.124124,336.516432,11,0
0,0,22,22,24,43,67,109,77,186,0.000333,0.376098,12,13539.51107,752.19506,1128.292589,343.368484,11,0
0,0,21,21,24,43,67,108,75,183,0.000333,0.370031,12,13321.13186,740.062881,1110.094322,343.368484,11,0
0,0,22,22,24,43,67,109,77,186,0.000333,0.376098,12,13539.51107,752.19506,1128.292589,343.368484,11,0
0,0,21,21,24,43,67,108,75,183,0.000333,0.370031,12,13321.13186,740.062881,1110.094322,343.368484,11,0
0,0,26,26,18,46,64,115,92,207,0.000333,0.414,18,22356,1242,1242,329.1425,9,0
0,0,22,22,18,44,62,107,79,186,0.000333,0.36916,9,9967.324624,553.740257,1107.480514,315.273641,9,0
0,0,32,32,18,53,71,133,121,254,0.000333,0.520679,18,28116.64383,1562.035768,1562.035768,378.638434,9,0
0,0,31,31,18,53,71,132,119,251,0.000333,0.514529,18,27784.55749,1543.586527,1543.586527,378.638434,9,0
0,0,13,13,19,21,40,68,47,115,0.000333,0.204007,18,11016.39116,612.021731,612.021731,172.949289,10,0
0,0,29,29,26,48,74,147,101,248,0.000333,0.513315,26,40038.5553,2224.364183,1539.944435,390.289633,16,0
0,0,28,28,26,48,74,146,99,245,0.000333,0.507105,26,39554.21794,2197.456552,1521.316075,390.289633,16,0
0,0,29,29,26,48,74,147,101,248,0.000333,0.513315,26,40038.5553,2224.364183,1539.944435,390.289633,16,0
0,0,28,28,26,48,74,146,99,245,0.000333,0.507105,26,39554.21794,2197.456552,1521.316075,390.289633,16,0
0,0,13,13,19,21,40,68,47,115,0.000333,0.204007,18,11016.39116,612.021731,612.021731,172.949289,10,0
0,0,12,12,13,24,37,50,40,90,0.000333,0.156284,6,2813.104817,156.283601,468.850803,158.144816,9,0
0,0,9,9,12,23,35,43,34,77,0.000333,0.131652,6,2369.728754,131.651597,394.954792,147.061475,8,0
0,0,10,10,13,14,27,44,28,72,0.000333,0.114117,12,4108.222802,228.2346,342.3519,101.408685,4,0
0,0,12,12,14,21,35,51,37,88,0.000333,0.150459,7,3159.638338,175.535463,451.376905,145.541635,7,0
0,0,11,11,15,21,36,56,38,94,0.000333,0.161991,7,3401.810651,188.989481,485.97295,150.842025,6,0
0,0,10,10,13,14,27,44,28,72,0.000333,0.114117,12,4108.222802,228.2346,342.3519,101.408685,4,0
0,0,12,12,14,21,35,51,37,88,0.000333,0.150459,7,3159.638338,175.535463,451.376905,145.541635,7,0
0,0,11,11,15,21,36,56,38,94,0.000333,0.161991,7,3401.810651,188.989481,485.97295,150.842025,6,0
0,0,26,26,24,47,71,129,94,223,0.000333,0.457131,24,32913.44658,1828.52481,1371.393608,371.104776,13,0
0,0,25,25,24,47,71,128,92,220,0.000333,0.450981,12,16235.3324,901.962911,1352.944366,371.104776,13,0
0,0,30,30,20,51,71,136,102,238,0.000333,0.48788,20,29272.79629,1626.26646,1463.639814,375.732254,9,0
0,0,29,29,20,51,71,135,100,235,0.000333,0.48173,10,14451.90573,802.883652,1445.190573,375.732254,9,0
0,0,16,16,13,19,32,60,52,112,0.000333,0.186667,12,6720,373.333333,560,128.816339,2,0
0,0,19,19,16,22,38,73,60,133,0.000333,0.232658,16,11167.58975,620.421653,697.974359,162.107496,3,0
0,0,10,10,13,18,31,42,33,75,0.000333,0.123855,6,2229.38834,123.854908,371.564723,123.164366,2,0
0,0,20,20,17,41,58,91,71,162,0.000333,0.316331,8,7591.94337,421.774632,948.992921,289.1465,7,0
0,0,19,19,17,41,58,90,69,159,0.000333,0.310473,8,7451.351826,413.96399,931.418978,289.1465,7,0
0,0,10,10,10,17,27,36,34,70,0.000333,0.110947,10,3328.421252,184.912292,332.842125,102.706149,2,0
0,0,13,13,14,20,34,49,42,91,0.000333,0.15432,14,6481.42766,360.079314,462.959119,139.741531,3,0
0,0,10,10,13,17,30,39,31,70,0.000333,0.114494,6,2060.89405,114.494114,343.482342,117.592585,2,0
0,0,30,30,20,50,70,133,102,235,0.000333,0.480127,20,28807.63018,1600.423899,1440.381509,368.631371,9,0
0,0,29,29,20,50,70,132,100,232,0.000333,0.473998,20,28439.8732,1579.992955,1421.99366,368.631371,9,0
0,0,23,23,17,43,60,102,79,181,0.000333,0.356382,8,8553.177582,475.176532,1069.147198,302.816253,7,0
0,0,7,7,8,14,22,18,21,39,0.000333,0.057973,4,695.671333,38.648407,173.917833,77.302969,1,0
0,0,17,17,11,20,31,60,55,115,0.000333,0.189911,10,5697.325757,316.518098,569.732576,124.49231,2,0
0,0,20,20,15,23,38,73,63,136,0.000333,0.237906,14,9992.053986,555.11411,713.718142,162.645284,3,0
0,0,10,10,13,19,32,43,33,76,0.000333,0.126667,6,2280,126.666667,380,128.816339,2,0
0,0,16,16,15,22,37,55,50,105,0.000333,0.182331,14,7657.896447,425.438692,546.992603,156.710855,3,0
0,0,4,4,10,13,23,19,19,38,0.000333,0.057298,5,859.476772,47.74871,171.895354,81.324997,2,0
0,0,7,7,9,15,24,24,27,51,0.000333,0.077944,4,935.33235,51.962908,233.833088,87.132684,2,0
0,0,8,8,9,15,24,25,29,54,0.000333,0.082529,4,990.3519,55.01955,247.587975,87.132684,2,0
0,0,8,8,13,19,32,31,32,63,0.000333,0.105,6,1890,105,315,128.816339,4,0
0,0,9,9,13,19,32,32,34,66,0.000333,0.11,6,1980,110,330,128.816339,4,0
0,0,29,29,20,49,69,127,113,240,0.000333,0.488682,20,29320.91739,1628.939855,1466.04587,361.559344,10,0
0,0,28,28,20,49,69,126,111,237,0.000333,0.482573,20,28954.40593,1608.578107,1447.720296,361.559344,10,0
0,0,30,30,24,52,76,134,122,256,0.000333,0.533156,24,38387.26664,2132.625925,1599.469443,406.461965,12,0
0,0,29,29,24,52,76,133,120,253,0.000333,0.526909,24,37937.41586,2107.634215,1580.725661,406.461965,12,0
0,0,4,4,10,13,23,19,19,38,0.000333,0.057298,5,859.476772,47.74871,171.895354,81.324997,2,0
0,0,14,14,13,16,29,50,40,90,0.000333,0.145739,12,5246.619475,291.47886,437.21829,112.105716,3,0
0,0,17,17,17,19,36,63,48,111,0.000333,0.191287,16,9181.786803,510.099267,573.861675,150.197491,4,0
0,0,10,10,14,15,29,40,29,69,0.000333,0.111734,7,2346.404821,130.355823,335.200689,111.906328,2,0
0,0,16,16,12,19,31,52,54,106,0.000333,0.175048,12,6301.737707,350.096539,525.144809,123.730173,3,0
0,0,19,19,16,22,38,65,62,127,0.000333,0.222162,16,10663.78871,592.432706,666.486794,162.107496,4,0
0,0,16,16,12,19,31,52,54,106,0.000333,0.175048,12,6301.737707,350.096539,525.144809,123.730173,3,0
0,0,19,19,16,22,38,65,62,127,0.000333,0.222162,16,10663.78871,592.432706,666.486794,162.107496,4,0
0,0,26,26,20,48,68,117,89,206,0.000333,0.418006,10,12540.17345,696.676303,1254.017345,354.516762,12,0
0,0,25,25,20,48,68,116,87,203,0.000333,0.411918,10,12357.54957,686.530532,1235.754957,354.516762,12,0
0,0,16,16,13,18,31,56,41,97,0.000333,0.160186,12,5766.684505,320.371361,480.557042,123.164366,3,0
0,0,19,19,16,21,37,69,49,118,0.000333,0.204905,16,9835.447954,546.413775,614.715497,156.238666,4,0
0,0,19,19,13,24,37,65,73,138,0.000333,0.239635,18,12940.28216,718.904564,718.904564,158.144816,4,0
0,0,20,20,13,24,37,66,75,141,0.000333,0.244844,18,13221.59264,734.532925,734.532925,158.144816,4,0
0,0,15,15,10,18,28,51,66,117,0.000333,0.187487,15,8436.907888,468.717105,562.460526,108.277931,2,0
0,0,18,18,14,21,35,64,74,138,0.000333,0.235947,21,14864.66218,825.814566,707.841056,145.541635,3,0
0,0,10,10,13,18,31,41,33,74,0.000333,0.122204,6,2199.663162,122.203509,366.610527,123.164366,2,0
0,0,15,15,14,24,38,56,52,108,0.000333,0.188925,14,7934.8664,440.825911,566.776171,163.342069,4,0
0,0,16,16,14,24,38,57,54,111,0.000333,0.194173,14,8155.279356,453.071075,582.519954,163.342069,4,0
0,0,17,17,12,20,32,54,58,112,0.000333,0.186667,12,6720,373.333333,560,129.458112,2,0
0,0,20,20,16,23,39,67,66,133,0.000333,0.234319,16,11247.33592,624.851996,702.958495,168.041925,3,0
0,0,10,10,13,19,32,41,35,76,0.000333,0.126667,6,2280,126.666667,380,128.816339,2,0
0,0,11,11,13,20,33,45,41,86,0.000333,0.144606,12,5205.814731,289.21193,433.817894,134.544278,2,0
0,0,12,12,13,20,33,46,43,89,0.000333,0.14965,12,5387.412919,299.300718,448.951077,134.544278,2,0
0,0,12,12,14,23,37,50,44,94,0.000333,0.16323,7,3427.820315,190.434462,489.688616,157.344894,3,0
0,0,13,13,14,23,37,51,46,97,0.000333,0.168439,14,7074.437671,393.024315,505.316976,157.344894,3,0
0,0,11,11,11,20,31,42,41,83,0.000333,0.137066,10,4111.982938,228.443497,411.198294,124.49231,2,0
0,0,12,12,11,20,31,43,43,86,0.000333,0.14202,10,4260.608827,236.70049,426.060883,124.49231,2,0
0,0,9,9,10,18,28,30,29,59,0.000333,0.094545,5,1418.169702,78.787206,283.63394,108.277931,2,0
0,0,7,7,8,14,22,17,20,37,0.000333,0.055,4,659.99588,36.666438,164.99897,77.302969,1,0
0,0,12,12,12,23,35,47,44,91,0.000333,0.155588,6,2800.588527,155.588252,466.764755,147.061475,3,0
0,0,13,13,12,23,35,48,46,94,0.000333,0.160718,12,5785.831243,321.435069,482.152604,147.061475,3,0
0,0,9,9,11,20,31,31,29,60,0.000333,0.099084,5,1486.258893,82.569939,297.251779,124.49231,2,0
0,0,12,12,11,18,29,36,40,76,0.000333,0.123069,10,3692.065556,205.114753,369.206556,113.112398,1,0
0,0,15,15,13,25,38,54,51,105,0.000333,0.183677,12,6612.388667,367.354926,551.032389,164.202121,3,0
0,0,13,13,12,16,28,45,35,80,0.000333,0.128196,12,4615.060725,256.392263,384.588394,107.01955,3,0
0,0,16,16,15,19,34,58,43,101,0.000333,0.171278,14,7193.672458,399.64847,513.833747,139.313982,4,0
0,0,13,13,11,16,27,44,35,79,0.000333,0.125212,10,3756.361127,208.686729,375.636113,102.053748,3,0
0,0,16,16,15,19,34,57,43,100,0.000333,0.169582,14,7122.447978,395.691554,508.746284,139.313982,4,0
0,0,16,16,17,35,52,79,64,143,0.000333,0.271721,8,6521.303038,362.294613,815.16288,249.011774,6,0
0,0,9,9,14,24,38,37,37,74,0.000333,0.129449,7,2718.426452,151.023692,388.346636,163.342069,2,0
0,0,15,15,13,19,32,51,48,99,0.000333,0.165,12,5940,330,495,128.816339,2,0
0,0,18,18,16,22,38,64,56,120,0.000333,0.209917,16,10076.02083,559.778935,629.751302,162.107496,3,0
0,0,10,10,13,19,32,42,33,75,0.000333,0.125,6,2250,125,375,128.816339,2,0
0,0,18,18,11,20,31,56,69,125,0.000333,0.206425,15,9289.118082,516.062116,619.274539,124.49231,2,0
0,0,21,21,15,23,38,69,77,146,0.000333,0.255399,21,16090.14576,893.896986,766.197417,162.645284,3,0
0,0,10,10,13,18,31,41,33,74,0.000333,0.122204,6,2199.663162,122.203509,366.610527,123.164366,2,0
0,0,14,14,11,18,29,46,45,91,0.000333,0.147359,10,4420.762706,245.597928,442.076271,113.112398,2,0
0,0,17,17,15,21,36,59,53,112,0.000333,0.193011,14,8106.442402,450.357911,579.0316,150.842025,3,0
0,0,10,10,13,18,31,41,33,74,0.000333,0.122204,6,2199.663162,122.203509,366.610527,123.164366,2,0
0,0,9,9,13,14,27,35,25,60,0.000333,0.095098,6,1711.759501,95.09775,285.29325,101.408685,4,0
0,0,9,9,13,14,27,34,25,59,0.000333,0.093513,6,1683.230176,93.512788,280.538363,101.408685,4,0
0,0,9,9,13,14,27,35,25,60,0.000333,0.095098,6,1711.759501,95.09775,285.29325,101.408685,4,0
0,0,9,9,13,14,27,34,25,59,0.000333,0.093513,6,1683.230176,93.512788,280.538363,101.408685,4,0
0,0,5,5,9,13,22,19,17,36,0.000333,0.053513,4,642.158153,35.675453,160.539538,76.635041,2,0
0,0,6,6,9,14,23,20,19,39,0.000333,0.058806,4,705.675665,39.204204,176.418916,81.832294,2,0
0,0,16,16,13,18,31,56,41,97,0.000333,0.160186,12,5766.684505,320.371361,480.557042,123.164366,3,0
0,0,19,19,16,21,37,69,49,118,0.000333,0.204905,16,9835.447954,546.413775,614.715497,156.238666,4,0
0,0,9,9,12,15,27,29,27,56,0.000333,0.088758,6,1597.642201,88.7579,266.2737,101.622909,2,0
0,0,9,9,10,18,28,32,34,66,0.000333,0.105762,5,1586.427124,88.13484,317.285425,108.277931,2,0
0,0,10,10,10,18,28,33,36,69,0.000333,0.110569,10,3317.074896,184.281939,331.70749,108.277931,2,0
0,0,10,10,11,21,32,37,37,74,0.000333,0.123333,5,1850,102.777778,370,130.292414,3,0
0,0,11,11,11,21,32,38,39,77,0.000333,0.128333,5,1925,106.944444,385,130.292414,3,0
0,0,5,5,9,13,22,18,19,37,0.000333,0.055,4,659.99588,36.666438,164.99897,76.635041,2,0
0,0,6,6,9,14,23,19,21,40,0.000333,0.060314,4,723.769913,40.20944,180.942478,81.832294,2,0
0,0,5,5,10,15,25,19,19,38,0.000333,0.058822,5,882.332676,49.018482,176.466535,91.82264,2,0
0,0,6,6,10,16,26,20,21,41,0.000333,0.064239,5,963.590142,53.532786,192.718028,97.219281,2,0
0,0,13,13,11,15,26,44,34,78,0.000333,0.122211,10,3666.34298,203.685721,366.634298,96.657107,3,0
0,0,16,16,15,18,33,57,42,99,0.000333,0.166465,14,6991.530249,388.418347,499.395018,133.662009,4,0
0,0,13,13,11,15,26,44,34,78,0.000333,0.122211,10,3666.34298,203.685721,366.634298,96.657107,3,0
0,0,16,16,15,18,33,57,42,99,0.000333,0.166465,14,6991.530249,388.418347,499.395018,133.662009,4,0
0,0,20,20,17,41,58,92,69,161,0.000333,0.314378,8,7545.079522,419.171085,943.13494,289.1465,7,0
0,0,19,19,17,41,58,91,67,158,0.000333,0.30852,8,7404.487978,411.360443,925.560997,289.1465,7,0
0,0,25,25,20,44,64,111,87,198,0.000333,0.396,10,11880,660,1188,326.653553,8,0
0,0,24,24,20,44,64,110,85,195,0.000333,0.39,10,11700,650,1170,326.653553,8,0
0,0,25,25,20,44,64,111,87,198,0.000333,0.396,10,11880,660,1188,326.653553,8,0
0,0,24,24,20,44,64,110,85,195,0.000333,0.39,10,11700,650,1170,326.653553,8,0
0,0,25,25,20,44,64,109,83,192,0.000333,0.384,10,11520,640,1152,326.653553,8,0
0,0,24,24,20,44,64,108,81,189,0.000333,0.378,10,11340,630,1134,326.653553,8,0
0,0,25,25,20,46,66,111,84,195,0.000333,0.392886,10,11786.56853,654.809363,1178.656853,340.522412,8,0
0,0,24,24,20,46,66,110,82,192,0.000333,0.386841,10,11605.23671,644.735373,1160.523671,340.522412,8,0
0,0,7,7,10,13,23,22,22,44,0.000333,0.066346,5,995.18363,55.287979,199.036726,81.324997,3,0
0,0,7,7,11,15,26,23,21,44,0.000333,0.06894,5,1034.096738,57.449819,206.819348,96.657107,2,0
0,0,11,11,13,16,29,40,37,77,0.000333,0.124688,12,4488.774439,249.376358,374.064537,112.105716,4,0
0,0,6,6,9,18,27,23,25,48,0.000333,0.076078,4,912.9384,50.7188,228.2346,103.587975,1,0
0,0,6,6,10,16,26,24,23,47,0.000333,0.07364,5,1104.603334,61.366852,220.920667,97.219281,1,0
0,0,7,7,13,22,35,39,31,70,0.000333,0.119683,6,2154.298867,119.68327,359.049811,146.213212,2,0
0,0,10,10,18,30,48,62,48,110,0.000333,0.204782,9,5529.112876,307.172938,614.345875,222.265368,3,0
0,0,6,6,11,16,27,26,27,53,0.000333,0.084003,5,1260.045188,70.00251,252.009038,102.053748,1,0
0,0,6,6,11,17,28,26,29,55,0.000333,0.088135,5,1322.022604,73.4457,264.404521,107.540616,1,0
0,0,7,7,14,23,37,41,37,78,0.000333,0.135446,7,2844.361538,158.020085,406.337363,157.344894,2,0
0,0,10,10,19,31,50,64,54,118,0.000333,0.221992,9,5993.775274,332.987515,665.97503,234.290708,3,0
0,0,9,9,19,29,48,61,51,112,0.000333,0.208505,9,5629.642201,312.7579,625.5158,221.592072,3,0
0,0,4,4,5,6,11,8,9,17,0.000333,0.019603,2,117.620675,6.534482,58.810338,27.119415,1,0
0,0,4,4,6,7,13,9,10,19,0.000333,0.023436,3,210.925064,11.718059,70.308355,35.161259,1,0
0,0,15,15,13,25,38,51,62,113,0.000333,0.197672,12,7116.189708,395.343873,593.015809,164.202121,1,0
0,0,22,22,18,33,51,90,94,184,0.000333,0.347909,18,18787.07273,1043.726263,1043.726263,241.523656,4,0
0,0,23,23,20,36,56,105,102,207,0.000333,0.400707,20,24042.44938,1335.691632,1202.122469,272.555862,5,0
0,0,26,26,25,42,67,128,119,247,0.000333,0.499441,24,35959.77672,1997.765373,1498.32403,342.573737,6,0
0,0,25,25,25,40,65,125,116,241,0.000333,0.483797,24,34833.37543,1935.187524,1451.390643,328.973529,6,0
0,0,58,58,22,62,84,268,199,467,0.000333,0.995071,33,98512.0038,5472.8891,2985.212236,467.267667,16,0
0,0,68,68,26,65,91,320,239,559,0.000333,1.212619,39,141876.431,7882.023942,3637.857204,513.665341,20,0
0,0,6,6,8,12,20,14,20,34,0.000333,0.048982,4,587.782221,32.654568,146.945555,67.01955,1,0
0,0,12,12,13,21,34,50,41,91,0.000333,0.15432,6,2777.754711,154.319706,462.959119,140.344382,4,0
0,0,6,6,9,17,26,24,24,48,0.000333,0.075207,4,902.484426,50.138024,225.621106,98.016193,1,0
0,0,6,6,9,18,27,24,25,49,0.000333,0.077663,4,931.95795,51.775442,232.989488,103.587975,1,0
0,0,7,7,12,24,36,39,33,72,0.000333,0.124078,6,2233.407601,124.0782,372.2346,153.05865,2,0
0,0,10,10,17,31,48,62,50,112,0.000333,0.208505,8,5004.126401,278.007022,625.5158,223.066954,3,0
0,0,9,9,17,29,46,59,47,106,0.000333,0.195166,8,4683.980539,260.221141,585.497567,210.368317,3,0
0,0,24,24,20,44,64,108,78,186,0.000333,0.372,10,11160,620,1116,326.653553,9,0
0,0,23,23,20,44,64,107,76,183,0.000333,0.366,10,10980,610,1098,326.653553,9,0
0,0,24,24,20,44,64,108,78,186,0.000333,0.372,10,11160,620,1116,326.653553,9,0
0,0,23,23,20,44,64,107,76,183,0.000333,0.366,10,10980,610,1098,326.653553,9,0
0,0,9,9,13,22,35,32,31,63,0.000333,0.107715,6,1938.86898,107.714943,323.14483,146.213212,3,0
0,0,10,10,15,20,35,41,38,79,0.000333,0.135071,7,2836.493508,157.582973,405.213358,145.041921,4,0
0,0,8,8,11,21,32,33,27,60,0.000333,0.1,5,1500,83.333333,300,130.292414,4,0
0,0,10,10,11,17,28,31,25,56,0.000333,0.089737,5,1346.059378,74.781077,269.211876,107.540616,4,0
0,0,12,12,11,17,28,37,27,64,0.000333,0.102557,5,1538.353575,85.464088,307.670715,107.540616,5,0
0,0,13,13,12,22,34,54,35,89,0.000333,0.150928,6,2716.705157,150.928064,452.784193,141.127046,6,0
0,0,11,11,14,15,29,39,27,66,0.000333,0.106876,7,2244.38722,124.688179,320.626746,111.906328,4,0
0,0,11,11,14,15,29,39,27,66,0.000333,0.106876,7,2244.38722,124.688179,320.626746,111.906328,4,0
0,0,7,7,7,13,20,20,23,43,0.000333,0.061948,3,557.528724,30.973818,185.842908,67.757201,1,0
0,0,7,7,8,14,22,18,24,42,0.000333,0.062432,4,749.184512,41.621362,187.296128,77.302969,1,0
0,0,7,7,8,15,23,21,23,44,0.000333,0.066346,4,796.146904,44.230384,199.036726,82.603359,1,0
0,0,13,13,11,20,31,43,48,91,0.000333,0.150277,10,4508.318642,250.462147,450.831864,124.49231,1,0
0,0,14,14,13,23,36,52,50,102,0.000333,0.175777,12,6327.988202,351.5549,527.33235,152.147641,2,0
0,0,5,5,12,11,23,19,14,33,0.000333,0.049759,6,895.665267,49.759182,149.277545,81.073298,3,0
0,0,5,5,12,11,23,19,14,33,0.000333,0.049759,6,895.665267,49.759182,149.277545,81.073298,3,0
0,0,5,5,12,11,23,19,14,33,0.000333,0.049759,6,895.665267,49.759182,149.277545,81.073298,3,0
0,0,6,6,11,19,30,24,27,51,0.000333,0.083417,5,1251.257102,69.514283,250.25142,118.764371,2,0
0,0,7,7,13,17,30,33,34,67,0.000333,0.109587,12,3945.140039,219.174447,328.76167,117.592585,3,0
0,0,5,5,9,18,27,25,23,48,0.000333,0.076078,4,912.9384,50.7188,228.2346,103.587975,3,0
0,0,7,7,9,14,23,23,21,44,0.000333,0.066346,4,796.146904,44.230384,199.036726,81.832294,3,0
0,0,9,9,9,14,23,29,23,52,0.000333,0.078408,4,940.900887,52.272271,235.225222,81.832294,4,0
0,0,10,10,10,19,29,46,31,77,0.000333,0.124688,5,1870.322683,103.906816,374.064537,113.929904,5,0
0,0,7,7,11,20,31,27,28,55,0.000333,0.090827,5,1362.403985,75.68911,272.480797,124.49231,3,0
0,0,8,8,13,18,31,36,35,71,0.000333,0.117249,6,2110.487628,117.249313,351.747938,123.164366,4,0
0,0,6,6,9,19,28,28,24,52,0.000333,0.083327,4,999.929824,55.551657,249.982456,109.239948,4,0
0,0,8,8,9,15,24,26,22,48,0.000333,0.073359,4,880.3128,48.906267,220.0782,87.132684,4,0
0,0,10,10,9,15,24,32,24,56,0.000333,0.085586,4,1027.0316,57.057311,256.7579,87.132684,5,0
0,0,11,11,10,20,30,49,32,81,0.000333,0.132486,5,1987.290691,110.405038,397.458138,119.657843,6,0
0,0,4,4,10,9,19,21,17,38,0.000333,0.053807,5,807.106228,44.839235,161.421246,61.748606,3,0
0,0,7,7,12,12,24,26,24,50,0.000333,0.076416,12,2750.9775,152.832083,229.248125,86.0391,3,0
0,0,7,7,9,15,24,23,21,44,0.000333,0.067246,4,806.9534,44.830744,201.73835,87.132684,2,0
0,0,10,10,14,18,32,36,29,65,0.000333,0.108333,7,2275,126.388889,325,128.361619,3,0
0,0,6,6,12,14,26,26,21,47,0.000333,0.07364,6,1325.524001,73.640222,220.920667,96.322519,3,0
0,0,11,11,12,22,34,44,36,80,0.000333,0.135666,6,2441.982164,135.665676,406.997027,141.127046,5,0
0,0,10,10,12,21,33,43,34,77,0.000333,0.129473,6,2330.510083,129.472782,388.418347,135.258216,5,0
0,0,9,9,12,20,32,42,32,74,0.000333,0.123333,6,2220,123.333333,370,129.458112,5,0
0,0,9,9,12,17,29,37,27,64,0.000333,0.103637,6,1865.464702,103.636928,310.910784,112.506418,4,0
0,0,9,9,12,14,26,33,24,57,0.000333,0.089308,6,1607.550384,89.308355,267.925064,96.322519,4,0
0,0,7,7,9,16,25,23,21,44,0.000333,0.06811,4,817.318689,45.406594,204.329672,92.529325,2,0
0,0,10,10,14,19,33,36,29,65,0.000333,0.109295,7,2295.199324,127.511074,327.885618,134.013592,3,0
0,0,6,6,12,15,27,26,21,47,0.000333,0.074493,6,1340.878276,74.493238,223.479713,101.622909,3,0
0,0,11,11,12,23,35,44,36,80,0.000333,0.136781,6,2462.055848,136.78088,410.342641,147.061475,5,0
0,0,10,10,12,22,34,43,34,77,0.000333,0.130578,6,2350.407833,130.578213,391.734639,141.127046,5,0
0,0,9,9,12,21,33,42,32,74,0.000333,0.124428,6,2239.710989,124.428388,373.285165,135.258216,5,0
0,0,7,7,11,12,23,25,17,42,0.000333,0.06333,5,949.948011,52.774889,189.989602,81.073298,2,0
0,0,10,10,15,15,30,38,25,63,0.000333,0.103045,7,2163.938753,120.21882,309.134108,117.206718,3,0
0,0,6,6,13,15,28,28,19,47,0.000333,0.075315,6,1355.674088,75.315227,225.945681,106.709075,3,0
0,0,10,10,15,18,33,47,29,76,0.000333,0.127791,7,2683.617671,149.089871,383.373953,133.662009,4,0
0,0,6,6,13,11,24,28,17,45,0.000333,0.068774,6,1237.939875,68.774438,206.323313,86.159464,3,0
0,0,9,9,12,18,30,37,27,64,0.000333,0.10468,6,1884.245989,104.680333,314.040998,118.0782,4,0
0,0,9,9,12,15,27,33,24,57,0.000333,0.090343,6,1626.171526,90.342863,271.028588,101.622909,4,0
0,0,10,10,14,18,32,45,30,75,0.000333,0.125,7,2625,145.833333,375,128.361619,5,0
0,0,9,9,14,17,31,44,28,72,0.000333,0.118901,7,2496.91494,138.717497,356.702134,122.789837,5,0
0,0,7,7,10,12,22,24,17,41,0.000333,0.060946,5,914.183482,50.787971,182.836696,76.238831,2,0
0,0,10,10,15,15,30,37,25,62,0.000333,0.101409,7,2129.590518,118.310584,304.227217,117.206718,3,0
0,0,6,6,12,15,27,27,19,46,0.000333,0.072908,6,1312.348951,72.908275,218.724825,101.622909,3,0
0,0,10,10,15,18,33,46,29,75,0.000333,0.12611,7,2648.306913,147.128162,378.329559,133.662009,4,0
0,0,6,6,13,11,24,27,17,44,0.000333,0.067246,6,1210.4301,67.246117,201.73835,86.159464,3,0
0,0,11,11,13,19,32,45,32,77,0.000333,0.128333,6,2310,128.333333,385,128.816339,5,0
0,0,10,10,13,18,31,44,30,74,0.000333,0.122204,6,2199.663162,122.203509,366.610527,123.164366,5,0
0,0,9,9,13,17,30,43,28,71,0.000333,0.11613,6,2090.335394,116.129744,348.389232,117.592585,5,0
0,0,9,9,13,19,32,35,34,69,0.000333,0.115,6,2070,115,345,128.816339,1,0
0,0,11,11,15,22,37,44,40,84,0.000333,0.145865,7,3063.158579,170.175477,437.594083,156.710855,2,0
0,0,8,8,13,15,28,30,27,57,0.000333,0.09134,6,1644.115383,91.339744,274.019231,106.709075,1,0
0,0,16,16,11,19,30,51,57,108,0.000333,0.176648,15,7949.162765,441.620154,529.944184,118.764371,2,0
0,0,19,19,15,22,37,64,65,129,0.000333,0.224006,14,9408.272778,522.681821,672.019484,156.710855,3,0
0,0,10,10,13,18,31,41,33,74,0.000333,0.122204,6,2199.663162,122.203509,366.610527,123.164366,2,0
0,0,15,15,10,18,28,51,66,117,0.000333,0.187487,15,8436.907888,468.717105,562.460526,108.277931,2,0
0,0,18,18,14,21,35,64,74,138,0.000333,0.235947,21,14864.66218,825.814566,707.841056,145.541635,3,0
0,0,10,10,13,18,31,41,33,74,0.000333,0.122204,6,2199.663162,122.203509,366.610527,123.164366,2,0
0,0,7,7,16,16,32,36,25,61,0.000333,0.101667,8,2440,135.555556,305,128,6,0
0,0,8,8,16,17,33,37,27,64,0.000333,0.107614,8,2582.729789,143.484988,322.841224,133.486868,6,0
0,0,7,7,16,16,32,36,25,61,0.000333,0.101667,8,2440,135.555556,305,128,6,0
0,0,8,8,16,17,33,37,27,64,0.000333,0.107614,8,2582.729789,143.484988,322.841224,133.486868,6,0
0,0,32,32,21,53,74,161,108,269,0.000333,0.556781,20,33406.85911,1855.936617,1670.342955,395.81845,11,0
0,0,17,17,17,24,41,83,56,139,0.000333,0.248233,16,11915.19566,661.955314,744.699729,179.525968,5,0
0,0,8,8,13,15,28,30,27,57,0.000333,0.09134,6,1644.115383,91.339744,274.019231,106.709075,1,0
0,0,15,15,12,16,28,49,37,86,0.000333,0.137811,12,4961.19028,275.621682,413.432523,107.01955,3,0
0,0,18,18,16,19,35,62,45,107,0.000333,0.182944,16,8781.332525,487.851807,548.833283,144.710623,4,0
0,0,15,15,12,16,28,49,37,86,0.000333,0.137811,12,4961.19028,275.621682,413.432523,107.01955,3,0
0,0,18,18,16,19,35,62,45,107,0.000333,0.182944,16,8781.332525,487.851807,548.833283,144.710623,4,0
0,0,26,26,19,45,64,114,87,201,0.000333,0.402,9,10854,603,1206,327.844012,9,0
0,0,22,22,21,42,63,102,73,175,0.000333,0.348675,10,10460.23987,581.124437,1046.023987,318.715998,10,0
0,0,21,21,21,42,63,101,71,172,0.000333,0.342697,10,10280.92147,571.162304,1028.092147,318.715998,10,0
0,0,22,22,21,42,63,102,73,175,0.000333,0.348675,10,10460.23987,581.124437,1046.023987,318.715998,10,0
0,0,21,21,21,42,63,101,71,172,0.000333,0.342697,10,10280.92147,571.162304,1028.092147,318.715998,10,0
0,0,7,7,11,21,32,27,29,56,0.000333,0.093333,5,1400,77.777778,280,130.292414,3,0
0,0,8,8,13,19,32,36,36,72,0.000333,0.12,6,2160,120,360,128.816339,4,0
0,0,6,6,9,20,29,28,25,53,0.000333,0.085824,4,1029.891971,57.216221,257.472993,114.967887,4,0
0,0,8,8,9,16,25,26,23,49,0.000333,0.07585,4,910.195813,50.566434,227.548953,92.529325,4,0
0,0,10,10,9,16,25,32,25,57,0.000333,0.088233,4,1058.799211,58.822178,264.699803,92.529325,5,0
0,0,11,11,10,21,31,49,33,82,0.000333,0.135415,5,2031.220487,112.845583,406.244097,125.457947,6,0
0,0,27,27,18,46,64,116,94,210,0.000333,0.42,18,22680,1260,1260,329.1425,10,0
0,0,23,23,18,44,62,108,81,189,0.000333,0.375114,9,10128.08792,562.671551,1125.343103,315.273641,10,0
0,0,21,21,18,45,63,106,80,186,0.000333,0.370591,9,10005.96659,555.887033,1111.774066,322.192039,9,0
0,0,7,7,9,11,20,20,17,37,0.000333,0.053304,4,639.645358,35.535853,159.91134,66.583073,1,0
0,0,13,13,12,14,26,45,34,79,0.000333,0.123778,12,4456.016853,247.556492,371.334738,96.322519,3,0
0,0,16,16,16,17,33,58,42,100,0.000333,0.168146,16,8071.030591,448.390588,504.439412,133.486868,4,0
0,0,10,10,14,15,29,40,29,69,0.000333,0.111734,7,2346.404821,130.355823,335.200689,111.906328,2,0
0,0,13,13,12,14,26,45,34,79,0.000333,0.123778,12,4456.016853,247.556492,371.334738,96.322519,3,0
0,0,16,16,16,17,33,58,42,100,0.000333,0.168146,16,8071.030591,448.390588,504.439412,133.486868,4,0
0,0,10,10,14,15,29,40,29,69,0.000333,0.111734,7,2346.404821,130.355823,335.200689,111.906328,2,0
0,0,8,8,13,17,30,32,28,60,0.000333,0.098138,6,1766.480614,98.137812,294.413436,117.592585,3,0
0,0,47,47,25,83,108,283,197,480,0.000333,1.080782,24,77816.30403,4323.128001,3242.346001,645.224678,20,0
0,0,13,13,15,30,45,84,56,140,0.000333,0.256286,7,5382.016034,299.000891,768.859433,205.810077,7,0
0,0,26,26,23,41,64,160,107,267,0.000333,0.534,22,35244,1958,1602,323.701557,10,0
0,0,19,19,15,24,39,84,65,149,0.000333,0.262508,14,11025.34903,612.51939,787.524931,168.642459,5,0
0,0,10,10,10,17,27,29,36,65,0.000333,0.103023,10,3090.676876,171.704271,309.067688,102.706149,1,0
0,0,6,6,10,13,23,23,21,44,0.000333,0.066346,5,995.18363,55.287979,199.036726,81.324997,3,0
0,0,10,10,11,16,27,31,34,65,0.000333,0.103023,10,3090.676876,171.704271,309.067688,102.053748,3,0
0,0,7,7,11,20,31,27,28,55,0.000333,0.090827,5,1362.403985,75.68911,272.480797,124.49231,3,0
0,0,8,8,13,18,31,36,35,71,0.000333,0.117249,6,2110.487628,117.249313,351.747938,123.164366,4,0
0,0,6,6,9,19,28,28,24,52,0.000333,0.083327,4,999.929824,55.551657,249.982456,109.239948,4,0
0,0,8,8,9,15,24,26,22,48,0.000333,0.073359,4,880.3128,48.906267,220.0782,87.132684,4,0
0,0,10,10,9,15,24,32,24,56,0.000333,0.085586,4,1027.0316,57.057311,256.7579,87.132684,5,0
0,0,11,11,10,20,30,49,32,81,0.000333,0.132486,5,1987.290691,110.405038,397.458138,119.657843,6,0
0,0,7,7,11,20,31,27,29,56,0.000333,0.092478,5,1387.174967,77.065276,277.434993,124.49231,3,0
0,0,8,8,13,18,31,36,36,72,0.000333,0.118901,12,4280.425612,237.801423,356.702134,123.164366,4,0
0,0,6,6,9,19,28,28,25,53,0.000333,0.08493,4,1019.159243,56.619958,254.789811,109.239948,4,0
0,0,8,8,9,15,24,26,23,49,0.000333,0.074888,4,898.65265,49.925147,224.663163,87.132684,4,0
0,0,10,10,9,15,24,32,25,57,0.000333,0.087114,4,1045.37145,58.076192,261.342863,87.132684,5,0
0,0,11,11,10,20,30,49,33,82,0.000333,0.134122,5,2011.825144,111.768064,402.365029,119.657843,6,0
0,0,7,7,11,20,31,27,28,55,0.000333,0.090827,5,1362.403985,75.68911,272.480797,124.49231,3,0
0,0,8,8,13,18,31,36,35,71,0.000333,0.117249,6,2110.487628,117.249313,351.747938,123.164366,4,0
0,0,6,6,9,19,28,28,24,52,0.000333,0.083327,4,999.929824,55.551657,249.982456,109.239948,4,0
0,0,8,8,9,15,24,26,22,48,0.000333,0.073359,4,880.3128,48.906267,220.0782,87.132684,4,0
0,0,10,10,9,15,24,32,24,56,0.000333,0.085586,4,1027.0316,57.057311,256.7579,87.132684,5,0
0,0,11,11,10,20,30,49,32,81,0.000333,0.132486,5,1987.290691,110.405038,397.458138,119.657843,6,0
0,0,9,9,12,22,34,31,31,62,0.000333,0.105141,6,1892.536177,105.140899,315.422696,141.127046,3,0
0,0,10,10,14,20,34,40,38,78,0.000333,0.132274,7,2777.754711,154.319706,396.822102,139.741531,4,0
0,0,8,8,10,21,31,32,27,59,0.000333,0.097433,5,1461.487912,81.193773,292.297582,125.457947,4,0
0,0,10,10,10,17,27,30,25,55,0.000333,0.087173,5,1307.594063,72.644115,261.518813,102.706149,4,0
0,0,12,12,10,17,27,36,27,63,0.000333,0.099853,5,1497.789563,83.210531,299.557913,102.706149,5,0
0,0,13,13,11,22,33,53,35,88,0.000333,0.147969,5,2219.533413,123.307412,443.906683,136.161243,6,0
0,0,10,10,15,15,30,41,34,75,0.000333,0.122672,14,5152.235125,286.235285,368.016795,117.206718,4,0
0,0,35,35,21,59,80,150,120,270,0.000333,0.568974,20,34138.41171,1896.578428,1706.920586,439.314606,13,0
0,0,34,34,21,59,80,149,118,267,0.000333,0.562652,20,33759.09603,1875.505335,1687.954801,439.314606,13,0
0,0,17,17,12,21,33,53,58,111,0.000333,0.186643,12,6719.132967,373.285165,559.927747,135.258216,2,0
0,0,20,20,16,24,40,66,66,132,0.000333,0.234165,16,11239.91214,624.439563,702.494509,174.0391,3,0
0,0,10,10,13,19,32,41,35,76,0.000333,0.126667,6,2280,126.666667,380,128.816339,2,0
0,0,25,25,22,48,70,118,84,202,0.000333,0.412705,11,13619.26686,756.625937,1238.115169,366.185696,9,0
0,0,24,24,22,48,70,117,82,199,0.000333,0.406576,11,13417.00052,745.388918,1219.72732,366.185696,9,0
0,0,25,25,22,48,70,118,84,202,0.000333,0.412705,11,13619.26686,756.625937,1238.115169,366.185696,9,0
0,0,24,24,22,48,70,117,82,199,0.000333,0.406576,11,13417.00052,745.388918,1219.72732,366.185696,9,0
0,0,25,25,21,49,70,118,85,203,0.000333,0.414748,10,12442.44452,691.246918,1244.244452,367.359448,9,0
0,0,24,24,21,49,70,117,83,200,0.000333,0.408619,10,12258.56603,681.031446,1225.856603,367.359448,9,0
0,0,25,25,21,49,70,118,85,203,0.000333,0.414748,10,12442.44452,691.246918,1244.244452,367.359448,9,0
0,0,24,24,21,49,70,117,83,200,0.000333,0.408619,10,12258.56603,681.031446,1225.856603,367.359448,9,0
0,0,25,25,21,48,69,118,84,202,0.000333,0.411307,10,12339.2194,685.512189,1233.92194,360.316866,9,0
0,0,24,24,21,48,69,117,82,199,0.000333,0.405199,10,12155.96367,675.331315,1215.596367,360.316866,9,0
0,0,25,25,21,48,69,118,84,202,0.000333,0.411307,10,12339.2194,685.512189,1233.92194,360.316866,9,0
0,0,24,24,21,48,69,117,82,199,0.000333,0.405199,10,12155.96367,675.331315,1215.596367,360.316866,9,0
0,0,25,25,21,48,69,118,84,202,0.000333,0.411307,10,12339.2194,685.512189,1233.92194,360.316866,9,0
0,0,24,24,21,48,69,117,82,199,0.000333,0.405199,10,12155.96367,675.331315,1215.596367,360.316866,9,0
0,0,25,25,21,48,69,118,84,202,0.000333,0.411307,10,12339.2194,685.512189,1233.92194,360.316866,9,0
0,0,24,24,21,48,69,117,82,199,0.000333,0.405199,10,12155.96367,675.331315,1215.596367,360.316866,9,0
0,0,25,25,21,49,70,118,85,203,0.000333,0.414748,10,12442.44452,691.246918,1244.244452,367.359448,9,0
0,0,24,24,21,49,70,117,83,200,0.000333,0.408619,10,12258.56603,681.031446,1225.856603,367.359448,9,0
0,0,25,25,21,49,70,118,85,203,0.000333,0.414748,10,12442.44452,691.246918,1244.244452,367.359448,9,0
0,0,24,24,21,49,70,117,83,200,0.000333,0.408619,10,12258.56603,681.031446,1225.856603,367.359448,9,0
0,0,13,13,12,16,28,45,35,80,0.000333,0.128196,12,4615.060725,256.392263,384.588394,107.01955,3,0
0,0,16,16,15,19,34,58,43,101,0.000333,0.171278,14,7193.672458,399.64847,513.833747,139.313982,4,0
0,0,13,13,11,16,27,44,35,79,0.000333,0.125212,10,3756.361127,208.686729,375.636113,102.053748,3,0
0,0,16,16,15,19,34,57,43,100,0.000333,0.169582,14,7122.447978,395.691554,508.746284,139.313982,4,0
0,0,13,13,11,15,26,44,34,78,0.000333,0.122211,10,3666.34298,203.685721,366.634298,96.657107,3,0
0,0,16,16,15,18,33,57,42,99,0.000333,0.166465,14,6991.530249,388.418347,499.395018,133.662009,4,0
0,0,13,13,11,15,26,44,34,78,0.000333,0.122211,10,3666.34298,203.685721,366.634298,96.657107,3,0
0,0,16,16,15,18,33,57,42,99,0.000333,0.166465,14,6991.530249,388.418347,499.395018,133.662009,4,0
0,0,12,12,11,20,31,58,38,96,0.000333,0.158534,5,2378.014229,132.111902,475.602846,124.49231,7,0
0,0,6,6,9,13,22,24,18,42,0.000333,0.062432,4,749.184512,41.621362,187.296128,76.635041,4,0
0,0,6,6,10,11,21,25,16,41,0.000333,0.060028,5,900.425072,50.023615,180.085014,71.273029,4,0
0,0,12,12,12,18,30,59,36,95,0.000333,0.155385,12,5593.855279,310.769738,466.154607,118.0782,7,0
0,0,6,6,10,11,21,25,16,41,0.000333,0.060028,5,900.425072,50.023615,180.085014,71.273029,4,0
0,0,12,12,12,18,30,59,36,95,0.000333,0.155385,12,5593.855279,310.769738,466.154607,118.0782,7,0
0,0,6,6,16,15,31,33,24,57,0.000333,0.09413,8,2259.113518,125.506307,282.38919,122.603359,5,0
0,0,7,7,16,16,32,34,26,60,0.000333,0.1,8,2400,133.333333,300,128,5,0
0,0,12,12,14,18,32,56,41,97,0.000333,0.161667,14,6790,377.222222,485,128.361619,5,0
0,0,6,6,9,10,19,17,15,32,0.000333,0.045311,4,543.734722,30.207485,135.93368,61.748606,1,0
0,0,20,20,17,41,58,92,69,161,0.000333,0.314378,8,7545.079522,419.171085,943.13494,289.1465,7,0
0,0,19,19,17,41,58,91,67,158,0.000333,0.30852,8,7404.487978,411.360443,925.560997,289.1465,7,0
0,0,20,20,18,40,58,93,68,161,0.000333,0.314378,9,8488.214462,471.56747,943.13494,287.935774,7,0
0,0,19,19,18,40,58,92,66,158,0.000333,0.30852,9,8330.048975,462.780499,925.560997,287.935774,7,0
0,0,5,5,10,12,22,20,18,38,0.000333,0.056486,5,847.292008,47.071778,169.458402,76.238831,3,0
0,0,9,9,11,15,26,28,31,59,0.000333,0.092442,10,2773.259434,154.069969,277.325943,96.657107,5,0
0,0,5,5,10,13,23,20,19,39,0.000333,0.058806,5,882.094581,49.005255,176.418916,81.324997,3,0
0,0,9,9,12,17,29,29,32,61,0.000333,0.098779,6,1778.021044,98.778947,296.336841,112.506418,4,0
0,0,17,17,16,24,40,60,61,121,0.000333,0.214651,16,10303.25279,572.402933,643.953299,174.0391,3,0
0,0,14,14,18,18,36,46,55,101,0.000333,0.174054,27,14098.38548,783.243638,522.162425,150.1173,2,0
0,0,12,12,11,13,24,42,33,75,0.000333,0.114624,10,3438.721876,191.040104,343.872188,86.159464,2,0
0,0,15,15,15,16,31,55,41,96,0.000333,0.158534,14,6658.439841,369.913325,475.602846,122.603359,3,0
0,0,10,10,14,15,29,40,29,69,0.000333,0.111734,7,2346.404821,130.355823,335.200689,111.906328,2,0
0,0,15,15,13,18,31,52,48,100,0.000333,0.16514,12,5945.035572,330.279754,495.419631,123.164366,2,0
0,0,18,18,16,21,37,65,56,121,0.000333,0.210115,16,10085.50172,560.305651,630.343857,156.238666,3,0
0,0,10,10,13,19,32,42,33,75,0.000333,0.125,6,2250,125,375,128.816339,2,0
0,0,13,13,15,21,36,51,35,86,0.000333,0.148205,7,3112.294851,172.905269,444.61355,150.842025,5,0
0,0,13,13,15,21,36,50,35,85,0.000333,0.146481,7,3076.105376,170.894743,439.443625,150.842025,5,0
0,0,22,22,24,44,68,109,78,187,0.000333,0.379452,12,13660.26662,758.903701,1138.355551,350.254091,11,0
0,0,21,21,24,44,68,108,76,184,0.000333,0.373364,12,13441.11795,746.728775,1120.093163,350.254091,11,0
0,0,22,22,24,44,68,109,78,187,0.000333,0.379452,12,13660.26662,758.903701,1138.355551,350.254091,11,0
0,0,21,21,24,44,68,108,76,184,0.000333,0.373364,12,13441.11795,746.728775,1120.093163,350.254091,11,0
0,0,13,13,11,14,25,45,34,79,0.000333,0.122288,10,3668.64639,203.813688,366.864639,91.356717,3,0
0,0,16,16,15,17,32,58,42,100,0.000333,0.166667,14,7000,388.888889,500,128.090227,4,0
0,0,13,13,11,14,25,45,34,79,0.000333,0.122288,10,3668.64639,203.813688,366.864639,91.356717,3,0
0,0,16,16,15,17,32,58,42,100,0.000333,0.166667,14,7000,388.888889,500,128.090227,4,0
0,0,9,9,12,16,28,38,31,69,0.000333,0.110569,6,1990.244938,110.569163,331.70749,107.01955,2,0
0,0,12,12,15,19,34,51,39,90,0.000333,0.152624,14,6410.20318,356.122399,457.871656,139.313982,3,0
0,0,10,10,14,19,33,43,34,77,0.000333,0.129473,7,2718.92843,151.051579,388.418347,134.013592,2,0
0,0,15,15,15,19,34,52,52,104,0.000333,0.176365,14,7407.345897,411.519216,529.096135,139.313982,2,0
0,0,18,18,18,22,40,65,60,125,0.000333,0.221747,18,11974.33821,665.241012,665.241012,173.166146,3,0
0,0,16,16,17,22,39,57,55,112,0.000333,0.197322,16,9471.440776,526.191154,591.965049,167.594364,2,0
0,0,9,9,10,14,24,27,29,56,0.000333,0.085586,10,2567.579,142.643278,256.7579,86.52225,1,0
0,0,47,47,25,84,109,283,193,476,0.000333,1.073885,24,77319.73773,4295.540985,3221.655739,653.051068,22,0
0,0,14,14,15,31,46,87,57,144,0.000333,0.265131,7,5567.750452,309.31947,795.392922,212.183445,8,0
0,0,24,24,23,40,63,154,101,255,0.000333,0.508069,22,33532.54037,1862.918909,1524.20638,316.919049,10,0
0,0,47,47,25,83,108,283,193,476,0.000333,1.071775,24,77167.83483,4287.101935,3215.326451,645.224678,22,0
0,0,14,14,15,31,46,87,57,144,0.000333,0.265131,7,5567.750452,309.31947,795.392922,212.183445,8,0
0,0,24,24,23,40,63,154,101,255,0.000333,0.508069,22,33532.54037,1862.918909,1524.20638,316.919049,10,0
0,0,6,6,13,16,29,26,22,48,0.000333,0.077728,6,1399.098527,77.727696,233.183088,112.105716,3,0
0,0,6,6,13,16,29,26,22,48,0.000333,0.077728,6,1399.098527,77.727696,233.183088,112.105716,3,0
0,0,13,13,12,15,27,45,35,80,0.000333,0.126797,12,4564.692002,253.594,380.391,101.622909,3,0
0,0,16,16,15,18,33,58,43,101,0.000333,0.169828,14,7132.773285,396.265182,509.483806,133.662009,4,0
0,0,13,13,11,15,26,44,35,79,0.000333,0.123778,10,3713.347377,206.297077,371.334738,96.657107,3,0
0,0,16,16,15,18,33,57,43,100,0.000333,0.168146,14,7062.151767,392.341765,504.439412,133.662009,4,0
0,0,10,10,12,17,29,32,29,61,0.000333,0.098779,6,1778.021044,98.778947,296.336841,112.506418,2,0
0,0,10,10,13,18,31,33,31,64,0.000333,0.10569,6,1902.411383,105.689521,317.068564,123.164366,2,0
0,0,10,10,11,17,28,37,32,69,0.000333,0.110569,5,1658.537448,92.140969,331.70749,107.540616,2,0
0,0,13,13,15,20,35,50,40,90,0.000333,0.153878,14,6462.896601,359.049811,461.635472,145.041921,3,0
0,0,10,10,14,15,29,40,29,69,0.000333,0.111734,7,2346.404821,130.355823,335.200689,111.906328,2,0
0,0,15,15,12,15,27,50,43,93,0.000333,0.147402,12,5306.454452,294.803025,442.204538,101.622909,2,0
0,0,18,18,16,18,34,63,51,114,0.000333,0.193324,16,9279.532222,515.529568,579.970764,139.05865,3,0
0,0,15,15,16,22,38,54,37,91,0.000333,0.159187,8,3820.49123,212.249513,477.561404,162.107496,5,0
0,0,15,15,16,21,37,54,37,91,0.000333,0.15802,8,3792.48205,210.693447,474.060256,156.238666,5,0
0,0,27,27,20,48,68,121,88,209,0.000333,0.424093,10,12722.79734,706.822074,1272.279734,354.516762,11,0
0,0,26,26,20,48,68,120,86,206,0.000333,0.418006,10,12540.17345,696.676303,1254.017345,354.516762,11,0
0,0,27,27,20,48,68,121,88,209,0.000333,0.424093,10,12722.79734,706.822074,1272.279734,354.516762,11,0
0,0,26,26,20,48,68,120,86,206,0.000333,0.418006,10,12540.17345,696.676303,1254.017345,354.516762,11,0
0,0,13,13,15,20,35,50,34,84,0.000333,0.14362,7,3016.018414,167.556579,430.859773,145.041921,5,0
0,0,13,13,15,20,35,50,34,84,0.000333,0.14362,7,3016.018414,167.556579,430.859773,145.041921,5,0
0,0,13,13,15,20,35,50,34,84,0.000333,0.14362,7,3016.018414,167.556579,430.859773,145.041921,5,0
0,0,13,13,15,20,35,50,34,84,0.000333,0.14362,7,3016.018414,167.556579,430.859773,145.041921,5,0
0,0,7,7,9,15,24,24,27,51,0.000333,0.077944,4,935.33235,51.962908,233.833088,87.132684,2,0
0,0,8,8,9,15,24,25,29,54,0.000333,0.082529,4,990.3519,55.01955,247.587975,87.132684,2,0
0,0,8,8,13,19,32,31,34,65,0.000333,0.108333,6,1950,108.333333,325,128.816339,4,0
0,0,9,9,13,19,32,32,36,68,0.000333,0.113333,6,2040,113.333333,340,128.816339,4,0
0,0,8,8,13,19,32,31,34,65,0.000333,0.108333,6,1950,108.333333,325,128.816339,4,0
0,0,9,9,13,19,32,32,36,68,0.000333,0.113333,6,2040,113.333333,340,128.816339,4,0
0,0,12,12,11,21,32,58,39,97,0.000333,0.161667,5,2425,134.722222,485,130.292414,7,0
0,0,6,6,9,14,23,24,19,43,0.000333,0.064838,4,778.052656,43.225148,194.513164,81.832294,4,0
0,0,6,6,11,12,23,26,17,43,0.000333,0.064838,5,972.565821,54.031434,194.513164,81.073298,4,0
0,0,12,12,12,19,31,60,37,97,0.000333,0.160186,6,2883.342253,160.185681,480.557042,123.730173,7,0
0,0,6,6,10,12,22,25,17,42,0.000333,0.062432,5,936.48064,52.026702,187.296128,76.238831,4,0
0,0,12,12,12,19,31,59,37,96,0.000333,0.158534,6,2853.617075,158.534282,475.602846,123.730173,7,0
0,0,9,9,10,15,25,36,30,66,0.000333,0.102165,10,3064.945085,170.274727,306.494509,91.82264,2,0
0,0,12,12,14,18,32,49,38,87,0.000333,0.145,14,6090,338.333333,435,128.361619,3,0
0,0,10,10,13,18,31,41,33,74,0.000333,0.122204,6,2199.663162,122.203509,366.610527,123.164366,2,0
0,0,14,14,11,18,29,46,45,91,0.000333,0.147359,10,4420.762706,245.597928,442.076271,113.112398,2,0
0,0,17,17,15,21,36,59,53,112,0.000333,0.193011,14,8106.442402,450.357911,579.0316,150.842025,3,0
0,0,10,10,13,18,31,41,33,74,0.000333,0.122204,6,2199.663162,122.203509,366.610527,123.164366,2,0
0,0,15,15,10,18,28,51,66,117,0.000333,0.187487,15,8436.907888,468.717105,562.460526,108.277931,2,0
0,0,18,18,14,21,35,64,74,138,0.000333,0.235947,21,14864.66218,825.814566,707.841056,145.541635,3,0
0,0,10,10,13,18,31,41,33,74,0.000333,0.122204,6,2199.663162,122.203509,366.610527,123.164366,2,0
0,0,10,10,11,17,28,37,32,69,0.000333,0.110569,5,1658.537448,92.140969,331.70749,107.540616,2,0
0,0,13,13,15,20,35,50,40,90,0.000333,0.153878,14,6462.896601,359.049811,461.635472,145.041921,3,0
0,0,15,15,14,23,37,63,50,113,0.000333,0.196223,14,8241.355224,457.853068,588.66823,157.344894,4,0
0,0,16,16,14,23,37,64,52,116,0.000333,0.201432,14,8460.152266,470.008459,604.29659,157.344894,4,0
0,0,16,16,13,19,32,60,52,112,0.000333,0.186667,12,6720,373.333333,560,128.816339,2,0
0,0,19,19,16,22,38,73,60,133,0.000333,0.232658,16,11167.58975,620.421653,697.974359,162.107496,3,0
0,0,10,10,13,18,31,42,33,75,0.000333,0.123855,6,2229.38834,123.854908,371.564723,123.164366,2,0
0,0,8,8,11,13,24,25,20,45,0.000333,0.068774,5,1031.616563,57.312031,206.323313,86.159464,2,0
0,0,8,8,11,13,24,25,20,45,0.000333,0.068774,5,1031.616563,57.312031,206.323313,86.159464,2,0
0,0,8,8,11,13,24,25,20,45,0.000333,0.068774,5,1031.616563,57.312031,206.323313,86.159464,2,0
0,0,26,26,18,45,63,113,91,204,0.000333,0.406455,18,21948.57188,1219.365104,1219.365104,322.192039,9,0
0,0,22,22,18,43,61,105,78,183,0.000333,0.361775,9,9767.924395,542.662466,1085.324933,308.388034,9,0
0,0,7,7,9,16,25,23,21,44,0.000333,0.06811,4,817.318689,45.406594,204.329672,92.529325,2,0
0,0,10,10,14,19,33,36,29,65,0.000333,0.109295,7,2295.199324,127.511074,327.885618,134.013592,3,0
0,0,6,6,12,15,27,26,21,47,0.000333,0.074493,6,1340.878276,74.493238,223.479713,101.622909,3,0
0,0,11,11,12,23,35,44,36,80,0.000333,0.136781,6,2462.055848,136.78088,410.342641,147.061475,5,0
0,0,10,10,12,22,34,43,34,77,0.000333,0.130578,6,2350.407833,130.578213,391.734639,141.127046,5,0
0,0,9,9,12,21,33,42,32,74,0.000333,0.124428,6,2239.710989,124.428388,373.285165,135.258216,5,0
0,0,6,6,13,15,28,28,19,47,0.000333,0.075315,6,1355.674088,75.315227,225.945681,106.709075,3,0
0,0,5,5,13,14,27,27,17,44,0.000333,0.069738,6,1255.290301,69.73835,209.21505,101.408685,3,0
0,0,8,8,11,17,28,29,26,55,0.000333,0.088135,5,1322.022604,73.4457,264.404521,107.540616,2,0
0,0,11,11,17,20,37,42,34,76,0.000333,0.131973,8,3167.347646,175.963758,395.918456,155.92543,3,0
0,0,7,7,15,17,32,32,26,58,0.000333,0.096667,7,2030,112.777778,290,128.090227,3,0
0,0,12,12,15,23,38,50,41,91,0.000333,0.159187,7,3342.929826,185.718324,477.561404,162.645284,5,0
0,0,11,11,15,22,37,49,39,88,0.000333,0.152811,7,3209.023273,178.279071,458.431896,156.710855,5,0
0,0,10,10,15,21,36,48,37,85,0.000333,0.146481,7,3076.105376,170.894743,439.443625,150.842025,5,0
0,0,8,8,12,13,25,30,22,52,0.000333,0.080494,6,1448.883131,80.493507,241.480522,91.125266,2,0
0,0,11,11,18,16,34,43,30,73,0.000333,0.123795,9,3342.463087,185.692394,371.384787,139.05865,3,0
0,0,7,7,15,15,30,33,24,57,0.000333,0.093231,7,1957.849348,108.769408,279.692764,117.206718,3,0
0,0,11,11,18,18,36,52,34,86,0.000333,0.148205,9,4001.521951,222.306775,444.61355,150.1173,4,0
0,0,7,7,16,13,29,33,22,55,0.000333,0.089063,8,2137.511638,118.750647,267.188955,112.105716,3,0
0,0,12,12,16,19,35,51,37,88,0.000333,0.150459,8,3611.015244,200.611958,451.376905,144.710623,5,0
0,0,11,11,16,18,34,50,35,85,0.000333,0.144145,8,3459.474732,192.193041,432.434342,139.05865,5,0
0,0,10,10,16,17,33,49,33,82,0.000333,0.13788,8,3309.122542,183.840141,413.640318,133.486868,5,0
0,0,11,11,10,19,29,37,44,81,0.000333,0.131165,10,3934.964606,218.609145,393.496461,113.929904,2,0
0,0,12,12,10,19,29,38,46,84,0.000333,0.136023,10,4080.704036,226.70578,408.070404,113.929904,2,0
0,0,12,12,11,22,33,42,49,91,0.000333,0.153013,10,4590.398649,255.022147,459.039865,136.161243,3,0
0,0,13,13,11,22,33,43,51,94,0.000333,0.158058,10,4741.730472,263.429471,474.173047,136.161243,3,0
0,0,33,33,21,56,77,144,111,255,0.000333,0.532677,10,15980.30568,887.79476,1598.030568,417.450542,13,0
0,0,32,32,21,56,77,143,109,252,0.000333,0.52641,10,15792.30208,877.350116,1579.230208,417.450542,13,0
0,0,14,14,11,18,29,46,45,91,0.000333,0.147359,10,4420.762706,245.597928,442.076271,113.112398,2,0
0,0,17,17,15,21,36,59,53,112,0.000333,0.193011,14,8106.442402,450.357911,579.0316,150.842025,3,0
0,0,10,10,13,18,31,41,33,74,0.000333,0.122204,6,2199.663162,122.203509,366.610527,123.164366,2,0
0,0,7,7,17,16,33,36,26,62,0.000333,0.104251,8,2502.019483,139.001082,312.752435,133.486868,5,0
0,0,8,8,17,17,34,37,28,65,0.000333,0.110228,8,2645.480677,146.971149,330.685085,138.973737,5,0
0,0,17,17,12,21,33,53,58,111,0.000333,0.186643,12,6719.132967,373.285165,559.927747,135.258216,2,0
0,0,20,20,16,24,40,66,66,132,0.000333,0.234165,16,11239.91214,624.439563,702.494509,174.0391,3,0
0,0,10,10,13,19,32,41,35,76,0.000333,0.126667,6,2280,126.666667,380,128.816339,2,0
0,0,7,7,7,12,19,18,20,38,0.000333,0.053807,3,484.263737,26.903541,161.421246,62.671034,1,0
0,0,7,7,8,14,22,18,21,39,0.000333,0.057973,4,695.671333,38.648407,173.917833,77.302969,1,0
0,0,18,18,15,23,38,68,58,126,0.000333,0.220413,14,9257.344134,514.296896,661.238867,162.645284,3,0
0,0,14,14,11,17,28,47,45,92,0.000333,0.147426,10,4422.766528,245.709252,442.276653,107.540616,2,0
0,0,17,17,15,20,35,60,53,113,0.000333,0.193203,14,8114.525733,450.806985,579.608981,145.041921,3,0
0,0,10,10,13,18,31,41,33,74,0.000333,0.122204,6,2199.663162,122.203509,366.610527,123.164366,2,0
0,0,27,27,17,47,64,115,99,214,0.000333,0.428,16,20544,1141.333333,1284,330.552544,9,0
0,0,26,26,17,47,64,114,97,211,0.000333,0.422,16,20256,1125.333333,1266,330.552544,9,0
0,0,28,28,21,50,71,122,106,228,0.000333,0.467381,20,28042.84687,1557.935937,1402.142343,374.431475,11,0
0,0,27,27,21,50,71,121,104,225,0.000333,0.461231,20,27673.86204,1537.43678,1383.693102,374.431475,11,0
0,0,23,23,21,56,77,148,113,261,0.000333,0.54521,20,32712.62574,1817.368097,1635.631287,417.450542,12,0
0,0,13,13,15,31,46,84,56,140,0.000333,0.257766,7,5413.090717,300.727262,773.298674,212.183445,7,0
0,0,23,23,21,28,49,95,80,175,0.000333,0.327525,20,19651.48445,1091.749136,982.574223,226.844604,13,0
0,0,13,13,14,18,32,41,54,95,0.000333,0.158333,21,9975,554.166667,475,128.361619,8,0
0,0,32,32,23,56,79,183,126,309,0.000333,0.649289,22,42853.10153,2380.727863,1947.868251,429.253801,15,0
0,0,14,14,15,31,46,87,57,144,0.000333,0.265131,7,5567.750452,309.31947,795.392922,212.183445,8,0
0,0,32,32,23,55,78,183,126,309,0.000333,0.647396,22,42728.16428,2373.786905,1942.189286,422.016709,15,0
0,0,14,14,15,31,46,87,57,144,0.000333,0.265131,7,5567.750452,309.31947,795.392922,212.183445,8,0
0,0,31,31,23,55,78,180,125,305,0.000333,0.639016,22,42175.04889,2343.058272,1917.047677,422.016709,14,0
0,0,14,14,15,31,46,87,57,144,0.000333,0.265131,7,5567.750452,309.31947,795.392922,212.183445,8,0
0,0,31,31,23,55,78,180,125,305,0.000333,0.639016,22,42175.04889,2343.058272,1917.047677,422.016709,14,0
0,0,14,14,15,31,46,87,57,144,0.000333,0.265131,7,5567.750452,309.31947,795.392922,212.183445,8,0
0,0,9,9,13,22,35,38,39,77,0.000333,0.131652,6,2369.728754,131.651597,394.954792,146.213212,3,0
0,0,27,27,23,46,69,166,118,284,0.000333,0.578274,22,38166.06081,2120.336711,1734.820946,358.125775,10,0
0,0,48,48,25,88,113,289,208,497,0.000333,1.129876,24,81351.09466,4519.505259,3389.628944,684.526387,20,0
0,0,13,13,14,34,48,87,61,148,0.000333,0.275525,7,5786.021151,321.445619,826.57445,226.276706,7,0
0,0,6,6,9,10,19,17,15,32,0.000333,0.045311,4,543.734722,30.207485,135.93368,61.748606,1,0
0,0,6,6,9,10,19,17,15,32,0.000333,0.045311,4,543.734722,30.207485,135.93368,61.748606,1,0
0,0,6,6,9,10,19,17,15,32,0.000333,0.045311,4,543.734722,30.207485,135.93368,61.748606,1,0
0,0,8,8,16,18,34,43,32,75,0.000333,0.127187,8,3052.477705,169.582095,381.559713,139.05865,6,0
0,0,9,9,16,18,34,44,34,78,0.000333,0.132274,8,3174.576813,176.365378,396.822102,139.05865,6,0
0,0,32,32,23,56,79,184,128,312,0.000333,0.655593,22,43269.15106,2403.841725,1966.779593,429.253801,15,0
0,0,14,14,16,32,48,88,58,146,0.000333,0.271802,8,6523.236201,362.402011,815.404525,224,8,0
0,0,17,17,21,35,56,109,77,186,0.000333,0.360056,20,21603.36031,1200.186684,1080.168016,271.763571,7,0
0,0,32,32,23,56,79,183,128,311,0.000333,0.653492,22,43130.46788,2396.137104,1960.475813,429.253801,15,0
0,0,14,14,15,32,47,87,58,145,0.000333,0.268472,7,5637.907684,313.217094,805.415383,218.603359,8,0
0,0,17,17,21,35,56,109,77,186,0.000333,0.360056,20,21603.36031,1200.186684,1080.168016,271.763571,7,0
0,0,31,31,23,56,79,181,126,307,0.000333,0.645087,22,42575.73517,2365.318621,1935.26069,429.253801,14,0
0,0,14,14,16,32,48,88,58,146,0.000333,0.271802,8,6523.236201,362.402011,815.404525,224,8,0
0,0,17,17,21,35,56,109,77,186,0.000333,0.360056,20,21603.36031,1200.186684,1080.168016,271.763571,7,0
0,0,31,31,23,56,79,180,126,306,0.000333,0.642986,22,42437.052,2357.614,1928.956909,429.253801,14,0
0,0,14,14,15,32,47,87,58,145,0.000333,0.268472,7,5637.907684,313.217094,805.415383,218.603359,8,0
0,0,17,17,21,35,56,109,77,186,0.000333,0.360056,20,21603.36031,1200.186684,1080.168016,271.763571,7,0
0,0,31,31,21,51,72,154,101,255,0.000333,0.524444,10,15733.30875,874.072709,1573.330875,381.532358,10,0
0,0,19,19,17,26,43,89,59,148,0.000333,0.267696,16,12849.39494,713.855274,803.087184,191.698301,6,0
0,0,10,10,16,17,33,36,30,66,0.000333,0.110977,8,2663.440095,147.968894,332.930012,133.486868,2,0
0,0,6,6,9,10,19,17,15,32,0.000333,0.045311,4,543.734722,30.207485,135.93368,61.748606,1,0
0,0,17,17,16,23,39,80,54,134,0.000333,0.236081,16,11331.90236,629.550131,708.243897,168.041925,5,0
0,0,8,8,11,15,26,25,26,51,0.000333,0.079907,5,1198.612128,66.589563,239.722426,96.657107,1,0
0,0,5,5,12,12,24,20,15,35,0.000333,0.053491,6,962.842125,53.491229,160.473688,86.0391,3,0
0,0,5,5,11,12,23,19,15,34,0.000333,0.051267,5,769.005533,42.72253,153.801107,81.073298,3,0
0,0,5,5,11,11,22,19,14,33,0.000333,0.049054,5,735.806217,40.878123,147.161243,76.107496,3,0
0,0,5,5,11,11,22,19,14,33,0.000333,0.049054,5,735.806217,40.878123,147.161243,76.107496,3,0
0,0,5,5,12,11,23,20,15,35,0.000333,0.052775,6,949.948011,52.774889,158.324668,81.073298,3,0
0,0,5,5,11,11,22,19,15,34,0.000333,0.05054,5,758.103375,42.116854,151.620675,76.107496,3,0
0,0,29,29,21,49,70,148,98,246,0.000333,0.502601,20,30156.07244,1675.337358,1507.803622,367.359448,10,0
0,0,17,17,17,24,41,83,56,139,0.000333,0.248233,16,11915.19566,661.955314,744.699729,179.525968,6,0
0,0,8,8,13,15,28,30,27,57,0.000333,0.09134,6,1644.115383,91.339744,274.019231,106.709075,2,0
0,0,12,12,10,20,30,42,49,91,0.000333,0.148842,10,4465.270442,248.07058,446.527044,119.657843,2,0
0,0,13,13,10,20,30,43,51,94,0.000333,0.153749,10,4612.47716,256.248731,461.247716,119.657843,2,0
0,0,16,16,10,22,32,52,69,121,0.000333,0.201667,15,9075,504.166667,605,131.326777,2,0
0,0,17,17,10,22,32,53,71,124,0.000333,0.206667,15,9300,516.666667,620,131.326777,2,0
0,0,32,32,23,55,78,184,128,312,0.000333,0.653682,22,43143.00083,2396.833379,1961.045492,422.016709,15,0
0,0,14,14,16,31,47,88,58,146,0.000333,0.270323,8,6487.759779,360.431099,810.969972,217.580086,8,0
0,0,17,17,21,35,56,109,77,186,0.000333,0.360056,20,21603.36031,1200.186684,1080.168016,271.763571,7,0
0,0,32,32,23,55,78,183,128,311,0.000333,0.651587,22,43004.72198,2389.151221,1954.76009,422.016709,15,0
0,0,14,14,15,31,46,87,58,145,0.000333,0.266972,7,5606.415385,311.467521,800.916484,212.183445,8,0
0,0,17,17,21,35,56,109,77,186,0.000333,0.360056,20,21603.36031,1200.186684,1080.168016,271.763571,7,0
0,0,31,31,23,55,78,181,126,307,0.000333,0.643206,22,42451.60659,2358.422588,1929.618481,422.016709,14,0
0,0,14,14,16,31,47,88,58,146,0.000333,0.270323,8,6487.759779,360.431099,810.969972,217.580086,8,0
0,0,17,17,21,35,56,109,77,186,0.000333,0.360056,20,21603.36031,1200.186684,1080.168016,271.763571,7,0
0,0,31,31,23,55,78,180,126,306,0.000333,0.641111,22,42313.32774,2350.74043,1923.333079,422.016709,14,0
0,0,14,14,15,31,46,87,58,145,0.000333,0.266972,7,5606.415385,311.467521,800.916484,212.183445,8,0
0,0,17,17,21,35,56,109,77,186,0.000333,0.360056,20,21603.36031,1200.186684,1080.168016,271.763571,7,0
0,0,14,14,11,15,26,45,39,84,0.000333,0.131612,10,3948.369363,219.353854,394.836936,96.657107,2,0
0,0,17,17,15,18,33,58,47,105,0.000333,0.176554,14,7415.259355,411.958853,529.661383,133.662009,3,0
0,0,26,26,19,45,64,114,87,201,0.000333,0.402,9,10854,603,1206,327.844012,9,0
0,0,22,22,19,41,60,106,76,182,0.000333,0.358351,9,9675.486796,537.527044,1075.054088,300.370255,9,0
0,0,15,15,12,14,26,51,43,94,0.000333,0.14728,18,7953.144003,441.841334,441.841334,96.322519,2,0
0,0,18,18,16,17,33,64,51,115,0.000333,0.193368,24,13922.52777,773.473765,580.105324,133.486868,3,0
0,0,10,10,14,15,29,40,29,69,0.000333,0.111734,7,2346.404821,130.355823,335.200689,111.906328,2,0
0,0,14,14,11,14,25,46,39,85,0.000333,0.131576,10,3947.277761,219.293209,394.727776,91.356717,2,0
0,0,17,17,15,17,32,59,47,106,0.000333,0.176667,14,7420,412.222222,530,128.090227,3,0
0,0,10,10,14,15,29,40,29,69,0.000333,0.111734,7,2346.404821,130.355823,335.200689,111.906328,2,0
0,0,11,11,13,12,25,48,37,85,0.000333,0.131576,18,7105.09997,394.727776,394.727776,91.125266,10,0
0,0,11,11,13,12,25,48,37,85,0.000333,0.131576,18,7105.09997,394.727776,394.727776,91.125266,10,0
0,0,9,9,13,12,25,34,28,62,0.000333,0.095973,12,3455.029005,191.946056,287.919084,91.125266,8,0
0,0,9,9,13,12,25,34,28,62,0.000333,0.095973,12,3455.029005,191.946056,287.919084,91.125266,8,0
0,0,11,11,13,12,25,48,37,85,0.000333,0.131576,18,7105.09997,394.727776,394.727776,91.125266,10,0
0,0,11,11,13,12,25,48,37,85,0.000333,0.131576,18,7105.09997,394.727776,394.727776,91.125266,10,0
0,0,9,9,13,12,25,34,28,62,0.000333,0.095973,12,3455.029005,191.946056,287.919084,91.125266,8,0
0,0,9,9,13,12,25,34,28,62,0.000333,0.095973,12,3455.029005,191.946056,287.919084,91.125266,8,0
0,0,18,18,13,12,25,88,64,152,0.000333,0.235289,30,21175.98423,1176.443568,705.866141,91.125266,17,0
0,0,14,14,13,12,25,60,46,106,0.000333,0.164083,18,8860.47761,492.248756,492.248756,91.125266,13,0
0,0,13,13,12,15,27,46,35,81,0.000333,0.128382,12,4621.750652,256.763925,385.145888,101.622909,3,0
0,0,16,16,15,18,33,59,43,102,0.000333,0.171509,14,7203.394802,400.1886,514.5282,133.662009,4,0
0,0,10,10,14,15,29,40,29,69,0.000333,0.111734,7,2346.404821,130.355823,335.200689,111.906328,2,0
0,0,13,13,11,15,26,45,35,80,0.000333,0.125345,10,3760.351775,208.908432,376.035177,96.657107,3,0
0,0,16,16,15,18,33,58,43,101,0.000333,0.169828,14,7132.773285,396.265182,509.483806,133.662009,4,0
0,0,10,10,14,15,29,40,29,69,0.000333,0.111734,7,2346.404821,130.355823,335.200689,111.906328,2,0
0,0,13,13,12,15,27,46,35,81,0.000333,0.128382,12,4621.750652,256.763925,385.145888,101.622909,3,0
0,0,16,16,15,18,33,59,43,102,0.000333,0.171509,14,7203.394802,400.1886,514.5282,133.662009,4,0
0,0,10,10,14,15,29,40,29,69,0.000333,0.111734,7,2346.404821,130.355823,335.200689,111.906328,2,0
0,0,13,13,11,15,26,45,35,80,0.000333,0.125345,10,3760.351775,208.908432,376.035177,96.657107,3,0
0,0,16,16,15,18,33,58,43,101,0.000333,0.169828,14,7132.773285,396.265182,509.483806,133.662009,4,0
0,0,10,10,14,15,29,40,29,69,0.000333,0.111734,7,2346.404821,130.355823,335.200689,111.906328,2,0
0,0,30,30,18,51,69,131,106,237,0.000333,0.482573,18,26058.96533,1447.720296,1447.720296,364.352342,9,0
0,0,29,29,18,51,69,130,104,234,0.000333,0.476465,18,25729.10501,1429.394723,1429.394723,364.352342,9,0
0,0,26,26,17,47,64,115,89,204,0.000333,0.408,8,9792,544,1224,330.552544,9,0
0,0,7,7,8,14,22,18,21,39,0.000333,0.057973,4,695.671333,38.648407,173.917833,77.302969,1,0
0,0,13,13,10,19,29,40,44,84,0.000333,0.136023,10,4080.704036,226.70578,408.070404,113.929904,1,0
0,0,21,21,18,45,63,106,80,186,0.000333,0.370591,9,10005.96659,555.887033,1111.774066,322.192039,9,0
0,0,21,21,18,46,64,106,82,188,0.000333,0.376,9,10152,564,1128,329.1425,9,0
0,0,15,15,15,20,35,51,52,103,0.000333,0.176105,14,7396.42611,410.912562,528.316151,145.041921,2,0
0,0,18,18,18,23,41,64,60,124,0.000333,0.221445,18,11958.05607,664.336449,664.336449,179.100575,3,0
0,0,16,16,17,23,40,56,55,111,0.000333,0.196911,16,9451.744297,525.096905,590.734019,173.528793,2,0
0,0,33,33,23,58,81,146,109,255,0.000333,0.538887,11,17783.27926,987.959959,1616.661751,443.804823,13,0
0,0,32,32,23,58,81,145,107,252,0.000333,0.532547,11,17574.06421,976.3369,1597.642201,443.804823,13,0
0,0,13,13,12,14,26,45,34,79,0.000333,0.123778,12,4456.016853,247.556492,371.334738,96.322519,3,0
0,0,16,16,16,17,33,58,42,100,0.000333,0.168146,16,8071.030591,448.390588,504.439412,133.486868,4,0
0,0,10,10,14,15,29,40,29,69,0.000333,0.111734,7,2346.404821,130.355823,335.200689,111.906328,2,0
0,0,13,13,12,14,26,45,34,79,0.000333,0.123778,12,4456.016853,247.556492,371.334738,96.322519,3,0
0,0,16,16,16,17,33,58,42,100,0.000333,0.168146,16,8071.030591,448.390588,504.439412,133.486868,4,0
0,0,10,10,14,15,29,40,29,69,0.000333,0.111734,7,2346.404821,130.355823,335.200689,111.906328,2,0
0,0,14,14,13,15,28,51,40,91,0.000333,0.145823,12,5249.631575,291.646199,437.469298,106.709075,3,0
0,0,17,17,17,18,35,64,48,112,0.000333,0.191493,16,9191.675166,510.64862,574.479698,144.545518,4,0
0,0,6,6,12,18,30,30,21,51,0.000333,0.083417,6,1501.508522,83.41714,250.25142,118.0782,3,0
0,0,6,6,12,18,30,30,21,51,0.000333,0.083417,6,1501.508522,83.41714,250.25142,118.0782,3,0
0,0,8,8,10,17,27,26,23,49,0.000333,0.077663,5,1164.947438,64.719302,232.989488,102.706149,2,0
0,0,16,16,15,35,50,100,66,166,0.000333,0.312293,7,6558.160893,364.342272,936.880128,238.128265,8,0
0,0,18,18,15,38,53,109,74,183,0.000333,0.349403,7,7337.466102,407.637006,1048.209443,258.024604,8,0
0,0,7,7,10,17,27,23,20,43,0.000333,0.068153,5,1022.300813,56.79449,204.460163,102.706149,2,0
0,0,11,11,18,28,46,60,44,104,0.000333,0.191483,9,5170.053991,287.225222,574.450443,209.664588,4,0
0,0,6,6,13,15,28,31,18,49,0.000333,0.07852,6,1413.362347,78.52013,235.560391,106.709075,3,0
0,0,16,16,19,25,44,98,67,165,0.000333,0.300269,18,16214.51191,900.806217,900.806217,196.807027,5,0
0,0,6,6,13,15,28,31,18,49,0.000333,0.07852,6,1413.362347,78.52013,235.560391,106.709075,3,0
0,0,8,8,11,14,25,27,20,47,0.000333,0.072754,5,1091.306205,60.628122,218.261241,91.356717,2,0
0,0,16,16,16,32,48,101,63,164,0.000333,0.305311,8,7327.470801,407.081711,915.93385,224,8,0
0,0,18,18,16,35,51,110,71,181,0.000333,0.342236,16,16427.34379,912.630211,1026.708987,243.524906,8,0
0,0,7,7,11,14,25,24,17,41,0.000333,0.063466,5,951.990519,52.888362,190.398104,91.356717,2,0
0,0,15,15,16,32,48,98,60,158,0.000333,0.294141,8,7059.392601,392.188478,882.424075,224,8,0
0,0,17,17,16,35,51,107,68,175,0.000333,0.330891,8,7941.395479,441.188638,992.674435,243.524906,8,0
0,0,11,11,19,25,44,61,41,102,0.000333,0.185621,9,5011.758226,278.431013,556.862025,196.807027,4,0
0,0,7,7,9,16,25,18,19,37,0.000333,0.057274,4,687.290716,38.182818,171.822679,92.529325,2,0
0,0,7,7,10,13,23,19,16,35,0.000333,0.052775,5,791.623342,43.979075,158.324668,81.324997,2,0
0,0,15,15,15,30,45,93,59,152,0.000333,0.278254,7,5843.331694,324.629539,834.761671,205.810077,8,0
0,0,17,17,15,33,48,102,67,169,0.000333,0.31462,14,13214.02128,734.112293,943.858663,225.068365,8,0
0,0,7,7,10,13,23,19,16,35,0.000333,0.052775,5,791.623342,43.979075,158.324668,81.324997,2,0
0,0,15,15,15,30,45,93,59,152,0.000333,0.278254,7,5843.331694,324.629539,834.761671,205.810077,8,0
0,0,17,17,15,33,48,102,67,169,0.000333,0.31462,14,13214.02128,734.112293,943.858663,225.068365,8,0
0,0,6,6,9,10,19,17,15,32,0.000333,0.045311,4,543.734722,30.207485,135.93368,61.748606,1,0
0,0,6,6,9,10,19,17,15,32,0.000333,0.045311,4,543.734722,30.207485,135.93368,61.748606,1,0
0,0,28,28,20,50,70,124,94,218,0.000333,0.445395,10,13361.83698,742.324276,1336.183698,368.631371,10,0
0,0,27,27,20,50,70,123,92,215,0.000333,0.439265,10,13177.95849,732.108805,1317.795849,368.631371,10,0
0,0,32,32,18,52,70,131,119,250,0.000333,0.510774,18,27581.77358,1532.320754,1532.320754,371.481515,9,0
0,0,31,31,18,52,70,130,117,247,0.000333,0.504644,18,27250.79229,1513.932905,1513.932905,371.481515,9,0
0,0,34,34,20,51,71,146,123,269,0.000333,0.551427,20,33085.6395,1838.091083,1654.281975,375.732254,9,0
0,0,33,33,20,51,71,145,121,266,0.000333,0.545278,20,32716.65468,1817.591926,1635.832734,375.732254,9,0
0,0,9,9,13,20,33,35,35,70,0.000333,0.117703,6,2118.64553,117.702529,353.107588,134.544278,1,0
0,0,8,8,12,16,28,29,28,57,0.000333,0.09134,6,1644.115383,91.339744,274.019231,107.01955,1,0
0,0,13,13,11,14,25,45,34,79,0.000333,0.122288,10,3668.64639,203.813688,366.864639,91.356717,3,0
0,0,16,16,15,17,32,58,42,100,0.000333,0.166667,14,7000,388.888889,500,128.090227,4,0
0,0,13,13,11,14,25,45,34,79,0.000333,0.122288,10,3668.64639,203.813688,366.864639,91.356717,3,0
0,0,16,16,15,17,32,58,42,100,0.000333,0.166667,14,7000,388.888889,500,128.090227,4,0
0,0,15,15,12,15,27,50,37,87,0.000333,0.137892,12,4964.102552,275.783475,413.675213,101.622909,3,0
0,0,18,18,16,18,34,63,45,108,0.000333,0.183149,16,8791.13579,488.396433,549.445987,139.05865,4,0
0,0,10,10,14,15,29,40,29,69,0.000333,0.111734,7,2346.404821,130.355823,335.200689,111.906328,2,0
0,0,15,15,12,14,26,50,37,87,0.000333,0.136313,12,4907.259066,272.625504,408.938255,96.322519,3,0
0,0,18,18,16,17,33,63,45,108,0.000333,0.181598,16,8716.713038,484.261835,544.794565,133.486868,4,0
0,0,10,10,14,15,29,40,29,69,0.000333,0.111734,7,2346.404821,130.355823,335.200689,111.906328,2,0
0,0,13,13,12,15,27,46,35,81,0.000333,0.128382,12,4621.750652,256.763925,385.145888,101.622909,3,0
0,0,16,16,15,18,33,59,43,102,0.000333,0.171509,14,7203.394802,400.1886,514.5282,133.662009,4,0
0,0,10,10,14,15,29,40,29,69,0.000333,0.111734,7,2346.404821,130.355823,335.200689,111.906328,2,0
0,0,13,13,11,15,26,45,35,80,0.000333,0.125345,10,3760.351775,208.908432,376.035177,96.657107,3,0
0,0,16,16,15,18,33,58,43,101,0.000333,0.169828,14,7132.773285,396.265182,509.483806,133.662009,4,0
0,0,10,10,14,15,29,40,29,69,0.000333,0.111734,7,2346.404821,130.355823,335.200689,111.906328,2,0
0,0,9,9,13,14,27,35,25,60,0.000333,0.095098,6,1711.759501,95.09775,285.29325,101.408685,4,0
0,0,9,9,13,14,27,34,25,59,0.000333,0.093513,6,1683.230176,93.512788,280.538363,101.408685,4,0
0,0,13,13,12,16,28,45,35,80,0.000333,0.128196,12,4615.060725,256.392263,384.588394,107.01955,3,0
0,0,16,16,15,19,34,58,43,101,0.000333,0.171278,14,7193.672458,399.64847,513.833747,139.313982,4,0
0,0,10,10,14,15,29,40,29,69,0.000333,0.111734,7,2346.404821,130.355823,335.200689,111.906328,2,0
0,0,13,13,11,16,27,44,35,79,0.000333,0.125212,10,3756.361127,208.686729,375.636113,102.053748,3,0
0,0,16,16,15,19,34,57,43,100,0.000333,0.169582,14,7122.447978,395.691554,508.746284,139.313982,4,0
0,0,10,10,14,15,29,40,29,69,0.000333,0.111734,7,2346.404821,130.355823,335.200689,111.906328,2,0
0,0,7,7,9,14,23,23,20,43,0.000333,0.064838,4,778.052656,43.225148,194.513164,81.832294,2,0
0,0,10,10,14,17,31,36,28,64,0.000333,0.10569,7,2219.479947,123.304442,317.068564,122.789837,3,0
0,0,6,6,12,14,26,26,20,46,0.000333,0.072073,6,1297.321362,72.073409,216.220227,96.322519,3,0
0,0,11,11,12,21,33,44,35,79,0.000333,0.132836,6,2391.042813,132.835712,398.507135,135.258216,5,0
0,0,10,10,12,20,32,43,33,76,0.000333,0.126667,6,2280,126.666667,380,129.458112,5,0
0,0,9,9,12,19,31,42,31,73,0.000333,0.120552,6,2169.937984,120.55211,361.656331,123.730173,5,0
0,0,6,6,10,10,20,20,14,34,0.000333,0.048982,5,734.727776,40.81821,146.945555,66.438562,2,0
0,0,9,9,15,13,28,33,22,55,0.000333,0.088135,7,1850.831645,102.82398,264.404521,106.709075,3,0
0,0,6,6,12,13,25,27,18,45,0.000333,0.069658,6,1253.841171,69.657843,208.973529,91.125266,3,0
0,0,5,5,12,12,24,26,16,42,0.000333,0.064189,6,1155.41055,64.189475,192.568425,86.0391,3,0
0,0,6,6,13,10,23,27,16,43,0.000333,0.064838,6,1167.078985,64.837721,194.513164,81.324997,3,0
0,0,11,11,13,17,30,45,31,76,0.000333,0.124308,6,2237.542112,124.307895,372.923685,117.592585,5,0
0,0,10,10,13,16,29,44,29,73,0.000333,0.118211,6,2127.795676,118.210871,354.632613,112.105716,5,0
0,0,9,9,13,15,28,43,27,70,0.000333,0.112172,6,2019.089067,112.171615,336.514845,106.709075,5,0
0,0,7,7,10,10,20,24,16,40,0.000333,0.057626,5,864.385619,48.021423,172.877124,66.438562,2,0
0,0,10,10,15,13,28,37,24,61,0.000333,0.09775,7,2052.740552,114.041142,293.24865,106.709075,3,0
0,0,6,6,12,13,25,27,18,45,0.000333,0.069658,6,1253.841171,69.657843,208.973529,91.125266,3,0
0,0,10,10,15,16,31,46,28,74,0.000333,0.122204,7,2566.273689,142.57076,366.610527,122.603359,4,0
0,0,6,6,13,10,23,27,16,43,0.000333,0.064838,6,1167.078985,64.837721,194.513164,81.324997,3,0
0,0,11,11,13,17,30,45,31,76,0.000333,0.124308,6,2237.542112,124.307895,372.923685,117.592585,5,0
0,0,10,10,13,16,29,44,29,73,0.000333,0.118211,6,2127.795676,118.210871,354.632613,112.105716,5,0
0,0,9,9,13,15,28,43,27,70,0.000333,0.112172,6,2019.089067,112.171615,336.514845,106.709075,5,0
0,0,5,5,8,15,23,14,17,31,0.000333,0.046743,4,560.921683,31.162316,140.230421,82.603359,2,0
0,0,5,5,10,12,22,16,14,30,0.000333,0.044594,5,668.914743,37.16193,133.782949,76.238831,2,0
0,0,13,13,15,30,45,90,57,147,0.000333,0.269101,7,5651.116836,313.950935,807.302405,205.810077,8,0
0,0,15,15,15,33,48,99,65,164,0.000333,0.305311,7,6411.536951,356.196497,915.93385,225.068365,8,0
0,0,5,5,9,12,21,15,14,29,0.000333,0.042459,4,509.508821,28.306046,127.377205,71.548875,2,0
0,0,15,15,14,33,47,98,65,163,0.000333,0.301799,7,6337.78588,352.099216,905.397983,219.767975,8,0
0,0,44,44,25,85,110,267,190,457,0.000333,1.033027,24,74377.95334,4132.108519,3099.081389,660.894634,20,0
0,0,13,13,15,31,46,84,56,140,0.000333,0.257766,7,5413.090717,300.727262,773.298674,212.183445,7,0
0,0,46,46,25,87,112,274,194,468,0.000333,1.061947,24,76460.21049,4247.789471,3185.842104,676.632489,22,0
0,0,44,44,25,79,104,257,180,437,0.000333,0.976031,24,70274.21176,3904.122876,2928.092157,614.095084,20,0
0,0,46,46,25,87,112,273,194,467,0.000333,1.059678,24,76296.83397,4238.712998,3179.034749,676.632489,22,0
0,0,14,14,15,33,48,87,58,145,0.000333,0.26994,7,5668.736938,314.92983,809.819563,225.068365,8,0
0,0,46,46,25,85,110,273,192,465,0.000333,1.051111,24,75679.9744,4204.443022,3153.332267,660.894634,22,0
0,0,14,14,15,31,46,87,57,144,0.000333,0.265131,7,5567.750452,309.31947,795.392922,212.183445,8,0
0,0,9,9,10,14,24,27,31,58,0.000333,0.088643,10,2659.27825,147.737681,265.927825,86.52225,1,0
0,0,9,9,10,14,24,27,31,58,0.000333,0.088643,10,2659.27825,147.737681,265.927825,86.52225,1,0
0,0,46,46,25,87,112,273,192,465,0.000333,1.05514,24,75970.08093,4220.560052,3165.420039,676.632489,22,0
0,0,44,44,25,79,104,256,178,434,0.000333,0.96933,24,69791.7801,3877.321117,2907.990838,614.095084,20,0
0,0,46,46,25,86,111,273,192,465,0.000333,1.053134,24,75825.68107,4212.537837,3159.403378,668.755174,22,0
0,0,14,14,15,32,47,87,57,144,0.000333,0.26662,7,5599.025562,311.056976,799.860795,218.603359,8,0
0,0,50,50,25,87,112,281,198,479,0.000333,1.086908,24,78257.35218,4347.630677,3260.723008,676.632489,22,0
0,0,16,16,16,33,49,91,60,151,0.000333,0.282607,8,6782.569492,376.809416,847.821186,230.465006,8,0
0,0,50,50,25,86,111,281,198,479,0.000333,1.084842,24,78108.6048,4339.366933,3254.5252,668.755174,22,0
0,0,16,16,16,33,49,91,60,151,0.000333,0.282607,8,6782.569492,376.809416,847.821186,230.465006,8,0
0,0,6,6,12,18,30,30,21,51,0.000333,0.083417,6,1501.508522,83.41714,250.25142,118.0782,3,0
0,0,39,39,21,58,79,258,173,431,0.000333,0.905643,20,54338.59005,3018.810558,2716.929502,432.001564,20,0
0,0,31,31,16,37,53,190,121,311,0.000333,0.593794,24,42753.19827,2375.177682,1781.383261,256.749775,15,0
0,0,16,16,16,37,53,95,63,158,0.000333,0.30167,8,7240.091455,402.227303,905.011432,256.749775,8,0
0,0,6,6,12,18,30,30,21,51,0.000333,0.083417,6,1501.508522,83.41714,250.25142,118.0782,3,0
0,0,34,34,22,57,79,252,176,428,0.000333,0.899339,33,89034.59929,4946.366627,2698.01816,430.582226,19,0
0,0,6,6,13,16,29,31,19,50,0.000333,0.080966,6,1457.394299,80.96635,242.89905,112.105716,3,0
0,0,36,36,22,56,78,247,166,413,0.000333,0.86529,22,57109.16456,3172.731364,2595.871116,423.319371,19,0
0,0,28,28,17,35,52,179,114,293,0.000333,0.556743,24,40085.4921,2226.971783,1670.228837,249.011774,14,0
0,0,16,16,17,35,52,96,61,157,0.000333,0.298323,8,7159.752286,397.764016,894.969036,249.011774,8,0
0,0,6,6,13,16,29,31,19,50,0.000333,0.080966,6,1457.394299,80.96635,242.89905,112.105716,3,0
0,0,23,23,21,49,70,152,103,255,0.000333,0.520989,20,31259.34339,1736.630188,1562.967169,367.359448,11,0
0,0,6,6,13,16,29,31,19,50,0.000333,0.080966,6,1457.394299,80.96635,242.89905,112.105716,3,0
0,0,25,25,22,56,78,176,123,299,0.000333,0.626445,22,41345.3758,2296.965322,1879.335263,423.319371,15,0
0,0,16,16,17,35,52,96,61,157,0.000333,0.298323,8,7159.752286,397.764016,894.969036,249.011774,8,0
0,0,16,16,17,35,52,96,61,157,0.000333,0.298323,8,7159.752286,397.764016,894.969036,249.011774,8,0
0,0,6,6,13,16,29,31,19,50,0.000333,0.080966,6,1457.394299,80.96635,242.89905,112.105716,3,0
0,0,37,37,22,59,81,191,139,330,0.000333,0.697384,22,46027.31102,2557.072834,2092.150501,445.183436,16,0
0,0,16,16,16,33,49,91,60,151,0.000333,0.282607,8,6782.569492,376.809416,847.821186,230.465006,8,0
0,0,37,37,22,58,80,191,139,330,0.000333,0.695412,22,45897.19797,2549.844332,2086.236271,437.870393,16,0
0,0,35,35,22,50,72,174,125,299,0.000333,0.614936,22,40585.76666,2254.764814,1844.807575,380.300305,14,0
0,0,34,34,22,58,80,184,135,319,0.000333,0.672232,22,44367.29137,2464.849521,2016.695062,437.870393,15,0
0,0,32,32,22,50,72,167,121,288,0.000333,0.592313,22,39092.64481,2171.813601,1776.9384,380.300305,13,0
0,0,34,34,22,58,80,184,135,319,0.000333,0.672232,22,44367.29137,2464.849521,2016.695062,437.870393,15,0
0,0,16,16,16,33,49,91,60,151,0.000333,0.282607,8,6782.569492,376.809416,847.821186,230.465006,8,0
0,0,9,9,12,13,25,36,31,67,0.000333,0.103713,12,3733.660377,207.425576,311.138365,91.125266,2,0
0,0,12,12,16,17,33,49,39,88,0.000333,0.147969,16,7102.50692,394.583718,443.906683,133.486868,3,0
0,0,10,10,15,17,32,41,34,75,0.000333,0.125,14,5250,291.666667,375,128.090227,2,0
0,0,17,17,16,19,35,55,66,121,0.000333,0.206881,24,14895.43788,827.524327,620.643245,144.710623,2,0
0,0,20,20,19,22,41,68,74,142,0.000333,0.253591,27,20540.85439,1141.158577,760.772385,178.818118,3,0
0,0,18,18,18,22,40,60,69,129,0.000333,0.228843,27,18536.27555,1029.793086,686.528724,173.166146,2,0
0,0,11,11,14,15,29,38,27,65,0.000333,0.105256,7,2210.381353,122.798964,315.768765,111.906328,4,0
0,0,11,11,14,15,29,38,27,65,0.000333,0.105256,7,2210.381353,122.798964,315.768765,111.906328,4,0
0,0,27,27,20,49,69,121,89,210,0.000333,0.427597,10,12827.90136,712.661187,1282.790136,361.559344,11,0
0,0,26,26,20,49,69,120,87,207,0.000333,0.421488,10,12644.64563,702.480313,1264.464563,361.559344,11,0
0,0,27,27,20,49,69,121,89,210,0.000333,0.427597,10,12827.90136,712.661187,1282.790136,361.559344,11,0
0,0,26,26,20,49,69,120,87,207,0.000333,0.421488,10,12644.64563,702.480313,1264.464563,361.559344,11,0
0,0,25,25,21,46,67,115,83,198,0.000333,0.400362,10,12010.8566,667.269811,1201.08566,346.322516,12,0
0,0,24,24,21,46,67,114,81,195,0.000333,0.394296,10,11828.87392,657.159662,1182.887392,346.322516,12,0
0,0,25,25,21,46,67,115,83,198,0.000333,0.400362,10,12010.8566,667.269811,1201.08566,346.322516,12,0
0,0,24,24,21,46,67,114,81,195,0.000333,0.394296,10,11828.87392,657.159662,1182.887392,346.322516,12,0
0,0,27,27,22,46,68,120,86,206,0.000333,0.418006,11,13794.1908,766.343933,1254.017345,352.191346,12,0
0,0,26,26,22,46,68,119,84,203,0.000333,0.411918,11,13593.30453,755.183585,1235.754957,352.191346,12,0
0,0,27,27,22,46,68,120,86,206,0.000333,0.418006,11,13794.1908,766.343933,1254.017345,352.191346,12,0
0,0,26,26,22,46,68,119,84,203,0.000333,0.411918,11,13593.30453,755.183585,1235.754957,352.191346,12,0
0,0,25,25,21,46,67,115,84,199,0.000333,0.402384,10,12071.51749,670.639861,1207.151749,346.322516,12,0
0,0,24,24,21,46,67,114,82,196,0.000333,0.396318,10,11889.53481,660.529712,1188.953481,346.322516,12,0
0,0,25,25,21,46,67,115,84,199,0.000333,0.402384,10,12071.51749,670.639861,1207.151749,346.322516,12,0
0,0,24,24,21,46,67,114,82,196,0.000333,0.396318,10,11889.53481,660.529712,1188.953481,346.322516,12,0
0,0,25,25,21,46,67,115,83,198,0.000333,0.400362,10,12010.8566,667.269811,1201.08566,346.322516,12,0
0,0,24,24,21,46,67,114,81,195,0.000333,0.394296,10,11828.87392,657.159662,1182.887392,346.322516,12,0
0,0,25,25,21,46,67,115,83,198,0.000333,0.400362,10,12010.8566,667.269811,1201.08566,346.322516,12,0
0,0,24,24,21,46,67,114,81,195,0.000333,0.394296,10,11828.87392,657.159662,1182.887392,346.322516,12,0
0,0,25,25,21,46,67,115,83,198,0.000333,0.400362,10,12010.8566,667.269811,1201.08566,346.322516,12,0
0,0,24,24,21,46,67,114,81,195,0.000333,0.394296,10,11828.87392,657.159662,1182.887392,346.322516,12,0
0,0,25,25,21,46,67,115,83,198,0.000333,0.400362,10,12010.8566,667.269811,1201.08566,346.322516,12,0
0,0,24,24,21,46,67,114,81,195,0.000333,0.394296,10,11828.87392,657.159662,1182.887392,346.322516,12,0
0,0,23,23,19,42,61,103,78,181,0.000333,0.357821,9,9661.171123,536.731729,1073.463458,307.187955,7,0
0,0,19,19,19,38,57,95,67,162,0.000333,0.314976,9,8504.353641,472.464091,944.928182,280.131868,7,0
0,0,14,14,14,25,39,54,43,97,0.000333,0.170895,7,3588.788107,199.377117,512.684015,169.399374,9,0
0,0,11,11,13,24,37,47,37,84,0.000333,0.145865,6,2625.564496,145.864694,437.594083,158.144816,8,0
0,0,12,12,14,15,29,48,31,79,0.000333,0.127927,14,5372.926981,298.495943,383.780499,111.906328,4,0
0,0,14,14,15,22,37,55,40,95,0.000333,0.164966,7,3464.286488,192.46036,494.89807,156.710855,7,0
0,0,13,13,16,22,38,60,41,101,0.000333,0.17668,8,4240.325431,235.573635,530.040679,162.107496,6,0
0,0,12,12,14,15,29,48,31,79,0.000333,0.127927,14,5372.926981,298.495943,383.780499,111.906328,4,0
0,0,14,14,15,22,37,55,40,95,0.000333,0.164966,7,3464.286488,192.46036,494.89807,156.710855,7,0
0,0,13,13,16,22,38,60,41,101,0.000333,0.17668,8,4240.325431,235.573635,530.040679,162.107496,6,0
0,0,12,12,13,25,38,50,41,91,0.000333,0.159187,6,2865.368422,159.187135,477.561404,164.202121,9,0
0,0,9,9,12,24,36,43,35,78,0.000333,0.134418,6,2419.524901,134.41805,403.25415,153.05865,8,0
0,0,10,10,14,15,29,45,29,74,0.000333,0.11983,7,2516.434155,139.801898,359.490594,111.906328,4,0
0,0,12,12,14,22,36,52,38,90,0.000333,0.155098,7,3257.052751,180.947375,465.29325,151.410465,7,0
0,0,11,11,15,22,37,57,39,96,0.000333,0.166703,7,3500.752662,194.486259,500.107523,156.710855,6,0
0,0,10,10,13,15,28,44,29,73,0.000333,0.116979,6,2105.621456,116.97897,350.936909,106.709075,4,0
0,0,12,12,14,22,36,51,38,89,0.000333,0.153374,7,3220.863276,178.936849,460.123325,151.410465,7,0
0,0,11,11,15,22,37,56,39,95,0.000333,0.164966,7,3464.286488,192.46036,494.89807,156.710855,6,0
0,0,12,12,13,25,38,50,41,91,0.000333,0.159187,6,2865.368422,159.187135,477.561404,164.202121,9,0
0,0,9,9,12,24,36,43,35,78,0.000333,0.134418,6,2419.524901,134.41805,403.25415,153.05865,8,0
0,0,10,10,14,15,29,45,29,74,0.000333,0.11983,7,2516.434155,139.801898,359.490594,111.906328,4,0
0,0,12,12,14,22,36,52,38,90,0.000333,0.155098,7,3257.052751,180.947375,465.29325,151.410465,7,0
0,0,11,11,15,22,37,57,39,96,0.000333,0.166703,7,3500.752662,194.486259,500.107523,156.710855,6,0
0,0,10,10,13,15,28,44,29,73,0.000333,0.116979,6,2105.621456,116.97897,350.936909,106.709075,4,0
0,0,12,12,14,22,36,51,38,89,0.000333,0.153374,7,3220.863276,178.936849,460.123325,151.410465,7,0
0,0,11,11,15,22,37,56,39,95,0.000333,0.164966,7,3464.286488,192.46036,494.89807,156.710855,6,0
0,0,11,11,18,19,37,61,39,100,0.000333,0.173648,18,9377.016058,520.945337,520.945337,155.769273,9,0
0,0,11,11,18,19,37,61,39,100,0.000333,0.173648,18,9377.016058,520.945337,520.945337,155.769273,9,0
0,0,12,12,18,19,37,62,41,103,0.000333,0.178858,18,9658.32654,536.573697,536.573697,155.769273,9,0
0,0,12,12,18,19,37,62,41,103,0.000333,0.178858,18,9658.32654,536.573697,536.573697,155.769273,9,0
0,0,47,47,27,87,114,285,203,488,0.000333,1.111483,26,86695.7085,4816.42825,3334.450327,688.918047,22,0
0,0,45,45,27,79,106,268,189,457,0.000333,1.024887,26,79941.15084,4441.175047,3074.659648,626.380642,20,0
0,0,14,14,11,14,25,46,39,85,0.000333,0.131576,10,3947.277761,219.293209,394.727776,91.356717,2,0
0,0,17,17,15,17,32,59,47,106,0.000333,0.176667,14,7420,412.222222,530,128.090227,3,0
0,0,10,10,14,15,29,40,29,69,0.000333,0.111734,7,2346.404821,130.355823,335.200689,111.906328,2,0
0,0,13,13,12,14,26,46,35,81,0.000333,0.126912,12,4568.827406,253.823745,380.735617,96.322519,3,0
0,0,16,16,15,17,32,59,43,102,0.000333,0.17,14,7140,396.666667,510,128.090227,4,0
0,0,13,13,11,14,25,45,35,80,0.000333,0.123836,10,3715.084952,206.393608,371.508495,91.356717,3,0
0,0,16,16,15,17,32,58,43,101,0.000333,0.168333,14,7070,392.777778,505,128.090227,4,0
0,0,9,9,12,26,38,62,43,105,0.000333,0.183677,6,3306.194333,183.677463,551.032389,165.230983,6,0
0,0,4,4,7,13,20,11,15,26,0.000333,0.037457,3,337.110391,18.728355,112.37013,67.757201,1,0
0,0,12,12,12,31,43,74,54,128,0.000333,0.231521,6,4167.371332,231.52063,694.561889,196.599636,6,0
0,0,4,4,8,10,18,12,12,24,0.000333,0.033359,4,400.3128,22.2396,100.0782,57.219281,1,0
0,0,12,12,14,28,42,86,55,141,0.000333,0.253439,7,5322.217296,295.678739,760.316757,187.908907,7,0
0,0,14,14,14,31,45,95,63,158,0.000333,0.289238,14,12147.97905,674.887725,867.712789,206.883055,7,0
0,0,9,9,13,21,34,35,35,70,0.000333,0.118707,6,2136.734393,118.707466,356.122399,140.344382,1,0
0,0,7,7,11,16,27,24,26,50,0.000333,0.079248,5,1188.721876,66.040104,237.744375,102.053748,1,0
0,0,6,6,13,14,27,26,20,46,0.000333,0.072908,6,1312.348951,72.908275,218.724825,101.408685,4,0
0,0,7,7,13,15,28,27,22,49,0.000333,0.07852,6,1413.362347,78.52013,235.560391,106.709075,4,0
0,0,27,27,19,46,65,117,88,205,0.000333,0.411528,9,11111.26862,617.292701,1234.585402,334.794473,10,0
0,0,23,23,19,42,61,109,77,186,0.000333,0.367706,9,9928.054303,551.558572,1103.117145,307.187955,10,0
0,0,16,16,12,15,27,54,48,102,0.000333,0.161666,18,8729.973454,484.998525,484.998525,101.622909,3,0
0,0,19,19,16,18,34,67,56,123,0.000333,0.208586,24,15018.19031,834.343906,625.757929,139.05865,4,0
0,0,10,10,14,15,29,40,29,69,0.000333,0.111734,7,2346.404821,130.355823,335.200689,111.906328,2,0
0,0,16,16,12,15,27,54,48,102,0.000333,0.161666,18,8729.973454,484.998525,484.998525,101.622909,3,0
0,0,19,19,16,18,34,67,56,123,0.000333,0.208586,24,15018.19031,834.343906,625.757929,139.05865,4,0
0,0,10,10,14,15,29,40,29,69,0.000333,0.111734,7,2346.404821,130.355823,335.200689,111.906328,2,0
0,0,9,9,12,16,28,38,31,69,0.000333,0.110569,6,1990.244938,110.569163,331.70749,107.01955,2,0
0,0,12,12,15,19,34,51,39,90,0.000333,0.152624,14,6410.20318,356.122399,457.871656,139.313982,3,0
0,0,10,10,14,19,33,43,34,77,0.000333,0.129473,7,2718.92843,151.051579,388.418347,134.013592,2,0
0,0,12,12,10,21,31,47,46,93,0.000333,0.15358,10,4607.402569,255.966809,460.740257,125.457947,2,0
0,0,13,13,10,21,31,48,48,96,0.000333,0.158534,10,4756.028458,264.223803,475.602846,125.457947,2,0
0,0,9,9,10,18,28,32,30,62,0.000333,0.099352,5,1490.280026,82.793335,298.056005,108.277931,2,0
0,0,7,7,8,14,22,18,21,39,0.000333,0.057973,4,695.671333,38.648407,173.917833,77.302969,1,0
0,0,13,13,10,20,30,40,45,85,0.000333,0.139029,10,4170.857006,231.714278,417.085701,119.657843,1,0
0,0,9,9,10,15,25,36,30,66,0.000333,0.102165,10,3064.945085,170.274727,306.494509,91.82264,2,0
0,0,12,12,14,18,32,49,38,87,0.000333,0.145,14,6090,338.333333,435,128.361619,3,0
0,0,10,10,13,18,31,41,33,74,0.000333,0.122204,6,2199.663162,122.203509,366.610527,123.164366,2,0
0,0,9,9,12,16,28,38,31,69,0.000333,0.110569,6,1990.244938,110.569163,331.70749,107.01955,2,0
0,0,12,12,15,19,34,51,39,90,0.000333,0.152624,14,6410.20318,356.122399,457.871656,139.313982,3,0
0,0,10,10,14,19,33,43,34,77,0.000333,0.129473,7,2718.92843,151.051579,388.418347,134.013592,2,0
0,0,22,22,24,42,66,109,77,186,0.000333,0.374752,12,13491.08767,749.504871,1124.257306,336.516432,11,0
0,0,21,21,24,42,66,108,75,183,0.000333,0.368708,12,13273.48949,737.416083,1106.124124,336.516432,11,0
0,0,22,22,24,42,66,109,77,186,0.000333,0.374752,12,13491.08767,749.504871,1124.257306,336.516432,11,0
0,0,21,21,24,42,66,108,75,183,0.000333,0.368708,12,13273.48949,737.416083,1106.124124,336.516432,11,0
0,0,22,22,24,43,67,109,78,187,0.000333,0.37812,12,13612.30414,756.239119,1134.358679,343.368484,11,0
0,0,21,21,24,43,67,108,76,184,0.000333,0.372053,12,13393.92493,744.106941,1116.160411,343.368484,11,0
0,0,22,22,24,43,67,109,78,187,0.000333,0.37812,12,13612.30414,756.239119,1134.358679,343.368484,11,0
0,0,21,21,24,43,67,108,76,184,0.000333,0.372053,12,13393.92493,744.106941,1116.160411,343.368484,11,0
0,0,22,22,24,44,68,109,78,187,0.000333,0.379452,12,13660.26662,758.903701,1138.355551,350.254091,11,0
0,0,21,21,24,44,68,108,76,184,0.000333,0.373364,12,13441.11795,746.728775,1120.093163,350.254091,11,0
0,0,22,22,24,44,68,109,78,187,0.000333,0.379452,12,13660.26662,758.903701,1138.355551,350.254091,11,0
0,0,21,21,24,44,68,108,76,184,0.000333,0.373364,12,13441.11795,746.728775,1120.093163,350.254091,11,0
0,0,9,9,10,16,26,37,32,69,0.000333,0.10811,10,3243.303406,180.183523,324.330341,97.219281,1,0
0,0,9,9,10,18,28,37,31,68,0.000333,0.108967,5,1634.500673,90.805593,326.900135,108.277931,1,0
0,0,9,9,11,18,29,38,32,70,0.000333,0.113353,5,1700.293348,94.460742,340.05867,113.112398,1,0
0,0,11,11,10,16,26,47,42,89,0.000333,0.139446,10,4183.391349,232.410631,418.339135,97.219281,1,0
0,0,11,11,10,18,28,47,42,89,0.000333,0.142618,10,4278.545881,237.696993,427.854588,108.277931,1,0
0,0,12,12,11,19,30,51,45,96,0.000333,0.15702,10,4710.614972,261.700832,471.061497,118.764371,1,0
0,0,9,9,12,16,28,38,31,69,0.000333,0.110569,6,1990.244938,110.569163,331.70749,107.01955,2,0
0,0,12,12,15,19,34,51,39,90,0.000333,0.152624,14,6410.20318,356.122399,457.871656,139.313982,3,0
0,0,10,10,14,19,33,43,34,77,0.000333,0.129473,7,2718.92843,151.051579,388.418347,134.013592,2,0
0,0,30,30,20,50,70,133,102,235,0.000333,0.480127,20,28807.63018,1600.423899,1440.381509,368.631371,9,0
0,0,29,29,20,50,70,132,100,232,0.000333,0.473998,20,28439.8732,1579.992955,1421.99366,368.631371,9,0
0,0,23,23,17,43,60,102,79,181,0.000333,0.356382,8,8553.177582,475.176532,1069.147198,302.816253,7,0
0,0,7,7,8,14,22,18,21,39,0.000333,0.057973,4,695.671333,38.648407,173.917833,77.302969,1,0
0,0,17,17,11,20,31,60,55,115,0.000333,0.189911,10,5697.325757,316.518098,569.732576,124.49231,2,0
0,0,20,20,15,23,38,73,63,136,0.000333,0.237906,14,9992.053986,555.11411,713.718142,162.645284,3,0
0,0,10,10,13,19,32,43,33,76,0.000333,0.126667,6,2280,126.666667,380,128.816339,2,0
0,0,16,16,15,22,37,55,50,105,0.000333,0.182331,14,7657.896447,425.438692,546.992603,156.710855,3,0
0,0,26,26,18,45,63,113,91,204,0.000333,0.406455,18,21948.57188,1219.365104,1219.365104,322.192039,12,0
0,0,22,22,18,43,61,105,78,183,0.000333,0.361775,9,9767.924395,542.662466,1085.324933,308.388034,10,0
0,0,26,26,19,47,66,114,92,206,0.000333,0.415048,9,11206.3067,622.572594,1245.145189,341.776299,11,0
0,0,22,22,18,44,62,105,79,184,0.000333,0.365191,9,9860.14909,547.786061,1095.572121,315.273641,10,0
0,0,9,9,12,16,28,38,31,69,0.000333,0.110569,6,1990.244938,110.569163,331.70749,107.01955,2,0
0,0,12,12,15,19,34,51,39,90,0.000333,0.152624,14,6410.20318,356.122399,457.871656,139.313982,3,0
0,0,10,10,14,19,33,43,34,77,0.000333,0.129473,7,2718.92843,151.051579,388.418347,134.013592,2,0
0,0,13,13,11,14,25,45,34,79,0.000333,0.122288,10,3668.64639,203.813688,366.864639,91.356717,3,0
0,0,16,16,15,17,32,58,42,100,0.000333,0.166667,14,7000,388.888889,500,128.090227,4,0
0,0,13,13,11,13,24,45,34,79,0.000333,0.120737,10,3622.120376,201.22891,362.212038,86.159464,3,0
0,0,16,16,15,16,31,58,42,100,0.000333,0.16514,14,6935.874835,385.32638,495.419631,122.603359,4,0
0,0,5,5,9,14,23,20,20,40,0.000333,0.060314,4,723.769913,40.20944,180.942478,81.832294,2,0
0,0,6,6,9,14,23,21,22,43,0.000333,0.064838,4,778.052656,43.225148,194.513164,81.832294,2,0
0,0,32,32,20,53,73,141,108,249,0.000333,0.513755,20,30825.3263,1712.518128,1541.266315,390.018346,11,0
0,0,31,31,20,53,73,140,106,246,0.000333,0.507566,20,30453.93683,1691.885379,1522.696841,390.018346,11,0
0,0,15,15,13,18,31,52,48,100,0.000333,0.16514,12,5945.035572,330.279754,495.419631,123.164366,2,0
0,0,18,18,16,21,37,65,56,121,0.000333,0.210115,16,10085.50172,560.305651,630.343857,156.238666,3,0
0,0,10,10,13,19,32,42,33,75,0.000333,0.125,6,2250,125,375,128.816339,2,0
0,0,15,15,12,17,29,50,47,97,0.000333,0.157075,12,5654.689878,314.149438,471.224157,112.506418,2,0
0,0,18,18,16,20,36,63,55,118,0.000333,0.20335,16,9760.818403,542.267689,610.05115,150.438562,3,0
0,0,10,10,14,15,29,40,29,69,0.000333,0.111734,7,2346.404821,130.355823,335.200689,111.906328,2,0
0,0,26,26,18,45,63,113,91,204,0.000333,0.406455,18,21948.57188,1219.365104,1219.365104,322.192039,9,0
0,0,22,22,18,43,61,105,78,183,0.000333,0.361775,9,9767.924395,542.662466,1085.324933,308.388034,9,0
0,0,33,33,20,53,73,146,112,258,0.000333,0.532325,20,31939.49472,1774.416374,1596.974736,390.018346,11,0
0,0,32,32,20,53,73,145,110,255,0.000333,0.526135,20,31568.10525,1753.783625,1578.405263,390.018346,11,0
0,0,26,26,17,47,64,115,89,204,0.000333,0.408,8,9792,544,1224,330.552544,9,0
0,0,7,7,8,14,22,18,21,39,0.000333,0.057973,4,695.671333,38.648407,173.917833,77.302969,1,0
0,0,17,17,11,20,31,60,55,115,0.000333,0.189911,10,5697.325757,316.518098,569.732576,124.49231,2,0
0,0,20,20,15,23,38,73,63,136,0.000333,0.237906,14,9992.053986,555.11411,713.718142,162.645284,3,0
0,0,10,10,13,19,32,43,33,76,0.000333,0.126667,6,2280,126.666667,380,128.816339,2,0
0,0,16,16,15,22,37,55,50,105,0.000333,0.182331,14,7657.896447,425.438692,546.992603,156.710855,3,0
0,0,27,27,19,44,63,137,87,224,0.000333,0.446304,9,12050.19633,669.455351,1338.910703,320.925614,9,0
0,0,15,15,15,19,34,72,45,117,0.000333,0.198411,14,8333.264134,462.959119,595.233152,139.313982,5,0
0,0,6,6,11,10,21,19,15,34,0.000333,0.04978,5,746.693962,41.482998,149.338792,71.273029,1,0
0,0,19,19,18,30,48,92,64,156,0.000333,0.290418,18,15682.5747,871.25415,871.25415,222.265368,6,0
0,0,10,10,16,22,38,38,35,73,0.000333,0.1277,8,3064.789668,170.266093,383.098708,162.107496,2,0
0,0,5,5,14,13,27,26,18,44,0.000333,0.069738,7,1464.505351,81.361408,209.21505,101.408685,3,0
0,0,5,5,13,13,26,25,18,43,0.000333,0.067373,6,1212.713447,67.372969,202.118908,96.211433,3,0
0,0,5,5,14,13,27,26,18,44,0.000333,0.069738,7,1464.505351,81.361408,209.21505,101.408685,3,0
0,0,5,5,13,13,26,25,18,43,0.000333,0.067373,6,1212.713447,67.372969,202.118908,96.211433,3,0
0,0,5,5,14,12,26,25,17,42,0.000333,0.065806,7,1381.929277,76.773849,197.418468,96.322519,3,0
0,0,5,5,14,12,26,25,17,42,0.000333,0.065806,7,1381.929277,76.773849,197.418468,96.322519,3,0
0,0,37,37,21,58,79,170,126,296,0.000333,0.621973,20,37318.38203,2073.243446,1865.919101,432.001564,13,0
0,0,36,36,21,58,79,169,124,293,0.000333,0.615669,20,36940.15518,2052.230844,1847.007759,432.001564,13,0
0,0,41,41,21,59,80,172,149,321,0.000333,0.676446,20,40586.77837,2254.821021,2029.338918,439.314606,13,0
0,0,40,40,21,59,80,171,147,318,0.000333,0.670124,20,40207.46268,2233.747927,2010.373134,439.314606,13,0
0,0,23,23,19,41,60,101,77,178,0.000333,0.350476,9,9462.838734,525.713263,1051.426526,300.370255,7,0
0,0,19,19,19,37,56,93,66,159,0.000333,0.30779,9,8310.324893,461.684716,923.369433,273.460397,7,0
0,0,23,23,19,40,59,102,78,180,0.000333,0.352959,9,9529.88174,529.437874,1058.875749,293.587747,7,0
0,0,19,19,19,38,57,93,67,160,0.000333,0.311087,9,8399.36162,466.631201,933.262402,280.131868,7,0
0,0,24,24,20,44,64,109,93,202,0.000333,0.404,20,24240,1346.666667,1212,326.653553,8,0
0,0,23,23,20,44,64,108,91,199,0.000333,0.398,20,23880,1326.666667,1194,326.653553,8,0
0,0,25,25,24,47,71,116,100,216,0.000333,0.442782,24,31880.28907,1771.12717,1328.345378,371.104776,10,0
0,0,24,24,24,47,71,115,98,213,0.000333,0.436632,24,31437.50728,1746.528182,1309.896136,371.104776,10,0
0,0,28,28,23,49,72,128,95,223,0.000333,0.458631,11,15134.82603,840.823668,1375.893275,379.162707,11,0
0,0,27,27,23,49,72,127,93,220,0.000333,0.452461,11,14931.2185,829.512139,1357.3835,379.162707,11,0
0,0,27,27,20,47,67,121,88,209,0.000333,0.422604,10,12678.12641,704.340356,1267.812641,347.504238,11,0
0,0,26,26,20,47,67,120,86,206,0.000333,0.416538,10,12496.14373,694.230207,1249.614373,347.504238,11,0
0,0,16,16,11,19,30,51,57,108,0.000333,0.176648,15,7949.162765,441.620154,529.944184,118.764371,2,0
0,0,19,19,15,22,37,64,65,129,0.000333,0.224006,14,9408.272778,522.681821,672.019484,156.710855,3,0
0,0,10,10,13,18,31,41,33,74,0.000333,0.122204,6,2199.663162,122.203509,366.610527,123.164366,2,0
0,0,9,9,11,13,24,37,28,65,0.000333,0.099341,10,2980.225625,165.56809,298.022563,86.159464,2,0
0,0,12,12,15,16,31,50,36,86,0.000333,0.14202,14,5964.852358,331.380687,426.060883,122.603359,3,0
0,0,10,10,14,16,30,42,31,73,0.000333,0.119401,7,2507.421094,139.301172,358.203013,117.302969,2,0
0,0,14,14,11,18,29,46,45,91,0.000333,0.147359,10,4420.762706,245.597928,442.076271,113.112398,2,0
0,0,17,17,15,21,36,59,53,112,0.000333,0.193011,14,8106.442402,450.357911,579.0316,150.842025,3,0
0,0,10,10,13,18,31,41,33,74,0.000333,0.122204,6,2199.663162,122.203509,366.610527,123.164366,2,0
0,0,15,15,12,20,32,48,44,92,0.000333,0.153333,12,5520,306.666667,460,129.458112,2,0
0,0,18,18,16,23,39,61,52,113,0.000333,0.199083,16,9556.007212,530.88929,597.250451,168.041925,3,0
0,0,14,14,11,18,29,46,45,91,0.000333,0.147359,10,4420.762706,245.597928,442.076271,113.112398,2,0
0,0,17,17,15,21,36,59,53,112,0.000333,0.193011,14,8106.442402,450.357911,579.0316,150.842025,3,0
0,0,10,10,13,18,31,41,33,74,0.000333,0.122204,6,2199.663162,122.203509,366.610527,123.164366,2,0
0,0,37,37,21,57,78,162,129,291,0.000333,0.609684,20,36581.04091,2032.280051,1829.052046,424.713397,13,0
0,0,36,36,21,57,78,161,127,288,0.000333,0.603399,20,36203.91678,2011.32871,1810.195839,424.713397,13,0
0,0,13,13,12,15,27,46,35,81,0.000333,0.128382,12,4621.750652,256.763925,385.145888,101.622909,3,0
0,0,16,16,15,18,33,59,43,102,0.000333,0.171509,14,7203.394802,400.1886,514.5282,133.662009,4,0
0,0,13,13,11,15,26,45,35,80,0.000333,0.125345,10,3760.351775,208.908432,376.035177,96.657107,3,0
0,0,16,16,15,18,33,58,43,101,0.000333,0.169828,14,7132.773285,396.265182,509.483806,133.662009,4,0
0,0,5,5,13,11,24,33,20,53,0.000333,0.081001,6,1458.018075,81.001004,243.003013,86.159464,3,0
0,0,5,5,13,11,24,32,20,52,0.000333,0.079473,6,1430.5083,79.472683,238.41805,86.159464,3,0
0,0,5,5,13,11,24,32,19,51,0.000333,0.077944,6,1402.998525,77.944363,233.833088,86.159464,3,0
0,0,5,5,13,11,24,32,19,51,0.000333,0.077944,6,1402.998525,77.944363,233.833088,86.159464,3,0
0,0,23,23,20,56,76,147,116,263,0.000333,0.547735,20,32864.09872,1825.783262,1643.204936,411.650438,12,0
0,0,13,13,14,34,48,83,59,142,0.000333,0.264355,7,5551.452726,308.41404,793.064675,226.276706,7,0
0,0,45,45,25,89,114,275,201,476,0.000333,1.084152,24,78058.93552,4336.607529,3252.455647,692.43668,18,0
0,0,43,43,25,81,106,258,187,445,0.000333,0.997975,24,71854.19046,3991.89947,2993.924602,629.624255,16,0
0,0,13,13,12,15,27,46,35,81,0.000333,0.128382,12,4621.750652,256.763925,385.145888,101.622909,3,0
0,0,16,16,15,18,33,59,43,102,0.000333,0.171509,14,7203.394802,400.1886,514.5282,133.662009,4,0
0,0,13,13,11,15,26,45,35,80,0.000333,0.125345,10,3760.351775,208.908432,376.035177,96.657107,3,0
0,0,16,16,15,18,33,58,43,101,0.000333,0.169828,14,7132.773285,396.265182,509.483806,133.662009,4,0
0,0,16,16,13,16,29,57,41,98,0.000333,0.158694,12,5712.98565,317.388092,476.082138,112.105716,3,0
0,0,19,19,16,19,35,70,49,119,0.000333,0.203462,16,9766.154864,542.564159,610.384679,144.710623,4,0
0,0,14,14,13,15,28,51,40,91,0.000333,0.145823,12,5249.631575,291.646199,437.469298,106.709075,3,0
0,0,17,17,17,18,35,64,48,112,0.000333,0.191493,16,9191.675166,510.64862,574.479698,144.545518,4,0
0,0,10,10,14,15,29,40,29,69,0.000333,0.111734,7,2346.404821,130.355823,335.200689,111.906328,2,0
0,0,12,12,11,13,24,42,33,75,0.000333,0.114624,10,3438.721876,191.040104,343.872188,86.159464,2,0
0,0,15,15,15,16,31,55,41,96,0.000333,0.158534,14,6658.439841,369.913325,475.602846,122.603359,3,0
0,0,10,10,14,15,29,40,29,69,0.000333,0.111734,7,2346.404821,130.355823,335.200689,111.906328,2,0
0,0,13,13,11,14,25,44,34,78,0.000333,0.12074,10,3622.207828,201.233768,362.220783,91.356717,3,0
0,0,16,16,15,17,32,57,42,99,0.000333,0.165,14,6930,385,495,128.090227,4,0
0,0,13,13,11,14,25,44,34,78,0.000333,0.12074,10,3622.207828,201.233768,362.220783,91.356717,3,0
0,0,16,16,15,17,32,57,42,99,0.000333,0.165,14,6930,385,495,128.090227,4,0
0,0,13,13,11,14,25,45,34,79,0.000333,0.122288,10,3668.64639,203.813688,366.864639,91.356717,3,0
0,0,16,16,15,17,32,58,42,100,0.000333,0.166667,14,7000,388.888889,500,128.090227,4,0
0,0,13,13,11,14,25,45,34,79,0.000333,0.122288,10,3668.64639,203.813688,366.864639,91.356717,3,0
0,0,16,16,15,17,32,58,42,100,0.000333,0.166667,14,7000,388.888889,500,128.090227,4,0
0,0,15,15,12,15,27,49,37,86,0.000333,0.136307,12,4907.043902,272.61355,408.920325,101.622909,3,0
0,0,18,18,16,18,34,62,45,107,0.000333,0.181453,16,8709.736384,483.874244,544.358524,139.05865,4,0
0,0,15,15,12,14,26,49,37,86,0.000333,0.134746,12,4850.853789,269.491877,404.237816,96.322519,3,0
0,0,18,18,16,17,33,62,45,107,0.000333,0.179917,16,8636.002732,479.77793,539.750171,133.486868,4,0
0,0,26,26,24,47,71,125,94,219,0.000333,0.448932,24,32323.07086,1795.726159,1346.794619,371.104776,12,0
0,0,25,25,24,47,71,124,92,216,0.000333,0.442782,12,15940.14453,885.563585,1328.345378,371.104776,12,0
0,0,13,13,11,15,26,44,34,78,0.000333,0.122211,10,3666.34298,203.685721,366.634298,96.657107,3,0
0,0,16,16,15,18,33,57,42,99,0.000333,0.166465,14,6991.530249,388.418347,499.395018,133.662009,4,0
0,0,13,13,11,15,26,44,34,78,0.000333,0.122211,10,3666.34298,203.685721,366.634298,96.657107,3,0
0,0,16,16,15,18,33,57,42,99,0.000333,0.166465,14,6991.530249,388.418347,499.395018,133.662009,4,0
0,0,19,19,15,26,41,84,60,144,0.000333,0.257162,14,10800.82484,600.045825,771.487489,180.814792,6,0
0,0,35,35,22,53,75,163,114,277,0.000333,0.575128,22,37958.4211,2108.801172,1725.382777,401.68728,12,0
0,0,34,34,22,53,75,162,112,274,0.000333,0.568899,22,37547.31907,2085.96217,1706.696321,401.68728,12,0
0,0,35,35,22,53,75,163,114,277,0.000333,0.575128,22,37958.4211,2108.801172,1725.382777,401.68728,12,0
0,0,34,34,22,53,75,162,112,274,0.000333,0.568899,22,37547.31907,2085.96217,1706.696321,401.68728,12,0
0,0,19,19,15,26,41,84,60,144,0.000333,0.257162,14,10800.82484,600.045825,771.487489,180.814792,6,0
0,0,11,11,13,15,28,33,25,58,0.000333,0.092942,6,1672.959513,92.942195,278.826585,106.709075,3,0
0,0,12,12,14,15,29,37,26,63,0.000333,0.102018,7,2142.369619,119.020534,306.052803,111.906328,3,0
0,0,12,12,14,15,29,37,26,63,0.000333,0.102018,7,2142.369619,119.020534,306.052803,111.906328,3,0
0,0,14,14,11,14,25,46,39,85,0.000333,0.131576,10,3947.277761,219.293209,394.727776,91.356717,2,0
0,0,17,17,15,17,32,59,47,106,0.000333,0.176667,14,7420,412.222222,530,128.090227,3,0
0,0,10,10,14,15,29,40,29,69,0.000333,0.111734,7,2346.404821,130.355823,335.200689,111.906328,2,0
0,0,4,4,13,11,24,22,16,38,0.000333,0.058076,6,1045.37145,58.076192,174.228575,86.159464,2,0
0,0,13,13,12,13,25,45,34,79,0.000333,0.122288,12,4402.375668,244.576426,366.864639,91.125266,3,0
0,0,16,16,16,16,32,58,42,100,0.000333,0.166667,16,8000,444.444444,500,128,4,0
0,0,10,10,14,15,29,40,29,69,0.000333,0.111734,7,2346.404821,130.355823,335.200689,111.906328,2,0
0,0,16,16,12,18,30,53,54,107,0.000333,0.175012,18,9450.671287,525.037294,525.037294,118.0782,3,0
0,0,19,19,16,21,37,66,62,128,0.000333,0.22227,16,10668.96049,592.720027,666.810031,156.238666,4,0
0,0,16,16,12,18,30,53,54,107,0.000333,0.175012,18,9450.671287,525.037294,525.037294,118.0782,3,0
0,0,19,19,16,21,37,66,62,128,0.000333,0.22227,16,10668.96049,592.720027,666.810031,156.238666,4,0
0,0,6,6,10,13,23,23,21,44,0.000333,0.066346,5,995.18363,55.287979,199.036726,81.324997,3,0
0,0,10,10,11,16,27,31,34,65,0.000333,0.103023,10,3090.676876,171.704271,309.067688,102.053748,3,0
0,0,5,5,13,11,24,25,17,42,0.000333,0.064189,6,1155.41055,64.189475,192.568425,86.159464,3,0
0,0,5,5,13,11,24,25,17,42,0.000333,0.064189,6,1155.41055,64.189475,192.568425,86.159464,3,0
0,0,5,5,13,12,25,25,17,42,0.000333,0.065014,6,1170.25176,65.013987,195.04196,91.125266,3,0
0,0,5,5,13,12,25,25,17,42,0.000333,0.065014,6,1170.25176,65.013987,195.04196,91.125266,3,0
0,0,5,5,14,12,26,26,18,44,0.000333,0.06894,7,1447.735433,80.429746,206.819348,96.322519,3,0
0,0,5,5,13,12,25,25,18,43,0.000333,0.066562,6,1198.114897,66.561939,199.685816,91.125266,3,0
0,0,13,13,12,14,26,46,35,81,0.000333,0.126912,12,4568.827406,253.823745,380.735617,96.322519,3,0
0,0,16,16,15,17,32,59,43,102,0.000333,0.17,14,7140,396.666667,510,128.090227,4,0
0,0,10,10,14,15,29,40,29,69,0.000333,0.111734,7,2346.404821,130.355823,335.200689,111.906328,2,0
0,0,13,13,11,14,25,45,35,80,0.000333,0.123836,10,3715.084952,206.393608,371.508495,91.356717,3,0
0,0,16,16,15,17,32,58,43,101,0.000333,0.168333,14,7070,392.777778,505,128.090227,4,0
0,0,10,10,14,15,29,40,29,69,0.000333,0.111734,7,2346.404821,130.355823,335.200689,111.906328,2,0
0,0,15,15,15,20,35,72,46,118,0.000333,0.201752,14,8473.575544,470.754197,605.255396,145.041921,5,0
0,0,6,6,10,11,21,18,16,34,0.000333,0.04978,5,746.693962,41.482998,149.338792,71.273029,1,0
0,0,17,17,16,18,34,56,66,122,0.000333,0.20689,24,14896.0912,827.560622,620.670467,139.05865,2,0
0,0,20,20,19,21,40,69,74,143,0.000333,0.253679,27,20547.96437,1141.553576,761.035718,172.949289,3,0
0,0,18,18,18,21,39,61,69,130,0.000333,0.229034,27,18551.76179,1030.653433,687.102288,167.297316,2,0
0,0,43,43,25,83,108,260,186,446,0.000333,1.004227,24,72304.31582,4016.906435,3012.679826,645.224678,18,0
0,0,13,13,15,31,46,84,56,140,0.000333,0.257766,7,5413.090717,300.727262,773.298674,212.183445,7,0
0,0,44,44,25,83,108,265,190,455,0.000333,1.024491,24,73763.37152,4097.965085,3073.473813,645.224678,18,0
0,0,13,13,15,31,46,84,56,140,0.000333,0.257766,7,5413.090717,300.727262,773.298674,212.183445,7,0
0,0,32,32,23,57,80,184,131,315,0.000333,0.663802,22,43810.9617,2433.942317,1991.40735,436.516656,13,0
0,0,13,13,15,30,45,84,56,140,0.000333,0.256286,7,5382.016034,299.000891,768.859433,205.810077,7,0
0,0,19,19,22,38,60,116,84,200,0.000333,0.393793,22,25990.31862,1443.90659,1181.378119,297.528741,7,0
0,0,33,33,23,61,84,185,136,321,0.000333,0.683978,22,45142.54564,2507.919202,2051.933893,465.816903,13,0
0,0,30,30,22,53,75,160,119,279,0.000333,0.57928,22,38232.48912,2124.027173,1737.840415,401.68728,11,0
0,0,20,20,23,40,63,128,91,219,0.000333,0.436341,22,28798.53467,1599.918593,1309.024303,316.919049,8,0
0,0,25,25,19,48,67,113,85,198,0.000333,0.400362,9,10809.77094,600.54283,1201.08566,348.788823,11,0
0,0,24,24,19,48,67,112,83,195,0.000333,0.394296,9,10645.98653,591.443696,1182.887392,348.788823,11,0
0,0,9,9,10,15,25,36,30,66,0.000333,0.102165,10,3064.945085,170.274727,306.494509,91.82264,2,0
0,0,12,12,14,18,32,49,38,87,0.000333,0.145,14,6090,338.333333,435,128.361619,3,0
0,0,10,10,13,18,31,41,33,74,0.000333,0.122204,6,2199.663162,122.203509,366.610527,123.164366,2,0
0,0,35,35,21,58,79,157,118,275,0.000333,0.577847,20,34670.79412,1926.155229,1733.539706,432.001564,13,0
0,0,34,34,21,58,79,156,116,272,0.000333,0.571543,20,34292.56727,1905.142626,1714.628364,432.001564,13,0
0,0,16,16,13,20,33,59,52,111,0.000333,0.186643,12,6719.132967,373.285165,559.927747,134.544278,2,0
0,0,19,19,16,23,39,72,60,132,0.000333,0.232558,16,11162.76949,620.15386,697.673093,168.041925,3,0
0,0,10,10,13,18,31,42,33,75,0.000333,0.123855,6,2229.38834,123.854908,371.564723,123.164366,2,0
0,0,15,15,12,18,30,49,47,96,0.000333,0.15702,12,5652.737966,314.040998,471.061497,118.0782,2,0
0,0,18,18,16,21,37,62,55,117,0.000333,0.203169,16,9752.0967,541.78315,609.506044,156.238666,3,0
0,0,10,10,14,15,29,40,29,69,0.000333,0.111734,7,2346.404821,130.355823,335.200689,111.906328,2,0
0,0,25,25,20,47,67,114,86,200,0.000333,0.404406,10,12132.17838,674.00991,1213.217838,347.504238,11,0
0,0,24,24,20,47,67,113,84,197,0.000333,0.39834,10,11950.19571,663.899761,1195.019571,347.504238,11,0
0,0,39,39,21,59,80,159,141,300,0.000333,0.632193,20,37931.56857,2107.309365,1896.578428,439.314606,13,0
0,0,38,38,21,59,80,158,139,297,0.000333,0.625871,20,37552.25288,2086.236271,1877.612644,439.314606,13,0
0,0,15,15,10,18,28,51,66,117,0.000333,0.187487,15,8436.907888,468.717105,562.460526,108.277931,2,0
0,0,18,18,14,21,35,64,74,138,0.000333,0.235947,21,14864.66218,825.814566,707.841056,145.541635,3,0
0,0,10,10,13,18,31,41,33,74,0.000333,0.122204,6,2199.663162,122.203509,366.610527,123.164366,2,0
0,0,34,34,21,57,78,149,114,263,0.000333,0.55102,20,33061.21567,1836.734204,1653.060784,424.713397,13,0
0,0,33,33,21,57,78,148,112,260,0.000333,0.544735,10,16342.04577,907.891432,1634.204577,424.713397,13,0
0,0,15,15,13,19,32,51,48,99,0.000333,0.165,12,5940,330,495,128.816339,2,0
0,0,18,18,16,22,38,64,56,120,0.000333,0.209917,16,10076.02083,559.778935,629.751302,162.107496,3,0
0,0,10,10,13,19,32,42,33,75,0.000333,0.125,6,2250,125,375,128.816339,2,0
0,0,13,13,11,15,26,44,34,78,0.000333,0.122211,10,3666.34298,203.685721,366.634298,96.657107,3,0
0,0,16,16,15,18,33,57,42,99,0.000333,0.166465,14,6991.530249,388.418347,499.395018,133.662009,4,0
0,0,13,13,11,15,26,44,34,78,0.000333,0.122211,10,3666.34298,203.685721,366.634298,96.657107,3,0
0,0,16,16,15,18,33,57,42,99,0.000333,0.166465,14,6991.530249,388.418347,499.395018,133.662009,4,0
0,0,6,6,9,10,19,17,15,32,0.000333,0.045311,4,543.734722,30.207485,135.93368,61.748606,1,0
0,0,6,6,9,10,19,17,15,32,0.000333,0.045311,4,543.734722,30.207485,135.93368,61.748606,1,0
0,0,21,21,18,44,62,104,79,183,0.000333,0.363206,9,9806.561323,544.808962,1089.617925,315.273641,9,0
0,0,21,21,18,45,63,104,81,185,0.000333,0.368599,9,9952.171073,552.898393,1105.796786,322.192039,9,0
0,0,6,6,7,11,18,14,18,32,0.000333,0.044479,3,400.3128,22.2396,133.4376,57.705232,1,0
0,0,7,7,8,14,22,17,20,37,0.000333,0.055,4,659.99588,36.666438,164.99897,77.302969,1,0
0,0,6,6,8,13,21,15,18,33,0.000333,0.048315,4,579.7859,32.210328,144.946475,72.105716,1,0
0,0,10,10,8,15,23,28,33,61,0.000333,0.091979,8,2207.498235,122.638791,275.937279,82.603359,1,0
0,0,10,10,12,16,28,32,35,67,0.000333,0.107364,12,3865.113357,214.72852,322.09278,107.01955,3,0
0,0,5,5,8,14,22,14,16,30,0.000333,0.044594,4,535.131794,29.729544,133.782949,77.302969,2,0
0,0,5,5,9,11,20,15,13,28,0.000333,0.040338,4,484.055947,26.891997,121.013987,66.583073,2,0
0,0,13,13,14,28,42,89,56,145,0.000333,0.260629,14,10946.40437,608.133576,781.886026,187.908907,8,0
0,0,15,15,14,31,45,98,64,162,0.000333,0.29656,14,12455.52282,691.97349,889.680202,206.883055,8,0
0,0,28,28,19,51,70,126,101,227,0.000333,0.463782,9,12522.1252,695.673622,1391.347245,370.004315,9,0
0,0,27,27,19,51,70,125,99,224,0.000333,0.457653,9,12356.63456,686.479698,1372.959396,370.004315,9,0
0,0,29,29,21,55,76,133,105,238,0.000333,0.495669,10,14870.06748,826.11486,1487.006748,410.21345,10,0
0,0,28,28,21,55,76,132,103,235,0.000333,0.489421,10,14682.62966,815.701648,1468.262966,410.21345,10,0
0,0,26,26,19,47,66,116,90,206,0.000333,0.415048,9,11206.3067,622.572594,1245.145189,341.776299,9,0
0,0,22,22,19,42,61,108,77,185,0.000333,0.365729,9,9874.677667,548.593204,1097.186407,307.187955,9,0
0,0,26,26,19,46,65,117,91,208,0.000333,0.417551,9,11273.87255,626.326253,1252.652505,334.794473,9,0
0,0,22,22,19,43,62,108,78,186,0.000333,0.36916,9,9967.324624,553.740257,1107.480514,314.040007,9,0
0,0,13,13,12,16,28,45,35,80,0.000333,0.128196,12,4615.060725,256.392263,384.588394,107.01955,3,0
0,0,16,16,15,19,34,58,43,101,0.000333,0.171278,14,7193.672458,399.64847,513.833747,139.313982,4,0
0,0,13,13,11,16,27,44,35,79,0.000333,0.125212,10,3756.361127,208.686729,375.636113,102.053748,3,0
0,0,16,16,15,19,34,57,43,100,0.000333,0.169582,14,7122.447978,395.691554,508.746284,139.313982,4,0
0,0,26,26,20,47,67,118,87,205,0.000333,0.414516,10,12435.48284,690.860158,1243.548284,347.504238,10,0
0,0,25,25,20,47,67,117,85,202,0.000333,0.40845,10,12253.50017,680.750009,1225.350016,347.504238,10,0
0,0,17,17,16,26,42,59,63,122,0.000333,0.219288,16,10525.80361,584.766867,657.862726,186.211433,3,0
0,0,14,14,17,20,37,43,58,101,0.000333,0.175385,16,8418.476639,467.693147,526.15479,155.92543,2,0
0,0,27,27,19,47,66,121,88,209,0.000333,0.421093,9,11369.50534,631.639185,1263.278371,341.776299,11,0
0,0,26,26,19,47,66,120,86,206,0.000333,0.415048,9,11206.3067,622.572594,1245.145189,341.776299,11,0
0,0,23,23,17,45,62,104,81,185,0.000333,0.367175,8,8812.210539,489.567252,1101.526317,316.620258,11,0
0,0,22,22,17,45,62,103,79,182,0.000333,0.361221,8,8669.309828,481.628324,1083.663728,316.620258,11,0
0,0,23,23,18,47,65,105,81,186,0.000333,0.373387,9,10081.44372,560.080207,1120.160413,336.124326,10,0
0,0,22,22,18,47,65,104,79,183,0.000333,0.367364,9,9918.839788,551.046655,1102.09331,336.124326,10,0
0,0,6,6,9,10,19,17,15,32,0.000333,0.045311,4,543.734722,30.207485,135.93368,61.748606,1,0
0,0,6,6,9,10,19,17,15,32,0.000333,0.045311,4,543.734722,30.207485,135.93368,61.748606,1,0
0,0,5,5,9,13,22,18,19,37,0.000333,0.055,4,659.99588,36.666438,164.99897,76.635041,2,0
0,0,6,6,9,14,23,19,21,40,0.000333,0.060314,4,723.769913,40.20944,180.942478,81.832294,2,0
0,0,10,10,11,17,28,37,32,69,0.000333,0.110569,5,1658.537448,92.140969,331.70749,107.540616,2,0
0,0,13,13,15,20,35,50,40,90,0.000333,0.153878,14,6462.896601,359.049811,461.635472,145.041921,3,0
0,0,10,10,14,15,29,40,29,69,0.000333,0.111734,7,2346.404821,130.355823,335.200689,111.906328,2,0
0,0,5,5,10,12,22,20,16,36,0.000333,0.053513,5,802.697691,44.594316,160.539538,76.238831,2,0
0,0,6,6,10,13,23,21,18,39,0.000333,0.058806,5,882.094581,49.005255,176.418916,81.324997,2,0
0,0,5,5,11,13,24,21,17,38,0.000333,0.058076,5,871.142875,48.396826,174.228575,86.159464,2,0
0,0,6,6,11,14,25,22,19,41,0.000333,0.063466,5,951.990519,52.888362,190.398104,91.356717,2,0
0,0,13,13,11,14,25,45,34,79,0.000333,0.122288,10,3668.64639,203.813688,366.864639,91.356717,3,0
0,0,16,16,15,17,32,58,42,100,0.000333,0.166667,14,7000,388.888889,500,128.090227,4,0
0,0,13,13,11,14,25,45,34,79,0.000333,0.122288,10,3668.64639,203.813688,366.864639,91.356717,3,0
0,0,16,16,15,17,32,58,42,100,0.000333,0.166667,14,7000,388.888889,500,128.090227,4,0
0,0,8,8,9,15,24,30,27,57,0.000333,0.087114,4,1045.37145,58.076192,261.342863,87.132684,1,0
0,0,8,8,10,17,27,30,26,56,0.000333,0.088758,5,1331.368501,73.964917,266.2737,102.706149,1,0
0,0,8,8,10,17,27,31,27,58,0.000333,0.091928,5,1378.917376,76.606521,275.783475,102.706149,1,0
0,0,10,10,9,15,24,40,37,77,0.000333,0.117681,8,2824.3369,156.907606,353.042113,87.132684,1,0
0,0,10,10,10,17,27,40,37,77,0.000333,0.122042,10,3661.263377,203.403521,366.126338,102.706149,1,0
0,0,11,11,10,18,28,44,40,84,0.000333,0.134606,10,4038.178135,224.34323,403.817813,108.277931,1,0
0,0,13,13,12,16,28,45,35,80,0.000333,0.128196,12,4615.060725,256.392263,384.588394,107.01955,3,0
0,0,16,16,15,19,34,58,43,101,0.000333,0.171278,14,7193.672458,399.64847,513.833747,139.313982,4,0
0,0,10,10,14,15,29,40,29,69,0.000333,0.111734,7,2346.404821,130.355823,335.200689,111.906328,2,0
0,0,13,13,11,16,27,44,35,79,0.000333,0.125212,10,3756.361127,208.686729,375.636113,102.053748,3,0
0,0,16,16,15,19,34,57,43,100,0.000333,0.169582,14,7122.447978,395.691554,508.746284,139.313982,4,0
0,0,10,10,14,15,29,40,29,69,0.000333,0.111734,7,2346.404821,130.355823,335.200689,111.906328,2,0
0,0,12,12,11,14,25,41,33,74,0.000333,0.114548,10,3436.45358,190.914088,343.645358,91.356717,2,0
0,0,15,15,15,17,32,54,41,95,0.000333,0.158333,14,6650,369.444444,475,128.090227,3,0
0,0,10,10,14,15,29,40,29,69,0.000333,0.111734,7,2346.404821,130.355823,335.200689,111.906328,2,0
0,0,13,13,12,27,39,45,53,98,0.000333,0.172656,6,3107.816505,172.656472,517.969417,171.401513,1,0
0,0,19,19,17,34,51,79,80,159,0.000333,0.300639,16,14430.65007,801.702782,901.915629,242.460605,4,0
0,0,20,20,19,37,56,94,88,182,0.000333,0.352313,18,19024.89473,1056.938596,1056.938596,273.460397,5,0
0,0,23,23,24,44,68,117,105,222,0.000333,0.450472,24,32434.00202,1801.889001,1351.416751,350.254091,6,0
0,0,15,15,13,26,39,49,64,113,0.000333,0.199083,12,7167.005409,398.166967,597.250451,170.317149,1,0
0,0,22,22,18,34,52,86,98,184,0.000333,0.349627,18,18879.85635,1048.880908,1048.880908,248.032387,4,0
0,0,23,23,20,37,57,101,106,207,0.000333,0.402469,20,24148.16466,1341.564703,1207.408233,279.188336,5,0
0,0,26,26,25,44,69,124,123,247,0.000333,0.502935,24,36211.33298,2011.740721,1508.805541,356.311396,6,0
0,0,5,5,8,14,22,14,16,30,0.000333,0.044594,4,535.131794,29.729544,133.782949,77.302969,2,0
0,0,5,5,9,11,20,15,13,28,0.000333,0.040338,4,484.055947,26.891997,121.013987,66.583073,2,0
0,0,15,15,14,32,46,98,64,162,0.000333,0.298272,14,12527.43852,695.968806,894.817037,213.302969,8,0
0,0,5,5,9,11,20,15,13,28,0.000333,0.040338,4,484.055947,26.891997,121.013987,66.583073,2,0
0,0,13,13,14,29,43,89,56,145,0.000333,0.262269,7,5507.658726,305.98104,786.808389,194.184418,8,0
0,0,15,15,14,32,46,98,64,162,0.000333,0.298272,14,12527.43852,695.968806,894.817037,213.302969,8,0
0,0,23,23,17,45,62,104,81,185,0.000333,0.367175,8,8812.210539,489.567252,1101.526317,316.620258,9,0
0,0,22,22,17,45,62,103,79,182,0.000333,0.361221,8,8669.309828,481.628324,1083.663728,316.620258,9,0
0,0,23,23,18,47,65,105,81,186,0.000333,0.373387,9,10081.44372,560.080207,1120.160413,336.124326,9,0
0,0,22,22,18,47,65,104,79,183,0.000333,0.367364,9,9918.839788,551.046655,1102.09331,336.124326,9,0
0,0,7,7,12,13,25,24,17,41,0.000333,0.063466,6,1142.388623,63.466035,190.398104,91.125266,3,0
0,0,7,7,12,13,25,24,17,41,0.000333,0.063466,6,1142.388623,63.466035,190.398104,91.125266,3,0
0,0,12,12,12,20,32,58,38,96,0.000333,0.16,6,2880,160,480,129.458112,7,0
0,0,6,6,10,13,23,24,18,42,0.000333,0.06333,5,949.948011,52.774889,189.989602,81.324997,4,0
0,0,6,6,11,11,22,25,16,41,0.000333,0.060946,5,914.183482,50.787971,182.836696,76.107496,4,0
0,0,12,12,13,18,31,59,36,95,0.000333,0.156883,12,5647.783794,313.765766,470.648649,123.164366,7,0
0,0,6,6,11,11,22,25,16,41,0.000333,0.060946,5,914.183482,50.787971,182.836696,76.107496,4,0
0,0,12,12,13,18,31,59,36,95,0.000333,0.156883,12,5647.783794,313.765766,470.648649,123.164366,7,0
0,0,11,11,11,19,30,55,37,92,0.000333,0.150478,5,2257.169674,125.398315,451.433935,118.764371,6,0
0,0,5,5,9,12,21,21,17,38,0.000333,0.055636,4,667.632248,37.09068,166.908062,71.548875,3,0
0,0,5,5,10,10,20,22,15,37,0.000333,0.053304,5,799.556698,44.419817,159.91134,66.438562,3,0
0,0,11,11,12,17,29,56,35,91,0.000333,0.147359,12,5304.915247,294.717514,442.076271,112.506418,6,0
0,0,11,11,11,19,30,55,37,92,0.000333,0.150478,5,2257.169674,125.398315,451.433935,118.764371,6,0
0,0,5,5,9,12,21,21,17,38,0.000333,0.055636,4,667.632248,37.09068,166.908062,71.548875,3,0
0,0,5,5,10,10,20,22,15,37,0.000333,0.053304,5,799.556698,44.419817,159.91134,66.438562,3,0
0,0,11,11,12,17,29,56,35,91,0.000333,0.147359,12,5304.915247,294.717514,442.076271,112.506418,6,0
0,0,13,13,14,22,36,49,37,86,0.000333,0.148205,7,3112.294851,172.905269,444.61355,151.410465,4,0
0,0,12,12,14,22,36,48,35,83,0.000333,0.143035,7,3003.726426,166.87369,429.103775,151.410465,4,0
0,0,13,13,14,22,36,49,37,86,0.000333,0.148205,7,3112.294851,172.905269,444.61355,151.410465,4,0
0,0,12,12,14,22,36,48,35,83,0.000333,0.143035,7,3003.726426,166.87369,429.103775,151.410465,4,0
0,0,18,18,14,23,37,77,54,131,0.000333,0.227479,14,9554.137473,530.785415,682.438391,157.344894,5,0
0,0,18,18,14,23,37,77,54,131,0.000333,0.227479,14,9554.137473,530.785415,682.438391,157.344894,5,0
0,0,17,17,14,23,37,76,52,128,0.000333,0.22227,14,9335.340431,518.630024,666.810031,157.344894,5,0
0,0,17,17,14,23,37,76,52,128,0.000333,0.22227,14,9335.340431,518.630024,666.810031,157.344894,5,0
0,0,12,12,16,24,40,52,41,93,0.000333,0.16498,8,3959.514503,219.973028,494.939313,174.0391,4,0
0,0,11,11,16,24,40,51,39,90,0.000333,0.159658,8,3831.788228,212.877124,478.973529,174.0391,4,0
0,0,15,15,12,19,31,49,44,93,0.000333,0.15358,12,5528.883082,307.160171,460.740257,123.730173,2,0
0,0,18,18,16,22,38,62,52,114,0.000333,0.199421,16,9572.219785,531.789988,598.263737,162.107496,3,0
0,0,16,16,15,24,39,68,54,122,0.000333,0.21494,14,9027.46699,501.525944,644.819071,168.642459,4,0
0,0,17,17,15,24,39,69,56,125,0.000333,0.220225,14,9249.453883,513.858549,660.675277,168.642459,4,0
0,0,17,17,15,25,40,76,58,134,0.000333,0.237713,14,9983.937106,554.663173,713.138365,174.699764,4,0
0,0,18,18,15,25,40,77,60,137,0.000333,0.243035,14,10207.45809,567.081005,729.104149,174.699764,4,0
0,0,24,24,20,28,48,99,82,181,0.000333,0.336959,20,20217.56425,1123.198014,1010.878213,221.0445,7,0
0,0,14,14,17,19,36,45,56,101,0.000333,0.174054,16,8354.598802,464.144378,522.162425,150.197491,2,0
0,0,16,16,12,15,27,54,48,102,0.000333,0.161666,18,8729.973454,484.998525,484.998525,101.622909,3,0
0,0,19,19,16,18,34,67,56,123,0.000333,0.208586,24,15018.19031,834.343906,625.757929,139.05865,4,0
0,0,10,10,14,15,29,40,29,69,0.000333,0.111734,7,2346.404821,130.355823,335.200689,111.906328,2,0
0,0,16,16,12,15,27,54,48,102,0.000333,0.161666,18,8729.973454,484.998525,484.998525,101.622909,3,0
0,0,19,19,16,18,34,67,56,123,0.000333,0.208586,24,15018.19031,834.343906,625.757929,139.05865,4,0
0,0,10,10,14,15,29,40,29,69,0.000333,0.111734,7,2346.404821,130.355823,335.200689,111.906328,2,0
0,0,11,11,12,20,32,42,42,84,0.000333,0.14,12,5040,280,420,129.458112,2,0
0,0,12,12,12,20,32,43,44,87,0.000333,0.145,12,5220,290,435,129.458112,2,0
0,0,5,5,10,12,22,22,19,41,0.000333,0.060946,5,914.183482,50.787971,182.836696,76.238831,2,0
0,0,9,9,11,15,26,30,32,62,0.000333,0.097142,10,2914.272625,161.904035,291.427263,96.657107,2,0
0,0,14,14,14,27,41,57,63,120,0.000333,0.214302,14,9000.687368,500.038187,642.906241,181.684931,5,0
0,0,20,20,17,41,58,92,69,161,0.000333,0.314378,8,7545.079522,419.171085,943.13494,289.1465,8,0
0,0,19,19,17,41,58,91,67,158,0.000333,0.30852,8,7404.487978,411.360443,925.560997,289.1465,8,0
0,0,20,20,18,40,58,93,68,161,0.000333,0.314378,9,8488.214462,471.56747,943.13494,287.935774,7,0
0,0,19,19,18,40,58,92,66,158,0.000333,0.30852,9,8330.048975,462.780499,925.560997,287.935774,7,0
0,0,24,24,20,45,65,117,90,207,0.000333,0.415543,20,24932.60275,1385.144597,1246.630137,333.571951,11,0
0,0,23,23,20,45,65,116,88,204,0.000333,0.409521,10,12285.63034,682.535019,1228.563034,333.571951,11,0
0,0,25,25,24,48,72,124,95,219,0.000333,0.450405,12,16214.5629,900.80905,1351.213575,378.1173,12,0
0,0,24,24,24,48,72,123,93,216,0.000333,0.444235,12,15992.4456,888.4692,1332.7038,378.1173,12,0
0,0,28,28,18,50,68,123,99,222,0.000333,0.450472,9,12162.75076,675.708375,1351.416751,357.25146,9,0
0,0,27,27,18,50,68,122,97,219,0.000333,0.444385,9,11998.38926,666.577181,1333.154362,357.25146,9,0
0,0,29,29,19,52,71,128,102,230,0.000333,0.471481,9,12729.97654,707.220919,1414.441837,377.133488,10,0
0,0,28,28,19,52,71,127,100,227,0.000333,0.465331,9,12563.93337,697.996298,1395.992596,377.133488,10,0
0,0,35,35,22,64,86,198,152,350,0.000333,0.749731,22,49482.23861,2749.013256,2249.192664,482.107496,14,0
0,0,29,29,22,49,71,160,117,277,0.000333,0.567827,22,37476.55895,2082.031053,1703.479952,373.228278,12,0
0,0,35,35,22,64,86,198,152,350,0.000333,0.749731,22,49482.23861,2749.013256,2249.192664,482.107496,14,0
0,0,13,13,14,35,49,86,61,147,0.000333,0.275121,7,5777.53643,320.974246,825.362347,232.827875,7,0
0,0,25,25,19,47,66,114,93,207,0.000333,0.417063,9,11260.70624,625.594791,1251.189583,341.776299,9,0
0,0,25,25,20,48,68,115,99,214,0.000333,0.434239,20,26054.34096,1447.463387,1302.717048,354.516762,9,0
0,0,16,16,12,15,27,54,48,102,0.000333,0.161666,18,8729.973454,484.998525,484.998525,101.622909,3,0
0,0,19,19,16,18,34,67,56,123,0.000333,0.208586,24,15018.19031,834.343906,625.757929,139.05865,4,0
0,0,16,16,12,15,27,54,48,102,0.000333,0.161666,18,8729.973454,484.998525,484.998525,101.622909,3,0
0,0,19,19,16,18,34,67,56,123,0.000333,0.208586,24,15018.19031,834.343906,625.757929,139.05865,4,0
0,0,8,8,14,18,32,36,34,70,0.000333,0.116667,7,2450,136.111111,350,128.361619,3,0
0,0,9,9,14,18,32,37,36,73,0.000333,0.121667,14,5110,283.888889,365,128.361619,3,0
0,0,9,9,18,21,39,43,39,82,0.000333,0.144468,9,3900.626838,216.701491,433.402982,167.297316,5,0
0,0,10,10,18,21,39,44,41,85,0.000333,0.149753,9,4043.332697,224.629594,449.259189,167.297316,5,0
0,0,5,5,9,13,22,18,19,37,0.000333,0.055,4,659.99588,36.666438,164.99897,76.635041,2,0
0,0,6,6,9,14,23,19,21,40,0.000333,0.060314,4,723.769913,40.20944,180.942478,81.832294,2,0
0,0,5,5,10,15,25,19,19,38,0.000333,0.058822,5,882.332676,49.018482,176.466535,91.82264,2,0
0,0,6,6,10,16,26,20,21,41,0.000333,0.064239,5,963.590142,53.532786,192.718028,97.219281,2,0
0,0,13,13,12,20,32,46,61,107,0.000333,0.178333,18,9630,535,535,129.458112,3,0
0,0,14,14,12,20,32,47,63,110,0.000333,0.183333,18,9900,550,550,129.458112,3,0
0,0,14,14,16,23,39,53,72,125,0.000333,0.220225,24,15856.20666,880.90037,660.675277,168.041925,5,0
0,0,15,15,16,23,39,54,74,128,0.000333,0.22551,24,16236.75562,902.041979,676.531484,168.041925,5,0
0,0,11,11,12,19,31,41,51,92,0.000333,0.151929,12,5469.432727,303.857374,455.786061,123.730173,3,0
0,0,12,12,12,19,31,42,53,95,0.000333,0.156883,12,5647.783794,313.765766,470.648649,123.730173,3,0
0,0,12,12,16,22,38,48,60,108,0.000333,0.188925,16,9068.418743,503.801041,566.776171,162.107496,5,0
0,0,13,13,16,22,38,49,62,111,0.000333,0.194173,16,9320.319264,517.795515,582.519954,162.107496,5,0
0,0,15,15,15,20,35,72,46,118,0.000333,0.201752,14,8473.575544,470.754197,605.255396,145.041921,5,0
0,0,6,6,11,11,22,18,16,34,0.000333,0.05054,5,758.103375,42.116854,151.620675,76.107496,1,0
0,0,7,7,11,15,26,26,19,45,0.000333,0.070507,5,1057.598937,58.755496,211.519787,96.657107,3,0
0,0,8,8,12,13,25,34,21,55,0.000333,0.085137,6,1532.472543,85.137363,255.41209,91.125266,4,0
0,0,7,7,12,13,25,27,17,44,0.000333,0.06811,6,1225.978034,68.109891,204.329672,91.125266,3,0
0,0,25,25,24,48,72,122,88,210,0.000333,0.431895,12,15548.211,863.7895,1295.68425,378.1173,13,0
0,0,24,24,24,48,72,121,86,207,0.000333,0.425725,12,15326.0937,851.44965,1277.174475,378.1173,13,0
0,0,25,25,24,48,72,122,88,210,0.000333,0.431895,12,15548.211,863.7895,1295.68425,378.1173,13,0
0,0,24,24,24,48,72,121,86,207,0.000333,0.425725,12,15326.0937,851.44965,1277.174475,378.1173,13,0
0,0,28,28,20,49,69,123,95,218,0.000333,0.443886,10,13316.58332,739.810184,1331.658332,361.559344,9,0
0,0,27,27,20,49,69,122,93,215,0.000333,0.437778,10,13133.32758,729.62931,1313.332758,361.559344,9,0
0,0,14,14,11,17,28,47,45,92,0.000333,0.147426,10,4422.766528,245.709252,442.276653,107.540616,2,0
0,0,17,17,15,20,35,60,53,113,0.000333,0.193203,14,8114.525733,450.806985,579.608981,145.041921,3,0
0,0,10,10,13,18,31,41,33,74,0.000333,0.122204,6,2199.663162,122.203509,366.610527,123.164366,2,0
0,0,23,23,18,44,62,106,78,184,0.000333,0.365191,9,9860.14909,547.786061,1095.572121,315.273641,9,0
0,0,22,22,18,44,62,105,76,181,0.000333,0.359237,9,9699.38579,538.854766,1077.709532,315.273641,9,0
0,0,23,23,19,45,64,107,79,186,0.000333,0.372,9,10044,558,1116,327.844012,9,0
0,0,22,22,19,45,64,106,77,183,0.000333,0.366,9,9882,549,1098,327.844012,9,0
0,0,13,13,11,21,32,45,51,96,0.000333,0.16,10,4800,266.666667,480,130.292414,2,0
0,0,12,12,11,21,32,44,49,93,0.000333,0.155,10,4650,258.333333,465,130.292414,2,0
0,0,14,14,13,25,38,52,57,109,0.000333,0.190675,12,6864.289188,381.349399,572.024099,164.202121,3,0
0,0,13,13,13,25,38,51,55,106,0.000333,0.185427,12,6675.363797,370.853544,556.280316,164.202121,3,0
0,0,13,13,13,22,35,53,48,101,0.000333,0.172686,12,6216.691017,345.371723,518.057585,146.213212,2,0
0,0,12,12,13,22,35,52,46,98,0.000333,0.167557,12,6032.036828,335.113157,502.669736,146.213212,2,0
0,0,14,14,15,26,41,60,52,112,0.000333,0.200015,14,8400.641543,466.702308,600.045825,180.814792,3,0
0,0,13,13,15,26,41,59,50,109,0.000333,0.194658,7,4087.81218,227.100677,583.973169,180.814792,3,0
0,0,13,13,12,16,28,45,35,80,0.000333,0.128196,12,4615.060725,256.392263,384.588394,107.01955,3,0
0,0,16,16,15,19,34,58,43,101,0.000333,0.171278,14,7193.672458,399.64847,513.833747,139.313982,4,0
0,0,10,10,14,15,29,40,29,69,0.000333,0.111734,7,2346.404821,130.355823,335.200689,111.906328,2,0
0,0,13,13,11,16,27,44,35,79,0.000333,0.125212,10,3756.361127,208.686729,375.636113,102.053748,3,0
0,0,16,16,15,19,34,57,43,100,0.000333,0.169582,14,7122.447978,395.691554,508.746284,139.313982,4,0
0,0,10,10,14,15,29,40,29,69,0.000333,0.111734,7,2346.404821,130.355823,335.200689,111.906328,2,0
0,0,15,15,12,16,28,49,37,86,0.000333,0.137811,12,4961.19028,275.621682,413.432523,107.01955,3,0
0,0,18,18,16,19,35,62,45,107,0.000333,0.182944,16,8781.332525,487.851807,548.833283,144.710623,4,0
0,0,10,10,14,15,29,40,29,69,0.000333,0.111734,7,2346.404821,130.355823,335.200689,111.906328,2,0
0,0,15,15,12,16,28,49,37,86,0.000333,0.137811,12,4961.19028,275.621682,413.432523,107.01955,3,0
0,0,18,18,16,19,35,62,45,107,0.000333,0.182944,16,8781.332525,487.851807,548.833283,144.710623,4,0
0,0,10,10,14,15,29,40,29,69,0.000333,0.111734,7,2346.404821,130.355823,335.200689,111.906328,2,0
0,0,13,13,12,15,27,45,35,80,0.000333,0.126797,12,4564.692002,253.594,380.391,101.622909,3,0
0,0,16,16,15,18,33,58,43,101,0.000333,0.169828,14,7132.773285,396.265182,509.483806,133.662009,4,0
0,0,10,10,14,15,29,40,29,69,0.000333,0.111734,7,2346.404821,130.355823,335.200689,111.906328,2,0
0,0,13,13,11,15,26,44,35,79,0.000333,0.123778,10,3713.347377,206.297077,371.334738,96.657107,3,0
0,0,16,16,15,18,33,57,43,100,0.000333,0.168146,14,7062.151767,392.341765,504.439412,133.662009,4,0
0,0,10,10,14,15,29,40,29,69,0.000333,0.111734,7,2346.404821,130.355823,335.200689,111.906328,2,0
0,0,16,16,12,19,31,52,54,106,0.000333,0.175048,12,6301.737707,350.096539,525.144809,123.730173,3,0
0,0,19,19,16,22,38,65,62,127,0.000333,0.222162,16,10663.78871,592.432706,666.486794,162.107496,4,0
0,0,16,16,12,19,31,52,54,106,0.000333,0.175048,12,6301.737707,350.096539,525.144809,123.730173,3,0
0,0,19,19,16,22,38,65,62,127,0.000333,0.222162,16,10663.78871,592.432706,666.486794,162.107496,4,0
0,0,15,15,12,20,32,48,44,92,0.000333,0.153333,12,5520,306.666667,460,129.458112,2,0
0,0,18,18,16,23,39,61,52,113,0.000333,0.199083,16,9556.007212,530.88929,597.250451,168.041925,3,0
0,0,10,10,14,15,29,40,29,69,0.000333,0.111734,7,2346.404821,130.355823,335.200689,111.906328,2,0
0,0,14,14,13,15,28,48,39,87,0.000333,0.139413,12,5018.878539,278.826585,418.239878,106.709075,2,0
0,0,17,17,16,18,34,61,47,108,0.000333,0.183149,16,8791.13579,488.396433,549.445987,139.05865,3,0
0,0,10,10,14,15,29,40,29,69,0.000333,0.111734,7,2346.404821,130.355823,335.200689,111.906328,2,0
0,0,25,25,19,48,67,113,85,198,0.000333,0.400362,9,10809.77094,600.54283,1201.08566,348.788823,11,0
0,0,24,24,19,48,67,112,83,195,0.000333,0.394296,9,10645.98653,591.443696,1182.887392,348.788823,11,0
0,0,9,9,11,13,24,37,28,65,0.000333,0.099341,10,2980.225625,165.56809,298.022563,86.159464,2,0
0,0,12,12,15,16,31,50,36,86,0.000333,0.14202,14,5964.852358,331.380687,426.060883,122.603359,3,0
0,0,10,10,14,16,30,42,31,73,0.000333,0.119401,7,2507.421094,139.301172,358.203013,117.302969,2,0
0,0,5,5,9,13,22,19,17,36,0.000333,0.053513,4,642.158153,35.675453,160.539538,76.635041,2,0
0,0,6,6,9,14,23,20,19,39,0.000333,0.058806,4,705.675665,39.204204,176.418916,81.832294,2,0
0,0,9,9,11,13,24,37,28,65,0.000333,0.099341,10,2980.225625,165.56809,298.022563,86.159464,2,0
0,0,12,12,15,16,31,50,36,86,0.000333,0.14202,14,5964.852358,331.380687,426.060883,122.603359,3,0
0,0,10,10,14,16,30,42,31,73,0.000333,0.119401,7,2507.421094,139.301172,358.203013,117.302969,2,0
0,0,15,15,12,19,31,49,44,93,0.000333,0.15358,12,5528.883082,307.160171,460.740257,123.730173,2,0
0,0,18,18,16,22,38,62,52,114,0.000333,0.199421,16,9572.219785,531.789988,598.263737,162.107496,3,0
0,0,10,10,14,15,29,40,29,69,0.000333,0.111734,7,2346.404821,130.355823,335.200689,111.906328,2,0
0,0,10,10,13,16,29,37,28,65,0.000333,0.105256,6,1894.612588,105.256255,315.768765,112.105716,3,0
0,0,27,27,18,47,65,118,97,215,0.000333,0.431603,18,23306.56344,1294.80908,1294.80908,336.124326,7,0
0,0,26,26,18,47,65,117,95,212,0.000333,0.425581,18,22981.35558,1276.741976,1276.741976,336.124326,7,0
0,0,23,23,17,43,60,102,79,181,0.000333,0.356382,8,8553.177582,475.176532,1069.147198,302.816253,7,0
0,0,7,7,8,14,22,18,21,39,0.000333,0.057973,4,695.671333,38.648407,173.917833,77.302969,1,0
0,0,13,13,10,20,30,40,45,85,0.000333,0.139029,10,4170.857006,231.714278,417.085701,119.657843,1,0
0,0,26,26,18,47,65,113,93,206,0.000333,0.413536,9,11165.46993,620.303885,1240.607769,336.124326,7,0
0,0,25,25,18,47,65,112,91,203,0.000333,0.407514,9,11002.86599,611.270333,1222.540666,336.124326,7,0
0,0,20,20,17,41,58,91,71,162,0.000333,0.316331,8,7591.94337,421.774632,948.992921,289.1465,7,0
0,0,19,19,17,41,58,90,69,159,0.000333,0.310473,8,7451.351826,413.96399,931.418978,289.1465,7,0
0,0,27,27,19,49,68,126,98,224,0.000333,0.454531,18,24544.65018,1363.591676,1363.591676,355.831405,7,0
0,0,26,26,19,49,68,125,96,221,0.000333,0.448443,9,12107.96359,672.664644,1345.329288,355.831405,7,0
0,0,28,28,21,53,74,133,102,235,0.000333,0.486407,10,14592.21541,810.678634,1459.221541,395.81845,8,0
0,0,27,27,21,53,74,132,100,232,0.000333,0.480198,10,14405.93181,800.329545,1440.593181,395.81845,8,0
0,0,20,20,17,42,59,94,70,164,0.000333,0.321584,8,7718.027681,428.779316,964.75346,295.9642,7,0
0,0,19,19,17,42,59,93,68,161,0.000333,0.315702,8,7576.844248,420.935792,947.105531,295.9642,7,0
0,0,20,20,18,41,59,95,69,164,0.000333,0.321584,9,8682.781141,482.37673,964.75346,294.718282,7,0
0,0,19,19,18,41,59,94,67,161,0.000333,0.315702,9,8523.949779,473.552765,947.105531,294.718282,7,0
0,0,27,27,19,50,69,119,100,219,0.000333,0.445922,18,24079.80341,1337.766856,1337.766856,362.903432,7,0
0,0,26,26,19,50,69,118,98,216,0.000333,0.439814,9,11874.97154,659.720641,1319.441283,362.903432,7,0
0,0,28,28,21,54,75,126,104,230,0.000333,0.477543,10,14326.28299,795.90461,1432.628299,403.002591,8,0
0,0,27,27,21,54,75,125,102,227,0.000333,0.471314,10,14139.41843,785.523246,1413.941843,403.002591,8,0
0,0,10,10,12,13,25,32,27,59,0.000333,0.091329,12,3287.850182,182.658343,273.987515,91.125266,2,0
0,0,11,11,13,13,26,36,28,64,0.000333,0.100276,12,3609.937704,200.552095,300.828142,96.211433,2,0
0,0,12,12,14,13,27,39,31,70,0.000333,0.110947,14,4659.789752,258.877208,332.842125,101.408685,2,0
0,0,12,12,14,12,26,40,32,72,0.000333,0.112811,14,4738.043236,263.224624,338.43166,96.322519,2,0
0,0,9,9,12,13,25,28,25,53,0.000333,0.082041,6,1476.746268,82.041459,246.124378,91.125266,2,0
0,0,9,9,13,15,28,29,25,54,0.000333,0.086532,6,1557.582995,86.532389,259.597166,106.709075,2,0
0,0,9,9,10,15,25,36,30,66,0.000333,0.102165,10,3064.945085,170.274727,306.494509,91.82264,2,0
0,0,12,12,14,18,32,49,38,87,0.000333,0.145,14,6090,338.333333,435,128.361619,3,0
0,0,10,10,13,18,31,41,33,74,0.000333,0.122204,6,2199.663162,122.203509,366.610527,123.164366,2,0
0,0,5,5,12,11,23,19,14,33,0.000333,0.049759,6,895.665267,49.759182,149.277545,81.073298,3,0
0,0,5,5,11,11,22,18,14,32,0.000333,0.047567,5,713.509059,39.639392,142.701812,76.107496,3,0
0,0,15,15,12,15,27,49,37,86,0.000333,0.136307,12,4907.043902,272.61355,408.920325,101.622909,3,0
0,0,18,18,16,18,34,62,45,107,0.000333,0.181453,16,8709.736384,483.874244,544.358524,139.05865,4,0
0,0,15,15,12,14,26,49,37,86,0.000333,0.134746,12,4850.853789,269.491877,404.237816,96.322519,3,0
0,0,18,18,16,17,33,62,45,107,0.000333,0.179917,16,8636.002732,479.77793,539.750171,133.486868,4,0
0,0,13,13,11,14,25,45,34,79,0.000333,0.122288,10,3668.64639,203.813688,366.864639,91.356717,3,0
0,0,16,16,15,17,32,58,42,100,0.000333,0.166667,14,7000,388.888889,500,128.090227,4,0
0,0,13,13,11,14,25,45,34,79,0.000333,0.122288,10,3668.64639,203.813688,366.864639,91.356717,3,0
0,0,16,16,15,17,32,58,42,100,0.000333,0.166667,14,7000,388.888889,500,128.090227,4,0
0,0,5,5,10,12,22,20,16,36,0.000333,0.053513,5,802.697691,44.594316,160.539538,76.238831,2,0
0,0,6,6,10,13,23,21,18,39,0.000333,0.058806,5,882.094581,49.005255,176.418916,81.324997,2,0
0,0,5,5,11,13,24,21,17,38,0.000333,0.058076,5,871.142875,48.396826,174.228575,86.159464,2,0
0,0,6,6,11,14,25,22,19,41,0.000333,0.063466,5,951.990519,52.888362,190.398104,91.356717,2,0
0,0,9,9,11,18,29,35,27,62,0.000333,0.100398,5,1505.974108,83.665228,301.194822,113.112398,4,0
0,0,10,10,11,18,29,36,29,65,0.000333,0.105256,5,1578.843823,87.713546,315.768765,113.112398,4,0
0,0,9,9,11,18,29,35,27,62,0.000333,0.100398,5,1505.974108,83.665228,301.194822,113.112398,4,0
0,0,10,10,11,18,29,36,29,65,0.000333,0.105256,5,1578.843823,87.713546,315.768765,113.112398,4,0
0,0,11,11,12,19,31,41,51,92,0.000333,0.151929,12,5469.432727,303.857374,455.786061,123.730173,10,0
0,0,12,12,12,19,31,42,53,95,0.000333,0.156883,12,5647.783794,313.765766,470.648649,123.730173,10,0
0,0,12,12,16,22,38,48,60,108,0.000333,0.188925,16,9068.418743,503.801041,566.776171,162.107496,11,0
0,0,13,13,16,22,38,49,62,111,0.000333,0.194173,16,9320.319264,517.795515,582.519954,162.107496,11,0
0,0,26,26,18,48,66,111,95,206,0.000333,0.415048,9,11206.3067,622.572594,1245.145189,343.13685,7,0
0,0,25,25,18,48,66,110,93,203,0.000333,0.409004,9,11043.10806,613.506003,1227.012006,343.13685,7,0
0,0,27,27,19,50,69,116,98,214,0.000333,0.435741,9,11765.0181,653.612117,1307.224234,362.903432,8,0
0,0,26,26,19,50,69,115,96,211,0.000333,0.429633,9,11600.08794,644.44933,1288.89866,362.903432,8,0
0,0,30,30,18,48,66,120,116,236,0.000333,0.475492,18,25676.58622,1426.477012,1426.477012,343.13685,7,0
0,0,29,29,18,48,66,119,114,233,0.000333,0.469448,18,25350.18894,1408.34383,1408.34383,343.13685,7,0
0,0,31,31,19,50,69,125,125,250,0.000333,0.509044,18,27488.36006,1527.131114,1527.131114,362.903432,8,0
0,0,30,30,19,50,69,124,123,247,0.000333,0.502935,18,27158.49974,1508.805541,1508.805541,362.903432,8,0
0,0,25,25,18,46,64,110,89,199,0.000333,0.398,9,10746,597,1194,329.1425,7,0
0,0,24,24,18,46,64,109,87,196,0.000333,0.392,9,10584,588,1176,329.1425,7,0
0,0,26,26,19,48,67,115,92,207,0.000333,0.41856,9,11301.12416,627.840231,1255.680462,348.788823,8,0
0,0,25,25,19,48,67,114,90,204,0.000333,0.412494,9,11137.33975,618.741097,1237.482195,348.788823,8,0
0,0,10,10,12,16,28,32,27,59,0.000333,0.094545,6,1701.803642,94.544647,283.63394,107.01955,2,0
0,0,31,31,18,49,67,123,119,242,0.000333,0.489331,18,26423.88451,1467.993584,1467.993584,350.179432,7,0
0,0,30,30,18,49,67,122,117,239,0.000333,0.483265,18,26096.3157,1449.795317,1449.795317,350.179432,7,0
0,0,7,7,7,12,19,16,20,36,0.000333,0.050975,3,458.776171,25.487565,152.92539,62.671034,1,0
0,0,7,7,8,15,23,17,21,38,0.000333,0.057298,4,687.581417,38.198968,171.895354,82.603359,1,0
0,0,18,18,15,24,39,67,58,125,0.000333,0.220225,14,9249.453883,513.858549,660.675277,168.642459,3,0
0,0,20,20,17,41,58,91,71,162,0.000333,0.316331,8,7591.94337,421.774632,948.992921,289.1465,7,0
0,0,19,19,17,41,58,90,69,159,0.000333,0.310473,8,7451.351826,413.96399,931.418978,289.1465,7,0
0,0,6,6,10,13,23,23,21,44,0.000333,0.066346,5,995.18363,55.287979,199.036726,81.324997,3,0
0,0,10,10,11,16,27,31,34,65,0.000333,0.103023,10,3090.676876,171.704271,309.067688,102.053748,3,0
0,0,21,21,18,44,62,104,79,183,0.000333,0.363206,9,9806.561323,544.808962,1089.617925,315.273641,9,0
0,0,34,34,20,52,72,138,125,263,0.000333,0.540897,20,32453.80551,1802.989195,1622.690275,382.861427,9,0
0,0,33,33,20,52,72,137,123,260,0.000333,0.534727,20,32083.61001,1782.422778,1604.1805,382.861427,9,0
0,0,15,15,10,18,28,51,66,117,0.000333,0.187487,15,8436.907888,468.717105,562.460526,108.277931,2,0
0,0,18,18,14,21,35,64,74,138,0.000333,0.235947,21,14864.66218,825.814566,707.841056,145.541635,3,0
0,0,10,10,13,18,31,41,33,74,0.000333,0.122204,6,2199.663162,122.203509,366.610527,123.164366,2,0
0,0,10,10,14,21,35,45,35,80,0.000333,0.136781,7,2872.398489,159.577694,410.342641,145.541635,5,0
0,0,10,10,14,21,35,45,35,80,0.000333,0.136781,7,2872.398489,159.577694,410.342641,145.541635,5,0
0,0,8,8,7,14,21,22,24,46,0.000333,0.067349,3,606.139804,33.674434,202.046601,72.954453,1,0
0,0,8,8,10,17,27,30,26,56,0.000333,0.088758,5,1331.368501,73.964917,266.2737,102.706149,1,0
0,0,8,8,8,16,24,23,24,47,0.000333,0.071831,4,861.97295,47.887386,215.493238,88,1,0
0,0,10,10,10,17,27,40,37,77,0.000333,0.122042,10,3661.263377,203.403521,366.126338,102.706149,1,0
0,0,11,11,8,17,25,36,37,73,0.000333,0.113001,8,2712.012015,150.667334,339.001502,93.486868,1,0
0,0,7,7,13,16,29,29,22,51,0.000333,0.082586,6,1486.542185,82.585677,247.757031,112.105716,5,0
0,0,8,8,13,17,30,30,24,54,0.000333,0.088324,6,1589.832553,88.324031,264.972092,117.592585,5,0
0,0,7,7,13,16,29,29,22,51,0.000333,0.082586,6,1486.542185,82.585677,247.757031,112.105716,5,0
0,0,8,8,13,17,30,30,24,54,0.000333,0.088324,6,1589.832553,88.324031,264.972092,117.592585,5,0
0,0,24,24,21,33,54,104,93,197,0.000333,0.377904,20,22674.25676,1259.680931,1133.712838,258.703672,7,0
0,0,14,14,18,25,43,51,67,118,0.000333,0.213433,18,11525.38634,640.299241,640.299241,191.155055,2,0
0,0,7,7,9,14,23,23,20,43,0.000333,0.064838,4,778.052656,43.225148,194.513164,81.832294,2,0
0,0,10,10,15,17,32,36,28,64,0.000333,0.106667,7,2240,124.444444,320,128.090227,3,0
0,0,6,6,13,14,27,26,20,46,0.000333,0.072908,6,1312.348951,72.908275,218.724825,101.408685,3,0
0,0,11,11,13,21,34,44,35,79,0.000333,0.13397,6,2411.457387,133.969855,401.909564,140.344382,5,0
0,0,10,10,13,20,33,43,33,76,0.000333,0.127791,6,2300.243718,127.791318,383.373953,134.544278,5,0
0,0,9,9,13,19,32,42,31,73,0.000333,0.121667,6,2190,121.666667,365,128.816339,5,0
0,0,7,7,10,10,20,24,16,40,0.000333,0.057626,5,864.385619,48.021423,172.877124,66.438562,2,0
0,0,10,10,16,13,29,37,24,61,0.000333,0.098779,8,2370.694726,131.705263,296.336841,112.105716,3,0
0,0,6,6,13,13,26,27,18,45,0.000333,0.070507,6,1269.118724,70.506596,211.519787,96.211433,3,0
0,0,10,10,16,16,32,46,28,74,0.000333,0.123333,8,2960,164.444444,370,128,4,0
0,0,6,6,14,10,24,27,16,43,0.000333,0.065718,7,1380.073713,76.670762,197.153388,86.52225,3,0
0,0,11,11,14,17,31,45,31,76,0.000333,0.125506,7,2635.632437,146.424024,376.51892,122.789837,5,0
0,0,10,10,14,16,30,44,29,73,0.000333,0.119401,7,2507.421094,139.301172,358.203013,117.302969,5,0
0,0,9,9,14,15,29,43,27,70,0.000333,0.113353,7,2380.410688,132.245038,340.05867,111.906328,5,0
0,0,17,17,14,23,37,87,56,143,0.000333,0.248317,14,10429.32564,579.40698,744.951831,157.344894,8,0
0,0,12,12,11,18,29,45,33,78,0.000333,0.126308,5,1894.612588,105.256255,378.922518,113.112398,2,0
0,0,15,15,15,21,36,58,41,99,0.000333,0.170608,7,3582.758026,199.042113,511.822575,150.842025,3,0
0,0,12,12,15,22,37,49,37,86,0.000333,0.149338,7,3136.090926,174.227274,448.012989,156.710855,3,0
0,0,15,15,17,25,42,67,45,112,0.000333,0.201313,8,4831.516411,268.417578,603.939551,185.583273,4,0
0,0,12,12,15,20,35,50,35,85,0.000333,0.14533,7,3051.923395,169.5513,435.989056,145.041921,3,0
0,0,8,8,11,17,28,28,22,50,0.000333,0.080123,5,1201.838731,66.768818,240.367746,107.540616,2,0
0,0,19,19,17,27,44,92,58,150,0.000333,0.272972,16,13102.63589,727.924216,818.914743,197.868831,6,0
0,0,6,6,9,14,23,19,16,35,0.000333,0.052775,4,633.298674,35.18326,158.324668,81.832294,2,0
0,0,8,8,14,17,31,35,24,59,0.000333,0.097433,7,2046.083076,113.671282,292.297582,122.789837,3,0
0,0,13,13,16,26,42,66,42,108,0.000333,0.194123,8,4658.962253,258.831236,582.370282,186.211433,5,0
0,0,16,16,14,25,39,58,46,104,0.000333,0.183227,7,3847.772815,213.765156,549.681831,169.399374,5,0
0,0,14,14,14,24,38,56,42,98,0.000333,0.171432,7,3600.078274,200.004349,514.296896,163.342069,5,0
0,0,12,12,14,23,37,54,38,92,0.000333,0.159757,7,3354.887967,186.382665,479.26971,157.344894,5,0
0,0,13,13,14,25,39,53,39,92,0.000333,0.162086,7,3403.799029,189.099946,486.257004,169.399374,5,0
0,0,12,12,14,24,38,52,37,89,0.000333,0.155689,7,3269.458841,181.636602,467.065549,163.342069,5,0
0,0,11,11,14,23,37,51,35,86,0.000333,0.149338,7,3136.090926,174.227274,448.012989,157.344894,5,0
0,0,11,11,14,23,37,51,35,86,0.000333,0.149338,7,3136.090926,174.227274,448.012989,157.344894,5,0
0,0,21,21,17,22,39,118,66,184,0.000333,0.324171,24,23340.3362,1296.685344,972.514008,167.594364,8,0
0,0,17,17,15,19,34,88,52,140,0.000333,0.237415,14,9971.427169,553.968176,712.244798,139.313982,8,0
0,0,13,13,12,14,26,50,31,81,0.000333,0.126912,12,4568.827406,253.823745,380.735617,96.322519,2,0
0,0,16,16,16,17,33,63,39,102,0.000333,0.171509,16,8232.451203,457.3584,514.5282,133.486868,3,0
0,0,13,13,16,18,34,54,35,89,0.000333,0.150928,8,3622.273543,201.237419,452.784193,139.05865,3,0
0,0,16,16,18,21,39,72,43,115,0.000333,0.202607,18,10940.78259,607.821255,607.821255,167.297316,4,0
0,0,13,13,16,17,33,55,33,88,0.000333,0.147969,8,3551.25346,197.291859,443.906683,133.486868,3,0
0,0,9,9,12,14,26,33,20,53,0.000333,0.083041,6,1494.73983,83.041102,249.123305,96.322519,2,0
0,0,20,20,18,23,41,97,56,153,0.000333,0.273235,18,14754.69822,819.705457,819.705457,179.100575,6,0
0,0,8,8,14,17,31,36,22,58,0.000333,0.095781,7,2011.403702,111.74465,287.343386,122.789837,3,0
0,0,20,20,17,22,39,106,60,166,0.000333,0.292459,16,14038.02829,779.890461,877.376768,167.594364,7,0
0,0,8,8,15,13,28,36,20,56,0.000333,0.089737,7,1884.483129,104.693507,269.211876,106.709075,3,0
0,0,13,13,17,22,39,67,38,105,0.000333,0.184989,8,4439.737864,246.652104,554.967233,167.594364,5,0
0,0,16,16,15,21,36,59,42,101,0.000333,0.174054,14,7310.273952,406.126331,522.162425,150.842025,5,0
0,0,14,14,15,20,35,57,38,95,0.000333,0.162427,7,3410.973206,189.498511,487.281887,145.041921,5,0
0,0,12,12,15,19,34,55,34,89,0.000333,0.150928,7,3169.48935,176.082742,452.784193,139.313982,5,0
0,0,11,11,13,20,33,45,30,75,0.000333,0.12611,6,2269.977354,126.109853,378.329559,134.544278,4,0
0,0,11,11,13,17,30,41,27,68,0.000333,0.111223,6,2002.011363,111.222854,333.668561,117.592585,4,0
0,0,12,12,15,20,35,53,33,86,0.000333,0.147039,7,3087.828376,171.546021,441.118339,145.041921,5,0
0,0,11,11,15,19,34,52,31,83,0.000333,0.140753,7,2955.815911,164.211995,422.259416,139.313982,5,0
0,0,11,11,15,19,34,52,31,83,0.000333,0.140753,7,2955.815911,164.211995,422.259416,139.313982,5,0
0,0,7,7,9,16,25,23,21,44,0.000333,0.06811,4,817.318689,45.406594,204.329672,92.529325,2,0
0,0,10,10,14,19,33,36,29,65,0.000333,0.109295,7,2295.199324,127.511074,327.885618,134.013592,3,0
0,0,6,6,12,15,27,26,21,47,0.000333,0.074493,6,1340.878276,74.493238,223.479713,101.622909,3,0
0,0,11,11,12,23,35,44,36,80,0.000333,0.136781,6,2462.055848,136.78088,410.342641,147.061475,5,0
0,0,10,10,12,22,34,43,34,77,0.000333,0.130578,6,2350.407833,130.578213,391.734639,141.127046,5,0
0,0,9,9,12,21,33,42,32,74,0.000333,0.124428,6,2239.710989,124.428388,373.285165,135.258216,5,0
0,0,7,7,11,12,23,25,17,42,0.000333,0.06333,5,949.948011,52.774889,189.989602,81.073298,2,0
0,0,10,10,15,15,30,38,25,63,0.000333,0.103045,7,2163.938753,120.21882,309.134108,117.206718,3,0
0,0,6,6,13,15,28,28,19,47,0.000333,0.075315,6,1355.674088,75.315227,225.945681,106.709075,3,0
0,0,10,10,15,18,33,47,29,76,0.000333,0.127791,7,2683.617671,149.089871,383.373953,133.662009,4,0
0,0,6,6,13,11,24,28,17,45,0.000333,0.068774,6,1237.939875,68.774438,206.323313,86.159464,3,0
0,0,9,9,12,18,30,37,27,64,0.000333,0.10468,6,1884.245989,104.680333,314.040998,118.0782,4,0
0,0,9,9,12,15,27,33,24,57,0.000333,0.090343,6,1626.171526,90.342863,271.028588,101.622909,4,0
0,0,10,10,14,18,32,45,30,75,0.000333,0.125,7,2625,145.833333,375,128.361619,5,0
0,0,9,9,14,17,31,44,28,72,0.000333,0.118901,7,2496.91494,138.717497,356.702134,122.789837,5,0
0,0,7,7,10,12,22,24,17,41,0.000333,0.060946,5,914.183482,50.787971,182.836696,76.238831,2,0
0,0,10,10,15,15,30,37,25,62,0.000333,0.101409,7,2129.590518,118.310584,304.227217,117.206718,3,0
0,0,6,6,12,15,27,27,19,46,0.000333,0.072908,6,1312.348951,72.908275,218.724825,101.622909,3,0
0,0,10,10,15,18,33,46,29,75,0.000333,0.12611,7,2648.306913,147.128162,378.329559,133.662009,4,0
0,0,6,6,13,11,24,27,17,44,0.000333,0.067246,6,1210.4301,67.246117,201.73835,86.159464,3,0
0,0,11,11,13,19,32,45,32,77,0.000333,0.128333,6,2310,128.333333,385,128.816339,5,0
0,0,10,10,13,18,31,44,30,74,0.000333,0.122204,6,2199.663162,122.203509,366.610527,123.164366,5,0
0,0,9,9,13,17,30,43,28,71,0.000333,0.11613,6,2090.335394,116.129744,348.389232,117.592585,5,0
0,0,13,13,11,14,25,45,34,79,0.000333,0.122288,10,3668.64639,203.813688,366.864639,91.356717,3,0
0,0,16,16,15,17,32,58,42,100,0.000333,0.166667,14,7000,388.888889,500,128.090227,4,0
0,0,13,13,11,13,24,45,34,79,0.000333,0.120737,10,3622.120376,201.22891,362.212038,86.159464,3,0
0,0,16,16,15,16,31,58,42,100,0.000333,0.16514,14,6935.874835,385.32638,495.419631,122.603359,4,0
0,0,13,13,11,14,25,45,34,79,0.000333,0.122288,10,3668.64639,203.813688,366.864639,91.356717,3,0
0,0,16,16,15,17,32,58,42,100,0.000333,0.166667,14,7000,388.888889,500,128.090227,4,0
0,0,13,13,11,14,25,45,34,79,0.000333,0.122288,10,3668.64639,203.813688,366.864639,91.356717,3,0
0,0,16,16,15,17,32,58,42,100,0.000333,0.166667,14,7000,388.888889,500,128.090227,4,0
0,0,13,13,11,14,25,45,34,79,0.000333,0.122288,10,3668.64639,203.813688,366.864639,91.356717,3,0
0,0,16,16,15,17,32,58,42,100,0.000333,0.166667,14,7000,388.888889,500,128.090227,4,0
0,0,10,10,14,15,29,40,29,69,0.000333,0.111734,7,2346.404821,130.355823,335.200689,111.906328,2,0
0,0,13,13,11,14,25,45,34,79,0.000333,0.122288,10,3668.64639,203.813688,366.864639,91.356717,3,0
0,0,16,16,15,17,32,58,42,100,0.000333,0.166667,14,7000,388.888889,500,128.090227,4,0
0,0,10,10,14,15,29,40,29,69,0.000333,0.111734,7,2346.404821,130.355823,335.200689,111.906328,2,0
0,0,5,5,10,12,22,20,16,36,0.000333,0.053513,5,802.697691,44.594316,160.539538,76.238831,2,0
0,0,6,6,10,13,23,21,18,39,0.000333,0.058806,5,882.094581,49.005255,176.418916,81.324997,2,0
0,0,9,9,12,14,26,29,23,52,0.000333,0.081474,6,1466.537192,81.474288,244.422865,96.322519,3,0
0,0,10,10,13,14,27,33,24,57,0.000333,0.090343,6,1626.171526,90.342863,271.028588,101.408685,3,0
0,0,10,10,13,14,27,33,24,57,0.000333,0.090343,6,1626.171526,90.342863,271.028588,101.408685,3,0
0,0,9,9,12,13,25,29,22,51,0.000333,0.078946,6,1421.019994,78.945555,236.836666,91.125266,3,0
0,0,10,10,13,13,26,33,23,56,0.000333,0.087742,6,1579.347745,87.741541,263.224624,96.211433,3,0
0,0,10,10,13,13,26,33,23,56,0.000333,0.087742,6,1579.347745,87.741541,263.224624,96.211433,3,0
0,0,9,9,12,13,25,29,22,51,0.000333,0.078946,6,1421.019994,78.945555,236.836666,91.125266,3,0
0,0,10,10,13,13,26,33,23,56,0.000333,0.087742,6,1579.347745,87.741541,263.224624,96.211433,3,0
0,0,10,10,13,13,26,33,23,56,0.000333,0.087742,6,1579.347745,87.741541,263.224624,96.211433,3,0
0,0,9,9,12,13,25,29,22,51,0.000333,0.078946,6,1421.019994,78.945555,236.836666,91.125266,3,0
0,0,10,10,13,13,26,33,23,56,0.000333,0.087742,6,1579.347745,87.741541,263.224624,96.211433,3,0
0,0,10,10,13,13,26,33,23,56,0.000333,0.087742,6,1579.347745,87.741541,263.224624,96.211433,3,0
0,0,8,8,12,12,24,26,21,47,0.000333,0.071831,6,1292.959425,71.831079,215.493238,86.0391,2,0
0,0,9,9,13,12,25,30,22,52,0.000333,0.080494,6,1448.883131,80.493507,241.480522,91.125266,2,0
0,0,14,14,11,17,28,47,45,92,0.000333,0.147426,10,4422.766528,245.709252,442.276653,107.540616,2,0
0,0,17,17,15,20,35,60,53,113,0.000333,0.193203,14,8114.525733,450.806985,579.608981,145.041921,3,0
0,0,10,10,13,18,31,41,33,74,0.000333,0.122204,6,2199.663162,122.203509,366.610527,123.164366,2,0
0,0,23,23,24,43,67,112,84,196,0.000333,0.396318,12,14267.44178,792.635654,1188.953481,343.368484,10,0
0,0,22,22,24,43,67,111,82,193,0.000333,0.390252,12,14049.06257,780.503476,1170.755214,343.368484,10,0
0,0,23,23,19,43,62,103,80,183,0.000333,0.363206,9,9806.561323,544.808962,1089.617925,314.040007,7,0
0,0,19,19,19,38,57,95,67,162,0.000333,0.314976,9,8504.353641,472.464091,944.928182,280.131868,7,0
0,0,23,23,19,42,61,104,81,185,0.000333,0.365729,9,9874.677667,548.593204,1097.186407,307.187955,7,0
0,0,19,19,19,39,58,95,68,163,0.000333,0.318284,9,8593.65812,477.425451,954.850902,286.841309,7,0
0,0,26,26,21,50,71,121,90,211,0.000333,0.432532,10,12975.96642,720.887023,1297.596642,374.431475,8,0
0,0,25,25,21,50,71,120,88,208,0.000333,0.426382,10,12791.47401,710.637445,1279.147401,374.431475,8,0
0,0,7,7,14,15,29,29,21,50,0.000333,0.080966,7,1700.293348,94.460742,242.89905,111.906328,5,0
0,0,8,8,14,16,30,30,23,53,0.000333,0.086688,7,1820.456411,101.136467,260.065202,117.302969,5,0
0,0,15,15,15,20,35,51,52,103,0.000333,0.176105,14,7396.42611,410.912562,528.316151,145.041921,2,0
0,0,18,18,18,23,41,64,60,124,0.000333,0.221445,18,11958.05607,664.336449,664.336449,179.100575,3,0
0,0,16,16,17,23,40,56,55,111,0.000333,0.196911,16,9451.744297,525.096905,590.734019,173.528793,2,0
0,0,9,9,10,15,25,36,30,66,0.000333,0.102165,10,3064.945085,170.274727,306.494509,91.82264,2,0
0,0,12,12,14,18,32,49,38,87,0.000333,0.145,14,6090,338.333333,435,128.361619,3,0
0,0,10,10,13,18,31,41,33,74,0.000333,0.122204,6,2199.663162,122.203509,366.610527,123.164366,2,0
0,0,9,9,10,18,28,32,34,66,0.000333,0.105762,5,1586.427124,88.13484,317.285425,108.277931,2,0
0,0,10,10,10,18,28,33,36,69,0.000333,0.110569,10,3317.074896,184.281939,331.70749,108.277931,2,0
0,0,10,10,11,21,32,37,39,76,0.000333,0.126667,5,1900,105.555556,380,130.292414,3,0
0,0,11,11,11,21,32,38,41,79,0.000333,0.131667,5,1975,109.722222,395,130.292414,3,0
0,0,10,10,11,21,32,37,39,76,0.000333,0.126667,5,1900,105.555556,380,130.292414,3,0
0,0,11,11,11,21,32,38,41,79,0.000333,0.131667,5,1975,109.722222,395,130.292414,3,0
0,0,9,9,12,18,30,35,27,62,0.000333,0.101409,6,1825.363302,101.409072,304.227217,118.0782,3,0
0,0,10,10,12,18,30,36,29,65,0.000333,0.106316,6,1913.687332,106.315963,318.947889,118.0782,3,0
0,0,20,20,17,41,58,91,71,162,0.000333,0.316331,8,7591.94337,421.774632,948.992921,289.1465,7,0
0,0,19,19,17,41,58,90,69,159,0.000333,0.310473,8,7451.351826,413.96399,931.418978,289.1465,7,0
0,0,20,20,18,43,61,92,71,163,0.000333,0.322237,9,8700.391674,483.355093,966.710186,308.388034,7,0
0,0,19,19,18,43,61,91,69,160,0.000333,0.316306,9,8540.261766,474.458987,948.917974,308.388034,7,0
0,0,25,25,19,46,65,110,89,199,0.000333,0.399484,9,10786.06075,599.225597,1198.451195,334.794473,7,0
0,0,24,24,19,46,65,109,87,196,0.000333,0.393461,9,10623.45682,590.192046,1180.384091,334.794473,7,0
0,0,26,26,20,48,68,115,92,207,0.000333,0.420035,10,12601.04808,700.058227,1260.104808,354.516762,8,0
0,0,25,25,20,48,68,114,90,204,0.000333,0.413947,10,12418.4242,689.912455,1241.84242,354.516762,8,0
0,0,30,30,19,48,67,120,116,236,0.000333,0.477199,18,25768.74688,1431.597049,1431.597049,348.788823,7,0
0,0,29,29,19,48,67,119,114,233,0.000333,0.471133,18,25441.17807,1413.398781,1413.398781,348.788823,7,0
0,0,31,31,20,50,70,125,125,250,0.000333,0.510774,20,30646.41509,1702.578616,1532.320754,368.631371,8,0
0,0,30,30,20,50,70,124,123,247,0.000333,0.504644,20,30278.6581,1682.147672,1513.932905,368.631371,8,0
0,0,24,24,19,45,64,108,79,187,0.000333,0.374,9,10098,561,1122,327.844012,9,0
0,0,23,23,19,45,64,107,77,184,0.000333,0.368,9,9936,552,1104,327.844012,9,0
0,0,24,24,19,45,64,108,79,187,0.000333,0.374,9,10098,561,1122,327.844012,9,0
0,0,23,23,19,45,64,107,77,184,0.000333,0.368,9,9936,552,1104,327.844012,9,0
0,0,10,10,15,19,34,47,37,84,0.000333,0.142449,7,2991.428151,166.190453,427.346879,139.313982,5,0
0,0,5,5,9,10,19,13,14,27,0.000333,0.038231,4,458.776171,25.487565,114.694043,61.748606,1,0
0,0,9,9,10,16,26,36,31,67,0.000333,0.104976,5,1574.647306,87.480406,314.929461,97.219281,1,0
0,0,9,9,10,18,28,37,31,68,0.000333,0.108967,5,1634.500673,90.805593,326.900135,108.277931,1,0
0,0,9,9,11,18,29,37,31,68,0.000333,0.110114,5,1651.713538,91.761863,330.342708,113.112398,1,0
0,0,11,11,10,16,26,46,41,87,0.000333,0.136313,10,4089.382555,227.18792,408.938255,97.219281,1,0
0,0,11,11,10,18,28,47,42,89,0.000333,0.142618,10,4278.545881,237.696993,427.854588,108.277931,1,0
0,0,12,12,11,19,30,50,44,94,0.000333,0.153749,10,4612.47716,256.248731,461.247716,118.764371,1,0
0,0,13,13,11,14,25,45,34,79,0.000333,0.122288,10,3668.64639,203.813688,366.864639,91.356717,3,0
0,0,16,16,15,17,32,58,42,100,0.000333,0.166667,14,7000,388.888889,500,128.090227,4,0
0,0,10,10,14,15,29,40,29,69,0.000333,0.111734,7,2346.404821,130.355823,335.200689,111.906328,2,0
0,0,13,13,11,14,25,45,34,79,0.000333,0.122288,10,3668.64639,203.813688,366.864639,91.356717,3,0
0,0,16,16,15,17,32,58,42,100,0.000333,0.166667,14,7000,388.888889,500,128.090227,4,0
0,0,10,10,14,15,29,40,29,69,0.000333,0.111734,7,2346.404821,130.355823,335.200689,111.906328,2,0
0,0,13,13,11,14,25,45,34,79,0.000333,0.122288,10,3668.64639,203.813688,366.864639,91.356717,3,0
0,0,16,16,15,17,32,58,42,100,0.000333,0.166667,14,7000,388.888889,500,128.090227,4,0
0,0,13,13,11,14,25,45,34,79,0.000333,0.122288,10,3668.64639,203.813688,366.864639,91.356717,3,0
0,0,16,16,15,17,32,58,42,100,0.000333,0.166667,14,7000,388.888889,500,128.090227,4,0
0,0,15,15,12,19,31,49,44,93,0.000333,0.15358,12,5528.883082,307.160171,460.740257,123.730173,2,0
0,0,18,18,16,22,38,62,52,114,0.000333,0.199421,16,9572.219785,531.789988,598.263737,162.107496,3,0
0,0,5,5,8,14,22,14,16,30,0.000333,0.044594,4,535.131794,29.729544,133.782949,77.302969,2,0
0,0,5,5,9,11,20,15,13,28,0.000333,0.040338,4,484.055947,26.891997,121.013987,66.583073,2,0
0,0,13,13,15,29,44,89,56,145,0.000333,0.263873,7,5541.323093,307.851283,791.617585,199.484808,8,0
0,0,15,15,15,32,47,98,64,162,0.000333,0.299948,14,12597.80752,699.878195,899.843394,218.603359,8,0
0,0,5,5,9,11,20,15,13,28,0.000333,0.040338,4,484.055947,26.891997,121.013987,66.583073,2,0
0,0,13,13,15,29,44,89,56,145,0.000333,0.263873,7,5541.323093,307.851283,791.617585,199.484808,8,0
0,0,15,15,15,32,47,98,64,162,0.000333,0.299948,14,12597.80752,699.878195,899.843394,218.603359,8,0
0,0,30,30,22,52,74,136,97,233,0.000333,0.482268,11,15914.82898,884.157165,1446.802634,394.530361,11,0
0,0,29,29,22,52,74,135,95,230,0.000333,0.476058,11,15709.91702,872.773168,1428.174274,394.530361,11,0
0,0,30,30,22,52,74,136,97,233,0.000333,0.482268,11,15914.82898,884.157165,1446.802634,394.530361,11,0
0,0,29,29,22,52,74,135,95,230,0.000333,0.476058,11,15709.91702,872.773168,1428.174274,394.530361,11,0
0,0,27,27,19,49,68,118,96,214,0.000333,0.434239,9,11724.45343,651.358524,1302.717048,355.831405,9,0
0,0,26,26,19,49,68,117,94,211,0.000333,0.428152,9,11560.09194,642.22733,1284.45466,355.831405,9,0
0,0,28,28,20,51,71,123,99,222,0.000333,0.455081,10,13652.43861,758.468811,1365.243861,375.732254,10,0
0,0,27,27,20,51,71,122,97,219,0.000333,0.448932,10,13467.94619,748.219233,1346.794619,375.732254,10,0
0,0,23,23,17,45,62,105,79,184,0.000333,0.365191,8,8764.576969,486.920943,1095.572121,316.620258,9,0
0,0,22,22,17,45,62,104,77,181,0.000333,0.359237,8,8621.676257,478.982014,1077.709532,316.620258,9,0
0,0,23,23,18,44,62,106,78,184,0.000333,0.365191,9,9860.14909,547.786061,1095.572121,315.273641,9,0
0,0,22,22,18,44,62,105,76,181,0.000333,0.359237,9,9699.38579,538.854766,1077.709532,315.273641,9,0
0,0,6,6,7,11,18,14,18,32,0.000333,0.044479,3,400.3128,22.2396,133.4376,57.705232,1,0
0,0,7,7,8,14,22,18,21,39,0.000333,0.057973,4,695.671333,38.648407,173.917833,77.302969,1,0
0,0,17,17,11,20,31,60,55,115,0.000333,0.189911,10,5697.325757,316.518098,569.732576,124.49231,2,0
0,0,20,20,15,23,38,73,63,136,0.000333,0.237906,14,9992.053986,555.11411,713.718142,162.645284,3,0
0,0,10,10,13,19,32,43,33,76,0.000333,0.126667,6,2280,126.666667,380,128.816339,2,0
0,0,16,16,15,22,37,55,50,105,0.000333,0.182331,14,7657.896447,425.438692,546.992603,156.710855,3,0
0,0,15,15,13,18,31,52,48,100,0.000333,0.16514,12,5945.035572,330.279754,495.419631,123.164366,2,0
0,0,18,18,16,21,37,65,56,121,0.000333,0.210115,16,10085.50172,560.305651,630.343857,156.238666,3,0
0,0,10,10,13,19,32,42,33,75,0.000333,0.125,6,2250,125,375,128.816339,2,0
0,0,6,6,10,13,23,25,22,47,0.000333,0.070869,5,1063.03706,59.057614,212.607412,81.324997,3,0
0,0,10,10,11,16,27,33,35,68,0.000333,0.107777,10,3233.323501,179.629083,323.33235,102.053748,3,0
0,0,16,16,10,22,32,50,67,117,0.000333,0.195,15,8775,487.5,585,131.326777,2,0
0,0,17,17,10,22,32,51,69,120,0.000333,0.2,15,9000,500,600,131.326777,2,0
0,0,15,15,12,20,32,48,44,92,0.000333,0.153333,12,5520,306.666667,460,129.458112,2,0
0,0,18,18,16,23,39,61,52,113,0.000333,0.199083,16,9556.007212,530.88929,597.250451,168.041925,3,0
0,0,10,10,14,15,29,40,29,69,0.000333,0.111734,7,2346.404821,130.355823,335.200689,111.906328,2,0
0,0,14,14,13,15,28,48,39,87,0.000333,0.139413,12,5018.878539,278.826585,418.239878,106.709075,2,0
0,0,17,17,16,18,34,61,47,108,0.000333,0.183149,16,8791.13579,488.396433,549.445987,139.05865,3,0
0,0,10,10,14,15,29,40,29,69,0.000333,0.111734,7,2346.404821,130.355823,335.200689,111.906328,2,0
0,0,9,9,12,12,24,30,28,58,0.000333,0.088643,12,3191.133901,177.285217,265.927825,86.0391,2,0
0,0,9,9,12,12,24,30,28,58,0.000333,0.088643,12,3191.133901,177.285217,265.927825,86.0391,2,0
0,0,8,8,11,12,23,25,22,47,0.000333,0.070869,5,1063.03706,59.057614,212.607412,81.073298,2,0
0,0,6,6,11,19,30,24,27,51,0.000333,0.083417,5,1251.257102,69.514283,250.25142,118.764371,2,0
0,0,7,7,13,17,30,33,34,67,0.000333,0.109587,12,3945.140039,219.174447,328.76167,117.592585,3,0
0,0,5,5,9,18,27,25,23,48,0.000333,0.076078,4,912.9384,50.7188,228.2346,103.587975,3,0
0,0,7,7,9,14,23,23,21,44,0.000333,0.066346,4,796.146904,44.230384,199.036726,81.832294,3,0
0,0,9,9,9,14,23,29,23,52,0.000333,0.078408,4,940.900887,52.272271,235.225222,81.832294,4,0
0,0,10,10,10,19,29,46,31,77,0.000333,0.124688,5,1870.322683,103.906816,374.064537,113.929904,5,0
0,0,6,6,12,15,27,25,23,48,0.000333,0.076078,6,1369.407601,76.0782,228.2346,101.622909,2,0
0,0,7,7,14,13,27,34,30,64,0.000333,0.101438,14,4260.379202,236.687733,304.3128,101.408685,3,0
0,0,5,5,10,14,24,26,19,45,0.000333,0.068774,5,1031.616563,57.312031,206.323313,86.52225,3,0
0,0,7,7,10,10,20,24,17,41,0.000333,0.059066,5,885.995259,49.221959,177.199052,66.438562,3,0
0,0,9,9,10,10,20,30,19,49,0.000333,0.070591,5,1058.872383,58.826244,211.774477,66.438562,4,0
0,0,10,10,11,15,26,47,27,74,0.000333,0.115944,5,1739.162696,96.62015,347.832539,96.657107,5,0
0,0,13,13,12,14,26,44,34,78,0.000333,0.122211,12,4399.611576,244.422865,366.634298,96.322519,3,0
0,0,16,16,16,17,33,57,42,99,0.000333,0.166465,16,7990.320285,443.906683,499.395018,133.486868,4,0
0,0,10,10,14,15,29,40,29,69,0.000333,0.111734,7,2346.404821,130.355823,335.200689,111.906328,2,0
0,0,9,9,12,22,34,31,31,62,0.000333,0.105141,6,1892.536177,105.140899,315.422696,141.127046,3,0
0,0,10,10,14,20,34,40,38,78,0.000333,0.132274,7,2777.754711,154.319706,396.822102,139.741531,4,0
0,0,8,8,10,21,31,32,27,59,0.000333,0.097433,5,1461.487912,81.193773,292.297582,125.457947,4,0
0,0,10,10,10,17,27,30,25,55,0.000333,0.087173,5,1307.594063,72.644115,261.518813,102.706149,4,0
0,0,12,12,10,17,27,36,27,63,0.000333,0.099853,5,1497.789563,83.210531,299.557913,102.706149,5,0
0,0,13,13,11,22,33,53,35,88,0.000333,0.147969,5,2219.533413,123.307412,443.906683,136.161243,6,0
0,0,6,6,11,11,22,25,20,45,0.000333,0.066891,5,1003.372114,55.742895,200.674423,76.107496,3,0
0,0,9,9,13,17,30,32,27,59,0.000333,0.096502,6,1737.039271,96.502182,289.506545,117.592585,3,0
0,0,9,9,13,14,27,30,27,57,0.000333,0.090343,6,1626.171526,90.342863,271.028588,101.408685,3,0
0,0,8,8,11,16,27,33,23,56,0.000333,0.088758,5,1331.368501,73.964917,266.2737,102.053748,4,0
0,0,10,10,11,13,24,31,21,52,0.000333,0.079473,5,1192.09025,66.227236,238.41805,86.159464,4,0
0,0,12,12,11,13,24,37,23,60,0.000333,0.091699,5,1375.48875,76.416042,275.09775,86.159464,5,0
0,0,13,13,12,17,29,54,31,85,0.000333,0.137643,6,2477.570308,137.642795,412.928385,112.506418,6,0
0,0,9,9,13,18,31,32,27,59,0.000333,0.097433,6,1753.785494,97.432527,292.297582,123.164366,3,0
0,0,10,10,15,16,31,41,34,75,0.000333,0.123855,14,5201.906126,288.994785,371.564723,122.603359,4,0
0,0,8,8,11,17,28,33,23,56,0.000333,0.089737,5,1346.059378,74.781077,269.211876,107.540616,4,0
0,0,10,10,11,13,24,31,21,52,0.000333,0.079473,5,1192.09025,66.227236,238.41805,86.159464,4,0
0,0,12,12,11,13,24,37,23,60,0.000333,0.091699,5,1375.48875,76.416042,275.09775,86.159464,5,0
0,0,13,13,12,18,30,54,31,85,0.000333,0.139029,6,2502.514204,139.028567,417.085701,118.0782,6,0
0,0,13,13,16,20,36,50,34,84,0.000333,0.144758,8,3474.189601,193.010533,434.2737,150.438562,5,0
0,0,13,13,16,20,36,50,34,84,0.000333,0.144758,8,3474.189601,193.010533,434.2737,150.438562,5,0
0,0,17,17,12,20,32,54,58,112,0.000333,0.186667,12,6720,373.333333,560,129.458112,2,0
0,0,20,20,16,23,39,67,66,133,0.000333,0.234319,16,11247.33592,624.851996,702.958495,168.041925,3,0
0,0,10,10,13,19,32,41,35,76,0.000333,0.126667,6,2280,126.666667,380,128.816339,2,0
0,0,10,10,10,17,27,36,34,70,0.000333,0.110947,10,3328.421252,184.912292,332.842125,102.706149,2,0
0,0,13,13,14,20,34,49,42,91,0.000333,0.15432,14,6481.42766,360.079314,462.959119,139.741531,3,0
0,0,10,10,13,17,30,39,31,70,0.000333,0.114494,6,2060.89405,114.494114,343.482342,117.592585,2,0
0,0,12,12,11,13,24,42,33,75,0.000333,0.114624,10,3438.721876,191.040104,343.872188,86.159464,2,0
0,0,15,15,15,16,31,55,41,96,0.000333,0.158534,14,6658.439841,369.913325,475.602846,122.603359,3,0
0,0,10,10,14,15,29,40,29,69,0.000333,0.111734,7,2346.404821,130.355823,335.200689,111.906328,2,0
0,0,15,15,12,19,31,49,44,93,0.000333,0.15358,12,5528.883082,307.160171,460.740257,123.730173,2,0
0,0,18,18,16,22,38,62,52,114,0.000333,0.199421,16,9572.219785,531.789988,598.263737,162.107496,3,0
0,0,10,10,14,15,29,40,29,69,0.000333,0.111734,7,2346.404821,130.355823,335.200689,111.906328,2,0
0,0,15,15,15,19,34,52,52,104,0.000333,0.176365,14,7407.345897,411.519216,529.096135,139.313982,2,0
0,0,18,18,18,22,40,65,60,125,0.000333,0.221747,18,11974.33821,665.241012,665.241012,173.166146,3,0
0,0,16,16,17,22,39,57,55,112,0.000333,0.197322,16,9471.440776,526.191154,591.965049,167.594364,2,0
0,0,14,14,11,15,26,45,39,84,0.000333,0.131612,10,3948.369363,219.353854,394.836936,96.657107,2,0
0,0,17,17,15,18,33,58,47,105,0.000333,0.176554,14,7415.259355,411.958853,529.661383,133.662009,3,0
0,0,10,10,14,15,29,40,29,69,0.000333,0.111734,7,2346.404821,130.355823,335.200689,111.906328,2,0
0,0,16,16,12,19,31,52,54,106,0.000333,0.175048,12,6301.737707,350.096539,525.144809,123.730173,3,0
0,0,19,19,16,22,38,65,62,127,0.000333,0.222162,16,10663.78871,592.432706,666.486794,162.107496,4,0
0,0,10,10,14,15,29,40,29,69,0.000333,0.111734,7,2346.404821,130.355823,335.200689,111.906328,2,0
0,0,16,16,12,19,31,52,54,106,0.000333,0.175048,12,6301.737707,350.096539,525.144809,123.730173,3,0
0,0,19,19,16,22,38,65,62,127,0.000333,0.222162,16,10663.78871,592.432706,666.486794,162.107496,4,0
0,0,10,10,14,15,29,40,29,69,0.000333,0.111734,7,2346.404821,130.355823,335.200689,111.906328,2,0
0,0,26,26,20,48,68,117,89,206,0.000333,0.418006,10,12540.17345,696.676303,1254.017345,354.516762,12,0
0,0,25,25,20,48,68,116,87,203,0.000333,0.411918,10,12357.54957,686.530532,1235.754957,354.516762,12,0
0,0,26,26,21,46,67,118,85,203,0.000333,0.410472,10,12314.16106,684.120059,1231.416106,346.322516,12,0
0,0,25,25,21,46,67,117,83,200,0.000333,0.404406,10,12132.17838,674.00991,1213.217838,346.322516,12,0
0,0,16,16,12,16,28,53,48,101,0.000333,0.161848,18,8739.771248,485.542847,485.542847,107.01955,3,0
0,0,19,19,16,19,35,66,56,122,0.000333,0.208591,16,10012.36045,556.242247,625.772528,144.710623,4,0
0,0,10,10,14,15,29,40,29,69,0.000333,0.111734,7,2346.404821,130.355823,335.200689,111.906328,2,0
0,0,16,16,12,16,28,53,48,101,0.000333,0.161848,18,8739.771248,485.542847,485.542847,107.01955,3,0
0,0,19,19,16,19,35,66,56,122,0.000333,0.208591,16,10012.36045,556.242247,625.772528,144.710623,4,0
0,0,10,10,14,15,29,40,29,69,0.000333,0.111734,7,2346.404821,130.355823,335.200689,111.906328,2,0
0,0,12,12,11,14,25,41,33,74,0.000333,0.114548,10,3436.45358,190.914088,343.645358,91.356717,2,0
0,0,15,15,15,17,32,54,41,95,0.000333,0.158333,14,6650,369.444444,475,128.090227,3,0
0,0,10,10,14,15,29,40,29,69,0.000333,0.111734,7,2346.404821,130.355823,335.200689,111.906328,2,0
0,0,13,13,12,15,27,44,34,78,0.000333,0.123627,12,4450.574702,247.25415,370.881225,101.622909,3,0
0,0,16,16,16,18,34,57,42,99,0.000333,0.167886,16,8058.541141,447.69673,503.658821,139.05865,4,0
0,0,10,10,14,15,29,40,29,69,0.000333,0.111734,7,2346.404821,130.355823,335.200689,111.906328,2,0
0,0,13,13,12,15,27,44,34,78,0.000333,0.123627,12,4450.574702,247.25415,370.881225,101.622909,3,0
0,0,16,16,16,18,34,57,42,99,0.000333,0.167886,16,8058.541141,447.69673,503.658821,139.05865,4,0
0,0,10,10,14,15,29,40,29,69,0.000333,0.111734,7,2346.404821,130.355823,335.200689,111.906328,2,0
0,0,13,13,12,16,28,45,35,80,0.000333,0.128196,12,4615.060725,256.392263,384.588394,107.01955,3,0
0,0,16,16,15,19,34,58,43,101,0.000333,0.171278,14,7193.672458,399.64847,513.833747,139.313982,4,0
0,0,10,10,14,15,29,40,29,69,0.000333,0.111734,7,2346.404821,130.355823,335.200689,111.906328,2,0
0,0,13,13,11,16,27,44,35,79,0.000333,0.125212,10,3756.361127,208.686729,375.636113,102.053748,3,0
0,0,16,16,15,19,34,57,43,100,0.000333,0.169582,14,7122.447978,395.691554,508.746284,139.313982,4,0
0,0,10,10,14,15,29,40,29,69,0.000333,0.111734,7,2346.404821,130.355823,335.200689,111.906328,2,0
0,0,22,22,24,43,67,109,77,186,0.000333,0.376098,12,13539.51107,752.19506,1128.292589,343.368484,11,0
0,0,21,21,24,43,67,108,75,183,0.000333,0.370031,12,13321.13186,740.062881,1110.094322,343.368484,11,0
0,0,22,22,24,43,67,109,77,186,0.000333,0.376098,12,13539.51107,752.19506,1128.292589,343.368484,11,0
0,0,21,21,24,43,67,108,75,183,0.000333,0.370031,12,13321.13186,740.062881,1110.094322,343.368484,11,0
0,0,14,14,11,20,31,54,71,125,0.000333,0.206425,15,9289.118082,516.062116,619.274539,124.49231,2,0
0,0,20,20,15,27,42,90,99,189,0.000333,0.339716,21,21402.10785,1189.005992,1019.147993,186.985321,5,0
0,0,6,6,9,18,27,27,26,53,0.000333,0.084003,4,1008.03615,56.002008,252.009038,103.587975,1,0
0,0,6,6,9,19,28,27,27,54,0.000333,0.086532,4,1038.388663,57.688259,259.597166,109.239948,1,0
0,0,7,7,12,25,37,42,35,77,0.000333,0.133709,6,2406.767455,133.709303,401.127909,159.115955,2,0
0,0,10,10,17,32,49,65,52,117,0.000333,0.218974,8,5255.368414,291.964912,656.921052,229.486868,3,0
0,0,9,9,17,30,47,62,49,111,0.000333,0.20552,8,4932.4749,274.026383,616.559363,216.693586,3,0
0,0,9,9,10,11,21,28,25,53,0.000333,0.077598,10,2327.928234,129.329346,232.792823,71.273029,1,0
0,0,8,8,9,11,20,23,21,44,0.000333,0.063388,4,760.659345,42.258852,190.164836,66.583073,1,0
0,0,12,12,15,17,32,56,40,96,0.000333,0.16,14,6720,373.333333,480,128.090227,5,0
0,0,6,6,10,10,20,17,16,33,0.000333,0.047541,5,713.118136,39.617674,142.623627,66.438562,2,0
0,0,6,6,12,10,22,19,15,34,0.000333,0.05054,6,909.72405,50.540225,151.620675,76.238831,1,0
0,0,14,14,11,15,26,45,39,84,0.000333,0.131612,10,3948.369363,219.353854,394.836936,96.657107,2,0
0,0,17,17,15,18,33,58,47,105,0.000333,0.176554,14,7415.259355,411.958853,529.661383,133.662009,3,0
0,0,10,10,14,15,29,40,29,69,0.000333,0.111734,7,2346.404821,130.355823,335.200689,111.906328,2,0
0,0,14,14,13,15,28,48,39,87,0.000333,0.139413,12,5018.878539,278.826585,418.239878,106.709075,2,0
0,0,17,17,16,18,34,61,47,108,0.000333,0.183149,16,8791.13579,488.396433,549.445987,139.05865,3,0
0,0,10,10,14,15,29,40,29,69,0.000333,0.111734,7,2346.404821,130.355823,335.200689,111.906328,2,0
0,0,16,16,12,19,31,52,54,106,0.000333,0.175048,12,6301.737707,350.096539,525.144809,123.730173,3,0
0,0,19,19,16,22,38,65,62,127,0.000333,0.222162,16,10663.78871,592.432706,666.486794,162.107496,4,0
0,0,10,10,14,15,29,40,29,69,0.000333,0.111734,7,2346.404821,130.355823,335.200689,111.906328,2,0
0,0,16,16,12,19,31,52,54,106,0.000333,0.175048,12,6301.737707,350.096539,525.144809,123.730173,3,0
0,0,19,19,16,22,38,65,62,127,0.000333,0.222162,16,10663.78871,592.432706,666.486794,162.107496,4,0
0,0,10,10,14,15,29,40,29,69,0.000333,0.111734,7,2346.404821,130.355823,335.200689,111.906328,2,0
0,0,24,24,25,43,68,113,80,193,0.000333,0.391627,12,14098.56394,783.253552,1174.880328,349.425789,11,0
0,0,23,23,25,43,68,112,78,190,0.000333,0.385539,12,13879.41528,771.078627,1156.61794,349.425789,11,0
0,0,24,24,25,43,68,113,80,193,0.000333,0.391627,12,14098.56394,783.253552,1174.880328,349.425789,11,0
0,0,23,23,25,43,68,112,78,190,0.000333,0.385539,12,13879.41528,771.078627,1156.61794,349.425789,11,0
0,0,5,5,9,13,22,19,17,36,0.000333,0.053513,4,642.158153,35.675453,160.539538,76.635041,2,0
0,0,6,6,9,14,23,20,19,39,0.000333,0.058806,4,705.675665,39.204204,176.418916,81.832294,2,0
0,0,5,5,10,12,22,20,16,36,0.000333,0.053513,5,802.697691,44.594316,160.539538,76.238831,2,0
0,0,6,6,10,13,23,21,18,39,0.000333,0.058806,5,882.094581,49.005255,176.418916,81.324997,2,0
0,0,12,12,14,22,36,55,42,97,0.000333,0.167161,7,3510.379076,195.02106,501.482725,151.410465,5,0
0,0,5,5,9,10,19,13,14,27,0.000333,0.038231,4,458.776171,25.487565,114.694043,61.748606,1,0
0,0,8,8,9,14,23,31,26,57,0.000333,0.085948,4,1031.372126,57.298451,257.843031,81.832294,1,0
0,0,8,8,10,16,26,31,25,56,0.000333,0.087742,5,1316.123121,73.117951,263.224624,97.219281,1,0
0,0,8,8,10,16,26,32,26,58,0.000333,0.090875,5,1363.127518,75.729307,272.625504,97.219281,1,0
0,0,10,10,9,14,23,41,36,77,0.000333,0.116105,8,2786.514165,154.806342,348.314271,81.832294,1,0
0,0,10,10,10,16,26,41,36,77,0.000333,0.120645,10,3619.338583,201.074366,361.933858,97.219281,1,0
0,0,11,11,10,17,27,45,39,84,0.000333,0.133137,10,3994.105502,221.89475,399.41055,102.706149,1,0
0,0,22,22,24,43,67,109,77,186,0.000333,0.376098,12,13539.51107,752.19506,1128.292589,343.368484,11,0
0,0,21,21,24,43,67,108,75,183,0.000333,0.370031,12,13321.13186,740.062881,1110.094322,343.368484,11,0
0,0,22,22,24,43,67,109,77,186,0.000333,0.376098,12,13539.51107,752.19506,1128.292589,343.368484,11,0
0,0,21,21,24,43,67,108,75,183,0.000333,0.370031,12,13321.13186,740.062881,1110.094322,343.368484,11,0
0,0,22,22,24,44,68,109,78,187,0.000333,0.379452,12,13660.26662,758.903701,1138.355551,350.254091,11,0
0,0,21,21,24,44,68,108,76,184,0.000333,0.373364,12,13441.11795,746.728775,1120.093163,350.254091,11,0
0,0,22,22,24,44,68,109,78,187,0.000333,0.379452,12,13660.26662,758.903701,1138.355551,350.254091,11,0
0,0,21,21,24,44,68,108,76,184,0.000333,0.373364,12,13441.11795,746.728775,1120.093163,350.254091,11,0
0,0,8,8,9,14,23,30,26,56,0.000333,0.08444,4,1013.277878,56.293215,253.31947,81.832294,1,0
0,0,8,8,9,16,25,31,26,57,0.000333,0.088233,4,1058.799211,58.822178,264.699803,92.529325,1,0
0,0,8,8,10,16,26,31,26,57,0.000333,0.089308,5,1339.62532,74.423629,267.925064,97.219281,1,0
0,0,10,10,9,14,23,40,36,76,0.000333,0.114597,8,2750.325669,152.795871,343.790709,81.832294,1,0
0,0,10,10,9,16,25,41,37,78,0.000333,0.12074,8,2897.766262,160.987015,362.220783,92.529325,1,0
0,0,11,11,10,17,27,44,39,83,0.000333,0.131552,10,3946.556627,219.253146,394.655663,102.706149,1,0
0,0,32,32,20,51,71,133,115,248,0.000333,0.508379,20,30502.74571,1694.596984,1525.137286,375.732254,9,0
0,0,31,31,20,51,71,132,113,245,0.000333,0.502229,20,30133.76089,1674.097827,1506.688044,375.732254,9,0
0,0,18,18,11,19,30,57,69,126,0.000333,0.206089,15,9274.023226,515.223513,618.268215,118.764371,2,0
0,0,21,21,15,22,37,70,77,147,0.000333,0.255263,21,16081.58254,893.421252,765.789645,156.710855,3,0
0,0,10,10,13,18,31,41,33,74,0.000333,0.122204,6,2199.663162,122.203509,366.610527,123.164366,2,0
0,0,28,28,20,49,69,123,95,218,0.000333,0.443886,10,13316.58332,739.810184,1331.658332,361.559344,9,0
0,0,27,27,20,49,69,122,93,215,0.000333,0.437778,10,13133.32758,729.62931,1313.332758,361.559344,9,0
0,0,14,14,11,17,28,47,45,92,0.000333,0.147426,10,4422.766528,245.709252,442.276653,107.540616,2,0
0,0,17,17,15,20,35,60,53,113,0.000333,0.193203,14,8114.525733,450.806985,579.608981,145.041921,3,0
0,0,10,10,13,18,31,41,33,74,0.000333,0.122204,6,2199.663162,122.203509,366.610527,123.164366,2,0
0,0,11,11,11,20,31,40,41,81,0.000333,0.133763,10,4012.899011,222.938834,401.289901,124.49231,2,0
0,0,10,10,11,20,31,39,39,78,0.000333,0.128809,5,1932.136561,107.34092,386.427312,124.49231,2,0
0,0,12,12,13,24,37,47,47,94,0.000333,0.16323,6,2938.131698,163.229539,489.688616,158.144816,3,0
0,0,11,11,13,24,37,46,45,91,0.000333,0.15802,6,2844.361538,158.020085,474.060256,158.144816,3,0
0,0,12,12,13,24,37,47,47,94,0.000333,0.16323,6,2938.131698,163.229539,489.688616,158.144816,3,0
0,0,11,11,13,24,37,46,45,91,0.000333,0.15802,6,2844.361538,158.020085,474.060256,158.144816,3,0
1,0,35,36,26,45,71,157,106,263,0.000333,0.539128,26,42051.9708,2336.2206,1617.383492,369.344822,10,0
1,0,34,35,26,44,70,150,101,251,0.000333,0.512817,26,39999.70097,2222.205609,1538.450037,362.426424,10,0
1,0,44,45,21,54,75,171,130,301,0.000333,0.624958,20,37497.48852,2083.193806,1874.874426,403.002591,12,0
1,0,37,38,21,45,66,141,104,245,0.000333,0.493626,20,29617.53119,1645.418399,1480.876559,339.372055,12,0
1,0,35,36,21,49,70,146,107,253,0.000333,0.516903,20,31014.17207,1723.009559,1550.708603,367.359448,9,0
1,0,85,86,29,129,158,513,369,882,0.000333,2.147312,28,180374.1694,10020.78719,6441.93462,1045.329765,29,0
1,0,32,33,24,44,68,140,96,236,0.000333,0.47888,24,34479.38953,1915.521641,1436.641231,350.254091,11,0
1,0,32,33,24,44,68,140,96,236,0.000333,0.47888,24,34479.38953,1915.521641,1436.641231,350.254091,11,0
1,0,34,35,25,48,73,157,105,262,0.000333,0.540578,24,38921.61683,2162.312046,1621.734034,384.174605,12,0
1,0,33,34,21,46,67,141,100,241,0.000333,0.487309,20,29238.5499,1624.363883,1461.927495,346.322516,10,0
1,0,31,32,20,42,62,124,91,215,0.000333,0.426717,20,25603.04414,1422.391341,1280.152207,312.915894,9,0
1,0,45,46,23,69,92,189,146,335,0.000333,0.728464,22,48078.65162,2671.036201,2185.393255,525.530113,14,0
1,0,44,45,23,69,92,186,144,330,0.000333,0.717592,22,47361.0598,2631.169989,2152.775445,525.530113,13,0
1,0,26,27,23,60,83,202,123,325,0.000333,0.690629,22,45581.53193,2532.30733,2071.887815,458.455361,28,0
1,0,26,27,24,60,84,202,122,324,0.000333,0.69037,24,49706.66028,2761.481127,2071.110845,464.452536,27,0
1,0,27,28,24,64,88,212,129,341,0.000333,0.734222,24,52863.98837,2936.888243,2202.666182,494.0391,29,0
0,0,18,18,19,41,60,116,74,190,0.000333,0.374103,9,10100.78292,561.154607,1122.309213,300.370255,9,0
0,0,7,7,15,23,38,59,37,96,0.000333,0.167934,7,3526.607289,195.922627,503.801041,162.645284,2,0
0,0,26,26,25,64,89,191,130,321,0.000333,0.692903,24,49889.05035,2771.613908,2078.710431,500.096405,13,0
0,0,6,6,13,18,31,36,23,59,0.000333,0.097433,6,1753.785494,97.432527,292.297582,123.164366,3,0
0,0,28,28,25,48,73,223,126,349,0.000333,0.720083,24,51845.97051,2880.331695,2160.248771,384.174605,32,0
0,0,36,36,25,77,102,344,200,544,0.000333,1.209933,24,87115.18527,4839.732515,3629.799386,598.638968,36,0
0,0,45,45,27,87,114,408,246,654,0.000333,1.48957,26,116186.4618,6454.803433,4468.710069,688.918047,43,0
0,0,16,16,22,37,59,142,75,217,0.000333,0.425511,22,28083.73792,1560.207662,1276.533542,290.85727,20,0
0,0,14,14,19,34,53,92,56,148,0.000333,0.282577,9,7629.590045,423.866114,847.732227,253.684359,14,0
0,0,36,36,26,81,107,340,205,545,0.000333,1.2247,26,95526.5872,5307.032622,3674.099508,635.739283,34,0
0,0,12,12,20,32,52,92,55,147,0.000333,0.279322,10,8379.646386,465.53591,837.964639,246.438562,11,0
0,0,31,31,26,52,78,251,142,393,0.000333,0.823388,26,64224.23987,3568.013326,2470.163072,418.634298,36,0
0,0,31,31,26,51,77,249,141,390,0.000333,0.814682,26,63545.21552,3530.289751,2444.046751,411.505125,35,0
0,0,31,31,26,53,79,256,147,403,0.000333,0.846808,26,66051.01468,3669.500816,2540.423642,425.791217,35,0
0,0,14,14,19,34,53,93,56,149,0.000333,0.284487,9,7681.14133,426.730074,853.460148,253.684359,14,0
0,0,41,41,28,68,96,296,178,474,0.000333,1.040424,28,87395.62231,4855.312351,3121.272225,548.553411,36,0
0,0,41,41,28,68,96,296,178,474,0.000333,1.040424,28,87395.62231,4855.312351,3121.272225,548.553411,36,0
0,0,16,16,19,38,57,99,63,162,0.000333,0.314976,9,8504.353641,472.464091,944.928182,280.131868,7,0
0,0,15,15,18,35,53,91,58,149,0.000333,0.284487,9,7681.14133,426.730074,853.460148,254.583556,7,0
0,0,7,7,15,23,38,59,37,96,0.000333,0.167934,7,3526.607289,195.922627,503.801041,162.645284,2,0
0,0,24,24,22,64,86,185,130,315,0.000333,0.674758,22,44534.01475,2474.111931,2024.273398,482.107496,9,0
0,0,6,6,13,18,31,36,23,59,0.000333,0.097433,6,1753.785494,97.432527,292.297582,123.164366,3,0
0,0,51,51,27,87,114,361,221,582,0.000333,1.325581,26,103395.2917,5744.182872,3976.741988,688.918047,40,0
0,0,51,51,27,87,114,361,221,582,0.000333,1.325581,26,103395.2917,5744.182872,3976.741988,688.918047,40,0
0,0,41,41,25,73,98,308,181,489,0.000333,1.078198,24,77630.23473,4312.790818,3234.593114,567.953598,38,0
0,0,40,40,23,84,107,344,203,547,0.000333,1.229194,22,81126.81371,4507.045206,3687.582442,640.996589,39,0
0,0,50,50,25,92,117,407,249,656,0.000333,1.50232,24,108167.0221,6009.279008,4506.959256,716.264105,47,0
0,0,27,27,22,58,80,226,125,351,0.000333,0.739666,22,48817.92875,2712.107153,2218.996761,437.870393,27,0
0,0,25,25,19,54,73,176,106,282,0.000333,0.581844,9,15709.77473,872.765263,1745.530526,391.474548,21,0
0,0,42,42,23,84,107,353,217,570,0.000333,1.280879,22,84537.99601,4696.555334,3842.636182,640.996589,40,0
0,0,21,21,20,50,70,169,99,268,0.000333,0.547549,10,16426.47849,912.582138,1642.647849,368.631371,18,0
0,0,44,44,25,75,100,344,201,545,0.000333,1.206967,24,86901.63896,4827.868831,3620.901623,583.257807,40,0
0,0,44,44,25,76,101,345,201,546,0.000333,1.211794,24,87249.20327,4847.177959,3635.38347,590.938896,40,0
0,0,45,45,25,79,104,355,208,563,0.000333,1.257449,24,90536.34147,5029.796748,3772.347561,614.095084,42,0
0,0,43,43,25,74,99,330,194,524,0.000333,1.157928,24,83370.78885,4631.710492,3473.782869,575.595954,42,0
0,0,43,43,25,73,98,328,193,521,0.000333,1.148755,24,82710.33189,4595.018438,3446.263829,567.953598,41,0
0,0,45,45,25,81,106,359,214,573,0.000333,1.285033,24,92522.36209,5140.131227,3855.09842,629.624255,42,0
0,0,25,25,19,54,73,177,106,283,0.000333,0.583907,9,15765.48315,875.860175,1751.72035,391.474548,21,0
0,0,14,14,17,34,51,89,57,146,0.000333,0.276058,8,6625.392799,368.077378,828.1741,242.460605,7,0
0,0,7,7,15,24,39,62,39,101,0.000333,0.177942,7,3736.779369,207.598854,533.825624,168.642459,3,0
0,0,54,54,28,87,115,398,239,637,0.000333,1.453526,28,122096.1605,6783.12003,4360.577162,695.142022,47,0
0,0,54,54,28,87,115,407,243,650,0.000333,1.48319,28,124587.9189,6921.551052,4449.568533,695.142022,47,0
0,0,6,6,13,19,32,39,25,64,0.000333,0.106667,6,1920,106.666667,320,128.816339,4,0
0,0,15,15,15,22,37,50,45,95,0.000333,0.164966,14,6928.572976,384.920721,494.89807,156.710855,5,0
0,0,49,49,25,61,86,216,169,385,0.000333,0.824704,24,59378.68633,3298.815907,2474.111931,477.871382,31,0
0,0,66,66,27,86,113,406,273,679,0.000333,1.543634,39,180605.1591,10033.61995,4630.901515,681.040731,41,0
0,0,36,36,22,39,61,166,102,268,0.000333,0.529813,22,34967.62734,1942.645963,1589.437606,304.238182,13,0
0,0,32,32,22,35,57,151,91,242,0.000333,0.47052,22,31054.30644,1725.239246,1411.559383,277.632401,13,0
0,0,33,33,22,36,58,154,93,247,0.000333,0.482307,22,31832.26873,1768.459374,1446.921306,284.224796,13,0
0,0,33,33,22,36,58,154,93,247,0.000333,0.482307,22,31832.26873,1768.459374,1446.921306,284.224796,13,0
0,0,20,20,18,25,43,107,55,162,0.000333,0.293018,18,15822.98803,879.05489,879.05489,191.155055,10,0
0,0,5,5,17,16,33,33,21,54,0.000333,0.090799,8,2179.17826,121.065459,272.397282,133.486868,3,0
0,0,11,11,17,30,47,71,56,127,0.000333,0.235144,8,5643.462273,313.525682,705.432784,216.693586,5,0
0,0,11,11,17,30,47,71,56,127,0.000333,0.235144,8,5643.462273,313.525682,705.432784,216.693586,5,0
0,0,11,11,17,30,47,71,56,127,0.000333,0.235144,8,5643.462273,313.525682,705.432784,216.693586,5,0
0,0,11,11,17,30,47,70,55,125,0.000333,0.231441,8,5554.588852,308.58827,694.323606,216.693586,5,0
0,0,6,6,15,24,39,46,38,84,0.000333,0.147991,7,3107.816505,172.656472,443.973786,168.642459,3,0
1,0,17,18,23,29,52,95,59,154,0.000333,0.292623,22,19313.08977,1072.949431,877.867717,244.923374,9,0
1,0,9,10,13,22,35,51,31,82,0.000333,0.1402,6,2523.607244,140.200402,420.601207,146.213212,6,0
1,0,9,10,16,22,38,45,31,76,0.000333,0.132947,8,3190.739928,177.263329,398.842491,162.107496,5,0
1,0,5,6,11,16,27,27,19,46,0.000333,0.072908,5,1093.624125,60.756896,218.724825,102.053748,3,0
1,0,15,16,25,33,58,86,70,156,0.000333,0.304615,24,21932.28085,1218.460047,913.845035,282.561411,15,0
0,0,11,11,15,25,40,52,39,91,0.000333,0.161432,7,3390.068196,188.337122,484.295457,174.699764,6,0
0,0,8,8,15,17,32,38,27,65,0.000333,0.108333,7,2275,126.388889,325,128.090227,5,0
0,0,10,10,14,25,39,47,38,85,0.000333,0.149753,7,3144.81432,174.711907,449.259189,169.399374,5,0
0,0,7,7,14,17,31,33,26,59,0.000333,0.097433,7,2046.083076,113.671282,292.297582,122.789837,4,0
0,0,13,13,16,24,40,66,46,112,0.000333,0.198685,8,4768.447573,264.913754,596.055947,174.0391,7,0
0,0,5,5,13,16,29,24,22,46,0.000333,0.074489,6,1340.802755,74.489042,223.467126,112.105716,3,0
0,0,27,27,22,48,70,120,105,225,0.000333,0.459696,22,30339.95093,1685.55283,1379.088679,366.185696,6,0
0,0,25,25,23,43,66,114,99,213,0.000333,0.429152,22,28324.03084,1573.557269,1287.455947,337.371309,5,0
0,0,28,28,24,51,75,133,113,246,0.000333,0.510763,24,36774.94555,2043.05253,1532.289398,399.332792,6,0
0,0,7,7,17,35,52,55,42,97,0.000333,0.184314,8,4423.541221,245.75229,552.942653,249.011774,5,0
0,0,4,4,12,15,27,27,19,46,0.000333,0.072908,6,1312.348951,72.908275,218.724825,101.622909,2,0
0,0,16,16,27,35,62,91,62,153,0.000333,0.303664,13,11842.89646,657.938692,910.992035,307.906868,9,0
0,0,16,16,27,35,62,91,62,153,0.000333,0.303664,13,11842.89646,657.938692,910.992035,307.906868,9,0
0,0,26,26,24,42,66,159,132,291,0.000333,0.586306,36,63321.07279,3517.837377,1758.918689,336.516432,15,0
0,0,26,26,24,42,66,159,132,291,0.000333,0.586306,36,63321.07279,3517.837377,1758.918689,336.516432,15,0
1,0,18,19,21,37,58,121,75,196,0.000333,0.382721,20,22963.2855,1275.738083,1148.164275,284.98844,12,0
1,0,17,18,20,36,56,110,67,177,0.000333,0.342634,10,10279.01821,571.056567,1027.901821,272.555862,12,0
1,0,16,17,20,35,55,100,63,163,0.000333,0.314121,10,9423.616333,523.534241,942.361633,265.963467,11,0
1,0,17,18,19,37,56,103,67,170,0.000333,0.329083,9,8885.253031,493.625168,987.250337,273.460397,10,0
1,0,20,21,21,40,61,137,87,224,0.000333,0.442828,20,26569.70327,1476.094626,1328.485164,305.11579,12,0
1,0,17,18,19,37,56,103,67,170,0.000333,0.329083,9,8885.253031,493.625168,987.250337,273.460397,10,0
1,0,20,21,21,40,61,137,87,224,0.000333,0.442828,20,26569.70327,1476.094626,1328.485164,305.11579,12,0
1,0,31,32,23,53,76,210,166,376,0.000333,0.783074,33,77524.28459,4306.904699,2349.220745,407.621709,15,0
1,0,31,32,23,53,76,210,166,376,0.000333,0.783074,33,77524.28459,4306.904699,2349.220745,407.621709,15,0
1,0,31,32,23,53,76,210,166,376,0.000333,0.783074,33,77524.28459,4306.904699,2349.220745,407.621709,15,0
1,0,31,32,23,53,76,210,166,376,0.000333,0.783074,33,77524.28459,4306.904699,2349.220745,407.621709,15,0
1,0,31,32,23,53,76,210,166,376,0.000333,0.783074,33,77524.28459,4306.904699,2349.220745,407.621709,15,0
1,0,31,32,23,53,76,210,166,376,0.000333,0.783074,33,77524.28459,4306.904699,2349.220745,407.621709,15,0
1,0,31,32,23,53,76,210,166,376,0.000333,0.783074,33,77524.28459,4306.904699,2349.220745,407.621709,15,0
0,0,10,10,21,22,43,70,49,119,0.000333,0.215242,20,12914.51012,717.472784,645.725506,190.346161,3,0
0,0,10,10,22,22,44,63,47,110,0.000333,0.200179,22,13211.82452,733.990251,600.537478,196.214991,4,0
0,0,10,10,15,26,41,40,40,80,0.000333,0.142868,7,3000.229123,166.679396,428.60416,180.814792,2,0
0,0,11,11,23,27,50,73,56,129,0.000333,0.242686,22,16017.26387,889.847993,728.057448,232.423888,5,0
0,0,67,67,28,115,143,437,391,828,0.000333,1.976124,42,248991.6856,13832.87142,5928.373467,921.837294,13,0
0,0,4,4,11,15,26,24,20,44,0.000333,0.06894,5,1034.096738,57.449819,206.819348,96.657107,2,0
0,0,80,80,29,95,124,460,273,733,0.000333,1.699142,28,142727.9251,7929.329171,5097.425896,765.017732,47,0
0,0,80,80,29,95,124,460,273,733,0.000333,1.699142,28,142727.9251,7929.329171,5097.425896,765.017732,47,0
0,0,80,80,29,95,124,460,273,733,0.000333,1.699142,28,142727.9251,7929.329171,5097.425896,765.017732,47,0
0,0,80,80,29,95,124,460,273,733,0.000333,1.699142,28,142727.9251,7929.329171,5097.425896,765.017732,47,0
0,0,80,80,29,95,124,460,273,733,0.000333,1.699142,28,142727.9251,7929.329171,5097.425896,765.017732,47,0
0,0,80,80,29,95,124,460,273,733,0.000333,1.699142,28,142727.9251,7929.329171,5097.425896,765.017732,47,0
0,0,80,80,29,95,124,460,273,733,0.000333,1.699142,28,142727.9251,7929.329171,5097.425896,765.017732,47,0
0,0,80,80,29,95,124,460,273,733,0.000333,1.699142,28,142727.9251,7929.329171,5097.425896,765.017732,47,0
0,0,80,80,29,95,124,460,273,733,0.000333,1.699142,28,142727.9251,7929.329171,5097.425896,765.017732,47,0
0,0,80,80,29,95,124,460,273,733,0.000333,1.699142,28,142727.9251,7929.329171,5097.425896,765.017732,47,0
0,0,80,80,29,95,124,460,273,733,0.000333,1.699142,28,142727.9251,7929.329171,5097.425896,765.017732,47,0
0,0,80,80,29,95,124,460,273,733,0.000333,1.699142,28,142727.9251,7929.329171,5097.425896,765.017732,47,0
0,0,80,80,29,95,124,460,273,733,0.000333,1.699142,28,142727.9251,7929.329171,5097.425896,765.017732,47,0
0,0,80,80,29,95,124,460,273,733,0.000333,1.699142,28,142727.9251,7929.329171,5097.425896,765.017732,47,0
0,0,80,80,29,95,124,460,273,733,0.000333,1.699142,28,142727.9251,7929.329171,5097.425896,765.017732,47,0
0,0,80,80,29,95,124,460,273,733,0.000333,1.699142,28,142727.9251,7929.329171,5097.425896,765.017732,47,0
0,0,80,80,29,95,124,460,273,733,0.000333,1.699142,28,142727.9251,7929.329171,5097.425896,765.017732,47,0
0,0,80,80,29,95,124,460,273,733,0.000333,1.699142,28,142727.9251,7929.329171,5097.425896,765.017732,47,0
0,0,80,80,29,95,124,460,273,733,0.000333,1.699142,28,142727.9251,7929.329171,5097.425896,765.017732,47,0
0,0,80,80,29,95,124,460,273,733,0.000333,1.699142,28,142727.9251,7929.329171,5097.425896,765.017732,47,0
0,0,80,80,29,95,124,460,273,733,0.000333,1.699142,28,142727.9251,7929.329171,5097.425896,765.017732,47,0
0,0,80,80,29,95,124,460,273,733,0.000333,1.699142,28,142727.9251,7929.329171,5097.425896,765.017732,47,0
0,0,14,14,15,33,48,81,53,134,0.000333,0.249462,7,5238.694826,291.038601,748.384975,225.068365,7,0
0,0,14,14,15,31,46,77,49,126,0.000333,0.23199,7,4871.781645,270.654536,695.968806,212.183445,7,0
0,0,33,33,27,60,87,165,126,291,0.000333,0.624966,26,48747.31049,2708.183916,1874.896557,482.795398,8,0
0,0,33,33,27,60,87,165,126,291,0.000333,0.624966,26,48747.31049,2708.183916,1874.896557,482.795398,8,0
0,0,27,27,21,54,75,172,137,309,0.000333,0.641568,20,38494.09951,2138.561084,1924.704975,403.002591,13,0
0,0,17,17,18,31,49,78,64,142,0.000333,0.265763,18,14351.19836,797.288798,797.288798,228.638736,8,0
0,0,11,11,16,21,37,53,41,94,0.000333,0.16323,8,3917.508931,217.639385,489.688616,156.238666,7,0
0,0,11,11,16,26,42,33,33,66,0.000333,0.118631,8,2847.143599,158.174644,355.89295,186.211433,6,0
0,0,8,8,9,14,23,12,17,29,0.000333,0.043728,4,524.733187,29.151844,131.183297,81.832294,2,0
0,0,15,15,17,45,62,136,101,237,0.000333,0.470382,16,22578.31241,1254.350689,1411.144526,316.620258,2,0
0,0,10,10,18,26,44,66,45,111,0.000333,0.201999,9,5453.972187,302.998455,605.99691,197.270083,4,0
0,0,7,7,16,22,38,45,35,80,0.000333,0.139945,8,3358.673609,186.592978,419.834201,162.107496,3,0
0,0,7,7,16,22,38,45,35,80,0.000333,0.139945,8,3358.673609,186.592978,419.834201,162.107496,3,0
0,0,61,61,26,53,79,433,252,685,0.000333,1.439363,52,224540.6703,12474.48168,4318.089813,425.791217,37,0
0,0,61,61,26,53,79,433,252,685,0.000333,1.439363,52,224540.6703,12474.48168,4318.089813,425.791217,37,0
0,0,45,45,21,41,62,334,196,530,0.000333,1.051908,40,126228.9618,7012.720099,3155.724045,311.898298,35,0
0,0,45,45,21,41,62,334,196,530,0.000333,1.051908,40,126228.9618,7012.720099,3155.724045,311.898298,35,0
0,0,45,45,21,41,62,334,196,530,0.000333,1.051908,40,126228.9618,7012.720099,3155.724045,311.898298,35,0
0,0,45,45,21,41,62,334,196,530,0.000333,1.051908,40,126228.9618,7012.720099,3155.724045,311.898298,35,0
0,0,27,27,20,37,57,232,133,365,0.000333,0.709668,30,63870.14566,3548.341425,2129.004855,279.188336,24,0
0,0,63,63,26,65,91,462,274,736,0.000333,1.596579,52,249066.3165,13837.01758,4789.736855,513.665341,38,0
0,0,66,66,26,65,91,475,280,755,0.000333,1.637795,52,255496.0176,14194.2232,4913.384953,513.665341,39,0
0,0,34,34,24,46,70,268,152,420,0.000333,0.8581,36,92674.75922,5148.597734,2574.298867,364.12295,34,0
0,0,14,14,18,28,46,101,60,161,0.000333,0.296431,18,16007.28255,889.293475,889.293475,209.664588,7,0
0,0,62,62,26,59,85,434,259,693,0.000333,1.480569,52,230968.8118,12831.60065,4441.707919,469.287373,33,0
0,0,57,57,26,58,84,376,231,607,0.000333,1.293379,39,151325.3303,8406.962797,3880.136676,461.97433,27,0
1,0,19,20,18,28,46,107,67,174,0.000333,0.320367,18,17299.79605,961.09978,961.09978,209.664588,9,0
1,0,19,20,18,28,46,103,67,170,0.000333,0.313002,18,16902.09959,939.005533,939.005533,209.664588,8,0
0,0,18,18,15,51,66,132,117,249,0.000333,0.501685,14,21070.7579,1170.597661,1505.054136,347.897051,4,0
0,0,8,8,16,28,44,40,36,76,0.000333,0.138306,8,3319.334424,184.407468,414.916803,198.605938,3,0
0,0,17,17,15,49,64,120,106,226,0.000333,0.452,14,18984,1054.666667,1356,333.724141,4,0
0,0,8,8,16,28,44,40,36,76,0.000333,0.138306,8,3319.334424,184.407468,414.916803,198.605938,3,0
0,0,16,16,15,47,62,108,95,203,0.000333,0.402901,14,16921.82591,940.10144,1208.701851,319.669035,4,0
0,0,8,8,16,28,44,40,36,76,0.000333,0.138306,8,3319.334424,184.407468,414.916803,198.605938,3,0
0,0,15,15,15,44,59,95,83,178,0.000333,0.349037,7,7329.77324,407.209624,1047.110463,298.81835,4,0
0,0,8,8,16,28,44,40,36,76,0.000333,0.138306,8,3319.334424,184.407468,414.916803,198.605938,3,0
0,0,13,13,14,41,55,77,68,145,0.000333,0.279432,7,5868.080109,326.004451,838.297158,272.962601,3,0
0,0,7,7,14,25,39,34,32,66,0.000333,0.116279,7,2441.855825,135.658657,348.836546,169.399374,2,0
0,0,5,5,13,22,35,27,27,54,0.000333,0.092327,6,1661.887697,92.327094,276.981283,146.213212,2,0
0,0,8,8,14,29,43,39,36,75,0.000333,0.135657,7,2848.788996,158.266055,406.969857,194.184418,3,0
0,0,8,8,15,32,47,45,41,86,0.000333,0.159232,7,3343.862489,185.770138,477.694641,218.603359,3,0
0,0,3,3,12,24,36,47,27,74,0.000333,0.127525,6,2295.446701,127.524817,382.57445,153.05865,4,0
1,0,28,29,25,35,60,147,104,251,0.000333,0.49421,24,35583.10895,1976.839386,1482.629539,295.62131,11,0
1,0,13,14,21,26,47,93,59,152,0.000333,0.281433,20,16885.95011,938.108339,844.297505,214.450099,9,0
0,0,48,48,26,34,60,251,137,388,0.000333,0.763958,52,119177.4247,6620.968036,2291.873551,295.185169,25,0
0,0,42,42,26,29,55,225,120,345,0.000333,0.664856,52,103717.5933,5762.088514,1994.569101,263.092882,24,0
0,0,29,29,24,31,55,158,90,248,0.000333,0.477926,24,34410.65302,1911.702945,1433.777209,263.619186,14,0
0,0,30,30,25,35,60,142,121,263,0.000333,0.517837,36,55926.44016,3107.024453,1553.512227,295.62131,26,0
0,0,21,21,20,34,54,101,87,188,0.000333,0.36064,20,21638.37701,1202.132056,1081.91885,259.412299,17,0
0,0,17,17,21,34,55,110,90,200,0.000333,0.385424,20,23125.43885,1284.746603,1156.271943,265.212402,7,0
0,0,17,17,21,34,55,110,90,200,0.000333,0.385424,20,23125.43885,1284.746603,1156.271943,265.212402,7,0
0,0,6,6,12,18,30,36,34,70,0.000333,0.114494,6,2060.89405,114.494114,343.482342,118.0782,2,0
0,0,6,6,12,18,30,36,34,70,0.000333,0.114494,6,2060.89405,114.494114,343.482342,118.0782,2,0
0,0,9,9,15,29,44,68,52,120,0.000333,0.218377,7,4585.92256,254.773476,655.131794,199.484808,3,0
0,0,9,9,15,29,44,68,52,120,0.000333,0.218377,7,4585.92256,254.773476,655.131794,199.484808,3,0
0,0,39,39,20,59,79,275,171,446,0.000333,0.937162,20,56229.72427,3123.873571,2811.486214,433.514502,28,0
0,0,33,33,19,50,69,212,145,357,0.000333,0.726914,18,39253.37816,2180.743231,2180.743231,362.903432,17,0
0,0,27,27,19,52,71,205,128,333,0.000333,0.682622,18,36861.58423,2047.865791,2047.865791,377.133488,21,0
0,0,20,20,18,43,61,136,101,237,0.000333,0.468528,18,25300.52548,1405.584749,1405.584749,308.388034,8,0
0,0,54,54,20,65,85,338,214,552,0.000333,1.179328,30,106139.5139,5896.639661,3537.983797,477.89247,32,0
0,0,51,51,19,63,82,324,205,529,0.000333,1.121048,27,90804.91528,5044.717516,3363.14501,457.279258,31,0
0,0,23,23,19,46,65,153,108,261,0.000333,0.523946,18,28293.08399,1571.837999,1571.837999,334.794473,12,0
0,0,19,19,18,42,60,127,95,222,0.000333,0.43711,18,23603.93482,1311.329712,1311.329712,301.535982,8,0
0,0,43,43,20,60,80,292,182,474,0.000333,0.998865,30,89897.81751,4994.323195,2996.593917,440.851998,29,0
0,0,38,38,19,54,73,243,161,404,0.000333,0.833563,18,45012.40419,2500.689122,2500.689122,391.474548,21,0
0,0,24,24,19,49,68,179,114,293,0.000333,0.594542,18,32105.27903,1783.626612,1783.626612,355.831405,19,0
0,0,18,18,18,41,59,118,89,207,0.000333,0.405902,18,21918.728,1217.707111,1217.707111,294.718282,8,0
0,0,50,50,20,62,82,320,201,521,0.000333,1.104095,30,99368.53783,5520.474324,3312.284594,455.598733,31,0
0,0,46,46,19,59,78,290,186,476,0.000333,0.997284,27,80779.98932,4487.777184,2991.851456,427.786563,27,0
0,0,22,22,19,45,64,154,103,257,0.000333,0.514,18,27756,1542,1542,327.844012,16,0
0,0,17,17,18,39,57,108,82,190,0.000333,0.369416,18,19948.48385,1108.249103,1108.249103,281.189337,8,0
0,0,50,50,20,62,82,320,201,521,0.000333,1.104095,30,99368.53783,5520.474324,3312.284594,455.598733,31,0
0,0,46,46,19,59,78,290,186,476,0.000333,0.997284,27,80779.98932,4487.777184,2991.851456,427.786563,27,0
0,0,21,21,19,44,63,145,97,242,0.000333,0.482167,18,26037.03135,1446.501741,1446.501741,320.925614,16,0
0,0,16,16,18,38,56,99,76,175,0.000333,0.338762,18,18293.168,1016.287111,1016.287111,274.479896,8,0
0,0,35,35,19,56,75,193,139,332,0.000333,0.689323,18,37223.42049,2067.967805,2067.967805,405.922498,8,0
0,0,31,31,19,53,72,177,123,300,0.000333,0.616993,18,33317.59501,1850.9775,1850.9775,384.290407,8,0
0,0,31,31,19,53,72,177,123,300,0.000333,0.616993,18,33317.59501,1850.9775,1850.9775,384.290407,8,0
0,0,31,31,19,53,72,177,123,300,0.000333,0.616993,18,33317.59501,1850.9775,1850.9775,384.290407,8,0
0,0,26,26,17,44,61,144,99,243,0.000333,0.48039,16,23058.70677,1281.039265,1441.169173,309.70186,8,0
0,0,20,20,16,40,56,110,75,185,0.000333,0.35812,8,8594.885285,477.493627,1074.360661,276.877124,6,0
0,0,55,55,31,46,77,351,256,607,0.000333,1.26798,75,285295.4573,15849.74763,3803.93943,407.663936,49,0
0,0,25,25,27,32,59,161,115,276,0.000333,0.541203,39,63320.76978,3517.820544,1623.609482,288.381963,14,0
0,0,55,55,31,46,77,351,256,607,0.000333,1.26798,75,285295.4573,15849.74763,3803.93943,407.663936,49,0
0,0,25,25,27,32,59,161,115,276,0.000333,0.541203,39,63320.76978,3517.820544,1623.609482,288.381963,14,0
0,0,25,25,27,32,59,161,115,276,0.000333,0.541203,39,63320.76978,3517.820544,1623.609482,288.381963,14,0
0,0,25,25,27,32,59,161,115,276,0.000333,0.541203,39,63320.76978,3517.820544,1623.609482,288.381963,14,0
0,0,62,62,30,46,76,463,325,788,0.000333,1.641122,105,516953.5225,28719.64014,4923.366881,401.290568,30,0
0,0,63,63,29,59,88,547,379,926,0.000333,1.993811,84,502440.429,27913.35717,5981.433679,487.957389,55,0
0,0,32,32,25,84,109,241,169,410,0.000333,0.924985,24,66598.93376,3699.940764,2774.955573,653.051068,14,0
1,0,8,9,13,14,27,37,21,58,0.000333,0.091928,6,1654.700851,91.927825,275.783475,101.408685,4,0
1,0,3,4,11,8,19,15,10,25,0.000333,0.035399,5,530.990939,29.499497,106.198188,62.053748,2,0
1,0,107,108,26,160,186,537,372,909,0.000333,2.284365,26,178180.4793,9898.915519,6853.095359,1293.719928,60,0
0,0,19,19,18,27,45,80,72,152,0.000333,0.278254,18,15025.71007,834.761671,834.761671,203.440613,3,0
0,0,28,28,16,35,51,108,100,208,0.000333,0.393288,16,18877.83154,1048.768419,1179.864471,243.524906,2,0
0,0,27,27,16,35,51,106,98,204,0.000333,0.385725,16,18514.79632,1028.599795,1157.17477,243.524906,2,0
0,0,26,26,16,35,51,104,96,200,0.000333,0.378162,16,18151.76109,1008.431172,1134.485068,243.524906,2,0
0,0,25,25,16,35,51,102,94,196,0.000333,0.370598,16,17788.72587,988.262548,1111.795367,243.524906,2,0
0,0,21,21,19,35,54,96,85,181,0.000333,0.347212,18,18749.42348,1041.634638,1041.634638,260.235528,4,0
0,0,18,18,17,25,42,75,67,142,0.000333,0.255236,16,12251.34519,680.630288,765.709074,185.583273,3,0
0,0,25,25,20,42,62,111,102,213,0.000333,0.422748,20,25364.87628,1409.159793,1268.243814,312.915894,4,0
0,0,20,20,17,27,44,79,72,151,0.000333,0.274791,16,13189.98679,732.777044,824.374174,197.868831,3,0
0,0,33,33,24,56,80,179,162,341,0.000333,0.718592,24,51738.65953,2874.369974,2155.77748,435.250976,7,0
0,0,32,32,24,56,80,177,160,337,0.000333,0.710163,24,51131.75443,2840.653024,2130.489768,435.250976,7,0
0,0,31,31,24,56,80,175,158,333,0.000333,0.701734,24,50524.84933,2806.936074,2105.202056,435.250976,7,0
0,0,31,31,24,56,80,175,158,333,0.000333,0.701734,24,50524.84933,2806.936074,2105.202056,435.250976,7,0
0,0,31,31,24,56,80,175,158,333,0.000333,0.701734,24,50524.84933,2806.936074,2105.202056,435.250976,7,0
0,0,30,30,24,56,80,173,156,329,0.000333,0.693305,24,49917.94424,2773.219124,2079.914343,435.250976,7,0
0,0,30,30,24,56,80,173,156,329,0.000333,0.693305,24,49917.94424,2773.219124,2079.914343,435.250976,7,0
0,0,30,30,24,56,80,173,156,329,0.000333,0.693305,24,49917.94424,2773.219124,2079.914343,435.250976,7,0
0,0,31,31,23,58,81,199,147,346,0.000333,0.731196,22,48258.93822,2681.052123,2193.588101,443.804823,20,0
0,0,28,28,23,29,52,153,122,275,0.000333,0.52254,44,68975.32059,3831.962255,1567.620922,244.923374,9,0
0,0,33,33,25,38,63,177,142,319,0.000333,0.635584,36,68643.08264,3813.504591,1906.752296,315.51765,9,0
0,0,29,29,23,33,56,146,122,268,0.000333,0.51879,33,51360.24693,2853.347052,1556.371119,270.506931,6,0
0,0,33,33,21,22,43,145,125,270,0.000333,0.488364,50,73254.57419,4069.698566,1465.091484,190.346161,9,0
0,0,45,45,25,34,59,216,182,398,0.000333,0.780431,60,140477.516,7804.306445,2341.291934,289.070141,9,0
0,0,43,43,22,34,56,207,175,382,0.000333,0.73947,55,122012.5269,6778.473717,2218.40958,271.081232,8,0
0,0,67,67,24,95,119,308,250,558,0.000333,1.282436,24,92335.39949,5129.744416,3847.308312,734.175383,24,0
0,0,68,68,24,95,119,311,253,564,0.000333,1.296226,24,93328.25324,5184.902958,3888.677219,734.175383,24,0
0,0,58,58,23,86,109,267,221,488,0.000333,1.100958,22,72663.22691,4036.845939,3302.87395,656.700694,18,0
0,0,18,18,17,39,56,76,66,142,0.000333,0.274881,8,6597.155191,366.508622,824.644399,275.617555,4,0
0,0,30,30,16,65,81,183,148,331,0.000333,0.699497,16,33575.84562,1865.324756,2098.490351,455.453908,8,0
0,0,14,14,13,28,41,50,43,93,0.000333,0.166084,6,2989.514019,166.084112,498.252336,182.711654,4,0
0,0,14,14,13,28,41,50,43,93,0.000333,0.166084,6,2989.514019,166.084112,498.252336,182.711654,4,0
0,0,14,14,13,28,41,50,43,93,0.000333,0.166084,6,2989.514019,166.084112,498.252336,182.711654,4,0
0,0,25,25,15,64,79,193,151,344,0.000333,0.722834,14,30359.00808,1686.61156,2168.500577,442.603359,6,0
1,0,26,27,24,52,76,122,88,210,0.000333,0.437355,12,15744.77733,874.709852,1312.064778,406.461965,9,0
1,0,40,41,29,75,104,190,146,336,0.000333,0.750449,14,31518.86843,1751.048246,2251.347745,608.042851,11,0
0,0,13,13,22,23,45,64,52,116,0.000333,0.212352,22,14015.2091,778.622728,637.054959,202.149421,5,0
1,0,15,16,23,24,47,84,54,138,0.000333,0.255511,22,16863.73175,936.873986,766.533262,214.081025,8,0
1,0,7,8,13,17,30,40,25,65,0.000333,0.106316,6,1913.687332,106.315963,318.947889,117.592585,5,0
1,0,7,8,16,17,33,34,25,59,0.000333,0.099206,8,2380.954024,132.275224,297.619253,133.486868,4,0
1,0,3,4,10,11,21,16,13,29,0.000333,0.042459,5,636.886026,35.382557,127.377205,71.273029,2,0
1,0,15,16,25,36,61,98,75,173,0.000333,0.342006,24,24624.42143,1368.023413,1026.017559,302.213705,16,0
0,0,33,33,24,54,78,199,144,343,0.000333,0.718631,24,51741.43107,2874.523948,2155.892961,420.803025,28,0
0,0,31,31,24,52,76,194,138,332,0.000333,0.691437,24,49783.48643,2765.749246,2074.311934,406.461965,27,0
0,0,33,33,24,54,78,199,144,343,0.000333,0.718631,24,51741.43107,2874.523948,2155.892961,420.803025,28,0
0,0,27,27,21,44,65,159,119,278,0.000333,0.558073,20,33484.36504,1860.242502,1674.218252,332.453657,23,0
0,0,27,27,22,44,66,163,119,282,0.000333,0.568173,22,37499.42112,2083.301173,1704.519142,338.322487,23,0
0,0,24,24,22,48,70,140,103,243,0.000333,0.496472,22,32767.14701,1820.397056,1489.415773,366.185696,16,0
0,0,24,24,22,48,70,140,103,243,0.000333,0.496472,22,32767.14701,1820.397056,1489.415773,366.185696,16,0
0,0,7,7,16,19,35,43,30,73,0.000333,0.124813,8,2995.501282,166.416738,374.43766,144.710623,5,0
0,0,9,9,16,25,41,58,39,97,0.000333,0.173228,8,4157.460356,230.97002,519.682544,180.096405,6,0
0,0,70,70,26,96,122,299,240,539,0.000333,1.245222,26,97127.35305,5395.964058,3735.667425,754.367833,17,0
0,0,39,39,20,49,69,161,123,284,0.000333,0.578274,20,34696.41891,1927.578829,1734.820946,361.559344,7,0
0,0,39,39,20,49,69,161,123,284,0.000333,0.578274,20,34696.41891,1927.578829,1734.820946,361.559344,7,0
0,0,70,70,26,96,122,299,240,539,0.000333,1.245222,26,97127.35305,5395.964058,3735.667425,754.367833,17,0
0,0,40,40,20,49,69,165,125,290,0.000333,0.590491,20,35429.44185,1968.302325,1771.472092,361.559344,7,0
0,0,39,39,23,52,75,160,122,282,0.000333,0.585509,22,38643.59116,2146.866175,1756.526871,400.46479,7,0
0,0,36,36,20,46,66,149,113,262,0.000333,0.527877,20,31672.62519,1759.590288,1583.631259,340.522412,7,0
1,0,31,32,23,54,77,210,166,376,0.000333,0.785437,33,77758.2874,4319.904855,2356.311739,414.80585,15,0
1,0,31,32,23,54,77,210,166,376,0.000333,0.785437,33,77758.2874,4319.904855,2356.311739,414.80585,15,0
1,0,31,32,23,54,77,210,166,376,0.000333,0.785437,33,77758.2874,4319.904855,2356.311739,414.80585,15,0
1,0,31,32,23,54,77,210,166,376,0.000333,0.785437,33,77758.2874,4319.904855,2356.311739,414.80585,15,0
1,0,31,32,23,54,77,210,166,376,0.000333,0.785437,33,77758.2874,4319.904855,2356.311739,414.80585,15,0
1,0,31,32,23,54,77,210,166,376,0.000333,0.785437,33,77758.2874,4319.904855,2356.311739,414.80585,15,0
1,0,31,32,23,54,77,210,166,376,0.000333,0.785437,33,77758.2874,4319.904855,2356.311739,414.80585,15,0
0,0,25,25,21,53,74,171,103,274,0.000333,0.56713,10,17013.90222,945.21679,1701.390222,395.81845,27,0
0,0,25,25,21,53,74,171,103,274,0.000333,0.56713,10,17013.90222,945.21679,1701.390222,395.81845,27,0
0,0,89,89,32,86,118,566,415,981,0.000333,2.250624,64,432119.8612,24006.65896,6751.872831,712.658769,34,0
0,0,78,78,32,81,113,496,365,861,0.000333,1.957391,64,375819.1415,20878.8412,5872.174087,673.52785,31,0
0,0,53,53,24,58,82,327,248,575,0.000333,1.218531,48,175468.4353,9748.246407,3655.592403,449.801998,24,0
0,0,80,80,32,84,116,517,379,896,0.000333,2.04825,64,393264.0622,21848.00346,6144.750972,696.954664,31,0
0,0,80,80,32,84,116,517,379,896,0.000333,2.04825,64,393264.0622,21848.00346,6144.750972,696.954664,31,0
0,0,51,51,24,58,82,312,238,550,0.000333,1.165551,48,167839.3729,9324.409607,3496.653603,449.801998,23,0
0,0,17,17,17,29,46,82,71,153,0.000333,0.281702,16,13521.67967,751.204426,845.104979,210.368317,9,0
0,0,64,64,31,76,107,435,321,756,0.000333,1.69885,60,305792.9425,16988.49681,5096.549042,628.422577,20,0
0,0,66,66,31,78,109,450,333,783,0.000333,1.766496,60,317969.2996,17664.96109,5299.488326,643.841459,20,0
0,0,21,21,21,33,54,116,96,212,0.000333,0.406679,20,24400.72301,1355.595723,1220.03615,258.703672,10,0
0,0,66,66,31,78,109,450,333,783,0.000333,1.766496,60,317969.2996,17664.96109,5299.488326,643.841459,20,0
0,0,67,67,31,78,109,453,337,790,0.000333,1.782289,60,320811.937,17822.88539,5346.865617,643.841459,20,0
0,0,67,67,31,78,109,453,337,790,0.000333,1.782289,60,320811.937,17822.88539,5346.865617,643.841459,20,0
0,0,17,17,17,29,46,82,71,153,0.000333,0.281702,16,13521.67967,751.204426,845.104979,210.368317,9,0
0,0,63,63,31,74,105,431,316,747,0.000333,1.671847,60,300932.4841,16718.47134,5015.541402,613.079635,20,0
0,0,65,65,31,77,108,446,328,774,0.000333,1.742761,60,313696.9756,17427.60976,5228.282927,636.122649,20,0
0,0,34,34,23,45,68,193,150,343,0.000333,0.696,33,68903.9919,3827.99955,2087.999755,351.175314,19,0
0,0,60,60,32,73,105,369,272,641,0.000333,1.43461,48,206583.9061,11476.88367,4303.831377,611.857193,26,0
0,0,64,64,32,75,107,398,293,691,0.000333,1.552785,48,223600.977,12422.2765,4658.353688,627.161402,27,0
0,0,31,31,20,44,64,161,129,290,0.000333,0.58,20,34800,1933.333333,1740,326.653553,17,0
0,0,66,66,32,79,111,417,303,720,0.000333,1.63066,48,234815.0123,13045.27846,4891.979424,657.998679,27,0
0,0,79,79,32,83,115,512,375,887,0.000333,2.023983,64,388604.7792,21589.1544,6071.949675,689.128273,31,0
0,0,79,79,32,83,115,512,375,887,0.000333,2.023983,64,388604.7792,21589.1544,6071.949675,689.128273,31,0
0,0,79,79,32,83,115,512,375,887,0.000333,2.023983,64,388604.7792,21589.1544,6071.949675,689.128273,31,0
0,0,49,49,24,58,82,294,228,522,0.000333,1.106214,36,119471.1173,6637.284293,3318.642146,449.801998,22,0
0,0,80,80,32,84,116,517,379,896,0.000333,2.04825,64,393264.0622,21848.00346,6144.750972,696.954664,31,0
0,0,80,80,32,84,116,517,379,896,0.000333,2.04825,64,393264.0622,21848.00346,6144.750972,696.954664,31,0
0,0,53,53,32,69,101,320,237,557,0.000333,1.236208,48,178013.9422,9889.663456,3708.623796,581.488188,23,0
0,0,55,55,29,68,97,410,294,704,0.000333,1.54878,56,260194.9639,14455.27577,4646.338641,554.828922,16,0
0,0,64,64,31,76,107,435,321,756,0.000333,1.69885,60,305792.9425,16988.49681,5096.549042,628.422577,20,0
0,0,62,62,31,76,107,416,308,724,0.000333,1.626941,60,292849.3259,16269.40699,4880.822098,628.422577,19,0
0,0,63,63,31,74,105,431,316,747,0.000333,1.671847,60,300932.4841,16718.47134,5015.541402,613.079635,20,0
0,0,55,55,32,71,103,331,245,576,0.000333,1.283808,48,184868.3666,10270.46481,3851.424304,596.632045,24,0
0,0,64,64,32,77,109,411,297,708,0.000333,1.597292,48,230009.9761,12778.33201,4791.874502,642.542564,27,0
0,0,67,67,31,78,109,453,337,790,0.000333,1.782289,60,320811.937,17822.88539,5346.865617,643.841459,20,0
0,0,69,69,25,69,94,427,327,754,0.000333,1.647387,48,237223.6797,13179.09332,4942.159994,537.584592,27,0
0,0,89,89,32,87,119,572,429,1001,0.000333,2.300571,64,441709.6052,24539.42251,6901.712581,720.536084,31,0
0,0,88,88,32,87,119,568,427,995,0.000333,2.286781,64,439061.9952,24392.33307,6860.343674,720.536084,30,0
0,0,65,65,31,77,108,446,328,774,0.000333,1.742761,60,313696.9756,17427.60976,5228.282927,636.122649,20,0
0,0,63,63,31,77,108,437,320,757,0.000333,1.704483,60,306806.9903,17044.8328,5113.449839,636.122649,19,0
0,0,67,67,31,78,109,453,337,790,0.000333,1.782289,60,320811.937,17822.88539,5346.865617,643.841459,20,0
0,0,67,67,31,78,109,453,337,790,0.000333,1.782289,60,320811.937,17822.88539,5346.865617,643.841459,20,0
0,0,66,66,31,78,109,450,333,783,0.000333,1.766496,60,317969.2996,17664.96109,5299.488326,643.841459,20,0
0,0,64,64,31,78,109,441,325,766,0.000333,1.728143,60,311065.7516,17281.43064,5184.429193,643.841459,19,0
0,0,78,78,24,55,79,396,288,684,0.000333,1.437262,60,258707.1619,14372.62011,4311.786032,428.013884,32,0
0,0,78,78,24,55,79,396,288,684,0.000333,1.437262,60,258707.1619,14372.62011,4311.786032,428.013884,32,0
0,0,78,78,24,55,79,396,288,684,0.000333,1.437262,60,258707.1619,14372.62011,4311.786032,428.013884,32,0
0,0,64,64,21,43,64,271,220,491,0.000333,0.982,50,147300,8183.333333,2946,325.56805,24,0
0,0,98,98,21,43,64,432,329,761,0.000333,1.522,70,319620,17756.66667,4566,325.56805,42,0
0,0,98,98,21,43,64,432,329,761,0.000333,1.522,70,319620,17756.66667,4566,325.56805,42,0
0,0,98,98,21,43,64,432,329,761,0.000333,1.522,70,319620,17756.66667,4566,325.56805,42,0
0,0,58,58,18,41,59,249,200,449,0.000333,0.880436,36,95087.04225,5282.613458,2641.306729,294.718282,20,0
0,0,92,92,20,45,65,410,309,719,0.000333,1.443361,60,259804.9475,14433.60819,4330.082458,333.571951,38,0
0,0,92,92,20,45,65,410,309,719,0.000333,1.443361,60,259804.9475,14433.60819,4330.082458,333.571951,38,0
0,0,92,92,20,45,65,410,309,719,0.000333,1.443361,60,259804.9475,14433.60819,4330.082458,333.571951,38,0
0,0,58,58,18,41,59,248,199,447,0.000333,0.876514,36,94663.49195,5259.082886,2629.541443,294.718282,20,0
0,0,92,92,20,45,65,409,308,717,0.000333,1.439346,60,259082.2633,14393.45907,4318.037722,333.571951,38,0
0,0,92,92,20,45,65,409,308,717,0.000333,1.439346,60,259082.2633,14393.45907,4318.037722,333.571951,38,0
0,0,92,92,20,45,65,409,308,717,0.000333,1.439346,60,259082.2633,14393.45907,4318.037722,333.571951,38,0
0,0,44,44,17,34,51,177,155,332,0.000333,0.627748,32,60263.84683,3347.991491,1883.245214,242.460605,12,0
0,0,78,78,20,45,65,338,264,602,0.000333,1.208488,50,181273.2712,10070.73729,3625.465423,333.571951,30,0
0,0,78,78,20,45,65,338,264,602,0.000333,1.208488,50,181273.2712,10070.73729,3625.465423,333.571951,30,0
0,0,112,112,20,45,65,499,373,872,0.000333,1.750502,80,420120.3786,23340.02104,5251.504733,333.571951,48,0
0,0,78,78,20,45,65,338,264,602,0.000333,1.208488,50,181273.2712,10070.73729,3625.465423,333.571951,30,0
0,0,112,112,20,45,65,499,373,872,0.000333,1.750502,80,420120.3786,23340.02104,5251.504733,333.571951,48,0
0,0,112,112,20,45,65,499,373,872,0.000333,1.750502,80,420120.3786,23340.02104,5251.504733,333.571951,48,0
0,0,38,38,16,24,40,147,136,283,0.000333,0.502035,40,60244.22603,3346.901446,1506.105651,174.0391,11,0
0,0,72,72,20,43,63,308,245,553,0.000333,1.101812,50,165271.7899,9181.766105,3305.435798,319.767946,29,0
0,0,72,72,20,43,63,308,245,553,0.000333,1.101812,50,165271.7899,9181.766105,3305.435798,319.767946,29,0
0,0,106,106,20,43,63,469,354,823,0.000333,1.639767,80,393544.1102,21863.56168,4919.301377,319.767946,47,0
0,0,72,72,20,43,63,308,245,553,0.000333,1.101812,50,165271.7899,9181.766105,3305.435798,319.767946,29,0
0,0,106,106,20,43,63,469,354,823,0.000333,1.639767,80,393544.1102,21863.56168,4919.301377,319.767946,47,0
0,0,106,106,20,43,63,469,354,823,0.000333,1.639767,80,393544.1102,21863.56168,4919.301377,319.767946,47,0
0,0,44,44,17,33,50,188,164,352,0.000333,0.662212,32,63572.39612,3531.799785,1986.637379,235.951874,11,0
0,0,78,78,21,47,68,349,273,622,0.000333,1.262134,50,189320.0944,10517.78302,3786.401887,353.304342,29,0
0,0,78,78,21,47,68,349,273,622,0.000333,1.262134,50,189320.0944,10517.78302,3786.401887,353.304342,29,0
0,0,112,112,21,47,68,510,382,892,0.000333,1.810006,80,434401.3484,24133.40824,5430.016854,353.304342,47,0
0,0,78,78,21,47,68,349,273,622,0.000333,1.262134,50,189320.0944,10517.78302,3786.401887,353.304342,29,0
0,0,112,112,21,47,68,510,382,892,0.000333,1.810006,80,434401.3484,24133.40824,5430.016854,353.304342,47,0
0,0,112,112,21,47,68,510,382,892,0.000333,1.810006,80,434401.3484,24133.40824,5430.016854,353.304342,47,0
0,0,33,33,17,29,46,148,131,279,0.000333,0.513691,32,49314.36114,2739.68673,1541.073786,210.368317,7,0
0,0,67,67,21,47,68,309,240,549,0.000333,1.114006,50,167100.855,9283.380833,3342.0171,353.304342,25,0
0,0,67,67,21,47,68,309,240,549,0.000333,1.114006,50,167100.855,9283.380833,3342.0171,353.304342,25,0
0,0,101,101,21,47,68,470,349,819,0.000333,1.661877,70,348994.2447,19388.56915,4985.632067,353.304342,43,0
0,0,67,67,21,47,68,309,240,549,0.000333,1.114006,50,167100.855,9283.380833,3342.0171,353.304342,25,0
0,0,101,101,21,47,68,470,349,819,0.000333,1.661877,70,348994.2447,19388.56915,4985.632067,353.304342,43,0
0,0,101,101,21,47,68,470,349,819,0.000333,1.661877,70,348994.2447,19388.56915,4985.632067,353.304342,43,0
0,0,64,64,21,43,64,271,220,491,0.000333,0.982,50,147300,8183.333333,2946,325.56805,24,0
0,0,98,98,21,43,64,432,329,761,0.000333,1.522,70,319620,17756.66667,4566,325.56805,42,0
0,0,98,98,21,43,64,432,329,761,0.000333,1.522,70,319620,17756.66667,4566,325.56805,42,0
0,0,98,98,21,43,64,432,329,761,0.000333,1.522,70,319620,17756.66667,4566,325.56805,42,0
0,0,58,58,18,41,59,249,200,449,0.000333,0.880436,36,95087.04225,5282.613458,2641.306729,294.718282,20,0
0,0,92,92,20,45,65,410,309,719,0.000333,1.443361,60,259804.9475,14433.60819,4330.082458,333.571951,38,0
0,0,92,92,20,45,65,410,309,719,0.000333,1.443361,60,259804.9475,14433.60819,4330.082458,333.571951,38,0
0,0,92,92,20,45,65,410,309,719,0.000333,1.443361,60,259804.9475,14433.60819,4330.082458,333.571951,38,0
0,0,58,58,18,41,59,248,199,447,0.000333,0.876514,36,94663.49195,5259.082886,2629.541443,294.718282,20,0
0,0,92,92,20,45,65,409,308,717,0.000333,1.439346,60,259082.2633,14393.45907,4318.037722,333.571951,38,0
0,0,92,92,20,45,65,409,308,717,0.000333,1.439346,60,259082.2633,14393.45907,4318.037722,333.571951,38,0
0,0,92,92,20,45,65,409,308,717,0.000333,1.439346,60,259082.2633,14393.45907,4318.037722,333.571951,38,0
0,0,44,44,17,34,51,177,155,332,0.000333,0.627748,32,60263.84683,3347.991491,1883.245214,242.460605,12,0
0,0,78,78,20,45,65,338,264,602,0.000333,1.208488,50,181273.2712,10070.73729,3625.465423,333.571951,30,0
0,0,78,78,20,45,65,338,264,602,0.000333,1.208488,50,181273.2712,10070.73729,3625.465423,333.571951,30,0
0,0,112,112,20,45,65,499,373,872,0.000333,1.750502,80,420120.3786,23340.02104,5251.504733,333.571951,48,0
0,0,78,78,20,45,65,338,264,602,0.000333,1.208488,50,181273.2712,10070.73729,3625.465423,333.571951,30,0
0,0,112,112,20,45,65,499,373,872,0.000333,1.750502,80,420120.3786,23340.02104,5251.504733,333.571951,48,0
0,0,112,112,20,45,65,499,373,872,0.000333,1.750502,80,420120.3786,23340.02104,5251.504733,333.571951,48,0
0,0,38,38,16,24,40,147,136,283,0.000333,0.502035,40,60244.22603,3346.901446,1506.105651,174.0391,11,0
0,0,72,72,20,43,63,308,245,553,0.000333,1.101812,50,165271.7899,9181.766105,3305.435798,319.767946,29,0
0,0,72,72,20,43,63,308,245,553,0.000333,1.101812,50,165271.7899,9181.766105,3305.435798,319.767946,29,0
0,0,106,106,20,43,63,469,354,823,0.000333,1.639767,80,393544.1102,21863.56168,4919.301377,319.767946,47,0
0,0,72,72,20,43,63,308,245,553,0.000333,1.101812,50,165271.7899,9181.766105,3305.435798,319.767946,29,0
0,0,106,106,20,43,63,469,354,823,0.000333,1.639767,80,393544.1102,21863.56168,4919.301377,319.767946,47,0
0,0,106,106,20,43,63,469,354,823,0.000333,1.639767,80,393544.1102,21863.56168,4919.301377,319.767946,47,0
0,0,44,44,17,33,50,188,164,352,0.000333,0.662212,32,63572.39612,3531.799785,1986.637379,235.951874,11,0
0,0,78,78,21,47,68,349,273,622,0.000333,1.262134,50,189320.0944,10517.78302,3786.401887,353.304342,29,0
0,0,78,78,21,47,68,349,273,622,0.000333,1.262134,50,189320.0944,10517.78302,3786.401887,353.304342,29,0
0,0,112,112,21,47,68,510,382,892,0.000333,1.810006,80,434401.3484,24133.40824,5430.016854,353.304342,47,0
0,0,78,78,21,47,68,349,273,622,0.000333,1.262134,50,189320.0944,10517.78302,3786.401887,353.304342,29,0
0,0,112,112,21,47,68,510,382,892,0.000333,1.810006,80,434401.3484,24133.40824,5430.016854,353.304342,47,0
0,0,112,112,21,47,68,510,382,892,0.000333,1.810006,80,434401.3484,24133.40824,5430.016854,353.304342,47,0
0,0,59,59,18,42,60,251,207,458,0.000333,0.901785,36,97392.81214,5410.711786,2705.355893,301.535982,20,0
0,0,93,93,21,45,66,412,316,728,0.000333,1.466773,70,308022.3243,17112.35135,4400.318919,339.372055,38,0
0,0,93,93,21,45,66,412,316,728,0.000333,1.466773,70,308022.3243,17112.35135,4400.318919,339.372055,38,0
0,0,93,93,21,45,66,412,316,728,0.000333,1.466773,70,308022.3243,17112.35135,4400.318919,339.372055,38,0
0,0,53,53,17,37,54,212,180,392,0.000333,0.751972,32,72189.30883,4010.517157,2255.915901,262.236643,16,0
0,0,87,87,21,45,66,373,289,662,0.000333,1.333796,60,240083.3344,13337.96302,4001.388907,339.372055,34,0
0,0,87,87,21,45,66,373,289,662,0.000333,1.333796,60,240083.3344,13337.96302,4001.388907,339.372055,34,0
0,0,121,121,21,45,66,534,398,932,0.000333,1.877792,80,450670.0255,25037.22364,5633.375319,339.372055,52,0
0,0,87,87,21,45,66,373,289,662,0.000333,1.333796,60,240083.3344,13337.96302,4001.388907,339.372055,34,0
0,0,121,121,21,45,66,534,398,932,0.000333,1.877792,80,450670.0255,25037.22364,5633.375319,339.372055,52,0
0,0,121,121,21,45,66,534,398,932,0.000333,1.877792,80,450670.0255,25037.22364,5633.375319,339.372055,52,0
0,0,49,49,17,32,49,186,161,347,0.000333,0.649435,40,77932.17264,4329.565146,1948.304316,229.486868,15,0
0,0,83,83,21,43,64,347,270,617,0.000333,1.234,60,222120,12340,3702,325.56805,33,0
0,0,83,83,21,43,64,347,270,617,0.000333,1.234,60,222120,12340,3702,325.56805,33,0
0,0,117,117,21,43,64,508,379,887,0.000333,1.774,80,425760,23653.33333,5322,325.56805,51,0
0,0,83,83,21,43,64,347,270,617,0.000333,1.234,60,222120,12340,3702,325.56805,33,0
0,0,117,117,21,43,64,508,379,887,0.000333,1.774,80,425760,23653.33333,5322,325.56805,51,0
0,0,117,117,21,43,64,508,379,887,0.000333,1.774,80,425760,23653.33333,5322,325.56805,51,0
0,0,39,39,14,19,33,143,129,272,0.000333,0.457358,42,57627.15842,3201.508801,1372.0752,134.013592,10,0
0,0,73,73,21,43,64,304,238,542,0.000333,1.084,50,162600,9033.333333,3252,325.56805,28,0
0,0,73,73,21,43,64,304,238,542,0.000333,1.084,50,162600,9033.333333,3252,325.56805,28,0
0,0,107,107,21,43,64,465,347,812,0.000333,1.624,80,389760,21653.33333,4872,325.56805,46,0
0,0,73,73,21,43,64,304,238,542,0.000333,1.084,50,162600,9033.333333,3252,325.56805,28,0
0,0,107,107,21,43,64,465,347,812,0.000333,1.624,80,389760,21653.33333,4872,325.56805,46,0
0,0,107,107,21,43,64,465,347,812,0.000333,1.624,80,389760,21653.33333,4872,325.56805,46,0
0,0,88,88,27,89,116,590,425,1015,0.000333,2.320284,52,361964.2369,20109.12427,6960.85071,704.722238,50,0
0,0,88,88,27,89,116,590,425,1015,0.000333,2.320284,52,361964.2369,20109.12427,6960.85071,704.722238,50,0
0,0,18,18,19,47,66,145,106,251,0.000333,0.505714,18,27308.57263,1517.142924,1517.142924,341.776299,20,0
0,0,17,17,19,46,65,133,97,230,0.000333,0.461715,18,24932.60275,1385.144597,1385.144597,334.794473,18,0
0,0,16,16,19,43,62,121,88,209,0.000333,0.414809,18,22399.68652,1244.427029,1244.427029,314.040007,16,0
0,0,54,54,27,81,108,366,261,627,0.000333,1.411771,39,165177.2641,9176.514672,4235.314464,641.909813,27,0
0,0,19,19,21,51,72,155,114,269,0.000333,0.553237,20,33194.19651,1844.122028,1659.709825,381.532358,20,0
0,0,12,12,18,38,56,96,70,166,0.000333,0.32134,9,8676.188254,482.010459,964.020917,274.479896,12,0
0,0,16,16,17,42,59,99,76,175,0.000333,0.343154,8,8235.700269,457.538904,1029.462534,295.9642,9,0
0,0,16,16,17,42,59,99,76,175,0.000333,0.343154,8,8235.700269,457.538904,1029.462534,295.9642,9,0
0,0,16,16,17,40,57,101,77,178,0.000333,0.346085,8,8306.03538,461.44641,1038.254423,282.363992,8,0
0,0,16,16,17,40,57,101,77,178,0.000333,0.346085,8,8306.03538,461.44641,1038.254423,282.363992,8,0
0,0,8,8,11,22,33,45,39,84,0.000333,0.141243,5,2118.64553,117.702529,423.729106,136.161243,2,0
0,0,6,6,13,18,31,27,24,51,0.000333,0.084221,6,1515.984071,84.221337,252.664012,123.164366,4,0
0,0,28,28,20,44,64,134,103,237,0.000333,0.474,20,28440,1580,1422,326.653553,14,0
0,0,12,12,13,24,37,54,46,100,0.000333,0.173648,6,3125.672019,173.648446,520.945337,158.144816,3,0
0,0,42,42,23,48,71,285,215,500,0.000333,1.024958,44,135294.4366,7516.357591,3074.87356,372.120125,20,0
0,0,46,46,23,49,72,312,233,545,0.000333,1.12087,44,147954.8015,8219.711196,3362.609126,379.162707,20,0
0,0,20,20,23,32,55,138,109,247,0.000333,0.475999,33,47123.86303,2617.99239,1427.995849,264.041925,10,0
0,0,32,32,23,44,67,228,171,399,0.000333,0.80679,33,79872.19637,4437.344243,2420.369587,344.256916,10,0
0,0,42,42,23,48,71,285,215,500,0.000333,1.024958,44,135294.4366,7516.357591,3074.87356,372.120125,20,0
0,0,46,46,23,49,72,312,233,545,0.000333,1.12087,44,147954.8015,8219.711196,3362.609126,379.162707,20,0
0,0,20,20,23,32,55,138,109,247,0.000333,0.475999,33,47123.86303,2617.99239,1427.995849,264.041925,10,0
0,0,32,32,23,44,67,228,171,399,0.000333,0.80679,33,79872.19637,4437.344243,2420.369587,344.256916,10,0
0,0,20,20,23,32,55,138,109,247,0.000333,0.475999,33,47123.86303,2617.99239,1427.995849,264.041925,10,0
0,0,19,19,22,29,51,118,92,210,0.000333,0.39707,33,39309.90762,2183.883757,1191.209322,238.988944,10,0
0,0,32,32,23,44,67,228,171,399,0.000333,0.80679,33,79872.19637,4437.344243,2420.369587,344.256916,10,0
0,0,40,40,24,45,69,284,205,489,0.000333,0.995689,48,143379.286,7965.515892,2987.068459,357.172489,32,0
0,0,39,39,26,49,75,272,199,471,0.000333,0.977925,52,152556.2274,8475.345965,2933.773603,397.332215,24,0
0,0,39,39,26,51,77,260,193,453,0.000333,0.946285,39,110715.3178,6150.85099,2838.854303,411.505125,24,0
0,0,38,38,24,44,68,243,178,421,0.000333,0.854274,48,123015.4491,6834.191616,2562.821856,350.254091,24,0
0,0,38,38,24,44,68,243,178,421,0.000333,0.854274,48,123015.4491,6834.191616,2562.821856,350.254091,24,0
0,0,40,40,24,45,69,284,205,489,0.000333,0.995689,48,143379.286,7965.515892,2987.068459,357.172489,32,0
0,0,39,39,26,49,75,272,199,471,0.000333,0.977925,52,152556.2274,8475.345965,2933.773603,397.332215,24,0
0,0,39,39,26,51,77,260,193,453,0.000333,0.946285,39,110715.3178,6150.85099,2838.854303,411.505125,24,0
0,0,38,38,24,44,68,243,178,421,0.000333,0.854274,48,123015.4491,6834.191616,2562.821856,350.254091,24,0
0,0,38,38,24,44,68,243,178,421,0.000333,0.854274,48,123015.4491,6834.191616,2562.821856,350.254091,24,0
0,0,23,23,26,36,62,129,90,219,0.000333,0.434656,26,33903.19379,1883.510766,1303.968992,308.328733,15,0
0,0,23,23,27,37,64,127,90,217,0.000333,0.434,26,33852,1880.666667,1302,321.131737,14,0
0,0,22,22,26,36,62,122,88,210,0.000333,0.416794,26,32509.91186,1806.106214,1250.381225,308.328733,14,0
0,0,24,24,27,37,64,134,92,226,0.000333,0.452,26,35256,1958.666667,1356,321.131737,15,0
0,0,34,34,26,37,63,162,114,276,0.000333,0.54991,39,64339.4411,3574.413394,1649.729259,314.961207,19,0
0,0,35,35,26,45,71,172,120,292,0.000333,0.598575,26,46688.88013,2593.826674,1795.726159,369.344822,18,0
0,0,30,30,26,38,64,156,106,262,0.000333,0.524,26,40872,2270.666667,1572,321.632678,18,0
0,0,30,30,26,38,64,156,106,262,0.000333,0.524,26,40872,2270.666667,1572,321.632678,18,0
0,0,40,40,26,45,71,187,131,318,0.000333,0.651873,26,50846.10918,2824.783844,1955.619584,369.344822,20,0
0,0,36,36,26,38,64,170,118,288,0.000333,0.576,39,67392,3744,1728,321.632678,20,0
0,0,36,36,26,38,64,170,118,288,0.000333,0.576,39,67392,3744,1728,321.632678,20,0
0,0,47,47,26,44,70,225,159,384,0.000333,0.784548,39,91792.14246,5099.56347,2353.644679,362.426424,25,0
0,0,36,36,26,38,64,170,118,288,0.000333,0.576,39,67392,3744,1728,321.632678,20,0
0,0,35,35,26,37,63,167,116,283,0.000333,0.563857,39,65971.23852,3665.068806,1691.570218,314.961207,20,0
0,0,20,20,20,31,51,96,73,169,0.000333,0.319547,20,19172.79766,1065.155425,958.639883,240.018648,11,0
0,0,21,21,20,32,52,99,75,174,0.000333,0.330626,20,19837.53022,1102.085012,991.876511,246.438562,11,0
0,0,19,19,20,30,50,90,71,161,0.000333,0.302887,20,18173.21693,1009.623163,908.660847,233.64528,10,0
0,0,20,20,20,31,51,93,73,166,0.000333,0.313874,20,18832.45214,1046.247341,941.622607,240.018648,10,0
0,0,18,18,20,30,50,85,69,154,0.000333,0.289718,20,17383.07707,965.726504,869.153853,233.64528,9,0
0,0,18,18,20,30,50,85,69,154,0.000333,0.289718,20,17383.07707,965.726504,869.153853,233.64528,9,0
0,0,19,19,20,33,53,91,74,165,0.000333,0.315036,20,18902.1375,1050.11875,945.106875,252.903568,9,0
0,0,20,20,20,31,51,93,73,166,0.000333,0.313874,20,18832.45214,1046.247341,941.622607,240.018648,10,0
0,0,19,19,20,31,51,91,71,162,0.000333,0.306311,20,18378.65811,1021.036562,918.932905,240.018648,10,0
0,0,20,20,20,32,52,94,73,167,0.000333,0.317324,20,19039.46866,1057.748259,951.973433,246.438562,10,0
0,0,19,19,23,32,55,101,77,178,0.000333,0.343027,22,22639.80464,1257.766924,1029.082029,264.041925,13,0
0,0,29,29,26,37,63,153,104,257,0.000333,0.512054,26,39940.18445,2218.899136,1536.16094,314.961207,18,0
0,0,30,30,26,38,64,156,106,262,0.000333,0.524,26,40872,2270.666667,1572,321.632678,18,0
0,0,7,7,16,19,35,43,28,71,0.000333,0.121393,8,2913.432754,161.857375,364.179094,144.710623,3,0
0,0,88,88,31,85,116,530,412,942,0.000333,2.153406,60,387613.0858,21534.06033,6460.218097,698.378315,39,0
0,0,88,88,31,85,116,530,412,942,0.000333,2.153406,60,387613.0858,21534.06033,6460.218097,698.378315,39,0
0,0,88,88,31,85,116,530,412,942,0.000333,2.153406,60,387613.0858,21534.06033,6460.218097,698.378315,39,0
0,0,54,54,26,51,77,259,206,465,0.000333,0.971352,52,151530.8986,8418.383253,2914.055741,411.505125,27,0
0,0,54,54,26,51,77,258,205,463,0.000333,0.967174,52,150879.1528,8382.175153,2901.522168,411.505125,27,0
0,0,87,87,31,84,115,530,411,941,0.000333,2.147202,60,386496.3683,21472.02046,6441.606138,690.534749,38,0
0,0,6,6,14,29,43,43,38,81,0.000333,0.146509,7,3076.692116,170.92734,439.527445,194.184418,2,0
0,0,10,10,17,25,42,61,47,108,0.000333,0.194123,8,4658.962253,258.831236,582.370282,185.583273,4,0
0,0,9,9,15,24,39,53,39,92,0.000333,0.162086,7,3403.799029,189.099946,486.257004,168.642459,4,0
0,0,20,20,11,38,49,90,86,176,0.000333,0.329396,10,9881.889326,548.993851,988.188933,237.474993,1,0
0,0,19,19,13,39,52,61,55,116,0.000333,0.220417,6,3967.506044,220.417002,661.251007,254.236403,4,0
0,0,33,33,14,56,70,119,97,216,0.000333,0.441308,7,9267.475922,514.859773,1323.925132,378.514845,9,0
0,0,20,20,14,41,55,69,59,128,0.000333,0.246671,7,5180.098303,287.783239,740.014043,272.962601,4,0
0,0,59,59,24,72,96,215,174,389,0.000333,0.85385,24,61477.20991,3415.40055,2561.550413,554.2737,20,0
0,0,14,14,17,28,45,54,46,100,0.000333,0.183062,8,4393.482477,244.08236,549.18531,204.092806,3,0
0,0,69,69,35,100,135,375,232,607,0.000333,1.431876,34,146051.3203,8113.962238,4295.627067,843.910525,42,0
0,0,70,70,35,100,135,380,236,616,0.000333,1.453106,34,148216.8259,8234.268104,4359.318408,843.910525,43,0
0,0,64,64,34,96,130,368,224,592,0.000333,1.385747,34,141346.2193,7852.567741,4157.241745,805.130137,40,0
0,0,69,69,35,100,135,375,232,607,0.000333,1.431876,34,146051.3203,8113.962238,4295.627067,843.910525,42,0
0,0,71,71,35,101,136,384,239,623,0.000333,1.47183,34,150126.6379,8340.368772,4415.48935,852.004265,43,0
0,0,62,62,33,91,124,344,211,555,0.000333,1.286526,32,123506.5265,6861.473693,3859.578952,758.674318,40,0
0,0,61,61,34,94,128,356,215,571,0.000333,1.332333,34,135898,7549.888889,3997,789.105089,39,0
0,0,61,61,33,90,123,338,207,545,0.000333,1.261223,32,121077.453,6726.525165,3783.670405,750.731785,39,0
0,0,61,61,34,92,126,354,213,567,0.000333,1.318706,34,134508.0024,7472.666798,3956.117717,773.141437,39,0
0,0,46,46,28,84,112,271,168,439,0.000333,0.996143,28,83676.0067,4648.667039,2988.428811,671.560601,31,0
0,0,48,48,28,76,104,264,160,424,0.000333,0.946995,28,79547.62033,4419.312241,2840.98644,609.448429,33,0
0,0,25,25,25,40,65,132,80,212,0.000333,0.425581,24,30641.80743,1702.322635,1276.741976,328.973529,16,0
0,0,25,25,23,41,64,124,78,202,0.000333,0.404,11,13332,740.666667,1212,323.701557,16,0
0,0,25,25,22,40,62,121,77,198,0.000333,0.392977,11,12968.23956,720.457754,1178.930869,310.984619,16,0
0,0,28,28,26,45,71,151,91,242,0.000333,0.49608,26,38694.20888,2149.678271,1488.238803,369.344822,16,0
0,0,55,55,31,99,130,322,207,529,0.000333,1.238278,30,111444.9772,6191.387622,3714.832573,809.886391,35,0
0,0,52,52,31,83,114,299,184,483,0.000333,1.100095,30,99008.57631,5500.476461,3300.285877,682.708358,31,0
0,0,56,56,32,80,112,318,184,502,0.000333,1.139097,32,109353.3495,6075.186082,3417.292171,665.754248,36,0
0,0,48,48,30,77,107,284,169,453,0.000333,1.017962,30,91616.53635,5089.807575,3053.884545,629.749282,32,0
0,0,44,44,28,76,104,255,154,409,0.000333,0.913493,28,76733.43565,4262.968647,2740.479845,609.448429,30,0
0,0,56,56,32,80,112,319,185,504,0.000333,1.143636,32,109789.0202,6099.39001,3430.906881,665.754248,36,0
0,0,41,41,28,74,102,241,146,387,0.000333,0.860743,14,36151.2005,2008.400028,2582.228607,594.105487,29,0
0,0,46,46,28,78,106,249,168,417,0.000333,0.935181,28,78555.19923,4364.177735,2805.54283,624.867311,31,0
0,0,45,45,27,70,97,238,158,396,0.000333,0.871188,26,67952.70262,3775.150146,2613.565486,557.431774,30,0
0,0,46,46,28,84,112,271,168,439,0.000333,0.996143,28,83676.0067,4648.667039,2988.428811,671.560601,31,0
0,0,48,48,28,76,104,264,160,424,0.000333,0.946995,28,79547.62033,4419.312241,2840.98644,609.448429,33,0
0,0,25,25,25,40,65,132,80,212,0.000333,0.425581,24,30641.80743,1702.322635,1276.741976,328.973529,16,0
0,0,25,25,23,41,64,124,78,202,0.000333,0.404,11,13332,740.666667,1212,323.701557,16,0
0,0,25,25,22,40,62,121,77,198,0.000333,0.392977,11,12968.23956,720.457754,1178.930869,310.984619,16,0
0,0,47,47,28,85,113,275,171,446,0.000333,1.013933,28,85170.39488,4731.688605,3041.799817,679.404167,31,0
0,0,35,35,23,54,77,185,123,308,0.000333,0.64339,22,42463.7456,2359.096978,1930.170255,414.80585,28,0
0,0,22,22,22,41,63,115,74,189,0.000333,0.376569,11,12426.76496,690.375831,1129.705906,317.767128,16,0
0,0,24,24,25,41,66,132,80,212,0.000333,0.427137,12,15376.93864,854.274369,1281.411553,335.756037,16,0
0,0,25,25,25,40,65,132,80,212,0.000333,0.425581,24,30641.80743,1702.322635,1276.741976,328.973529,16,0
0,0,24,24,25,43,68,135,83,218,0.000333,0.442356,12,15924.80279,884.711266,1327.066899,349.425789,15,0
0,0,49,49,32,84,116,280,175,455,0.000333,1.040127,32,99852.20329,5547.344627,3120.381353,696.954664,30,0
0,0,21,21,20,35,55,106,68,174,0.000333,0.335319,10,10059.5659,558.864772,1005.95659,265.963467,12,0
0,0,36,36,24,56,80,215,140,355,0.000333,0.748095,24,53862.82737,2992.379298,2244.284474,435.250976,13,0
0,0,4,4,11,15,26,22,19,41,0.000333,0.064239,5,963.590142,53.532786,192.718028,96.657107,2,0
0,0,58,58,27,76,103,396,239,635,0.000333,1.415309,39,165591.1856,9199.510309,4245.927835,603.224454,18,0
0,0,3,3,9,12,21,15,15,30,0.000333,0.043923,4,527.078091,29.282116,131.769523,71.548875,2,0
0,0,62,62,33,90,123,346,213,559,0.000333,1.293622,32,124187.6995,6899.316637,3880.865608,750.731785,38,0
0,0,61,61,33,90,123,342,211,553,0.000333,1.279737,32,122854.7367,6825.263149,3839.210521,750.731785,37,0
0,0,51,51,30,79,109,299,180,479,0.000333,1.080653,30,97258.80875,5403.267153,3241.960292,645.205397,32,0
0,0,44,44,30,76,106,256,157,413,0.000333,0.92621,30,83358.93443,4631.051913,2778.631148,622.049209,29,0
0,0,34,34,25,57,82,187,125,312,0.000333,0.661185,24,47605.34941,2644.741634,1983.556225,448.571136,23,0
0,0,29,29,25,55,80,166,107,273,0.000333,0.575295,12,20710.63644,1150.590913,1725.88637,434.071189,22,0
0,0,25,25,24,46,70,131,84,215,0.000333,0.439265,12,15813.55018,878.530566,1317.795849,364.12295,17,0
0,0,25,25,27,46,73,147,90,237,0.000333,0.488996,13,19070.84947,1059.491637,1466.98842,382.465813,16,0
0,0,22,22,20,36,56,109,70,179,0.000333,0.346506,10,10395.16531,577.509184,1039.516531,272.555862,12,0
0,0,21,21,20,35,55,106,68,174,0.000333,0.335319,10,10059.5659,558.864772,1005.95659,265.963467,12,0
0,0,22,22,17,30,47,90,63,153,0.000333,0.283284,16,13597.63351,755.424084,849.852094,216.693586,14,0
0,0,22,22,18,33,51,106,69,175,0.000333,0.330891,18,17868.13983,992.674435,992.674435,241.523656,14,0
0,0,15,15,15,22,37,59,41,100,0.000333,0.173648,7,3646.617356,202.589853,520.945337,156.710855,8,0
0,0,14,14,15,25,40,71,45,116,0.000333,0.205781,7,4321.405613,240.07809,617.343659,174.699764,7,0
0,0,16,16,16,34,50,71,55,126,0.000333,0.237042,8,5689.007039,316.055947,711.12588,236.973737,7,0
0,0,15,15,15,32,47,64,49,113,0.000333,0.209223,7,4393.679782,244.093321,627.66854,218.603359,5,0
0,0,17,17,17,21,38,73,43,116,0.000333,0.20292,16,9740.153465,541.119637,608.759592,161.725534,14,0
0,0,16,16,16,19,35,68,39,107,0.000333,0.182944,16,8781.332525,487.851807,548.833283,144.710623,14,0
0,0,21,21,22,53,75,96,106,202,0.000333,0.419407,22,27680.87026,1537.826126,1258.221375,401.68728,9,0
0,0,33,33,23,66,89,164,161,325,0.000333,0.701538,22,46301.49403,2572.305224,2104.613365,502.971937,14,0
0,0,36,36,24,67,91,180,174,354,0.000333,0.76792,24,55290.22326,3071.67907,2303.759303,516.467076,16,0
0,0,29,29,24,64,88,171,172,343,0.000333,0.738528,24,53174.04109,2954.113394,2215.585045,494.0391,12,0
0,0,26,26,19,57,76,148,138,286,0.000333,0.595636,18,32164.33084,1786.907269,1786.907269,413.185354,14,0
0,0,6,6,12,21,33,25,31,56,0.000333,0.094162,6,1694.916424,94.162024,282.486071,135.258216,2,0
0,0,19,19,18,37,55,81,83,164,0.000333,0.316048,18,17066.57387,948.142993,948.142993,267.808425,9,0
0,0,31,31,19,51,70,154,140,294,0.000333,0.60067,18,32436.16573,1802.009207,1802.009207,370.004315,14,0
0,0,34,34,20,52,72,170,153,323,0.000333,0.664295,20,39857.71551,2214.317528,1992.885775,382.861427,16,0
0,0,34,34,20,52,72,170,153,323,0.000333,0.664295,20,39857.71551,2214.317528,1992.885775,382.861427,16,0
0,0,28,28,24,64,88,165,167,332,0.000333,0.714844,24,51468.75114,2859.375063,2144.531297,494.0391,11,0
0,0,26,26,19,58,77,153,140,293,0.000333,0.612056,18,33051.03222,1836.168456,1836.168456,420.47352,14,0
0,0,6,6,12,21,33,25,31,56,0.000333,0.094162,6,1694.916424,94.162024,282.486071,135.258216,2,0
0,0,26,26,21,49,70,138,111,249,0.000333,0.50873,20,30523.82942,1695.768301,1526.191471,367.359448,5,0
0,0,24,24,20,47,67,127,103,230,0.000333,0.465067,20,27904.01028,1550.222793,1395.200514,347.504238,5,0
0,0,23,23,20,45,65,116,94,210,0.000333,0.421566,20,25293.94482,1405.219156,1264.697241,333.571951,5,0
0,0,22,22,20,44,64,107,86,193,0.000333,0.386,10,11580,643.333333,1158,326.653553,5,0
0,0,21,21,20,42,62,96,77,173,0.000333,0.343359,10,10300.75962,572.264423,1030.075962,312.915894,5,0
0,0,25,25,28,42,70,139,111,250,0.000333,0.510774,28,42904.98112,2383.610062,1532.320754,361.08327,7,0
0,0,24,24,28,42,70,135,107,242,0.000333,0.494429,28,41532.02172,2307.33454,1483.28649,361.08327,7,0
0,0,25,25,28,42,70,139,111,250,0.000333,0.510774,28,42904.98112,2383.610062,1532.320754,361.08327,7,0
0,0,22,22,28,42,70,125,98,223,0.000333,0.45561,28,38271.24316,2126.180175,1366.830113,361.08327,7,0
0,0,20,20,17,55,72,128,96,224,0.000333,0.460688,8,11056.5056,614.250311,1382.0632,387.461653,7,0
0,0,10,10,16,23,39,57,36,93,0.000333,0.163847,8,3932.339251,218.463292,491.542406,168.041925,4,0
0,0,22,22,19,48,67,127,117,244,0.000333,0.493375,18,26642.26372,1480.125762,1480.125762,348.788823,18,0
0,0,20,20,19,45,64,111,102,213,0.000333,0.426,18,23004,1278,1278,327.844012,17,0
0,0,20,20,19,45,64,111,102,213,0.000333,0.426,18,23004,1278,1278,327.844012,17,0
0,0,21,21,20,46,66,116,106,222,0.000333,0.447285,20,26837.10989,1490.950549,1341.855494,340.522412,17,0
0,0,21,21,20,45,65,113,103,216,0.000333,0.43361,20,26016.62895,1445.368275,1300.831448,333.571951,17,0
0,0,5,5,13,14,27,34,24,58,0.000333,0.091928,6,1654.700851,91.927825,275.783475,101.408685,2,0
0,0,4,4,13,13,26,25,19,44,0.000333,0.06894,6,1240.916086,68.939783,206.819348,96.211433,2,0
0,0,30,30,22,52,74,154,127,281,0.000333,0.581619,22,38386.84071,2132.602261,1744.856396,394.530361,10,0
0,0,27,27,22,47,69,134,107,241,0.000333,0.490718,22,32387.39667,1799.299815,1472.154394,359.173172,10,0
0,0,26,26,28,42,70,143,113,256,0.000333,0.523032,28,43934.70067,2440.816704,1569.096452,361.08327,8,0
0,0,25,25,28,42,70,139,109,248,0.000333,0.506687,28,42561.74127,2364.541182,1520.062188,361.08327,8,0
0,0,26,26,28,42,70,143,113,256,0.000333,0.523032,28,43934.70067,2440.816704,1569.096452,361.08327,8,0
0,0,23,23,28,42,70,129,100,229,0.000333,0.467869,28,39300.96271,2183.386817,1403.605811,361.08327,8,0
0,0,26,26,22,34,56,102,82,184,0.000333,0.356184,22,23508.17272,1306.009596,1068.553306,271.081232,14,0
0,0,26,26,21,34,55,101,83,184,0.000333,0.35459,20,21275.40375,1181.966875,1063.770187,265.212402,14,0
0,0,25,25,21,34,55,98,81,179,0.000333,0.344954,20,20697.26777,1149.84821,1034.863389,265.212402,13,0
0,0,24,24,21,33,54,93,77,170,0.000333,0.32611,20,19566.61751,1087.034306,978.330875,258.703672,13,0
0,0,66,66,26,82,108,532,491,1023,0.000333,2.303417,65,449166.2445,24953.68025,6910.249915,643.530697,18,0
0,0,66,66,26,82,108,532,491,1023,0.000333,2.303417,65,449166.2445,24953.68025,6910.249915,643.530697,18,0
0,0,66,66,26,82,108,532,491,1023,0.000333,2.303417,65,449166.2445,24953.68025,6910.249915,643.530697,18,0
0,0,64,64,26,78,104,466,415,881,0.000333,1.967696,65,383700.6805,21316.70447,5903.087392,612.472806,18,0
0,0,66,66,26,87,113,552,503,1055,0.000333,2.39843,65,467693.7723,25982.98735,7195.288805,682.747517,18,0
0,0,66,66,26,87,113,552,503,1055,0.000333,2.39843,65,467693.7723,25982.98735,7195.288805,682.747517,18,0
0,0,66,66,26,87,113,552,503,1055,0.000333,2.39843,65,467693.7723,25982.98735,7195.288805,682.747517,18,0
0,0,66,66,26,85,111,516,467,983,0.000333,2.226304,65,434129.2018,24118.28899,6678.910797,667.009662,18,0
0,0,66,66,26,85,111,516,467,983,0.000333,2.226304,65,434129.2018,24118.28899,6678.910797,667.009662,18,0
0,0,66,66,26,85,111,516,467,983,0.000333,2.226304,65,434129.2018,24118.28899,6678.910797,667.009662,18,0
0,0,64,64,26,75,101,466,417,883,0.000333,1.959734,65,382148.0481,21230.44711,5879.200739,589.372834,18,0
0,0,65,65,26,86,112,517,467,984,0.000333,2.232812,65,435398.4208,24188.80116,6698.437243,674.870202,18,0
0,0,65,65,26,86,112,517,467,984,0.000333,2.232812,65,435398.4208,24188.80116,6698.437243,674.870202,18,0
0,0,65,65,26,83,109,496,446,942,0.000333,2.12521,65,414415.9262,23023.10701,6375.629634,651.339705,18,0
0,0,65,65,26,83,109,496,446,942,0.000333,2.12521,65,414415.9262,23023.10701,6375.629634,651.339705,18,0
0,0,64,64,26,71,97,454,405,859,0.000333,1.889775,65,368506.1335,20472.56298,5669.325131,558.843478,18,0
0,0,65,65,26,73,99,451,403,854,0.000333,1.887157,65,367995.586,20444.19922,5661.470554,574.068625,18,0
0,0,65,65,26,73,99,451,403,854,0.000333,1.887157,65,367995.586,20444.19922,5661.470554,574.068625,18,0
0,0,16,16,19,41,60,82,62,144,0.000333,0.283531,9,7655.330212,425.296123,850.592246,300.370255,3,0
0,0,11,11,19,36,55,66,46,112,0.000333,0.215837,9,5827.610591,323.756144,647.512288,266.827923,3,0
0,0,16,16,19,47,66,96,68,164,0.000333,0.330427,9,8921.52572,495.640318,991.280636,341.776299,3,0
0,0,11,11,19,42,61,80,52,132,0.000333,0.260952,9,7045.715957,391.428664,782.857329,307.187955,3,0
0,0,29,29,22,68,90,139,110,249,0.000333,0.538824,11,17781.18563,987.843646,1616.471421,512.054969,4,0
0,0,13,13,18,22,40,88,44,132,0.000333,0.234165,18,12644.90115,702.494509,702.494509,173.166146,13,0
0,0,12,12,18,21,39,86,42,128,0.000333,0.22551,18,12177.56671,676.531484,676.531484,167.297316,13,0
0,0,12,12,18,21,39,86,42,128,0.000333,0.22551,18,12177.56671,676.531484,676.531484,167.297316,13,0
0,0,7,7,16,14,30,55,28,83,0.000333,0.135757,16,6516.350711,362.019484,407.271919,117.302969,10,0
0,0,18,18,18,28,46,95,63,158,0.000333,0.290908,18,15709.0102,872.722789,872.722789,209.664588,9,0
0,0,17,17,18,25,43,95,59,154,0.000333,0.278548,18,15041.6059,835.644772,835.644772,191.155055,9,0
0,0,18,18,18,28,46,95,63,158,0.000333,0.290908,18,15709.0102,872.722789,872.722789,209.664588,9,0
0,0,17,17,18,26,44,95,59,154,0.000333,0.280251,18,15133.54445,840.752469,840.752469,197.270083,9,0
0,0,58,58,23,56,79,260,197,457,0.000333,0.960276,33,95067.31746,5281.517637,2880.827802,429.253801,22,0
0,0,55,55,22,54,76,246,185,431,0.000333,0.897619,33,88864.27302,4936.904057,2692.856758,408.871421,22,0
0,0,55,55,22,54,76,246,185,431,0.000333,0.897619,33,88864.27302,4936.904057,2692.856758,408.871421,22,0
0,0,9,9,17,30,47,63,45,108,0.000333,0.199965,8,4799.164768,266.620265,599.895596,216.693586,4,0
0,0,37,37,25,66,91,201,166,367,0.000333,0.79612,24,57320.65519,3184.480844,2388.360633,515.026417,25,0
0,0,29,29,25,50,75,154,125,279,0.000333,0.57928,24,41708.16995,2317.120553,1737.840415,398.289214,23,0
0,0,29,29,20,42,62,128,112,240,0.000333,0.476336,20,28580.14229,1587.785683,1429.007114,312.915894,22,0
0,0,25,25,22,44,66,116,85,201,0.000333,0.404974,11,13364.1554,742.453078,1214.923218,338.322487,8,0
0,0,11,11,21,36,57,78,57,135,0.000333,0.26248,10,7874.401519,437.466751,787.440152,278.355966,8,0
0,0,20,20,17,30,47,69,55,124,0.000333,0.22959,8,5510.152141,306.119563,688.769018,216.693586,7,0
0,0,10,10,20,34,54,75,56,131,0.000333,0.251297,10,7538.902628,418.827924,753.890263,259.412299,7,0
0,0,37,37,25,66,91,201,166,367,0.000333,0.79612,24,57320.65519,3184.480844,2388.360633,515.026417,25,0
0,0,29,29,25,50,75,154,125,279,0.000333,0.57928,24,41708.16995,2317.120553,1737.840415,398.289214,23,0
0,0,29,29,20,42,62,128,112,240,0.000333,0.476336,20,28580.14229,1587.785683,1429.007114,312.915894,22,0
0,0,25,25,22,44,66,116,85,201,0.000333,0.404974,11,13364.1554,742.453078,1214.923218,338.322487,8,0
0,0,11,11,21,36,57,78,57,135,0.000333,0.26248,10,7874.401519,437.466751,787.440152,278.355966,8,0
0,0,20,20,17,30,47,69,55,124,0.000333,0.22959,8,5510.152141,306.119563,688.769018,216.693586,7,0
0,0,30,30,25,51,76,160,130,290,0.000333,0.603966,24,43485.57549,2415.865305,1811.898979,405.390097,23,0
0,0,6,6,14,24,38,46,44,90,0.000333,0.157438,7,3306.194333,183.677463,472.313476,163.342069,9,0
0,0,5,5,13,21,34,28,27,55,0.000333,0.09327,6,1678.862738,93.270152,279.810456,140.344382,5,0
0,0,5,5,14,17,31,29,24,53,0.000333,0.087524,7,1838.006831,102.111491,262.572404,122.789837,3,0
0,0,79,79,26,101,127,382,297,679,0.000333,1.581772,26,123378.2395,6854.346637,4745.316902,794.690792,22,0
0,0,51,51,25,69,94,238,190,428,0.000333,0.935121,24,67328.73668,3740.485371,2805.364029,537.584592,11,0
0,0,51,51,25,69,94,238,190,428,0.000333,0.935121,24,67328.73668,3740.485371,2805.364029,537.584592,11,0
0,0,49,49,23,69,92,228,182,410,0.000333,0.891553,22,58842.52884,3269.02938,2674.660402,525.530113,10,0
0,0,47,47,23,68,91,221,178,399,0.000333,0.865537,22,57125.42135,3173.63452,2596.610061,517.989398,10,0
1,0,3,4,12,38,50,75,40,115,0.000333,0.216348,6,3894.260771,216.347821,649.043462,242.440796,3,0
0,0,52,52,29,69,98,284,218,502,0.000333,1.106861,42,139464.5424,7748.030131,3320.584342,562.369636,16,0
0,0,43,43,27,63,90,229,183,412,0.000333,0.891548,26,69540.73037,3863.373909,2674.643476,504.950598,16,0
0,0,48,48,28,66,94,253,198,451,0.000333,0.985373,42,124157.022,6897.612335,2956.119572,533.53595,12,0
0,0,25,25,27,43,70,138,110,248,0.000333,0.506687,26,39521.61689,2195.645383,1520.062188,361.711347,12,0
0,0,42,42,23,56,79,204,176,380,0.000333,0.798479,33,79049.41058,4391.633921,2395.436684,429.253801,13,0
0,0,43,43,24,61,85,242,209,451,0.000333,0.963545,36,104062.8712,5781.270624,2890.635312,471.814078,13,0
0,0,43,43,24,61,85,242,209,451,0.000333,0.963545,36,104062.8712,5781.270624,2890.635312,471.814078,13,0
0,0,14,14,18,28,46,89,54,143,0.000333,0.26329,9,7108.824237,394.93468,789.86936,209.664588,9,0
0,0,14,14,18,28,46,89,54,143,0.000333,0.26329,9,7108.824237,394.93468,789.86936,209.664588,9,0
0,0,5,5,16,16,32,32,23,55,0.000333,0.091667,8,2200,122.222222,275,128,3,0
0,0,16,16,17,40,57,110,68,178,0.000333,0.346085,8,8306.03538,461.44641,1038.254423,282.363992,11,0
0,0,25,25,21,36,57,106,90,196,0.000333,0.381082,20,22864.92886,1270.273825,1143.246443,278.355966,8,0
0,0,24,24,21,36,57,101,88,189,0.000333,0.367472,20,22048.32425,1224.906903,1102.416213,278.355966,7,0
0,0,24,24,21,35,56,96,84,180,0.000333,0.348441,20,20906.47772,1161.470984,1045.323886,271.763571,7,0
0,0,28,28,21,45,66,131,111,242,0.000333,0.487581,20,29254.86754,1625.270419,1462.743377,339.372055,9,0
0,0,14,14,16,27,43,62,56,118,0.000333,0.213433,16,10244.78786,569.154881,640.299241,192.381963,4,0
0,0,12,12,16,26,42,49,49,98,0.000333,0.176149,8,4227.576859,234.865381,528.447107,186.211433,3,0
0,0,18,18,19,39,58,96,81,177,0.000333,0.345621,18,18663.52745,1036.862636,1036.862636,286.841309,5,0
0,0,17,17,17,33,50,83,73,156,0.000333,0.293481,16,14087.06505,782.614725,880.441566,235.951874,5,0
0,0,15,15,18,33,51,75,64,139,0.000333,0.262822,9,7096.204103,394.233561,788.467123,241.523656,4,0
0,0,14,14,16,27,43,62,56,118,0.000333,0.213433,16,10244.78786,569.154881,640.299241,192.381963,4,0
0,0,13,13,18,35,53,68,60,128,0.000333,0.244391,9,6598.564364,366.586909,733.173818,254.583556,3,0
0,0,12,12,16,26,42,49,49,98,0.000333,0.176149,8,4227.576859,234.865381,528.447107,186.211433,3,0
0,0,11,11,14,26,40,44,47,91,0.000333,0.161432,7,3390.068196,188.337122,484.295457,175.514402,2,0
0,0,17,17,17,44,61,112,91,203,0.000333,0.401313,16,19263.03487,1070.168604,1203.93968,309.70186,5,0
0,0,17,17,17,44,61,112,91,203,0.000333,0.401313,16,19263.03487,1070.168604,1203.93968,309.70186,5,0
1,0,26,27,22,45,67,136,89,225,0.000333,0.454957,11,15013.57075,834.087264,1364.870068,345.240885,14,0
1,0,24,25,21,41,62,126,81,207,0.000333,0.41084,10,12325.18636,684.732576,1232.518636,311.898298,14,0
1,0,21,22,15,38,53,100,69,169,0.000333,0.322673,7,6776.129898,376.451661,968.018557,258.024604,10,0
1,0,20,21,15,35,50,92,64,156,0.000333,0.293481,7,6163.090959,342.393942,880.441566,238.128265,9,0
1,0,19,20,15,35,50,91,63,154,0.000333,0.289718,7,6084.076973,338.004276,869.153853,238.128265,8,0
1,0,3,4,6,8,14,10,9,19,0.000333,0.024113,3,217.019231,12.056624,72.339744,39.509775,1,0
1,0,3,4,6,7,13,8,8,16,0.000333,0.019736,3,177.621106,9.867839,59.207035,35.161259,1,0
0,0,41,41,33,67,100,252,179,431,0.000333,0.954501,32,91632.06457,5090.670254,2863.502018,572.892982,20,0
0,0,40,40,33,66,99,249,177,426,0.000333,0.941369,32,90371.38945,5020.632747,2824.10592,565.395018,20,0
0,0,49,49,34,79,113,304,208,512,0.000333,1.163977,34,118725.6754,6595.870854,3491.931629,670.972416,21,0
0,0,49,49,34,79,113,304,208,512,0.000333,1.163977,34,118725.6754,6595.870854,3491.931629,670.972416,21,0
0,0,40,40,32,66,98,246,174,420,0.000333,0.926059,32,88901.70031,4938.98335,2778.178135,558.930012,20,0
0,0,34,34,32,66,98,235,161,396,0.000333,0.873142,32,83821.60315,4656.75573,2619.425098,558.930012,14,0
0,0,44,44,35,77,112,299,196,495,0.000333,1.123214,34,114567.7833,6364.876852,3369.640686,662.067469,17,0
0,0,47,47,35,75,110,290,195,485,0.000333,1.09632,34,111824.6217,6212.478982,3288.959461,646.686307,22,0
0,0,47,47,35,76,111,292,196,488,0.000333,1.105225,34,112732.9481,6262.941559,3315.674943,654.367397,22,0
0,0,46,46,35,75,110,290,195,485,0.000333,1.09632,34,111824.6217,6212.478982,3288.959461,646.686307,20,0
0,0,46,46,35,74,109,294,199,493,0.000333,1.112238,34,113448.3057,6302.683647,3336.714872,639.024455,18,0
0,0,34,34,32,66,98,235,161,396,0.000333,0.873142,32,83821.60315,4656.75573,2619.425098,558.930012,14,0
0,0,49,49,34,79,113,304,208,512,0.000333,1.163977,34,118725.6754,6595.870854,3491.931629,670.972416,21,0
0,0,49,49,34,79,113,304,208,512,0.000333,1.163977,34,118725.6754,6595.870854,3491.931629,670.972416,21,0
0,0,3,3,12,17,29,25,24,49,0.000333,0.079347,6,1428.246413,79.347023,238.041069,112.506418,2,0
0,0,53,53,25,59,84,267,208,475,0.000333,1.012117,36,109308.6279,6072.701552,3036.350776,463.172345,21,0
0,0,53,53,25,59,84,267,208,475,0.000333,1.012117,36,109308.6279,6072.701552,3036.350776,463.172345,21,0
0,0,51,51,25,54,79,255,198,453,0.000333,0.951871,36,102802.0564,5711.225358,2855.612679,426.86033,19,0
0,0,31,31,22,47,69,178,131,309,0.000333,0.629178,22,41525.74926,2306.98607,1887.534057,359.173172,15,0
0,0,16,16,17,37,54,116,84,200,0.000333,0.383659,16,18415.64001,1023.091111,1150.9775,262.236643,11,0
0,0,12,12,17,35,52,96,69,165,0.000333,0.313524,8,7524.580428,418.032246,940.572553,249.011774,11,0
0,0,29,29,25,52,77,214,142,356,0.000333,0.743659,24,53543.4242,2974.634678,2230.976008,412.51927,15,0
0,0,28,28,25,52,77,202,137,339,0.000333,0.708147,24,50986.5753,2832.587516,2124.440637,412.51927,16,0
0,0,28,28,25,53,78,202,137,339,0.000333,0.71025,24,51138.03245,2841.001803,2130.751352,419.676189,16,0
0,0,37,37,27,59,86,264,173,437,0.000333,0.936093,26,73015.22014,4056.401119,2808.277698,475.457902,21,0
0,0,27,27,25,52,77,198,135,333,0.000333,0.695613,24,50084.15803,2782.453224,2086.839918,412.51927,15,0
0,0,31,31,27,56,83,237,154,391,0.000333,0.83088,26,64808.65086,3600.480603,2492.640418,453.593838,20,0
0,0,14,14,18,39,57,101,79,180,0.000333,0.349973,18,18898.56365,1049.920203,1049.920203,281.189337,9,0
0,0,28,28,26,54,80,215,140,355,0.000333,0.748095,26,58351.39632,3241.74424,2244.284474,432.975358,17,0
0,0,8,8,19,30,49,72,53,125,0.000333,0.233946,9,6316.548575,350.919365,701.838731,227.917341,11,0
0,0,39,39,26,55,81,295,177,472,0.000333,0.99747,39,116703.9589,6483.55327,2992.409201,440.186217,19,0
0,0,14,14,18,33,51,116,74,190,0.000333,0.359254,18,19399.69467,1077.760815,1077.760815,241.523656,14,0
0,0,3,3,13,20,33,30,25,55,0.000333,0.092481,6,1664.650059,92.480559,277.441677,134.544278,2,0
0,0,21,21,20,43,63,141,100,241,0.000333,0.480175,20,28810.48923,1600.582735,1440.524462,319.767946,12,0
0,0,78,78,29,56,85,410,317,727,0.000333,1.553209,70,326173.9047,18120.77249,4659.627211,466.093324,18,0
0,0,66,66,27,49,76,358,270,628,0.000333,1.307899,65,255040.4011,14168.91117,3923.698478,403.502745,18,0
0,0,66,66,27,49,76,358,270,628,0.000333,1.307899,65,255040.4011,14168.91117,3923.698478,403.502745,18,0
0,0,64,64,27,49,76,352,260,612,0.000333,1.274577,65,248542.5565,13807.91981,3823.731638,403.502745,18,0
0,0,64,64,27,49,76,352,260,612,0.000333,1.274577,65,248542.5565,13807.91981,3823.731638,403.502745,18,0
0,0,62,62,27,49,76,340,248,588,0.000333,1.224594,65,238795.7896,13266.43275,3673.781378,403.502745,18,0
0,0,62,62,27,49,76,340,248,588,0.000333,1.224594,65,238795.7896,13266.43275,3673.781378,403.502745,18,0
0,0,59,59,27,48,75,326,232,558,0.000333,1.15856,52,180735.4031,10040.85573,3475.680829,396.460163,18,0
0,0,55,55,27,48,75,299,212,511,0.000333,1.060975,52,165512.1702,9195.120569,3182.926351,396.460163,18,0
0,0,55,55,27,48,75,299,212,511,0.000333,1.060975,52,165512.1702,9195.120569,3182.926351,396.460163,18,0
0,0,55,55,27,48,75,299,212,511,0.000333,1.060975,52,165512.1702,9195.120569,3182.926351,396.460163,18,0
0,0,37,37,25,45,70,161,138,299,0.000333,0.610885,36,65975.60239,3665.311244,1832.655622,363.229794,16,0
0,0,40,40,28,46,74,170,151,321,0.000333,0.664412,42,83715.85028,4650.880571,1993.23453,388.689788,15,0
0,0,40,40,28,46,74,170,151,321,0.000333,0.664412,42,83715.85028,4650.880571,1993.23453,388.689788,15,0
0,0,6,6,13,20,33,36,35,71,0.000333,0.119384,6,2148.911895,119.383994,358.151982,134.544278,4,0
0,0,7,7,13,18,31,33,28,61,0.000333,0.100735,6,1813.23585,100.735325,302.205975,123.164366,4,0
0,0,16,16,18,45,63,101,89,190,0.000333,0.378561,9,10221.14867,567.841593,1135.683185,322.192039,4,0
0,0,11,11,12,35,47,54,54,108,0.000333,0.199965,6,3599.373576,199.965199,599.895596,222.544456,3,0
0,0,17,17,19,46,65,97,97,194,0.000333,0.389446,18,21030.1084,1168.339356,1168.339356,334.794473,7,0
0,0,15,15,19,45,64,92,92,184,0.000333,0.368,18,19872,1104,1104,327.844012,7,0
0,0,15,15,19,45,64,92,92,184,0.000333,0.368,18,19872,1104,1104,327.844012,7,0
0,0,13,13,19,42,61,86,84,170,0.000333,0.336075,18,18148.05625,1008.225347,1008.225347,307.187955,7,0
0,0,13,13,19,42,61,86,84,170,0.000333,0.336075,18,18148.05625,1008.225347,1008.225347,307.187955,7,0
0,0,5,5,15,20,35,39,34,73,0.000333,0.124813,7,2621.063622,145.614646,374.43766,145.041921,5,0
0,0,5,5,15,21,36,39,34,73,0.000333,0.125802,7,2641.831676,146.768426,377.404525,150.842025,5,0
0,0,15,15,17,31,48,85,57,142,0.000333,0.264355,8,6344.517401,352.473189,793.064675,223.066954,8,0
0,0,15,15,18,28,46,81,58,139,0.000333,0.255925,18,13819.95201,767.775112,767.775112,209.664588,8,0
0,0,16,16,17,32,49,91,62,153,0.000333,0.28635,8,6872.404849,381.800269,859.050606,229.486868,8,0
0,0,23,23,20,38,58,125,83,208,0.000333,0.406153,20,24369.20094,1353.844497,1218.460047,285.859807,13,0
0,0,23,23,20,38,58,125,83,208,0.000333,0.406153,20,24369.20094,1353.844497,1218.460047,285.859807,13,0
0,0,13,13,14,30,44,74,50,124,0.000333,0.225657,7,4738.786645,263.265925,676.969521,200.509687,7,0
0,0,24,24,19,40,59,136,90,226,0.000333,0.443159,18,23930.59193,1329.477329,1329.477329,293.587747,14,0
0,0,88,88,26,75,101,500,376,876,0.000333,1.944198,65,379118.5618,21062.14232,5832.593259,589.372834,16,0
0,0,86,86,25,75,100,484,369,853,0.000333,1.88907,48,272026.0478,15112.55821,5667.20933,583.257807,14,0
0,0,61,61,18,62,80,513,344,857,0.000333,1.805964,45,243805.157,13544.73094,5417.892377,444.218821,12,0
0,0,88,88,26,75,101,500,376,876,0.000333,1.944198,65,379118.5618,21062.14232,5832.593259,589.372834,16,0
0,0,86,86,25,75,100,484,369,853,0.000333,1.88907,48,272026.0478,15112.55821,5667.20933,583.257807,14,0
0,0,89,89,26,78,104,513,385,898,0.000333,2.005665,52,312883.7331,17382.42962,6016.994867,612.472806,16,0
0,0,89,89,26,78,104,513,385,898,0.000333,2.005665,52,312883.7331,17382.42962,6016.994867,612.472806,16,0
0,0,87,87,26,75,101,495,374,869,0.000333,1.928662,52,300871.2605,16715.07003,5785.985779,589.372834,15,0
0,0,86,86,26,75,101,490,372,862,0.000333,1.913126,52,298447.6715,16580.4262,5739.378298,589.372834,14,0
0,0,91,91,25,84,109,518,395,913,0.000333,2.059784,48,296608.9098,16478.27277,6179.352289,653.051068,14,0
0,0,91,91,25,84,109,518,395,913,0.000333,2.059784,48,296608.9098,16478.27277,6179.352289,653.051068,14,0
0,0,85,85,25,75,100,479,367,846,0.000333,1.873567,48,269793.7122,14988.53956,5620.702337,583.257807,13,0
0,0,62,62,18,61,79,517,347,864,0.000333,1.815489,45,245090.9955,13616.16642,5446.466566,436.833628,12,0
0,0,89,89,26,78,104,513,385,898,0.000333,2.005665,52,312883.7331,17382.42962,6016.994867,612.472806,16,0
0,0,89,89,26,78,104,513,385,898,0.000333,2.005665,52,312883.7331,17382.42962,6016.994867,612.472806,16,0
0,0,87,87,26,75,101,495,374,869,0.000333,1.928662,52,300871.2605,16715.07003,5785.985779,589.372834,15,0
0,0,91,91,25,84,109,518,395,913,0.000333,2.059784,48,296608.9098,16478.27277,6179.352289,653.051068,14,0
0,0,91,91,25,84,109,518,395,913,0.000333,2.059784,48,296608.9098,16478.27277,6179.352289,653.051068,14,0
0,0,93,93,25,88,113,553,420,973,0.000333,2.212011,48,318529.6383,17696.09101,6636.03413,684.526387,13,0
0,0,89,89,26,78,104,513,385,898,0.000333,2.005665,52,312883.7331,17382.42962,6016.994867,612.472806,16,0
0,0,89,89,26,78,104,513,385,898,0.000333,2.005665,52,312883.7331,17382.42962,6016.994867,612.472806,16,0
0,0,91,91,25,84,109,518,395,913,0.000333,2.059784,48,296608.9098,16478.27277,6179.352289,653.051068,14,0
0,0,91,91,25,84,109,518,395,913,0.000333,2.059784,48,296608.9098,16478.27277,6179.352289,653.051068,14,0
0,0,87,87,25,77,102,492,375,867,0.000333,1.928331,48,277679.653,15426.64739,5784.992771,598.638968,13,0
0,0,85,85,25,76,101,479,368,847,0.000333,1.879835,48,270696.246,15038.68034,5639.505126,590.938896,11,0
0,0,85,85,25,76,101,479,368,847,0.000333,1.879835,48,270696.246,15038.68034,5639.505126,590.938896,11,0
0,0,89,89,26,78,104,513,385,898,0.000333,2.005665,52,312883.7331,17382.42962,6016.994867,612.472806,16,0
0,0,89,89,26,78,104,513,385,898,0.000333,2.005665,52,312883.7331,17382.42962,6016.994867,612.472806,16,0
0,0,91,91,25,84,109,518,395,913,0.000333,2.059784,48,296608.9098,16478.27277,6179.352289,653.051068,14,0
0,0,91,91,25,84,109,518,395,913,0.000333,2.059784,48,296608.9098,16478.27277,6179.352289,653.051068,14,0
0,0,85,85,25,76,101,479,368,847,0.000333,1.879835,48,270696.246,15038.68034,5639.505126,590.938896,11,0
0,0,85,85,25,76,101,479,368,847,0.000333,1.879835,48,270696.246,15038.68034,5639.505126,590.938896,11,0
0,0,19,19,20,36,56,91,75,166,0.000333,0.32134,20,19280.41834,1071.134352,964.020917,272.555862,4,0
0,0,10,10,20,29,49,99,53,152,0.000333,0.284479,10,8534.358963,474.131054,853.435896,227.320011,9,0
0,0,23,23,23,42,65,136,90,226,0.000333,0.453685,22,29943.21277,1663.51182,1361.055126,330.519257,11,0
0,0,7,7,18,19,37,54,28,82,0.000333,0.142392,9,3844.576584,213.587588,427.175176,155.769273,6,0
0,0,7,7,19,20,39,58,31,89,0.000333,0.1568,9,4233.607177,235.200399,470.400797,167.149185,5,0
0,0,23,23,26,39,65,153,85,238,0.000333,0.477775,26,37266.41203,2070.356224,1433.32354,328.342119,17,0
0,0,11,11,21,21,42,97,44,141,0.000333,0.253439,20,15206.33513,844.796396,760.316757,184.477332,12,0
0,0,36,36,26,43,69,226,140,366,0.000333,0.74524,39,87193.0781,4844.059894,2235.719951,355.540817,21,0
0,0,10,10,21,21,42,91,42,133,0.000333,0.239059,20,14343.56435,796.864686,717.178217,184.477332,11,0
0,0,9,9,19,21,40,77,38,115,0.000333,0.204007,9,5508.195578,306.010865,612.021731,172.949289,9,0
0,0,8,8,19,21,40,72,36,108,0.000333,0.191589,9,5172.914108,287.384117,574.768234,172.949289,8,0
0,0,7,7,19,20,39,66,34,100,0.000333,0.17618,9,4756.861997,264.270111,528.540222,167.149185,7,0
0,0,7,7,20,21,41,69,36,105,0.000333,0.187514,10,5625.429605,312.523867,562.54296,178.677228,6,0
0,0,12,12,20,34,54,78,66,144,0.000333,0.276235,10,8287.038003,460.391,828.7038,259.412299,6,0
0,0,13,13,21,40,61,88,75,163,0.000333,0.322237,10,9667.10186,537.061214,966.710186,305.11579,6,0
0,0,4,4,12,16,28,23,19,42,0.000333,0.067303,6,1211.45344,67.302969,201.908907,107.01955,1,0
0,0,4,4,16,17,33,38,28,66,0.000333,0.110977,8,2663.440095,147.968894,332.930012,133.486868,4,0
0,0,3,3,15,14,29,27,20,47,0.000333,0.076108,7,1598.275747,88.793097,228.325107,111.906328,3,0
0,0,35,35,21,57,78,180,152,332,0.000333,0.695585,20,41735.07073,2318.615041,2086.753537,424.713397,12,0
0,0,21,21,17,42,59,91,88,179,0.000333,0.350998,16,16847.88969,935.993872,1052.993106,295.9642,9,0
0,0,21,21,17,42,59,91,88,179,0.000333,0.350998,16,16847.88969,935.993872,1052.993106,295.9642,9,0
0,0,41,41,22,67,89,212,178,390,0.000333,0.841845,22,55561.79284,3086.766269,2525.536038,504.535471,14,0
0,0,37,37,21,59,80,188,158,346,0.000333,0.729129,20,43747.74242,2430.430134,2187.387121,439.314606,13,0
0,0,36,36,21,58,79,183,155,338,0.000333,0.710226,20,42613.55786,2367.419881,2130.677893,432.001564,12,0
0,0,31,31,20,50,70,161,135,296,0.000333,0.604756,20,36285.35546,2015.853081,1814.267773,368.631371,11,0
0,0,36,36,21,58,79,183,155,338,0.000333,0.710226,20,42613.55786,2367.419881,2130.677893,432.001564,12,0
0,0,31,31,20,51,71,131,123,254,0.000333,0.520679,20,31240.71537,1735.595298,1562.035768,375.732254,13,0
0,0,27,27,19,43,62,107,103,210,0.000333,0.416794,18,22506.86205,1250.381225,1250.381225,314.040007,12,0
0,0,26,26,19,42,61,102,100,202,0.000333,0.399336,18,21564.16096,1198.008942,1198.008942,307.187955,11,0
0,0,23,23,19,41,60,92,89,181,0.000333,0.356382,18,19244.64956,1069.147198,1069.147198,300.370255,10,0
0,0,9,9,14,21,35,41,31,72,0.000333,0.123103,7,2585.158641,143.619924,369.308377,145.541635,4,0
0,0,9,9,14,21,35,41,31,72,0.000333,0.123103,7,2585.158641,143.619924,369.308377,145.541635,4,0
0,0,36,36,21,58,79,183,155,338,0.000333,0.710226,20,42613.55786,2367.419881,2130.677893,432.001564,12,0
0,0,35,35,21,57,78,180,152,332,0.000333,0.695585,20,41735.07073,2318.615041,2086.753537,424.713397,12,0
0,0,32,32,20,54,74,167,142,309,0.000333,0.639574,20,38374.4218,2131.912322,1918.72109,397.202487,12,0
0,0,20,20,18,47,65,124,105,229,0.000333,0.459707,18,24824.20013,1379.122229,1379.122229,336.124326,6,0
0,0,28,28,20,57,77,172,139,311,0.000333,0.649657,20,38979.41228,2165.522905,1948.970614,418.913293,8,0
0,0,28,28,20,57,77,172,139,311,0.000333,0.649657,20,38979.41228,2165.522905,1948.970614,418.913293,8,0
0,0,28,28,20,57,77,172,139,311,0.000333,0.649657,20,38979.41228,2165.522905,1948.970614,418.913293,8,0
0,0,28,28,20,57,77,172,139,311,0.000333,0.649657,20,38979.41228,2165.522905,1948.970614,418.913293,8,0
0,0,28,28,20,57,77,172,139,311,0.000333,0.649657,20,38979.41228,2165.522905,1948.970614,418.913293,8,0
0,0,28,28,20,57,77,172,139,311,0.000333,0.649657,20,38979.41228,2165.522905,1948.970614,418.913293,8,0
0,0,28,28,20,57,77,172,139,311,0.000333,0.649657,20,38979.41228,2165.522905,1948.970614,418.913293,8,0
0,0,28,28,20,57,77,172,139,311,0.000333,0.649657,20,38979.41228,2165.522905,1948.970614,418.913293,8,0
0,0,10,10,17,27,44,63,50,113,0.000333,0.205639,8,4935.326183,274.184788,616.915773,197.868831,10,0
0,0,10,10,17,27,44,63,50,113,0.000333,0.205639,8,4935.326183,274.184788,616.915773,197.868831,10,0
0,0,37,37,22,40,62,174,131,305,0.000333,0.605343,33,59928.98586,3329.388104,1816.029875,310.984619,11,0
0,0,36,36,22,40,62,172,128,300,0.000333,0.59542,33,58946.54347,3274.807971,1786.258893,310.984619,11,0
0,0,27,27,18,32,50,108,83,191,0.000333,0.359326,18,19403.57758,1077.976532,1077.976532,235.05865,5,0
0,0,32,32,19,35,54,136,102,238,0.000333,0.456554,18,24653.93806,1369.663226,1369.663226,260.235528,7,0
0,0,37,37,21,40,61,177,132,309,0.000333,0.610866,30,54977.93512,3054.329729,1832.597837,305.11579,10,0
0,0,37,37,21,40,61,177,132,309,0.000333,0.610866,30,54977.93512,3054.329729,1832.597837,305.11579,10,0
0,0,41,41,22,40,62,190,142,332,0.000333,0.658931,33,65234.17478,3624.120821,1976.793175,310.984619,12,0
0,0,40,40,22,40,62,186,139,325,0.000333,0.645038,33,63858.75543,3547.708635,1935.113801,310.984619,12,0
0,0,39,39,22,39,61,185,139,324,0.000333,0.64052,33,63411.44361,3522.857979,1921.558897,304.238182,12,0
0,0,32,32,19,36,55,131,99,230,0.000333,0.443238,18,23934.82921,1329.712734,1329.712734,266.827923,7,0
0,0,27,27,18,32,50,108,83,191,0.000333,0.359326,18,19403.57758,1077.976532,1077.976532,235.05865,5,0
0,0,29,29,23,54,77,201,126,327,0.000333,0.68308,22,45083.26237,2504.625687,2049.239199,414.80585,25,0
0,0,33,33,25,58,83,235,147,382,0.000333,0.811755,24,58446.36151,3247.020084,2435.265063,455.859302,26,0
0,0,76,76,30,75,105,502,397,899,0.000333,2.012036,75,452708.004,25150.44467,6036.10672,614.36812,67,0
0,0,23,23,18,39,57,95,78,173,0.000333,0.336363,18,18163.6195,1009.089972,1009.089972,281.189337,9,0
0,0,22,22,19,33,52,83,66,149,0.000333,0.283122,18,15288.57932,849.365518,849.365518,247.175629,9,0
0,0,17,17,17,32,49,66,56,122,0.000333,0.228332,8,5479.956808,304.442045,684.994601,229.486868,6,0
0,0,18,18,18,33,51,72,61,133,0.000333,0.251478,9,6789.893134,377.216285,754.43257,241.523656,7,0
0,0,22,22,19,42,61,124,99,223,0.000333,0.440851,18,23805.97967,1322.554426,1322.554426,307.187955,8,0
0,0,17,17,18,35,53,71,58,129,0.000333,0.246301,9,6650.115648,369.450869,738.901739,254.583556,7,0
0,0,14,14,18,28,46,57,51,108,0.000333,0.198848,9,5368.902221,298.272346,596.544691,209.664588,5,0
1,0,21,22,14,41,55,105,79,184,0.000333,0.35459,7,7446.391311,413.688406,1063.770187,272.962601,14,0
1,0,21,22,15,41,56,111,81,192,0.000333,0.371671,7,7805.085015,433.615834,1115.012145,278.262991,14,0
1,0,8,9,13,27,40,49,39,88,0.000333,0.15611,6,2809.978034,156.109891,468.329672,176.487679,6,0
0,0,56,56,34,82,116,428,262,690,0.000333,1.577336,51,241332.3512,13407.35285,4732.006887,694.293001,25,0
0,0,59,59,34,86,120,455,280,735,0.000333,1.692188,51,258904.794,14383.59967,5076.564588,725.632506,25,0
0,0,70,70,35,96,131,542,334,876,0.000333,2.05376,51,314225.206,17456.95589,6161.278549,811.681306,26,0
0,0,68,68,35,93,128,524,331,855,0.000333,1.995,51,305235,16957.5,5985,787.666675,25,0
0,0,15,15,20,33,53,113,58,171,0.000333,0.326491,10,9794.743977,544.152443,979.474398,252.903568,10,0
0,0,29,29,27,57,84,259,173,432,0.000333,0.920494,39,107697.7639,5983.209108,2761.481127,460.856693,11,0
0,0,47,47,32,74,106,349,209,558,0.000333,1.251393,32,120133.7476,6674.097091,3754.179614,619.499549,22,0
0,0,56,56,34,82,116,428,262,690,0.000333,1.577336,51,241332.3512,13407.35285,4732.006887,694.293001,25,0
0,0,50,50,33,79,112,376,227,603,0.000333,1.368278,32,131354.7206,7297.484476,4104.835018,664.463685,22,0
0,0,59,59,34,86,120,455,280,735,0.000333,1.692188,51,258904.794,14383.59967,5076.564588,725.632506,25,0
0,0,61,61,33,90,123,463,281,744,0.000333,1.721744,48,247931.078,13773.94878,5165.230792,750.731785,23,0
0,0,70,70,35,96,131,542,334,876,0.000333,2.05376,51,314225.206,17456.95589,6161.278549,811.681306,26,0
0,0,59,59,34,87,121,445,278,723,0.000333,1.667446,51,255119.2441,14173.29134,5002.338121,733.509821,22,0
0,0,68,68,35,93,128,524,331,855,0.000333,1.995,51,305235,16957.5,5985,787.666675,25,0
0,0,12,12,17,33,50,78,51,129,0.000333,0.242686,8,5824.459588,323.581088,728.057448,235.951874,6,0
0,0,18,18,19,27,46,79,66,145,0.000333,0.266972,18,14416.49671,800.916484,800.916484,209.092585,8,0
0,0,12,12,17,25,42,52,46,98,0.000333,0.176149,8,4227.576859,234.865381,528.447107,185.583273,6,0
0,0,18,18,19,33,52,99,95,194,0.000333,0.368628,18,19905.9355,1105.885305,1105.885305,247.175629,5,0
0,0,10,10,15,24,39,42,42,84,0.000333,0.147991,7,3107.816505,172.656472,443.973786,168.642459,3,0
0,0,56,56,28,59,87,291,237,528,0.000333,1.133958,56,190504.9533,10583.60852,3401.874166,481.681878,17,0
0,0,35,35,24,47,71,195,165,360,0.000333,0.73797,36,79700.72267,4427.817926,2213.908963,371.104776,12,0
0,0,16,16,19,37,56,92,82,174,0.000333,0.336827,18,18188.63562,1010.479756,1010.479756,273.460397,6,0
0,0,17,17,17,33,50,97,69,166,0.000333,0.312293,16,14990.08204,832.782336,936.880128,235.951874,7,0
0,0,9,9,13,22,35,50,35,85,0.000333,0.14533,6,2615.934339,145.329685,435.989056,146.213212,4,0
0,0,19,19,17,37,54,99,71,170,0.000333,0.32611,8,7826.647003,434.813722,978.330875,262.236643,7,0
0,0,19,19,17,37,54,99,70,169,0.000333,0.324192,8,7780.607903,432.255995,972.575988,262.236643,7,0
0,0,18,18,16,34,50,93,65,158,0.000333,0.297243,8,7133.834224,396.324124,891.729278,236.973737,5,0
0,0,17,17,17,33,50,92,63,155,0.000333,0.291599,8,6998.381675,388.798982,874.797709,235.951874,7,0
0,0,15,15,15,26,41,76,49,125,0.000333,0.223231,7,4687.858004,260.436556,669.694001,180.814792,6,0
0,0,18,18,17,35,52,105,73,178,0.000333,0.338226,16,16234.85232,901.93624,1014.67827,249.011774,7,0
0,0,7,7,16,18,34,45,28,73,0.000333,0.123795,8,2971.078299,165.059906,371.384787,139.05865,4,0
0,0,9,9,14,22,36,43,34,77,0.000333,0.132695,7,2786.589576,154.810532,398.084225,151.410465,2,0
0,0,6,6,13,17,30,33,25,58,0.000333,0.094867,6,1707.597927,94.866552,284.599655,117.592585,2,0
0,0,90,90,28,92,120,379,329,708,0.000333,1.630026,42,205383.2988,11410.18326,4890.078542,734.773638,16,0
0,0,83,83,28,88,116,353,307,660,0.000333,1.508756,42,190103.2332,10561.29073,4526.267457,703.03592,16,0
0,0,83,83,28,88,116,353,307,660,0.000333,1.508756,42,190103.2332,10561.29073,4526.267457,703.03592,16,0
0,0,83,83,28,88,116,353,307,660,0.000333,1.508756,42,190103.2332,10561.29073,4526.267457,703.03592,16,0
0,0,83,83,28,88,116,353,307,660,0.000333,1.508756,42,190103.2332,10561.29073,4526.267457,703.03592,16,0
0,0,83,83,28,88,116,353,307,660,0.000333,1.508756,42,190103.2332,10561.29073,4526.267457,703.03592,16,0
0,0,83,83,28,88,116,353,307,660,0.000333,1.508756,42,190103.2332,10561.29073,4526.267457,703.03592,16,0
0,0,83,83,28,88,116,353,307,660,0.000333,1.508756,42,190103.2332,10561.29073,4526.267457,703.03592,16,0
0,0,83,83,28,88,116,353,307,660,0.000333,1.508756,42,190103.2332,10561.29073,4526.267457,703.03592,16,0
0,0,83,83,28,88,116,353,307,660,0.000333,1.508756,42,190103.2332,10561.29073,4526.267457,703.03592,16,0
0,0,83,83,28,88,116,353,307,660,0.000333,1.508756,42,190103.2332,10561.29073,4526.267457,703.03592,16,0
0,0,83,83,28,88,116,353,307,660,0.000333,1.508756,42,190103.2332,10561.29073,4526.267457,703.03592,16,0
0,0,83,83,28,88,116,353,307,660,0.000333,1.508756,42,190103.2332,10561.29073,4526.267457,703.03592,16,0
0,0,7,7,17,14,31,31,21,52,0.000333,0.085873,8,2060.945665,114.496981,257.618208,122.789837,4,0
0,0,7,7,17,14,31,31,21,52,0.000333,0.085873,8,2060.945665,114.496981,257.618208,122.789837,4,0
0,0,4,4,11,11,22,16,13,29,0.000333,0.043108,5,646.617585,35.923199,129.323517,76.107496,3,0
0,0,21,21,22,23,45,102,72,174,0.000333,0.318527,33,31534.22048,1751.901138,955.582439,202.149421,8,0
0,0,21,21,22,23,45,102,72,174,0.000333,0.318527,33,31534.22048,1751.901138,955.582439,202.149421,8,0
0,0,11,11,19,38,57,91,66,157,0.000333,0.305255,9,8241.87359,457.881866,915.763732,280.131868,2,0
0,0,11,11,18,32,50,66,51,117,0.000333,0.22011,9,5942.980568,330.165587,660.331174,235.05865,3,0
0,0,11,11,18,32,50,66,51,117,0.000333,0.22011,9,5942.980568,330.165587,660.331174,235.05865,3,0
0,0,10,10,19,34,53,60,47,107,0.000333,0.204296,9,5515.987398,306.443744,612.887489,253.684359,3,0
0,0,9,9,16,30,46,51,42,93,0.000333,0.17123,8,4109.530095,228.307228,513.691262,211.206718,3,0
1,0,21,22,14,41,55,105,79,184,0.000333,0.35459,7,7446.391311,413.688406,1063.770187,272.962601,14,0
1,0,21,22,15,41,56,111,81,192,0.000333,0.371671,7,7805.085015,433.615834,1115.012145,278.262991,14,0
1,0,8,9,13,27,40,49,39,88,0.000333,0.15611,6,2809.978034,156.109891,468.329672,176.487679,6,0
1,0,40,41,23,83,106,226,177,403,0.000333,0.903784,22,59649.74275,3313.874597,2711.351943,633.170198,21,0
1,0,23,24,21,49,70,124,95,219,0.000333,0.447438,10,13423.12981,745.729434,1342.312981,367.359448,13,0
1,0,42,43,24,84,108,240,187,427,0.000333,0.961446,24,69224.08712,3845.782618,2884.336963,646.993764,22,0
1,0,42,43,24,84,108,240,187,427,0.000333,0.961446,24,69224.08712,3845.782618,2884.336963,646.993764,22,0
1,0,42,43,24,84,108,240,187,427,0.000333,0.961446,24,69224.08712,3845.782618,2884.336963,646.993764,22,0
1,0,42,43,24,84,108,240,187,427,0.000333,0.961446,24,69224.08712,3845.782618,2884.336963,646.993764,22,0
0,0,7,7,18,23,41,46,32,78,0.000333,0.139296,9,3761.001507,208.944528,417.889056,179.100575,1,0
0,0,28,28,19,32,51,136,89,225,0.000333,0.425432,18,22973.32264,1276.295702,1276.295702,240.710623,9,0
0,0,27,27,19,32,51,126,80,206,0.000333,0.389507,18,21033.35317,1168.51962,1168.51962,240.710623,9,0
0,0,28,28,19,32,51,136,89,225,0.000333,0.425432,18,22973.32264,1276.295702,1276.295702,240.710623,9,0
0,0,24,24,19,32,51,106,73,179,0.000333,0.338455,18,18276.55445,1015.364136,1015.364136,240.710623,7,0
0,0,23,23,19,28,47,96,64,160,0.000333,0.296245,18,15997.21589,888.734216,888.734216,215.316561,7,0
0,0,30,30,19,31,50,141,94,235,0.000333,0.442102,27,35810.26752,1989.459307,1326.306205,234.290708,9,0
0,0,26,26,22,33,55,116,96,212,0.000333,0.408549,22,26964.2617,1498.014539,1225.648259,264.572502,11,0
0,0,24,24,21,32,53,109,90,199,0.000333,0.379952,20,22797.12341,1266.506856,1139.85617,252.238666,11,0
0,0,26,26,22,33,55,116,96,212,0.000333,0.408549,22,26964.2617,1498.014539,1225.648259,264.572502,11,0
0,0,20,20,21,28,49,85,74,159,0.000333,0.29758,20,17854.7773,991.932072,892.738865,226.844604,9,0
0,0,18,18,22,29,51,76,65,141,0.000333,0.266604,22,17595.86341,977.547967,799.811973,238.988944,8,0
0,0,15,15,21,28,49,65,57,122,0.000333,0.228332,20,13699.89202,761.105112,684.994601,226.844604,7,0
0,0,23,23,22,32,54,105,86,191,0.000333,0.366395,22,24182.03728,1343.446516,1099.183513,258.107496,11,0
0,0,15,15,21,26,47,60,54,114,0.000333,0.211074,20,12664.46258,703.581255,633.223129,214.450099,7,0
0,0,13,13,18,28,46,69,52,121,0.000333,0.222784,9,6015.15897,334.175498,668.350997,209.664588,5,0
0,0,13,13,18,28,46,69,52,121,0.000333,0.222784,9,6015.15897,334.175498,668.350997,209.664588,5,0
0,0,13,13,18,28,46,69,52,121,0.000333,0.222784,9,6015.15897,334.175498,668.350997,209.664588,5,0
1,0,3,4,12,43,55,85,45,130,0.000333,0.250526,6,4509.460577,250.525588,751.576763,276.348934,1,0
0,0,111,111,25,110,135,544,400,944,0.000333,2.226838,36,240498.5013,13361.02785,6680.513924,862.045973,48,0
0,0,109,109,25,109,134,535,396,931,0.000333,2.192843,36,236827.0453,13157.05807,6578.529036,853.828496,47,0
0,0,110,110,25,110,135,540,399,939,0.000333,2.215043,36,239224.6744,13290.25969,6645.129846,862.045973,47,0
0,0,110,110,25,110,135,540,399,939,0.000333,2.215043,36,239224.6744,13290.25969,6645.129846,862.045973,47,0
0,0,109,109,25,109,134,535,396,931,0.000333,2.192843,36,236827.0453,13157.05807,6578.529036,853.828496,47,0
0,0,111,111,25,110,135,545,402,947,0.000333,2.233915,36,241262.7973,13403.48874,6701.74437,862.045973,47,0
0,0,111,111,25,110,135,545,402,947,0.000333,2.233915,36,241262.7973,13403.48874,6701.74437,862.045973,47,0
0,0,111,111,25,110,135,545,402,947,0.000333,2.233915,36,241262.7973,13403.48874,6701.74437,862.045973,47,0
0,0,38,38,17,58,75,175,132,307,0.000333,0.637416,16,30595.95741,1699.775412,1912.247338,409.249766,10,0
0,0,38,38,17,58,75,175,132,307,0.000333,0.637416,16,30595.95741,1699.775412,1912.247338,409.249766,10,0
1,0,49,50,26,84,110,211,165,376,0.000333,0.84993,13,33147.28628,1841.515904,2549.791252,659.166096,28,0
1,0,47,48,26,83,109,209,161,370,0.000333,0.834743,13,32554.9666,1808.609256,2504.2282,651.339705,28,0
1,0,47,48,26,83,109,209,161,370,0.000333,0.834743,13,32554.9666,1808.609256,2504.2282,651.339705,28,0
1,0,47,48,26,83,109,209,161,370,0.000333,0.834743,13,32554.9666,1808.609256,2504.2282,651.339705,28,0
1,0,47,48,26,83,109,209,161,370,0.000333,0.834743,13,32554.9666,1808.609256,2504.2282,651.339705,28,0
1,0,18,19,14,36,50,66,51,117,0.000333,0.22011,7,4622.318219,256.795457,660.331174,239.420269,9,0
1,0,18,19,14,29,43,63,43,106,0.000333,0.191728,7,4026.288448,223.682692,575.184064,194.184418,12,0
1,0,12,13,14,27,41,72,60,132,0.000333,0.235732,14,9900.756105,550.042006,707.196865,181.684931,4,0
1,0,16,17,15,29,44,84,68,152,0.000333,0.276611,14,11617.67048,645.426138,829.833606,199.484808,4,0
1,0,6,7,12,18,30,24,29,53,0.000333,0.086688,6,1560.391209,86.688401,260.065202,118.0782,2,0
0,0,25,25,26,36,62,94,82,176,0.000333,0.349313,26,27246.40232,1513.689018,1047.938551,308.328733,10,0
0,0,21,21,24,34,58,76,69,145,0.000333,0.283136,24,20385.77386,1132.542992,849.407244,283.012837,7,0
0,0,20,20,23,33,56,70,65,135,0.000333,0.261331,11,8623.922059,479.106781,783.992914,270.506931,7,0
1,0,14,15,20,32,52,61,48,109,0.000333,0.207116,10,6213.479293,345.193294,621.347929,246.438562,5,0
1,0,13,14,20,32,52,62,50,112,0.000333,0.212816,10,6384.492484,354.694027,638.449248,246.438562,4,0
1,0,11,12,20,28,48,57,44,101,0.000333,0.188027,10,5640.812126,313.378451,564.081213,221.0445,4,0
1,0,14,15,20,32,52,61,48,109,0.000333,0.207116,10,6213.479293,345.193294,621.347929,246.438562,5,0
1,0,13,14,20,32,52,62,50,112,0.000333,0.212816,10,6384.492484,354.694027,638.449248,246.438562,4,0
1,0,12,13,20,28,48,56,42,98,0.000333,0.182442,10,5473.263251,304.070181,547.326325,221.0445,5,0
0,0,76,76,29,84,113,507,401,908,0.000333,2.064241,56,346792.4599,19266.24777,6192.722498,677.836112,29,0
0,0,76,76,29,84,113,507,401,908,0.000333,2.064241,56,346792.4599,19266.24777,6192.722498,677.836112,29,0
0,0,76,76,29,84,113,507,401,908,0.000333,2.064241,56,346792.4599,19266.24777,6192.722498,677.836112,29,0
0,0,13,13,13,36,49,66,60,126,0.000333,0.235818,6,4244.720642,235.817813,707.45344,234.223016,4,0
0,0,14,14,17,37,54,79,63,142,0.000333,0.272398,8,6537.552202,363.197345,817.194025,262.236643,7,0
0,0,53,53,26,83,109,355,283,638,0.000333,1.439367,39,168405.9624,9355.886798,4318.101599,651.339705,18,0
0,0,52,52,26,81,107,340,272,612,0.000333,1.375259,39,160905.334,8939.185224,4125.777796,635.739283,18,0
0,0,53,53,26,87,113,357,292,649,0.000333,1.475432,39,172625.5497,9590.308318,4426.296147,682.747517,18,0
0,0,29,29,21,52,73,164,125,289,0.000333,0.596286,20,35777.18595,1987.621442,1788.859298,388.661531,12,0
0,0,9,9,14,25,39,43,37,80,0.000333,0.140944,7,2959.825243,164.434736,422.832178,169.399374,5,0
0,0,8,8,11,24,35,33,33,66,0.000333,0.112844,5,1692.663396,94.036855,338.532679,148.092848,3,0
0,0,10,10,15,25,40,47,39,86,0.000333,0.152562,7,3203.800713,177.988929,457.685816,174.699764,6,0
1,0,10,11,22,25,47,53,38,91,0.000333,0.168489,11,5560.143441,308.896858,505.467586,214.2039,5,0
1,0,6,7,18,21,39,34,26,60,0.000333,0.105708,9,2854.117198,158.562067,317.124133,167.297316,3,0
0,0,50,50,19,78,97,236,172,408,0.000333,0.897588,18,48469.75991,2692.76444,2692.76444,570.971996,11,0
0,0,31,31,19,53,72,183,116,299,0.000333,0.614936,18,33206.53636,1844.807575,1844.807575,384.290407,8,0
0,0,30,30,19,52,71,180,115,295,0.000333,0.604725,18,32655.15721,1814.1754,1814.1754,377.133488,7,0
0,0,30,30,19,52,71,180,115,295,0.000333,0.604725,18,32655.15721,1814.1754,1814.1754,377.133488,7,0
0,0,32,32,19,54,73,210,134,344,0.000333,0.709767,18,38327.39367,2129.299648,2129.299648,391.474548,5,0
0,0,54,54,19,80,99,263,194,457,0.000333,1.009872,18,54533.08756,3029.615975,3029.615975,586.46487,15,0
0,0,39,39,20,59,79,215,149,364,0.000333,0.764859,20,45891.52385,2549.529103,2294.576192,433.514502,9,0
0,0,38,38,20,58,78,210,146,356,0.000333,0.745868,20,44752.0638,2486.225767,2237.60319,426.20146,8,0
0,0,38,38,20,58,78,210,146,356,0.000333,0.745868,20,44752.0638,2486.225767,2237.60319,426.20146,8,0
0,0,5,5,12,20,32,27,30,57,0.000333,0.095,6,1710,95,285,129.458112,2,0
0,0,9,9,9,18,27,32,29,61,0.000333,0.096683,4,1160.192551,64.455142,290.048138,103.587975,7,0
0,0,9,9,12,25,37,42,38,80,0.000333,0.138919,6,2500.537616,138.918756,416.756269,159.115955,6,0
0,0,10,10,13,27,40,52,46,98,0.000333,0.17385,6,3129.29372,173.849651,521.548953,176.487679,6,0
0,0,11,11,13,27,40,62,53,115,0.000333,0.204007,6,3672.130385,204.007244,612.021731,176.487679,6,0
0,0,9,9,12,26,38,47,42,89,0.000333,0.155689,6,2802.393292,155.688516,467.065549,165.230983,6,0
0,0,9,9,12,26,38,47,42,89,0.000333,0.155689,6,2802.393292,155.688516,467.065549,165.230983,6,0
0,0,8,8,9,18,27,29,27,56,0.000333,0.088758,4,1065.0948,59.171933,266.2737,103.587975,6,0
0,0,10,10,13,25,38,57,49,106,0.000333,0.185427,6,3337.681899,185.426772,556.280316,164.202121,5,0
0,0,8,8,12,25,37,44,40,84,0.000333,0.145865,6,2625.564496,145.864694,437.594083,159.115955,5,0
0,0,8,8,12,25,37,44,40,84,0.000333,0.145865,6,2625.564496,145.864694,437.594083,159.115955,5,0
0,0,7,7,12,16,28,31,28,59,0.000333,0.094545,6,1701.803642,94.544647,283.63394,107.01955,5,0
0,0,7,7,12,23,35,36,34,70,0.000333,0.119683,6,2154.298867,119.68327,359.049811,147.061475,4,0
0,0,7,7,12,25,37,41,38,79,0.000333,0.137182,6,2469.280895,137.182272,411.546816,159.115955,4,0
0,0,7,7,12,24,36,41,38,79,0.000333,0.136141,6,2450.544451,136.141358,408.424075,153.05865,4,0
0,0,7,7,12,24,36,41,38,79,0.000333,0.136141,6,2450.544451,136.141358,408.424075,153.05865,4,0
0,0,6,6,12,16,28,28,26,54,0.000333,0.086532,6,1557.582995,86.532389,259.597166,107.01955,4,0
0,0,6,6,12,24,36,38,36,74,0.000333,0.127525,6,2295.446701,127.524817,382.57445,153.05865,3,0
0,0,6,6,12,23,35,38,36,74,0.000333,0.126522,6,2277.40166,126.522314,379.566943,147.061475,3,0
0,0,3,3,11,21,32,27,27,54,0.000333,0.09,5,1350,75,270,130.292414,1,0
0,0,30,30,17,28,45,116,96,212,0.000333,0.388091,24,27942.54855,1552.363809,1164.272856,204.092806,8,0
0,0,43,43,17,30,47,167,137,304,0.000333,0.562865,32,54035.04035,3001.946686,1688.595011,216.693586,8,0
0,0,60,60,25,89,114,290,228,518,0.000333,1.179812,24,84946.48866,4719.24937,3539.437027,692.43668,17,0
0,0,44,44,26,64,90,205,167,372,0.000333,0.80499,26,62789.20315,3488.289064,2414.969352,506.211433,11,0
0,0,44,44,26,64,90,205,167,372,0.000333,0.80499,26,62789.20315,3488.289064,2414.969352,506.211433,11,0
0,0,42,42,24,64,88,195,159,354,0.000333,0.762213,24,54879.33103,3048.851724,2286.638793,494.0391,10,0
0,0,40,40,24,63,87,188,155,343,0.000333,0.736643,24,53038.31086,2946.572825,2209.929619,486.607735,10,0
0,0,41,41,19,58,77,173,139,312,0.000333,0.651746,18,35194.27321,1955.237401,1955.237401,420.47352,10,0
0,0,41,41,19,58,77,173,139,312,0.000333,0.651746,18,35194.27321,1955.237401,1955.237401,420.47352,10,0
0,0,38,38,19,57,76,164,132,296,0.000333,0.616462,18,33288.95779,1849.386544,1849.386544,413.185354,9,0
0,0,36,36,19,56,75,157,128,285,0.000333,0.591738,18,31953.83988,1775.213327,1775.213327,405.922498,9,0
0,0,13,13,19,34,53,93,81,174,0.000333,0.332219,18,17939.84686,996.658159,996.658159,253.684359,6,0
0,0,20,20,20,44,64,135,117,252,0.000333,0.504,20,30240,1680,1512,326.653553,7,0
0,0,12,12,16,26,42,67,51,118,0.000333,0.212098,8,5090.347647,282.797092,636.293456,186.211433,8,0
0,0,12,12,16,26,42,67,51,118,0.000333,0.212098,8,5090.347647,282.797092,636.293456,186.211433,8,0
0,0,10,10,16,23,39,56,42,98,0.000333,0.172656,8,4143.75534,230.20863,517.969417,168.041925,8,0
0,0,10,10,16,22,38,53,41,94,0.000333,0.164435,8,3946.44149,219.246749,493.305186,162.107496,6,0
0,0,9,9,16,22,38,48,37,85,0.000333,0.148691,8,3568.590709,198.255039,446.073839,162.107496,6,0
0,0,11,11,16,23,39,61,46,107,0.000333,0.188513,16,9048.608599,502.700478,565.538037,168.041925,8,0
0,0,8,8,15,23,38,42,34,76,0.000333,0.132947,7,2791.897437,155.105413,398.842491,162.645284,4,0
0,0,75,75,31,89,120,406,243,649,0.000333,1.494191,30,134477.1599,7470.953328,4482.571997,729.920361,49,0
0,0,76,76,31,90,121,417,248,665,0.000333,1.533681,30,138031.3216,7668.406755,4601.044053,737.846864,50,0
0,0,74,74,31,88,119,403,241,644,0.000333,1.480088,30,133207.8792,7400.437733,4440.26264,722.010068,49,0
0,0,59,59,28,84,112,334,203,537,0.000333,1.218517,28,102355.3886,5686.410478,3655.549593,671.560601,40,0
0,0,57,57,28,76,104,315,188,503,0.000333,1.12344,28,94368.99299,5242.721833,3370.321178,609.448429,40,0
0,0,68,68,26,87,113,336,211,547,0.000333,1.243546,26,96996.5852,5388.699178,3730.637892,682.747517,46,0
0,0,51,51,25,67,92,256,162,418,0.000333,0.90895,24,65444.37354,3635.79853,2726.848898,522.524381,35,0
0,0,41,41,25,57,82,218,137,355,0.000333,0.75231,24,54166.34308,3009.241282,2256.930962,448.571136,29,0
0,0,27,27,23,37,60,139,78,217,0.000333,0.427265,22,28199.4957,1566.63865,1281.795259,296.7917,18,0
0,0,27,27,21,38,59,131,76,207,0.000333,0.405902,20,24354.14222,1353.007901,1217.707111,291.659911,18,0
0,0,25,25,20,35,55,117,68,185,0.000333,0.356517,10,10695.51547,594.195304,1069.551547,265.963467,18,0
0,0,10,10,15,17,32,48,29,77,0.000333,0.128333,7,2695,149.722222,385,128.090227,7,0
0,0,54,54,26,82,108,303,176,479,0.000333,1.07853,26,84125.36895,4673.631608,3235.591114,643.530697,38,0
0,0,47,47,25,62,87,258,154,412,0.000333,0.884831,24,63707.82529,3539.323627,2654.49272,485.256576,34,0
0,0,35,35,24,45,69,196,102,298,0.000333,0.60678,24,43688.16692,2427.120384,1820.340288,357.172489,24,0
0,0,19,19,19,26,45,119,57,176,0.000333,0.322189,18,17398.19061,966.566145,966.566145,202.922055,14,0
0,0,75,75,31,89,120,406,243,649,0.000333,1.494191,30,134477.1599,7470.953328,4482.571997,729.920361,49,0
0,0,76,76,31,90,121,417,248,665,0.000333,1.533681,30,138031.3216,7668.406755,4601.044053,737.846864,50,0
0,0,74,74,31,88,119,403,241,644,0.000333,1.480088,30,133207.8792,7400.437733,4440.26264,722.010068,49,0
0,0,59,59,28,84,112,334,203,537,0.000333,1.218517,28,102355.3886,5686.410478,3655.549593,671.560601,40,0
0,0,57,57,28,76,104,315,188,503,0.000333,1.12344,28,94368.99299,5242.721833,3370.321178,609.448429,40,0
0,0,68,68,26,87,113,336,211,547,0.000333,1.243546,26,96996.5852,5388.699178,3730.637892,682.747517,46,0
0,0,51,51,25,67,92,256,162,418,0.000333,0.90895,24,65444.37354,3635.79853,2726.848898,522.524381,35,0
0,0,41,41,25,57,82,218,137,355,0.000333,0.75231,24,54166.34308,3009.241282,2256.930962,448.571136,29,0
0,0,27,27,23,37,60,139,78,217,0.000333,0.427265,22,28199.4957,1566.63865,1281.795259,296.7917,18,0
0,0,27,27,21,38,59,131,76,207,0.000333,0.405902,20,24354.14222,1353.007901,1217.707111,291.659911,18,0
0,0,25,25,20,35,55,117,68,185,0.000333,0.356517,10,10695.51547,594.195304,1069.551547,265.963467,18,0
0,0,10,10,15,17,32,48,29,77,0.000333,0.128333,7,2695,149.722222,385,128.090227,7,0
0,0,76,76,31,91,122,416,247,663,0.000333,1.531693,30,137852.3656,7658.464758,4595.078855,745.789398,50,0
0,0,47,47,25,62,87,258,154,412,0.000333,0.884831,24,63707.82529,3539.323627,2654.49272,485.256576,34,0
0,0,35,35,24,45,69,196,102,298,0.000333,0.60678,24,43688.16692,2427.120384,1820.340288,357.172489,24,0
0,0,19,19,19,26,45,119,57,176,0.000333,0.322189,18,17398.19061,966.566145,966.566145,202.922055,14,0
0,0,65,65,29,92,121,372,228,600,0.000333,1.383773,28,116236.9024,6457.605688,4151.317942,741.049149,43,0
0,0,56,56,29,79,108,307,182,489,0.000333,1.101047,28,92487.91968,5138.21776,3303.139989,638.880128,35,0
0,0,70,70,30,82,112,385,223,608,0.000333,1.379624,30,124166.1538,6898.119654,4138.871793,668.525982,45,0
0,0,62,62,28,79,107,351,208,559,0.000333,1.25616,28,105517.4413,5862.080071,3768.480045,632.604617,41,0
0,0,48,48,26,73,99,264,153,417,0.000333,0.921481,26,71875.48448,3993.082471,2764.441711,574.068625,34,0
0,0,70,70,30,82,112,386,224,610,0.000333,1.384162,30,124574.5951,6920.810837,4152.486502,668.525982,45,0
0,0,45,45,26,71,97,250,145,395,0.000333,0.868989,26,67781.10489,3765.616938,2606.965573,558.843478,33,0
0,0,53,53,26,76,102,268,174,442,0.000333,0.983071,26,76679.51203,4259.972891,2949.212001,597.053924,36,0
0,0,51,51,25,67,92,256,162,418,0.000333,0.90895,24,65444.37354,3635.79853,2726.848898,522.524381,35,0
0,0,75,75,31,89,120,406,243,649,0.000333,1.494191,30,134477.1599,7470.953328,4482.571997,729.920361,49,0
0,0,76,76,31,90,121,417,248,665,0.000333,1.533681,30,138031.3216,7668.406755,4601.044053,737.846864,50,0
0,0,74,74,31,88,119,403,241,644,0.000333,1.480088,30,133207.8792,7400.437733,4440.26264,722.010068,49,0
0,0,59,59,28,84,112,334,203,537,0.000333,1.218517,28,102355.3886,5686.410478,3655.549593,671.560601,40,0
0,0,57,57,28,76,104,315,188,503,0.000333,1.12344,28,94368.99299,5242.721833,3370.321178,609.448429,40,0
0,0,68,68,26,87,113,336,211,547,0.000333,1.243546,26,96996.5852,5388.699178,3730.637892,682.747517,46,0
0,0,51,51,25,67,92,256,162,418,0.000333,0.90895,24,65444.37354,3635.79853,2726.848898,522.524381,35,0
0,0,41,41,25,57,82,218,137,355,0.000333,0.75231,24,54166.34308,3009.241282,2256.930962,448.571136,29,0
0,0,27,27,23,37,60,139,78,217,0.000333,0.427265,22,28199.4957,1566.63865,1281.795259,296.7917,18,0
0,0,27,27,21,38,59,131,76,207,0.000333,0.405902,20,24354.14222,1353.007901,1217.707111,291.659911,18,0
0,0,25,25,20,35,55,117,68,185,0.000333,0.356517,10,10695.51547,594.195304,1069.551547,265.963467,18,0
0,0,10,10,15,17,32,48,29,77,0.000333,0.128333,7,2695,149.722222,385,128.090227,7,0
0,0,76,76,31,91,122,416,247,663,0.000333,1.531693,30,137852.3656,7658.464758,4595.078855,745.789398,50,0
0,0,54,54,26,82,108,303,176,479,0.000333,1.07853,26,84125.36895,4673.631608,3235.591114,643.530697,38,0
0,0,35,35,24,45,69,196,102,298,0.000333,0.60678,24,43688.16692,2427.120384,1820.340288,357.172489,24,0
0,0,19,19,19,26,45,119,57,176,0.000333,0.322189,18,17398.19061,966.566145,966.566145,202.922055,14,0
0,0,75,75,31,89,120,406,243,649,0.000333,1.494191,30,134477.1599,7470.953328,4482.571997,729.920361,49,0
0,0,76,76,31,90,121,417,248,665,0.000333,1.533681,30,138031.3216,7668.406755,4601.044053,737.846864,50,0
0,0,74,74,31,88,119,403,241,644,0.000333,1.480088,30,133207.8792,7400.437733,4440.26264,722.010068,49,0
0,0,59,59,28,84,112,334,203,537,0.000333,1.218517,28,102355.3886,5686.410478,3655.549593,671.560601,40,0
0,0,57,57,28,76,104,315,188,503,0.000333,1.12344,28,94368.99299,5242.721833,3370.321178,609.448429,40,0
0,0,68,68,26,87,113,336,211,547,0.000333,1.243546,26,96996.5852,5388.699178,3730.637892,682.747517,46,0
0,0,51,51,25,67,92,256,162,418,0.000333,0.90895,24,65444.37354,3635.79853,2726.848898,522.524381,35,0
0,0,41,41,25,57,82,218,137,355,0.000333,0.75231,24,54166.34308,3009.241282,2256.930962,448.571136,29,0
0,0,27,27,23,37,60,139,78,217,0.000333,0.427265,22,28199.4957,1566.63865,1281.795259,296.7917,18,0
0,0,27,27,21,38,59,131,76,207,0.000333,0.405902,20,24354.14222,1353.007901,1217.707111,291.659911,18,0
0,0,25,25,20,35,55,117,68,185,0.000333,0.356517,10,10695.51547,594.195304,1069.551547,265.963467,18,0
0,0,10,10,15,17,32,48,29,77,0.000333,0.128333,7,2695,149.722222,385,128.090227,7,0
0,0,76,76,31,91,122,416,247,663,0.000333,1.531693,30,137852.3656,7658.464758,4595.078855,745.789398,50,0
0,0,54,54,26,82,108,303,176,479,0.000333,1.07853,26,84125.36895,4673.631608,3235.591114,643.530697,38,0
0,0,47,47,25,62,87,258,154,412,0.000333,0.884831,24,63707.82529,3539.323627,2654.49272,485.256576,34,0
0,0,19,19,19,26,45,119,57,176,0.000333,0.322189,18,17398.19061,966.566145,966.566145,202.922055,14,0
0,0,40,40,21,52,73,201,126,327,0.000333,0.674691,20,40481.45262,2248.96959,2024.072631,388.661531,32,0
0,0,27,27,20,39,59,131,77,208,0.000333,0.407863,10,12235.89754,679.772086,1223.589754,292.569248,20,0
0,0,25,25,23,39,62,133,76,209,0.000333,0.414809,11,13688.69732,760.483184,1244.427029,310.172612,17,0
0,0,27,27,23,37,60,139,78,217,0.000333,0.427265,22,28199.4957,1566.63865,1281.795259,296.7917,18,0
0,0,25,25,23,40,63,135,78,213,0.000333,0.424387,11,14004.76686,778.042603,1273.160624,316.919049,16,0
0,0,53,53,30,80,110,288,173,461,0.000333,1.042069,30,93786.20484,5210.344713,3126.206828,652.960965,34,0
0,0,21,21,17,32,49,100,60,160,0.000333,0.299451,8,7186.8286,399.268256,898.353575,229.486868,13,0
0,0,42,42,25,60,85,258,166,424,0.000333,0.905861,24,65221.96217,3623.442343,2717.581757,470.50984,13,0
0,0,3,3,9,12,21,15,15,30,0.000333,0.043923,4,527.078091,29.282116,131.769523,71.548875,2,0
0,0,72,72,31,88,119,395,241,636,0.000333,1.461701,30,131553.1229,7308.506829,4385.104097,722.010068,46,0
0,0,71,71,31,88,119,391,239,630,0.000333,1.447912,30,130312.0557,7239.558651,4343.735191,722.010068,45,0
0,0,64,64,28,80,108,358,215,573,0.000333,1.290184,28,108375.4151,6020.856394,3870.550539,640.360185,41,0
0,0,48,48,28,73,101,265,156,421,0.000333,0.934369,28,78486.99696,4360.38872,2803.107034,586.463131,33,0
0,0,39,39,23,55,78,203,128,331,0.000333,0.693489,22,45770.29896,2542.794387,2080.468134,422.016709,27,0
0,0,34,34,23,53,76,182,110,292,0.000333,0.608132,22,40136.68635,2229.815908,1824.394834,407.621709,26,0
0,0,30,30,22,44,66,147,87,234,0.000333,0.471463,11,15558.27046,864.348359,1414.388224,338.322487,21,0
0,0,30,30,25,44,69,163,93,256,0.000333,0.521261,24,37530.77426,2085.043015,1563.782261,356.311396,20,0
0,0,22,22,17,33,50,103,62,165,0.000333,0.310412,8,7449.890171,413.882787,931.236271,235.951874,13,0
0,0,21,21,17,32,49,100,60,160,0.000333,0.299451,8,7186.8286,399.268256,898.353575,229.486868,13,0
0,0,75,75,31,89,120,406,243,649,0.000333,1.494191,30,134477.1599,7470.953328,4482.571997,729.920361,49,0
0,0,76,76,31,90,121,417,248,665,0.000333,1.533681,30,138031.3216,7668.406755,4601.044053,737.846864,50,0
0,0,74,74,31,88,119,403,241,644,0.000333,1.480088,30,133207.8792,7400.437733,4440.26264,722.010068,49,0
0,0,59,59,28,84,112,334,203,537,0.000333,1.218517,28,102355.3886,5686.410478,3655.549593,671.560601,40,0
0,0,57,57,28,76,104,315,188,503,0.000333,1.12344,28,94368.99299,5242.721833,3370.321178,609.448429,40,0
0,0,68,68,26,87,113,336,211,547,0.000333,1.243546,26,96996.5852,5388.699178,3730.637892,682.747517,46,0
0,0,51,51,25,67,92,256,162,418,0.000333,0.90895,24,65444.37354,3635.79853,2726.848898,522.524381,35,0
0,0,41,41,25,57,82,218,137,355,0.000333,0.75231,24,54166.34308,3009.241282,2256.930962,448.571136,29,0
0,0,27,27,23,37,60,139,78,217,0.000333,0.427265,22,28199.4957,1566.63865,1281.795259,296.7917,18,0
0,0,27,27,21,38,59,131,76,207,0.000333,0.405902,20,24354.14222,1353.007901,1217.707111,291.659911,18,0
0,0,25,25,20,35,55,117,68,185,0.000333,0.356517,10,10695.51547,594.195304,1069.551547,265.963467,18,0
0,0,10,10,15,17,32,48,29,77,0.000333,0.128333,7,2695,149.722222,385,128.090227,7,0
0,0,76,76,31,91,122,416,247,663,0.000333,1.531693,30,137852.3656,7658.464758,4595.078855,745.789398,50,0
0,0,54,54,26,82,108,303,176,479,0.000333,1.07853,26,84125.36895,4673.631608,3235.591114,643.530697,38,0
0,0,47,47,25,62,87,258,154,412,0.000333,0.884831,24,63707.82529,3539.323627,2654.49272,485.256576,34,0
0,0,35,35,24,45,69,196,102,298,0.000333,0.60678,24,43688.16692,2427.120384,1820.340288,357.172489,24,0
0,0,12,12,18,23,41,56,44,100,0.000333,0.178585,9,4821.796804,267.8776,535.7552,179.100575,4,0
0,0,11,11,15,24,39,54,47,101,0.000333,0.177942,7,3736.779369,207.598854,533.825624,168.642459,3,0
0,0,12,12,17,25,42,62,51,113,0.000333,0.203111,16,9749.3099,541.628328,609.331869,185.583273,3,0
0,0,12,12,17,25,42,62,51,113,0.000333,0.203111,16,9749.3099,541.628328,609.331869,185.583273,3,0
0,0,5,5,12,20,32,29,30,59,0.000333,0.098333,6,1770,98.333333,295,129.458112,1,0
0,0,11,11,18,26,44,68,55,123,0.000333,0.223837,18,12087.1816,671.510089,671.510089,197.270083,3,0
1,0,35,36,26,45,71,157,106,263,0.000333,0.539128,26,42051.9708,2336.2206,1617.383492,369.344822,10,0
1,0,34,35,26,44,70,150,101,251,0.000333,0.512817,26,39999.70097,2222.205609,1538.450037,362.426424,10,0
1,0,44,45,21,54,75,171,130,301,0.000333,0.624958,20,37497.48852,2083.193806,1874.874426,403.002591,12,0
1,0,37,38,21,45,66,141,104,245,0.000333,0.493626,20,29617.53119,1645.418399,1480.876559,339.372055,12,0
1,0,35,36,21,49,70,146,107,253,0.000333,0.516903,20,31014.17207,1723.009559,1550.708603,367.359448,9,0
1,0,85,86,29,129,158,513,369,882,0.000333,2.147312,28,180374.1694,10020.78719,6441.93462,1045.329765,29,0
1,0,32,33,24,44,68,140,96,236,0.000333,0.47888,24,34479.38953,1915.521641,1436.641231,350.254091,11,0
1,0,32,33,24,44,68,140,96,236,0.000333,0.47888,24,34479.38953,1915.521641,1436.641231,350.254091,11,0
1,0,34,35,25,48,73,157,105,262,0.000333,0.540578,24,38921.61683,2162.312046,1621.734034,384.174605,12,0
1,0,33,34,21,46,67,141,100,241,0.000333,0.487309,20,29238.5499,1624.363883,1461.927495,346.322516,10,0
1,0,31,32,20,42,62,124,91,215,0.000333,0.426717,20,25603.04414,1422.391341,1280.152207,312.915894,9,0
1,0,45,46,23,69,92,185,146,331,0.000333,0.719766,22,47504.57816,2639.143231,2159.299007,525.530113,14,0
1,0,44,45,23,69,92,182,144,326,0.000333,0.708894,22,46786.98635,2599.277019,2126.681198,525.530113,13,0
1,0,26,27,23,60,83,202,123,325,0.000333,0.690629,22,45581.53193,2532.30733,2071.887815,458.455361,28,0
1,0,26,27,24,60,84,202,122,324,0.000333,0.69037,24,49706.66028,2761.481127,2071.110845,464.452536,27,0
1,0,27,28,24,64,88,212,129,341,0.000333,0.734222,24,52863.98837,2936.888243,2202.666182,494.0391,29,0
0,0,18,18,19,41,60,116,74,190,0.000333,0.374103,9,10100.78292,561.154607,1122.309213,300.370255,9,0
0,0,7,7,15,23,38,59,37,96,0.000333,0.167934,7,3526.607289,195.922627,503.801041,162.645284,2,0
0,0,26,26,25,67,92,191,129,320,0.000333,0.695847,12,25050.47791,1391.693217,2087.539826,522.524381,13,0
0,0,6,6,13,18,31,36,23,59,0.000333,0.097433,6,1753.785494,97.432527,292.297582,123.164366,3,0
0,0,28,28,25,48,73,223,126,349,0.000333,0.720083,24,51845.97051,2880.331695,2160.248771,384.174605,32,0
0,0,36,36,25,77,102,345,201,546,0.000333,1.214381,24,87435.46168,4857.525649,3643.144237,598.638968,36,0
0,0,45,45,27,87,114,409,247,656,0.000333,1.494125,26,116541.7721,6474.542893,4482.375849,688.918047,43,0
0,0,16,16,22,37,59,142,75,217,0.000333,0.425511,22,28083.73792,1560.207662,1276.533542,290.85727,20,0
0,0,14,14,19,34,53,92,56,148,0.000333,0.282577,9,7629.590045,423.866114,847.732227,253.684359,14,0
0,0,14,14,21,36,57,104,60,164,0.000333,0.318865,10,9565.939623,531.44109,956.593962,278.355966,16,0
0,0,12,12,20,32,52,92,55,147,0.000333,0.279322,10,8379.646386,465.53591,837.964639,246.438562,11,0
0,0,31,31,26,52,78,251,142,393,0.000333,0.823388,26,64224.23987,3568.013326,2470.163072,418.634298,36,0
0,0,31,31,26,51,77,250,142,392,0.000333,0.81886,26,63871.08842,3548.393801,2456.580324,411.505125,35,0
0,0,31,31,26,53,79,257,148,405,0.000333,0.85101,26,66378.81128,3687.711738,2553.031203,425.791217,35,0
0,0,14,14,19,34,53,93,56,149,0.000333,0.284487,9,7681.14133,426.730074,853.460148,253.684359,14,0
0,0,41,41,28,68,96,296,178,474,0.000333,1.040424,28,87395.62231,4855.312351,3121.272225,548.553411,36,0
0,0,41,41,28,68,96,296,178,474,0.000333,1.040424,28,87395.62231,4855.312351,3121.272225,548.553411,36,0
0,0,16,16,19,38,57,99,63,162,0.000333,0.314976,9,8504.353641,472.464091,944.928182,280.131868,7,0
0,0,15,15,18,35,53,91,58,149,0.000333,0.284487,9,7681.14133,426.730074,853.460148,254.583556,7,0
0,0,7,7,15,23,38,59,37,96,0.000333,0.167934,7,3526.607289,195.922627,503.801041,162.645284,2,0
0,0,25,25,22,69,91,190,135,325,0.000333,0.705011,11,23265.36584,1292.520324,2115.033258,519.595683,9,0
0,0,6,6,13,18,31,36,23,59,0.000333,0.097433,6,1753.785494,97.432527,292.297582,123.164366,3,0
0,0,51,51,27,87,114,361,221,582,0.000333,1.325581,26,103395.2917,5744.182872,3976.741988,688.918047,40,0
0,0,51,51,27,87,114,361,221,582,0.000333,1.325581,26,103395.2917,5744.182872,3976.741988,688.918047,40,0
0,0,41,41,25,73,98,308,181,489,0.000333,1.078198,24,77630.23473,4312.790818,3234.593114,567.953598,38,0
0,0,40,40,22,84,106,345,204,549,0.000333,1.231209,22,81259.82325,4514.434625,3693.62833,635.062159,39,0
0,0,50,50,25,92,117,408,250,658,0.000333,1.5069,24,108496.7997,6027.599981,4520.699985,716.264105,47,0
0,0,27,27,22,58,80,226,125,351,0.000333,0.739666,22,48817.92875,2712.107153,2218.996761,437.870393,27,0
0,0,25,25,19,54,73,176,106,282,0.000333,0.581844,9,15709.77473,872.765263,1745.530526,391.474548,21,0
0,0,42,42,22,86,108,354,218,572,0.000333,1.287932,22,85003.50433,4722.416907,3863.795651,650.766265,40,0
0,0,21,21,20,50,70,169,99,268,0.000333,0.547549,10,16426.47849,912.582138,1642.647849,368.631371,18,0
0,0,44,44,25,75,100,344,201,545,0.000333,1.206967,24,86901.63896,4827.868831,3620.901623,583.257807,40,0
0,0,44,44,25,76,101,345,201,546,0.000333,1.211794,24,87249.20327,4847.177959,3635.38347,590.938896,40,0
0,0,45,45,25,79,104,355,208,563,0.000333,1.257449,24,90536.34147,5029.796748,3772.347561,614.095084,42,0
0,0,43,43,25,74,99,330,194,524,0.000333,1.157928,24,83370.78885,4631.710492,3473.782869,575.595954,42,0
0,0,43,43,25,73,98,329,194,523,0.000333,1.153164,24,83027.83796,4612.657665,3459.493248,567.953598,41,0
0,0,45,45,25,81,106,360,215,575,0.000333,1.289518,24,92845.30227,5158.072348,3868.554261,629.624255,42,0
0,0,25,25,19,54,73,177,106,283,0.000333,0.583907,9,15765.48315,875.860175,1751.72035,391.474548,21,0
0,0,14,14,17,34,51,89,57,146,0.000333,0.276058,8,6625.392799,368.077378,828.1741,242.460605,7,0
0,0,7,7,15,24,39,62,39,101,0.000333,0.177942,7,3736.779369,207.598854,533.825624,168.642459,3,0
0,0,54,54,28,87,115,398,239,637,0.000333,1.453526,28,122096.1605,6783.12003,4360.577162,695.142022,47,0
0,0,54,54,28,87,115,407,243,650,0.000333,1.48319,28,124587.9189,6921.551052,4449.568533,695.142022,47,0
0,0,6,6,13,19,32,39,25,64,0.000333,0.106667,6,1920,106.666667,320,128.816339,4,0
0,0,15,15,15,22,37,50,45,95,0.000333,0.164966,14,6928.572976,384.920721,494.89807,156.710855,5,0
0,0,49,49,25,61,86,216,169,385,0.000333,0.824704,24,59378.68633,3298.815907,2474.111931,477.871382,31,0
0,0,111,111,25,110,135,544,400,944,0.000333,2.226838,36,240498.5013,13361.02785,6680.513924,862.045973,48,0
0,0,109,109,25,109,134,535,396,931,0.000333,2.192843,36,236827.0453,13157.05807,6578.529036,853.828496,47,0
0,0,110,110,25,110,135,540,399,939,0.000333,2.215043,36,239224.6744,13290.25969,6645.129846,862.045973,47,0
0,0,110,110,25,110,135,540,399,939,0.000333,2.215043,36,239224.6744,13290.25969,6645.129846,862.045973,47,0
0,0,109,109,25,109,134,535,396,931,0.000333,2.192843,36,236827.0453,13157.05807,6578.529036,853.828496,47,0
0,0,111,111,25,110,135,545,402,947,0.000333,2.233915,36,241262.7973,13403.48874,6701.74437,862.045973,47,0
0,0,111,111,25,110,135,545,402,947,0.000333,2.233915,36,241262.7973,13403.48874,6701.74437,862.045973,47,0
0,0,111,111,25,110,135,545,402,947,0.000333,2.233915,36,241262.7973,13403.48874,6701.74437,862.045973,47,0
0,0,38,38,17,58,75,175,132,307,0.000333,0.637416,16,30595.95741,1699.775412,1912.247338,409.249766,10,0
0,0,38,38,17,58,75,175,132,307,0.000333,0.637416,16,30595.95741,1699.775412,1912.247338,409.249766,10,0
0,0,23,23,20,32,52,118,74,192,0.000333,0.364828,20,21889.68852,1216.093807,1094.484426,246.438562,10,0
0,0,8,8,18,18,36,52,31,83,0.000333,0.143035,9,3861.933976,214.551888,429.103775,150.1173,5,0
0,0,9,9,18,19,37,55,33,88,0.000333,0.152811,9,4125.887066,229.215948,458.431896,155.769273,5,0
0,0,23,23,20,32,52,117,73,190,0.000333,0.361028,20,21661.67093,1203.426163,1083.083546,246.438562,10,0
0,0,21,21,18,25,43,112,56,168,0.000333,0.303871,18,16409.02462,911.612479,911.612479,191.155055,11,0
0,0,5,5,17,16,33,33,21,54,0.000333,0.090799,8,2179.17826,121.065459,272.397282,133.486868,3,0
1,0,17,18,23,29,52,95,59,154,0.000333,0.292623,22,19313.08977,1072.949431,877.867717,244.923374,9,0
1,0,9,10,13,22,35,51,31,82,0.000333,0.1402,6,2523.607244,140.200402,420.601207,146.213212,6,0
1,0,9,10,16,22,38,45,31,76,0.000333,0.132947,8,3190.739928,177.263329,398.842491,162.107496,5,0
1,0,5,6,11,16,27,27,19,46,0.000333,0.072908,5,1093.624125,60.756896,218.724825,102.053748,3,0
1,0,14,15,23,30,53,79,60,139,0.000333,0.265394,22,17515.98075,973.110042,796.180943,251.248643,14,0
0,0,9,9,14,24,38,44,34,78,0.000333,0.136446,7,2865.368422,159.187135,409.338346,163.342069,5,0
0,0,6,6,13,16,29,30,22,52,0.000333,0.084205,6,1515.69007,84.205004,252.615012,112.105716,4,0
0,0,8,8,13,24,37,39,33,72,0.000333,0.125027,6,2250.483854,125.026881,375.080642,158.144816,4,0
0,0,5,5,12,16,28,25,21,46,0.000333,0.073713,6,1326.829958,73.712775,221.138326,107.01955,3,0
0,0,4,4,12,16,28,20,20,40,0.000333,0.064098,6,1153.765181,64.098066,192.294197,107.01955,2,0
0,0,23,23,20,39,59,91,85,176,0.000333,0.345115,20,20706.90353,1150.38353,1035.345177,292.569248,6,0
0,0,7,7,17,35,52,55,42,97,0.000333,0.184314,8,4423.541221,245.75229,552.942653,249.011774,5,0
0,0,4,4,12,15,27,27,19,46,0.000333,0.072908,6,1312.348951,72.908275,218.724825,101.622909,2,0
0,0,67,67,28,115,143,429,387,816,0.000333,1.947485,42,245383.1105,13632.39503,5842.455011,921.837294,13,0
0,0,4,4,11,15,26,24,20,44,0.000333,0.06894,5,1034.096738,57.449819,206.819348,96.657107,2,0
0,0,14,14,23,30,53,72,50,122,0.000333,0.232935,11,7686.86925,427.048292,698.806295,251.248643,9,0
0,0,14,14,23,30,53,72,50,122,0.000333,0.232935,11,7686.86925,427.048292,698.806295,251.248643,9,0
0,0,45,45,30,56,86,321,258,579,0.000333,1.240269,60,223248.4376,12402.69098,3720.807293,472.418594,20,0
0,0,45,45,30,56,86,321,258,579,0.000333,1.240269,60,223248.4376,12402.69098,3720.807293,472.418594,20,0
0,0,23,23,21,40,61,138,115,253,0.000333,0.500159,20,30009.53093,1667.196163,1500.476546,305.11579,8,0
0,0,5,5,12,15,27,22,21,43,0.000333,0.068153,6,1226.760976,68.153388,204.460163,101.622909,2,0
0,0,4,4,12,14,26,17,17,34,0.000333,0.053272,6,958.889703,53.27165,159.81495,96.322519,2,0
1,0,31,32,23,54,77,210,166,376,0.000333,0.785437,33,77758.2874,4319.904855,2356.311739,414.80585,15,0
1,0,31,32,23,54,77,210,166,376,0.000333,0.785437,33,77758.2874,4319.904855,2356.311739,414.80585,15,0
1,0,31,32,23,54,77,210,166,376,0.000333,0.785437,33,77758.2874,4319.904855,2356.311739,414.80585,15,0
1,0,31,32,23,54,77,210,166,376,0.000333,0.785437,33,77758.2874,4319.904855,2356.311739,414.80585,15,0
1,0,31,32,23,54,77,210,166,376,0.000333,0.785437,33,77758.2874,4319.904855,2356.311739,414.80585,15,0
1,0,31,32,23,54,77,210,166,376,0.000333,0.785437,33,77758.2874,4319.904855,2356.311739,414.80585,15,0
1,0,31,32,23,54,77,210,166,376,0.000333,0.785437,33,77758.2874,4319.904855,2356.311739,414.80585,15,0
0,0,10,10,19,22,41,61,46,107,0.000333,0.191086,18,10318.64516,573.258064,573.258064,178.818118,3,0
0,0,10,10,20,22,42,54,44,98,0.000333,0.176149,20,10568.94215,587.163453,528.447107,184.546058,4,0
0,0,10,10,15,26,41,40,40,80,0.000333,0.142868,7,3000.229123,166.679396,428.60416,180.814792,2,0
0,0,11,11,21,27,48,64,53,117,0.000333,0.217814,10,6534.406126,363.022563,653.440613,220.620628,5,0
0,0,6,6,13,23,36,47,33,80,0.000333,0.137865,6,2481.564001,137.864667,413.594,152.147641,5,0
0,0,84,84,29,96,125,468,282,750,0.000333,1.741446,28,146281.47,8126.748332,5224.338213,773.037849,46,0
0,0,50,50,26,65,91,285,171,456,0.000333,0.989185,26,77156.41325,4286.467403,2967.554356,513.665341,25,0
0,0,4,4,8,14,22,17,18,35,0.000333,0.052027,4,624.320427,34.684468,156.080107,77.302969,1,0
0,0,4,4,8,12,20,13,14,27,0.000333,0.038897,4,466.768234,25.931569,116.692059,67.01955,1,0
0,0,83,83,29,95,124,462,278,740,0.000333,1.715368,28,144090.9476,8005.052642,5146.10527,765.017732,46,0
0,0,83,83,29,95,124,462,278,740,0.000333,1.715368,28,144090.9476,8005.052642,5146.10527,765.017732,46,0
0,0,83,83,29,95,124,462,278,740,0.000333,1.715368,28,144090.9476,8005.052642,5146.10527,765.017732,46,0
0,0,84,84,29,96,125,468,282,750,0.000333,1.741446,28,146281.47,8126.748332,5224.338213,773.037849,46,0
0,0,83,83,29,95,124,462,278,740,0.000333,1.715368,28,144090.9476,8005.052642,5146.10527,765.017732,46,0
0,0,83,83,29,95,124,462,278,740,0.000333,1.715368,28,144090.9476,8005.052642,5146.10527,765.017732,46,0
0,0,83,83,29,95,124,462,278,740,0.000333,1.715368,28,144090.9476,8005.052642,5146.10527,765.017732,46,0
0,0,83,83,29,95,124,462,278,740,0.000333,1.715368,28,144090.9476,8005.052642,5146.10527,765.017732,46,0
0,0,84,84,29,96,125,468,282,750,0.000333,1.741446,28,146281.47,8126.748332,5224.338213,773.037849,46,0
0,0,32,32,26,60,86,161,124,285,0.000333,0.610495,26,47618.62183,2645.478991,1831.485455,476.624868,7,0
0,0,32,32,26,60,86,161,124,285,0.000333,0.610495,26,47618.62183,2645.478991,1831.485455,476.624868,7,0
0,0,64,64,27,86,113,386,261,647,0.000333,1.470885,39,172093.5758,9560.754209,4412.655789,681.040731,39,0
0,0,23,23,19,45,64,131,104,235,0.000333,0.47,18,25380,1410,1410,327.844012,6,0
0,0,17,17,18,31,49,76,63,139,0.000333,0.260148,18,14048.00403,780.444668,780.444668,228.638736,8,0
0,0,11,11,16,21,37,51,40,91,0.000333,0.15802,8,3792.48205,210.693447,474.060256,156.238666,7,0
0,0,11,11,16,26,42,33,33,66,0.000333,0.118631,8,2847.143599,158.174644,355.89295,186.211433,6,0
0,0,8,8,9,14,23,12,17,29,0.000333,0.043728,4,524.733187,29.151844,131.183297,81.832294,2,0
0,0,10,10,18,26,44,66,45,111,0.000333,0.201999,9,5453.972187,302.998455,605.99691,197.270083,4,0
0,0,14,14,16,35,51,81,61,142,0.000333,0.268495,8,6443.875188,357.993066,805.484399,243.524906,4,0
0,0,14,14,16,35,51,81,61,142,0.000333,0.268495,8,6443.875188,357.993066,805.484399,243.524906,4,0
0,0,59,59,25,50,75,415,244,659,0.000333,1.368264,48,197029.9928,10946.11071,4104.791517,398.289214,33,0
0,0,59,59,25,50,75,415,244,659,0.000333,1.368264,48,197029.9928,10946.11071,4104.791517,398.289214,33,0
0,0,43,43,20,38,58,316,188,504,0.000333,0.984141,40,118096.8969,6560.938715,2952.422422,285.859807,31,0
0,0,43,43,20,38,58,316,188,504,0.000333,0.984141,40,118096.8969,6560.938715,2952.422422,285.859807,31,0
0,0,43,43,20,38,58,316,188,504,0.000333,0.984141,40,118096.8969,6560.938715,2952.422422,285.859807,31,0
0,0,43,43,20,38,58,316,188,504,0.000333,0.984141,40,118096.8969,6560.938715,2952.422422,285.859807,31,0
0,0,27,27,20,36,56,232,133,365,0.000333,0.706562,30,63590.5364,3532.807578,2119.684547,272.555862,24,0
0,0,59,59,25,50,75,426,246,672,0.000333,1.395255,48,200916.7757,11162.04309,4185.76616,398.289214,34,0
0,0,62,62,25,50,75,439,252,691,0.000333,1.434705,60,258246.8229,14347.04572,4304.113715,398.289214,35,0
0,0,32,32,23,44,67,250,144,394,0.000333,0.79668,33,78871.29165,4381.738425,2390.039141,344.256916,30,0
0,0,14,14,18,28,46,101,60,161,0.000333,0.296431,18,16007.28255,889.293475,889.293475,209.664588,7,0
0,0,58,58,25,44,69,398,231,629,0.000333,1.280754,60,230535.713,12807.53961,3842.261883,356.311396,29,0
0,0,53,53,25,43,68,340,203,543,0.000333,1.101831,48,158663.6315,8814.646194,3305.492323,349.425789,23,0
1,0,19,20,18,28,46,107,67,174,0.000333,0.320367,18,17299.79605,961.09978,961.09978,209.664588,9,0
1,0,19,20,18,28,46,103,67,170,0.000333,0.313002,18,16902.09959,939.005533,939.005533,209.664588,8,0
0,0,18,18,15,51,66,132,117,249,0.000333,0.501685,14,21070.7579,1170.597661,1505.054136,347.897051,4,0
0,0,8,8,16,28,44,40,36,76,0.000333,0.138306,8,3319.334424,184.407468,414.916803,198.605938,3,0
0,0,17,17,15,49,64,120,106,226,0.000333,0.452,14,18984,1054.666667,1356,333.724141,4,0
0,0,8,8,16,28,44,40,36,76,0.000333,0.138306,8,3319.334424,184.407468,414.916803,198.605938,3,0
0,0,16,16,15,47,62,108,95,203,0.000333,0.402901,14,16921.82591,940.10144,1208.701851,319.669035,4,0
0,0,8,8,16,28,44,40,36,76,0.000333,0.138306,8,3319.334424,184.407468,414.916803,198.605938,3,0
0,0,15,15,15,44,59,95,83,178,0.000333,0.349037,7,7329.77324,407.209624,1047.110463,298.81835,4,0
0,0,8,8,16,28,44,40,36,76,0.000333,0.138306,8,3319.334424,184.407468,414.916803,198.605938,3,0
0,0,13,13,14,41,55,77,68,145,0.000333,0.279432,7,5868.080109,326.004451,838.297158,272.962601,3,0
0,0,7,7,14,25,39,34,32,66,0.000333,0.116279,7,2441.855825,135.658657,348.836546,169.399374,2,0
0,0,5,5,13,22,35,27,27,54,0.000333,0.092327,6,1661.887697,92.327094,276.981283,146.213212,2,0
0,0,8,8,14,29,43,39,36,75,0.000333,0.135657,7,2848.788996,158.266055,406.969857,194.184418,3,0
0,0,8,8,15,32,47,45,41,86,0.000333,0.159232,7,3343.862489,185.770138,477.694641,218.603359,3,0
0,0,3,3,12,24,36,47,27,74,0.000333,0.127525,6,2295.446701,127.524817,382.57445,153.05865,4,0
1,0,28,29,25,36,61,148,105,253,0.000333,0.500159,24,36011.43711,2000.635395,1500.476546,302.213705,11,0
1,0,13,14,21,27,48,94,60,154,0.000333,0.286695,20,17201.6845,955.649139,860.084225,220.620628,9,0
0,0,21,21,20,34,54,101,87,188,0.000333,0.36064,20,21638.37701,1202.132056,1081.91885,259.412299,17,0
0,0,6,6,12,18,30,36,34,70,0.000333,0.114494,6,2060.89405,114.494114,343.482342,118.0782,2,0
0,0,6,6,12,18,30,36,34,70,0.000333,0.114494,6,2060.89405,114.494114,343.482342,118.0782,2,0
0,0,9,9,15,29,44,68,52,120,0.000333,0.218377,7,4585.92256,254.773476,655.131794,199.484808,3,0
0,0,9,9,15,29,44,68,52,120,0.000333,0.218377,7,4585.92256,254.773476,655.131794,199.484808,3,0
0,0,39,39,20,59,79,272,168,440,0.000333,0.924555,20,55473.27058,3081.848366,2773.663529,433.514502,27,0
0,0,33,33,19,50,69,209,142,351,0.000333,0.714697,18,38593.65752,2144.092084,2144.092084,362.903432,16,0
0,0,27,27,19,52,71,202,125,327,0.000333,0.670322,18,36197.41155,2010.967308,2010.967308,377.133488,20,0
0,0,20,20,18,43,61,133,98,231,0.000333,0.456667,18,24660.00585,1370.000325,1370.000325,308.388034,7,0
0,0,54,54,20,65,85,335,211,546,0.000333,1.166509,30,104985.8235,5832.545752,3499.527451,477.89247,31,0
0,0,51,51,19,63,82,321,202,523,0.000333,1.108333,27,89774.99186,4987.499548,3324.999698,457.279258,30,0
0,0,23,23,19,46,65,150,105,255,0.000333,0.511901,18,27642.66826,1535.703792,1535.703792,334.794473,11,0
0,0,19,19,18,42,60,124,92,216,0.000333,0.425296,18,22965.99064,1275.888369,1275.888369,301.535982,7,0
0,0,43,43,20,60,80,289,179,468,0.000333,0.986221,20,59173.24697,3287.402609,2958.662348,440.851998,28,0
0,0,38,38,19,54,73,240,158,398,0.000333,0.821183,18,44343.90314,2463.550174,2463.550174,391.474548,20,0
0,0,24,24,19,49,68,176,111,287,0.000333,0.582367,18,31447.83304,1747.101835,1747.101835,355.831405,18,0
0,0,18,18,18,41,59,115,86,201,0.000333,0.394137,18,21283.40255,1182.411253,1182.411253,294.718282,7,0
0,0,50,50,20,62,82,317,198,515,0.000333,1.09138,30,98224.17847,5456.898804,3274.139282,455.598733,30,0
0,0,46,46,19,59,78,287,183,470,0.000333,0.984713,27,79761.75416,4431.208564,2954.139043,427.786563,26,0
0,0,22,22,19,45,64,151,100,251,0.000333,0.502,18,27108,1506,1506,327.844012,15,0
0,0,17,17,18,39,57,105,79,184,0.000333,0.357751,18,19318.53173,1073.251763,1073.251763,281.189337,7,0
0,0,50,50,20,62,82,317,198,515,0.000333,1.09138,30,98224.17847,5456.898804,3274.139282,455.598733,30,0
0,0,46,46,19,59,78,287,183,470,0.000333,0.984713,27,79761.75416,4431.208564,2954.139043,427.786563,26,0
0,0,21,21,19,44,63,142,94,236,0.000333,0.470213,18,25391.48512,1410.638062,1410.638062,320.925614,15,0
0,0,16,16,18,38,56,96,73,169,0.000333,0.327148,9,8832.986836,490.721491,981.442982,274.479896,7,0
0,0,29,29,17,47,64,151,114,265,0.000333,0.53,16,25440,1413.333333,1590,330.552544,5,0
0,0,24,24,17,42,59,130,94,224,0.000333,0.439237,16,21083.39269,1171.299594,1317.712043,295.9642,5,0
0,0,24,24,17,42,59,130,94,224,0.000333,0.439237,16,21083.39269,1171.299594,1317.712043,295.9642,5,0
0,0,24,24,17,42,59,130,94,224,0.000333,0.439237,16,21083.39269,1171.299594,1317.712043,295.9642,5,0
0,0,17,17,15,29,44,87,64,151,0.000333,0.274791,14,11541.23844,641.179913,824.374174,199.484808,5,0
0,0,11,11,14,24,38,53,40,93,0.000333,0.162686,7,3416.400811,189.800045,488.057259,163.342069,3,0
0,0,61,61,30,45,75,459,323,782,0.000333,1.623645,105,511448.3027,28413.79459,4870.936216,394.340107,29,0
0,0,63,63,29,59,88,547,379,926,0.000333,1.993811,84,502440.429,27913.35717,5981.433679,487.957389,55,0
0,0,32,32,25,78,103,229,163,392,0.000333,0.873703,24,62906.59696,3494.810942,2621.108207,606.357778,14,0
0,0,25,25,20,31,51,105,93,198,0.000333,0.37438,30,33694.20653,1871.900363,1123.140218,240.018648,5,0
0,0,35,35,20,42,62,134,123,257,0.000333,0.510076,20,30604.56904,1700.253835,1530.228452,312.915894,4,0
0,0,34,34,20,42,62,132,121,253,0.000333,0.502137,20,30128.23333,1673.790741,1506.411667,312.915894,4,0
0,0,33,33,20,42,62,130,119,249,0.000333,0.494198,20,29651.89763,1647.327646,1482.594881,312.915894,4,0
0,0,32,32,20,42,62,128,117,245,0.000333,0.486259,20,29175.56192,1620.864551,1458.778096,312.915894,4,0
0,0,24,24,20,31,51,96,87,183,0.000333,0.346018,20,20761.07675,1153.393153,1038.053838,240.018648,4,0
0,0,29,29,19,42,61,125,109,234,0.000333,0.462598,18,24980.26567,1387.792537,1387.792537,307.187955,3,0
0,0,40,40,22,58,80,203,179,382,0.000333,0.804992,33,79694.22556,4427.456976,2414.976532,437.870393,5,0
0,0,39,39,22,58,80,201,177,378,0.000333,0.796563,33,78859.73106,4381.09617,2389.68882,437.870393,5,0
0,0,38,38,22,58,80,199,175,374,0.000333,0.788134,33,78025.23655,4334.735364,2364.401107,437.870393,5,0
0,0,38,38,22,58,80,199,175,374,0.000333,0.788134,33,78025.23655,4334.735364,2364.401107,437.870393,5,0
0,0,38,38,22,58,80,199,175,374,0.000333,0.788134,33,78025.23655,4334.735364,2364.401107,437.870393,5,0
0,0,37,37,22,58,80,197,173,370,0.000333,0.779704,22,51460.49469,2858.916372,2339.113395,437.870393,5,0
0,0,37,37,22,58,80,197,173,370,0.000333,0.779704,22,51460.49469,2858.916372,2339.113395,437.870393,5,0
0,0,37,37,22,58,80,197,173,370,0.000333,0.779704,22,51460.49469,2858.916372,2339.113395,437.870393,5,0
0,0,31,31,23,58,81,199,147,346,0.000333,0.731196,22,48258.93822,2681.052123,2193.588101,443.804823,20,0
0,0,61,61,23,93,116,292,238,530,0.000333,1.211577,22,79964.0584,4442.447689,3634.729927,712.183694,22,0
0,0,62,62,23,93,116,295,241,536,0.000333,1.225293,22,80869.3119,4492.73955,3675.877813,712.183694,22,0
0,0,52,52,22,84,106,251,209,460,0.000333,1.031614,22,68086.555,3782.586389,3094.843409,635.062159,16,0
0,0,18,18,17,39,56,76,66,142,0.000333,0.274881,8,6597.155191,366.508622,824.644399,275.617555,4,0
0,0,30,30,16,65,81,183,148,331,0.000333,0.699497,16,33575.84562,1865.324756,2098.490351,455.453908,8,0
0,0,14,14,13,28,41,50,43,93,0.000333,0.166084,6,2989.514019,166.084112,498.252336,182.711654,4,0
0,0,14,14,13,28,41,50,43,93,0.000333,0.166084,6,2989.514019,166.084112,498.252336,182.711654,4,0
0,0,14,14,13,28,41,50,43,93,0.000333,0.166084,6,2989.514019,166.084112,498.252336,182.711654,4,0
0,0,25,25,15,64,79,193,151,344,0.000333,0.722834,14,30359.00808,1686.61156,2168.500577,442.603359,6,0
0,0,13,13,22,23,45,64,52,116,0.000333,0.212352,22,14015.2091,778.622728,637.054959,202.149421,5,0
1,0,15,16,23,24,47,84,54,138,0.000333,0.255511,22,16863.73175,936.873986,766.533262,214.081025,8,0
1,0,7,8,13,17,30,40,25,65,0.000333,0.106316,6,1913.687332,106.315963,318.947889,117.592585,5,0
1,0,7,8,16,17,33,34,25,59,0.000333,0.099206,8,2380.954024,132.275224,297.619253,133.486868,4,0
1,0,3,4,10,11,21,16,13,29,0.000333,0.042459,5,636.886026,35.382557,127.377205,71.273029,2,0
0,0,33,33,24,54,78,199,144,343,0.000333,0.718631,24,51741.43107,2874.523948,2155.892961,420.803025,28,0
0,0,31,31,24,52,76,194,138,332,0.000333,0.691437,24,49783.48643,2765.749246,2074.311934,406.461965,27,0
0,0,33,33,24,54,78,199,144,343,0.000333,0.718631,24,51741.43107,2874.523948,2155.892961,420.803025,28,0
0,0,27,27,21,44,65,159,119,278,0.000333,0.558073,20,33484.36504,1860.242502,1674.218252,332.453657,23,0
0,0,27,27,22,44,66,163,119,282,0.000333,0.568173,22,37499.42112,2083.301173,1704.519142,338.322487,23,0
0,0,24,24,22,48,70,140,103,243,0.000333,0.496472,22,32767.14701,1820.397056,1489.415773,366.185696,16,0
0,0,24,24,22,48,70,140,103,243,0.000333,0.496472,22,32767.14701,1820.397056,1489.415773,366.185696,16,0
0,0,7,7,16,19,35,43,30,73,0.000333,0.124813,8,2995.501282,166.416738,374.43766,144.710623,5,0
0,0,10,10,16,25,41,63,41,104,0.000333,0.185728,8,4457.483268,247.637959,557.185408,180.096405,7,0
0,0,74,74,25,93,118,317,255,572,0.000333,1.312291,24,94484.92378,5249.162432,3936.871824,724.238174,17,0
0,0,46,46,22,56,78,191,147,338,0.000333,0.708155,22,46738.2509,2596.569494,2124.46595,423.319371,7,0
0,0,46,46,22,56,78,191,147,338,0.000333,0.708155,22,46738.2509,2596.569494,2124.46595,423.319371,7,0
0,0,74,74,25,93,118,317,255,572,0.000333,1.312291,24,94484.92378,5249.162432,3936.871824,724.238174,17,0
0,0,74,74,25,93,118,317,255,572,0.000333,1.312291,24,94484.92378,5249.162432,3936.871824,724.238174,17,0
0,0,54,54,24,74,98,206,174,380,0.000333,0.837863,24,60326.15378,3351.452988,2513.589741,569.538649,7,0
0,0,43,43,22,54,76,179,137,316,0.000333,0.658115,22,43435.59207,2413.088449,1974.345094,408.871421,7,0
1,0,43,44,24,56,80,299,233,532,0.000333,1.121089,48,161436.7558,8968.708657,3363.265746,435.250976,26,0
1,0,43,44,24,56,80,299,233,532,0.000333,1.121089,48,161436.7558,8968.708657,3363.265746,435.250976,26,0
1,0,43,44,24,56,80,299,233,532,0.000333,1.121089,48,161436.7558,8968.708657,3363.265746,435.250976,26,0
1,0,43,44,24,56,80,299,233,532,0.000333,1.121089,48,161436.7558,8968.708657,3363.265746,435.250976,26,0
1,0,43,44,24,56,80,299,233,532,0.000333,1.121089,48,161436.7558,8968.708657,3363.265746,435.250976,26,0
1,0,43,44,24,56,80,299,233,532,0.000333,1.121089,48,161436.7558,8968.708657,3363.265746,435.250976,26,0
1,0,43,44,24,56,80,299,233,532,0.000333,1.121089,48,161436.7558,8968.708657,3363.265746,435.250976,26,0
1,0,43,44,24,56,80,299,233,532,0.000333,1.121089,48,161436.7558,8968.708657,3363.265746,435.250976,26,0
1,0,43,44,24,56,80,299,233,532,0.000333,1.121089,48,161436.7558,8968.708657,3363.265746,435.250976,26,0
1,0,43,44,24,56,80,299,233,532,0.000333,1.121089,48,161436.7558,8968.708657,3363.265746,435.250976,26,0
1,0,43,44,24,56,80,299,233,532,0.000333,1.121089,48,161436.7558,8968.708657,3363.265746,435.250976,26,0
1,0,43,44,24,56,80,299,233,532,0.000333,1.121089,48,161436.7558,8968.708657,3363.265746,435.250976,26,0
1,0,43,44,24,56,80,299,233,532,0.000333,1.121089,48,161436.7558,8968.708657,3363.265746,435.250976,26,0
1,0,43,44,24,56,80,299,233,532,0.000333,1.121089,48,161436.7558,8968.708657,3363.265746,435.250976,26,0
0,0,23,23,20,47,67,154,91,245,0.000333,0.495397,10,14861.91852,825.66214,1486.191852,347.504238,27,0
0,0,23,23,20,47,67,154,91,245,0.000333,0.495397,10,14861.91852,825.66214,1486.191852,347.504238,27,0
0,0,89,89,32,86,118,565,414,979,0.000333,2.246036,64,431238.8829,23957.71572,6738.107545,712.658769,34,0
0,0,78,78,32,81,113,495,364,859,0.000333,1.952845,64,374946.1586,20830.34215,5858.533729,673.52785,31,0
0,0,53,53,24,58,82,327,248,575,0.000333,1.218531,48,175468.4353,9748.246407,3655.592403,449.801998,24,0
0,0,80,80,32,84,116,516,378,894,0.000333,2.043678,64,392386.2406,21799.23559,6131.03501,696.954664,31,0
0,0,80,80,32,84,116,516,378,894,0.000333,2.043678,64,392386.2406,21799.23559,6131.03501,696.954664,31,0
0,0,51,51,24,58,82,312,238,550,0.000333,1.165551,48,167839.3729,9324.409607,3496.653603,449.801998,23,0
0,0,17,17,17,29,46,82,71,153,0.000333,0.281702,16,13521.67967,751.204426,845.104979,210.368317,9,0
0,0,21,21,21,33,54,116,96,212,0.000333,0.406679,20,24400.72301,1355.595723,1220.03615,258.703672,10,0
0,0,17,17,17,29,46,82,71,153,0.000333,0.281702,16,13521.67967,751.204426,845.104979,210.368317,9,0
0,0,34,34,23,45,68,193,150,343,0.000333,0.696,33,68903.9919,3827.99955,2087.999755,351.175314,19,0
0,0,60,60,32,73,105,368,271,639,0.000333,1.430134,48,205939.3385,11441.07436,4290.402886,611.857193,26,0
0,0,64,64,32,75,107,397,292,689,0.000333,1.54829,48,222953.7962,12386.32201,4644.870754,627.161402,27,0
0,0,31,31,20,44,64,161,129,290,0.000333,0.58,20,34800,1933.333333,1740,326.653553,17,0
0,0,66,66,32,79,111,416,302,718,0.000333,1.62613,48,234162.7484,13009.04158,4878.390592,657.998679,27,0
0,0,79,79,32,83,115,511,374,885,0.000333,2.01942,64,387728.5565,21540.47536,6058.258695,689.128273,31,0
0,0,79,79,32,83,115,511,374,885,0.000333,2.01942,64,387728.5565,21540.47536,6058.258695,689.128273,31,0
0,0,79,79,32,83,115,511,374,885,0.000333,2.01942,64,387728.5565,21540.47536,6058.258695,689.128273,31,0
0,0,49,49,24,58,82,294,228,522,0.000333,1.106214,36,119471.1173,6637.284293,3318.642146,449.801998,22,0
0,0,80,80,32,84,116,516,378,894,0.000333,2.043678,64,392386.2406,21799.23559,6131.03501,696.954664,31,0
0,0,80,80,32,84,116,516,378,894,0.000333,2.043678,64,392386.2406,21799.23559,6131.03501,696.954664,31,0
0,0,53,53,32,69,101,319,236,555,0.000333,1.231769,48,177374.7539,9854.152994,3695.307373,581.488188,23,0
0,0,55,55,32,71,103,330,244,574,0.000333,1.27935,48,184226.4625,10234.80347,3838.051303,596.632045,24,0
0,0,64,64,32,77,109,410,296,706,0.000333,1.592779,48,229360.2304,12742.23502,4778.338133,642.542564,27,0
0,0,69,69,25,69,94,427,327,754,0.000333,1.647387,48,237223.6797,13179.09332,4942.159994,537.584592,27,0
0,0,78,78,25,54,79,373,270,643,0.000333,1.35111,60,243199.8613,13511.1034,4053.331021,426.86033,32,0
0,0,78,78,25,54,79,373,270,643,0.000333,1.35111,60,243199.8613,13511.1034,4053.331021,426.86033,32,0
0,0,78,78,25,54,79,373,270,643,0.000333,1.35111,60,243199.8613,13511.1034,4053.331021,426.86033,32,0
0,0,62,62,21,42,63,259,214,473,0.000333,0.942418,50,141362.6702,7853.481677,2827.253404,318.715998,23,0
0,0,94,94,21,42,63,408,317,725,0.000333,1.444509,70,303346.9561,16852.60867,4333.527945,318.715998,40,0
0,0,94,94,21,42,63,408,317,725,0.000333,1.444509,70,303346.9561,16852.60867,4333.527945,318.715998,40,0
0,0,94,94,21,42,63,408,317,725,0.000333,1.444509,70,303346.9561,16852.60867,4333.527945,318.715998,40,0
0,0,56,56,18,40,58,237,194,431,0.000333,0.841597,36,90892.43312,5049.579618,2524.789809,287.935774,19,0
0,0,88,88,20,44,64,386,297,683,0.000333,1.366,60,245880,13660,4098,326.653553,36,0
0,0,88,88,20,44,64,386,297,683,0.000333,1.366,60,245880,13660,4098,326.653553,36,0
0,0,120,120,20,44,64,535,400,935,0.000333,1.87,90,504900,28050,5610,326.653553,53,0
0,0,88,88,20,44,64,386,297,683,0.000333,1.366,60,245880,13660,4098,326.653553,36,0
0,0,120,120,20,44,64,535,400,935,0.000333,1.87,90,504900,28050,5610,326.653553,53,0
0,0,120,120,20,44,64,535,400,935,0.000333,1.87,90,504900,28050,5610,326.653553,53,0
0,0,56,56,18,40,58,236,193,429,0.000333,0.837691,36,90470.65849,5026.147694,2513.073847,287.935774,19,0
0,0,88,88,20,44,64,385,296,681,0.000333,1.362,60,245160,13620,4086,326.653553,36,0
0,0,88,88,20,44,64,385,296,681,0.000333,1.362,60,245160,13620,4086,326.653553,36,0
0,0,120,120,20,44,64,534,399,933,0.000333,1.866,90,503820,27990,5598,326.653553,53,0
0,0,88,88,20,44,64,385,296,681,0.000333,1.362,60,245160,13620,4086,326.653553,36,0
0,0,120,120,20,44,64,534,399,933,0.000333,1.866,90,503820,27990,5598,326.653553,53,0
0,0,120,120,20,44,64,534,399,933,0.000333,1.866,90,503820,27990,5598,326.653553,53,0
0,0,41,41,17,32,49,162,146,308,0.000333,0.576444,32,55338.58022,3074.365568,1729.330632,229.486868,11,0
0,0,73,73,20,44,64,311,249,560,0.000333,1.12,50,168000,9333.333333,3360,326.653553,28,0
0,0,73,73,20,44,64,311,249,560,0.000333,1.12,50,168000,9333.333333,3360,326.653553,28,0
0,0,105,105,20,44,64,460,352,812,0.000333,1.624,80,389760,21653.33333,4872,326.653553,45,0
0,0,73,73,20,44,64,311,249,560,0.000333,1.12,50,168000,9333.333333,3360,326.653553,28,0
0,0,105,105,20,44,64,460,352,812,0.000333,1.624,80,389760,21653.33333,4872,326.653553,45,0
0,0,105,105,20,44,64,460,352,812,0.000333,1.624,80,389760,21653.33333,4872,326.653553,45,0
0,0,35,35,15,22,37,132,127,259,0.000333,0.449749,35,47223.69476,2623.538598,1349.248422,156.710855,10,0
0,0,67,67,20,42,62,281,230,511,0.000333,1.014198,50,152129.7157,8451.650874,3042.594315,312.915894,27,0
0,0,67,67,20,42,62,281,230,511,0.000333,1.014198,50,152129.7157,8451.650874,3042.594315,312.915894,27,0
0,0,99,99,20,42,62,430,333,763,0.000333,1.514351,70,318013.6249,17667.42361,4543.051785,312.915894,44,0
0,0,67,67,20,42,62,281,230,511,0.000333,1.014198,50,152129.7157,8451.650874,3042.594315,312.915894,27,0
0,0,99,99,20,42,62,430,333,763,0.000333,1.514351,70,318013.6249,17667.42361,4543.051785,312.915894,44,0
0,0,99,99,20,42,62,430,333,763,0.000333,1.514351,70,318013.6249,17667.42361,4543.051785,312.915894,44,0
0,0,41,41,17,31,48,173,155,328,0.000333,0.610623,40,73274.70801,4070.817112,1831.8677,223.066954,10,0
0,0,73,73,21,46,67,322,258,580,0.000333,1.172777,50,175916.5865,9773.143696,3518.33173,346.322516,27,0
0,0,73,73,21,46,67,322,258,580,0.000333,1.172777,50,175916.5865,9773.143696,3518.33173,346.322516,27,0
0,0,105,105,21,46,67,471,361,832,0.000333,1.682329,70,353289.0345,19627.16858,5046.986206,346.322516,44,0
0,0,73,73,21,46,67,322,258,580,0.000333,1.172777,50,175916.5865,9773.143696,3518.33173,346.322516,27,0
0,0,105,105,21,46,67,471,361,832,0.000333,1.682329,70,353289.0345,19627.16858,5046.986206,346.322516,44,0
0,0,105,105,21,46,67,471,361,832,0.000333,1.682329,70,353289.0345,19627.16858,5046.986206,346.322516,44,0
0,0,33,33,17,29,46,148,131,279,0.000333,0.513691,32,49314.36114,2739.68673,1541.073786,210.368317,7,0
0,0,65,65,21,46,67,297,234,531,0.000333,1.073698,50,161054.668,8947.481556,3221.09336,346.322516,24,0
0,0,65,65,21,46,67,297,234,531,0.000333,1.073698,50,161054.668,8947.481556,3221.09336,346.322516,24,0
0,0,97,97,21,46,67,446,337,783,0.000333,1.583249,70,332482.3485,18471.24159,4749.747836,346.322516,41,0
0,0,65,65,21,46,67,297,234,531,0.000333,1.073698,50,161054.668,8947.481556,3221.09336,346.322516,24,0
0,0,97,97,21,46,67,446,337,783,0.000333,1.583249,70,332482.3485,18471.24159,4749.747836,346.322516,41,0
0,0,97,97,21,46,67,446,337,783,0.000333,1.583249,70,332482.3485,18471.24159,4749.747836,346.322516,41,0
0,0,62,62,21,42,63,259,214,473,0.000333,0.942418,50,141362.6702,7853.481677,2827.253404,318.715998,23,0
0,0,94,94,21,42,63,408,317,725,0.000333,1.444509,70,303346.9561,16852.60867,4333.527945,318.715998,40,0
0,0,94,94,21,42,63,408,317,725,0.000333,1.444509,70,303346.9561,16852.60867,4333.527945,318.715998,40,0
0,0,94,94,21,42,63,408,317,725,0.000333,1.444509,70,303346.9561,16852.60867,4333.527945,318.715998,40,0
0,0,56,56,18,40,58,237,194,431,0.000333,0.841597,36,90892.43312,5049.579618,2524.789809,287.935774,19,0
0,0,88,88,20,44,64,386,297,683,0.000333,1.366,60,245880,13660,4098,326.653553,36,0
0,0,88,88,20,44,64,386,297,683,0.000333,1.366,60,245880,13660,4098,326.653553,36,0
0,0,120,120,20,44,64,535,400,935,0.000333,1.87,90,504900,28050,5610,326.653553,53,0
0,0,88,88,20,44,64,386,297,683,0.000333,1.366,60,245880,13660,4098,326.653553,36,0
0,0,120,120,20,44,64,535,400,935,0.000333,1.87,90,504900,28050,5610,326.653553,53,0
0,0,120,120,20,44,64,535,400,935,0.000333,1.87,90,504900,28050,5610,326.653553,53,0
0,0,56,56,18,40,58,236,193,429,0.000333,0.837691,36,90470.65849,5026.147694,2513.073847,287.935774,19,0
0,0,88,88,20,44,64,385,296,681,0.000333,1.362,60,245160,13620,4086,326.653553,36,0
0,0,88,88,20,44,64,385,296,681,0.000333,1.362,60,245160,13620,4086,326.653553,36,0
0,0,120,120,20,44,64,534,399,933,0.000333,1.866,90,503820,27990,5598,326.653553,53,0
0,0,88,88,20,44,64,385,296,681,0.000333,1.362,60,245160,13620,4086,326.653553,36,0
0,0,120,120,20,44,64,534,399,933,0.000333,1.866,90,503820,27990,5598,326.653553,53,0
0,0,120,120,20,44,64,534,399,933,0.000333,1.866,90,503820,27990,5598,326.653553,53,0
0,0,41,41,17,32,49,162,146,308,0.000333,0.576444,32,55338.58022,3074.365568,1729.330632,229.486868,11,0
0,0,73,73,20,44,64,311,249,560,0.000333,1.12,50,168000,9333.333333,3360,326.653553,28,0
0,0,73,73,20,44,64,311,249,560,0.000333,1.12,50,168000,9333.333333,3360,326.653553,28,0
0,0,105,105,20,44,64,460,352,812,0.000333,1.624,80,389760,21653.33333,4872,326.653553,45,0
0,0,73,73,20,44,64,311,249,560,0.000333,1.12,50,168000,9333.333333,3360,326.653553,28,0
0,0,105,105,20,44,64,460,352,812,0.000333,1.624,80,389760,21653.33333,4872,326.653553,45,0
0,0,105,105,20,44,64,460,352,812,0.000333,1.624,80,389760,21653.33333,4872,326.653553,45,0
0,0,35,35,15,22,37,132,127,259,0.000333,0.449749,35,47223.69476,2623.538598,1349.248422,156.710855,10,0
0,0,67,67,20,42,62,281,230,511,0.000333,1.014198,50,152129.7157,8451.650874,3042.594315,312.915894,27,0
0,0,67,67,20,42,62,281,230,511,0.000333,1.014198,50,152129.7157,8451.650874,3042.594315,312.915894,27,0
0,0,99,99,20,42,62,430,333,763,0.000333,1.514351,70,318013.6249,17667.42361,4543.051785,312.915894,44,0
0,0,67,67,20,42,62,281,230,511,0.000333,1.014198,50,152129.7157,8451.650874,3042.594315,312.915894,27,0
0,0,99,99,20,42,62,430,333,763,0.000333,1.514351,70,318013.6249,17667.42361,4543.051785,312.915894,44,0
0,0,99,99,20,42,62,430,333,763,0.000333,1.514351,70,318013.6249,17667.42361,4543.051785,312.915894,44,0
0,0,41,41,17,31,48,173,155,328,0.000333,0.610623,40,73274.70801,4070.817112,1831.8677,223.066954,10,0
0,0,73,73,21,46,67,322,258,580,0.000333,1.172777,50,175916.5865,9773.143696,3518.33173,346.322516,27,0
0,0,73,73,21,46,67,322,258,580,0.000333,1.172777,50,175916.5865,9773.143696,3518.33173,346.322516,27,0
0,0,105,105,21,46,67,471,361,832,0.000333,1.682329,70,353289.0345,19627.16858,5046.986206,346.322516,44,0
0,0,73,73,21,46,67,322,258,580,0.000333,1.172777,50,175916.5865,9773.143696,3518.33173,346.322516,27,0
0,0,105,105,21,46,67,471,361,832,0.000333,1.682329,70,353289.0345,19627.16858,5046.986206,346.322516,44,0
0,0,105,105,21,46,67,471,361,832,0.000333,1.682329,70,353289.0345,19627.16858,5046.986206,346.322516,44,0
0,0,57,57,18,41,59,239,201,440,0.000333,0.862788,36,93181.0659,5176.725883,2588.362942,294.718282,19,0
0,0,89,89,21,44,65,388,304,692,0.000333,1.38916,60,250048.7116,13891.59509,4167.478527,332.453657,36,0
0,0,89,89,21,44,65,388,304,692,0.000333,1.38916,60,250048.7116,13891.59509,4167.478527,332.453657,36,0
0,0,121,121,21,44,65,537,407,944,0.000333,1.895038,90,511660.3694,28425.57608,5685.115215,332.453657,53,0
0,0,89,89,21,44,65,388,304,692,0.000333,1.38916,60,250048.7116,13891.59509,4167.478527,332.453657,36,0
0,0,121,121,21,44,65,537,407,944,0.000333,1.895038,90,511660.3694,28425.57608,5685.115215,332.453657,53,0
0,0,121,121,21,44,65,537,407,944,0.000333,1.895038,90,511660.3694,28425.57608,5685.115215,332.453657,53,0
0,0,51,51,17,36,53,200,174,374,0.000333,0.714081,32,68551.752,3808.430667,2142.24225,255.604168,15,0
0,0,83,83,21,44,65,349,277,626,0.000333,1.256667,60,226200.1351,12566.67417,3770.002251,332.453657,32,0
0,0,83,83,21,44,65,349,277,626,0.000333,1.256667,60,226200.1351,12566.67417,3770.002251,332.453657,32,0
0,0,115,115,21,44,65,498,380,878,0.000333,1.762546,80,423011.1152,23500.61751,5287.63894,332.453657,49,0
0,0,83,83,21,44,65,349,277,626,0.000333,1.256667,60,226200.1351,12566.67417,3770.002251,332.453657,32,0
0,0,115,115,21,44,65,498,380,878,0.000333,1.762546,80,423011.1152,23500.61751,5287.63894,332.453657,49,0
0,0,115,115,21,44,65,498,380,878,0.000333,1.762546,80,423011.1152,23500.61751,5287.63894,332.453657,49,0
0,0,47,47,16,31,47,174,155,329,0.000333,0.609153,40,73098.38929,4061.021627,1827.459732,217.580086,14,0
0,0,79,79,21,42,63,323,258,581,0.000333,1.1576,60,208367.9781,11575.99879,3472.799636,318.715998,31,0
0,0,79,79,21,42,63,323,258,581,0.000333,1.1576,60,208367.9781,11575.99879,3472.799636,318.715998,31,0
0,0,111,111,21,42,63,472,361,833,0.000333,1.659691,80,398325.9341,22129.21856,4979.074176,318.715998,48,0
0,0,79,79,21,42,63,323,258,581,0.000333,1.1576,60,208367.9781,11575.99879,3472.799636,318.715998,31,0
0,0,111,111,21,42,63,472,361,833,0.000333,1.659691,80,398325.9341,22129.21856,4979.074176,318.715998,48,0
0,0,111,111,21,42,63,472,361,833,0.000333,1.659691,80,398325.9341,22129.21856,4979.074176,318.715998,48,0
0,0,19,19,19,47,66,151,110,261,0.000333,0.525862,18,28396.56357,1577.586865,1577.586865,341.776299,20,0
0,0,18,18,19,46,65,139,101,240,0.000333,0.481789,18,26016.62895,1445.368275,1445.368275,334.794473,18,0
0,0,17,17,19,43,62,127,92,219,0.000333,0.434656,18,23471.44186,1303.968992,1303.968992,314.040007,16,0
0,0,56,56,28,83,111,375,266,641,0.000333,1.45174,42,182919.264,10162.18133,4355.22057,663.734211,27,0
0,0,22,22,22,53,75,170,123,293,0.000333,0.608348,22,40150.96528,2230.609182,1825.043876,401.68728,20,0
0,0,20,20,21,52,73,155,113,268,0.000333,0.552958,20,33177.45964,1843.192202,1658.872982,388.661531,17,0
0,0,18,18,18,44,62,108,81,189,0.000333,0.375114,9,10128.08792,562.671551,1125.343103,315.273641,9,0
0,0,18,18,18,44,62,108,81,189,0.000333,0.375114,9,10128.08792,562.671551,1125.343103,315.273641,9,0
0,0,18,18,18,42,60,110,82,192,0.000333,0.378041,9,10207.10695,567.061497,1134.122994,301.535982,8,0
0,0,18,18,18,42,60,110,82,192,0.000333,0.378041,9,10207.10695,567.061497,1134.122994,301.535982,8,0
0,0,10,10,12,24,36,54,44,98,0.000333,0.168884,6,3039.915901,168.884217,506.65265,153.05865,2,0
0,0,6,6,13,18,31,27,24,51,0.000333,0.084221,6,1515.984071,84.221337,252.664012,123.164366,4,0
0,0,25,25,16,41,57,118,94,212,0.000333,0.412191,16,19785.16293,1099.175718,1236.572683,283.659632,11,0
0,0,14,14,14,26,40,63,51,114,0.000333,0.202233,7,4246.89862,235.938812,606.699803,175.514402,3,0
0,0,5,5,13,20,33,29,26,55,0.000333,0.092481,6,1664.650059,92.480559,277.441677,134.544278,1,0
0,0,5,5,13,20,33,29,26,55,0.000333,0.092481,6,1664.650059,92.480559,277.441677,134.544278,1,0
0,0,23,23,26,36,62,129,90,219,0.000333,0.434656,26,33903.19379,1883.510766,1303.968992,308.328733,15,0
0,0,23,23,27,37,64,127,90,217,0.000333,0.434,26,33852,1880.666667,1302,321.131737,14,0
0,0,22,22,26,36,62,122,88,210,0.000333,0.416794,26,32509.91186,1806.106214,1250.381225,308.328733,14,0
0,0,24,24,27,37,64,134,92,226,0.000333,0.452,26,35256,1958.666667,1356,321.131737,15,0
0,0,34,34,26,37,63,162,114,276,0.000333,0.54991,39,64339.4411,3574.413394,1649.729259,314.961207,19,0
0,0,36,36,26,38,64,170,118,288,0.000333,0.576,39,67392,3744,1728,321.632678,20,0
0,0,20,20,20,31,51,96,73,169,0.000333,0.319547,20,19172.79766,1065.155425,958.639883,240.018648,11,0
0,0,21,21,20,32,52,99,75,174,0.000333,0.330626,20,19837.53022,1102.085012,991.876511,246.438562,11,0
0,0,19,19,20,30,50,90,71,161,0.000333,0.302887,20,18173.21693,1009.623163,908.660847,233.64528,10,0
0,0,18,18,20,30,50,85,69,154,0.000333,0.289718,20,17383.07707,965.726504,869.153853,233.64528,9,0
0,0,18,18,20,30,50,85,69,154,0.000333,0.289718,20,17383.07707,965.726504,869.153853,233.64528,9,0
0,0,19,19,20,33,53,91,74,165,0.000333,0.315036,20,18902.1375,1050.11875,945.106875,252.903568,9,0
0,0,20,20,20,31,51,93,73,166,0.000333,0.313874,20,18832.45214,1046.247341,941.622607,240.018648,10,0
0,0,19,19,20,31,51,91,71,162,0.000333,0.306311,20,18378.65811,1021.036562,918.932905,240.018648,10,0
0,0,20,20,20,32,52,94,73,167,0.000333,0.317324,20,19039.46866,1057.748259,951.973433,246.438562,10,0
0,0,19,19,23,32,55,101,77,178,0.000333,0.343027,22,22639.80464,1257.766924,1029.082029,264.041925,13,0
0,0,35,35,26,37,63,167,116,283,0.000333,0.563857,39,65971.23852,3665.068806,1691.570218,314.961207,20,0
0,0,47,47,26,44,70,225,159,384,0.000333,0.784548,39,91792.14246,5099.56347,2353.644679,362.426424,25,0
0,0,36,36,26,38,64,170,118,288,0.000333,0.576,39,67392,3744,1728,321.632678,20,0
0,0,7,7,16,19,35,43,28,71,0.000333,0.121393,8,2913.432754,161.857375,364.179094,144.710623,3,0
0,0,49,49,26,49,75,242,189,431,0.000333,0.894874,39,104700.2134,5816.67852,2684.620856,397.332215,26,0
0,0,49,49,26,49,75,241,188,429,0.000333,0.890721,39,104214.3655,5789.686973,2672.163218,397.332215,26,0
0,0,6,6,14,28,42,42,37,79,0.000333,0.141998,7,2981.951535,165.663974,425.993076,187.908907,2,0
0,0,10,10,17,25,42,61,47,108,0.000333,0.194123,8,4658.962253,258.831236,582.370282,185.583273,4,0
0,0,9,9,15,24,39,53,39,92,0.000333,0.162086,7,3403.799029,189.099946,486.257004,168.642459,4,0
0,0,20,20,11,38,49,90,86,176,0.000333,0.329396,10,9881.889326,548.993851,988.188933,237.474993,1,0
0,0,19,19,13,39,52,61,55,116,0.000333,0.220417,6,3967.506044,220.417002,661.251007,254.236403,4,0
0,0,33,33,14,56,70,119,97,216,0.000333,0.441308,7,9267.475922,514.859773,1323.925132,378.514845,9,0
0,0,20,20,14,41,55,69,59,128,0.000333,0.246671,7,5180.098303,287.783239,740.014043,272.962601,4,0
0,0,59,59,24,72,96,215,174,389,0.000333,0.85385,24,61477.20991,3415.40055,2561.550413,554.2737,20,0
0,0,14,14,17,28,45,54,46,100,0.000333,0.183062,8,4393.482477,244.08236,549.18531,204.092806,3,0
0,0,69,69,35,100,135,375,232,607,0.000333,1.431876,34,146051.3203,8113.962238,4295.627067,843.910525,42,0
0,0,70,70,35,100,135,380,236,616,0.000333,1.453106,34,148216.8259,8234.268104,4359.318408,843.910525,43,0
0,0,64,64,34,96,130,368,224,592,0.000333,1.385747,34,141346.2193,7852.567741,4157.241745,805.130137,40,0
0,0,69,69,35,100,135,375,232,607,0.000333,1.431876,34,146051.3203,8113.962238,4295.627067,843.910525,42,0
0,0,71,71,35,101,136,384,239,623,0.000333,1.47183,34,150126.6379,8340.368772,4415.48935,852.004265,43,0
0,0,62,62,33,91,124,344,211,555,0.000333,1.286526,32,123506.5265,6861.473693,3859.578952,758.674318,40,0
0,0,61,61,34,94,128,356,215,571,0.000333,1.332333,34,135898,7549.888889,3997,789.105089,39,0
0,0,61,61,33,90,123,338,207,545,0.000333,1.261223,32,121077.453,6726.525165,3783.670405,750.731785,39,0
0,0,61,61,34,92,126,354,213,567,0.000333,1.318706,34,134508.0024,7472.666798,3956.117717,773.141437,39,0
0,0,46,46,28,84,112,271,168,439,0.000333,0.996143,28,83676.0067,4648.667039,2988.428811,671.560601,31,0
0,0,48,48,28,76,104,264,160,424,0.000333,0.946995,28,79547.62033,4419.312241,2840.98644,609.448429,33,0
0,0,25,25,25,40,65,132,80,212,0.000333,0.425581,24,30641.80743,1702.322635,1276.741976,328.973529,16,0
0,0,25,25,23,41,64,124,78,202,0.000333,0.404,11,13332,740.666667,1212,323.701557,16,0
0,0,25,25,22,40,62,121,77,198,0.000333,0.392977,11,12968.23956,720.457754,1178.930869,310.984619,16,0
0,0,28,28,26,45,71,151,91,242,0.000333,0.49608,26,38694.20888,2149.678271,1488.238803,369.344822,16,0
0,0,55,55,31,99,130,322,207,529,0.000333,1.238278,30,111444.9772,6191.387622,3714.832573,809.886391,35,0
0,0,52,52,31,83,114,299,184,483,0.000333,1.100095,30,99008.57631,5500.476461,3300.285877,682.708358,31,0
0,0,56,56,32,80,112,318,184,502,0.000333,1.139097,32,109353.3495,6075.186082,3417.292171,665.754248,36,0
0,0,48,48,30,77,107,284,169,453,0.000333,1.017962,30,91616.53635,5089.807575,3053.884545,629.749282,32,0
0,0,44,44,28,76,104,255,154,409,0.000333,0.913493,28,76733.43565,4262.968647,2740.479845,609.448429,30,0
0,0,56,56,32,80,112,319,185,504,0.000333,1.143636,32,109789.0202,6099.39001,3430.906881,665.754248,36,0
0,0,41,41,28,74,102,241,146,387,0.000333,0.860743,14,36151.2005,2008.400028,2582.228607,594.105487,29,0
0,0,47,47,28,79,107,250,170,420,0.000333,0.943805,28,79279.65176,4404.425098,2831.416134,632.604617,31,0
0,0,45,45,27,70,97,238,158,396,0.000333,0.871188,26,67952.70262,3775.150146,2613.565486,557.431774,30,0
0,0,46,46,28,84,112,271,168,439,0.000333,0.996143,28,83676.0067,4648.667039,2988.428811,671.560601,31,0
0,0,48,48,28,76,104,264,160,424,0.000333,0.946995,28,79547.62033,4419.312241,2840.98644,609.448429,33,0
0,0,25,25,25,40,65,132,80,212,0.000333,0.425581,24,30641.80743,1702.322635,1276.741976,328.973529,16,0
0,0,25,25,23,41,64,124,78,202,0.000333,0.404,11,13332,740.666667,1212,323.701557,16,0
0,0,25,25,22,40,62,121,77,198,0.000333,0.392977,11,12968.23956,720.457754,1178.930869,310.984619,16,0
0,0,47,47,28,85,113,275,171,446,0.000333,1.013933,28,85170.39488,4731.688605,3041.799817,679.404167,31,0
0,0,35,35,23,54,77,185,123,308,0.000333,0.64339,22,42463.7456,2359.096978,1930.170255,414.80585,28,0
0,0,22,22,22,41,63,115,74,189,0.000333,0.376569,11,12426.76496,690.375831,1129.705906,317.767128,16,0
0,0,24,24,25,41,66,132,80,212,0.000333,0.427137,12,15376.93864,854.274369,1281.411553,335.756037,16,0
0,0,25,25,25,40,65,132,80,212,0.000333,0.425581,24,30641.80743,1702.322635,1276.741976,328.973529,16,0
0,0,24,24,25,43,68,135,83,218,0.000333,0.442356,12,15924.80279,884.711266,1327.066899,349.425789,15,0
0,0,49,49,32,84,116,280,175,455,0.000333,1.040127,32,99852.20329,5547.344627,3120.381353,696.954664,30,0
0,0,21,21,20,35,55,106,68,174,0.000333,0.335319,10,10059.5659,558.864772,1005.95659,265.963467,12,0
0,0,36,36,24,56,80,215,140,355,0.000333,0.748095,24,53862.82737,2992.379298,2244.284474,435.250976,13,0
0,0,4,4,11,15,26,22,19,41,0.000333,0.064239,5,963.590142,53.532786,192.718028,96.657107,2,0
0,0,58,58,27,76,103,396,239,635,0.000333,1.415309,39,165591.1856,9199.510309,4245.927835,603.224454,18,0
0,0,3,3,9,12,21,15,15,30,0.000333,0.043923,4,527.078091,29.282116,131.769523,71.548875,2,0
0,0,62,62,33,90,123,346,213,559,0.000333,1.293622,32,124187.6995,6899.316637,3880.865608,750.731785,38,0
0,0,61,61,33,90,123,342,211,553,0.000333,1.279737,32,122854.7367,6825.263149,3839.210521,750.731785,37,0
0,0,51,51,30,79,109,299,180,479,0.000333,1.080653,30,97258.80875,5403.267153,3241.960292,645.205397,32,0
0,0,44,44,30,76,106,256,157,413,0.000333,0.92621,30,83358.93443,4631.051913,2778.631148,622.049209,29,0
0,0,34,34,25,57,82,187,125,312,0.000333,0.661185,24,47605.34941,2644.741634,1983.556225,448.571136,23,0
0,0,29,29,25,55,80,166,107,273,0.000333,0.575295,12,20710.63644,1150.590913,1725.88637,434.071189,22,0
0,0,25,25,24,46,70,131,84,215,0.000333,0.439265,12,15813.55018,878.530566,1317.795849,364.12295,17,0
0,0,25,25,27,46,73,147,90,237,0.000333,0.488996,13,19070.84947,1059.491637,1466.98842,382.465813,16,0
0,0,22,22,20,36,56,109,70,179,0.000333,0.346506,10,10395.16531,577.509184,1039.516531,272.555862,12,0
0,0,21,21,20,35,55,106,68,174,0.000333,0.335319,10,10059.5659,558.864772,1005.95659,265.963467,12,0
0,0,22,22,17,30,47,90,63,153,0.000333,0.283284,16,13597.63351,755.424084,849.852094,216.693586,14,0
0,0,22,22,18,33,51,106,69,175,0.000333,0.330891,18,17868.13983,992.674435,992.674435,241.523656,14,0
0,0,15,15,15,22,37,59,41,100,0.000333,0.173648,7,3646.617356,202.589853,520.945337,156.710855,8,0
0,0,14,14,15,25,40,71,45,116,0.000333,0.205781,7,4321.405613,240.07809,617.343659,174.699764,7,0
0,0,17,17,17,21,38,73,43,116,0.000333,0.20292,16,9740.153465,541.119637,608.759592,161.725534,14,0
0,0,16,16,16,19,35,68,39,107,0.000333,0.182944,16,8781.332525,487.851807,548.833283,144.710623,14,0
0,0,14,14,15,33,48,63,67,130,0.000333,0.242015,14,10164.63175,564.701764,726.045125,225.068365,7,0
0,0,27,27,18,49,67,136,129,265,0.000333,0.535838,18,28935.24544,1607.513635,1607.513635,350.179432,11,0
0,0,30,30,19,50,69,152,142,294,0.000333,0.598635,18,32326.31143,1795.90619,1795.90619,362.903432,13,0
0,0,21,21,19,42,61,112,104,216,0.000333,0.427013,18,23058.70677,1281.039265,1281.039265,307.187955,8,0
0,0,26,26,19,57,76,148,138,286,0.000333,0.595636,18,32164.33084,1786.907269,1786.907269,413.185354,14,0
0,0,6,6,12,21,33,25,31,56,0.000333,0.094162,6,1694.916424,94.162024,282.486071,135.258216,2,0
0,0,14,14,15,33,48,63,67,130,0.000333,0.242015,14,10164.63175,564.701764,726.045125,225.068365,7,0
0,0,27,27,18,50,68,141,131,272,0.000333,0.55193,18,29804.21807,1655.789893,1655.789893,357.25146,11,0
0,0,30,30,19,51,70,157,144,301,0.000333,0.614971,18,33208.45539,1844.914188,1844.914188,370.004315,13,0
0,0,30,30,19,51,70,157,144,301,0.000333,0.614971,18,33208.45539,1844.914188,1844.914188,370.004315,13,0
0,0,21,21,19,43,62,117,106,223,0.000333,0.442595,18,23900.14399,1327.785777,1327.785777,314.040007,8,0
0,0,26,26,19,58,77,153,140,293,0.000333,0.612056,18,33051.03222,1836.168456,1836.168456,420.47352,14,0
0,0,6,6,12,21,33,25,31,56,0.000333,0.094162,6,1694.916424,94.162024,282.486071,135.258216,2,0
0,0,28,28,22,49,71,141,114,255,0.000333,0.522729,22,34500.08134,1916.671186,1568.185515,373.228278,6,0
0,0,26,26,21,47,68,130,106,236,0.000333,0.47888,20,28732.82461,1596.268034,1436.641231,353.304342,6,0
0,0,25,25,21,45,66,119,97,216,0.000333,0.435196,20,26111.7826,1450.654589,1305.58913,339.372055,6,0
0,0,24,24,21,44,65,110,89,199,0.000333,0.399484,20,23969.0239,1331.612439,1198.451195,332.453657,6,0
0,0,23,23,21,42,63,99,80,179,0.000333,0.356644,10,10699.33106,594.407281,1069.933106,318.715998,6,0
0,0,24,24,28,41,69,139,109,248,0.000333,0.504971,28,42417.59383,2356.53299,1514.914065,354.26557,7,0
0,0,23,23,28,41,69,135,105,240,0.000333,0.488682,28,41049.28435,2280.515797,1466.04587,354.26557,7,0
0,0,24,24,28,41,69,139,109,248,0.000333,0.504971,28,42417.59383,2356.53299,1514.914065,354.26557,7,0
0,0,21,21,28,41,69,125,96,221,0.000333,0.449995,28,37799.54934,2099.974963,1349.983905,354.26557,7,0
0,0,21,21,20,57,77,140,102,242,0.000333,0.505521,10,15165.62343,842.534635,1516.562343,418.913293,9,0
0,0,11,11,19,25,44,69,42,111,0.000333,0.201999,9,5453.972187,302.998455,605.99691,196.807027,6,0
0,0,69,69,20,45,65,432,410,842,0.000333,1.690278,90,456375.0329,25354.16849,5070.833699,333.571951,62,0
0,0,67,67,20,42,62,416,395,811,0.000333,1.609618,90,434596.7887,24144.26604,4828.853208,312.915894,61,0
0,0,66,66,20,42,62,405,386,791,0.000333,1.569923,90,423879.2353,23548.84641,4709.769282,312.915894,58,0
0,0,62,62,21,43,64,372,359,731,0.000333,1.462,80,350880,19493.33333,4386,325.56805,50,0
0,0,64,64,20,42,62,379,360,739,0.000333,1.466717,80,352012.0859,19556.22699,4400.151073,312.915894,52,0
0,0,29,29,22,51,73,154,126,280,0.000333,0.577717,22,38129.31928,2118.295516,1733.150876,387.401188,10,0
0,0,26,26,22,46,68,134,106,240,0.000333,0.486997,22,32141.8038,1785.655767,1460.991082,352.191346,10,0
0,0,25,25,28,42,70,139,111,250,0.000333,0.510774,28,42904.98112,2383.610062,1532.320754,361.08327,7,0
0,0,24,24,28,42,70,135,107,242,0.000333,0.494429,28,41532.02172,2307.33454,1483.28649,361.08327,7,0
0,0,25,25,28,42,70,139,111,250,0.000333,0.510774,28,42904.98112,2383.610062,1532.320754,361.08327,7,0
0,0,22,22,28,42,70,125,98,223,0.000333,0.45561,28,38271.24316,2126.180175,1366.830113,361.08327,7,0
0,0,26,26,22,34,56,102,82,184,0.000333,0.356184,22,23508.17272,1306.009596,1068.553306,271.081232,14,0
0,0,26,26,21,34,55,101,83,184,0.000333,0.35459,20,21275.40375,1181.966875,1063.770187,265.212402,14,0
0,0,25,25,21,34,55,98,81,179,0.000333,0.344954,20,20697.26777,1149.84821,1034.863389,265.212402,13,0
0,0,24,24,21,33,54,93,77,170,0.000333,0.32611,20,19566.61751,1087.034306,978.330875,258.703672,13,0
0,0,63,63,26,81,107,524,485,1009,0.000333,2.26738,65,442139.1123,24563.28402,6802.140189,635.739283,16,0
0,0,63,63,26,81,107,524,485,1009,0.000333,2.26738,65,442139.1123,24563.28402,6802.140189,635.739283,16,0
0,0,63,63,26,81,107,524,485,1009,0.000333,2.26738,65,442139.1123,24563.28402,6802.140189,635.739283,16,0
0,0,61,61,26,77,103,458,409,867,0.000333,1.932399,65,376817.7372,20934.31873,5797.195957,604.753996,16,0
0,0,63,63,26,86,112,544,497,1041,0.000333,2.362152,65,460619.6708,25589.98171,7086.456474,674.870202,16,0
0,0,63,63,26,86,112,544,497,1041,0.000333,2.362152,65,460619.6708,25589.98171,7086.456474,674.870202,16,0
0,0,63,63,26,86,112,544,497,1041,0.000333,2.362152,65,460619.6708,25589.98171,7086.456474,674.870202,16,0
0,0,63,63,26,84,110,508,461,969,0.000333,2.190379,65,427123.9416,23729.10786,6571.137562,659.166096,16,0
0,0,63,63,26,84,110,508,461,969,0.000333,2.190379,65,427123.9416,23729.10786,6571.137562,659.166096,16,0
0,0,63,63,26,84,110,508,461,969,0.000333,2.190379,65,427123.9416,23729.10786,6571.137562,659.166096,16,0
0,0,61,61,26,74,100,458,411,869,0.000333,1.924504,65,375278.2169,20848.78983,5773.511029,581.710982,16,0
0,0,62,62,26,85,111,509,461,970,0.000333,2.196861,65,428387.9204,23799.32891,6590.58339,667.009662,16,0
0,0,62,62,26,85,111,509,461,970,0.000333,2.196861,65,428387.9204,23799.32891,6590.58339,667.009662,16,0
0,0,62,62,26,82,108,488,440,928,0.000333,2.089512,65,407454.8141,22636.37856,6268.535602,643.530697,16,0
0,0,62,62,26,82,108,488,440,928,0.000333,2.089512,65,407454.8141,22636.37856,6268.535602,643.530697,16,0
0,0,61,61,26,70,96,446,399,845,0.000333,1.854764,65,361679.0654,20093.28141,5564.293313,551.261244,16,0
0,0,62,62,26,72,98,443,397,840,0.000333,1.852119,65,361163.1575,20064.61986,5556.356269,566.446033,16,0
0,0,62,62,26,72,98,443,397,840,0.000333,1.852119,65,361163.1575,20064.61986,5556.356269,566.446033,16,0
0,0,15,15,17,39,56,77,59,136,0.000333,0.263267,8,6318.402155,351.022342,789.800269,275.617555,2,0
0,0,10,10,17,34,51,61,43,104,0.000333,0.196644,8,4719.457885,262.192105,589.932236,242.460605,2,0
0,0,15,15,17,45,62,91,65,156,0.000333,0.309618,8,7430.836995,412.824278,928.854624,316.620258,2,0
0,0,10,10,17,40,57,75,49,124,0.000333,0.241093,8,5786.226894,321.45705,723.278362,282.363992,2,0
0,0,28,28,21,67,88,134,107,241,0.000333,0.518908,10,15567.2302,864.846122,1556.72302,498.666642,3,0
0,0,13,13,18,22,40,88,44,132,0.000333,0.234165,18,12644.90115,702.494509,702.494509,173.166146,13,0
0,0,12,12,18,21,39,86,42,128,0.000333,0.22551,18,12177.56671,676.531484,676.531484,167.297316,13,0
0,0,12,12,18,21,39,86,42,128,0.000333,0.22551,18,12177.56671,676.531484,676.531484,167.297316,13,0
0,0,7,7,16,14,30,55,28,83,0.000333,0.135757,16,6516.350711,362.019484,407.271919,117.302969,10,0
0,0,18,18,18,28,46,95,63,158,0.000333,0.290908,18,15709.0102,872.722789,872.722789,209.664588,9,0
0,0,17,17,18,25,43,95,59,154,0.000333,0.278548,18,15041.6059,835.644772,835.644772,191.155055,9,0
0,0,18,18,18,28,46,95,63,158,0.000333,0.290908,18,15709.0102,872.722789,872.722789,209.664588,9,0
0,0,17,17,18,26,44,95,59,154,0.000333,0.280251,18,15133.54445,840.752469,840.752469,197.270083,9,0
0,0,9,9,17,30,47,63,45,108,0.000333,0.199965,8,4799.164768,266.620265,599.895596,216.693586,4,0
0,0,51,51,25,65,90,228,186,414,0.000333,0.895876,24,64503.05237,3583.502909,2687.627182,507.550313,27,0
0,0,44,44,25,49,74,183,147,330,0.000333,0.68304,36,73768.30598,4098.239221,2049.119611,391.217187,25,0
0,0,43,43,20,41,61,155,132,287,0.000333,0.567374,30,51063.64848,2836.86936,1702.121616,306.098194,24,0
0,0,25,25,22,44,66,116,85,201,0.000333,0.404974,11,13364.1554,742.453078,1214.923218,338.322487,8,0
0,0,11,11,21,36,57,78,57,135,0.000333,0.26248,10,7874.401519,437.466751,787.440152,278.355966,8,0
0,0,20,20,17,30,47,69,55,124,0.000333,0.22959,8,5510.152141,306.119563,688.769018,216.693586,7,0
0,0,10,10,20,34,54,75,56,131,0.000333,0.251297,10,7538.902628,418.827924,753.890263,259.412299,7,0
0,0,51,51,25,65,90,228,186,414,0.000333,0.895876,24,64503.05237,3583.502909,2687.627182,507.550313,27,0
0,0,44,44,25,49,74,183,147,330,0.000333,0.68304,36,73768.30598,4098.239221,2049.119611,391.217187,25,0
0,0,43,43,20,41,61,155,132,287,0.000333,0.567374,30,51063.64848,2836.86936,1702.121616,306.098194,24,0
0,0,25,25,22,44,66,116,85,201,0.000333,0.404974,11,13364.1554,742.453078,1214.923218,338.322487,8,0
0,0,11,11,21,36,57,78,57,135,0.000333,0.26248,10,7874.401519,437.466751,787.440152,278.355966,8,0
0,0,20,20,17,30,47,69,55,124,0.000333,0.22959,8,5510.152141,306.119563,688.769018,216.693586,7,0
0,0,45,45,25,50,75,189,152,341,0.000333,0.708009,36,76464.97825,4248.054347,2124.027173,398.289214,25,0
0,0,6,6,14,24,38,46,44,90,0.000333,0.157438,7,3306.194333,183.677463,472.313476,163.342069,9,0
0,0,5,5,13,21,34,28,27,55,0.000333,0.09327,6,1678.862738,93.270152,279.810456,140.344382,5,0
0,0,5,5,14,17,31,29,24,53,0.000333,0.087524,7,1838.006831,102.111491,262.572404,122.789837,3,0
0,0,66,66,24,92,116,312,246,558,0.000333,1.275584,24,91842.08149,5102.33786,3826.753395,710.2068,17,0
0,0,51,51,25,69,94,232,189,421,0.000333,0.919827,24,66227.56576,3679.309209,2759.481907,537.584592,11,0
0,0,51,51,25,69,94,232,189,421,0.000333,0.919827,24,66227.56576,3679.309209,2759.481907,537.584592,11,0
0,0,49,49,23,69,92,222,181,403,0.000333,0.876332,22,57837.9003,3213.216683,2628.995468,525.530113,10,0
0,0,47,47,23,68,91,215,177,392,0.000333,0.850352,22,56123.22098,3117.956721,2551.055499,517.989398,10,0
1,0,3,4,12,38,50,75,40,115,0.000333,0.216348,6,3894.260771,216.347821,649.043462,242.440796,3,0
0,0,41,41,23,55,78,198,173,371,0.000333,0.777295,33,76952.17937,4275.121076,2331.884223,422.016709,12,0
0,0,42,42,24,60,84,236,206,442,0.000333,0.941801,36,101714.5548,5650.808602,2825.404301,464.452536,12,0
0,0,42,42,24,60,84,236,206,442,0.000333,0.941801,36,101714.5548,5650.808602,2825.404301,464.452536,12,0
0,0,14,14,18,28,46,87,53,140,0.000333,0.257766,9,6959.688065,386.649337,773.298674,209.664588,9,0
0,0,14,14,18,28,46,87,53,140,0.000333,0.257766,9,6959.688065,386.649337,773.298674,209.664588,9,0
0,0,5,5,16,16,32,30,22,52,0.000333,0.086667,8,2080,115.555556,260,128,3,0
0,0,16,16,17,40,57,108,67,175,0.000333,0.340252,8,8166.04602,453.669223,1020.755752,282.363992,11,0
0,0,27,27,21,36,57,110,94,204,0.000333,0.396637,20,23798.19126,1322.121737,1189.909563,278.355966,8,0
0,0,26,26,21,36,57,105,92,197,0.000333,0.383026,20,22981.58666,1276.754814,1149.079333,278.355966,7,0
0,0,26,26,21,35,56,100,88,188,0.000333,0.363928,20,21835.65451,1213.091917,1091.782725,271.763571,7,0
0,0,30,30,21,45,66,135,115,250,0.000333,0.5037,20,30221.9706,1678.998366,1511.09853,339.372055,9,0
0,0,14,14,16,27,43,62,56,118,0.000333,0.213433,16,10244.78786,569.154881,640.299241,192.381963,4,0
0,0,12,12,16,26,42,49,49,98,0.000333,0.176149,8,4227.576859,234.865381,528.447107,186.211433,3,0
0,0,18,18,19,39,58,96,81,177,0.000333,0.345621,18,18663.52745,1036.862636,1036.862636,286.841309,5,0
0,0,17,17,17,33,50,83,73,156,0.000333,0.293481,16,14087.06505,782.614725,880.441566,235.951874,5,0
0,0,15,15,18,33,51,75,64,139,0.000333,0.262822,9,7096.204103,394.233561,788.467123,241.523656,4,0
0,0,14,14,16,27,43,62,56,118,0.000333,0.213433,16,10244.78786,569.154881,640.299241,192.381963,4,0
0,0,13,13,18,35,53,68,60,128,0.000333,0.244391,9,6598.564364,366.586909,733.173818,254.583556,3,0
0,0,12,12,16,26,42,49,49,98,0.000333,0.176149,8,4227.576859,234.865381,528.447107,186.211433,3,0
0,0,11,11,14,26,40,44,47,91,0.000333,0.161432,7,3390.068196,188.337122,484.295457,175.514402,2,0
0,0,17,17,17,44,61,112,91,203,0.000333,0.401313,16,19263.03487,1070.168604,1203.93968,309.70186,5,0
0,0,17,17,17,44,61,112,91,203,0.000333,0.401313,16,19263.03487,1070.168604,1203.93968,309.70186,5,0
1,0,26,27,22,45,67,136,89,225,0.000333,0.454957,11,15013.57075,834.087264,1364.870068,345.240885,14,0
1,0,24,25,21,41,62,126,81,207,0.000333,0.41084,10,12325.18636,684.732576,1232.518636,311.898298,14,0
1,0,21,22,15,38,53,100,69,169,0.000333,0.322673,7,6776.129898,376.451661,968.018557,258.024604,10,0
1,0,20,21,15,35,50,92,64,156,0.000333,0.293481,7,6163.090959,342.393942,880.441566,238.128265,9,0
1,0,19,20,15,35,50,91,63,154,0.000333,0.289718,7,6084.076973,338.004276,869.153853,238.128265,8,0
1,0,3,4,6,8,14,10,9,19,0.000333,0.024113,3,217.019231,12.056624,72.339744,39.509775,1,0
1,0,3,4,6,7,13,8,8,16,0.000333,0.019736,3,177.621106,9.867839,59.207035,35.161259,1,0
0,0,41,41,33,67,100,248,178,426,0.000333,0.943428,32,90569.04758,5031.613754,2830.282737,572.892982,19,0
0,0,40,40,33,66,99,245,176,421,0.000333,0.93032,32,89310.69239,4961.705133,2790.959137,565.395018,19,0
0,0,49,49,34,79,113,300,207,507,0.000333,1.15261,34,117566.245,6531.458053,3457.830734,670.972416,20,0
0,0,49,49,34,79,113,300,207,507,0.000333,1.15261,34,117566.245,6531.458053,3457.830734,670.972416,20,0
0,0,40,40,32,66,98,242,173,415,0.000333,0.915035,32,87843.34673,4880.185929,2745.104585,558.930012,19,0
0,0,34,34,32,66,98,231,160,391,0.000333,0.862117,32,82763.24957,4597.958309,2586.351549,558.930012,13,0
0,0,44,44,35,77,112,295,195,490,0.000333,1.111868,34,113410.533,6300.585167,3335.603912,662.067469,16,0
0,0,47,47,35,75,110,286,194,480,0.000333,1.085018,34,110671.7905,6148.432807,3255.052662,646.686307,21,0
0,0,47,47,35,76,111,288,195,483,0.000333,1.093901,34,111577.8974,6198.772075,3281.702863,654.367397,21,0
0,0,46,46,35,75,110,286,194,480,0.000333,1.085018,34,110671.7905,6148.432807,3255.052662,646.686307,19,0
0,0,46,46,35,74,109,290,198,488,0.000333,1.100958,34,112297.7143,6238.761906,3302.87395,639.024455,17,0
0,0,34,34,32,66,98,231,160,391,0.000333,0.862117,32,82763.24957,4597.958309,2586.351549,558.930012,13,0
0,0,49,49,34,79,113,300,207,507,0.000333,1.15261,34,117566.245,6531.458053,3457.830734,670.972416,20,0
0,0,49,49,34,79,113,300,207,507,0.000333,1.15261,34,117566.245,6531.458053,3457.830734,670.972416,20,0
0,0,3,3,12,17,29,25,24,49,0.000333,0.079347,6,1428.246413,79.347023,238.041069,112.506418,2,0
0,0,66,66,27,49,76,358,270,628,0.000333,1.307899,65,255040.4011,14168.91117,3923.698478,403.502745,18,0
0,0,66,66,27,49,76,358,270,628,0.000333,1.307899,65,255040.4011,14168.91117,3923.698478,403.502745,18,0
0,0,64,64,27,49,76,352,260,612,0.000333,1.274577,65,248542.5565,13807.91981,3823.731638,403.502745,18,0
0,0,64,64,27,49,76,352,260,612,0.000333,1.274577,65,248542.5565,13807.91981,3823.731638,403.502745,18,0
0,0,62,62,27,49,76,340,248,588,0.000333,1.224594,65,238795.7896,13266.43275,3673.781378,403.502745,18,0
0,0,62,62,27,49,76,340,248,588,0.000333,1.224594,65,238795.7896,13266.43275,3673.781378,403.502745,18,0
0,0,59,59,27,48,75,326,232,558,0.000333,1.15856,52,180735.4031,10040.85573,3475.680829,396.460163,18,0
0,0,55,55,27,48,75,299,212,511,0.000333,1.060975,52,165512.1702,9195.120569,3182.926351,396.460163,18,0
0,0,55,55,27,48,75,299,212,511,0.000333,1.060975,52,165512.1702,9195.120569,3182.926351,396.460163,18,0
0,0,55,55,27,48,75,299,212,511,0.000333,1.060975,52,165512.1702,9195.120569,3182.926351,396.460163,18,0
0,0,37,37,25,45,70,159,136,295,0.000333,0.602713,36,65092.98564,3616.27698,1808.13849,363.229794,16,0
0,0,40,40,28,46,74,168,149,317,0.000333,0.656132,42,82672.66211,4592.925673,1968.396717,388.689788,15,0
0,0,40,40,28,46,74,168,149,317,0.000333,0.656132,42,82672.66211,4592.925673,1968.396717,388.689788,15,0
0,0,6,6,13,20,33,36,35,71,0.000333,0.119384,6,2148.911895,119.383994,358.151982,134.544278,4,0
0,0,7,7,13,18,31,33,28,61,0.000333,0.100735,6,1813.23585,100.735325,302.205975,123.164366,4,0
0,0,13,13,18,44,62,94,82,176,0.000333,0.349313,9,9431.446956,523.969275,1047.938551,315.273641,3,0
0,0,8,8,12,31,43,42,46,88,0.000333,0.15917,6,2865.06779,159.170433,477.511298,196.599636,2,0
0,0,16,16,16,41,57,79,83,162,0.000333,0.314976,16,15118.85092,839.936162,944.928182,283.659632,3,0
0,0,14,14,16,40,56,74,78,152,0.000333,0.294239,8,7061.743585,392.319088,882.717948,276.877124,3,0
0,0,14,14,16,40,56,74,78,152,0.000333,0.294239,8,7061.743585,392.319088,882.717948,276.877124,3,0
0,0,12,12,15,37,52,68,70,138,0.000333,0.26222,7,5506.624768,305.923598,786.660681,251.353133,3,0
0,0,12,12,15,37,52,68,70,138,0.000333,0.26222,7,5506.624768,305.923598,786.660681,251.353133,3,0
0,0,4,4,11,17,28,21,20,41,0.000333,0.065701,5,985.507759,54.750431,197.101552,107.540616,1,0
0,0,4,4,11,18,29,21,20,41,0.000333,0.066392,5,995.886104,55.327006,199.177221,113.112398,1,0
0,0,15,15,17,31,48,85,57,142,0.000333,0.264355,8,6344.517401,352.473189,793.064675,223.066954,8,0
0,0,15,15,18,28,46,81,58,139,0.000333,0.255925,18,13819.95201,767.775112,767.775112,209.664588,8,0
0,0,16,16,17,32,49,91,62,153,0.000333,0.28635,8,6872.404849,381.800269,859.050606,229.486868,8,0
0,0,23,23,20,38,58,125,83,208,0.000333,0.406153,20,24369.20094,1353.844497,1218.460047,285.859807,13,0
0,0,23,23,20,38,58,125,83,208,0.000333,0.406153,20,24369.20094,1353.844497,1218.460047,285.859807,13,0
0,0,13,13,14,30,44,74,50,124,0.000333,0.225657,7,4738.786645,263.265925,676.969521,200.509687,7,0
0,0,24,24,19,40,59,136,90,226,0.000333,0.443159,18,23930.59193,1329.477329,1329.477329,293.587747,14,0
0,0,88,88,26,75,101,500,376,876,0.000333,1.944198,65,379118.5618,21062.14232,5832.593259,589.372834,16,0
0,0,86,86,25,75,100,484,369,853,0.000333,1.88907,48,272026.0478,15112.55821,5667.20933,583.257807,14,0
0,0,61,61,18,62,80,513,344,857,0.000333,1.805964,45,243805.157,13544.73094,5417.892377,444.218821,12,0
0,0,88,88,26,75,101,500,376,876,0.000333,1.944198,65,379118.5618,21062.14232,5832.593259,589.372834,16,0
0,0,86,86,25,75,100,484,369,853,0.000333,1.88907,48,272026.0478,15112.55821,5667.20933,583.257807,14,0
0,0,89,89,26,78,104,513,385,898,0.000333,2.005665,52,312883.7331,17382.42962,6016.994867,612.472806,16,0
0,0,87,87,26,75,101,495,374,869,0.000333,1.928662,52,300871.2605,16715.07003,5785.985779,589.372834,15,0
0,0,86,86,26,75,101,490,372,862,0.000333,1.913126,52,298447.6715,16580.4262,5739.378298,589.372834,14,0
0,0,91,91,25,84,109,518,395,913,0.000333,2.059784,48,296608.9098,16478.27277,6179.352289,653.051068,14,0
0,0,91,91,25,84,109,518,395,913,0.000333,2.059784,48,296608.9098,16478.27277,6179.352289,653.051068,14,0
0,0,85,85,25,75,100,479,367,846,0.000333,1.873567,48,269793.7122,14988.53956,5620.702337,583.257807,13,0
0,0,62,62,18,61,79,517,347,864,0.000333,1.815489,45,245090.9955,13616.16642,5446.466566,436.833628,12,0
0,0,89,89,26,78,104,513,385,898,0.000333,2.005665,52,312883.7331,17382.42962,6016.994867,612.472806,16,0
0,0,89,89,26,78,104,513,385,898,0.000333,2.005665,52,312883.7331,17382.42962,6016.994867,612.472806,16,0
0,0,89,89,26,78,104,513,385,898,0.000333,2.005665,52,312883.7331,17382.42962,6016.994867,612.472806,16,0
0,0,87,87,26,75,101,495,374,869,0.000333,1.928662,52,300871.2605,16715.07003,5785.985779,589.372834,15,0
0,0,91,91,25,84,109,518,395,913,0.000333,2.059784,48,296608.9098,16478.27277,6179.352289,653.051068,14,0
0,0,91,91,25,84,109,518,395,913,0.000333,2.059784,48,296608.9098,16478.27277,6179.352289,653.051068,14,0
0,0,93,93,25,88,113,553,420,973,0.000333,2.212011,48,318529.6383,17696.09101,6636.03413,684.526387,13,0
0,0,89,89,26,78,104,513,385,898,0.000333,2.005665,52,312883.7331,17382.42962,6016.994867,612.472806,16,0
0,0,91,91,25,84,109,518,395,913,0.000333,2.059784,48,296608.9098,16478.27277,6179.352289,653.051068,14,0
0,0,91,91,25,84,109,518,395,913,0.000333,2.059784,48,296608.9098,16478.27277,6179.352289,653.051068,14,0
0,0,87,87,25,77,102,492,375,867,0.000333,1.928331,48,277679.653,15426.64739,5784.992771,598.638968,13,0
0,0,85,85,25,76,101,479,368,847,0.000333,1.879835,48,270696.246,15038.68034,5639.505126,590.938896,11,0
0,0,85,85,25,76,101,479,368,847,0.000333,1.879835,48,270696.246,15038.68034,5639.505126,590.938896,11,0
0,0,89,89,26,78,104,513,385,898,0.000333,2.005665,52,312883.7331,17382.42962,6016.994867,612.472806,16,0
0,0,89,89,26,78,104,513,385,898,0.000333,2.005665,52,312883.7331,17382.42962,6016.994867,612.472806,16,0
0,0,89,89,26,78,104,513,385,898,0.000333,2.005665,52,312883.7331,17382.42962,6016.994867,612.472806,16,0
0,0,91,91,25,84,109,518,395,913,0.000333,2.059784,48,296608.9098,16478.27277,6179.352289,653.051068,14,0
0,0,91,91,25,84,109,518,395,913,0.000333,2.059784,48,296608.9098,16478.27277,6179.352289,653.051068,14,0
0,0,85,85,25,76,101,479,368,847,0.000333,1.879835,48,270696.246,15038.68034,5639.505126,590.938896,11,0
0,0,85,85,25,76,101,479,368,847,0.000333,1.879835,48,270696.246,15038.68034,5639.505126,590.938896,11,0
0,0,13,13,21,31,52,138,67,205,0.000333,0.38953,20,23371.80284,1298.433491,1168.590142,245.818752,13,0
0,0,26,26,24,43,67,175,104,279,0.000333,0.564146,24,40618.53322,2256.585179,1692.438884,343.368484,15,0
0,0,10,10,19,20,39,93,42,135,0.000333,0.237843,18,12843.52739,713.5293,713.5293,167.149185,10,0
0,0,10,10,20,22,42,97,45,142,0.000333,0.255236,20,15314.18148,850.78786,765.709074,184.546058,9,0
0,0,38,38,26,44,70,236,145,381,0.000333,0.778419,39,91075.01635,5059.72313,2335.256829,362.426424,22,0
0,0,11,11,21,21,42,97,44,141,0.000333,0.253439,20,15206.33513,844.796396,760.316757,184.477332,12,0
0,0,37,37,26,43,69,232,144,376,0.000333,0.765602,39,89575.40263,4976.411257,2296.805196,355.540817,21,0
0,0,10,10,21,21,42,91,42,133,0.000333,0.239059,20,14343.56435,796.864686,717.178217,184.477332,11,0
0,0,9,9,19,21,40,77,38,115,0.000333,0.204007,9,5508.195578,306.010865,612.021731,172.949289,9,0
0,0,8,8,19,21,40,72,36,108,0.000333,0.191589,9,5172.914108,287.384117,574.768234,172.949289,8,0
0,0,7,7,19,20,39,66,34,100,0.000333,0.17618,9,4756.861997,264.270111,528.540222,167.149185,7,0
0,0,7,7,20,21,41,69,36,105,0.000333,0.187514,10,5625.429605,312.523867,562.54296,178.677228,6,0
0,0,12,12,20,34,54,78,66,144,0.000333,0.276235,10,8287.038003,460.391,828.7038,259.412299,6,0
0,0,13,13,21,40,61,88,75,163,0.000333,0.322237,10,9667.10186,537.061214,966.710186,305.11579,6,0
0,0,4,4,12,16,28,23,19,42,0.000333,0.067303,6,1211.45344,67.302969,201.908907,107.01955,1,0
0,0,4,4,16,17,33,38,28,66,0.000333,0.110977,8,2663.440095,147.968894,332.930012,133.486868,4,0
0,0,3,3,15,14,29,27,20,47,0.000333,0.076108,7,1598.275747,88.793097,228.325107,111.906328,3,0
0,0,35,35,21,57,78,180,152,332,0.000333,0.695585,20,41735.07073,2318.615041,2086.753537,424.713397,12,0
0,0,21,21,17,42,59,91,88,179,0.000333,0.350998,16,16847.88969,935.993872,1052.993106,295.9642,9,0
0,0,21,21,17,42,59,91,88,179,0.000333,0.350998,16,16847.88969,935.993872,1052.993106,295.9642,9,0
0,0,41,41,22,67,89,212,178,390,0.000333,0.841845,22,55561.79284,3086.766269,2525.536038,504.535471,14,0
0,0,37,37,21,59,80,188,158,346,0.000333,0.729129,20,43747.74242,2430.430134,2187.387121,439.314606,13,0
0,0,36,36,21,58,79,183,155,338,0.000333,0.710226,20,42613.55786,2367.419881,2130.677893,432.001564,12,0
0,0,31,31,20,50,70,161,135,296,0.000333,0.604756,20,36285.35546,2015.853081,1814.267773,368.631371,11,0
0,0,36,36,21,58,79,183,155,338,0.000333,0.710226,20,42613.55786,2367.419881,2130.677893,432.001564,12,0
0,0,31,31,20,51,71,131,123,254,0.000333,0.520679,20,31240.71537,1735.595298,1562.035768,375.732254,13,0
0,0,27,27,19,43,62,107,103,210,0.000333,0.416794,18,22506.86205,1250.381225,1250.381225,314.040007,12,0
0,0,26,26,19,42,61,102,100,202,0.000333,0.399336,18,21564.16096,1198.008942,1198.008942,307.187955,11,0
0,0,23,23,19,41,60,92,89,181,0.000333,0.356382,18,19244.64956,1069.147198,1069.147198,300.370255,10,0
0,0,9,9,14,21,35,41,31,72,0.000333,0.123103,7,2585.158641,143.619924,369.308377,145.541635,4,0
0,0,9,9,14,21,35,41,31,72,0.000333,0.123103,7,2585.158641,143.619924,369.308377,145.541635,4,0
0,0,36,36,21,58,79,183,155,338,0.000333,0.710226,20,42613.55786,2367.419881,2130.677893,432.001564,12,0
0,0,35,35,21,57,78,180,152,332,0.000333,0.695585,20,41735.07073,2318.615041,2086.753537,424.713397,12,0
0,0,32,32,20,54,74,167,142,309,0.000333,0.639574,20,38374.4218,2131.912322,1918.72109,397.202487,12,0
0,0,20,20,18,47,65,124,105,229,0.000333,0.459707,18,24824.20013,1379.122229,1379.122229,336.124326,6,0
0,0,28,28,20,57,77,172,139,311,0.000333,0.649657,20,38979.41228,2165.522905,1948.970614,418.913293,8,0
0,0,28,28,20,57,77,172,139,311,0.000333,0.649657,20,38979.41228,2165.522905,1948.970614,418.913293,8,0
0,0,28,28,20,57,77,172,139,311,0.000333,0.649657,20,38979.41228,2165.522905,1948.970614,418.913293,8,0
0,0,28,28,20,57,77,172,139,311,0.000333,0.649657,20,38979.41228,2165.522905,1948.970614,418.913293,8,0
0,0,28,28,20,57,77,172,139,311,0.000333,0.649657,20,38979.41228,2165.522905,1948.970614,418.913293,8,0
0,0,28,28,20,57,77,172,139,311,0.000333,0.649657,20,38979.41228,2165.522905,1948.970614,418.913293,8,0
0,0,28,28,20,57,77,172,139,311,0.000333,0.649657,20,38979.41228,2165.522905,1948.970614,418.913293,8,0
0,0,28,28,20,57,77,172,139,311,0.000333,0.649657,20,38979.41228,2165.522905,1948.970614,418.913293,8,0
0,0,10,10,17,27,44,63,50,113,0.000333,0.205639,8,4935.326183,274.184788,616.915773,197.868831,10,0
0,0,10,10,17,27,44,63,50,113,0.000333,0.205639,8,4935.326183,274.184788,616.915773,197.868831,10,0
0,0,26,26,23,52,75,186,118,304,0.000333,0.631187,22,41658.3394,2314.352189,1893.560882,400.46479,23,0
0,0,32,32,25,57,82,228,142,370,0.000333,0.784098,24,56455.0618,3136.392322,2352.294242,448.571136,26,0
0,0,23,23,18,39,57,95,78,173,0.000333,0.336363,18,18163.6195,1009.089972,1009.089972,281.189337,9,0
0,0,22,22,19,33,52,83,66,149,0.000333,0.283122,18,15288.57932,849.365518,849.365518,247.175629,9,0
0,0,17,17,17,32,49,66,56,122,0.000333,0.228332,8,5479.956808,304.442045,684.994601,229.486868,6,0
0,0,18,18,18,33,51,72,61,133,0.000333,0.251478,9,6789.893134,377.216285,754.43257,241.523656,7,0
0,0,22,22,19,42,61,124,99,223,0.000333,0.440851,18,23805.97967,1322.554426,1322.554426,307.187955,8,0
0,0,17,17,18,35,53,71,58,129,0.000333,0.246301,9,6650.115648,369.450869,738.901739,254.583556,7,0
0,0,13,13,18,28,46,53,49,102,0.000333,0.187801,9,5070.629876,281.70166,563.40332,209.664588,4,0
1,0,21,22,14,41,55,105,79,184,0.000333,0.35459,7,7446.391311,413.688406,1063.770187,272.962601,14,0
1,0,21,22,15,41,56,111,81,192,0.000333,0.371671,7,7805.085015,433.615834,1115.012145,278.262991,14,0
1,0,8,9,13,27,40,49,39,88,0.000333,0.15611,6,2809.978034,156.109891,468.329672,176.487679,6,0
0,0,56,56,33,81,114,411,259,670,0.000333,1.526012,48,219745.7429,12208.09683,4578.036309,679.992856,24,0
0,0,59,59,33,85,118,438,277,715,0.000333,1.640363,48,236212.3095,13122.90608,4921.08978,711.263236,24,0
0,0,61,61,34,86,120,471,288,759,0.000333,1.747443,51,267358.8281,14853.26823,5242.329962,725.632506,25,0
0,0,59,59,34,82,116,453,285,738,0.000333,1.687063,51,258120.6887,14340.03826,5061.189974,694.293001,24,0
0,0,15,15,18,32,50,96,55,151,0.000333,0.284074,9,7670.000562,426.111142,852.222285,235.05865,9,0
0,0,29,29,27,57,84,259,173,432,0.000333,0.920494,39,107697.7639,5983.209108,2761.481127,460.856693,11,0
0,0,47,47,31,73,104,332,206,538,0.000333,1.201612,30,108145.0971,6008.060947,3604.836568,605.437278,21,0
0,0,56,56,33,81,114,411,259,670,0.000333,1.526012,48,219745.7429,12208.09683,4578.036309,679.992856,24,0
0,0,50,50,32,78,110,359,224,583,0.000333,1.317844,32,126513.0468,7028.502601,3953.532713,650.261373,21,0
0,0,59,59,33,85,118,438,277,715,0.000333,1.640363,48,236212.3095,13122.90608,4921.08978,711.263236,24,0
0,0,52,52,32,80,112,392,235,627,0.000333,1.422737,32,136582.7692,7587.93162,4268.211536,665.754248,22,0
0,0,61,61,34,86,120,471,288,759,0.000333,1.747443,51,267358.8281,14853.26823,5242.329962,725.632506,25,0
0,0,50,50,33,76,109,374,232,606,0.000333,1.367173,48,196872.9456,10937.38587,4101.519701,641.307497,21,0
0,0,59,59,34,82,116,453,285,738,0.000333,1.687063,51,258120.6887,14340.03826,5061.189974,694.293001,24,0
0,0,12,12,17,33,50,78,51,129,0.000333,0.242686,8,5824.459588,323.581088,728.057448,235.951874,6,0
0,0,18,18,19,27,46,79,66,145,0.000333,0.266972,18,14416.49671,800.916484,800.916484,209.092585,8,0
0,0,12,12,17,25,42,52,46,98,0.000333,0.176149,8,4227.576859,234.865381,528.447107,185.583273,6,0
0,0,18,18,19,33,52,99,95,194,0.000333,0.368628,18,19905.9355,1105.885305,1105.885305,247.175629,5,0
0,0,10,10,15,24,39,42,42,84,0.000333,0.147991,7,3107.816505,172.656472,443.973786,168.642459,3,0
0,0,16,16,19,37,56,92,82,174,0.000333,0.336827,18,18188.63562,1010.479756,1010.479756,273.460397,6,0
0,0,9,9,13,22,35,50,35,85,0.000333,0.14533,6,2615.934339,145.329685,435.989056,146.213212,4,0
0,0,15,15,15,26,41,76,49,125,0.000333,0.223231,7,4687.858004,260.436556,669.694001,180.814792,6,0
0,0,5,5,15,16,31,36,22,58,0.000333,0.095781,7,2011.403702,111.74465,287.343386,122.603359,4,0
0,0,7,7,14,20,34,34,28,62,0.000333,0.105141,7,2207.958873,122.664382,315.422696,139.741531,2,0
0,0,4,4,12,15,27,24,19,43,0.000333,0.068153,6,1226.760976,68.153388,204.460163,101.622909,2,0
0,0,88,88,27,92,119,371,325,696,0.000333,1.599598,39,187152.9334,10397.38519,4798.793163,728.549663,14,0
0,0,81,81,27,88,115,345,303,648,0.000333,1.478626,39,172999.2246,9611.068032,4435.877553,696.811945,14,0
0,0,81,81,27,88,115,345,303,648,0.000333,1.478626,39,172999.2246,9611.068032,4435.877553,696.811945,14,0
0,0,81,81,27,88,115,345,303,648,0.000333,1.478626,39,172999.2246,9611.068032,4435.877553,696.811945,14,0
0,0,81,81,27,88,115,345,303,648,0.000333,1.478626,39,172999.2246,9611.068032,4435.877553,696.811945,14,0
0,0,81,81,27,88,115,345,303,648,0.000333,1.478626,39,172999.2246,9611.068032,4435.877553,696.811945,14,0
0,0,81,81,27,88,115,345,303,648,0.000333,1.478626,39,172999.2246,9611.068032,4435.877553,696.811945,14,0
0,0,81,81,27,88,115,345,303,648,0.000333,1.478626,39,172999.2246,9611.068032,4435.877553,696.811945,14,0
0,0,81,81,27,88,115,345,303,648,0.000333,1.478626,39,172999.2246,9611.068032,4435.877553,696.811945,14,0
0,0,81,81,27,88,115,345,303,648,0.000333,1.478626,39,172999.2246,9611.068032,4435.877553,696.811945,14,0
0,0,81,81,27,88,115,345,303,648,0.000333,1.478626,39,172999.2246,9611.068032,4435.877553,696.811945,14,0
0,0,81,81,27,88,115,345,303,648,0.000333,1.478626,39,172999.2246,9611.068032,4435.877553,696.811945,14,0
0,0,81,81,27,88,115,345,303,648,0.000333,1.478626,39,172999.2246,9611.068032,4435.877553,696.811945,14,0
0,0,7,7,17,14,31,31,21,52,0.000333,0.085873,8,2060.945665,114.496981,257.618208,122.789837,4,0
0,0,7,7,17,14,31,31,21,52,0.000333,0.085873,8,2060.945665,114.496981,257.618208,122.789837,4,0
0,0,4,4,11,11,22,16,13,29,0.000333,0.043108,5,646.617585,35.923199,129.323517,76.107496,3,0
0,0,45,45,26,33,59,239,129,368,0.000333,0.721604,39,84427.69304,4690.427391,2164.812642,288.676439,24,0
0,0,43,43,26,30,56,229,125,354,0.000333,0.685268,52,106901.7894,5938.9883,2055.803642,269.418151,23,0
0,0,27,27,24,30,54,150,86,236,0.000333,0.452718,24,32595.68281,1810.871267,1358.153451,257.245818,13,0
0,0,11,11,19,38,57,91,66,157,0.000333,0.305255,9,8241.87359,457.881866,915.763732,280.131868,2,0
1,0,21,22,14,41,55,104,78,182,0.000333,0.350736,7,7365.452275,409.191793,1052.207468,272.962601,14,0
1,0,21,22,15,41,56,110,80,190,0.000333,0.367799,7,7723.782046,429.099003,1103.397435,278.262991,14,0
1,0,8,9,12,26,38,48,38,86,0.000333,0.150441,6,2707.930597,150.440589,451.321766,165.230983,6,0
1,0,40,41,23,83,106,226,177,403,0.000333,0.903784,22,59649.74275,3313.874597,2711.351943,633.170198,21,0
1,0,23,24,21,49,70,124,95,219,0.000333,0.447438,10,13423.12981,745.729434,1342.312981,367.359448,13,0
1,0,42,43,24,84,108,240,187,427,0.000333,0.961446,24,69224.08712,3845.782618,2884.336963,646.993764,22,0
1,0,42,43,24,84,108,240,187,427,0.000333,0.961446,24,69224.08712,3845.782618,2884.336963,646.993764,22,0
1,0,42,43,24,84,108,240,187,427,0.000333,0.961446,24,69224.08712,3845.782618,2884.336963,646.993764,22,0
1,0,42,43,24,84,108,240,187,427,0.000333,0.961446,24,69224.08712,3845.782618,2884.336963,646.993764,22,0
0,0,28,28,18,32,50,134,87,221,0.000333,0.415764,18,22451.25992,1247.292218,1247.292218,235.05865,8,0
0,0,27,27,18,32,50,124,78,202,0.000333,0.38002,18,20521.06111,1140.05895,1140.05895,235.05865,8,0
0,0,28,28,18,32,50,134,87,221,0.000333,0.415764,18,22451.25992,1247.292218,1247.292218,235.05865,8,0
0,0,24,24,18,32,50,104,71,175,0.000333,0.329225,18,17778.147,987.674833,987.674833,235.05865,6,0
0,0,23,23,18,28,46,94,62,156,0.000333,0.287225,18,15510.16197,861.675665,861.675665,209.664588,6,0
0,0,23,23,18,31,49,99,68,167,0.000333,0.312552,18,16877.81779,937.656544,937.656544,228.638736,6,0
0,0,25,25,21,32,53,107,87,194,0.000333,0.370406,20,22224.33136,1234.685076,1111.216568,252.238666,9,0
0,0,23,23,20,31,51,100,81,181,0.000333,0.342236,20,20534.17974,1140.787763,1026.708987,240.018648,9,0
0,0,25,25,21,32,53,107,87,194,0.000333,0.370406,20,22224.33136,1234.685076,1111.216568,252.238666,9,0
0,0,20,20,20,28,48,81,70,151,0.000333,0.28111,20,16866.58675,937.032597,843.329338,221.0445,7,0
0,0,17,17,21,29,50,70,61,131,0.000333,0.246448,20,14786.90322,821.494623,739.345161,233.120115,6,0
0,0,15,15,20,28,48,63,55,118,0.000333,0.219675,10,6590.255751,366.125319,659.025575,221.0445,6,0
0,0,23,23,21,32,53,101,82,183,0.000333,0.349403,20,20964.18886,1164.677159,1048.209443,252.238666,9,0
0,0,15,15,20,26,46,58,52,110,0.000333,0.202531,20,12151.8363,675.102017,607.591815,208.649995,6,0
1,0,3,4,12,43,55,85,45,130,0.000333,0.250526,6,4509.460577,250.525588,751.576763,276.348934,1,0
1,0,50,51,27,85,112,213,167,380,0.000333,0.862265,13,33628.33332,1868.24074,2586.79487,673.180192,29,0
1,0,48,49,27,84,111,211,163,374,0.000333,0.847037,13,33034.44994,1835.247219,2541.111534,665.336626,29,0
1,0,48,49,27,84,111,211,163,374,0.000333,0.847037,13,33034.44994,1835.247219,2541.111534,665.336626,29,0
1,0,48,49,27,84,111,211,163,374,0.000333,0.847037,13,33034.44994,1835.247219,2541.111534,665.336626,29,0
1,0,48,49,27,84,111,211,163,374,0.000333,0.847037,13,33034.44994,1835.247219,2541.111534,665.336626,29,0
1,0,18,19,14,36,50,66,51,117,0.000333,0.22011,7,4622.318219,256.795457,660.331174,239.420269,9,0
1,0,18,19,14,29,43,63,43,106,0.000333,0.191728,7,4026.288448,223.682692,575.184064,194.184418,12,0
1,0,6,7,12,18,30,24,29,53,0.000333,0.086688,6,1560.391209,86.688401,260.065202,118.0782,2,0
0,0,25,25,25,35,60,90,79,169,0.000333,0.332755,24,23958.34826,1331.019348,998.264511,295.62131,9,0
0,0,20,20,23,33,56,69,61,130,0.000333,0.251652,11,8304.517539,461.362085,754.95614,270.506931,6,0
1,0,14,15,20,32,52,61,48,109,0.000333,0.207116,10,6213.479293,345.193294,621.347929,246.438562,5,0
1,0,13,14,20,32,52,62,50,112,0.000333,0.212816,10,6384.492484,354.694027,638.449248,246.438562,4,0
1,0,11,12,20,28,48,57,44,101,0.000333,0.188027,10,5640.812126,313.378451,564.081213,221.0445,4,0
1,0,14,15,20,32,52,61,48,109,0.000333,0.207116,10,6213.479293,345.193294,621.347929,246.438562,5,0
1,0,13,14,20,32,52,62,50,112,0.000333,0.212816,10,6384.492484,354.694027,638.449248,246.438562,4,0
1,0,12,13,20,28,48,56,42,98,0.000333,0.182442,10,5473.263251,304.070181,547.326325,221.0445,5,0
1,0,10,11,22,25,47,53,38,91,0.000333,0.168489,11,5560.143441,308.896858,505.467586,214.2039,5,0
1,0,6,7,18,21,39,34,26,60,0.000333,0.105708,9,2854.117198,158.562067,317.124133,167.297316,3,0
0,0,9,9,9,18,27,32,29,61,0.000333,0.096683,4,1160.192551,64.455142,290.048138,103.587975,7,0
0,0,8,8,9,18,27,29,27,56,0.000333,0.088758,4,1065.0948,59.171933,266.2737,103.587975,6,0
0,0,7,7,12,16,28,31,28,59,0.000333,0.094545,6,1701.803642,94.544647,283.63394,107.01955,5,0
0,0,6,6,12,16,28,28,26,54,0.000333,0.086532,6,1557.582995,86.532389,259.597166,107.01955,4,0
0,0,66,66,24,92,116,312,246,558,0.000333,1.275584,24,91842.08149,5102.33786,3826.753395,710.2068,17,0
0,0,51,51,25,69,94,232,189,421,0.000333,0.919827,24,66227.56576,3679.309209,2759.481907,537.584592,11,0
0,0,51,51,25,69,94,232,189,421,0.000333,0.919827,24,66227.56576,3679.309209,2759.481907,537.584592,11,0
0,0,49,49,23,69,92,222,181,403,0.000333,0.876332,22,57837.9003,3213.216683,2628.995468,525.530113,10,0
0,0,47,47,23,68,91,215,177,392,0.000333,0.850352,22,56123.22098,3117.956721,2551.055499,517.989398,10,0
0,0,57,57,28,76,104,315,188,503,0.000333,1.12344,28,94368.99299,5242.721833,3370.321178,609.448429,40,0
0,0,68,68,26,87,113,336,211,547,0.000333,1.243546,26,96996.5852,5388.699178,3730.637892,682.747517,46,0
0,0,51,51,25,67,92,256,162,418,0.000333,0.90895,24,65444.37354,3635.79853,2726.848898,522.524381,35,0
0,0,41,41,25,57,82,218,137,355,0.000333,0.75231,24,54166.34308,3009.241282,2256.930962,448.571136,29,0
0,0,27,27,23,37,60,139,78,217,0.000333,0.427265,22,28199.4957,1566.63865,1281.795259,296.7917,18,0
0,0,27,27,21,38,59,131,76,207,0.000333,0.405902,20,24354.14222,1353.007901,1217.707111,291.659911,18,0
0,0,25,25,20,35,55,117,68,185,0.000333,0.356517,10,10695.51547,594.195304,1069.551547,265.963467,18,0
0,0,10,10,15,17,32,48,29,77,0.000333,0.128333,7,2695,149.722222,385,128.090227,7,0
0,0,47,47,25,62,87,258,154,412,0.000333,0.884831,24,63707.82529,3539.323627,2654.49272,485.256576,34,0
0,0,35,35,24,45,69,196,102,298,0.000333,0.60678,24,43688.16692,2427.120384,1820.340288,357.172489,24,0
0,0,19,19,19,26,45,119,57,176,0.000333,0.322189,18,17398.19061,966.566145,966.566145,202.922055,14,0
0,0,57,57,28,76,104,315,188,503,0.000333,1.12344,28,94368.99299,5242.721833,3370.321178,609.448429,40,0
0,0,68,68,26,87,113,336,211,547,0.000333,1.243546,26,96996.5852,5388.699178,3730.637892,682.747517,46,0
0,0,51,51,25,67,92,256,162,418,0.000333,0.90895,24,65444.37354,3635.79853,2726.848898,522.524381,35,0
0,0,41,41,25,57,82,218,137,355,0.000333,0.75231,24,54166.34308,3009.241282,2256.930962,448.571136,29,0
0,0,27,27,23,37,60,139,78,217,0.000333,0.427265,22,28199.4957,1566.63865,1281.795259,296.7917,18,0
0,0,27,27,21,38,59,131,76,207,0.000333,0.405902,20,24354.14222,1353.007901,1217.707111,291.659911,18,0
0,0,25,25,20,35,55,117,68,185,0.000333,0.356517,10,10695.51547,594.195304,1069.551547,265.963467,18,0
0,0,10,10,15,17,32,48,29,77,0.000333,0.128333,7,2695,149.722222,385,128.090227,7,0
0,0,47,47,25,62,87,258,154,412,0.000333,0.884831,24,63707.82529,3539.323627,2654.49272,485.256576,34,0
0,0,35,35,24,45,69,196,102,298,0.000333,0.60678,24,43688.16692,2427.120384,1820.340288,357.172489,24,0
0,0,19,19,19,26,45,119,57,176,0.000333,0.322189,18,17398.19061,966.566145,966.566145,202.922055,14,0
0,0,48,48,26,73,99,264,153,417,0.000333,0.921481,26,71875.48448,3993.082471,2764.441711,574.068625,34,0
0,0,45,45,26,71,97,250,145,395,0.000333,0.868989,26,67781.10489,3765.616938,2606.965573,558.843478,33,0
0,0,53,53,26,76,102,268,174,442,0.000333,0.983071,26,76679.51203,4259.972891,2949.212001,597.053924,36,0
0,0,51,51,25,67,92,256,162,418,0.000333,0.90895,24,65444.37354,3635.79853,2726.848898,522.524381,35,0
0,0,57,57,28,76,104,315,188,503,0.000333,1.12344,28,94368.99299,5242.721833,3370.321178,609.448429,40,0
0,0,68,68,26,87,113,336,211,547,0.000333,1.243546,26,96996.5852,5388.699178,3730.637892,682.747517,46,0
0,0,51,51,25,67,92,256,162,418,0.000333,0.90895,24,65444.37354,3635.79853,2726.848898,522.524381,35,0
0,0,41,41,25,57,82,218,137,355,0.000333,0.75231,24,54166.34308,3009.241282,2256.930962,448.571136,29,0
0,0,27,27,23,37,60,139,78,217,0.000333,0.427265,22,28199.4957,1566.63865,1281.795259,296.7917,18,0
0,0,27,27,21,38,59,131,76,207,0.000333,0.405902,20,24354.14222,1353.007901,1217.707111,291.659911,18,0
0,0,25,25,20,35,55,117,68,185,0.000333,0.356517,10,10695.51547,594.195304,1069.551547,265.963467,18,0
0,0,10,10,15,17,32,48,29,77,0.000333,0.128333,7,2695,149.722222,385,128.090227,7,0
0,0,35,35,24,45,69,196,102,298,0.000333,0.60678,24,43688.16692,2427.120384,1820.340288,357.172489,24,0
0,0,19,19,19,26,45,119,57,176,0.000333,0.322189,18,17398.19061,966.566145,966.566145,202.922055,14,0
0,0,57,57,28,76,104,315,188,503,0.000333,1.12344,28,94368.99299,5242.721833,3370.321178,609.448429,40,0
0,0,68,68,26,87,113,336,211,547,0.000333,1.243546,26,96996.5852,5388.699178,3730.637892,682.747517,46,0
0,0,51,51,25,67,92,256,162,418,0.000333,0.90895,24,65444.37354,3635.79853,2726.848898,522.524381,35,0
0,0,41,41,25,57,82,218,137,355,0.000333,0.75231,24,54166.34308,3009.241282,2256.930962,448.571136,29,0
0,0,27,27,23,37,60,139,78,217,0.000333,0.427265,22,28199.4957,1566.63865,1281.795259,296.7917,18,0
0,0,27,27,21,38,59,131,76,207,0.000333,0.405902,20,24354.14222,1353.007901,1217.707111,291.659911,18,0
0,0,25,25,20,35,55,117,68,185,0.000333,0.356517,10,10695.51547,594.195304,1069.551547,265.963467,18,0
0,0,10,10,15,17,32,48,29,77,0.000333,0.128333,7,2695,149.722222,385,128.090227,7,0
0,0,47,47,25,62,87,258,154,412,0.000333,0.884831,24,63707.82529,3539.323627,2654.49272,485.256576,34,0
0,0,19,19,19,26,45,119,57,176,0.000333,0.322189,18,17398.19061,966.566145,966.566145,202.922055,14,0
0,0,40,40,21,52,73,201,126,327,0.000333,0.674691,20,40481.45262,2248.96959,2024.072631,388.661531,32,0
0,0,27,27,20,39,59,131,77,208,0.000333,0.407863,10,12235.89754,679.772086,1223.589754,292.569248,20,0
0,0,25,25,23,39,62,133,76,209,0.000333,0.414809,11,13688.69732,760.483184,1244.427029,310.172612,17,0
0,0,27,27,23,37,60,139,78,217,0.000333,0.427265,22,28199.4957,1566.63865,1281.795259,296.7917,18,0
0,0,25,25,23,40,63,135,78,213,0.000333,0.424387,11,14004.76686,778.042603,1273.160624,316.919049,16,0
0,0,21,21,17,32,49,100,60,160,0.000333,0.299451,8,7186.8286,399.268256,898.353575,229.486868,13,0
0,0,3,3,9,12,21,15,15,30,0.000333,0.043923,4,527.078091,29.282116,131.769523,71.548875,2,0
0,0,48,48,28,73,101,265,156,421,0.000333,0.934369,28,78486.99696,4360.38872,2803.107034,586.463131,33,0
0,0,39,39,23,55,78,203,128,331,0.000333,0.693489,22,45770.29896,2542.794387,2080.468134,422.016709,27,0
0,0,34,34,23,53,76,182,110,292,0.000333,0.608132,22,40136.68635,2229.815908,1824.394834,407.621709,26,0
0,0,30,30,22,44,66,147,87,234,0.000333,0.471463,11,15558.27046,864.348359,1414.388224,338.322487,21,0
0,0,30,30,25,44,69,163,93,256,0.000333,0.521261,24,37530.77426,2085.043015,1563.782261,356.311396,20,0
0,0,22,22,17,33,50,103,62,165,0.000333,0.310412,8,7449.890171,413.882787,931.236271,235.951874,13,0
0,0,21,21,17,32,49,100,60,160,0.000333,0.299451,8,7186.8286,399.268256,898.353575,229.486868,13,0
0,0,57,57,28,76,104,315,188,503,0.000333,1.12344,28,94368.99299,5242.721833,3370.321178,609.448429,40,0
0,0,68,68,26,87,113,336,211,547,0.000333,1.243546,26,96996.5852,5388.699178,3730.637892,682.747517,46,0
0,0,51,51,25,67,92,256,162,418,0.000333,0.90895,24,65444.37354,3635.79853,2726.848898,522.524381,35,0
0,0,41,41,25,57,82,218,137,355,0.000333,0.75231,24,54166.34308,3009.241282,2256.930962,448.571136,29,0
0,0,27,27,23,37,60,139,78,217,0.000333,0.427265,22,28199.4957,1566.63865,1281.795259,296.7917,18,0
0,0,27,27,21,38,59,131,76,207,0.000333,0.405902,20,24354.14222,1353.007901,1217.707111,291.659911,18,0
0,0,25,25,20,35,55,117,68,185,0.000333,0.356517,10,10695.51547,594.195304,1069.551547,265.963467,18,0
0,0,10,10,15,17,32,48,29,77,0.000333,0.128333,7,2695,149.722222,385,128.090227,7,0
0,0,47,47,25,62,87,258,154,412,0.000333,0.884831,24,63707.82529,3539.323627,2654.49272,485.256576,34,0
0,0,35,35,24,45,69,196,102,298,0.000333,0.60678,24,43688.16692,2427.120384,1820.340288,357.172489,24,0
0,0,44,44,23,71,94,195,178,373,0.000333,0.814954,22,53786.95612,2988.164229,2444.861642,540.67397,11,0
0,0,51,51,23,86,109,243,221,464,0.000333,1.046813,22,69089.62559,3838.312533,3140.437527,656.700694,13,0
0,0,68,68,30,97,127,322,277,599,0.000333,1.395407,30,125586.6638,6977.036879,4186.222127,787.398264,21,0
0,0,51,51,24,83,107,245,218,463,0.000333,1.040433,24,74911.18115,4161.732286,3121.299215,639.167373,16,0
0,0,47,47,24,79,103,220,196,416,0.000333,0.927195,24,66758.02126,3708.778959,2781.584219,608.037779,15,0
0,0,47,47,24,79,103,220,196,416,0.000333,0.927195,24,66758.02126,3708.778959,2781.584219,608.037779,15,0
0,0,46,46,24,76,100,209,189,398,0.000333,0.881418,24,63462.11433,3525.673018,2644.254764,584.881591,14,0
0,0,46,46,24,76,100,209,189,398,0.000333,0.881418,24,63462.11433,3525.673018,2644.254764,584.881591,14,0
0,0,44,44,23,71,94,195,178,373,0.000333,0.814954,22,53786.95612,2988.164229,2444.861642,540.67397,11,0
0,0,51,51,23,86,109,243,221,464,0.000333,1.046813,22,69089.62559,3838.312533,3140.437527,656.700694,13,0
0,0,68,68,30,97,127,322,277,599,0.000333,1.395407,30,125586.6638,6977.036879,4186.222127,787.398264,21,0
0,0,51,51,24,83,107,245,218,463,0.000333,1.040433,24,74911.18115,4161.732286,3121.299215,639.167373,16,0
0,0,47,47,24,79,103,220,196,416,0.000333,0.927195,24,66758.02126,3708.778959,2781.584219,608.037779,15,0
0,0,47,47,24,79,103,220,196,416,0.000333,0.927195,24,66758.02126,3708.778959,2781.584219,608.037779,15,0
0,0,46,46,24,76,100,209,189,398,0.000333,0.881418,24,63462.11433,3525.673018,2644.254764,584.881591,14,0
0,0,46,46,24,76,100,209,189,398,0.000333,0.881418,24,63462.11433,3525.673018,2644.254764,584.881591,14,0
0,0,44,44,23,71,94,195,178,373,0.000333,0.814954,22,53786.95612,2988.164229,2444.861642,540.67397,11,0
0,0,51,51,23,86,109,243,221,464,0.000333,1.046813,22,69089.62559,3838.312533,3140.437527,656.700694,13,0
0,0,68,68,30,97,127,322,277,599,0.000333,1.395407,30,125586.6638,6977.036879,4186.222127,787.398264,21,0
0,0,51,51,24,83,107,245,218,463,0.000333,1.040433,24,74911.18115,4161.732286,3121.299215,639.167373,16,0
0,0,47,47,24,79,103,220,196,416,0.000333,0.927195,24,66758.02126,3708.778959,2781.584219,608.037779,15,0
0,0,47,47,24,79,103,220,196,416,0.000333,0.927195,24,66758.02126,3708.778959,2781.584219,608.037779,15,0
0,0,46,46,24,76,100,209,189,398,0.000333,0.881418,24,63462.11433,3525.673018,2644.254764,584.881591,14,0
0,0,46,46,24,76,100,209,189,398,0.000333,0.881418,24,63462.11433,3525.673018,2644.254764,584.881591,14,0
0,0,44,44,23,71,94,195,178,373,0.000333,0.814954,22,53786.95612,2988.164229,2444.861642,540.67397,11,0
0,0,51,51,23,86,109,243,221,464,0.000333,1.046813,22,69089.62559,3838.312533,3140.437527,656.700694,13,0
0,0,68,68,30,97,127,322,277,599,0.000333,1.395407,30,125586.6638,6977.036879,4186.222127,787.398264,21,0
0,0,51,51,24,83,107,245,218,463,0.000333,1.040433,24,74911.18115,4161.732286,3121.299215,639.167373,16,0
0,0,47,47,24,79,103,220,196,416,0.000333,0.927195,24,66758.02126,3708.778959,2781.584219,608.037779,15,0
0,0,47,47,24,79,103,220,196,416,0.000333,0.927195,24,66758.02126,3708.778959,2781.584219,608.037779,15,0
0,0,46,46,24,76,100,209,189,398,0.000333,0.881418,24,63462.11433,3525.673018,2644.254764,584.881591,14,0
0,0,46,46,24,76,100,209,189,398,0.000333,0.881418,24,63462.11433,3525.673018,2644.254764,584.881591,14,0
0,0,44,44,23,71,94,195,178,373,0.000333,0.814954,22,53786.95612,2988.164229,2444.861642,540.67397,11,0
0,0,51,51,23,86,109,243,221,464,0.000333,1.046813,22,69089.62559,3838.312533,3140.437527,656.700694,13,0
0,0,68,68,30,97,127,322,277,599,0.000333,1.395407,30,125586.6638,6977.036879,4186.222127,787.398264,21,0
0,0,51,51,24,83,107,245,218,463,0.000333,1.040433,24,74911.18115,4161.732286,3121.299215,639.167373,16,0
0,0,47,47,24,79,103,220,196,416,0.000333,0.927195,24,66758.02126,3708.778959,2781.584219,608.037779,15,0
0,0,47,47,24,79,103,220,196,416,0.000333,0.927195,24,66758.02126,3708.778959,2781.584219,608.037779,15,0
0,0,46,46,24,76,100,209,189,398,0.000333,0.881418,24,63462.11433,3525.673018,2644.254764,584.881591,14,0
0,0,46,46,24,76,100,209,189,398,0.000333,0.881418,24,63462.11433,3525.673018,2644.254764,584.881591,14,0
0,0,25,25,17,47,64,117,106,223,0.000333,0.446,16,21408,1189.333333,1338,330.552544,4,0
0,0,25,25,17,47,64,117,106,223,0.000333,0.446,16,21408,1189.333333,1338,330.552544,4,0
0,0,17,17,15,23,38,63,64,127,0.000333,0.222162,14,9330.815119,518.378618,666.486794,162.645284,4,0
0,0,27,27,18,43,61,118,109,227,0.000333,0.448759,18,24232.99276,1346.277376,1346.277376,308.388034,6,0
0,0,87,87,26,190,216,527,448,975,0.000333,2.520338,26,196586.3982,10921.46657,7561.015315,1560.483998,8,0
0,0,57,57,24,131,155,335,285,620,0.000333,1.503732,24,108268.7312,6014.929508,4511.197131,1031.417513,3,0
0,0,31,31,23,56,79,149,126,275,0.000333,0.577847,22,38137.87353,2118.770751,1733.539706,429.253801,9,0
0,0,35,35,21,53,74,149,134,283,0.000333,0.585758,20,35145.50605,1952.528114,1757.275302,395.81845,10,0
0,0,20,20,21,43,64,103,94,197,0.000333,0.394,20,23640,1313.333333,1182,325.56805,6,0
0,0,24,24,19,43,62,103,99,202,0.000333,0.400916,18,21649.45779,1202.747655,1202.747655,314.040007,7,0
0,0,24,24,19,42,61,110,90,200,0.000333,0.395382,18,21350.65442,1186.147468,1186.147468,307.187955,6,0
0,0,30,30,19,43,62,118,105,223,0.000333,0.442595,18,23900.14399,1327.785777,1327.785777,314.040007,7,0
0,0,23,23,19,43,62,111,99,210,0.000333,0.416794,18,22506.86205,1250.381225,1250.381225,314.040007,4,0
0,0,27,27,18,44,62,111,104,215,0.000333,0.426717,18,23042.73972,1280.152207,1280.152207,315.273641,5,0
0,0,27,27,19,47,66,121,96,217,0.000333,0.437211,18,23609.40343,1311.633524,1311.633524,341.776299,8,0
0,0,30,30,19,43,62,118,105,223,0.000333,0.442595,18,23900.14399,1327.785777,1327.785777,314.040007,7,0
0,0,24,24,18,44,62,112,94,206,0.000333,0.408855,18,22078.15992,1226.56444,1226.56444,315.273641,6,0
0,0,25,25,18,42,60,101,93,194,0.000333,0.381979,18,20626.86196,1145.936776,1145.936776,301.535982,5,0
0,0,16,16,18,29,47,91,64,155,0.000333,0.286987,18,15497.3029,860.961272,860.961272,215.940099,3,0
0,0,31,31,19,55,74,172,124,296,0.000333,0.612666,18,33083.96753,1837.998196,1837.998196,398.685407,3,0
0,0,31,31,18,50,68,187,143,330,0.000333,0.669621,18,36159.52928,2008.862738,2008.862738,357.25146,3,0
0,0,47,47,24,79,103,220,196,416,0.000333,0.927195,24,66758.02126,3708.778959,2781.584219,608.037779,15,0
0,0,44,44,23,71,94,195,178,373,0.000333,0.814954,22,53786.95612,2988.164229,2444.861642,540.67397,11,0
0,0,51,51,24,83,107,245,218,463,0.000333,1.040433,24,74911.18115,4161.732286,3121.299215,639.167373,16,0
0,0,51,51,24,83,107,245,218,463,0.000333,1.040433,24,74911.18115,4161.732286,3121.299215,639.167373,16,0
0,0,46,46,24,76,100,209,189,398,0.000333,0.881418,24,63462.11433,3525.673018,2644.254764,584.881591,14,0
0,0,46,46,24,76,100,209,189,398,0.000333,0.881418,24,63462.11433,3525.673018,2644.254764,584.881591,14,0
0,0,66,66,29,99,128,312,273,585,0.000333,1.365,28,114660,6370,4095,797.187754,18,0
0,0,48,48,23,82,105,222,203,425,0.000333,0.951185,22,62778.19559,3487.677533,2853.554345,625.361189,12,0
0,0,47,47,24,79,103,220,196,416,0.000333,0.927195,24,66758.02126,3708.778959,2781.584219,608.037779,15,0
0,0,44,44,23,71,94,195,178,373,0.000333,0.814954,22,53786.95612,2988.164229,2444.861642,540.67397,11,0
0,0,51,51,24,83,107,245,218,463,0.000333,1.040433,24,74911.18115,4161.732286,3121.299215,639.167373,16,0
0,0,51,51,24,83,107,245,218,463,0.000333,1.040433,24,74911.18115,4161.732286,3121.299215,639.167373,16,0
0,0,46,46,24,76,100,209,189,398,0.000333,0.881418,24,63462.11433,3525.673018,2644.254764,584.881591,14,0
0,0,46,46,24,76,100,209,189,398,0.000333,0.881418,24,63462.11433,3525.673018,2644.254764,584.881591,14,0
0,0,66,66,29,99,128,312,273,585,0.000333,1.365,28,114660,6370,4095,797.187754,18,0
0,0,48,48,23,82,105,222,203,425,0.000333,0.951185,22,62778.19559,3487.677533,2853.554345,625.361189,12,0
0,0,47,47,24,79,103,220,196,416,0.000333,0.927195,24,66758.02126,3708.778959,2781.584219,608.037779,15,0
0,0,44,44,23,71,94,195,178,373,0.000333,0.814954,22,53786.95612,2988.164229,2444.861642,540.67397,11,0
0,0,51,51,24,83,107,245,218,463,0.000333,1.040433,24,74911.18115,4161.732286,3121.299215,639.167373,16,0
0,0,51,51,24,83,107,245,218,463,0.000333,1.040433,24,74911.18115,4161.732286,3121.299215,639.167373,16,0
0,0,46,46,24,76,100,209,189,398,0.000333,0.881418,24,63462.11433,3525.673018,2644.254764,584.881591,14,0
0,0,46,46,24,76,100,209,189,398,0.000333,0.881418,24,63462.11433,3525.673018,2644.254764,584.881591,14,0
0,0,66,66,29,99,128,312,273,585,0.000333,1.365,28,114660,6370,4095,797.187754,18,0
0,0,48,48,23,82,105,222,203,425,0.000333,0.951185,22,62778.19559,3487.677533,2853.554345,625.361189,12,0
0,0,47,47,24,79,103,220,196,416,0.000333,0.927195,24,66758.02126,3708.778959,2781.584219,608.037779,15,0
0,0,44,44,23,71,94,195,178,373,0.000333,0.814954,22,53786.95612,2988.164229,2444.861642,540.67397,11,0
0,0,51,51,24,83,107,245,218,463,0.000333,1.040433,24,74911.18115,4161.732286,3121.299215,639.167373,16,0
0,0,51,51,24,83,107,245,218,463,0.000333,1.040433,24,74911.18115,4161.732286,3121.299215,639.167373,16,0
0,0,46,46,24,76,100,209,189,398,0.000333,0.881418,24,63462.11433,3525.673018,2644.254764,584.881591,14,0
0,0,46,46,24,76,100,209,189,398,0.000333,0.881418,24,63462.11433,3525.673018,2644.254764,584.881591,14,0
0,0,66,66,29,99,128,312,273,585,0.000333,1.365,28,114660,6370,4095,797.187754,18,0
0,0,48,48,23,82,105,222,203,425,0.000333,0.951185,22,62778.19559,3487.677533,2853.554345,625.361189,12,0
0,0,47,47,24,79,103,220,196,416,0.000333,0.927195,24,66758.02126,3708.778959,2781.584219,608.037779,15,0
0,0,44,44,23,71,94,195,178,373,0.000333,0.814954,22,53786.95612,2988.164229,2444.861642,540.67397,11,0
0,0,51,51,24,83,107,245,218,463,0.000333,1.040433,24,74911.18115,4161.732286,3121.299215,639.167373,16,0
0,0,51,51,24,83,107,245,218,463,0.000333,1.040433,24,74911.18115,4161.732286,3121.299215,639.167373,16,0
0,0,46,46,24,76,100,209,189,398,0.000333,0.881418,24,63462.11433,3525.673018,2644.254764,584.881591,14,0
0,0,46,46,24,76,100,209,189,398,0.000333,0.881418,24,63462.11433,3525.673018,2644.254764,584.881591,14,0
0,0,66,66,29,99,128,312,273,585,0.000333,1.365,28,114660,6370,4095,797.187754,18,0
0,0,48,48,23,82,105,222,203,425,0.000333,0.951185,22,62778.19559,3487.677533,2853.554345,625.361189,12,0
0,0,25,25,17,47,64,117,106,223,0.000333,0.446,16,21408,1189.333333,1338,330.552544,4,0
0,0,25,25,17,47,64,117,106,223,0.000333,0.446,16,21408,1189.333333,1338,330.552544,4,0
0,0,17,17,15,23,38,63,64,127,0.000333,0.222162,14,9330.815119,518.378618,666.486794,162.645284,4,0
0,0,27,27,18,43,61,118,109,227,0.000333,0.448759,18,24232.99276,1346.277376,1346.277376,308.388034,6,0
0,0,87,87,26,190,216,527,448,975,0.000333,2.520338,26,196586.3982,10921.46657,7561.015315,1560.483998,8,0
0,0,57,57,24,131,155,335,285,620,0.000333,1.503732,24,108268.7312,6014.929508,4511.197131,1031.417513,3,0
0,0,31,31,23,56,79,149,126,275,0.000333,0.577847,22,38137.87353,2118.770751,1733.539706,429.253801,9,0
0,0,35,35,21,53,74,149,134,283,0.000333,0.585758,20,35145.50605,1952.528114,1757.275302,395.81845,10,0
0,0,20,20,21,43,64,103,94,197,0.000333,0.394,20,23640,1313.333333,1182,325.56805,6,0
0,0,24,24,19,43,62,103,99,202,0.000333,0.400916,18,21649.45779,1202.747655,1202.747655,314.040007,7,0
0,0,24,24,19,42,61,110,90,200,0.000333,0.395382,18,21350.65442,1186.147468,1186.147468,307.187955,6,0
0,0,30,30,19,43,62,118,105,223,0.000333,0.442595,18,23900.14399,1327.785777,1327.785777,314.040007,7,0
0,0,23,23,19,43,62,111,99,210,0.000333,0.416794,18,22506.86205,1250.381225,1250.381225,314.040007,4,0
0,0,27,27,18,44,62,111,104,215,0.000333,0.426717,18,23042.73972,1280.152207,1280.152207,315.273641,5,0
0,0,31,31,20,51,71,141,113,254,0.000333,0.520679,20,31240.71537,1735.595298,1562.035768,375.732254,8,0
0,0,34,34,21,47,68,138,122,260,0.000333,0.52758,20,31654.80678,1758.600376,1582.740339,353.304342,7,0
0,0,24,24,18,44,62,112,94,206,0.000333,0.408855,18,22078.15992,1226.56444,1226.56444,315.273641,6,0
0,0,25,25,18,42,60,101,93,194,0.000333,0.381979,18,20626.86196,1145.936776,1145.936776,301.535982,5,0
0,0,16,16,18,29,47,91,64,155,0.000333,0.286987,18,15497.3029,860.961272,860.961272,215.940099,3,0
0,0,31,31,19,55,74,172,124,296,0.000333,0.612666,18,33083.96753,1837.998196,1837.998196,398.685407,3,0
0,0,31,31,18,50,68,187,143,330,0.000333,0.669621,18,36159.52928,2008.862738,2008.862738,357.25146,3,0
0,0,105,105,33,100,133,528,414,942,0.000333,2.215359,64,425348.8675,23630.49264,6646.076054,830.850625,66,0
0,0,104,104,33,100,133,525,410,935,0.000333,2.198896,64,422188.1009,23454.8945,6596.689077,830.850625,66,0
0,0,103,103,33,100,133,523,407,930,0.000333,2.187138,64,419930.4106,23329.46725,6561.412665,830.850625,66,0
0,0,103,103,33,100,133,523,407,930,0.000333,2.187138,64,419930.4106,23329.46725,6561.412665,830.850625,66,0
0,0,105,105,32,100,132,536,418,954,0.000333,2.240117,64,430102.5274,23894.58485,6720.35199,824.385619,66,0
0,0,104,104,32,100,132,533,414,947,0.000333,2.22368,64,426946.6388,23719.25771,6671.041231,824.385619,66,0
0,0,103,103,32,100,132,531,411,942,0.000333,2.21194,64,424692.4327,23594.02404,6635.81926,824.385619,66,0
0,0,103,103,32,100,132,531,411,942,0.000333,2.21194,64,424692.4327,23594.02404,6635.81926,824.385619,66,0
0,0,115,115,32,102,134,539,427,966,0.000333,2.275281,64,436853.8981,24269.66101,6825.842158,840.587385,65,0
0,0,113,113,31,101,132,532,421,953,0.000333,2.237769,60,402798.4557,22377.69199,6713.307596,826.059445,65,0
0,0,106,106,32,99,131,503,392,895,0.000333,2.098305,48,302155.8521,16786.43623,6294.913586,816.306305,64,0
0,0,104,104,32,98,130,497,387,884,0.000333,2.069258,48,297973.111,16554.06173,6207.773147,808.241565,63,0
0,0,104,104,32,98,130,497,387,884,0.000333,2.069258,48,297973.111,16554.06173,6207.773147,808.241565,63,0
0,0,104,104,32,98,130,497,387,884,0.000333,2.069258,48,297973.111,16554.06173,6207.773147,808.241565,63,0
0,0,104,104,32,98,130,497,387,884,0.000333,2.069258,48,297973.111,16554.06173,6207.773147,808.241565,63,0
0,0,105,105,33,100,133,528,414,942,0.000333,2.215359,64,425348.8675,23630.49264,6646.076054,830.850625,66,0
0,0,104,104,33,100,133,525,410,935,0.000333,2.198896,64,422188.1009,23454.8945,6596.689077,830.850625,66,0
0,0,103,103,33,100,133,523,407,930,0.000333,2.187138,64,419930.4106,23329.46725,6561.412665,830.850625,66,0
0,0,103,103,33,100,133,523,407,930,0.000333,2.187138,64,419930.4106,23329.46725,6561.412665,830.850625,66,0
0,0,105,105,32,100,132,536,418,954,0.000333,2.240117,64,430102.5274,23894.58485,6720.35199,824.385619,66,0
0,0,104,104,32,100,132,533,414,947,0.000333,2.22368,64,426946.6388,23719.25771,6671.041231,824.385619,66,0
0,0,103,103,32,100,132,531,411,942,0.000333,2.21194,64,424692.4327,23594.02404,6635.81926,824.385619,66,0
0,0,103,103,32,100,132,531,411,942,0.000333,2.21194,64,424692.4327,23594.02404,6635.81926,824.385619,66,0
0,0,115,115,32,102,134,539,427,966,0.000333,2.275281,64,436853.8981,24269.66101,6825.842158,840.587385,65,0
0,0,113,113,31,101,132,532,421,953,0.000333,2.237769,60,402798.4557,22377.69199,6713.307596,826.059445,65,0
0,0,106,106,32,99,131,503,392,895,0.000333,2.098305,48,302155.8521,16786.43623,6294.913586,816.306305,64,0
0,0,104,104,32,98,130,497,387,884,0.000333,2.069258,48,297973.111,16554.06173,6207.773147,808.241565,63,0
0,0,104,104,32,98,130,497,387,884,0.000333,2.069258,48,297973.111,16554.06173,6207.773147,808.241565,63,0
0,0,104,104,32,98,130,497,387,884,0.000333,2.069258,48,297973.111,16554.06173,6207.773147,808.241565,63,0
0,0,104,104,32,98,130,497,387,884,0.000333,2.069258,48,297973.111,16554.06173,6207.773147,808.241565,63,0
0,0,10,10,16,21,37,60,45,105,0.000333,0.182331,16,8751.881654,486.215647,546.992603,156.238666,7,0
0,0,7,7,12,18,30,37,28,65,0.000333,0.106316,6,1913.687332,106.315963,318.947889,118.0782,5,0
0,0,6,6,11,16,27,31,24,55,0.000333,0.087173,5,1307.594063,72.644115,261.518813,102.053748,4,0
0,0,18,18,22,29,51,123,86,209,0.000333,0.395179,22,26081.81172,1448.98954,1185.536896,238.988944,9,0
0,0,18,18,22,29,51,123,86,209,0.000333,0.395179,22,26081.81172,1448.98954,1185.536896,238.988944,9,0
0,0,18,18,22,29,51,123,86,209,0.000333,0.395179,22,26081.81172,1448.98954,1185.536896,238.988944,9,0
0,0,14,14,19,23,42,90,62,152,0.000333,0.273211,18,14753.38047,819.632248,819.632248,184.752548,9,0
0,0,14,14,19,23,42,90,62,152,0.000333,0.273211,18,14753.38047,819.632248,819.632248,184.752548,9,0
0,0,14,14,21,29,50,92,67,159,0.000333,0.299124,20,17947.46268,997.08126,897.373134,233.120115,7,0
0,0,7,7,12,16,28,36,25,61,0.000333,0.09775,6,1759.491901,97.74955,293.24865,107.01955,5,0
0,0,6,6,11,14,25,30,21,51,0.000333,0.078946,5,1184.183328,65.787963,236.836666,91.356717,4,0
0,0,10,10,17,23,40,64,47,111,0.000333,0.196911,16,9451.744297,525.096905,590.734019,173.528793,7,0
0,0,13,13,18,27,45,78,57,135,0.000333,0.247133,18,13345.20302,741.400168,741.400168,203.440613,11,0
0,0,7,7,12,18,30,37,28,65,0.000333,0.106316,6,1913.687332,106.315963,318.947889,118.0782,5,0
0,0,6,6,11,16,27,31,24,55,0.000333,0.087173,5,1307.594063,72.644115,261.518813,102.053748,4,0
0,0,13,13,21,25,46,92,67,159,0.000333,0.292749,20,17564.92702,975.829279,878.246351,208.335071,8,0
0,0,6,6,12,17,29,34,25,59,0.000333,0.09554,6,1719.725272,95.540293,286.620879,112.506418,5,0
0,0,5,5,12,14,26,28,21,49,0.000333,0.076774,6,1381.929277,76.773849,230.321546,96.322519,4,0
0,0,7,7,15,20,35,42,33,75,0.000333,0.128232,7,2692.873584,149.604088,384.696226,145.041921,6,0
0,0,15,15,21,28,49,99,73,172,0.000333,0.32191,20,19314.60186,1073.033437,965.730093,226.844604,9,0
0,0,5,5,12,14,26,28,21,49,0.000333,0.076774,6,1381.929277,76.773849,230.321546,96.322519,4,0
0,0,13,13,24,28,52,95,67,162,0.000333,0.307824,24,22163.30962,1231.294979,923.471234,244.645038,9,0
0,0,5,5,14,18,32,36,27,63,0.000333,0.105,7,2205,122.5,315,128.361619,5,0
0,0,4,4,13,16,29,30,23,53,0.000333,0.085824,6,1544.837956,85.824331,257.472993,112.105716,4,0
2,0,5,7,14,14,28,26,23,49,0.000333,0.07852,7,1648.922738,91.606819,235.560391,106.605938,2,0
0,0,14,14,13,16,29,56,29,85,0.000333,0.137643,6,2477.570308,137.642795,412.928385,112.105716,2,0
0,0,14,14,13,16,29,56,29,85,0.000333,0.137643,6,2477.570308,137.642795,412.928385,112.105716,2,0
0,0,14,14,13,16,29,56,29,85,0.000333,0.137643,6,2477.570308,137.642795,412.928385,112.105716,2,0
0,0,14,14,13,16,29,56,29,85,0.000333,0.137643,6,2477.570308,137.642795,412.928385,112.105716,2,0
0,0,14,14,13,16,29,56,29,85,0.000333,0.137643,6,2477.570308,137.642795,412.928385,112.105716,2,0
0,0,14,14,13,16,29,56,29,85,0.000333,0.137643,6,2477.570308,137.642795,412.928385,112.105716,2,0
0,0,14,14,13,16,29,56,29,85,0.000333,0.137643,6,2477.570308,137.642795,412.928385,112.105716,2,0
0,0,14,14,13,16,29,56,29,85,0.000333,0.137643,6,2477.570308,137.642795,412.928385,112.105716,2,0
0,0,14,14,13,16,29,56,29,85,0.000333,0.137643,6,2477.570308,137.642795,412.928385,112.105716,2,0
0,0,14,14,13,16,29,56,29,85,0.000333,0.137643,6,2477.570308,137.642795,412.928385,112.105716,2,0
0,0,14,14,13,16,29,56,29,85,0.000333,0.137643,6,2477.570308,137.642795,412.928385,112.105716,2,0
1,0,13,14,17,28,45,67,55,122,0.000333,0.223335,8,5360.048622,297.780479,670.006078,204.092806,3,0
1,0,13,14,17,29,46,67,55,122,0.000333,0.224625,8,5390.996469,299.499804,673.874559,210.368317,3,0
1,0,22,23,22,39,61,106,87,193,0.000333,0.381544,22,25181.91074,1398.995041,1144.632306,304.238182,8,0
0,0,78,78,25,65,90,359,288,647,0.000333,1.400076,48,201610.9898,11200.61054,4200.228953,507.550313,17,0
0,0,9,9,10,13,23,19,16,35,0.000333,0.052775,5,791.623342,43.979075,158.324668,81.324997,1,0
0,0,45,45,25,63,88,179,147,326,0.000333,0.701925,24,50538.59298,2807.69961,2105.774708,492.66504,9,0
0,0,17,17,18,31,49,76,54,130,0.000333,0.243304,9,6569.210518,364.95614,729.91228,228.638736,7,0
0,0,16,16,18,32,50,70,53,123,0.000333,0.231398,9,6247.748802,347.097156,694.194311,235.05865,6,0
0,0,16,16,21,34,55,76,55,131,0.000333,0.252453,10,7573.581225,420.754512,757.358122,265.212402,7,0
0,0,16,16,21,33,54,75,54,129,0.000333,0.24746,10,7423.804878,412.433604,742.380488,258.703672,7,0
0,0,15,15,17,28,45,59,44,103,0.000333,0.188554,8,4525.286951,251.404831,565.660869,204.092806,6,0
0,0,17,17,17,30,47,70,51,121,0.000333,0.224035,8,5376.842008,298.713445,672.105251,216.693586,7,0
0,0,17,17,17,29,46,77,55,132,0.000333,0.243037,8,5832.881426,324.048968,729.110178,210.368317,7,0
0,0,17,17,17,29,46,77,55,132,0.000333,0.243037,8,5832.881426,324.048968,729.110178,210.368317,7,0
0,0,9,9,10,13,23,19,16,35,0.000333,0.052775,5,791.623342,43.979075,158.324668,81.324997,1,0
0,0,44,44,25,61,86,172,142,314,0.000333,0.672616,24,48428.33119,2690.462844,2017.847133,477.871382,9,0
0,0,15,15,17,28,45,59,44,103,0.000333,0.188554,8,4525.286951,251.404831,565.660869,204.092806,6,0
0,0,23,23,17,44,61,98,78,176,0.000333,0.347937,8,8350.478171,463.915454,1043.809771,309.70186,10,0
0,0,17,17,17,29,46,77,55,132,0.000333,0.243037,8,5832.881426,324.048968,729.110178,210.368317,7,0
0,0,17,17,17,29,46,77,55,132,0.000333,0.243037,8,5832.881426,324.048968,729.110178,210.368317,7,0
0,0,51,51,23,78,101,230,151,381,0.000333,0.845593,11,27904.56432,1550.253574,2536.778575,594.303298,20,0
0,0,43,43,24,75,99,361,172,533,0.000333,1.177816,24,84802.72988,4711.262771,3533.447079,577.200502,42,0
1,0,96,97,30,98,128,418,311,729,0.000333,1.701,45,229635,12757.5,5103,795.448283,49,0
1,0,90,91,27,86,113,418,304,722,0.000333,1.64139,39,192042.5992,10669.03329,4924.169211,681.040731,46,0
1,0,87,88,27,86,113,405,294,699,0.000333,1.589102,39,185924.8987,10329.16104,4767.305095,681.040731,44,0
1,0,84,85,27,86,113,392,284,676,0.000333,1.536814,39,179807.1982,9989.288787,4610.440979,681.040731,42,0
1,0,81,82,27,86,113,379,274,653,0.000333,1.484526,39,173689.4976,9649.416535,4453.576862,681.040731,40,0
1,0,99,100,30,99,129,440,325,765,0.000333,1.787863,45,241361.4983,13408.97213,5363.58885,803.513023,51,0
1,0,98,99,30,98,128,434,322,756,0.000333,1.764,45,238140,13230,5292,795.448283,51,0
1,0,99,100,30,99,129,440,325,765,0.000333,1.787863,45,241361.4983,13408.97213,5363.58885,803.513023,51,0
1,0,98,99,30,98,128,434,322,756,0.000333,1.764,45,238140,13230,5292,795.448283,51,0
1,0,97,98,30,99,129,424,314,738,0.000333,1.724762,45,232842.8572,12935.71429,5174.285715,803.513023,49,0
1,0,96,97,30,98,128,418,311,729,0.000333,1.701,45,229635,12757.5,5103,795.448283,49,0
1,0,96,97,30,98,128,418,311,729,0.000333,1.701,45,229635,12757.5,5103,795.448283,49,0
1,0,97,98,30,99,129,424,314,738,0.000333,1.724762,45,232842.8572,12935.71429,5174.285715,803.513023,49,0
1,0,97,98,30,99,129,424,314,738,0.000333,1.724762,45,232842.8572,12935.71429,5174.285715,803.513023,49,0
1,0,96,97,30,98,128,418,311,729,0.000333,1.701,45,229635,12757.5,5103,795.448283,49,0
1,0,90,91,27,86,113,418,304,722,0.000333,1.64139,39,192042.5992,10669.03329,4924.169211,681.040731,46,0
1,0,87,88,27,86,113,405,294,699,0.000333,1.589102,39,185924.8987,10329.16104,4767.305095,681.040731,44,0
1,0,84,85,27,86,113,392,284,676,0.000333,1.536814,39,179807.1982,9989.288787,4610.440979,681.040731,42,0
1,0,81,82,27,86,113,379,274,653,0.000333,1.484526,39,173689.4976,9649.416535,4453.576862,681.040731,40,0
1,0,90,91,27,86,113,418,304,722,0.000333,1.64139,39,192042.5992,10669.03329,4924.169211,681.040731,46,0
1,0,90,91,27,86,113,418,304,722,0.000333,1.64139,39,192042.5992,10669.03329,4924.169211,681.040731,46,0
1,0,54,55,25,59,84,252,180,432,0.000333,0.920494,36,99413.32056,5522.962253,2761.481127,463.172345,26,0
1,0,54,55,25,60,85,253,180,433,0.000333,0.925089,36,99909.58591,5550.532551,2775.266275,470.50984,26,0
2,0,26,28,23,45,68,127,96,223,0.000333,0.452501,22,29865.0927,1659.171817,1357.504214,351.175314,8,0
2,0,25,27,24,42,66,120,89,209,0.000333,0.421093,24,30318.6809,1684.371161,1263.278371,336.516432,8,0
0,0,7,7,16,32,48,57,38,95,0.000333,0.176857,8,4244.571501,235.809528,530.571438,224,2,0
0,0,29,29,19,41,60,128,104,232,0.000333,0.4568,18,24667.17513,1370.398618,1370.398618,300.370255,9,0
0,0,13,13,20,40,60,80,69,149,0.000333,0.293376,10,8801.266987,488.959277,880.126699,299.315686,6,0
0,0,13,13,19,35,54,72,61,133,0.000333,0.255133,9,6888.60034,382.700019,765.400038,260.235528,6,0
0,0,10,10,17,39,56,68,61,129,0.000333,0.249716,8,5993.19028,332.955016,749.148785,275.617555,4,0
0,0,10,10,18,36,54,61,51,112,0.000333,0.214849,9,5800.926602,322.2737,644.5474,261.17595,5,0
0,0,9,9,15,30,45,51,42,93,0.000333,0.170247,7,3575.196366,198.62202,510.742338,205.810077,5,0
0,0,9,9,16,37,53,55,50,105,0.000333,0.200477,8,4811.453182,267.302955,601.431648,256.749775,4,0
0,0,13,13,19,38,57,65,57,122,0.000333,0.237204,9,6404.513236,355.806291,711.612582,280.131868,6,0
0,0,13,13,18,34,52,63,52,115,0.000333,0.218517,9,5899.955108,327.775284,655.550568,248.032387,6,0
0,0,10,10,16,35,51,53,49,102,0.000333,0.192862,8,4628.699079,257.149949,578.587385,243.524906,4,0
0,0,14,14,18,29,47,67,51,118,0.000333,0.21848,9,5898.97336,327.720742,655.441484,215.940099,7,0
0,0,13,13,17,28,45,59,47,106,0.000333,0.194045,8,4657.091426,258.727301,582.136428,204.092806,6,0
0,0,6,6,15,17,32,33,25,58,0.000333,0.096667,7,2030,112.777778,290,128.090227,3,0
0,0,4,4,13,12,25,20,15,35,0.000333,0.054178,6,975.2098,54.178322,162.534967,91.125266,3,0
0,0,34,34,21,47,68,156,112,268,0.000333,0.543813,20,32628.80083,1812.711157,1631.440041,353.304342,14,0
0,0,16,16,19,25,44,78,60,138,0.000333,0.251134,18,13561.22814,753.401563,753.401563,196.807027,7,0
0,0,15,15,18,25,43,72,58,130,0.000333,0.235138,18,12697.45953,705.414418,705.414418,191.155055,6,0
0,0,31,31,19,45,64,145,104,249,0.000333,0.498,18,26892,1494,1494,327.844012,13,0
0,0,20,20,18,26,44,94,72,166,0.000333,0.302089,18,16312.78168,906.265649,906.265649,197.270083,11,0
0,0,21,21,18,27,45,100,75,175,0.000333,0.320358,18,17299.33725,961.074292,961.074292,203.440613,12,0
0,0,19,19,17,23,40,84,65,149,0.000333,0.264322,16,12687.47658,704.85981,792.967286,173.528793,10,0
0,0,36,36,21,48,69,194,141,335,0.000333,0.682119,20,40927.11386,2273.728548,2046.355693,360.316866,9,0
0,0,31,31,20,46,66,166,128,294,0.000333,0.592351,20,35541.03742,1974.502079,1777.051871,340.522412,6,0
0,0,10,10,13,20,33,45,34,79,0.000333,0.132836,6,2391.042813,132.835712,398.507135,134.544278,3,0
1,0,16,17,12,35,47,80,86,166,0.000333,0.307354,12,11064.74099,614.707833,922.061749,222.544456,1,0
1,0,23,24,12,26,38,111,97,208,0.000333,0.363856,18,19648.24061,1091.568923,1091.568923,165.230983,4,0
1,0,18,19,14,36,50,91,94,185,0.000333,0.348038,14,14617.58753,812.088196,1044.113395,239.420269,2,0
1,0,18,19,12,26,38,78,75,153,0.000333,0.267644,12,9635.194915,535.288606,802.93291,165.230983,2,0
1,0,19,20,11,25,36,89,81,170,0.000333,0.292962,15,13183.30875,732.406042,878.88725,154.150153,2,0
1,0,20,21,13,27,40,89,83,172,0.000333,0.305124,18,16476.68938,915.371632,915.371632,176.487679,3,0
1,0,21,22,12,26,38,100,89,189,0.000333,0.330619,18,17853.4494,991.8583,991.8583,165.230983,3,0
1,0,42,43,17,44,61,290,215,505,0.000333,0.998341,32,95840.71538,5324.484188,2995.022355,309.70186,3,0
1,0,62,63,17,46,63,377,285,662,0.000333,1.318986,48,189934.0468,10551.89149,3956.959309,323.570718,5,0
1,0,36,37,17,45,62,253,183,436,0.000333,0.865343,32,83072.94692,4615.163718,2596.029591,316.620258,3,0
1,0,36,37,17,45,62,253,183,436,0.000333,0.865343,32,83072.94692,4615.163718,2596.029591,316.620258,3,0
2,0,12,14,12,21,33,51,46,97,0.000333,0.163102,12,5871.674755,326.204153,489.30623,135.258216,2,0
3,0,20,23,15,31,46,95,80,175,0.000333,0.322208,14,13532.72679,751.818155,966.623342,212.183445,4,0
3,0,20,23,15,31,46,93,83,176,0.000333,0.324049,14,13610.05666,756.114259,972.146904,212.183445,5,0
1,0,43,44,18,45,63,288,214,502,0.000333,1.000198,36,108021.4028,6001.189043,3000.594522,322.192039,3,0
3,0,59,62,22,69,91,371,281,652,0.000333,1.414361,44,186695.6126,10371.97848,4243.082105,519.595683,9,0
1,0,3,4,11,10,21,15,12,27,0.000333,0.039531,5,592.962852,32.942381,118.59257,71.273029,1,0
0,0,29,29,21,42,63,161,128,289,0.000333,0.575811,30,51823.01694,2879.056496,1727.433898,318.715998,22,0
0,0,23,23,20,39,59,136,108,244,0.000333,0.478455,20,28707.29808,1594.849893,1435.364904,292.569248,16,0
0,0,39,39,21,55,76,230,174,404,0.000333,0.841388,30,75724.88146,4206.937859,2524.162715,410.21345,28,0
0,0,27,27,18,36,54,141,115,256,0.000333,0.491084,27,39777.78242,2209.876801,1473.251201,261.17595,16,0
0,0,26,26,19,44,63,170,134,304,0.000333,0.605698,27,49061.51361,2725.639645,1817.093097,320.925614,19,0
0,0,26,26,22,44,66,162,128,290,0.000333,0.584291,22,38563.23448,2142.401916,1752.874295,338.322487,19,0
0,0,42,42,23,59,82,256,194,450,0.000333,0.953633,33,94409.64727,5244.980404,2860.898402,451.117865,31,0
0,0,30,30,19,42,61,167,135,302,0.000333,0.597028,27,48359.23225,2686.624014,1791.082676,307.187955,19,0
0,0,25,25,19,44,63,163,129,292,0.000333,0.581789,18,31416.58328,1745.365738,1745.365738,320.925614,19,0
0,0,25,25,22,44,66,155,123,278,0.000333,0.560114,22,36967.51443,2053.750802,1680.341565,338.322487,19,0
0,0,41,41,23,59,82,249,189,438,0.000333,0.928203,33,91892.05668,5105.11426,2784.607778,451.117865,31,0
0,0,29,29,19,42,61,160,130,290,0.000333,0.573305,27,46437.67335,2579.870742,1719.913828,307.187955,19,0
0,0,12,12,19,36,55,91,79,170,0.000333,0.32761,18,17690.96072,982.831151,982.831151,266.827923,12,0
0,0,22,22,25,51,76,173,145,318,0.000333,0.66228,24,47684.18278,2649.121266,1986.840949,405.390097,34,0
0,0,45,45,34,79,113,318,256,574,0.000333,1.304928,51,199653.9189,11091.88439,3914.782724,670.972416,48,0
0,0,45,45,28,90,118,311,246,557,0.000333,1.277877,28,107341.701,5963.427833,3833.632178,718.872716,36,0
0,0,44,44,28,89,117,329,253,582,0.000333,1.332851,28,111959.4635,6219.970193,3998.552267,710.946213,39,0
2,0,56,58,28,87,115,470,371,841,0.000333,1.919019,56,322395.1994,17910.84441,5757.057133,695.142022,60,0
1,0,31,32,27,77,104,296,224,520,0.000333,1.16141,26,90589.94499,5032.774722,3484.228653,610.924526,39,0
0,0,46,46,29,73,102,334,257,591,0.000333,1.314468,42,165622.9418,9201.274547,3943.403377,592.738642,42,0
0,0,32,32,28,68,96,269,212,481,0.000333,1.055789,42,133029.4124,7390.522913,3167.366963,548.553411,35,0
0,0,48,48,29,74,103,363,278,641,0.000333,1.428682,42,180013.9672,10000.77596,4286.046838,600.380998,47,0
0,0,36,36,27,64,91,274,219,493,0.000333,1.069448,39,125125.3675,6951.409308,3208.342758,512.381963,35,0
0,0,22,22,26,51,77,154,135,289,0.000333,0.6037,26,47088.63407,2616.035226,1811.10131,411.505125,26,0
0,0,45,45,34,79,113,318,256,574,0.000333,1.304928,51,199653.9189,11091.88439,3914.782724,670.972416,48,0
0,0,45,45,28,90,118,311,246,557,0.000333,1.277877,28,107341.701,5963.427833,3833.632178,718.872716,36,0
0,0,44,44,28,89,117,329,253,582,0.000333,1.332851,28,111959.4635,6219.970193,3998.552267,710.946213,39,0
2,0,56,58,28,87,115,470,371,841,0.000333,1.919019,56,322395.1994,17910.84441,5757.057133,695.142022,60,0
1,0,31,32,27,77,104,296,224,520,0.000333,1.16141,26,90589.94499,5032.774722,3484.228653,610.924526,39,0
0,0,46,46,29,73,102,334,257,591,0.000333,1.314468,42,165622.9418,9201.274547,3943.403377,592.738642,42,0
0,0,32,32,28,68,96,269,212,481,0.000333,1.055789,42,133029.4124,7390.522913,3167.366963,548.553411,35,0
0,0,48,48,29,74,103,363,278,641,0.000333,1.428682,42,180013.9672,10000.77596,4286.046838,600.380998,47,0
0,0,36,36,27,64,91,274,219,493,0.000333,1.069448,39,125125.3675,6951.409308,3208.342758,512.381963,35,0
0,0,10,10,18,27,45,63,54,117,0.000333,0.214182,18,11565.84262,642.546812,642.546812,203.440613,7,0
0,0,17,17,21,48,69,138,126,264,0.000333,0.53755,20,32253.00913,1791.833841,1612.650457,360.316866,11,0
0,0,28,28,27,65,92,215,183,398,0.000333,0.865459,26,67505.81912,3750.323285,2596.377659,519.83587,26,0
0,0,18,18,22,40,62,125,100,225,0.000333,0.446565,22,29473.27174,1637.403985,1339.69417,310.984619,19,0
0,0,29,29,28,66,94,224,190,414,0.000333,0.904533,28,75980.79397,4221.15522,2713.599785,533.53595,26,0
0,0,19,19,23,41,64,134,107,241,0.000333,0.482,22,31812,1767.333333,1446,323.701557,19,0
0,0,23,23,26,51,77,168,136,304,0.000333,0.635034,26,49532.68082,2751.815601,1905.103108,411.505125,27,0
0,0,53,53,34,82,116,380,302,682,0.000333,1.559048,51,238534.295,13251.90528,4677.143039,694.293001,60,0
0,0,59,59,31,105,136,390,306,696,0.000333,1.644291,30,147986.2241,8221.456896,4932.874138,858.575865,54,0
0,0,58,58,31,104,135,408,313,721,0.000333,1.700795,45,229607.282,12755.96011,5102.384045,850.425816,57,0
2,0,70,72,32,103,135,549,431,980,0.000333,2.31176,64,443857.8742,24658.77079,6935.279285,848.709554,78,0
1,0,45,46,31,93,124,375,284,659,0.000333,1.527605,45,206226.6916,11457.03842,4582.815369,761.721855,57,0
0,0,36,36,27,72,99,278,220,498,0.000333,1.100473,39,128755.3643,7153.075793,3301.419597,572.616563,47,0
0,0,27,27,21,44,65,145,116,261,0.000333,0.523946,20,31436.75998,1746.486666,1571.837999,332.453657,28,0
0,0,24,24,27,52,79,177,143,320,0.000333,0.672403,26,52447.45583,2913.747546,2017.209839,424.804828,27,0
0,0,54,54,34,83,117,389,309,698,0.000333,1.598505,51,244571.2433,13587.29129,4795.514574,702.102009,60,0
0,0,60,60,32,106,138,399,313,712,0.000333,1.68709,32,161960.6212,8997.81229,5061.269413,873.159568,54,0
0,0,59,59,32,105,137,417,320,737,0.000333,1.74375,48,251099.983,13949.99905,5231.249645,864.995779,57,0
2,0,71,73,33,104,137,558,438,996,0.000333,2.356547,64,452456.9571,25136.49762,7069.639955,863.310737,78,0
1,0,46,47,32,94,126,384,291,675,0.000333,1.569888,48,226063.8695,12559.10386,4709.663948,776.131352,57,0
0,0,37,37,28,73,101,287,227,514,0.000333,1.140774,42,143737.4695,7985.414972,3422.320702,586.463131,47,0
0,0,28,28,22,46,68,154,123,277,0.000333,0.562076,22,37096.99856,2060.944364,1686.227207,352.191346,28,0
0,0,13,13,15,28,43,70,44,114,0.000333,0.206198,7,4330.159274,240.564404,618.594182,193.209297,4,0
0,0,17,17,16,30,46,104,67,171,0.000333,0.314843,16,15112.46551,839.581417,944.529094,211.206718,3,0
0,0,15,15,16,28,44,86,55,141,0.000333,0.256593,8,6158.238866,342.124381,769.779858,198.605938,3,0
0,0,13,13,15,26,41,65,42,107,0.000333,0.191086,7,4012.806451,222.933692,573.258064,180.814792,3,0
0,0,5,5,13,16,29,32,20,52,0.000333,0.084205,6,1515.69007,84.205004,252.615012,112.105716,3,0
0,0,7,7,16,20,36,43,27,70,0.000333,0.120632,8,2895.158001,160.842111,361.89475,150.438562,2,0
0,0,5,5,13,16,29,32,20,52,0.000333,0.084205,6,1515.69007,84.205004,252.615012,112.105716,3,0
0,0,7,7,16,20,36,43,27,70,0.000333,0.120632,8,2895.158001,160.842111,361.89475,150.438562,2,0
0,0,60,60,23,66,89,271,220,491,0.000333,1.059862,33,104926.3088,5829.239377,3179.585115,502.971937,20,0
0,0,63,63,25,83,108,333,263,596,0.000333,1.341971,36,144932.8662,8051.825903,4025.912951,645.224678,36,0
0,0,64,64,24,67,91,295,234,529,0.000333,1.147541,36,123934.4411,6885.246729,3442.623365,516.467076,23,0
0,0,62,62,24,68,92,281,227,508,0.000333,1.104656,36,119302.9011,6627.938947,3313.969474,523.986573,21,0
0,0,62,62,24,67,91,284,228,512,0.000333,1.110664,36,119951.6708,6663.981712,3331.990856,516.467076,21,0
0,0,61,61,24,67,91,278,225,503,0.000333,1.09114,36,117843.1453,6546.841408,3273.420704,516.467076,20,0
0,0,60,60,23,66,89,271,220,491,0.000333,1.059862,33,104926.3088,5829.239377,3179.585115,502.971937,20,0
0,0,60,60,23,66,89,271,220,491,0.000333,1.059862,33,104926.3088,5829.239377,3179.585115,502.971937,20,0
0,0,63,63,25,83,108,333,263,596,0.000333,1.341971,36,144932.8662,8051.825903,4025.912951,645.224678,36,0
0,0,64,64,24,67,91,295,234,529,0.000333,1.147541,36,123934.4411,6885.246729,3442.623365,516.467076,23,0
0,0,62,62,24,68,92,281,227,508,0.000333,1.104656,36,119302.9011,6627.938947,3313.969474,523.986573,21,0
0,0,62,62,24,67,91,284,228,512,0.000333,1.110664,36,119951.6708,6663.981712,3331.990856,516.467076,21,0
0,0,61,61,24,67,91,278,225,503,0.000333,1.09114,36,117843.1453,6546.841408,3273.420704,516.467076,20,0
0,0,60,60,23,66,89,271,220,491,0.000333,1.059862,33,104926.3088,5829.239377,3179.585115,502.971937,20,0
1,0,25,26,23,48,71,104,81,185,0.000333,0.379234,11,12514.73539,695.263077,1137.703217,372.120125,7,0
1,0,28,29,25,48,73,115,88,203,0.000333,0.418845,12,15078.41263,837.68959,1256.534385,384.174605,8,0
1,0,25,26,23,48,71,104,81,185,0.000333,0.379234,11,12514.73539,695.263077,1137.703217,372.120125,7,0
1,0,28,29,25,48,73,115,88,203,0.000333,0.418845,12,15078.41263,837.68959,1256.534385,384.174605,8,0
1,0,6,7,15,22,37,59,30,89,0.000333,0.154547,7,3245.489447,180.304969,463.64135,156.710855,3,0
1,0,3,4,12,9,21,21,11,32,0.000333,0.046851,6,843.324945,46.851386,140.554158,71.548875,1,0
0,0,5,5,12,17,29,28,23,51,0.000333,0.082586,6,1486.542185,82.585677,247.757031,112.506418,2,0
0,0,44,44,27,52,79,180,139,319,0.000333,0.670302,26,52283.55753,2904.642085,2010.906059,424.804828,11,0
0,0,51,51,25,65,90,244,180,424,0.000333,0.917515,24,66061.09711,3670.06095,2752.545713,507.550313,18,0
0,0,24,24,19,35,54,132,106,238,0.000333,0.456554,27,36980.90709,2054.494838,1369.663226,260.235528,8,0
0,0,49,49,25,52,77,218,165,383,0.000333,0.80006,36,86406.45282,4800.35849,2400.179245,412.51927,13,0
0,0,30,30,22,43,65,158,126,284,0.000333,0.570117,22,37627.7541,2090.430783,1710.352459,331.43688,10,0
0,0,30,30,21,50,71,176,132,308,0.000333,0.631374,20,37882.44226,2104.580125,1894.122113,374.431475,12,0
0,0,37,37,22,58,80,223,161,384,0.000333,0.809207,22,53407.64855,2967.091586,2427.620388,437.870393,16,0
0,0,28,28,19,36,55,136,109,245,0.000333,0.472144,27,38243.69451,2124.649695,1416.43313,266.827923,8,0
0,0,29,29,21,47,68,148,116,264,0.000333,0.535697,20,32141.8038,1785.655767,1607.09019,353.304342,8,0
0,0,52,52,25,70,95,240,180,420,0.000333,0.91978,24,66224.14453,3679.119141,2759.339355,545.146216,14,0
0,0,29,29,21,47,68,148,116,264,0.000333,0.535697,20,32141.8038,1785.655767,1607.09019,353.304342,8,0
0,0,41,41,25,48,73,183,140,323,0.000333,0.666438,24,47983.51998,2665.75111,1999.313333,384.174605,11,0
0,0,26,26,20,40,60,135,107,242,0.000333,0.476489,20,28589.35048,1588.297249,1429.467524,299.315686,8,0
0,0,29,29,22,48,70,164,121,285,0.000333,0.582282,22,38430.60452,2135.033584,1746.84566,366.185696,10,0
0,0,51,51,25,70,95,292,201,493,0.000333,1.079646,24,77734.53156,4318.585087,3238.938815,545.146216,24,0
0,0,30,30,21,48,69,164,124,288,0.000333,0.586418,20,35185.10087,1954.727826,1759.255044,360.316866,11,0
0,0,29,29,21,46,67,172,126,298,0.000333,0.602565,20,36153.89158,2008.549532,1807.694579,346.322516,12,0
0,0,37,37,23,56,79,204,145,349,0.000333,0.73334,22,48400.42859,2688.912699,2200.019481,429.253801,15,0
0,0,30,30,21,43,64,161,119,280,0.000333,0.56,20,33600,1866.666667,1680,325.56805,11,0
0,0,43,43,24,59,83,232,158,390,0.000333,0.828755,24,59670.36908,3315.020504,2486.265378,457.11504,18,0
0,0,31,31,21,49,70,165,128,293,0.000333,0.598627,20,35917.59848,1995.422138,1795.879924,367.359448,10,0
0,0,32,32,21,51,72,181,133,314,0.000333,0.645785,20,38747.12901,2152.618278,1937.35645,381.532358,11,0
0,0,52,52,25,57,82,253,188,441,0.000333,0.93456,36,100932.4956,5607.360868,2803.680434,448.571136,15,0
0,0,30,30,21,50,71,155,117,272,0.000333,0.557577,20,33454.62433,1858.590241,1672.731217,374.431475,9,0
0,0,27,27,20,48,68,150,116,266,0.000333,0.539755,20,32385.30232,1799.183462,1619.265116,354.516762,8,0
0,0,44,44,27,52,79,180,139,319,0.000333,0.670302,26,52283.55753,2904.642085,2010.906059,424.804828,11,0
0,0,51,51,25,65,90,244,180,424,0.000333,0.917515,24,66061.09711,3670.06095,2752.545713,507.550313,18,0
0,0,24,24,19,35,54,132,106,238,0.000333,0.456554,27,36980.90709,2054.494838,1369.663226,260.235528,8,0
0,0,49,49,25,52,77,218,165,383,0.000333,0.80006,36,86406.45282,4800.35849,2400.179245,412.51927,13,0
0,0,30,30,22,43,65,158,126,284,0.000333,0.570117,22,37627.7541,2090.430783,1710.352459,331.43688,10,0
0,0,30,30,21,50,71,176,132,308,0.000333,0.631374,20,37882.44226,2104.580125,1894.122113,374.431475,12,0
0,0,37,37,22,58,80,223,161,384,0.000333,0.809207,22,53407.64855,2967.091586,2427.620388,437.870393,16,0
0,0,28,28,19,36,55,136,109,245,0.000333,0.472144,27,38243.69451,2124.649695,1416.43313,266.827923,8,0
0,0,29,29,21,47,68,148,116,264,0.000333,0.535697,20,32141.8038,1785.655767,1607.09019,353.304342,8,0
0,0,52,52,25,70,95,240,180,420,0.000333,0.91978,24,66224.14453,3679.119141,2759.339355,545.146216,14,0
0,0,29,29,21,47,68,148,116,264,0.000333,0.535697,20,32141.8038,1785.655767,1607.09019,353.304342,8,0
0,0,41,41,25,48,73,183,140,323,0.000333,0.666438,24,47983.51998,2665.75111,1999.313333,384.174605,11,0
0,0,26,26,20,40,60,135,107,242,0.000333,0.476489,20,28589.35048,1588.297249,1429.467524,299.315686,8,0
0,0,29,29,22,48,70,164,121,285,0.000333,0.582282,22,38430.60452,2135.033584,1746.84566,366.185696,10,0
0,0,51,51,25,70,95,292,201,493,0.000333,1.079646,24,77734.53156,4318.585087,3238.938815,545.146216,24,0
0,0,30,30,21,48,69,164,124,288,0.000333,0.586418,20,35185.10087,1954.727826,1759.255044,360.316866,11,0
0,0,29,29,21,46,67,172,126,298,0.000333,0.602565,20,36153.89158,2008.549532,1807.694579,346.322516,12,0
0,0,37,37,23,56,79,204,145,349,0.000333,0.73334,22,48400.42859,2688.912699,2200.019481,429.253801,15,0
0,0,30,30,21,43,64,161,119,280,0.000333,0.56,20,33600,1866.666667,1680,325.56805,11,0
0,0,43,43,24,59,83,232,158,390,0.000333,0.828755,24,59670.36908,3315.020504,2486.265378,457.11504,18,0
0,0,31,31,21,49,70,165,128,293,0.000333,0.598627,20,35917.59848,1995.422138,1795.879924,367.359448,10,0
0,0,32,32,21,51,72,181,133,314,0.000333,0.645785,20,38747.12901,2152.618278,1937.35645,381.532358,11,0
0,0,52,52,25,57,82,253,188,441,0.000333,0.93456,36,100932.4956,5607.360868,2803.680434,448.571136,15,0
0,0,30,30,21,50,71,155,117,272,0.000333,0.557577,20,33454.62433,1858.590241,1672.731217,374.431475,9,0
0,0,27,27,20,48,68,150,116,266,0.000333,0.539755,20,32385.30232,1799.183462,1619.265116,354.516762,8,0
0,0,38,38,27,50,77,150,116,266,0.000333,0.555655,26,43341.09572,2407.838651,1666.96522,410.574772,10,0
0,0,48,48,25,63,88,221,163,384,0.000333,0.826807,24,59530.1218,3307.228989,2480.421742,492.66504,17,0
0,0,21,21,19,33,52,109,89,198,0.000333,0.376229,18,20316.36716,1128.687064,1128.687064,247.175629,7,0
0,0,46,46,25,50,75,195,148,343,0.000333,0.712162,24,51275.63546,2848.646414,2136.484811,398.289214,12,0
0,0,27,27,22,41,63,135,109,244,0.000333,0.486152,22,32086.03863,1782.557702,1458.456301,317.767128,9,0
0,0,27,27,21,48,69,153,115,268,0.000333,0.545695,20,32741.69109,1818.982838,1637.084554,360.316866,11,0
0,0,34,34,22,56,78,200,144,344,0.000333,0.720726,22,47567.92399,2642.662444,2162.178363,423.319371,15,0
0,0,137,137,28,70,98,625,367,992,0.000333,2.187264,70,459325.4516,25518.08064,6561.792165,563.655749,43,0
0,0,25,25,19,34,53,113,92,205,0.000333,0.391408,18,21136.02648,1174.223693,1174.223693,253.684359,7,0
0,0,26,26,21,45,66,125,99,224,0.000333,0.451315,20,27078.88566,1504.382536,1353.944283,339.372055,7,0
0,0,49,49,25,68,93,217,163,380,0.000333,0.828293,24,59637.12836,3313.173798,2484.880348,530.043878,13,0
0,0,26,26,21,45,66,125,99,224,0.000333,0.451315,20,27078.88566,1504.382536,1353.944283,339.372055,7,0
0,0,38,38,25,46,71,160,123,283,0.000333,0.580126,24,41769.08244,2320.50458,1740.378435,370.180255,10,0
0,0,23,23,20,38,58,112,90,202,0.000333,0.394437,20,23666.24322,1314.79129,1183.312161,285.859807,7,0
0,0,26,26,22,46,68,141,104,245,0.000333,0.497143,22,32811.42471,1822.856929,1491.428396,352.191346,9,0
0,0,48,48,25,68,93,269,184,453,0.000333,0.987413,24,71093.73459,3949.651922,2962.238941,530.043878,23,0
0,0,27,27,21,46,67,141,107,248,0.000333,0.501463,20,30087.80239,1671.544577,1504.390119,346.322516,10,0
0,0,26,26,21,44,65,149,109,258,0.000333,0.517924,20,31075.41792,1726.412106,1553.770896,332.453657,11,0
0,0,34,34,23,54,77,181,128,309,0.000333,0.645479,22,42601.6149,2366.756384,1936.437041,414.80585,14,0
0,0,27,27,21,41,62,138,102,240,0.000333,0.476336,20,28580.14229,1587.785683,1429.007114,311.898298,10,0
0,0,40,40,24,57,81,209,141,350,0.000333,0.739649,24,53254.74002,2958.596668,2218.947501,442.513831,17,0
0,0,28,28,21,47,68,142,111,253,0.000333,0.513376,20,30802.56198,1711.253443,1540.128099,353.304342,9,0
0,0,29,29,21,49,70,158,116,274,0.000333,0.559808,20,33588.47093,1866.026163,1679.423547,367.359448,10,0
0,0,49,49,25,55,80,230,171,401,0.000333,0.845031,36,91263.35398,5070.186332,2535.093166,434.071189,14,0
0,0,27,27,21,48,69,132,100,232,0.000333,0.472393,20,28343.55348,1574.64186,1417.177674,360.316866,8,0
0,0,24,24,20,46,66,127,99,226,0.000333,0.455344,20,27320.66142,1517.814523,1366.033071,340.522412,7,0
0,0,45,45,27,55,82,190,147,337,0.000333,0.714165,26,55704.87066,3094.715037,2142.495026,446.356747,11,0
0,0,52,52,25,68,93,254,188,442,0.000333,0.963436,24,69367.39667,3853.744259,2890.308195,530.043878,18,0
0,0,25,25,19,38,57,142,114,256,0.000333,0.49774,27,40316.93578,2239.829765,1493.219844,280.131868,8,0
0,0,50,50,25,55,80,228,173,401,0.000333,0.845031,36,91263.35398,5070.186332,2535.093166,434.071189,13,0
0,0,31,31,22,46,68,168,134,302,0.000333,0.612805,22,40445.10312,2246.950173,1838.413778,352.191346,10,0
0,0,31,31,21,53,74,186,140,326,0.000333,0.674761,20,40485.63594,2249.201997,2024.281797,395.81845,12,0
0,0,38,38,22,61,83,233,169,402,0.000333,0.854255,22,56380.84873,3132.269374,2562.765851,459.882473,16,0
0,0,29,29,19,39,58,146,117,263,0.000333,0.51355,27,41597.52305,2310.973503,1540.649002,286.841309,8,0
0,0,30,30,21,50,71,158,124,282,0.000333,0.578076,20,34684.57375,1926.920764,1734.228688,374.431475,8,0
0,0,53,53,25,73,98,250,188,438,0.000333,0.965748,24,69533.82988,3862.990549,2897.242912,567.953598,14,0
0,0,30,30,21,50,71,158,124,282,0.000333,0.578076,20,34684.57375,1926.920764,1734.228688,374.431475,8,0
0,0,42,42,25,51,76,193,148,341,0.000333,0.710181,24,51133.03877,2840.724376,2130.543282,405.390097,11,0
0,0,27,27,20,43,63,145,115,260,0.000333,0.518031,20,31081.8556,1726.769756,1554.09278,319.767946,8,0
0,0,30,30,22,51,73,174,129,303,0.000333,0.625172,22,41261.37051,2292.298362,1875.516841,387.401188,10,0
0,0,52,52,25,73,98,302,209,511,0.000333,1.126706,24,81122.80153,4506.822307,3380.11673,567.953598,24,0
0,0,31,31,21,51,72,174,132,306,0.000333,0.629332,20,37759.94101,2097.7745,1887.99705,381.532358,11,0
0,0,30,30,21,49,70,182,134,316,0.000333,0.645618,20,38737.06867,2152.05937,1936.853433,367.359448,12,0
0,0,38,38,23,59,82,214,153,367,0.000333,0.777741,22,51330.87489,2851.715271,2333.221586,451.117865,15,0
0,0,31,31,21,46,67,171,127,298,0.000333,0.602565,20,36153.89158,2008.549532,1807.694579,346.322516,11,0
0,0,44,44,24,62,86,242,166,408,0.000333,0.873972,24,62925.98448,3495.888027,2621.91602,479.199271,18,0
0,0,32,32,21,52,73,175,136,311,0.000333,0.641678,20,38500.70876,2138.928264,1925.035438,388.661531,10,0
0,0,33,33,21,54,75,191,141,332,0.000333,0.689323,20,41359.35611,2297.742006,2067.967805,403.002591,11,0
0,0,53,53,25,60,85,263,196,459,0.000333,0.980637,36,105908.7758,5883.820879,2941.91044,470.50984,15,0
0,0,31,31,21,53,74,165,125,290,0.000333,0.600247,20,36014.82952,2000.823862,1800.741476,395.81845,9,0
0,0,28,28,20,51,71,160,124,284,0.000333,0.582176,20,34930.56364,1940.586869,1746.528182,375.732254,8,0
0,0,14,14,17,30,47,69,56,125,0.000333,0.231441,8,5554.588852,308.58827,694.323606,216.693586,3,0
0,0,44,44,27,52,79,180,139,319,0.000333,0.670302,26,52283.55753,2904.642085,2010.906059,424.804828,11,0
0,0,51,51,25,65,90,244,180,424,0.000333,0.917515,24,66061.09711,3670.06095,2752.545713,507.550313,18,0
0,0,24,24,19,35,54,132,106,238,0.000333,0.456554,27,36980.90709,2054.494838,1369.663226,260.235528,8,0
0,0,49,49,25,52,77,218,165,383,0.000333,0.80006,36,86406.45282,4800.35849,2400.179245,412.51927,13,0
0,0,30,30,22,43,65,158,126,284,0.000333,0.570117,22,37627.7541,2090.430783,1710.352459,331.43688,10,0
0,0,30,30,21,50,71,176,132,308,0.000333,0.631374,20,37882.44226,2104.580125,1894.122113,374.431475,12,0
0,0,37,37,22,58,80,223,161,384,0.000333,0.809207,22,53407.64855,2967.091586,2427.620388,437.870393,16,0
0,0,28,28,19,36,55,136,109,245,0.000333,0.472144,27,38243.69451,2124.649695,1416.43313,266.827923,8,0
0,0,29,29,21,47,68,148,116,264,0.000333,0.535697,20,32141.8038,1785.655767,1607.09019,353.304342,8,0
0,0,52,52,25,70,95,240,180,420,0.000333,0.91978,24,66224.14453,3679.119141,2759.339355,545.146216,14,0
0,0,29,29,21,47,68,148,116,264,0.000333,0.535697,20,32141.8038,1785.655767,1607.09019,353.304342,8,0
0,0,41,41,25,48,73,183,140,323,0.000333,0.666438,24,47983.51998,2665.75111,1999.313333,384.174605,11,0
0,0,26,26,20,40,60,135,107,242,0.000333,0.476489,20,28589.35048,1588.297249,1429.467524,299.315686,8,0
0,0,29,29,22,48,70,164,121,285,0.000333,0.582282,22,38430.60452,2135.033584,1746.84566,366.185696,10,0
0,0,51,51,25,70,95,292,201,493,0.000333,1.079646,24,77734.53156,4318.585087,3238.938815,545.146216,24,0
0,0,30,30,21,48,69,164,124,288,0.000333,0.586418,20,35185.10087,1954.727826,1759.255044,360.316866,11,0
0,0,29,29,21,46,67,172,126,298,0.000333,0.602565,20,36153.89158,2008.549532,1807.694579,346.322516,12,0
0,0,37,37,23,56,79,204,145,349,0.000333,0.73334,22,48400.42859,2688.912699,2200.019481,429.253801,15,0
0,0,30,30,21,43,64,161,119,280,0.000333,0.56,20,33600,1866.666667,1680,325.56805,11,0
0,0,43,43,24,59,83,232,158,390,0.000333,0.828755,24,59670.36908,3315.020504,2486.265378,457.11504,18,0
0,0,31,31,21,49,70,165,128,293,0.000333,0.598627,20,35917.59848,1995.422138,1795.879924,367.359448,10,0
0,0,32,32,21,51,72,181,133,314,0.000333,0.645785,20,38747.12901,2152.618278,1937.35645,381.532358,11,0
0,0,52,52,25,57,82,253,188,441,0.000333,0.93456,36,100932.4956,5607.360868,2803.680434,448.571136,15,0
0,0,30,30,21,50,71,155,117,272,0.000333,0.557577,20,33454.62433,1858.590241,1672.731217,374.431475,9,0
0,0,27,27,20,48,68,150,116,266,0.000333,0.539755,20,32385.30232,1799.183462,1619.265116,354.516762,8,0
0,0,44,44,27,52,79,180,139,319,0.000333,0.670302,26,52283.55753,2904.642085,2010.906059,424.804828,11,0
0,0,51,51,25,65,90,244,180,424,0.000333,0.917515,24,66061.09711,3670.06095,2752.545713,507.550313,18,0
0,0,24,24,19,35,54,132,106,238,0.000333,0.456554,27,36980.90709,2054.494838,1369.663226,260.235528,8,0
0,0,49,49,25,52,77,218,165,383,0.000333,0.80006,36,86406.45282,4800.35849,2400.179245,412.51927,13,0
0,0,30,30,22,43,65,158,126,284,0.000333,0.570117,22,37627.7541,2090.430783,1710.352459,331.43688,10,0
0,0,30,30,21,50,71,176,132,308,0.000333,0.631374,20,37882.44226,2104.580125,1894.122113,374.431475,12,0
0,0,37,37,22,58,80,223,161,384,0.000333,0.809207,22,53407.64855,2967.091586,2427.620388,437.870393,16,0
0,0,28,28,19,36,55,136,109,245,0.000333,0.472144,27,38243.69451,2124.649695,1416.43313,266.827923,8,0
0,0,29,29,21,47,68,148,116,264,0.000333,0.535697,20,32141.8038,1785.655767,1607.09019,353.304342,8,0
0,0,52,52,25,70,95,240,180,420,0.000333,0.91978,24,66224.14453,3679.119141,2759.339355,545.146216,14,0
0,0,29,29,21,47,68,148,116,264,0.000333,0.535697,20,32141.8038,1785.655767,1607.09019,353.304342,8,0
0,0,41,41,25,48,73,183,140,323,0.000333,0.666438,24,47983.51998,2665.75111,1999.313333,384.174605,11,0
0,0,26,26,20,40,60,135,107,242,0.000333,0.476489,20,28589.35048,1588.297249,1429.467524,299.315686,8,0
0,0,29,29,22,48,70,164,121,285,0.000333,0.582282,22,38430.60452,2135.033584,1746.84566,366.185696,10,0
0,0,51,51,25,70,95,292,201,493,0.000333,1.079646,24,77734.53156,4318.585087,3238.938815,545.146216,24,0
0,0,30,30,21,48,69,164,124,288,0.000333,0.586418,20,35185.10087,1954.727826,1759.255044,360.316866,11,0
0,0,29,29,21,46,67,172,126,298,0.000333,0.602565,20,36153.89158,2008.549532,1807.694579,346.322516,12,0
0,0,37,37,23,56,79,204,145,349,0.000333,0.73334,22,48400.42859,2688.912699,2200.019481,429.253801,15,0
0,0,30,30,21,43,64,161,119,280,0.000333,0.56,20,33600,1866.666667,1680,325.56805,11,0
0,0,43,43,24,59,83,232,158,390,0.000333,0.828755,24,59670.36908,3315.020504,2486.265378,457.11504,18,0
0,0,31,31,21,49,70,165,128,293,0.000333,0.598627,20,35917.59848,1995.422138,1795.879924,367.359448,10,0
0,0,32,32,21,51,72,181,133,314,0.000333,0.645785,20,38747.12901,2152.618278,1937.35645,381.532358,11,0
0,0,52,52,25,57,82,253,188,441,0.000333,0.93456,36,100932.4956,5607.360868,2803.680434,448.571136,15,0
0,0,30,30,21,50,71,155,117,272,0.000333,0.557577,20,33454.62433,1858.590241,1672.731217,374.431475,9,0
0,0,27,27,20,48,68,150,116,266,0.000333,0.539755,20,32385.30232,1799.183462,1619.265116,354.516762,8,0
0,0,38,38,27,50,77,150,116,266,0.000333,0.555655,26,43341.09572,2407.838651,1666.96522,410.574772,10,0
0,0,48,48,25,63,88,221,163,384,0.000333,0.826807,24,59530.1218,3307.228989,2480.421742,492.66504,17,0
0,0,21,21,19,33,52,109,89,198,0.000333,0.376229,18,20316.36716,1128.687064,1128.687064,247.175629,7,0
0,0,46,46,25,50,75,195,148,343,0.000333,0.712162,24,51275.63546,2848.646414,2136.484811,398.289214,12,0
0,0,27,27,22,41,63,135,109,244,0.000333,0.486152,22,32086.03863,1782.557702,1458.456301,317.767128,9,0
0,0,27,27,21,48,69,153,115,268,0.000333,0.545695,20,32741.69109,1818.982838,1637.084554,360.316866,11,0
0,0,34,34,22,56,78,200,144,344,0.000333,0.720726,22,47567.92399,2642.662444,2162.178363,423.319371,15,0
0,0,137,137,28,70,98,625,367,992,0.000333,2.187264,70,459325.4516,25518.08064,6561.792165,563.655749,43,0
0,0,25,25,19,34,53,113,92,205,0.000333,0.391408,18,21136.02648,1174.223693,1174.223693,253.684359,7,0
0,0,26,26,21,45,66,125,99,224,0.000333,0.451315,20,27078.88566,1504.382536,1353.944283,339.372055,7,0
0,0,49,49,25,68,93,217,163,380,0.000333,0.828293,24,59637.12836,3313.173798,2484.880348,530.043878,13,0
0,0,26,26,21,45,66,125,99,224,0.000333,0.451315,20,27078.88566,1504.382536,1353.944283,339.372055,7,0
0,0,38,38,25,46,71,160,123,283,0.000333,0.580126,24,41769.08244,2320.50458,1740.378435,370.180255,10,0
0,0,23,23,20,38,58,112,90,202,0.000333,0.394437,20,23666.24322,1314.79129,1183.312161,285.859807,7,0
0,0,26,26,22,46,68,141,104,245,0.000333,0.497143,22,32811.42471,1822.856929,1491.428396,352.191346,9,0
0,0,48,48,25,68,93,269,184,453,0.000333,0.987413,24,71093.73459,3949.651922,2962.238941,530.043878,23,0
0,0,27,27,21,46,67,141,107,248,0.000333,0.501463,20,30087.80239,1671.544577,1504.390119,346.322516,10,0
0,0,26,26,21,44,65,149,109,258,0.000333,0.517924,20,31075.41792,1726.412106,1553.770896,332.453657,11,0
0,0,34,34,23,54,77,181,128,309,0.000333,0.645479,22,42601.6149,2366.756384,1936.437041,414.80585,14,0
0,0,27,27,21,41,62,138,102,240,0.000333,0.476336,20,28580.14229,1587.785683,1429.007114,311.898298,10,0
0,0,40,40,24,57,81,209,141,350,0.000333,0.739649,24,53254.74002,2958.596668,2218.947501,442.513831,17,0
0,0,28,28,21,47,68,142,111,253,0.000333,0.513376,20,30802.56198,1711.253443,1540.128099,353.304342,9,0
0,0,29,29,21,49,70,158,116,274,0.000333,0.559808,20,33588.47093,1866.026163,1679.423547,367.359448,10,0
0,0,49,49,25,55,80,230,171,401,0.000333,0.845031,36,91263.35398,5070.186332,2535.093166,434.071189,14,0
0,0,27,27,21,48,69,132,100,232,0.000333,0.472393,20,28343.55348,1574.64186,1417.177674,360.316866,8,0
0,0,24,24,20,46,66,127,99,226,0.000333,0.455344,20,27320.66142,1517.814523,1366.033071,340.522412,7,0
0,0,45,45,27,55,82,190,147,337,0.000333,0.714165,26,55704.87066,3094.715037,2142.495026,446.356747,11,0
0,0,52,52,25,68,93,254,188,442,0.000333,0.963436,24,69367.39667,3853.744259,2890.308195,530.043878,18,0
0,0,25,25,19,38,57,142,114,256,0.000333,0.49774,27,40316.93578,2239.829765,1493.219844,280.131868,8,0
0,0,50,50,25,55,80,228,173,401,0.000333,0.845031,36,91263.35398,5070.186332,2535.093166,434.071189,13,0
0,0,31,31,22,46,68,168,134,302,0.000333,0.612805,22,40445.10312,2246.950173,1838.413778,352.191346,10,0
0,0,31,31,21,53,74,186,140,326,0.000333,0.674761,20,40485.63594,2249.201997,2024.281797,395.81845,12,0
0,0,38,38,22,61,83,233,169,402,0.000333,0.854255,22,56380.84873,3132.269374,2562.765851,459.882473,16,0
0,0,29,29,19,39,58,146,117,263,0.000333,0.51355,27,41597.52305,2310.973503,1540.649002,286.841309,8,0
0,0,30,30,21,50,71,158,124,282,0.000333,0.578076,20,34684.57375,1926.920764,1734.228688,374.431475,8,0
0,0,53,53,25,73,98,250,188,438,0.000333,0.965748,24,69533.82988,3862.990549,2897.242912,567.953598,14,0
0,0,30,30,21,50,71,158,124,282,0.000333,0.578076,20,34684.57375,1926.920764,1734.228688,374.431475,8,0
0,0,42,42,25,51,76,193,148,341,0.000333,0.710181,24,51133.03877,2840.724376,2130.543282,405.390097,11,0
0,0,27,27,20,43,63,145,115,260,0.000333,0.518031,20,31081.8556,1726.769756,1554.09278,319.767946,8,0
0,0,30,30,22,51,73,174,129,303,0.000333,0.625172,22,41261.37051,2292.298362,1875.516841,387.401188,10,0
0,0,52,52,25,73,98,302,209,511,0.000333,1.126706,24,81122.80153,4506.822307,3380.11673,567.953598,24,0
0,0,31,31,21,51,72,174,132,306,0.000333,0.629332,20,37759.94101,2097.7745,1887.99705,381.532358,11,0
0,0,30,30,21,49,70,182,134,316,0.000333,0.645618,20,38737.06867,2152.05937,1936.853433,367.359448,12,0
0,0,38,38,23,59,82,214,153,367,0.000333,0.777741,22,51330.87489,2851.715271,2333.221586,451.117865,15,0
0,0,31,31,21,46,67,171,127,298,0.000333,0.602565,20,36153.89158,2008.549532,1807.694579,346.322516,11,0
0,0,44,44,24,62,86,242,166,408,0.000333,0.873972,24,62925.98448,3495.888027,2621.91602,479.199271,18,0
0,0,32,32,21,52,73,175,136,311,0.000333,0.641678,20,38500.70876,2138.928264,1925.035438,388.661531,10,0
0,0,33,33,21,54,75,191,141,332,0.000333,0.689323,20,41359.35611,2297.742006,2067.967805,403.002591,11,0
0,0,53,53,25,60,85,263,196,459,0.000333,0.980637,36,105908.7758,5883.820879,2941.91044,470.50984,15,0
0,0,31,31,21,53,74,165,125,290,0.000333,0.600247,20,36014.82952,2000.823862,1800.741476,395.81845,9,0
0,0,28,28,20,51,71,160,124,284,0.000333,0.582176,20,34930.56364,1940.586869,1746.528182,375.732254,8,0
0,0,7,7,13,19,32,31,24,55,0.000333,0.091667,6,1650,91.666667,275,128.816339,2,0
0,0,44,44,22,59,81,262,159,421,0.000333,0.889692,22,58719.69073,3262.20504,2669.076851,445.183436,16,0
0,0,43,43,22,53,75,240,145,385,0.000333,0.799365,22,52758.09431,2931.005239,2398.095196,401.68728,16,0
0,0,45,45,25,60,85,281,172,453,0.000333,0.967818,24,69682.89826,3871.272125,2903.454094,470.50984,17,0
0,0,44,44,25,56,81,254,155,409,0.000333,0.864333,24,62231.96763,3457.331535,2592.998651,441.30828,17,0
0,0,45,45,25,60,85,281,172,453,0.000333,0.967818,24,69682.89826,3871.272125,2903.454094,470.50984,17,0
0,0,42,42,25,50,75,242,146,388,0.000333,0.805594,24,58002.75965,3222.375536,2416.781652,398.289214,16,0
0,0,27,27,23,45,68,160,101,261,0.000333,0.529609,22,34954.21163,1941.900646,1588.827802,351.175314,10,0
0,0,35,35,25,48,73,194,134,328,0.000333,0.676754,24,48726.29893,2707.016607,2030.262455,384.174605,14,0
0,0,65,65,27,74,101,370,260,630,0.000333,1.398224,39,163592.2561,9088.458674,4194.673234,587.881512,15,0
0,0,36,36,25,49,74,208,144,352,0.000333,0.728576,24,52457.46203,2914.303446,2185.727585,391.217187,15,0
0,0,130,130,27,108,135,588,414,1002,0.000333,2.363656,39,276547.7999,15363.76666,7090.969228,857.909813,49,0
0,0,49,49,32,50,82,352,173,525,0.000333,1.112572,48,160210.3105,8900.572806,3337.714802,442.192809,34,0
0,0,82,82,33,70,103,476,247,723,0.000333,1.611447,48,232048.3143,12891.57302,4834.339881,595.514817,44,0
0,0,46,46,32,49,81,345,163,508,0.000333,1.073548,48,154590.9025,8588.383471,3220.643801,435.120782,32,0
0,0,79,79,33,69,102,469,237,706,0.000333,1.570244,48,226115.15,12561.95278,4710.732291,587.953193,42,0
0,0,12,12,23,19,42,66,40,106,0.000333,0.190529,22,12574.88423,698.604679,571.585647,184.752548,6,0
0,0,11,11,21,19,40,63,38,101,0.000333,0.179172,20,10750.29475,597.238597,537.514738,172.949289,6,0
0,0,11,11,21,19,40,63,38,101,0.000333,0.179172,20,10750.29475,597.238597,537.514738,172.949289,6,0
0,0,9,9,18,13,31,48,30,78,0.000333,0.128809,18,6955.69162,386.427312,386.427312,123.164366,5,0
0,0,102,102,32,99,131,461,306,767,0.000333,1.798212,48,258942.5012,14385.69451,5394.635442,816.306305,41,0
0,0,120,120,30,96,126,524,348,872,0.000333,2.028063,45,273788.4642,15210.47023,6084.188093,779.363118,47,0
0,0,119,119,27,69,96,557,374,931,0.000333,2.043533,65,398489.0057,22138.2781,6130.600088,549.87015,51,0
0,0,110,110,28,70,98,524,348,872,0.000333,1.922676,56,323009.5111,17944.97284,5768.026984,563.655749,50,0
0,0,102,102,32,99,131,461,306,767,0.000333,1.798212,48,258942.5012,14385.69451,5394.635442,816.306305,41,0
0,0,120,120,30,96,126,524,348,872,0.000333,2.028063,45,273788.4642,15210.47023,6084.188093,779.363118,47,0
0,0,119,119,27,69,96,557,374,931,0.000333,2.043533,65,398489.0057,22138.2781,6130.600088,549.87015,51,0
0,0,110,110,28,70,98,524,348,872,0.000333,1.922676,56,323009.5111,17944.97284,5768.026984,563.655749,50,0
0,0,84,84,33,96,129,437,372,809,0.000333,1.890694,48,272259.9768,15125.55427,5672.08285,798.621406,23,0
0,0,51,51,31,71,102,257,218,475,0.000333,1.056467,45,142623.0917,7923.505094,3169.402037,590.212131,14,0
0,0,34,34,27,52,79,178,148,326,0.000333,0.685011,26,53430.84562,2968.380312,2055.032524,424.804828,8,0
0,0,36,36,27,56,83,182,153,335,0.000333,0.711879,26,55526.59345,3084.810747,2135.63821,453.593838,9,0
0,0,95,95,35,93,128,467,373,840,0.000333,1.96,68,399840,22213.33333,5880,787.666675,29,0
0,0,36,36,25,51,76,176,151,327,0.000333,0.681024,24,49033.73513,2724.096396,2043.072297,405.390097,7,0
0,0,34,34,27,52,79,178,148,326,0.000333,0.685011,26,53430.84562,2968.380312,2055.032524,424.804828,8,0
0,0,46,46,30,71,101,239,200,439,0.000333,0.974318,30,87688.64523,4871.591402,2922.954841,583.838763,13,0
0,0,85,85,33,83,116,418,328,746,0.000333,1.705351,48,245570.5835,13642.81019,5116.053822,695.593279,31,0
0,0,57,57,29,78,107,287,229,516,0.000333,1.159532,28,97400.71502,5411.150834,3478.596965,631.142822,25,0
0,0,72,72,32,90,122,381,284,665,0.000333,1.536313,48,221229.1358,12290.50755,4608.940329,744.266779,31,0
0,0,48,48,27,68,95,257,202,459,0.000333,1.005188,26,78404.65683,4355.814268,3015.563724,542.329436,20,0
0,0,52,52,27,74,101,276,220,496,0.000333,1.100824,26,85864.29528,4770.238627,3302.472895,587.881512,22,0
0,0,70,70,32,74,106,354,265,619,0.000333,1.388194,48,199899.9725,11105.55403,4164.582761,619.499549,28,0
0,0,89,89,34,104,138,489,393,882,0.000333,2.089906,51,319755.6471,17764.20262,6269.718571,869.819467,26,0
0,0,59,59,30,72,102,273,226,499,0.000333,1.109847,45,149829.3111,8323.850614,3329.540246,591.441318,16,0
0,0,43,43,26,65,91,218,180,398,0.000333,0.863367,26,67342.65894,3741.25883,2590.102267,513.665341,11,0
0,0,43,43,26,65,91,218,180,398,0.000333,0.863367,26,67342.65894,3741.25883,2590.102267,513.665341,11,0
0,0,87,87,34,100,134,458,372,830,0.000333,1.954951,51,299107.5554,16617.08641,5864.854028,837.359356,22,0
0,0,41,41,26,63,89,208,173,381,0.000333,0.822418,26,64148.61537,3563.811965,2467.254437,498.780068,10,0
0,0,40,40,26,62,88,205,170,375,0.000333,0.807429,26,62979.45828,3498.858793,2422.286857,491.371604,10,0
0,0,40,40,26,62,88,205,170,375,0.000333,0.807429,26,62979.45828,3498.858793,2422.286857,491.371604,10,0
0,0,46,46,27,69,96,256,202,458,0.000333,1.005304,26,78413.73346,4356.318525,3015.912825,549.87015,20,0
0,0,54,54,29,75,104,275,220,495,0.000333,1.105573,28,92868.09449,5159.338583,3316.71766,608.042851,24,0
0,0,61,61,31,84,115,337,252,589,0.000333,1.343998,45,181439.7138,10079.9841,4031.99364,690.534749,28,0
0,0,45,45,27,65,92,245,193,438,0.000333,0.95244,26,74290.32356,4127.240198,2857.320137,519.83587,19,0
0,0,49,49,27,71,98,264,211,475,0.000333,1.047329,26,81691.66658,4538.425921,3141.987176,565.014008,21,0
0,0,59,59,31,68,99,310,233,543,0.000333,1.199914,45,161988.329,8999.351612,3599.740645,567.527559,25,0
0,0,86,86,33,96,129,448,374,822,0.000333,1.921076,48,276634.9826,15368.61014,5763.228804,798.621406,23,0
0,0,89,89,33,103,136,474,387,861,0.000333,2.034102,48,292910.6643,16272.81468,6102.305506,855.17456,27,0
0,0,42,42,29,71,100,232,195,427,0.000333,0.945642,28,79433.94461,4412.996922,2836.926593,577.513494,13,0
0,0,29,29,26,49,75,162,139,301,0.000333,0.624958,26,48746.73507,2708.151948,1874.874426,397.332215,7,0
0,0,31,31,26,53,79,166,144,310,0.000333,0.651391,26,50808.47283,2822.692935,1954.172032,425.791217,8,0
0,0,45,45,29,73,102,252,209,461,0.000333,1.025329,28,86127.66631,4784.870351,3075.988083,592.738642,15,0
0,0,31,31,25,49,74,160,142,302,0.000333,0.625085,24,45006.11799,2500.339889,1875.254916,391.217187,6,0
0,0,29,29,26,49,75,162,139,301,0.000333,0.624958,26,48746.73507,2708.151948,1874.874426,397.332215,7,0
0,0,41,41,29,71,100,223,191,414,0.000333,0.916852,28,77015.58095,4278.643386,2750.556463,577.513494,12,0
0,0,44,44,26,69,95,252,202,454,0.000333,0.994238,26,77550.5756,4308.365311,2982.714446,543.69962,20,0
0,0,52,52,28,75,103,271,220,491,0.000333,1.094357,28,91926.00925,5107.000514,3283.071759,601.76734,24,0
0,0,59,59,30,84,114,333,252,585,0.000333,1.332414,45,179875.8296,9993.101646,3997.240658,684.161381,28,0
0,0,43,43,26,65,91,241,193,434,0.000333,0.941461,26,73433.95472,4079.664151,2824.382874,513.665341,19,0
0,0,47,47,26,71,97,260,211,471,0.000333,1.036186,26,80822.53267,4490.140704,3108.558949,558.843478,21,0
0,0,57,57,30,68,98,306,233,539,0.000333,1.188443,45,160439.7873,8913.321515,3565.328606,561.154191,25,0
0,0,84,84,33,101,134,473,384,857,0.000333,2.018546,48,290670.6449,16148.36916,6055.638436,838.944366,25,0
0,0,39,39,25,63,88,205,174,379,0.000333,0.816042,24,58754.99,3264.166111,2448.124583,492.66504,10,0
0,0,38,38,25,62,87,202,171,373,0.000333,0.801073,24,57677.23018,3204.290565,2403.217924,485.256576,10,0
0,0,38,38,25,62,87,202,171,373,0.000333,0.801073,24,57677.23018,3204.290565,2403.217924,485.256576,10,0
0,0,82,82,33,97,130,442,363,805,0.000333,1.884335,48,271344.2923,15074.68291,5653.006089,806.656552,21,0
0,0,93,93,33,102,135,481,399,880,0.000333,2.075866,48,298924.6908,16606.92727,6227.597725,847.052391,24,0
0,0,36,36,25,60,85,192,164,356,0.000333,0.760581,24,54761.83616,3042.324231,2281.743173,470.50984,9,0
0,0,35,35,25,59,84,189,161,350,0.000333,0.74577,24,53695.46635,2983.081464,2237.311098,463.172345,9,0
0,0,35,35,25,59,84,189,161,350,0.000333,0.74577,24,53695.46635,2983.081464,2237.311098,463.172345,9,0
0,0,41,41,25,66,91,240,193,433,0.000333,0.939292,24,67629.0019,3757.166772,2817.875079,515.026417,19,0
0,0,49,49,28,72,100,259,211,470,0.000333,1.040871,28,87433.14746,4857.397081,3122.612409,578.840538,23,0
0,0,56,56,30,81,111,321,243,564,0.000333,1.27735,45,172442.2747,9580.126372,3832.050549,660.734568,27,0
0,0,40,40,25,62,87,229,184,413,0.000333,0.886979,24,63862.45593,3547.914218,2660.935664,485.256576,18,0
0,0,44,44,25,68,93,248,202,450,0.000333,0.980874,24,70622.91516,3923.495287,2942.621465,530.043878,20,0
0,0,54,54,29,65,94,294,224,518,0.000333,1.131759,42,142601.6351,7922.313059,3395.277025,532.335357,24,0
0,0,112,112,35,121,156,557,466,1023,0.000333,2.484322,51,380101.29,21116.73833,7452.96647,1016.707357,33,0
0,0,95,95,33,111,144,484,400,884,0.000333,2.112738,48,304234.2577,16901.9032,6338.213701,920.645167,29,0
0,0,79,79,32,91,123,413,339,752,0.000333,1.740257,48,250597.0036,13922.05576,5220.770908,752.209312,20,0
0,0,96,96,35,110,145,516,415,931,0.000333,2.228165,51,340909.2635,18939.40353,6684.495363,925.474474,28,0
0,0,84,84,33,96,129,437,372,809,0.000333,1.890694,48,272259.9768,15125.55427,5672.08285,798.621406,23,0
0,0,51,51,31,71,102,257,218,475,0.000333,1.056467,45,142623.0917,7923.505094,3169.402037,590.212131,14,0
0,0,34,34,27,52,79,178,148,326,0.000333,0.685011,26,53430.84562,2968.380312,2055.032524,424.804828,8,0
0,0,36,36,27,56,83,182,153,335,0.000333,0.711879,26,55526.59345,3084.810747,2135.63821,453.593838,9,0
0,0,95,95,35,93,128,467,373,840,0.000333,1.96,68,399840,22213.33333,5880,787.666675,29,0
0,0,36,36,25,51,76,176,151,327,0.000333,0.681024,24,49033.73513,2724.096396,2043.072297,405.390097,7,0
0,0,34,34,27,52,79,178,148,326,0.000333,0.685011,26,53430.84562,2968.380312,2055.032524,424.804828,8,0
0,0,46,46,30,71,101,239,200,439,0.000333,0.974318,30,87688.64523,4871.591402,2922.954841,583.838763,13,0
0,0,85,85,33,83,116,418,328,746,0.000333,1.705351,48,245570.5835,13642.81019,5116.053822,695.593279,31,0
0,0,57,57,29,78,107,287,229,516,0.000333,1.159532,28,97400.71502,5411.150834,3478.596965,631.142822,25,0
0,0,72,72,32,90,122,381,284,665,0.000333,1.536313,48,221229.1358,12290.50755,4608.940329,744.266779,31,0
0,0,48,48,27,68,95,257,202,459,0.000333,1.005188,26,78404.65683,4355.814268,3015.563724,542.329436,20,0
0,0,52,52,27,74,101,276,220,496,0.000333,1.100824,26,85864.29528,4770.238627,3302.472895,587.881512,22,0
0,0,70,70,32,74,106,354,265,619,0.000333,1.388194,48,199899.9725,11105.55403,4164.582761,619.499549,28,0
0,0,89,89,34,104,138,489,393,882,0.000333,2.089906,51,319755.6471,17764.20262,6269.718571,869.819467,26,0
0,0,59,59,30,72,102,273,226,499,0.000333,1.109847,45,149829.3111,8323.850614,3329.540246,591.441318,16,0
0,0,43,43,26,65,91,218,180,398,0.000333,0.863367,26,67342.65894,3741.25883,2590.102267,513.665341,11,0
0,0,43,43,26,65,91,218,180,398,0.000333,0.863367,26,67342.65894,3741.25883,2590.102267,513.665341,11,0
0,0,87,87,34,100,134,458,372,830,0.000333,1.954951,51,299107.5554,16617.08641,5864.854028,837.359356,22,0
0,0,41,41,26,63,89,208,173,381,0.000333,0.822418,26,64148.61537,3563.811965,2467.254437,498.780068,10,0
0,0,40,40,26,62,88,205,170,375,0.000333,0.807429,26,62979.45828,3498.858793,2422.286857,491.371604,10,0
0,0,40,40,26,62,88,205,170,375,0.000333,0.807429,26,62979.45828,3498.858793,2422.286857,491.371604,10,0
0,0,46,46,27,69,96,256,202,458,0.000333,1.005304,26,78413.73346,4356.318525,3015.912825,549.87015,20,0
0,0,54,54,29,75,104,275,220,495,0.000333,1.105573,28,92868.09449,5159.338583,3316.71766,608.042851,24,0
0,0,61,61,31,84,115,337,252,589,0.000333,1.343998,45,181439.7138,10079.9841,4031.99364,690.534749,28,0
0,0,45,45,27,65,92,245,193,438,0.000333,0.95244,26,74290.32356,4127.240198,2857.320137,519.83587,19,0
0,0,49,49,27,71,98,264,211,475,0.000333,1.047329,26,81691.66658,4538.425921,3141.987176,565.014008,21,0
0,0,59,59,31,68,99,310,233,543,0.000333,1.199914,45,161988.329,8999.351612,3599.740645,567.527559,25,0
0,0,86,86,33,96,129,448,374,822,0.000333,1.921076,48,276634.9826,15368.61014,5763.228804,798.621406,23,0
0,0,89,89,33,103,136,474,387,861,0.000333,2.034102,48,292910.6643,16272.81468,6102.305506,855.17456,27,0
0,0,42,42,29,71,100,232,195,427,0.000333,0.945642,28,79433.94461,4412.996922,2836.926593,577.513494,13,0
0,0,29,29,26,49,75,162,139,301,0.000333,0.624958,26,48746.73507,2708.151948,1874.874426,397.332215,7,0
0,0,31,31,26,53,79,166,144,310,0.000333,0.651391,26,50808.47283,2822.692935,1954.172032,425.791217,8,0
0,0,45,45,29,73,102,252,209,461,0.000333,1.025329,28,86127.66631,4784.870351,3075.988083,592.738642,15,0
0,0,31,31,25,49,74,160,142,302,0.000333,0.625085,24,45006.11799,2500.339889,1875.254916,391.217187,6,0
0,0,29,29,26,49,75,162,139,301,0.000333,0.624958,26,48746.73507,2708.151948,1874.874426,397.332215,7,0
0,0,41,41,29,71,100,223,191,414,0.000333,0.916852,28,77015.58095,4278.643386,2750.556463,577.513494,12,0
0,0,44,44,26,69,95,252,202,454,0.000333,0.994238,26,77550.5756,4308.365311,2982.714446,543.69962,20,0
0,0,52,52,28,75,103,271,220,491,0.000333,1.094357,28,91926.00925,5107.000514,3283.071759,601.76734,24,0
0,0,59,59,30,84,114,333,252,585,0.000333,1.332414,45,179875.8296,9993.101646,3997.240658,684.161381,28,0
0,0,43,43,26,65,91,241,193,434,0.000333,0.941461,26,73433.95472,4079.664151,2824.382874,513.665341,19,0
0,0,47,47,26,71,97,260,211,471,0.000333,1.036186,26,80822.53267,4490.140704,3108.558949,558.843478,21,0
0,0,57,57,30,68,98,306,233,539,0.000333,1.188443,45,160439.7873,8913.321515,3565.328606,561.154191,25,0
0,0,84,84,33,101,134,473,384,857,0.000333,2.018546,48,290670.6449,16148.36916,6055.638436,838.944366,25,0
0,0,39,39,25,63,88,205,174,379,0.000333,0.816042,24,58754.99,3264.166111,2448.124583,492.66504,10,0
0,0,38,38,25,62,87,202,171,373,0.000333,0.801073,24,57677.23018,3204.290565,2403.217924,485.256576,10,0
0,0,38,38,25,62,87,202,171,373,0.000333,0.801073,24,57677.23018,3204.290565,2403.217924,485.256576,10,0
0,0,82,82,33,97,130,442,363,805,0.000333,1.884335,48,271344.2923,15074.68291,5653.006089,806.656552,21,0
0,0,93,93,33,102,135,481,399,880,0.000333,2.075866,48,298924.6908,16606.92727,6227.597725,847.052391,24,0
0,0,36,36,25,60,85,192,164,356,0.000333,0.760581,24,54761.83616,3042.324231,2281.743173,470.50984,9,0
0,0,35,35,25,59,84,189,161,350,0.000333,0.74577,24,53695.46635,2983.081464,2237.311098,463.172345,9,0
0,0,35,35,25,59,84,189,161,350,0.000333,0.74577,24,53695.46635,2983.081464,2237.311098,463.172345,9,0
0,0,41,41,25,66,91,240,193,433,0.000333,0.939292,24,67629.0019,3757.166772,2817.875079,515.026417,19,0
0,0,49,49,28,72,100,259,211,470,0.000333,1.040871,28,87433.14746,4857.397081,3122.612409,578.840538,23,0
0,0,56,56,30,81,111,321,243,564,0.000333,1.27735,45,172442.2747,9580.126372,3832.050549,660.734568,27,0
0,0,40,40,25,62,87,229,184,413,0.000333,0.886979,24,63862.45593,3547.914218,2660.935664,485.256576,18,0
0,0,44,44,25,68,93,248,202,450,0.000333,0.980874,24,70622.91516,3923.495287,2942.621465,530.043878,20,0
0,0,54,54,29,65,94,294,224,518,0.000333,1.131759,42,142601.6351,7922.313059,3395.277025,532.335357,24,0
0,0,112,112,35,121,156,557,466,1023,0.000333,2.484322,51,380101.29,21116.73833,7452.96647,1016.707357,33,0
0,0,95,95,33,111,144,484,400,884,0.000333,2.112738,48,304234.2577,16901.9032,6338.213701,920.645167,29,0
0,0,79,79,32,91,123,413,339,752,0.000333,1.740257,48,250597.0036,13922.05576,5220.770908,752.209312,20,0
0,0,96,96,35,110,145,516,415,931,0.000333,2.228165,51,340909.2635,18939.40353,6684.495363,925.474474,28,0
0,0,69,69,29,73,102,342,270,612,0.000333,1.361175,42,171508.021,9528.223388,4083.524309,592.738642,27,0
0,0,50,50,26,71,97,246,196,442,0.000333,0.972387,26,75846.19838,4213.677688,2917.161476,558.843478,26,0
0,0,39,39,23,55,78,199,157,356,0.000333,0.745868,22,49227.27018,2734.848343,2237.60319,422.016709,20,0
0,0,43,43,23,62,85,218,175,393,0.000333,0.83963,22,55415.59403,3078.644113,2518.890638,473.202096,22,0
0,0,57,57,26,61,87,246,192,438,0.000333,0.94067,39,110058.3608,6114.353378,2822.009251,483.98641,17,0
0,0,59,59,27,77,104,274,212,486,0.000333,1.085471,26,84666.75628,4703.708682,3256.413703,610.924526,20,0
0,0,50,50,24,60,84,244,197,441,0.000333,0.939671,36,101484.4314,5638.023967,2819.011983,464.452536,22,0
0,0,37,37,21,57,78,167,141,308,0.000333,0.645301,20,38718.07767,2151.004315,1935.903883,424.713397,12,0
0,0,49,49,24,60,84,239,193,432,0.000333,0.920494,36,99413.32056,5522.962253,2761.481127,464.452536,21,0
0,0,48,48,24,57,81,211,166,377,0.000333,0.796708,24,57362.96283,3186.831268,2390.123451,442.513831,15,0
0,0,50,50,26,73,99,239,186,425,0.000333,0.939159,26,73254.39065,4069.68837,2817.476564,574.068625,18,0
0,0,49,49,24,59,83,241,194,435,0.000333,0.924381,36,99833.1175,5546.284305,2773.142153,457.11504,22,0
0,0,36,36,21,56,77,164,138,302,0.000333,0.630857,20,37851.39071,2102.855039,1892.569535,417.450542,12,0
0,0,48,48,24,59,83,236,190,426,0.000333,0.905256,36,97767.60472,5431.533596,2715.766798,457.11504,21,0
0,0,48,48,24,57,81,211,166,377,0.000333,0.796708,24,57362.96283,3186.831268,2390.123451,442.513831,15,0
0,0,50,50,26,73,99,239,186,425,0.000333,0.939159,26,73254.39065,4069.68837,2817.476564,574.068625,18,0
0,0,49,49,24,59,83,241,194,435,0.000333,0.924381,36,99833.1175,5546.284305,2773.142153,457.11504,22,0
0,0,36,36,21,56,77,164,138,302,0.000333,0.630857,20,37851.39071,2102.855039,1892.569535,417.450542,12,0
0,0,48,48,24,59,83,236,190,426,0.000333,0.905256,36,97767.60472,5431.533596,2715.766798,457.11504,21,0
0,0,55,55,27,59,86,278,209,487,0.000333,1.043197,39,122054.0465,6780.78036,3129.590936,475.457902,26,0
0,0,65,65,25,66,91,312,247,559,0.000333,1.212619,36,130962.8593,7275.714408,3637.857204,515.026417,26,0
0,0,50,50,25,68,93,239,190,429,0.000333,0.9351,24,67327.17912,3740.39884,2805.29913,530.043878,26,0
0,0,39,39,23,52,75,192,151,343,0.000333,0.712162,22,47002.66584,2611.259213,2136.484811,400.46479,20,0
0,0,43,43,23,59,82,211,169,380,0.000333,0.80529,22,53149.13476,2952.729709,2415.869762,451.117865,22,0
0,0,57,57,25,58,83,239,186,425,0.000333,0.903131,36,97538.1033,5418.783517,2709.391758,455.859302,17,0
0,0,59,59,26,74,100,267,206,473,0.000333,1.047515,26,81706.14342,4539.23019,3142.543978,581.710982,20,0
0,0,50,50,24,57,81,237,191,428,0.000333,0.904485,36,97684.40884,5426.911602,2713.455801,442.513831,22,0
0,0,37,37,21,54,75,160,135,295,0.000333,0.612501,20,36750.03027,2041.668349,1837.501514,403.002591,12,0
0,0,49,49,24,57,81,232,187,419,0.000333,0.885466,36,95630.29744,5312.794302,2656.397151,442.513831,21,0
0,0,48,48,24,54,78,204,160,364,0.000333,0.762629,24,54909.27378,3050.51521,2287.886408,420.803025,15,0
0,0,50,50,26,70,96,232,180,412,0.000333,0.904335,26,70538.11831,3918.78435,2713.00455,551.261244,18,0
0,0,49,49,24,56,80,234,188,422,0.000333,0.889285,36,96042.73162,5335.707312,2667.853656,435.250976,22,0
0,0,36,36,21,53,74,157,132,289,0.000333,0.598177,20,35890.64045,1993.92447,1794.532023,395.81845,12,0
0,0,48,48,24,56,80,229,184,413,0.000333,0.870319,36,93994.42692,5221.912606,2610.956303,435.250976,21,0
0,0,48,48,24,54,78,204,160,364,0.000333,0.762629,24,54909.27378,3050.51521,2287.886408,420.803025,15,0
0,0,50,50,26,70,96,232,180,412,0.000333,0.904335,26,70538.11831,3918.78435,2713.00455,551.261244,18,0
0,0,49,49,24,56,80,234,188,422,0.000333,0.889285,36,96042.73162,5335.707312,2667.853656,435.250976,22,0
0,0,36,36,21,53,74,157,132,289,0.000333,0.598177,20,35890.64045,1993.92447,1794.532023,395.81845,12,0
0,0,48,48,24,56,80,229,184,413,0.000333,0.870319,36,93994.42692,5221.912606,2610.956303,435.250976,21,0
0,0,55,55,26,56,82,271,203,474,0.000333,1.004493,39,117525.7064,6529.205909,3013.47965,447.423308,26,0
0,0,57,57,24,61,85,285,222,507,0.000333,1.083187,36,116984.2034,6499.122409,3249.561205,471.814078,24,0
0,0,46,46,25,67,92,223,178,401,0.000333,0.871983,24,62782.76027,3487.931126,2615.948344,522.524381,24,0
0,0,35,35,20,51,71,176,139,315,0.000333,0.645723,20,38743.40685,2152.411492,1937.170343,375.732254,18,0
0,0,39,39,20,58,78,195,157,352,0.000333,0.737487,20,44249.23162,2458.290646,2212.461581,426.20146,20,0
0,0,53,53,24,57,81,223,174,397,0.000333,0.838973,36,90609.13624,5033.840902,2516.920451,442.513831,15,0
0,0,55,55,26,73,99,251,194,445,0.000333,0.983355,26,76701.65609,4261.203116,2950.063696,574.068625,18,0
0,0,46,46,21,56,77,221,179,400,0.000333,0.835572,30,75201.43849,4177.857694,2506.714616,417.450542,20,0
0,0,33,33,18,53,71,144,123,267,0.000333,0.547327,18,29555.68466,1641.982481,1641.982481,378.638434,10,0
0,0,45,45,21,56,77,216,175,391,0.000333,0.816771,30,73509.40612,4083.855896,2450.313537,417.450542,19,0
0,0,44,44,22,53,75,188,148,336,0.000333,0.697628,22,46043.42776,2557.968209,2092.88308,401.68728,13,0
0,0,46,46,25,69,94,216,168,384,0.000333,0.838987,24,60407.09086,3355.949492,2516.962119,537.584592,16,0
0,0,45,45,21,55,76,218,176,394,0.000333,0.820561,30,73850.50321,4102.805734,2461.68344,410.21345,20,0
0,0,32,32,18,52,70,141,120,261,0.000333,0.533248,18,28795.37161,1599.742867,1599.742867,371.481515,10,0
0,0,44,44,21,55,76,213,172,385,0.000333,0.801817,30,72163.56278,4009.086821,2405.452093,410.21345,19,0
0,0,44,44,22,53,75,188,148,336,0.000333,0.697628,22,46043.42776,2557.968209,2092.88308,401.68728,13,0
0,0,46,46,25,69,94,216,168,384,0.000333,0.838987,24,60407.09086,3355.949492,2516.962119,537.584592,16,0
0,0,45,45,21,55,76,218,176,394,0.000333,0.820561,30,73850.50321,4102.805734,2461.68344,410.21345,20,0
0,0,32,32,18,52,70,141,120,261,0.000333,0.533248,18,28795.37161,1599.742867,1599.742867,371.481515,10,0
0,0,44,44,21,55,76,213,172,385,0.000333,0.801817,30,72163.56278,4009.086821,2405.452093,410.21345,19,0
0,0,51,51,26,55,81,255,191,446,0.000333,0.942524,39,110275.351,6126.408386,2827.573101,440.186217,24,0
0,0,65,65,25,66,91,312,247,559,0.000333,1.212619,36,130962.8593,7275.714408,3637.857204,515.026417,26,0
0,0,50,50,25,68,93,239,190,429,0.000333,0.9351,24,67327.17912,3740.39884,2805.29913,530.043878,26,0
0,0,39,39,23,52,75,192,151,343,0.000333,0.712162,22,47002.66584,2611.259213,2136.484811,400.46479,20,0
0,0,43,43,23,59,82,211,169,380,0.000333,0.80529,22,53149.13476,2952.729709,2415.869762,451.117865,22,0
0,0,57,57,25,58,83,239,186,425,0.000333,0.903131,36,97538.1033,5418.783517,2709.391758,455.859302,17,0
0,0,59,59,26,74,100,267,206,473,0.000333,1.047515,26,81706.14342,4539.23019,3142.543978,581.710982,20,0
0,0,50,50,24,57,81,237,191,428,0.000333,0.904485,36,97684.40884,5426.911602,2713.455801,442.513831,22,0
0,0,37,37,21,54,75,160,135,295,0.000333,0.612501,20,36750.03027,2041.668349,1837.501514,403.002591,12,0
0,0,49,49,24,57,81,232,187,419,0.000333,0.885466,36,95630.29744,5312.794302,2656.397151,442.513831,21,0
0,0,48,48,24,54,78,204,160,364,0.000333,0.762629,24,54909.27378,3050.51521,2287.886408,420.803025,15,0
0,0,50,50,26,70,96,232,180,412,0.000333,0.904335,26,70538.11831,3918.78435,2713.00455,551.261244,18,0
0,0,49,49,24,56,80,234,188,422,0.000333,0.889285,36,96042.73162,5335.707312,2667.853656,435.250976,22,0
0,0,36,36,21,53,74,157,132,289,0.000333,0.598177,20,35890.64045,1993.92447,1794.532023,395.81845,12,0
0,0,48,48,24,56,80,229,184,413,0.000333,0.870319,36,93994.42692,5221.912606,2610.956303,435.250976,21,0
0,0,48,48,24,54,78,204,160,364,0.000333,0.762629,24,54909.27378,3050.51521,2287.886408,420.803025,15,0
0,0,50,50,26,70,96,232,180,412,0.000333,0.904335,26,70538.11831,3918.78435,2713.00455,551.261244,18,0
0,0,49,49,24,56,80,234,188,422,0.000333,0.889285,36,96042.73162,5335.707312,2667.853656,435.250976,22,0
0,0,36,36,21,53,74,157,132,289,0.000333,0.598177,20,35890.64045,1993.92447,1794.532023,395.81845,12,0
0,0,48,48,24,56,80,229,184,413,0.000333,0.870319,36,93994.42692,5221.912606,2610.956303,435.250976,21,0
0,0,55,55,26,56,82,271,203,474,0.000333,1.004493,39,117525.7064,6529.205909,3013.47965,447.423308,26,0
0,0,58,58,25,59,84,288,224,512,0.000333,1.090956,36,117823.1947,6545.733041,3272.86652,463.172345,26,0
0,0,47,47,25,65,90,226,180,406,0.000333,0.878564,24,63256.61657,3514.256476,2635.692357,507.550313,26,0
0,0,36,36,22,49,71,179,141,320,0.000333,0.655973,22,43294.21972,2405.234429,1967.919078,373.228278,20,0
0,0,40,40,22,56,78,198,159,357,0.000333,0.747963,22,49365.54903,2742.530501,2243.888592,423.319371,22,0
0,0,54,54,25,55,80,226,176,402,0.000333,0.847138,36,91490.94339,5082.830188,2541.415094,434.071189,17,0
0,0,56,56,26,71,97,254,196,450,0.000333,0.989987,26,77218.98025,4289.943347,2969.960779,558.843478,20,0
0,0,47,47,23,54,77,224,181,405,0.000333,0.846016,33,83755.60212,4653.089006,2538.048549,414.80585,22,0
0,0,34,34,20,51,71,147,125,272,0.000333,0.557577,20,33454.62433,1858.590241,1672.731217,375.732254,12,0
0,0,46,46,23,54,77,219,177,396,0.000333,0.827216,33,81894.36651,4549.687029,2481.64747,414.80585,21,0
0,0,45,45,23,51,74,191,150,341,0.000333,0.705808,22,46583.31915,2587.962175,2117.423598,393.335617,15,0
0,0,47,47,25,67,92,219,170,389,0.000333,0.845889,24,60903.97442,3383.554135,2537.665601,522.524381,18,0
0,0,46,46,23,53,76,221,178,399,0.000333,0.830974,33,82266.46157,4570.358976,2492.923078,407.621709,22,0
0,0,33,33,20,50,70,144,122,266,0.000333,0.543463,20,32607.78565,1811.543647,1630.389283,368.631371,12,0
0,0,45,45,23,53,76,216,174,390,0.000333,0.812231,33,80410.8271,4467.268172,2436.69173,407.621709,21,0
0,0,45,45,23,51,74,191,150,341,0.000333,0.705808,22,46583.31915,2587.962175,2117.423598,393.335617,15,0
0,0,47,47,25,67,92,219,170,389,0.000333,0.845889,24,60903.97442,3383.554135,2537.665601,522.524381,18,0
0,0,46,46,23,53,76,221,178,399,0.000333,0.830974,33,82266.46157,4570.358976,2492.923078,407.621709,22,0
0,0,33,33,20,50,70,144,122,266,0.000333,0.543463,20,32607.78565,1811.543647,1630.389283,368.631371,12,0
0,0,45,45,23,53,76,216,174,390,0.000333,0.812231,33,80410.8271,4467.268172,2436.69173,407.621709,21,0
0,0,52,52,26,53,79,258,193,451,0.000333,0.947668,39,110877.1996,6159.844421,2843.005117,425.791217,26,0
0,0,73,73,29,70,99,357,281,638,0.000333,1.409843,56,236853.6533,13158.5363,4229.529524,569.93126,29,0
0,0,47,47,27,69,96,243,194,437,0.000333,0.95921,26,74818.34393,4156.574663,2877.628613,549.87015,24,0
0,0,36,36,23,54,77,196,155,351,0.000333,0.733214,22,48392.12567,2688.451426,2199.642076,414.80585,18,0
0,0,40,40,23,61,84,215,173,388,0.000333,0.82674,22,54564.82152,3031.378973,2480.21916,465.816903,20,0
0,0,34,34,22,55,77,195,155,350,0.000333,0.731125,22,48254.25636,2680.79202,2193.375289,416.08228,18,0
0,0,42,42,25,61,86,214,173,387,0.000333,0.828988,24,59687.14704,3315.952613,2486.96446,477.871382,22,0
0,0,33,33,22,51,73,184,146,330,0.000333,0.680881,22,44938.1263,2496.562572,2042.642104,387.401188,17,0
0,0,37,37,22,58,80,203,164,367,0.000333,0.773383,22,51043.24744,2835.735969,2320.147611,437.870393,19,0
0,0,79,79,31,90,121,421,346,767,0.000333,1.768923,45,238804.5646,13266.92026,5306.768103,737.846864,20,0
0,0,81,81,31,94,125,425,351,776,0.000333,1.801816,45,243245.1872,13513.62151,5405.448605,769.711438,21,0
0,0,40,40,28,62,90,201,177,378,0.000333,0.817973,28,68709.77317,3817.209621,2453.92047,503.766109,12,0
0,0,47,47,26,73,99,217,202,419,0.000333,0.9259,26,72220.21102,4012.233946,2777.700424,574.068625,13,0
0,0,35,35,26,53,79,165,145,310,0.000333,0.651391,26,50808.47283,2822.692935,1954.172032,425.791217,7,0
0,0,79,79,31,90,121,421,346,767,0.000333,1.768923,45,238804.5646,13266.92026,5306.768103,737.846864,20,0
0,0,27,27,26,44,70,141,121,262,0.000333,0.535291,26,41752.67591,2319.593106,1605.87215,362.426424,7,0
0,0,91,91,33,110,143,482,398,880,0.000333,2.100229,48,302432.9653,16801.8314,6300.686776,912.414574,25,0
0,0,60,60,28,61,89,307,230,537,0.000333,1.159156,42,146053.6918,8114.093989,3477.468852,496.380915,26,0
0,0,85,85,33,98,131,454,369,823,0.000333,1.929502,48,277848.3423,15436.01901,5788.50713,814.706571,28,0
0,0,63,63,28,67,95,279,224,503,0.000333,1.101546,42,138794.7696,7710.820532,3304.637371,541.033914,18,0
0,0,50,50,27,75,102,255,201,456,0.000333,1.014209,26,79108.27485,4394.904159,3042.625956,595.543364,16,0
0,0,49,49,24,63,87,257,209,466,0.000333,1.000804,36,108086.8201,6004.823338,3002.411669,486.607735,20,0
0,0,36,36,21,59,80,180,153,333,0.000333,0.701734,20,42104.04111,2339.113395,2105.202056,439.314606,10,0
0,0,48,48,24,63,87,252,205,457,0.000333,0.981475,36,105999.3064,5888.850355,2944.425178,486.607735,19,0
0,0,47,47,24,59,83,224,178,402,0.000333,0.854255,36,92259.57065,5125.531703,2562.765851,457.11504,13,0
0,0,49,49,27,74,101,252,198,450,0.000333,0.998732,26,77901.07435,4327.837464,2996.195167,587.881512,16,0
0,0,48,48,24,62,86,254,206,460,0.000333,0.985361,36,106418.9443,5912.163574,2956.081787,479.199271,20,0
0,0,35,35,21,58,79,177,150,327,0.000333,0.687112,20,41226.72609,2290.373672,2061.336305,432.001564,10,0
0,0,47,47,24,62,86,249,202,451,0.000333,0.966082,36,104336.8346,5796.490809,2898.245404,479.199271,19,0
0,0,47,47,24,59,83,224,178,402,0.000333,0.854255,36,92259.57065,5125.531703,2562.765851,457.11504,13,0
0,0,49,49,27,74,101,252,198,450,0.000333,0.998732,26,77901.07435,4327.837464,2996.195167,587.881512,16,0
0,0,48,48,24,62,86,254,206,460,0.000333,0.985361,36,106418.9443,5912.163574,2956.081787,479.199271,20,0
0,0,35,35,21,58,79,177,150,327,0.000333,0.687112,20,41226.72609,2290.373672,2061.336305,432.001564,10,0
0,0,47,47,24,62,86,249,202,451,0.000333,0.966082,36,104336.8346,5796.490809,2898.245404,479.199271,19,0
0,0,83,83,33,94,127,423,348,771,0.000333,1.796092,48,258637.2429,14368.73572,5388.275894,782.596358,24,0
0,0,113,113,35,107,142,528,439,967,0.000333,2.304602,68,470138.7716,26118.82064,6913.805465,900.861873,33,0
0,0,45,45,24,57,81,214,171,385,0.000333,0.813614,36,87870.32104,4881.684502,2440.842251,442.513831,12,0
0,0,47,47,27,72,99,242,191,433,0.000333,0.956837,26,74633.29683,4146.294268,2870.511416,572.616563,15,0
0,0,46,46,24,61,85,244,199,443,0.000333,0.946453,36,102216.9667,5678.720369,2839.360185,471.814078,19,0
0,0,33,33,21,56,77,167,143,310,0.000333,0.647568,20,38854.07655,2158.559808,1942.703828,417.450542,9,0
0,0,45,45,24,61,85,239,195,434,0.000333,0.927225,36,100140.324,5563.351333,2781.675666,471.814078,18,0
0,0,44,44,24,56,80,211,168,379,0.000333,0.79867,36,86256.38693,4792.021496,2396.010748,435.250976,12,0
0,0,46,46,27,71,98,239,188,427,0.000333,0.941494,26,73436.50869,4079.806038,2824.481103,565.014008,15,0
0,0,45,45,24,60,84,241,196,437,0.000333,0.931148,36,100563.9377,5586.885428,2793.442714,464.452536,19,0
0,0,32,32,21,55,76,164,140,304,0.000333,0.633123,20,37987.39928,2110.411071,1899.369964,410.21345,9,0
0,0,44,44,24,60,84,236,192,428,0.000333,0.911971,36,98492.82685,5471.823714,2735.911857,464.452536,18,0
0,0,44,44,24,56,80,211,168,379,0.000333,0.79867,36,86256.38693,4792.021496,2396.010748,435.250976,12,0
0,0,46,46,27,71,98,239,188,427,0.000333,0.941494,26,73436.50869,4079.806038,2824.481103,565.014008,15,0
0,0,45,45,24,60,84,241,196,437,0.000333,0.931148,36,100563.9377,5586.885428,2793.442714,464.452536,19,0
0,0,32,32,21,55,76,164,140,304,0.000333,0.633123,20,37987.39928,2110.411071,1899.369964,410.21345,9,0
0,0,44,44,24,60,84,236,192,428,0.000333,0.911971,36,98492.82685,5471.823714,2735.911857,464.452536,18,0
0,0,99,99,31,82,113,522,385,907,0.000333,2.061967,60,371154.1391,20619.6744,6185.902319,674.89935,54,0
0,0,49,49,27,55,82,263,198,461,0.000333,0.976944,39,114302.4275,6350.134861,2930.831474,446.356747,23,0
0,0,79,79,33,82,115,403,316,719,0.000333,1.640636,48,236251.5526,13125.08626,4921.907347,687.78427,30,0
0,0,47,47,27,69,96,243,194,437,0.000333,0.95921,26,74818.34393,4156.574663,2877.628613,549.87015,24,0
0,0,36,36,23,54,77,196,155,351,0.000333,0.733214,22,48392.12567,2688.451426,2199.642076,414.80585,18,0
0,0,40,40,23,61,84,215,173,388,0.000333,0.82674,22,54564.82152,3031.378973,2480.21916,465.816903,20,0
0,0,34,34,22,55,77,195,155,350,0.000333,0.731125,22,48254.25636,2680.79202,2193.375289,416.08228,18,0
0,0,42,42,25,61,86,214,173,387,0.000333,0.828988,24,59687.14704,3315.952613,2486.96446,477.871382,22,0
0,0,33,33,22,51,73,184,146,330,0.000333,0.680881,22,44938.1263,2496.562572,2042.642104,387.401188,17,0
0,0,37,37,22,58,80,203,164,367,0.000333,0.773383,22,51043.24744,2835.735969,2320.147611,437.870393,19,0
0,0,79,79,31,90,121,421,346,767,0.000333,1.768923,45,238804.5646,13266.92026,5306.768103,737.846864,20,0
0,0,81,81,31,94,125,425,351,776,0.000333,1.801816,45,243245.1872,13513.62151,5405.448605,769.711438,21,0
0,0,40,40,28,62,90,201,177,378,0.000333,0.817973,28,68709.77317,3817.209621,2453.92047,503.766109,12,0
0,0,47,47,26,73,99,217,202,419,0.000333,0.9259,26,72220.21102,4012.233946,2777.700424,574.068625,13,0
0,0,35,35,26,53,79,165,145,310,0.000333,0.651391,26,50808.47283,2822.692935,1954.172032,425.791217,7,0
0,0,79,79,31,90,121,421,346,767,0.000333,1.768923,45,238804.5646,13266.92026,5306.768103,737.846864,20,0
0,0,27,27,26,44,70,141,121,262,0.000333,0.535291,26,41752.67591,2319.593106,1605.87215,362.426424,7,0
0,0,91,91,33,110,143,482,398,880,0.000333,2.100229,48,302432.9653,16801.8314,6300.686776,912.414574,25,0
0,0,60,60,28,61,89,307,230,537,0.000333,1.159156,42,146053.6918,8114.093989,3477.468852,496.380915,26,0
0,0,85,85,33,98,131,454,369,823,0.000333,1.929502,48,277848.3423,15436.01901,5788.50713,814.706571,28,0
0,0,63,63,28,67,95,279,224,503,0.000333,1.101546,42,138794.7696,7710.820532,3304.637371,541.033914,18,0
0,0,50,50,27,75,102,255,201,456,0.000333,1.014209,26,79108.27485,4394.904159,3042.625956,595.543364,16,0
0,0,49,49,24,63,87,257,209,466,0.000333,1.000804,36,108086.8201,6004.823338,3002.411669,486.607735,20,0
0,0,36,36,21,59,80,180,153,333,0.000333,0.701734,20,42104.04111,2339.113395,2105.202056,439.314606,10,0
0,0,48,48,24,63,87,252,205,457,0.000333,0.981475,36,105999.3064,5888.850355,2944.425178,486.607735,19,0
0,0,47,47,24,59,83,224,178,402,0.000333,0.854255,36,92259.57065,5125.531703,2562.765851,457.11504,13,0
0,0,49,49,27,74,101,252,198,450,0.000333,0.998732,26,77901.07435,4327.837464,2996.195167,587.881512,16,0
0,0,48,48,24,62,86,254,206,460,0.000333,0.985361,36,106418.9443,5912.163574,2956.081787,479.199271,20,0
0,0,35,35,21,58,79,177,150,327,0.000333,0.687112,20,41226.72609,2290.373672,2061.336305,432.001564,10,0
0,0,47,47,24,62,86,249,202,451,0.000333,0.966082,36,104336.8346,5796.490809,2898.245404,479.199271,19,0
0,0,47,47,24,59,83,224,178,402,0.000333,0.854255,36,92259.57065,5125.531703,2562.765851,457.11504,13,0
0,0,49,49,27,74,101,252,198,450,0.000333,0.998732,26,77901.07435,4327.837464,2996.195167,587.881512,16,0
0,0,48,48,24,62,86,254,206,460,0.000333,0.985361,36,106418.9443,5912.163574,2956.081787,479.199271,20,0
0,0,35,35,21,58,79,177,150,327,0.000333,0.687112,20,41226.72609,2290.373672,2061.336305,432.001564,10,0
0,0,47,47,24,62,86,249,202,451,0.000333,0.966082,36,104336.8346,5796.490809,2898.245404,479.199271,19,0
0,0,83,83,33,94,127,423,348,771,0.000333,1.796092,48,258637.2429,14368.73572,5388.275894,782.596358,24,0
0,0,113,113,35,107,142,528,439,967,0.000333,2.304602,68,470138.7716,26118.82064,6913.805465,900.861873,33,0
0,0,45,45,24,57,81,214,171,385,0.000333,0.813614,36,87870.32104,4881.684502,2440.842251,442.513831,12,0
0,0,47,47,27,72,99,242,191,433,0.000333,0.956837,26,74633.29683,4146.294268,2870.511416,572.616563,15,0
0,0,46,46,24,61,85,244,199,443,0.000333,0.946453,36,102216.9667,5678.720369,2839.360185,471.814078,19,0
0,0,33,33,21,56,77,167,143,310,0.000333,0.647568,20,38854.07655,2158.559808,1942.703828,417.450542,9,0
0,0,45,45,24,61,85,239,195,434,0.000333,0.927225,36,100140.324,5563.351333,2781.675666,471.814078,18,0
0,0,44,44,24,56,80,211,168,379,0.000333,0.79867,36,86256.38693,4792.021496,2396.010748,435.250976,12,0
0,0,46,46,27,71,98,239,188,427,0.000333,0.941494,26,73436.50869,4079.806038,2824.481103,565.014008,15,0
0,0,45,45,24,60,84,241,196,437,0.000333,0.931148,36,100563.9377,5586.885428,2793.442714,464.452536,19,0
0,0,32,32,21,55,76,164,140,304,0.000333,0.633123,20,37987.39928,2110.411071,1899.369964,410.21345,9,0
0,0,44,44,24,60,84,236,192,428,0.000333,0.911971,36,98492.82685,5471.823714,2735.911857,464.452536,18,0
0,0,44,44,24,56,80,211,168,379,0.000333,0.79867,36,86256.38693,4792.021496,2396.010748,435.250976,12,0
0,0,46,46,27,71,98,239,188,427,0.000333,0.941494,26,73436.50869,4079.806038,2824.481103,565.014008,15,0
0,0,45,45,24,60,84,241,196,437,0.000333,0.931148,36,100563.9377,5586.885428,2793.442714,464.452536,19,0
0,0,32,32,21,55,76,164,140,304,0.000333,0.633123,20,37987.39928,2110.411071,1899.369964,410.21345,9,0
0,0,44,44,24,60,84,236,192,428,0.000333,0.911971,36,98492.82685,5471.823714,2735.911857,464.452536,18,0
0,0,99,99,31,82,113,522,385,907,0.000333,2.061967,60,371154.1391,20619.6744,6185.902319,674.89935,54,0
0,0,49,49,27,55,82,263,198,461,0.000333,0.976944,39,114302.4275,6350.134861,2930.831474,446.356747,23,0
0,0,79,79,33,82,115,403,316,719,0.000333,1.640636,48,236251.5526,13125.08626,4921.907347,687.78427,30,0
0,0,47,47,27,69,96,243,194,437,0.000333,0.95921,26,74818.34393,4156.574663,2877.628613,549.87015,24,0
0,0,36,36,23,54,77,196,155,351,0.000333,0.733214,22,48392.12567,2688.451426,2199.642076,414.80585,18,0
0,0,40,40,23,61,84,215,173,388,0.000333,0.82674,22,54564.82152,3031.378973,2480.21916,465.816903,20,0
0,0,34,34,22,55,77,195,155,350,0.000333,0.731125,22,48254.25636,2680.79202,2193.375289,416.08228,18,0
0,0,42,42,25,61,86,214,173,387,0.000333,0.828988,24,59687.14704,3315.952613,2486.96446,477.871382,22,0
0,0,33,33,22,51,73,184,146,330,0.000333,0.680881,22,44938.1263,2496.562572,2042.642104,387.401188,17,0
0,0,37,37,22,58,80,203,164,367,0.000333,0.773383,22,51043.24744,2835.735969,2320.147611,437.870393,19,0
0,0,79,79,31,90,121,421,346,767,0.000333,1.768923,45,238804.5646,13266.92026,5306.768103,737.846864,20,0
0,0,81,81,31,94,125,425,351,776,0.000333,1.801816,45,243245.1872,13513.62151,5405.448605,769.711438,21,0
0,0,40,40,28,62,90,201,177,378,0.000333,0.817973,28,68709.77317,3817.209621,2453.92047,503.766109,12,0
0,0,47,47,26,73,99,217,202,419,0.000333,0.9259,26,72220.21102,4012.233946,2777.700424,574.068625,13,0
0,0,35,35,26,53,79,165,145,310,0.000333,0.651391,26,50808.47283,2822.692935,1954.172032,425.791217,7,0
0,0,79,79,31,90,121,421,346,767,0.000333,1.768923,45,238804.5646,13266.92026,5306.768103,737.846864,20,0
0,0,27,27,26,44,70,141,121,262,0.000333,0.535291,26,41752.67591,2319.593106,1605.87215,362.426424,7,0
0,0,91,91,33,110,143,482,398,880,0.000333,2.100229,48,302432.9653,16801.8314,6300.686776,912.414574,25,0
0,0,60,60,28,61,89,307,230,537,0.000333,1.159156,42,146053.6918,8114.093989,3477.468852,496.380915,26,0
0,0,85,85,33,98,131,454,369,823,0.000333,1.929502,48,277848.3423,15436.01901,5788.50713,814.706571,28,0
0,0,63,63,28,67,95,279,224,503,0.000333,1.101546,42,138794.7696,7710.820532,3304.637371,541.033914,18,0
0,0,50,50,27,75,102,255,201,456,0.000333,1.014209,26,79108.27485,4394.904159,3042.625956,595.543364,16,0
0,0,49,49,24,63,87,257,209,466,0.000333,1.000804,36,108086.8201,6004.823338,3002.411669,486.607735,20,0
0,0,36,36,21,59,80,180,153,333,0.000333,0.701734,20,42104.04111,2339.113395,2105.202056,439.314606,10,0
0,0,48,48,24,63,87,252,205,457,0.000333,0.981475,36,105999.3064,5888.850355,2944.425178,486.607735,19,0
0,0,47,47,24,59,83,224,178,402,0.000333,0.854255,36,92259.57065,5125.531703,2562.765851,457.11504,13,0
0,0,49,49,27,74,101,252,198,450,0.000333,0.998732,26,77901.07435,4327.837464,2996.195167,587.881512,16,0
0,0,48,48,24,62,86,254,206,460,0.000333,0.985361,36,106418.9443,5912.163574,2956.081787,479.199271,20,0
0,0,35,35,21,58,79,177,150,327,0.000333,0.687112,20,41226.72609,2290.373672,2061.336305,432.001564,10,0
0,0,47,47,24,62,86,249,202,451,0.000333,0.966082,36,104336.8346,5796.490809,2898.245404,479.199271,19,0
0,0,47,47,24,59,83,224,178,402,0.000333,0.854255,36,92259.57065,5125.531703,2562.765851,457.11504,13,0
0,0,49,49,27,74,101,252,198,450,0.000333,0.998732,26,77901.07435,4327.837464,2996.195167,587.881512,16,0
0,0,48,48,24,62,86,254,206,460,0.000333,0.985361,36,106418.9443,5912.163574,2956.081787,479.199271,20,0
0,0,35,35,21,58,79,177,150,327,0.000333,0.687112,20,41226.72609,2290.373672,2061.336305,432.001564,10,0
0,0,47,47,24,62,86,249,202,451,0.000333,0.966082,36,104336.8346,5796.490809,2898.245404,479.199271,19,0
0,0,83,83,33,94,127,423,348,771,0.000333,1.796092,48,258637.2429,14368.73572,5388.275894,782.596358,24,0
0,0,113,113,35,107,142,528,439,967,0.000333,2.304602,68,470138.7716,26118.82064,6913.805465,900.861873,33,0
0,0,45,45,24,57,81,214,171,385,0.000333,0.813614,36,87870.32104,4881.684502,2440.842251,442.513831,12,0
0,0,47,47,27,72,99,242,191,433,0.000333,0.956837,26,74633.29683,4146.294268,2870.511416,572.616563,15,0
0,0,46,46,24,61,85,244,199,443,0.000333,0.946453,36,102216.9667,5678.720369,2839.360185,471.814078,19,0
0,0,33,33,21,56,77,167,143,310,0.000333,0.647568,20,38854.07655,2158.559808,1942.703828,417.450542,9,0
0,0,45,45,24,61,85,239,195,434,0.000333,0.927225,36,100140.324,5563.351333,2781.675666,471.814078,18,0
0,0,44,44,24,56,80,211,168,379,0.000333,0.79867,36,86256.38693,4792.021496,2396.010748,435.250976,12,0
0,0,46,46,27,71,98,239,188,427,0.000333,0.941494,26,73436.50869,4079.806038,2824.481103,565.014008,15,0
0,0,45,45,24,60,84,241,196,437,0.000333,0.931148,36,100563.9377,5586.885428,2793.442714,464.452536,19,0
0,0,32,32,21,55,76,164,140,304,0.000333,0.633123,20,37987.39928,2110.411071,1899.369964,410.21345,9,0
0,0,44,44,24,60,84,236,192,428,0.000333,0.911971,36,98492.82685,5471.823714,2735.911857,464.452536,18,0
0,0,44,44,24,56,80,211,168,379,0.000333,0.79867,36,86256.38693,4792.021496,2396.010748,435.250976,12,0
0,0,46,46,27,71,98,239,188,427,0.000333,0.941494,26,73436.50869,4079.806038,2824.481103,565.014008,15,0
0,0,45,45,24,60,84,241,196,437,0.000333,0.931148,36,100563.9377,5586.885428,2793.442714,464.452536,19,0
0,0,32,32,21,55,76,164,140,304,0.000333,0.633123,20,37987.39928,2110.411071,1899.369964,410.21345,9,0
0,0,44,44,24,60,84,236,192,428,0.000333,0.911971,36,98492.82685,5471.823714,2735.911857,464.452536,18,0
0,0,99,99,31,82,113,522,385,907,0.000333,2.061967,60,371154.1391,20619.6744,6185.902319,674.89935,54,0
0,0,49,49,27,55,82,263,198,461,0.000333,0.976944,39,114302.4275,6350.134861,2930.831474,446.356747,23,0
0,0,79,79,33,82,115,403,316,719,0.000333,1.640636,48,236251.5526,13125.08626,4921.907347,687.78427,30,0
0,0,47,47,27,69,96,243,194,437,0.000333,0.95921,26,74818.34393,4156.574663,2877.628613,549.87015,24,0
0,0,36,36,23,54,77,196,155,351,0.000333,0.733214,22,48392.12567,2688.451426,2199.642076,414.80585,18,0
0,0,40,40,23,61,84,215,173,388,0.000333,0.82674,22,54564.82152,3031.378973,2480.21916,465.816903,20,0
0,0,34,34,22,55,77,195,155,350,0.000333,0.731125,22,48254.25636,2680.79202,2193.375289,416.08228,18,0
0,0,42,42,25,61,86,214,173,387,0.000333,0.828988,24,59687.14704,3315.952613,2486.96446,477.871382,22,0
0,0,33,33,22,51,73,184,146,330,0.000333,0.680881,22,44938.1263,2496.562572,2042.642104,387.401188,17,0
0,0,37,37,22,58,80,203,164,367,0.000333,0.773383,22,51043.24744,2835.735969,2320.147611,437.870393,19,0
0,0,79,79,31,90,121,421,346,767,0.000333,1.768923,45,238804.5646,13266.92026,5306.768103,737.846864,20,0
0,0,81,81,31,94,125,425,351,776,0.000333,1.801816,45,243245.1872,13513.62151,5405.448605,769.711438,21,0
0,0,40,40,28,62,90,201,177,378,0.000333,0.817973,28,68709.77317,3817.209621,2453.92047,503.766109,12,0
0,0,47,47,26,73,99,217,202,419,0.000333,0.9259,26,72220.21102,4012.233946,2777.700424,574.068625,13,0
0,0,35,35,26,53,79,165,145,310,0.000333,0.651391,26,50808.47283,2822.692935,1954.172032,425.791217,7,0
0,0,79,79,31,90,121,421,346,767,0.000333,1.768923,45,238804.5646,13266.92026,5306.768103,737.846864,20,0
0,0,27,27,26,44,70,141,121,262,0.000333,0.535291,26,41752.67591,2319.593106,1605.87215,362.426424,7,0
0,0,91,91,33,110,143,482,398,880,0.000333,2.100229,48,302432.9653,16801.8314,6300.686776,912.414574,25,0
0,0,60,60,28,61,89,307,230,537,0.000333,1.159156,42,146053.6918,8114.093989,3477.468852,496.380915,26,0
0,0,85,85,33,98,131,454,369,823,0.000333,1.929502,48,277848.3423,15436.01901,5788.50713,814.706571,28,0
0,0,63,63,28,67,95,279,224,503,0.000333,1.101546,42,138794.7696,7710.820532,3304.637371,541.033914,18,0
0,0,50,50,27,75,102,255,201,456,0.000333,1.014209,26,79108.27485,4394.904159,3042.625956,595.543364,16,0
0,0,49,49,24,63,87,257,209,466,0.000333,1.000804,36,108086.8201,6004.823338,3002.411669,486.607735,20,0
0,0,36,36,21,59,80,180,153,333,0.000333,0.701734,20,42104.04111,2339.113395,2105.202056,439.314606,10,0
0,0,48,48,24,63,87,252,205,457,0.000333,0.981475,36,105999.3064,5888.850355,2944.425178,486.607735,19,0
0,0,47,47,24,59,83,224,178,402,0.000333,0.854255,36,92259.57065,5125.531703,2562.765851,457.11504,13,0
0,0,49,49,27,74,101,252,198,450,0.000333,0.998732,26,77901.07435,4327.837464,2996.195167,587.881512,16,0
0,0,48,48,24,62,86,254,206,460,0.000333,0.985361,36,106418.9443,5912.163574,2956.081787,479.199271,20,0
0,0,35,35,21,58,79,177,150,327,0.000333,0.687112,20,41226.72609,2290.373672,2061.336305,432.001564,10,0
0,0,47,47,24,62,86,249,202,451,0.000333,0.966082,36,104336.8346,5796.490809,2898.245404,479.199271,19,0
0,0,47,47,24,59,83,224,178,402,0.000333,0.854255,36,92259.57065,5125.531703,2562.765851,457.11504,13,0
0,0,49,49,27,74,101,252,198,450,0.000333,0.998732,26,77901.07435,4327.837464,2996.195167,587.881512,16,0
0,0,48,48,24,62,86,254,206,460,0.000333,0.985361,36,106418.9443,5912.163574,2956.081787,479.199271,20,0
0,0,35,35,21,58,79,177,150,327,0.000333,0.687112,20,41226.72609,2290.373672,2061.336305,432.001564,10,0
0,0,47,47,24,62,86,249,202,451,0.000333,0.966082,36,104336.8346,5796.490809,2898.245404,479.199271,19,0
0,0,83,83,33,94,127,423,348,771,0.000333,1.796092,48,258637.2429,14368.73572,5388.275894,782.596358,24,0
0,0,113,113,35,107,142,528,439,967,0.000333,2.304602,68,470138.7716,26118.82064,6913.805465,900.861873,33,0
0,0,45,45,24,57,81,214,171,385,0.000333,0.813614,36,87870.32104,4881.684502,2440.842251,442.513831,12,0
0,0,47,47,27,72,99,242,191,433,0.000333,0.956837,26,74633.29683,4146.294268,2870.511416,572.616563,15,0
0,0,46,46,24,61,85,244,199,443,0.000333,0.946453,36,102216.9667,5678.720369,2839.360185,471.814078,19,0
0,0,33,33,21,56,77,167,143,310,0.000333,0.647568,20,38854.07655,2158.559808,1942.703828,417.450542,9,0
0,0,45,45,24,61,85,239,195,434,0.000333,0.927225,36,100140.324,5563.351333,2781.675666,471.814078,18,0
0,0,44,44,24,56,80,211,168,379,0.000333,0.79867,36,86256.38693,4792.021496,2396.010748,435.250976,12,0
0,0,46,46,27,71,98,239,188,427,0.000333,0.941494,26,73436.50869,4079.806038,2824.481103,565.014008,15,0
0,0,45,45,24,60,84,241,196,437,0.000333,0.931148,36,100563.9377,5586.885428,2793.442714,464.452536,19,0
0,0,32,32,21,55,76,164,140,304,0.000333,0.633123,20,37987.39928,2110.411071,1899.369964,410.21345,9,0
0,0,44,44,24,60,84,236,192,428,0.000333,0.911971,36,98492.82685,5471.823714,2735.911857,464.452536,18,0
0,0,44,44,24,56,80,211,168,379,0.000333,0.79867,36,86256.38693,4792.021496,2396.010748,435.250976,12,0
0,0,46,46,27,71,98,239,188,427,0.000333,0.941494,26,73436.50869,4079.806038,2824.481103,565.014008,15,0
0,0,45,45,24,60,84,241,196,437,0.000333,0.931148,36,100563.9377,5586.885428,2793.442714,464.452536,19,0
0,0,32,32,21,55,76,164,140,304,0.000333,0.633123,20,37987.39928,2110.411071,1899.369964,410.21345,9,0
0,0,44,44,24,60,84,236,192,428,0.000333,0.911971,36,98492.82685,5471.823714,2735.911857,464.452536,18,0
0,0,99,99,31,82,113,522,385,907,0.000333,2.061967,60,371154.1391,20619.6744,6185.902319,674.89935,54,0
0,0,49,49,27,55,82,263,198,461,0.000333,0.976944,39,114302.4275,6350.134861,2930.831474,446.356747,23,0
0,0,70,70,26,65,91,334,262,596,0.000333,1.292882,52,201689.5715,11204.97619,3878.645606,513.665341,29,0
0,0,44,44,24,65,89,220,175,395,0.000333,0.852638,24,61389.95293,3410.55294,2557.914705,501.493008,24,0
0,0,33,33,19,49,68,173,136,309,0.000333,0.627009,18,33858.46832,1881.026018,1881.026018,355.831405,18,0
0,0,37,37,19,56,75,192,154,346,0.000333,0.71839,18,38793.0828,2155.171267,2155.171267,405.922498,20,0
0,0,31,31,18,50,68,172,136,308,0.000333,0.62498,18,33748.89399,1874.938555,1874.938555,357.25146,18,0
0,0,39,39,22,57,79,191,154,345,0.000333,0.724935,22,47845.69588,2658.094215,2174.804358,430.582226,22,0
0,0,30,30,18,46,64,161,127,288,0.000333,0.576,18,31104,1728,1728,329.1425,17,0
0,0,34,34,18,53,71,180,145,325,0.000333,0.666223,18,35976.02065,1998.667814,1998.667814,378.638434,19,0
0,0,76,76,29,86,115,398,327,725,0.000333,1.654327,42,208445.1721,11580.28734,4962.980287,693.540218,20,0
0,0,78,78,29,90,119,402,332,734,0.000333,1.686932,42,212553.442,11808.52456,5060.796238,725.148228,21,0
0,0,37,37,24,57,81,178,158,336,0.000333,0.710063,24,51124.55042,2840.252801,2130.189601,442.513831,12,0
0,0,44,44,22,68,90,194,183,377,0.000333,0.81581,22,53843.42958,2991.301643,2447.428617,512.054969,13,0
0,0,32,32,22,48,70,142,126,268,0.000333,0.547549,22,36138.25267,2007.680704,1642.647849,366.185696,7,0
0,0,76,76,29,86,115,398,327,725,0.000333,1.654327,42,208445.1721,11580.28734,4962.980287,693.540218,20,0
0,0,24,24,22,39,61,118,102,220,0.000333,0.434921,22,28704.76871,1594.709373,1304.762214,304.238182,7,0
0,0,88,88,31,106,137,459,379,838,0.000333,1.982717,45,267666.7898,14870.37721,5948.150886,866.739654,25,0
0,0,57,57,25,56,81,284,211,495,0.000333,1.046075,36,112976.1271,6276.451503,3138.225751,441.30828,26,0
0,0,82,82,31,94,125,431,350,781,0.000333,1.813426,45,244812.4887,13600.69382,5440.277526,769.711438,28,0
0,0,60,60,25,65,90,256,205,461,0.000333,0.997581,36,107738.794,5985.488555,2992.744277,507.550313,18,0
0,0,47,47,23,73,96,232,182,414,0.000333,0.908725,22,59975.83846,3331.991025,2726.174475,555.899118,16,0
0,0,46,46,20,61,81,234,190,424,0.000333,0.896032,30,80642.89204,4480.160669,2688.096401,448.213539,20,0
0,0,33,33,17,57,74,157,134,291,0.000333,0.602317,16,28911.21487,1606.178604,1806.950929,401.961599,10,0
0,0,45,45,20,61,81,229,186,415,0.000333,0.877013,30,78931.13254,4385.062919,2631.037751,448.213539,19,0
0,0,44,44,21,57,78,201,159,360,0.000333,0.754248,20,45254.89598,2514.160888,2262.744799,424.713397,13,0
0,0,46,46,23,72,95,229,179,408,0.000333,0.8935,22,58971.02394,3276.167997,2680.501088,548.276525,16,0
0,0,45,45,20,60,80,231,187,418,0.000333,0.880855,30,79276.97831,4404.276573,2642.565944,440.851998,20,0
0,0,32,32,17,56,73,154,131,285,0.000333,0.588033,16,28225.59999,1568.088888,1764.099999,394.698744,10,0
0,0,44,44,20,60,80,226,183,409,0.000333,0.86189,30,77570.05772,4309.447651,2585.668591,440.851998,19,0
0,0,44,44,21,57,78,201,159,360,0.000333,0.754248,20,45254.89598,2514.160888,2262.744799,424.713397,13,0
0,0,46,46,23,72,95,229,179,408,0.000333,0.8935,22,58971.02394,3276.167997,2680.501088,548.276525,16,0
0,0,45,45,20,60,80,231,187,418,0.000333,0.880855,30,79276.97831,4404.276573,2642.565944,440.851998,20,0
0,0,32,32,17,56,73,154,131,285,0.000333,0.588033,16,28225.59999,1568.088888,1764.099999,394.698744,10,0
0,0,44,44,20,60,80,226,183,409,0.000333,0.86189,30,77570.05772,4309.447651,2585.668591,440.851998,19,0
0,0,80,80,31,90,121,400,329,729,0.000333,1.681284,45,226973.3085,12609.62825,5043.8513,737.846864,24,0
0,0,110,110,33,106,139,505,420,925,0.000333,2.195007,48,316080.9836,17560.05465,6585.020492,879.624574,33,0
0,0,42,42,21,55,76,191,152,343,0.000333,0.714346,20,42860.78274,2381.154597,2143.039137,410.21345,12,0
0,0,44,44,23,70,93,219,172,391,0.000333,0.85227,22,56249.84409,3124.991339,2556.811095,533.091736,15,0
0,0,43,43,20,59,79,221,180,401,0.000333,0.842605,30,75834.4824,4213.0268,2527.81608,433.514502,19,0
0,0,30,30,17,54,71,144,124,268,0.000333,0.549377,16,26370.11565,1465.006425,1648.132228,380.250793,9,0
0,0,42,42,20,59,79,216,176,392,0.000333,0.823694,20,49421.64107,2745.646726,2471.082053,433.514502,18,0
0,0,41,41,21,54,75,188,149,337,0.000333,0.699704,20,41982.23797,2332.346554,2099.111899,403.002591,12,0
0,0,43,43,23,69,92,216,169,385,0.000333,0.83719,22,55254.56977,3069.69832,2511.571353,525.530113,15,0
0,0,42,42,20,58,78,218,177,395,0.000333,0.827578,30,74482.01629,4137.889794,2482.733876,426.20146,19,0
0,0,29,29,17,53,70,141,121,262,0.000333,0.535291,16,25693.95441,1427.441912,1605.87215,373.066652,9,0
0,0,41,41,20,58,78,213,173,386,0.000333,0.808722,20,48523.30513,2695.739174,2426.165256,426.20146,18,0
0,0,41,41,21,54,75,188,149,337,0.000333,0.699704,20,41982.23797,2332.346554,2099.111899,403.002591,12,0
0,0,43,43,23,69,92,216,169,385,0.000333,0.83719,22,55254.56977,3069.69832,2511.571353,525.530113,15,0
0,0,42,42,20,58,78,218,177,395,0.000333,0.827578,30,74482.01629,4137.889794,2482.733876,426.20146,19,0
0,0,29,29,17,53,70,141,121,262,0.000333,0.535291,16,25693.95441,1427.441912,1605.87215,373.066652,9,0
0,0,41,41,20,58,78,213,173,386,0.000333,0.808722,20,48523.30513,2695.739174,2426.165256,426.20146,18,0
0,0,96,96,27,78,105,499,366,865,0.000333,1.935941,52,302006.7634,16778.15352,5807.822373,618.643336,54,0
0,0,46,46,24,50,74,240,179,419,0.000333,0.867254,36,93663.39457,5203.52192,2601.76096,392.23191,23,0
0,0,78,78,30,72,102,373,290,663,0.000333,1.474606,60,265429.0801,14746.06001,4423.818002,591.441318,30,0
0,0,52,52,28,72,100,259,203,462,0.000333,1.023154,28,85944.92367,4774.717982,3069.46156,578.840538,25,0
0,0,41,41,24,57,81,212,164,376,0.000333,0.794595,24,57210.80643,3178.378135,2383.783601,442.513831,19,0
0,0,45,45,24,64,88,231,182,413,0.000333,0.889248,24,64025.8862,3556.993678,2667.745258,494.0391,21,0
0,0,39,39,24,58,82,211,164,375,0.000333,0.794694,24,57217.96804,3178.776002,2384.082002,449.801998,19,0
0,0,47,47,26,64,90,230,182,412,0.000333,0.891548,26,69540.73037,3863.373909,2674.643476,506.211433,23,0
0,0,38,38,24,54,78,200,155,355,0.000333,0.743773,24,53551.62691,2975.090384,2231.317788,420.803025,18,0
0,0,42,42,24,61,85,219,173,392,0.000333,0.837494,24,60299.54993,3349.974996,2512.481247,471.814078,20,0
0,0,84,84,32,93,125,437,355,792,0.000333,1.838967,48,264811.2554,14711.73641,5516.901153,768.141769,21,0
0,0,86,86,32,97,129,441,360,801,0.000333,1.871998,48,269567.6655,14975.98142,5615.993032,800.191546,22,0
0,0,45,45,29,62,91,217,186,403,0.000333,0.874214,42,110150.9321,6119.496227,2622.64124,510.04162,13,0
0,0,52,52,27,74,101,233,211,444,0.000333,0.985415,26,76862.39336,4270.132964,2956.245898,587.881512,14,0
0,0,40,40,27,56,83,181,154,335,0.000333,0.711879,26,55526.59345,3084.810747,2135.63821,453.593838,8,0
0,0,84,84,32,93,125,437,355,792,0.000333,1.838967,48,264811.2554,14711.73641,5516.901153,768.141769,21,0
0,0,32,32,27,47,74,157,130,287,0.000333,0.594038,26,46334.94101,2574.16339,1782.113116,389.447639,8,0
0,0,96,96,34,110,144,498,407,905,0.000333,2.162927,51,330927.8884,18384.88269,6488.782126,918.923305,26,0
0,0,65,65,29,64,93,323,239,562,0.000333,1.225002,42,154350.3046,8575.016921,3675.007252,524.881449,27,0
0,0,90,90,34,101,135,470,378,848,0.000333,2.00038,51,306058.1209,17003.22894,6001.139626,845.453096,29,0
0,0,68,68,29,69,98,295,233,528,0.000333,1.164189,42,146687.8055,8149.322528,3492.566798,562.369636,19,0
0,0,55,55,28,78,106,271,210,481,0.000333,1.07871,28,90611.63268,5033.979593,3236.129739,624.867311,17,0
0,0,54,54,25,66,91,273,218,491,0.000333,1.065109,36,115031.7781,6390.654337,3195.327168,515.026417,21,0
0,0,41,41,22,62,84,196,162,358,0.000333,0.762817,22,50345.89202,2796.994001,2288.449637,467.267667,11,0
0,0,53,53,25,66,91,268,214,482,0.000333,1.045586,36,112923.2526,6273.514033,3136.757017,515.026417,20,0
0,0,52,52,25,62,87,240,187,427,0.000333,0.917046,36,99040.92742,5502.273745,2751.136873,485.256576,14,0
0,0,54,54,28,77,105,268,207,475,0.000333,1.063089,28,89299.46539,4961.08141,3189.266621,617.148501,17,0
0,0,53,53,25,65,90,270,215,485,0.000333,1.049516,36,113347.7551,6297.097503,3148.548752,507.550313,21,0
0,0,40,40,22,61,83,193,159,352,0.000333,0.748005,22,49368.30536,2742.683631,2244.01388,459.882473,11,0
0,0,52,52,25,65,90,265,211,476,0.000333,1.030041,36,111244.3947,6180.244148,3090.122074,507.550313,20,0
0,0,52,52,25,62,87,240,187,427,0.000333,0.917046,36,99040.92742,5502.273745,2751.136873,485.256576,14,0
0,0,54,54,28,77,105,268,207,475,0.000333,1.063089,28,89299.46539,4961.08141,3189.266621,617.148501,17,0
0,0,53,53,25,65,90,270,215,485,0.000333,1.049516,36,113347.7551,6297.097503,3148.548752,507.550313,21,0
0,0,40,40,22,61,83,193,159,352,0.000333,0.748005,22,49368.30536,2742.683631,2244.01388,459.882473,11,0
0,0,52,52,25,65,90,265,211,476,0.000333,1.030041,36,111244.3947,6180.244148,3090.122074,507.550313,20,0
0,0,88,88,34,97,131,439,357,796,0.000333,1.866202,51,285528.8402,15862.71334,5598.604709,813.165282,25,0
0,0,118,118,36,109,145,544,448,992,0.000333,2.374157,72,512817.8268,28489.87927,7122.469817,923.849391,34,0
0,0,50,50,25,60,85,230,180,410,0.000333,0.87595,36,94602.61022,5255.700568,2627.850284,470.50984,13,0
0,0,52,52,28,75,103,258,200,458,0.000333,1.020806,28,85747.68276,4763.760153,3062.417241,601.76734,16,0
0,0,51,51,25,64,89,260,208,468,0.000333,1.010214,36,109103.1568,6061.286491,3030.643246,500.096405,20,0
0,0,38,38,22,59,81,183,152,335,0.000333,0.70795,22,46724.69452,2595.816362,2123.849751,445.183436,10,0
0,0,50,50,25,64,89,255,204,459,0.000333,0.990787,36,107005.0192,5944.72329,2972.361645,500.096405,19,0
0,0,49,49,25,59,84,227,177,404,0.000333,0.860832,36,92969.8646,5164.992478,2582.496239,463.172345,13,0
0,0,51,51,28,74,102,255,197,452,0.000333,1.005312,28,84446.21513,4691.456396,3015.936255,594.105487,16,0
0,0,50,50,25,63,88,257,205,462,0.000333,0.994752,36,107433.2667,5968.514816,2984.257408,492.66504,20,0
0,0,37,37,22,58,80,180,149,329,0.000333,0.693305,22,45758.11555,2542.117531,2079.914343,437.870393,10,0
0,0,49,49,25,63,88,252,201,453,0.000333,0.975374,36,105340.4108,5852.245046,2926.122523,492.66504,19,0
0,0,49,49,25,59,84,227,177,404,0.000333,0.860832,36,92969.8646,5164.992478,2582.496239,463.172345,13,0
0,0,51,51,28,74,102,255,197,452,0.000333,1.005312,28,84446.21513,4691.456396,3015.936255,594.105487,16,0
0,0,50,50,25,63,88,257,205,462,0.000333,0.994752,36,107433.2667,5968.514816,2984.257408,492.66504,20,0
0,0,37,37,22,58,80,180,149,329,0.000333,0.693305,22,45758.11555,2542.117531,2079.914343,437.870393,10,0
0,0,49,49,25,63,88,252,201,453,0.000333,0.975374,36,105340.4108,5852.245046,2926.122523,492.66504,19,0
0,0,104,104,32,84,116,538,394,932,0.000333,2.130546,64,409064.8504,22725.82502,6391.638287,696.954664,55,0
0,0,54,54,29,58,87,279,207,486,0.000333,1.043757,42,131513.3626,7306.297924,3131.270539,480.644347,24,0
0,0,86,86,34,90,124,436,342,778,0.000333,1.803455,51,275928.6012,15329.36673,5410.364729,757.240515,31,0
0,0,54,54,30,78,108,276,220,496,0.000333,1.116808,30,100512.726,5584.040335,3350.424201,637.468091,25,0
0,0,43,43,26,63,89,229,181,410,0.000333,0.885017,26,69031.31837,3835.073243,2655.050707,498.780068,19,0
0,0,47,47,26,70,96,248,199,447,0.000333,0.981159,26,76530.43418,4251.690788,2943.478238,551.261244,21,0
0,0,41,41,26,64,90,228,181,409,0.000333,0.885056,26,69034.36583,3835.242546,2655.167916,506.211433,19,0
0,0,49,49,28,70,98,247,199,446,0.000333,0.983387,28,82604.49653,4589.138696,2950.16059,563.655749,23,0
0,0,40,40,26,60,86,217,172,389,0.000333,0.833272,26,64995.24173,3610.846763,2499.81699,476.624868,18,0
0,0,44,44,26,67,93,236,190,426,0.000333,0.928561,26,72427.72299,4023.762388,2785.681654,528.639408,20,0
0,0,86,86,34,99,133,454,372,826,0.000333,1.942554,51,297210.8279,16511.71266,5827.663292,829.280042,21,0
0,0,88,88,34,103,137,458,377,835,0.000333,1.975619,51,302269.6963,16792.7609,5926.856789,861.683291,22,0
0,0,47,47,31,68,99,234,203,437,0.000333,0.965676,30,86910.86529,4828.381405,2897.028843,567.527559,13,0
0,0,54,54,29,80,109,250,228,478,0.000333,1.078397,28,90585.379,5032.521056,3235.192107,646.635696,14,0
0,0,42,42,29,62,91,198,171,369,0.000333,0.800459,28,67238.53422,3735.474123,2401.376222,510.04162,8,0
0,0,86,86,34,99,133,454,372,826,0.000333,1.942554,51,297210.8279,16511.71266,5827.663292,829.280042,21,0
0,0,34,34,29,53,82,174,147,321,0.000333,0.680258,28,57141.67742,3174.537634,2040.774193,444.461233,8,0
0,0,98,98,36,116,152,515,424,939,0.000333,2.268601,54,367513.4125,20417.41181,6805.803935,981.643095,26,0
0,0,67,67,31,70,101,340,256,596,0.000333,1.322765,45,178573.232,9920.735109,3968.294044,582.629897,27,0
0,0,92,92,36,107,143,487,395,882,0.000333,2.105002,54,341010.352,18945.01956,6315.006519,907.454268,29,0
0,0,70,70,31,75,106,312,250,562,0.000333,1.260364,45,170149.1083,9452.728239,3781.091295,620.741487,19,0
0,0,57,57,30,84,114,288,227,515,0.000333,1.172979,30,105568.1507,5864.897262,3518.938357,684.161381,17,0
0,0,56,56,27,72,99,290,235,525,0.000333,1.160137,39,135736.0768,7540.893155,3480.412226,572.616563,21,0
0,0,43,43,24,68,92,213,179,392,0.000333,0.852412,24,61373.67088,3409.648382,2557.236287,523.986573,11,0
0,0,55,55,27,72,99,285,231,516,0.000333,1.140249,39,133409.1726,7411.620701,3420.748016,572.616563,20,0
0,0,54,54,27,68,95,257,204,461,0.000333,1.009568,39,118119.434,6562.190777,3028.703435,542.329436,14,0
0,0,56,56,30,83,113,285,224,509,0.000333,1.157157,30,104144.1328,5785.785153,3471.471092,676.334991,17,0
0,0,55,55,27,71,98,287,232,519,0.000333,1.144345,39,133888.342,7438.24122,3433.034409,565.014008,21,0
0,0,42,42,24,67,91,210,176,386,0.000333,0.837336,24,60288.20955,3349.344975,2512.008731,516.467076,11,0
0,0,54,54,27,71,98,282,228,510,0.000333,1.124501,39,131566.5788,7309.254378,3373.50202,565.014008,20,0
0,0,54,54,27,68,95,257,204,461,0.000333,1.009568,39,118119.434,6562.190777,3028.703435,542.329436,14,0
0,0,56,56,30,83,113,285,224,509,0.000333,1.157157,30,104144.1328,5785.785153,3471.471092,676.334991,17,0
0,0,55,55,27,71,98,287,232,519,0.000333,1.144345,39,133888.342,7438.24122,3433.034409,565.014008,21,0
0,0,42,42,24,67,91,210,176,386,0.000333,0.837336,24,60288.20955,3349.344975,2512.008731,516.467076,11,0
0,0,54,54,27,71,98,282,228,510,0.000333,1.124501,39,131566.5788,7309.254378,3373.50202,565.014008,20,0
0,0,90,90,36,103,139,456,374,830,0.000333,1.969574,54,319070.9389,17726.16327,5908.72109,874.826854,25,0
0,0,52,52,27,66,93,247,197,444,0.000333,0.967796,26,75488.04932,4193.780518,2903.386512,527.311974,13,0
0,0,54,54,30,81,111,275,217,492,0.000333,1.114284,30,100285.5782,5571.42101,3342.852606,660.734568,16,0
0,0,53,53,27,70,97,277,225,502,0.000333,1.104385,39,129213.0936,7178.505201,3313.156247,557.431774,20,0
0,0,40,40,24,65,89,200,169,369,0.000333,0.796515,24,57349.09527,3186.060848,2389.545636,501.493008,10,0
0,0,52,52,27,70,97,272,221,493,0.000333,1.084586,39,126896.5242,7049.806901,3253.757031,557.431774,19,0
0,0,51,51,27,65,92,244,194,438,0.000333,0.95244,26,74290.32356,4127.240198,2857.320137,519.83587,13,0
0,0,53,53,30,80,110,272,214,486,0.000333,1.09858,30,98872.22462,5492.901368,3295.740821,652.960965,16,0
0,0,52,52,27,69,96,274,222,496,0.000333,1.088714,39,127379.5146,7076.639701,3266.1414,549.87015,20,0
0,0,39,39,24,64,88,197,166,363,0.000333,0.781591,24,56274.56826,3126.364903,2344.773678,494.0391,10,0
0,0,51,51,27,69,96,269,218,487,0.000333,1.068959,39,125068.1928,6948.232932,3206.876738,549.87015,19,0
0,0,51,51,27,65,92,244,194,438,0.000333,0.95244,26,74290.32356,4127.240198,2857.320137,519.83587,13,0
0,0,53,53,30,80,110,272,214,486,0.000333,1.09858,30,98872.22462,5492.901368,3295.740821,652.960965,16,0
0,0,52,52,27,69,96,274,222,496,0.000333,1.088714,39,127379.5146,7076.639701,3266.1414,549.87015,20,0
0,0,39,39,24,64,88,197,166,363,0.000333,0.781591,24,56274.56826,3126.364903,2344.773678,494.0391,10,0
0,0,51,51,27,69,96,269,218,487,0.000333,1.068959,39,125068.1928,6948.232932,3206.876738,549.87015,19,0
0,0,106,106,33,90,123,555,411,966,0.000333,2.23549,64,429214.0168,23845.22315,6706.469012,750.731785,55,0
0,0,56,56,31,64,95,296,224,520,0.000333,1.138775,45,153734.6212,8540.812291,3416.324916,537.580086,24,0
0,0,86,86,34,90,124,436,342,778,0.000333,1.803455,51,275928.6012,15329.36673,5410.364729,757.240515,31,0
0,0,54,54,30,78,108,276,220,496,0.000333,1.116808,30,100512.726,5584.040335,3350.424201,637.468091,25,0
0,0,43,43,26,63,89,229,181,410,0.000333,0.885017,26,69031.31837,3835.073243,2655.050707,498.780068,19,0
0,0,47,47,26,70,96,248,199,447,0.000333,0.981159,26,76530.43418,4251.690788,2943.478238,551.261244,21,0
0,0,41,41,26,64,90,228,181,409,0.000333,0.885056,26,69034.36583,3835.242546,2655.167916,506.211433,19,0
0,0,49,49,28,70,98,247,199,446,0.000333,0.983387,28,82604.49653,4589.138696,2950.16059,563.655749,23,0
0,0,40,40,26,60,86,217,172,389,0.000333,0.833272,26,64995.24173,3610.846763,2499.81699,476.624868,18,0
0,0,44,44,26,67,93,236,190,426,0.000333,0.928561,26,72427.72299,4023.762388,2785.681654,528.639408,20,0
0,0,86,86,34,99,133,454,372,826,0.000333,1.942554,51,297210.8279,16511.71266,5827.663292,829.280042,21,0
0,0,88,88,34,103,137,458,377,835,0.000333,1.975619,51,302269.6963,16792.7609,5926.856789,861.683291,22,0
0,0,47,47,31,68,99,234,203,437,0.000333,0.965676,30,86910.86529,4828.381405,2897.028843,567.527559,13,0
0,0,54,54,29,80,109,250,228,478,0.000333,1.078397,28,90585.379,5032.521056,3235.192107,646.635696,14,0
0,0,42,42,29,62,91,198,171,369,0.000333,0.800459,28,67238.53422,3735.474123,2401.376222,510.04162,8,0
0,0,86,86,34,99,133,454,372,826,0.000333,1.942554,51,297210.8279,16511.71266,5827.663292,829.280042,21,0
0,0,34,34,29,53,82,174,147,321,0.000333,0.680258,28,57141.67742,3174.537634,2040.774193,444.461233,8,0
0,0,98,98,36,116,152,515,424,939,0.000333,2.268601,54,367513.4125,20417.41181,6805.803935,981.643095,26,0
0,0,67,67,31,70,101,340,256,596,0.000333,1.322765,45,178573.232,9920.735109,3968.294044,582.629897,27,0
0,0,92,92,36,107,143,487,395,882,0.000333,2.105002,54,341010.352,18945.01956,6315.006519,907.454268,29,0
0,0,70,70,31,75,106,312,250,562,0.000333,1.260364,45,170149.1083,9452.728239,3781.091295,620.741487,19,0
0,0,57,57,30,84,114,288,227,515,0.000333,1.172979,30,105568.1507,5864.897262,3518.938357,684.161381,17,0
0,0,56,56,27,72,99,290,235,525,0.000333,1.160137,39,135736.0768,7540.893155,3480.412226,572.616563,21,0
0,0,43,43,24,68,92,213,179,392,0.000333,0.852412,24,61373.67088,3409.648382,2557.236287,523.986573,11,0
0,0,55,55,27,72,99,285,231,516,0.000333,1.140249,39,133409.1726,7411.620701,3420.748016,572.616563,20,0
0,0,54,54,27,68,95,257,204,461,0.000333,1.009568,39,118119.434,6562.190777,3028.703435,542.329436,14,0
0,0,56,56,30,83,113,285,224,509,0.000333,1.157157,30,104144.1328,5785.785153,3471.471092,676.334991,17,0
0,0,55,55,27,71,98,287,232,519,0.000333,1.144345,39,133888.342,7438.24122,3433.034409,565.014008,21,0
0,0,42,42,24,67,91,210,176,386,0.000333,0.837336,24,60288.20955,3349.344975,2512.008731,516.467076,11,0
0,0,54,54,27,71,98,282,228,510,0.000333,1.124501,39,131566.5788,7309.254378,3373.50202,565.014008,20,0
0,0,54,54,27,68,95,257,204,461,0.000333,1.009568,39,118119.434,6562.190777,3028.703435,542.329436,14,0
0,0,56,56,30,83,113,285,224,509,0.000333,1.157157,30,104144.1328,5785.785153,3471.471092,676.334991,17,0
0,0,55,55,27,71,98,287,232,519,0.000333,1.144345,39,133888.342,7438.24122,3433.034409,565.014008,21,0
0,0,42,42,24,67,91,210,176,386,0.000333,0.837336,24,60288.20955,3349.344975,2512.008731,516.467076,11,0
0,0,54,54,27,71,98,282,228,510,0.000333,1.124501,39,131566.5788,7309.254378,3373.50202,565.014008,20,0
0,0,90,90,36,103,139,456,374,830,0.000333,1.969574,54,319070.9389,17726.16327,5908.72109,874.826854,25,0
0,0,52,52,27,66,93,247,197,444,0.000333,0.967796,26,75488.04932,4193.780518,2903.386512,527.311974,13,0
0,0,54,54,30,81,111,275,217,492,0.000333,1.114284,30,100285.5782,5571.42101,3342.852606,660.734568,16,0
0,0,53,53,27,70,97,277,225,502,0.000333,1.104385,39,129213.0936,7178.505201,3313.156247,557.431774,20,0
0,0,40,40,24,65,89,200,169,369,0.000333,0.796515,24,57349.09527,3186.060848,2389.545636,501.493008,10,0
0,0,52,52,27,70,97,272,221,493,0.000333,1.084586,39,126896.5242,7049.806901,3253.757031,557.431774,19,0
0,0,51,51,27,65,92,244,194,438,0.000333,0.95244,26,74290.32356,4127.240198,2857.320137,519.83587,13,0
0,0,53,53,30,80,110,272,214,486,0.000333,1.09858,30,98872.22462,5492.901368,3295.740821,652.960965,16,0
0,0,52,52,27,69,96,274,222,496,0.000333,1.088714,39,127379.5146,7076.639701,3266.1414,549.87015,20,0
0,0,39,39,24,64,88,197,166,363,0.000333,0.781591,24,56274.56826,3126.364903,2344.773678,494.0391,10,0
0,0,51,51,27,69,96,269,218,487,0.000333,1.068959,39,125068.1928,6948.232932,3206.876738,549.87015,19,0
0,0,51,51,27,65,92,244,194,438,0.000333,0.95244,26,74290.32356,4127.240198,2857.320137,519.83587,13,0
0,0,53,53,30,80,110,272,214,486,0.000333,1.09858,30,98872.22462,5492.901368,3295.740821,652.960965,16,0
0,0,52,52,27,69,96,274,222,496,0.000333,1.088714,39,127379.5146,7076.639701,3266.1414,549.87015,20,0
0,0,39,39,24,64,88,197,166,363,0.000333,0.781591,24,56274.56826,3126.364903,2344.773678,494.0391,10,0
0,0,51,51,27,69,96,269,218,487,0.000333,1.068959,39,125068.1928,6948.232932,3206.876738,549.87015,19,0
0,0,106,106,33,90,123,555,411,966,0.000333,2.23549,64,429214.0168,23845.22315,6706.469012,750.731785,55,0
0,0,56,56,31,64,95,296,224,520,0.000333,1.138775,45,153734.6212,8540.812291,3416.324916,537.580086,24,0
0,0,80,80,34,89,123,414,328,742,0.000333,1.717115,51,262718.6339,14595.47966,5151.345763,749.314012,28,0
0,0,48,48,29,77,106,254,206,460,0.000333,1.031614,28,86655.61546,4814.200859,3094.843409,623.424012,22,0
0,0,37,37,25,62,87,207,167,374,0.000333,0.80322,24,57831.86082,3212.881157,2409.660867,485.256576,16,0
0,0,41,41,25,69,94,226,185,411,0.000333,0.897979,24,64654.46443,3591.914691,2693.936018,537.584592,18,0
0,0,35,35,24,63,87,206,167,373,0.000333,0.801073,24,57677.23018,3204.290565,2403.217924,486.607735,16,0
0,0,43,43,27,69,96,225,185,410,0.000333,0.899945,26,70195.70026,3899.761125,2699.834625,549.87015,20,0
0,0,34,34,24,59,83,195,158,353,0.000333,0.75013,24,54009.33406,3000.518559,2250.388919,457.11504,15,0
0,0,38,38,24,66,90,214,176,390,0.000333,0.843941,24,60763.74498,3375.76361,2531.822708,508.969112,17,0
0,0,80,80,33,97,130,432,358,790,0.000333,1.849224,48,266288.1875,14793.78819,5547.670572,806.656552,18,0
0,0,82,82,33,101,134,436,363,799,0.000333,1.881935,48,270998.6526,15055.4807,5645.805263,838.944366,19,0
0,0,41,41,31,66,97,212,189,401,0.000333,0.882188,30,79396.95149,4410.94175,2646.56505,552.510097,10,0
0,0,48,48,29,78,107,228,214,442,0.000333,0.993243,28,83432.39542,4635.133079,2979.728408,631.142822,11,0
0,0,36,36,28,60,88,176,157,333,0.000333,0.716997,28,60227.74041,3345.985578,2150.990729,489.019374,5,0
0,0,80,80,33,97,130,432,358,790,0.000333,1.849224,48,266288.1875,14793.78819,5547.670572,806.656552,18,0
0,0,28,28,28,51,79,152,133,285,0.000333,0.598859,28,50304.17037,2794.676132,1796.577513,423.89963,5,0
0,0,92,92,36,114,150,493,410,903,0.000333,2.175874,54,352491.657,19582.86983,6527.623278,965.066762,23,0
0,0,61,61,30,69,99,318,242,560,0.000333,1.23748,45,167059.7868,9281.099268,3712.439707,568.694905,24,0
0,0,86,86,36,105,141,465,381,846,0.000333,2.013353,54,326163.264,18120.18133,6040.060444,891.113079,26,0
0,0,64,64,31,74,105,290,236,526,0.000333,1.177231,45,158926.1914,8829.232856,3531.693142,613.079635,16,0
0,0,51,51,30,83,113,266,213,479,0.000333,1.088955,30,98005.97169,5444.776205,3266.865723,676.334991,14,0
0,0,50,50,26,71,97,268,221,489,0.000333,1.075786,39,125866.9378,6992.607656,3227.35738,558.843478,18,0
0,0,37,37,23,67,90,191,165,356,0.000333,0.770367,22,50844.19345,2824.677414,2311.099702,510.469901,8,0
0,0,49,49,26,71,97,263,217,480,0.000333,1.055986,39,123550.3684,6863.909356,3167.958164,558.843478,17,0
0,0,48,48,26,67,93,235,190,425,0.000333,0.926381,26,72257.70486,4014.316937,2779.142495,528.639408,11,0
0,0,50,50,30,82,112,263,210,473,0.000333,1.073293,30,96596.36634,5366.464797,3219.878878,668.525982,14,0
0,0,49,49,26,70,96,265,218,483,0.000333,1.060179,39,124040.9386,6891.163257,3180.536888,551.261244,18,0
0,0,36,36,23,66,89,188,162,350,0.000333,0.755502,22,49863.14742,2770.174857,2266.506701,502.971937,8,0
0,0,48,48,26,70,96,260,214,474,0.000333,1.040424,39,121729.6168,6762.756488,3121.272225,551.261244,17,0
0,0,48,48,26,67,93,235,190,425,0.000333,0.926381,26,72257.70486,4014.316937,2779.142495,528.639408,11,0
0,0,50,50,30,82,112,263,210,473,0.000333,1.073293,30,96596.36634,5366.464797,3219.878878,668.525982,14,0
0,0,49,49,26,70,96,265,218,483,0.000333,1.060179,39,124040.9386,6891.163257,3180.536888,551.261244,18,0
0,0,36,36,23,66,89,188,162,350,0.000333,0.755502,22,49863.14742,2770.174857,2266.506701,502.971937,8,0
0,0,48,48,26,70,96,260,214,474,0.000333,1.040424,39,121729.6168,6762.756488,3121.272225,551.261244,17,0
0,0,84,84,35,101,136,434,360,794,0.000333,1.875815,51,286999.7203,15944.42891,5627.445496,852.004265,22,0
0,0,114,114,38,114,152,539,451,990,0.000333,2.391816,57,409000.5496,22722.25276,7175.448238,978.370707,31,0
0,0,46,46,26,65,91,225,183,408,0.000333,0.88506,26,69034.68554,3835.260308,2655.180213,513.665341,10,0
0,0,48,48,30,80,110,253,203,456,0.000333,1.030767,30,92769.00088,5153.833382,3092.300029,652.960965,13,0
0,0,47,47,26,69,95,255,211,466,0.000333,1.020518,39,119400.5558,6633.364213,3061.552713,543.69962,17,0
0,0,34,34,23,64,87,178,155,333,0.000333,0.715167,22,47201.00405,2622.278003,2145.500184,488.041925,7,0
0,0,46,46,26,69,95,250,207,457,0.000333,1.000808,39,117094.5365,6505.252028,3002.424013,543.69962,16,0
0,0,45,45,26,64,90,222,180,402,0.000333,0.869908,26,67852.84856,3769.602698,2609.724945,506.211433,10,0
0,0,47,47,30,79,109,250,200,450,0.000333,1.015228,30,91370.48838,5076.138244,3045.682946,645.205397,13,0
0,0,46,46,26,68,94,252,208,460,0.000333,1.005037,39,117589.324,6532.740222,3015.110872,536.158906,17,0
0,0,33,33,23,63,86,175,152,327,0.000333,0.700463,22,46230.54865,2568.363814,2101.388575,480.61056,7,0
0,0,45,45,26,68,94,247,204,451,0.000333,0.985373,39,115288.6633,6404.92574,2956.119572,536.158906,16,0
0,0,45,45,26,64,90,222,180,402,0.000333,0.869908,26,67852.84856,3769.602698,2609.724945,506.211433,10,0
0,0,47,47,30,79,109,250,200,450,0.000333,1.015228,30,91370.48838,5076.138244,3045.682946,645.205397,13,0
0,0,46,46,26,68,94,252,208,460,0.000333,1.005037,39,117589.324,6532.740222,3015.110872,536.158906,17,0
0,0,33,33,23,63,86,175,152,327,0.000333,0.700463,22,46230.54865,2568.363814,2101.388575,480.61056,7,0
0,0,45,45,26,68,94,247,204,451,0.000333,0.985373,39,115288.6633,6404.92574,2956.119572,536.158906,16,0
0,0,100,100,33,90,123,533,397,930,0.000333,2.152179,64,413218.4634,22956.5813,6456.53849,750.731785,52,0
0,0,50,50,29,63,92,274,210,484,0.000333,1.052468,42,132610.9674,7367.275969,3157.403987,517.450084,21,0
0,0,16,16,22,42,64,108,91,199,0.000333,0.398,22,26268,1459.333333,1194,324.584827,2,0
0,0,68,68,26,65,91,326,258,584,0.000333,1.266851,39,148221.5307,8234.529485,3800.55207,513.665341,27,0
0,0,42,42,23,66,89,212,171,383,0.000333,0.826735,22,54564.52989,3031.362772,2480.205904,502.971937,22,0
0,0,31,31,18,49,67,165,132,297,0.000333,0.600543,18,32429.31281,1801.62849,1801.62849,350.179432,16,0
0,0,35,35,18,56,74,184,150,334,0.000333,0.691319,18,37331.23363,2073.957424,2073.957424,400.270526,18,0
0,0,29,29,17,50,67,164,132,296,0.000333,0.598521,16,28728.99841,1596.055467,1795.5624,351.679678,16,0
0,0,37,37,21,58,79,183,150,333,0.000333,0.69972,20,41983.17978,2332.398877,2099.158989,432.001564,20,0
0,0,28,28,17,46,63,153,123,276,0.000333,0.54991,16,26395.66814,1466.426008,1649.729259,323.570718,15,0
0,0,32,32,17,53,70,172,141,313,0.000333,0.639489,16,30695.44935,1705.302742,1918.465584,373.066652,17,0
0,0,74,74,28,86,114,390,323,713,0.000333,1.62395,42,204617.7244,11367.65135,4871.85058,687.264707,18,0
0,0,76,76,28,90,118,394,328,722,0.000333,1.656423,42,208709.2678,11594.95932,4969.268282,718.872716,19,0
0,0,35,35,24,55,79,170,154,324,0.000333,0.680808,24,49018.1991,2723.233283,2042.424962,428.013884,10,0
0,0,42,42,22,66,88,186,179,365,0.000333,0.785898,22,51869.2359,2881.624217,2357.692541,497.037507,11,0
0,0,30,30,21,47,68,134,122,256,0.000333,0.519463,20,31167.80975,1731.544986,1558.390487,353.304342,5,0
0,0,74,74,28,85,113,390,323,713,0.000333,1.620929,42,204237.0792,11346.5044,4862.7876,679.404167,18,0
0,0,22,22,21,38,59,110,98,208,0.000333,0.407863,20,24471.79509,1359.544171,1223.589754,291.659911,5,0
0,0,86,86,31,104,135,451,375,826,0.000333,1.948483,45,263045.2357,14613.62421,5845.449683,850.425816,23,0
0,0,55,55,24,57,81,276,207,483,0.000333,1.020716,36,110237.3119,6124.295103,3062.147551,442.513831,24,0
0,0,80,80,31,94,125,423,346,769,0.000333,1.785563,45,241050.9652,13391.72029,5356.688115,769.711438,26,0
0,0,58,58,25,65,90,248,201,449,0.000333,0.971614,36,104934.3134,5829.684081,2914.84204,507.550313,16,0
0,0,45,45,23,74,97,224,178,402,0.000333,0.884388,22,58369.62918,3242.757176,2653.164963,563.541474,14,0
0,0,44,44,19,61,80,226,186,412,0.000333,0.868211,27,70325.12813,3906.951563,2604.634375,442.4856,18,0
0,0,31,31,16,57,73,149,130,279,0.000333,0.575654,16,27631.37683,1535.076491,1726.961052,396.474731,8,0
0,0,43,43,19,61,80,221,182,403,0.000333,0.849246,18,45859.2664,2547.737022,2547.737022,442.4856,17,0
0,0,42,42,20,58,78,193,155,348,0.000333,0.729107,20,43746.39944,2430.355525,2187.319972,426.20146,11,0
0,0,44,44,23,73,96,221,175,396,0.000333,0.869215,22,57368.19331,3187.12185,2607.64515,555.899118,14,0
0,0,43,43,19,60,79,223,183,406,0.000333,0.853112,27,69102.04456,3839.002476,2559.334984,435.124058,18,0
0,0,30,30,16,56,72,146,127,273,0.000333,0.561463,16,26950.23241,1497.235134,1684.389525,389.211876,8,0
0,0,42,42,19,60,79,218,179,397,0.000333,0.8342,18,45046.81723,2502.600957,2502.600957,435.124058,17,0
0,0,42,42,20,58,78,193,155,348,0.000333,0.729107,20,43746.39944,2430.355525,2187.319972,426.20146,11,0
0,0,44,44,23,73,96,221,175,396,0.000333,0.869215,22,57368.19331,3187.12185,2607.64515,555.899118,14,0
0,0,43,43,19,60,79,223,183,406,0.000333,0.853112,27,69102.04456,3839.002476,2559.334984,435.124058,18,0
0,0,30,30,16,56,72,146,127,273,0.000333,0.561463,16,26950.23241,1497.235134,1684.389525,389.211876,8,0
0,0,42,42,19,60,79,218,179,397,0.000333,0.8342,18,45046.81723,2502.600957,2502.600957,435.124058,17,0
0,0,78,78,30,90,120,392,325,717,0.000333,1.650747,45,222850.8251,12380.60139,4952.240557,731.473497,22,0
0,0,108,108,33,106,139,497,416,913,0.000333,2.166531,48,311980.4736,17332.24853,6499.593199,879.624574,31,0
0,0,40,40,20,56,76,183,148,331,0.000333,0.689355,20,41361.28014,2297.848897,2068.064007,411.650438,10,0
0,0,42,42,23,71,94,211,168,379,0.000333,0.828063,22,54652.16185,3036.231214,2484.189175,540.67397,13,0
0,0,41,41,19,59,78,213,176,389,0.000333,0.815007,18,44010.38634,2445.021463,2445.021463,427.786563,17,0
0,0,28,28,16,54,70,136,120,256,0.000333,0.523032,16,25105.54324,1394.752402,1569.096452,374.763925,7,0
0,0,40,40,19,59,78,208,172,380,0.000333,0.796151,18,42992.15118,2388.452843,2388.452843,427.786563,16,0
0,0,39,39,20,55,75,180,145,325,0.000333,0.674789,20,40487.32149,2249.295638,2024.366074,404.413346,10,0
0,0,41,41,23,70,93,208,165,373,0.000333,0.813035,22,53660.3372,2981.129845,2439.106237,533.091736,13,0
0,0,40,40,19,58,77,210,173,383,0.000333,0.80006,18,43203.22641,2400.179245,2400.179245,420.47352,17,0
0,0,27,27,16,53,69,133,117,250,0.000333,0.509044,16,24434.09783,1357.449879,1527.131114,367.579784,7,0
0,0,39,39,19,58,77,205,169,374,0.000333,0.781259,18,42188.00699,2343.778166,2343.778166,420.47352,16,0
0,0,39,39,20,55,75,180,145,325,0.000333,0.674789,20,40487.32149,2249.295638,2024.366074,404.413346,10,0
0,0,41,41,23,70,93,208,165,373,0.000333,0.813035,22,53660.3372,2981.129845,2439.106237,533.091736,13,0
0,0,40,40,19,58,77,210,173,383,0.000333,0.80006,18,43203.22641,2400.179245,2400.179245,420.47352,17,0
0,0,27,27,16,53,69,133,117,250,0.000333,0.509044,16,24434.09783,1357.449879,1527.131114,367.579784,7,0
0,0,39,39,19,58,77,205,169,374,0.000333,0.781259,18,42188.00699,2343.778166,2343.778166,420.47352,16,0
0,0,94,94,27,79,106,491,362,853,0.000333,1.912972,52,298423.6397,16579.09109,5738.916148,626.380642,52,0
0,0,44,44,23,51,74,232,175,407,0.000333,0.842416,33,83399.16815,4633.28712,2527.24752,393.335617,21,0
0,0,31,31,26,55,81,153,128,281,0.000333,0.593833,26,46318.94412,2573.274673,1781.497851,440.186217,9,0
0,0,35,35,29,60,89,199,155,354,0.000333,0.764137,28,64187.46977,3565.970543,2292.409635,495.294885,10,0
0,0,32,32,29,57,86,178,141,319,0.000333,0.683326,28,57399.39679,3188.855377,2049.978457,473.35618,8,0
0,0,6,6,13,28,41,47,56,103,0.000333,0.183943,12,6621.934278,367.885238,551.827856,182.711654,3,0
0,0,6,6,13,27,40,43,46,89,0.000333,0.157884,6,2841.909603,157.883867,473.6516,176.487679,3,0
0,0,5,5,13,25,38,31,35,66,0.000333,0.115454,6,2078.179295,115.454405,346.363216,164.202121,3,0
0,0,4,4,11,18,29,19,23,42,0.000333,0.068012,5,1020.176009,56.676445,204.035202,113.112398,3,0
0,0,12,12,17,30,47,76,72,148,0.000333,0.274026,16,13153.2664,730.737022,822.07915,216.693586,4,0
0,0,19,19,23,46,69,131,113,244,0.000333,0.496827,22,32790.55928,1821.697738,1490.479967,358.125775,5,0
0,0,19,19,23,46,69,131,113,244,0.000333,0.496827,22,32790.55928,1821.697738,1490.479967,358.125775,5,0
0,0,19,19,23,46,69,131,113,244,0.000333,0.496827,22,32790.55928,1821.697738,1490.479967,358.125775,5,0
0,0,18,18,23,46,69,128,109,237,0.000333,0.482573,22,31849.84652,1769.435918,1447.720296,358.125775,5,0
0,0,19,19,23,46,69,131,113,244,0.000333,0.496827,22,32790.55928,1821.697738,1490.479967,358.125775,5,0
0,0,19,19,23,46,69,131,113,244,0.000333,0.496827,22,32790.55928,1821.697738,1490.479967,358.125775,5,0
0,0,7,7,15,26,41,49,48,97,0.000333,0.173228,7,3637.777811,202.098767,519.682544,180.814792,4,0
0,0,10,10,17,29,46,68,76,144,0.000333,0.265131,16,12726.28675,707.01593,795.392922,210.368317,4,0
0,0,17,17,24,46,70,124,120,244,0.000333,0.498515,24,35893.08135,1994.060075,1495.545056,364.12295,5,0
0,0,16,16,24,46,70,121,115,236,0.000333,0.48217,24,34716.25901,1928.681056,1446.510792,364.12295,5,0
0,0,17,17,24,46,70,124,120,244,0.000333,0.498515,24,35893.08135,1994.060075,1495.545056,364.12295,5,0
0,0,7,7,15,28,43,53,58,111,0.000333,0.200772,14,8432.415429,468.467524,602.315388,193.209297,4,0
0,0,5,5,13,17,30,25,25,50,0.000333,0.081782,6,1472.067179,81.78151,245.34453,117.592585,4,0
0,0,5,5,13,17,30,25,25,50,0.000333,0.081782,6,1472.067179,81.78151,245.34453,117.592585,4,0
0,0,5,5,15,23,38,31,33,64,0.000333,0.111956,7,2351.071526,130.615085,335.867361,162.645284,3,0
0,0,4,4,13,16,29,19,21,40,0.000333,0.064773,6,1165.915439,64.77308,194.31924,112.105716,3,0
0,0,5,5,14,24,38,42,38,80,0.000333,0.139945,7,2938.839408,163.268856,419.834201,163.342069,1,0
0,0,12,12,20,40,60,97,79,176,0.000333,0.346538,10,10396.12745,577.562636,1039.612745,299.315686,2,0
0,0,12,12,20,40,60,97,79,176,0.000333,0.346538,10,10396.12745,577.562636,1039.612745,299.315686,2,0
0,0,15,15,15,56,71,138,137,275,0.000333,0.563727,14,23676.52641,1315.362578,1691.180458,383.815235,2,0
0,0,15,15,15,56,71,138,137,275,0.000333,0.563727,14,23676.52641,1315.362578,1691.180458,383.815235,2,0
0,0,15,15,15,56,71,138,137,275,0.000333,0.563727,14,23676.52641,1315.362578,1691.180458,383.815235,2,0
0,0,15,15,15,56,71,138,137,275,0.000333,0.563727,14,23676.52641,1315.362578,1691.180458,383.815235,2,0
0,0,15,15,15,56,71,138,137,275,0.000333,0.563727,14,23676.52641,1315.362578,1691.180458,383.815235,2,0
0,0,15,15,15,56,71,138,137,275,0.000333,0.563727,14,23676.52641,1315.362578,1691.180458,383.815235,2,0
0,0,15,15,15,56,71,138,137,275,0.000333,0.563727,14,23676.52641,1315.362578,1691.180458,383.815235,2,0
0,0,15,15,15,56,71,138,137,275,0.000333,0.563727,14,23676.52641,1315.362578,1691.180458,383.815235,2,0
0,0,15,15,15,56,71,138,137,275,0.000333,0.563727,14,23676.52641,1315.362578,1691.180458,383.815235,2,0
0,0,14,14,14,56,70,130,132,262,0.000333,0.535291,14,22482.21011,1249.011673,1605.87215,378.514845,1,0
0,0,15,15,15,56,71,138,137,275,0.000333,0.563727,14,23676.52641,1315.362578,1691.180458,383.815235,2,0
0,0,15,15,15,56,71,138,137,275,0.000333,0.563727,14,23676.52641,1315.362578,1691.180458,383.815235,2,0
0,0,15,15,15,56,71,138,137,275,0.000333,0.563727,14,23676.52641,1315.362578,1691.180458,383.815235,2,0
0,0,15,15,15,56,71,138,137,275,0.000333,0.563727,14,23676.52641,1315.362578,1691.180458,383.815235,2,0
0,0,15,15,15,56,71,138,137,275,0.000333,0.563727,14,23676.52641,1315.362578,1691.180458,383.815235,2,0
0,0,15,15,15,56,71,138,137,275,0.000333,0.563727,14,23676.52641,1315.362578,1691.180458,383.815235,2,0
0,0,15,15,15,56,71,138,137,275,0.000333,0.563727,14,23676.52641,1315.362578,1691.180458,383.815235,2,0
0,0,3,3,10,13,23,16,16,32,0.000333,0.048251,5,723.769913,40.20944,144.753983,81.324997,2,0
0,0,14,14,14,56,70,130,132,262,0.000333,0.535291,14,22482.21011,1249.011673,1605.87215,378.514845,1,0
0,0,57,57,27,73,100,255,216,471,0.000333,1.043085,26,81360.6629,4520.036828,3129.256265,580.239155,12,0
0,0,41,41,26,67,93,191,156,347,0.000333,0.756363,26,58996.29079,3277.571711,2269.088107,528.639408,12,0
0,0,40,40,26,63,89,192,157,349,0.000333,0.753344,26,58760.80515,3264.489175,2260.030967,498.780068,11,0
0,0,77,77,32,101,133,419,344,763,0.000333,1.794393,48,258392.6639,14355.148,5383.180498,832.47936,13,0
0,0,34,34,29,63,92,202,156,358,0.000333,0.778478,28,65392.18505,3632.899169,2335.43518,517.450084,9,0
0,0,10,10,18,23,41,52,38,90,0.000333,0.160727,9,4339.617124,241.08984,482.17968,179.100575,3,0
0,0,10,10,18,23,41,52,38,90,0.000333,0.160727,9,4339.617124,241.08984,482.17968,179.100575,3,0
0,0,9,9,15,19,34,40,29,69,0.000333,0.117012,7,2457.244552,136.513586,351.034936,139.313982,3,0
0,0,5,5,13,19,32,32,25,57,0.000333,0.095,6,1710,95,285,128.816339,1,0
0,0,5,5,13,19,32,32,25,57,0.000333,0.095,6,1710,95,285,128.816339,1,0
0,0,5,5,13,19,32,32,25,57,0.000333,0.095,6,1710,95,285,128.816339,1,0
0,0,5,5,13,19,32,32,25,57,0.000333,0.095,6,1710,95,285,128.816339,1,0
0,0,8,8,19,26,45,44,38,82,0.000333,0.150111,9,4052.987585,225.165977,450.331954,202.922055,3,0
0,0,8,8,19,26,45,44,38,82,0.000333,0.150111,9,4052.987585,225.165977,450.331954,202.922055,3,0
0,0,65,65,25,55,80,255,179,434,0.000333,0.914572,36,98773.80456,5487.433586,2743.716793,434.071189,17,0
0,0,63,63,25,53,78,234,170,404,0.000333,0.846434,36,91414.88987,5078.604993,2539.302496,419.676189,15,0
0,0,66,66,25,57,82,263,193,456,0.000333,0.966348,36,104365.5737,5798.087428,2899.043714,448.571136,15,0
0,0,62,62,25,51,76,226,164,390,0.000333,0.812231,36,87720.90229,4873.38346,2436.69173,405.390097,15,0
0,0,75,75,29,63,92,293,221,514,0.000333,1.117704,42,140830.6555,7823.925306,3353.110845,517.450084,19,0
0,0,42,42,22,31,53,147,90,237,0.000333,0.452506,22,29865.37725,1659.187625,1357.517148,251.687581,10,0
0,0,54,54,24,40,64,202,130,332,0.000333,0.664,36,71712,3984,1992,322.916224,13,0
0,0,52,52,22,36,58,180,117,297,0.000333,0.57994,33,57414.07173,3189.670652,1739.820356,284.224796,13,0
0,0,33,33,18,24,42,99,62,161,0.000333,0.289388,18,15626.93589,868.163105,868.163105,185.09775,6,0
0,0,45,45,21,37,58,180,115,295,0.000333,0.576035,30,51843.13181,2880.173989,1728.104394,284.98844,9,0
0,0,45,45,21,37,58,180,115,295,0.000333,0.576035,30,51843.13181,2880.173989,1728.104394,284.98844,9,0
0,0,11,11,17,27,44,68,53,121,0.000333,0.220197,8,5284.729807,293.5961,660.591226,197.868831,5,0
0,0,10,10,16,22,38,58,44,102,0.000333,0.17843,16,8564.617702,475.812095,535.288606,162.107496,5,0
0,0,5,5,14,19,33,31,24,55,0.000333,0.092481,7,1942.091736,107.893985,277.441677,134.013592,2,0
0,0,3,3,12,14,26,19,15,34,0.000333,0.053272,6,958.889703,53.27165,159.81495,96.322519,2,0
0,0,3,3,11,15,26,18,17,35,0.000333,0.054838,5,822.576951,45.698719,164.51539,96.657107,1,0
0,0,9,9,16,26,42,49,37,86,0.000333,0.15458,8,3709.914387,206.106355,463.739298,186.211433,2,0
0,0,6,6,13,20,33,34,27,61,0.000333,0.102569,6,1846.248248,102.569347,307.708041,134.544278,1,0
0,0,15,15,16,30,46,61,49,110,0.000333,0.202531,8,4860.734521,270.040807,607.591815,211.206718,4,0
0,0,20,20,19,34,53,82,65,147,0.000333,0.280668,9,7578.038761,421.002153,842.004307,253.684359,6,0
0,0,15,15,20,34,54,74,54,128,0.000333,0.245542,10,7366.256003,409.236445,736.6256,259.412299,4,0
0,0,20,20,22,38,60,95,70,165,0.000333,0.324879,11,10721.00643,595.611468,974.636948,297.528741,6,0
0,0,13,13,19,29,48,69,54,123,0.000333,0.228983,9,6182.553488,343.475194,686.950388,221.592072,4,0
0,0,9,9,15,21,36,39,31,70,0.000333,0.120632,7,2533.263251,140.736847,361.89475,150.842025,4,0
0,0,77,77,34,88,122,462,330,792,0.000333,1.829715,51,279946.3425,15552.57459,5489.143971,741.403719,47,0
0,0,77,77,34,87,121,460,331,791,0.000333,1.824274,51,279113.8619,15506.32566,5472.820821,733.509821,46,0
0,0,78,78,34,87,121,469,333,802,0.000333,1.849643,51,282995.3441,15721.96356,5548.928316,733.509821,47,0
0,0,79,79,34,89,123,478,340,818,0.000333,1.892992,51,289627.8201,16090.43445,5678.976865,749.314012,47,0
0,0,79,79,34,89,123,478,340,818,0.000333,1.892992,51,289627.8201,16090.43445,5678.976865,749.314012,47,0
0,0,19,19,22,33,55,175,122,297,0.000333,0.572355,33,56663.10655,3147.950364,1717.063835,264.572502,18,0
0,0,16,16,21,30,51,157,107,264,0.000333,0.499173,30,44925.60871,2495.86715,1497.52029,239.445384,18,0
0,0,75,75,31,81,112,399,302,701,0.000333,1.590652,45,214738.011,11929.8895,4771.9558,667.107936,37,0
2,0,71,73,26,97,123,318,233,551,0.000333,1.275108,26,99458.4628,5525.470156,3825.325492,762.402978,46,0
2,0,25,27,18,49,67,118,89,207,0.000333,0.41856,9,11301.12416,627.840231,1255.680462,350.179432,12,0
1,0,57,58,26,91,117,257,194,451,0.000333,1.032845,26,80561.8967,4475.660928,3098.534489,714.420745,28,0
2,0,30,32,18,47,65,122,95,217,0.000333,0.435618,18,23523.36868,1306.853815,1306.853815,336.124326,13,0
2,0,70,72,26,96,122,316,231,547,0.000333,1.263704,26,98568.94642,5476.052579,3791.113324,754.367833,46,0
2,0,24,26,18,48,66,116,87,203,0.000333,0.409004,9,11043.10806,613.506003,1227.012006,343.13685,12,0
1,0,56,57,26,90,116,255,192,447,0.000333,1.021839,26,79703.45513,4427.969729,3065.517505,706.478211,28,0
2,0,29,31,18,46,64,120,93,213,0.000333,0.426,18,23004,1278,1278,329.1425,13,0
1,0,95,96,30,75,105,497,408,905,0.000333,2.025464,75,455729.4145,25318.30081,6076.392193,614.36812,30,0
1,0,71,72,29,73,102,437,345,782,0.000333,1.739279,56,292198.8506,16233.26948,5217.836617,592.738642,24,0
1,0,71,72,29,73,102,437,345,782,0.000333,1.739279,56,292198.8506,16233.26948,5217.836617,592.738642,24,0
0,0,4,4,10,15,25,20,19,39,0.000333,0.06037,5,905.551957,50.308442,181.110391,91.82264,2,0
0,0,19,19,23,30,53,105,78,183,0.000333,0.349403,22,23060.60775,1281.144875,1048.209443,251.248643,9,0
0,0,7,7,14,19,33,33,28,61,0.000333,0.102569,7,2153.956289,119.664238,307.708041,134.013592,3,0
0,0,14,14,18,27,45,68,54,122,0.000333,0.223335,18,12060.1094,670.006078,670.006078,203.440613,7,0
0,0,21,21,21,33,54,116,91,207,0.000333,0.397087,20,23825.23426,1323.624125,1191.261713,258.703672,8,0
0,0,16,16,15,28,43,65,55,120,0.000333,0.217051,7,4558.062394,253.225689,651.151771,193.209297,9,0
0,0,13,13,12,25,37,52,46,98,0.000333,0.170175,6,3063.158579,170.175477,510.52643,159.115955,8,0
0,0,16,16,14,22,36,65,48,113,0.000333,0.194734,14,8178.821352,454.378964,584.201525,151.410465,10,0
0,0,16,16,17,35,52,75,64,139,0.000333,0.26412,8,6338.888967,352.160498,792.361121,249.011774,8,0
0,0,13,13,14,32,46,62,55,117,0.000333,0.215419,7,4523.797242,251.322069,646.256749,213.302969,7,0
0,0,16,16,16,29,45,75,57,132,0.000333,0.241642,8,5799.39687,322.188715,724.924609,204.881449,9,0
0,0,17,17,18,37,55,85,72,157,0.000333,0.302558,9,8169.061275,453.836738,907.673475,267.808425,8,0
0,0,14,14,15,34,49,72,63,135,0.000333,0.252662,7,5305.900803,294.772267,757.985829,231.577096,7,0
0,0,17,17,17,31,48,85,65,150,0.000333,0.279248,16,13403.91,744.661667,837.744375,223.066954,9,0
0,0,18,18,18,37,55,95,79,174,0.000333,0.335319,18,18107.21862,1005.95659,1005.95659,267.808425,8,0
0,0,15,15,15,34,49,82,70,152,0.000333,0.284479,14,11948.10255,663.783475,853.435896,231.577096,7,0
0,0,18,18,17,31,48,95,72,167,0.000333,0.310896,16,14923.0198,829.056656,932.688738,223.066954,9,0
0,0,16,16,17,36,53,80,68,148,0.000333,0.282577,8,6781.857818,376.769879,847.732227,255.604168,8,0
0,0,13,13,14,33,47,67,59,126,0.000333,0.233293,7,4899.147367,272.174854,699.878195,219.767975,7,0
0,0,16,16,16,30,46,80,61,141,0.000333,0.259607,16,12461.15577,692.286432,778.822236,211.206718,9,0
0,0,16,16,17,36,53,80,68,148,0.000333,0.282577,8,6781.857818,376.769879,847.732227,255.604168,8,0
0,0,13,13,14,33,47,67,59,126,0.000333,0.233293,7,4899.147367,272.174854,699.878195,219.767975,7,0
0,0,16,16,16,30,46,80,61,141,0.000333,0.259607,16,12461.15577,692.286432,778.822236,211.206718,9,0
0,0,15,15,15,28,43,62,53,115,0.000333,0.208007,7,4368.143128,242.674618,624.020447,193.209297,8,0
0,0,12,12,12,25,37,49,44,93,0.000333,0.161493,6,2906.874978,161.493054,484.479163,159.115955,7,0
0,0,15,15,14,22,36,62,46,108,0.000333,0.186117,14,7816.926602,434.2737,558.3519,151.410465,9,0
0,0,17,17,18,35,53,90,75,165,0.000333,0.315036,18,17011.92375,945.106875,945.106875,254.583556,7,0
0,0,14,14,15,32,47,77,66,143,0.000333,0.264769,14,11120.28688,617.793716,794.306206,218.603359,6,0
0,0,17,17,17,29,46,90,68,158,0.000333,0.290908,16,13963.56463,775.75359,872.722789,210.368317,8,0
0,0,15,15,17,35,52,77,66,143,0.000333,0.271721,8,6521.303038,362.294613,815.16288,249.011774,7,0
0,0,12,12,14,32,46,64,57,121,0.000333,0.222784,7,4678.456977,259.914276,668.350997,213.302969,6,0
0,0,15,15,16,29,45,77,59,136,0.000333,0.248964,16,11950.27234,663.904019,746.892021,204.881449,8,0
0,0,15,15,17,35,52,77,66,143,0.000333,0.271721,8,6521.303038,362.294613,815.16288,249.011774,7,0
0,0,12,12,14,32,46,64,57,121,0.000333,0.222784,7,4678.456977,259.914276,668.350997,213.302969,6,0
0,0,15,15,16,29,45,77,59,136,0.000333,0.248964,16,11950.27234,663.904019,746.892021,204.881449,8,0
0,0,14,14,17,26,43,64,54,118,0.000333,0.213433,16,10244.78786,569.154881,640.299241,191.698301,7,0
0,0,11,11,14,23,37,51,45,96,0.000333,0.166703,7,3500.752662,194.486259,500.107523,157.344894,6,0
0,0,14,14,16,20,36,64,47,111,0.000333,0.191287,16,9181.786803,510.099267,573.861675,150.438562,8,0
0,0,14,14,17,33,50,69,60,129,0.000333,0.242686,8,5824.459588,323.581088,728.057448,235.951874,6,0
0,0,11,11,14,30,44,56,51,107,0.000333,0.19472,7,4089.114282,227.173016,584.159183,200.509687,5,0
0,0,14,14,16,27,43,69,53,122,0.000333,0.220668,8,5296.034401,294.224133,662.0043,192.381963,7,0
0,0,14,14,17,35,52,74,64,138,0.000333,0.26222,8,6293.285449,349.626969,786.660681,249.011774,6,0
0,0,11,11,14,32,46,61,55,116,0.000333,0.213578,7,4485.132308,249.174017,640.733187,213.302969,5,0
0,0,14,14,16,29,45,74,57,131,0.000333,0.239811,8,5755.462045,319.747891,719.432756,204.881449,7,0
0,0,14,14,17,34,51,74,64,138,0.000333,0.260932,8,6262.357578,347.908754,782.794697,242.460605,6,0
0,0,11,11,14,31,45,61,55,116,0.000333,0.212352,7,4459.384714,247.743595,637.054959,206.883055,5,0
0,0,14,14,16,28,44,74,57,131,0.000333,0.238395,16,11442.96867,635.720482,715.185542,198.605938,7,0
0,0,14,14,17,34,51,74,64,138,0.000333,0.260932,8,6262.357578,347.908754,782.794697,242.460605,6,0
0,0,11,11,14,31,45,61,55,116,0.000333,0.212352,7,4459.384714,247.743595,637.054959,206.883055,5,0
0,0,14,14,16,28,44,74,57,131,0.000333,0.238395,16,11442.96867,635.720482,715.185542,198.605938,7,0
0,0,13,13,17,26,43,61,52,113,0.000333,0.204389,16,9810.686677,545.038149,613.167917,191.698301,6,0
0,0,10,10,14,23,37,48,43,91,0.000333,0.15802,7,3318.421794,184.356766,474.060256,157.344894,5,0
0,0,13,13,16,20,36,61,45,106,0.000333,0.182671,16,8768.192802,487.121822,548.01205,150.438562,7,0
0,0,13,13,17,34,51,71,62,133,0.000333,0.251478,8,6035.460564,335.303365,754.43257,242.460605,5,0
0,0,10,10,14,31,45,58,53,111,0.000333,0.203199,7,4267.169856,237.064992,609.595694,206.883055,4,0
0,0,13,13,16,28,44,71,55,126,0.000333,0.229296,8,5503.107072,305.728171,687.888384,198.605938,6,0
0,0,13,13,17,33,50,71,62,133,0.000333,0.250211,8,6005.062986,333.61461,750.632873,235.951874,5,0
0,0,10,10,14,30,44,58,53,111,0.000333,0.201999,7,4241.978368,235.665465,605.99691,200.509687,4,0
0,0,13,13,16,27,43,71,55,126,0.000333,0.227903,16,10939.34975,607.741653,683.709359,192.381963,6,0
0,0,10,10,17,31,48,60,53,113,0.000333,0.210367,8,5048.806101,280.489228,631.100763,223.066954,3,0
0,0,7,7,14,28,42,47,44,91,0.000333,0.163567,7,3434.906198,190.828122,490.700885,187.908907,2,0
0,0,10,10,16,25,41,60,46,106,0.000333,0.1893,8,4543.2041,252.400228,567.900512,180.096405,4,0
0,0,37,37,22,37,59,149,122,271,0.000333,0.531399,33,52608.47679,2922.693155,1594.196266,290.85727,10,0
0,0,34,34,19,35,54,136,113,249,0.000333,0.477656,27,38690.10868,2149.450482,1432.966988,260.235528,9,0
0,0,37,37,21,32,53,149,115,264,0.000333,0.504057,30,45365.13,2520.285,1512.171,252.238666,11,0
0,0,50,50,22,39,61,200,163,363,0.000333,0.717619,44,94725.73676,5262.540931,2152.857654,304.238182,10,0
0,0,47,47,19,37,56,187,154,341,0.000333,0.660103,36,71291.08902,3960.616057,1980.308028,273.460397,9,0
0,0,50,50,21,34,55,200,156,356,0.000333,0.686055,40,82326.56232,4573.697907,2058.164058,265.212402,11,0
0,0,12,12,17,17,34,52,37,89,0.000333,0.150928,16,7244.547086,402.474838,452.784193,138.973737,6,0
0,0,69,69,28,67,95,361,299,660,0.000333,1.445368,56,242821.8633,13490.10352,4336.104701,541.033914,29,0
0,0,59,59,27,59,86,302,243,545,0.000333,1.167438,52,182120.3431,10117.79684,3502.314291,475.457902,30,0
0,0,73,73,28,69,97,381,299,680,0.000333,1.49598,56,251324.681,13962.48228,4487.940733,556.094125,35,0
0,0,69,69,28,67,95,361,299,660,0.000333,1.445368,56,242821.8633,13490.10352,4336.104701,541.033914,29,0
0,0,59,59,27,59,86,302,243,545,0.000333,1.167438,52,182120.3431,10117.79684,3502.314291,475.457902,30,0
0,0,73,73,28,69,97,381,299,680,0.000333,1.49598,56,251324.681,13962.48228,4487.940733,556.094125,35,0
0,0,53,53,27,54,81,276,240,516,0.000333,1.090454,52,170110.8553,9450.603071,3271.362601,439.145888,22,0
0,0,43,43,25,46,71,217,184,401,0.000333,0.822016,48,118370.3326,6576.129586,2466.048595,370.180255,23,0
0,0,57,57,27,56,83,296,240,536,0.000333,1.139007,52,177685.099,9871.394391,3417.021135,453.593838,28,0
0,0,29,29,23,38,61,147,131,278,0.000333,0.549582,33,54408.58434,3022.69913,1648.74498,303.463171,15,0
0,0,26,26,23,37,60,132,118,250,0.000333,0.492241,33,48731.84741,2707.324856,1476.722649,296.7917,16,0
0,0,40,40,25,47,72,211,174,385,0.000333,0.791807,36,85515.16052,4750.842251,2375.421126,377.162081,21,0
0,0,25,25,23,37,60,129,115,244,0.000333,0.480427,33,47562.28308,2642.34906,1441.281305,296.7917,11,0
0,0,22,22,23,36,59,114,102,216,0.000333,0.42355,22,27954.31977,1553.017765,1270.650899,290.159225,12,0
0,0,36,36,25,46,71,193,158,351,0.000333,0.71952,36,77708.2046,4317.122478,2158.561239,370.180255,17,0
0,0,22,22,18,49,67,106,104,210,0.000333,0.424626,18,22929.81714,1273.87873,1273.87873,350.179432,4,0
0,0,23,23,21,53,74,129,130,259,0.000333,0.536083,20,32164.96843,1786.942691,1608.248422,395.81845,5,0
0,0,6,6,14,16,30,21,22,43,0.000333,0.070332,7,1476.974069,82.054115,210.996296,117.302969,3,0
0,0,23,23,21,53,74,129,130,259,0.000333,0.536083,20,32164.96843,1786.942691,1608.248422,395.81845,5,0
0,0,23,23,19,55,74,128,131,259,0.000333,0.536083,18,28948.47159,1608.248422,1608.248422,398.685407,4,0
0,0,20,20,13,48,61,90,93,183,0.000333,0.361775,6,6511.949597,361.774978,1085.324933,316.183916,3,0
0,0,20,20,12,47,59,89,92,181,0.000333,0.354919,6,6388.550352,354.919464,1064.758392,304.085226,3,0
0,0,27,27,17,56,73,165,167,332,0.000333,0.685007,16,32880.34806,1826.686003,2055.021754,394.698744,4,0
0,0,31,31,25,52,77,150,109,259,0.000333,0.541033,24,38954.34514,2164.130285,1623.097714,412.51927,9,0
0,0,3,3,11,10,21,17,14,31,0.000333,0.045387,5,680.809201,37.822733,136.16184,71.273029,3,0
0,0,43,43,24,68,92,204,160,364,0.000333,0.791526,24,56989.83725,3166.102069,2374.576552,523.986573,9,0
0,0,43,43,22,59,81,182,146,328,0.000333,0.693157,22,45748.35762,2541.575423,2079.470801,445.183436,9,0
0,0,44,44,25,62,87,194,153,347,0.000333,0.745234,24,53656.83343,2980.935191,2235.701393,485.256576,9,0
0,0,45,45,25,62,87,196,154,350,0.000333,0.751677,24,54120.72537,3006.706965,2255.030224,485.256576,9,0
0,0,45,45,25,62,87,196,154,350,0.000333,0.751677,24,54120.72537,3006.706965,2255.030224,485.256576,9,0
0,0,6,6,18,20,38,40,27,67,0.000333,0.117204,9,3164.500291,175.805572,351.611143,161.497212,2,0
0,0,23,23,25,34,59,118,70,188,0.000333,0.368646,24,26542.48544,1474.582524,1105.936893,289.070141,12,0
0,0,25,25,27,34,61,137,82,219,0.000333,0.432944,26,33769.6184,1876.089911,1298.831477,301.355699,15,0
0,0,8,8,16,18,34,34,31,65,0.000333,0.110228,8,2645.480677,146.971149,330.685085,139.05865,2,0
0,0,92,92,32,105,137,539,427,966,0.000333,2.285566,64,438828.7355,24379.37419,6856.698992,864.995779,44,0
0,0,96,96,32,107,139,570,452,1022,0.000333,2.425186,64,465635.6977,25868.64987,7275.557776,881.336968,46,0
0,0,92,92,32,105,137,539,427,966,0.000333,2.285566,64,438828.7355,24379.37419,6856.698992,864.995779,44,0
0,0,96,96,32,107,139,570,452,1022,0.000333,2.425186,64,465635.6977,25868.64987,7275.557776,881.336968,46,0
0,0,91,91,31,105,136,537,426,963,0.000333,2.275076,60,409513.603,22750.75572,6825.226716,858.575865,44,0
0,0,95,95,31,107,138,568,451,1019,0.000333,2.414529,60,434615.1853,24145.28807,7243.586421,874.917053,46,0
0,0,91,91,31,105,136,537,426,963,0.000333,2.275076,60,409513.603,22750.75572,6825.226716,858.575865,44,0
0,0,95,95,31,107,138,568,451,1019,0.000333,2.414529,60,434615.1853,24145.28807,7243.586421,874.917053,46,0
0,0,92,92,32,105,137,539,427,966,0.000333,2.285566,64,438828.7355,24379.37419,6856.698992,864.995779,44,0
0,0,96,96,32,107,139,570,452,1022,0.000333,2.425186,64,465635.6977,25868.64987,7275.557776,881.336968,46,0
0,0,92,92,32,105,137,539,427,966,0.000333,2.285566,64,438828.7355,24379.37419,6856.698992,864.995779,44,0
0,0,96,96,32,107,139,570,452,1022,0.000333,2.425186,64,465635.6977,25868.64987,7275.557776,881.336968,46,0
0,0,90,90,31,105,136,532,423,955,0.000333,2.256176,60,406111.6208,22561.75671,6768.527013,858.575865,44,0
0,0,94,94,31,107,138,563,448,1011,0.000333,2.395573,60,431203.0935,23955.72742,7186.718226,874.917053,46,0
0,0,90,90,31,105,136,532,423,955,0.000333,2.256176,60,406111.6208,22561.75671,6768.527013,858.575865,44,0
0,0,94,94,31,107,138,563,448,1011,0.000333,2.395573,60,431203.0935,23955.72742,7186.718226,874.917053,46,0
0,0,88,88,32,105,137,521,416,937,0.000333,2.216952,48,319241.091,17735.61617,6650.856062,864.995779,42,0
0,0,92,92,32,107,139,552,441,993,0.000333,2.356369,64,452422.9431,25134.60795,7069.108485,881.336968,44,0
0,0,88,88,32,105,137,521,416,937,0.000333,2.216952,48,319241.091,17735.61617,6650.856062,864.995779,42,0
0,0,92,92,32,107,139,552,441,993,0.000333,2.356369,64,452422.9431,25134.60795,7069.108485,881.336968,44,0
0,0,87,87,32,105,137,518,415,933,0.000333,2.207488,48,317878.2688,17659.90382,6622.463933,864.995779,41,0
0,0,91,91,32,107,139,549,440,989,0.000333,2.346878,64,450600.4941,25033.36079,7040.632721,881.336968,43,0
0,0,87,87,32,105,137,518,415,933,0.000333,2.207488,48,317878.2688,17659.90382,6622.463933,864.995779,41,0
0,0,91,91,32,107,139,549,440,989,0.000333,2.346878,64,450600.4941,25033.36079,7040.632721,881.336968,43,0
0,0,37,37,25,59,84,290,251,541,0.000333,1.152748,48,165995.6988,9221.983269,3458.243726,463.172345,29,0
0,0,32,32,24,56,80,223,199,422,0.000333,0.889285,36,96042.73162,5335.707312,2667.853656,435.250976,29,0
0,0,36,36,25,59,84,284,246,530,0.000333,1.129309,48,162620.5552,9034.475291,3387.928234,463.172345,29,0
0,0,38,38,27,59,86,298,256,554,0.000333,1.186717,52,185127.8351,10284.87973,3560.150674,475.457902,30,0
0,0,34,34,27,56,83,256,221,477,0.000333,1.013631,39,118594.8585,6588.603252,3040.893809,453.593838,30,0
0,0,53,53,31,65,96,408,347,755,0.000333,1.657216,75,372873.5016,20715.19453,4971.646688,545.033993,33,0
0,0,39,39,29,64,93,309,267,576,0.000333,1.255518,56,210927.1066,11718.17259,3766.555475,524.881449,30,0
0,0,39,39,29,64,93,309,267,576,0.000333,1.255518,56,210927.1066,11718.17259,3766.555475,524.881449,30,0
0,0,43,43,30,65,95,331,287,618,0.000333,1.35339,60,243610.246,13533.90255,4060.170766,538.660626,31,0
0,0,49,49,31,65,96,368,313,681,0.000333,1.494786,60,269061.5678,14947.86488,4484.359463,545.033993,33,0
0,0,43,43,30,65,95,331,286,617,0.000333,1.3512,60,243216.0546,13512.00303,4053.60091,538.660626,31,0
0,0,39,39,28,59,87,304,259,563,0.000333,1.209126,56,203133.1225,11285.17347,3627.377188,481.681878,31,0
0,0,43,43,30,65,95,331,287,618,0.000333,1.35339,60,243610.246,13533.90255,4060.170766,538.660626,31,0
0,0,48,48,31,65,96,362,310,672,0.000333,1.475032,60,265505.688,14750.316,4425.0948,545.033993,32,0
0,0,43,43,30,65,95,331,286,617,0.000333,1.3512,60,243216.0546,13512.00303,4053.60091,538.660626,31,0
0,0,39,39,28,59,87,304,259,563,0.000333,1.209126,56,203133.1225,11285.17347,3627.377188,481.681878,31,0
0,0,45,45,31,65,96,341,295,636,0.000333,1.396012,60,251282.169,13960.1205,4188.03615,545.033993,31,0
0,0,46,46,31,65,96,346,298,644,0.000333,1.413572,60,254442.951,14135.7195,4240.71585,545.033993,31,0
0,0,46,46,31,65,96,346,298,644,0.000333,1.413572,60,254442.951,14135.7195,4240.71585,545.033993,31,0
0,0,39,39,28,59,87,304,259,563,0.000333,1.209126,56,203133.1225,11285.17347,3627.377188,481.681878,31,0
0,0,48,48,29,64,93,382,323,705,0.000333,1.536702,70,322707.4873,17928.19374,4610.106962,524.881449,32,0
0,0,48,48,29,64,93,382,323,705,0.000333,1.536702,70,322707.4873,17928.19374,4610.106962,524.881449,32,0
0,0,48,48,29,64,93,382,323,705,0.000333,1.536702,70,322707.4873,17928.19374,4610.106962,524.881449,32,0
0,0,10,10,11,24,35,55,46,101,0.000333,0.172686,5,2590.287924,143.904885,518.057585,148.092848,4,0
0,0,8,8,11,21,32,45,38,83,0.000333,0.138333,5,2075,115.277778,415,130.292414,4,0
0,0,8,8,11,21,32,45,38,83,0.000333,0.138333,5,2075,115.277778,415,130.292414,4,0
0,0,6,6,8,17,25,37,30,67,0.000333,0.103713,4,1244.553459,69.141859,311.138365,93.486868,1,0
0,0,3,3,7,10,17,16,16,32,0.000333,0.0436,3,392.396433,21.799802,130.798811,52.870765,1,0
1,0,28,29,28,40,68,187,148,335,0.000333,0.679767,42,85650.60218,4758.366788,2039.300052,347.483062,16,0
0,0,110,110,33,93,126,522,359,881,0.000333,2.048995,48,295055.2134,16391.9563,6146.983613,774.606775,37,0
0,0,25,25,21,54,75,341,240,581,0.000333,1.206315,40,144757.7464,8042.09702,3618.943659,403.002591,5,0
0,0,5,5,15,15,30,28,21,49,0.000333,0.080146,7,1683.063474,93.503526,240.437639,117.206718,5,0
0,0,6,6,19,20,39,45,30,75,0.000333,0.132135,9,3567.646498,198.202583,396.405166,167.149185,6,0
0,0,7,7,17,22,39,61,44,105,0.000333,0.184989,16,8879.475728,493.304207,554.967233,167.594364,9,0
0,0,7,7,18,24,42,73,52,125,0.000333,0.22468,18,12132.7142,674.039678,674.039678,185.09775,9,0
0,0,6,6,17,18,35,41,28,69,0.000333,0.117974,8,2831.364225,157.298013,353.920528,144.545518,5,0
0,0,6,6,19,22,41,51,38,89,0.000333,0.158941,9,4291.399156,238.411064,476.822128,178.818118,7,0
0,0,14,14,26,25,51,77,67,144,0.000333,0.272276,26,21237.56048,1179.864471,816.829249,238.307837,5,0
0,0,8,8,11,14,25,37,36,73,0.000333,0.113001,10,3390.015019,188.334168,339.001502,91.356717,2,0
1,0,15,16,18,29,47,84,76,160,0.000333,0.296245,18,15997.21589,888.734216,888.734216,215.940099,9,0
0,0,13,13,20,36,56,94,81,175,0.000333,0.338762,20,20325.74223,1129.207902,1016.287111,272.555862,6,0
0,0,14,14,20,36,56,102,86,188,0.000333,0.363928,20,21835.65451,1213.091917,1091.782725,272.555862,7,0
0,0,3,3,14,12,26,34,28,62,0.000333,0.097142,14,4079.981675,226.665649,291.427263,96.322519,4,0
0,0,39,39,31,80,111,398,280,678,0.000333,1.535538,45,207297.6281,11516.53489,4606.613957,659.334333,23,0
0,0,29,29,26,59,85,242,174,416,0.000333,0.888769,26,69323.97237,3851.331798,2666.306629,469.287373,17,0
0,0,54,54,33,99,132,543,393,936,0.000333,2.197851,48,316490.539,17582.80772,6593.552896,822.771311,21,0
0,0,9,9,17,23,40,60,40,100,0.000333,0.177398,8,4257.542476,236.530138,532.192809,173.528793,4,0
0,0,55,55,33,100,133,555,399,954,0.000333,2.24358,48,323075.4933,17948.63852,6730.739443,830.850625,21,0
0,0,9,9,19,27,46,58,56,114,0.000333,0.209895,18,11334.34913,629.686063,629.686063,209.092585,2,0
0,0,5,5,15,19,34,29,31,60,0.000333,0.101749,7,2136.734393,118.707466,305.24777,139.313982,2,0
0,0,7,7,14,24,38,39,42,81,0.000333,0.141694,7,2975.5749,165.309717,425.082129,163.342069,1,0
0,0,36,36,22,53,75,174,150,324,0.000333,0.672712,22,44399.01963,2466.612201,2018.137256,401.68728,6,0
0,0,31,31,20,56,76,181,160,341,0.000333,0.710181,20,42610.86564,2367.270313,2130.543282,411.650438,5,0
0,0,31,31,20,56,76,181,160,341,0.000333,0.710181,20,42610.86564,2367.270313,2130.543282,411.650438,5,0
0,0,31,31,20,56,76,181,160,341,0.000333,0.710181,20,42610.86564,2367.270313,2130.543282,411.650438,5,0
0,0,31,31,20,56,76,181,160,341,0.000333,0.710181,20,42610.86564,2367.270313,2130.543282,411.650438,5,0
0,0,53,53,24,52,76,251,202,453,0.000333,0.943437,36,101891.2019,5660.622327,2830.311164,406.461965,14,0
0,0,53,53,24,52,76,251,202,453,0.000333,0.943437,36,101891.2019,5660.622327,2830.311164,406.461965,14,0
0,0,57,57,24,58,82,270,216,486,0.000333,1.029923,36,111231.7299,6179.540548,3089.770274,449.801998,17,0
0,0,52,52,24,53,77,246,201,447,0.000333,0.933751,36,100845.129,5602.507167,2801.253584,413.618884,14,0
0,0,8,8,16,22,38,53,41,94,0.000333,0.164435,8,3946.44149,219.246749,493.305186,162.107496,2,0
0,0,6,6,12,20,32,41,33,74,0.000333,0.123333,6,2220,123.333333,370,129.458112,1,0
0,0,16,16,17,37,54,76,64,140,0.000333,0.268561,8,6445.474002,358.081889,805.68425,262.236643,4,0
0,0,9,9,16,24,40,41,39,80,0.000333,0.141918,8,3406.033981,189.22411,425.754248,174.0391,3,0
0,0,7,7,16,22,38,37,32,69,0.000333,0.120702,8,2896.855987,160.936444,362.106998,162.107496,3,0
0,0,3,3,10,12,22,19,17,36,0.000333,0.053513,5,802.697691,44.594316,160.539538,76.238831,1,0
0,0,53,53,23,49,72,327,243,570,0.000333,1.172286,44,154741.719,8596.762169,3516.857251,379.162707,15,0
9,0,108,117,33,134,167,553,371,924,0.000333,2.274181,32,218321.3685,12128.96492,6822.542766,1113.320957,37,0
2,0,51,53,30,77,107,246,177,423,0.000333,0.950547,30,85549.21606,4752.734225,2851.640535,629.749282,21,0
5,0,65,70,31,90,121,322,228,550,0.000333,1.268458,30,114161.2434,6342.291301,3805.374781,737.846864,23,0
8,0,104,112,32,132,164,528,352,880,0.000333,2.158215,32,207188.6645,11510.48136,6474.645764,1089.860024,38,0
6,0,68,74,31,101,132,338,244,582,0.000333,1.366612,30,122995.1213,6833.062296,4099.837377,826.059445,24,0
3,0,77,80,35,121,156,398,293,691,0.000333,1.678071,34,171163.2397,9509.068874,5034.212933,1016.707357,35,0
3,0,71,74,30,106,136,325,233,558,0.000333,1.318268,30,118644.128,6591.340442,3954.804265,860.366286,29,0
2,0,76,78,30,110,140,394,270,664,0.000333,1.577948,30,142015.3177,7889.739872,4733.843923,893.156286,35,0
2,0,62,64,32,95,127,305,221,526,0.000333,1.225349,32,117633.5406,6535.196703,3676.048145,784.136283,30,0
2,0,52,54,30,77,107,246,176,422,0.000333,0.9483,30,85346.97205,4741.498447,2844.899068,629.749282,23,0
2,0,56,58,31,79,110,272,192,464,0.000333,1.04885,30,94396.52721,5244.251512,3146.550907,651.578765,25,0
2,0,67,69,31,103,134,352,234,586,0.000333,1.380243,30,124221.848,6901.213776,4140.728266,842.28964,35,0
2,0,57,59,31,89,120,278,200,478,0.000333,1.100498,30,99044.81114,5502.489508,3301.493705,729.920361,26,0
2,0,72,74,32,114,146,366,269,635,0.000333,1.521846,32,146097.235,8116.513058,4565.538595,938.949462,37,0
2,0,38,40,32,61,93,198,146,344,0.000333,0.749824,32,71983.06019,3999.0589,2249.470631,521.774978,19,0
1,0,110,111,31,105,136,545,372,917,0.000333,2.166401,45,292464.1541,16248.00856,6499.203425,858.575865,54,0
2,0,110,112,32,109,141,560,380,940,0.000333,2.237059,48,322136.557,17896.47539,6711.178271,897.732091,53,0
1,0,115,116,32,112,144,555,375,930,0.000333,2.222677,48,320065.4521,17781.414,6668.030251,922.423751,55,0
3,0,110,113,33,117,150,556,368,924,0.000333,2.226476,48,320612.5666,17811.80925,6679.42847,970.297678,45,0
2,0,62,64,31,86,117,304,212,516,0.000333,1.181703,30,106353.2459,5908.513659,3545.108195,706.238855,29,0
3,0,81,84,32,101,133,371,259,630,0.000333,1.481609,32,142234.4939,7901.916328,4444.827934,832.47936,30,0
7,0,97,104,32,114,146,476,332,808,0.000333,1.936459,32,185900.1038,10327.78354,5809.378244,938.949462,35,0
8,0,102,110,30,127,157,575,388,963,0.000333,2.341573,45,316112.3902,17561.79945,7024.719781,1034.769673,45,0
2,0,78,80,29,113,142,397,271,668,0.000333,1.59201,28,133728.8701,7429.381674,4776.031076,911.561672,36,0
1,0,111,112,31,105,136,545,371,916,0.000333,2.164039,45,292145.2183,16230.28991,6492.115963,858.575865,56,0
2,0,111,113,32,109,141,560,379,939,0.000333,2.23468,48,321793.8586,17877.43659,6704.03872,897.732091,55,0
1,0,116,117,32,112,144,555,374,929,0.000333,2.220287,48,319721.2957,17762.2942,6660.860326,922.423751,57,0
2,0,84,86,31,95,126,437,288,725,0.000333,1.686176,45,227633.7575,12646.31986,5058.527945,777.716368,41,0
2,0,63,65,31,86,117,304,211,515,0.000333,1.179413,30,106147.1349,5897.063051,3538.237831,706.238855,31,0
2,0,60,62,30,82,112,282,198,480,0.000333,1.089177,30,98025.91088,5445.883938,3267.530363,668.525982,28,0
2,0,65,67,31,89,120,331,229,560,0.000333,1.289286,30,116035.762,6446.431223,3867.858734,729.920361,33,0
2,0,86,88,29,118,147,493,324,817,0.000333,1.960711,28,164699.7046,9149.983587,5882.132306,953.033329,47,0
2,0,79,81,29,113,142,397,270,667,0.000333,1.589627,28,133528.6772,7418.259845,4768.881329,911.561672,38,0
2,0,72,74,32,111,143,343,253,596,0.000333,1.422428,32,136553.0661,7586.281452,4267.283317,914.180161,27,0
1,0,112,113,34,109,143,560,388,948,0.000333,2.262519,51,346165.4594,19231.41441,6787.558027,910.705828,53,0
2,0,80,82,33,117,150,428,302,730,0.000333,1.759013,32,168865.2046,9381.400256,5277.037644,970.297678,33,0
1,0,56,57,32,80,112,265,200,465,0.000333,1.05514,32,101293.4412,5627.413402,3165.420039,665.754248,22,0
2,0,66,68,34,101,135,339,253,592,0.000333,1.396492,34,142442.1443,7913.452463,4189.474833,845.453096,28,0
2,0,56,58,32,85,117,280,208,488,0.000333,1.117579,32,107287.6155,5960.423081,3352.737983,704.79823,21,0
2,0,60,62,33,87,120,306,224,530,0.000333,1.220217,32,117140.8645,6507.825806,3660.652016,727.00109,23,0
1,0,61,62,32,87,119,275,203,478,0.000333,1.098574,32,105463.1325,5859.062917,3295.722891,720.536084,23,0
2,0,71,73,34,110,144,386,266,652,0.000333,1.558264,34,158942.8974,8830.160968,4674.791101,918.923305,33,0
2,0,61,63,33,97,130,312,232,544,0.000333,1.273389,32,122245.3789,6791.409938,3820.16809,806.656552,24,0
2,0,76,78,35,122,157,400,301,701,0.000333,1.70451,34,173859.9909,9658.888385,5113.529145,1025.074861,35,0
2,0,73,75,32,111,143,343,252,595,0.000333,1.420041,32,136323.9503,7573.552792,4260.123445,914.180161,29,0
1,0,113,114,34,109,143,560,387,947,0.000333,2.260133,51,345800.306,19211.12811,6780.398156,910.705828,55,0
2,0,81,83,33,117,150,428,301,729,0.000333,1.756603,32,168633.8824,9368.549023,5269.808825,970.297678,35,0
1,0,57,58,32,80,112,265,199,464,0.000333,1.052871,32,101075.6059,5615.311438,3158.612684,665.754248,24,0
2,0,67,69,34,102,136,339,252,591,0.000333,1.39623,34,142415.4783,7911.971018,4188.690539,853.561121,30,0
2,0,57,59,32,85,117,280,207,487,0.000333,1.115289,32,107067.7638,5948.209099,3345.867618,704.79823,23,0
2,0,61,63,33,87,120,306,223,529,0.000333,1.217915,32,116919.844,6495.546889,3653.745125,727.00109,25,0
1,0,62,63,32,87,119,275,202,477,0.000333,1.096276,32,105242.4983,5846.805463,3288.828073,720.536084,25,0
2,0,72,74,34,110,144,386,265,651,0.000333,1.555874,34,158699.12,8816.617777,4667.621176,918.923305,35,0
2,0,62,64,33,97,130,312,231,543,0.000333,1.271049,32,122020.6631,6778.925729,3813.145722,806.656552,26,0
2,0,77,79,35,122,157,400,300,700,0.000333,1.702078,34,173611.9738,9645.109657,5106.234524,1025.074861,37,0
1,0,58,59,31,78,109,280,216,496,0.000333,1.119006,30,100710.5828,5595.032375,3357.019425,643.841459,21,0
1,0,59,60,31,78,109,280,215,495,0.000333,1.11675,30,100507.5372,5583.752068,3350.251241,643.841459,23,0
1,0,31,32,27,36,63,167,148,315,0.000333,0.627614,52,97907.84515,5439.32473,1882.843176,314.499263,10,0
2,0,54,56,32,60,92,243,218,461,0.000333,1.002454,48,144353.379,8019.632165,3007.362062,514.413436,22,0
2,0,43,45,32,61,93,232,177,409,0.000333,0.891505,32,85584.51052,4754.695029,2674.515954,521.774978,19,0
2,0,55,57,32,60,92,250,225,475,0.000333,1.032897,48,148737.2126,8263.178478,3098.691929,514.413436,22,0
2,0,115,117,37,123,160,541,397,938,0.000333,2.289323,54,370870.3019,20603.90566,6867.968553,1046.679059,52,0
2,0,96,98,37,109,146,441,331,772,0.000333,1.850182,54,299729.4062,16651.63368,5550.544559,930.481866,39,0
2,0,56,58,32,60,92,257,232,489,0.000333,1.063341,48,153121.0462,8506.724791,3190.021797,514.413436,22,0
2,0,116,118,37,123,160,548,404,952,0.000333,2.323492,54,376405.6795,20911.42664,6970.475546,1046.679059,52,0
2,0,97,99,37,109,146,448,338,786,0.000333,1.883734,54,305164.9136,16953.60631,5651.202103,930.481866,39,0
2,0,113,115,35,119,154,526,381,907,0.000333,2.196992,51,336139.745,18674.43028,6590.975392,1000.008219,53,0
3,0,113,116,36,124,160,541,389,930,0.000333,2.269798,54,367707.2289,20428.17939,6809.393128,1048.437643,52,0
3,0,117,120,36,126,162,567,405,972,0.000333,2.378111,54,385254.047,21403.00261,7134.334203,1065.25457,54,0
2,0,118,120,35,125,160,536,384,920,0.000333,2.245391,51,343544.8662,19085.8259,6736.173847,1050.247941,54,0
3,0,118,121,36,136,172,573,413,986,0.000333,2.440766,54,395404.0406,21966.89114,7322.297048,1150.012246,55,0
3,0,110,113,35,131,166,504,368,872,0.000333,2.143678,34,218655.1691,12147.50939,6431.034384,1100.903319,45,0
3,0,118,121,36,140,176,589,417,1006,0.000333,2.501396,36,270150.7755,15008.37642,7504.188208,1184.216922,51,0
2,0,94,96,35,103,138,426,315,741,0.000333,1.755806,51,268638.2477,14924.3471,5267.416622,868.23446,40,0
3,0,104,107,37,125,162,500,368,868,0.000333,2.123663,36,229355.6329,12741.97961,6370.989803,1063.47281,46,0
3,0,94,97,36,108,144,441,323,764,0.000333,1.825941,36,197201.6172,10955.6454,5477.822701,915.64515,39,0
3,0,98,101,36,110,146,467,339,806,0.000333,1.931666,54,312929.9241,17384.99578,5794.998594,932.066869,41,0
2,0,99,101,35,109,144,436,318,754,0.000333,1.802041,34,183808.1973,10211.56652,5406.123451,917.256997,41,0
3,0,109,112,36,132,168,547,381,928,0.000333,2.28669,36,246962.5405,13720.14114,6860.070568,1115.977324,51,0
3,0,99,102,36,120,156,473,347,820,0.000333,1.991343,36,215065.0735,11948.05964,5974.029819,1014.944172,42,0
3,0,114,117,37,141,178,561,416,977,0.000333,2.434597,36,262936.4962,14607.58312,7303.791562,1199.426515,53,0
9,0,112,121,38,135,173,572,384,956,0.000333,2.369168,38,270085.1743,15004.7319,7107.504586,1154.791351,38,0
2,0,55,57,35,78,113,265,190,455,0.000333,1.034394,34,105508.1685,5861.564919,3103.181428,669.786279,22,0
5,0,69,74,36,91,127,341,241,582,0.000333,1.355805,36,146426.9216,8134.828975,4067.414488,778.326612,24,0
8,0,108,116,37,133,170,547,365,912,0.000333,2.252455,36,243265.1232,13514.72907,6757.364534,1131.102338,39,0
6,0,72,78,36,102,138,357,257,614,0.000333,1.454878,36,157126.8246,8729.268033,4364.634016,866.704685,25,0
3,0,81,84,39,122,161,417,306,723,0.000333,1.766751,38,201409.6103,11189.4228,5300.252903,1051.680642,36,0
3,0,75,78,35,107,142,344,246,590,0.000333,1.406117,34,143423.9272,7967.995957,4218.350801,900.861873,30,0
2,0,80,82,35,111,146,413,283,696,0.000333,1.668039,34,170140.0084,9452.222687,5004.117893,933.705067,36,0
2,0,66,68,37,96,133,324,234,558,0.000333,1.312283,36,141726.5136,7873.695198,3936.847599,824.906175,31,0
2,0,56,58,35,78,113,265,189,454,0.000333,1.03212,34,105276.2825,5848.682359,3096.361249,669.786279,24,0
2,0,60,62,36,80,116,291,205,496,0.000333,1.133853,36,122456.1086,6803.117147,3401.558574,691.871548,26,0
2,0,71,73,36,104,140,371,247,618,0.000333,1.468632,36,158612.2886,8811.793809,4405.896904,882.963031,36,0
2,0,61,63,36,90,126,297,213,510,0.000333,1.186138,36,128102.8594,7116.825522,3558.412761,770.384079,27,0
2,0,76,78,37,115,152,385,282,667,0.000333,1.611456,36,174037.2355,9668.735303,4834.367651,979.98113,38,0
2,0,42,44,37,61,98,217,159,376,0.000333,0.829044,36,89536.71245,4974.261803,2487.130901,554.524752,20,0
1,0,114,115,36,106,142,564,385,949,0.000333,2.261703,54,366395.9409,20355.33005,6785.110016,899.276868,55,0
2,0,114,116,37,110,147,579,393,972,0.000333,2.332694,54,377896.402,20994.24456,6998.081519,938.699343,54,0
1,0,119,120,37,113,150,574,388,962,0.000333,2.318041,54,375522.6733,20862.37074,6954.12358,963.429997,56,0
3,0,114,117,37,118,155,575,381,956,0.000333,2.318658,54,375622.6463,20867.92479,6955.974931,1004.901654,46,0
2,0,66,68,36,87,123,323,225,548,0.000333,1.268166,36,136961.9262,7608.995898,3804.497949,746.653384,30,0
3,0,85,88,37,102,139,390,272,662,0.000333,1.570913,36,169658.6036,9425.47798,4712.73899,873.337159,31,0
7,0,101,108,37,115,152,495,345,840,0.000333,2.02942,54,328765.992,18264.77733,6088.259111,979.98113,36,0
2,0,82,84,34,114,148,416,284,700,0.000333,1.682206,34,171584.9901,9532.49945,5046.617356,951.923198,37,0
1,0,115,116,36,106,142,564,384,948,0.000333,2.25932,54,366009.8545,20333.88081,6777.960269,899.276868,57,0
2,0,115,117,37,110,147,579,392,971,0.000333,2.330294,54,377507.6197,20972.64554,6990.881847,938.699343,56,0
1,0,120,121,37,113,150,574,387,961,0.000333,2.315632,54,375132.3171,20840.68429,6946.894762,963.429997,58,0
2,0,88,90,35,96,131,456,301,757,0.000333,1.774767,51,271539.3618,15085.5201,5324.301212,811.681306,42,0
2,0,67,69,36,87,123,323,224,547,0.000333,1.265852,36,136711.9956,7595.110869,3797.555434,746.653384,32,0
2,0,64,66,35,83,118,301,211,512,0.000333,1.174638,34,119813.0502,6656.280567,3523.913241,708.653178,29,0
2,0,69,71,36,90,126,350,242,592,0.000333,1.37685,36,148699.7897,8261.099429,4130.549715,770.384079,34,0
2,0,90,92,34,119,153,512,337,849,0.000333,2.053841,34,209491.7575,11638.43097,6161.522278,993.45705,48,0
2,0,83,85,34,114,148,416,283,699,0.000333,1.679803,34,171339.8687,9518.881594,5039.407903,951.923198,39,0
2,0,76,78,37,112,149,362,266,628,0.000333,1.511213,36,163210.9619,9067.275662,4533.637831,955.173526,28,0
1,0,116,117,39,110,149,579,401,980,0.000333,2.358262,57,403262.7536,22403.48631,7074.78515,952.080255,54,0
2,0,84,86,38,118,156,447,315,762,0.000333,1.850492,38,210956.1066,11719.7837,5551.476491,1011.573125,34,0
1,0,60,61,37,81,118,284,213,497,0.000333,1.140225,36,123144.2494,6841.347191,3420.673596,706.277625,23,0
2,0,70,72,39,102,141,358,266,624,0.000333,1.485027,38,169293.0417,9405.168982,4455.080044,886.718071,29,0
2,0,60,62,37,86,123,299,221,520,0.000333,1.203369,36,129963.8715,7220.215086,3610.107543,745.408543,22,0
2,0,64,66,38,88,126,325,237,562,0.000333,1.307077,38,149006.79,8278.155003,3921.231317,767.851228,24,0
1,0,65,66,37,88,125,294,216,510,0.000333,1.184183,36,127891.7995,7105.09997,3552.549985,761.179757,24,0
2,0,75,77,39,111,150,405,279,684,0.000333,1.648171,38,187891.4554,10438.41419,4944.511984,960.310848,34,0
2,0,65,67,38,98,136,331,245,576,0.000333,1.360793,38,155130.3867,8618.354815,4082.378597,847.66281,25,0
2,0,80,82,40,123,163,419,314,733,0.000333,1.795539,40,215464.7095,11970.26164,5386.617737,1066.806408,36,0
2,0,77,79,37,112,149,362,265,627,0.000333,1.508806,36,162951.0718,9052.837325,4526.418662,955.173526,30,0
1,0,117,118,39,110,149,579,400,979,0.000333,2.355855,57,402851.2609,22380.62561,7067.565982,952.080255,56,0
2,0,85,87,38,118,156,447,314,761,0.000333,1.848064,38,210679.2614,11704.40341,5544.191089,1011.573125,36,0
1,0,61,62,37,81,118,284,212,496,0.000333,1.13793,36,122896.4743,6827.581905,3413.790952,706.277625,25,0
2,0,71,73,39,103,142,358,265,623,0.000333,1.484764,38,169263.1133,9403.506295,4454.292455,894.840241,31,0
2,0,61,63,37,86,123,299,220,519,0.000333,1.201055,36,129713.941,7206.330057,3603.165028,745.408543,24,0
2,0,65,67,38,88,126,325,236,561,0.000333,1.304751,38,148741.6534,8263.425189,3914.254037,767.851228,26,0
1,0,66,67,37,88,125,294,215,509,0.000333,1.181861,36,127641.0312,7091.168402,3545.584201,761.179757,26,0
2,0,76,78,39,111,150,405,278,683,0.000333,1.645761,38,187616.7603,10423.15335,4937.283166,960.310848,36,0
2,0,66,68,38,98,136,331,244,575,0.000333,1.35843,38,154861.0631,8603.392393,4075.291134,847.66281,27,0
2,0,81,83,40,123,163,419,313,732,0.000333,1.79309,40,215170.7604,11953.93113,5379.269009,1066.806408,38,0
1,0,62,63,36,79,115,299,229,528,0.000333,1.204806,36,130119.0749,7228.837494,3614.418747,684.115979,22,0
1,0,63,64,36,79,115,299,228,527,0.000333,1.202524,36,129872.6372,7215.146514,3607.573257,684.115979,24,0
1,0,35,36,32,36,68,186,161,347,0.000333,0.704117,64,135190.3748,7510.576377,2112.349606,346.1173,11,0
2,0,58,60,34,59,93,262,231,493,0.000333,1.074602,51,164414.07,9134.114999,3223.805294,520.049677,23,0
2,0,47,49,37,61,98,251,190,441,0.000333,0.972362,54,157522.7002,8751.261124,2917.087041,554.524752,20,0
2,0,59,61,34,59,93,269,238,507,0.000333,1.105118,68,225444.0392,12524.66884,3315.353517,520.049677,23,0
2,0,119,121,39,123,162,560,410,970,0.000333,2.373218,57,405820.3067,22545.57259,7119.654503,1060.059971,53,0
2,0,100,102,39,109,148,460,344,804,0.000333,1.932134,57,330394.8288,18355.26827,5796.400506,943.862778,40,0
2,0,60,62,34,59,93,276,245,521,0.000333,1.135634,68,231669.3184,12870.51769,3406.901741,520.049677,23,0
2,0,120,122,39,123,162,567,417,984,0.000333,2.407471,57,411677.507,22870.97261,7222.412403,1060.059971,53,0
2,0,101,103,39,109,148,467,351,818,0.000333,1.965778,57,336147.9726,18674.88737,5897.332853,943.862778,40,0
2,0,117,119,37,119,156,545,394,939,0.000333,2.280331,54,369413.6049,20522.97805,6840.992684,1013.233088,54,0
3,0,117,120,38,124,162,560,402,962,0.000333,2.353645,57,402473.3351,22359.62973,7060.935703,1061.741588,53,0
3,0,121,124,38,126,164,586,418,1004,0.000333,2.462327,57,421057.9861,23392.11034,7386.982213,1078.558516,55,0
2,0,122,124,37,125,162,555,397,952,0.000333,2.329179,54,377327.0089,20962.61161,6987.537203,1063.47281,55,0
3,0,114,117,37,131,168,523,381,904,0.000333,2.227552,36,240575.5782,13365.3099,6682.65495,1114.128188,46,0
2,0,98,100,37,103,140,445,328,773,0.000333,1.836979,54,297590.5317,16532.80732,5510.935772,881.459329,41,0
3,0,108,111,39,125,164,519,381,900,0.000333,2.207266,57,377442.4178,20969.02321,6621.796804,1076.853722,47,0
3,0,98,101,38,108,146,460,336,796,0.000333,1.9077,57,326216.7199,18123.15111,5723.100349,928.949096,40,0
3,0,102,105,38,110,148,486,352,838,0.000333,2.013841,57,344366.7495,19131.48608,6041.52192,945.370814,42,0
2,0,103,105,37,109,146,455,331,786,0.000333,1.883734,54,305164.9136,16953.60631,5651.202103,930.481866,42,0
3,0,113,116,38,132,170,566,394,960,0.000333,2.371005,38,270294.5814,15016.36563,7113.015299,1129.281269,52,0
3,0,103,106,38,120,158,492,360,852,0.000333,2.074274,57,354700.8083,19705.60046,6222.821197,1028.248117,43,0
3,0,118,121,39,141,180,580,429,1009,0.000333,2.51976,57,430878.9471,23937.71929,7559.279774,1212.807427,54,0
2,0,98,100,35,115,150,488,340,828,0.000333,1.995154,34,203505.7038,11305.87243,5985.461876,966.756261,43,0
5,0,112,117,35,128,163,564,391,955,0.000333,2.339345,51,357919.8048,19884.4336,7018.035387,1075.524906,45,0
6,0,115,121,36,138,174,580,407,987,0.000333,2.448728,36,264462.6683,14692.37046,7346.18523,1167.093675,46,0
4,0,122,126,37,132,169,554,400,954,0.000333,2.35348,54,381263.705,21181.31695,7060.438982,1122.609798,45,0
2,0,103,105,36,132,168,536,368,904,0.000333,2.227552,36,240575.5782,13365.3099,6682.65495,1115.977324,42,0
2,0,89,91,37,116,153,447,319,766,0.000333,1.853053,36,200129.7272,11118.31818,5559.159088,988.27557,37,0
2,0,79,81,35,99,134,388,274,662,0.000333,1.55925,34,159043.5355,8835.751972,4677.751044,835.831211,30,0
2,0,83,85,35,101,136,414,290,704,0.000333,1.663191,34,169645.5106,9424.750587,4989.57384,852.004265,32,0
2,0,94,96,36,123,159,494,332,826,0.000333,2.01348,36,217455.8876,12080.88264,6040.441321,1040.046584,42,0
2,0,84,86,36,111,147,420,298,718,0.000333,1.723122,36,186097.1308,10338.72949,5169.364744,940.297461,33,0
2,0,99,101,37,132,169,508,367,875,0.000333,2.15859,36,233127.7022,12951.53901,6475.769507,1122.609798,44,0
1,0,47,48,31,47,78,245,221,466,0.000333,0.976332,60,175739.846,9763.32478,2928.997434,414.645762,13,0
1,0,107,108,36,114,150,536,393,929,0.000333,2.238524,54,362640.9184,20146.71769,6715.572563,965.066762,43,0
1,0,88,89,36,100,136,436,327,763,0.000333,1.802578,54,292017.644,16223.20244,5407.734148,850.502919,30,0
2,0,120,122,37,143,180,592,423,1015,0.000333,2.534744,36,273752.3121,15208.46179,7604.230893,1216.611376,49,0
1,0,104,105,37,116,153,514,370,884,0.000333,2.13851,54,346438.6661,19246.59256,6415.530853,988.27557,44,0
2,0,114,116,39,134,173,588,423,1011,0.000333,2.50547,57,428435.3209,23801.96227,7516.409138,1152.986638,50,0
2,0,104,106,37,121,158,529,378,907,0.000333,2.208176,54,357724.5735,19873.58742,6624.529139,1029.932226,43,0
2,0,108,110,37,123,160,555,394,949,0.000333,2.31617,54,375219.5272,20845.52929,6948.509762,1046.679059,45,0
1,0,109,110,37,122,159,524,373,897,0.000333,2.186552,54,354221.4246,19678.96803,6559.656011,1038.29973,45,0
2,0,109,111,38,133,171,561,402,963,0.000333,2.381131,57,407173.3424,22620.74124,7143.391972,1137.773809,46,0
2,0,101,103,37,130,167,492,357,849,0.000333,2.089588,36,225675.538,12537.52989,6268.764944,1105.65759,36,0
2,0,109,111,39,139,178,577,406,983,0.000333,2.449549,38,279248.5466,15513.80814,7348.645963,1195.663496,42,0
1,0,85,86,37,102,139,414,304,718,0.000333,1.7038,36,184010.3888,10222.79938,5111.39969,873.337159,31,0
2,0,95,97,39,123,162,488,357,845,0.000333,2.067391,38,235682.5836,13093.47687,6202.173252,1060.059971,37,0
2,0,85,87,37,107,144,429,312,741,0.000333,1.770971,36,191264.9193,10625.82885,5312.914426,914.086742,30,0
2,0,89,91,37,109,146,455,328,783,0.000333,1.876544,54,304000.162,16888.89789,5629.63263,930.481866,32,0
1,0,90,91,37,108,145,424,307,731,0.000333,1.749505,36,188946.4876,10497.02709,5248.513545,922.277625,32,0
2,0,100,102,39,130,169,535,370,905,0.000333,2.232599,38,254516.2438,14139.79132,6697.79589,1119.038502,42,0
2,0,90,92,38,119,157,461,336,797,0.000333,1.937938,38,220924.884,12273.60467,5813.812737,1019.904559,33,0
2,0,105,107,40,140,180,549,405,954,0.000333,2.382409,40,285889.1142,15882.72856,7147.227854,1210.976746,44,0
2,0,109,111,36,122,158,546,375,921,0.000333,2.242261,54,363246.2317,20180.34621,6726.782069,1031.667255,51,0
2,0,111,113,36,115,151,579,386,965,0.000333,2.328354,54,377193.271,20955.18172,6985.060573,973.348656,48,0
2,0,90,92,36,106,142,446,309,755,0.000333,1.799353,36,194330.1267,10796.11815,5398.059075,899.276868,38,0
2,0,87,89,35,102,137,424,296,720,0.000333,1.703528,34,173759.8254,9653.323633,5110.5831,860.11229,35,0
2,0,92,94,37,109,146,473,327,800,0.000333,1.917287,54,310600.4209,17255.57894,5751.859647,930.481866,40,0
2,0,106,108,35,132,167,539,368,907,0.000333,2.23234,34,227698.673,12649.92628,6697.019793,1109.384929,45,0
2,0,99,101,35,116,151,492,341,833,0.000333,2.009864,34,205006.099,11389.22772,6029.591148,975.050701,43,0
5,0,113,118,35,129,164,568,392,960,0.000333,2.354417,51,360225.7461,20012.54145,7063.249924,1083.973222,45,0
6,0,116,122,36,139,175,584,408,992,0.000333,2.463867,36,266097.6512,14783.20285,7391.601423,1175.650109,46,0
4,0,123,127,37,133,170,558,401,959,0.000333,2.368535,54,383702.719,21316.81772,7105.605908,1131.102338,45,0
2,0,104,106,36,133,169,540,369,909,0.000333,2.242466,36,242186.3787,13454.79882,6727.399408,1124.469864,42,0
2,0,90,92,37,117,154,451,320,771,0.000333,1.867564,36,201696.9272,11205.38485,5602.692423,996.582447,37,0
2,0,80,82,35,100,135,392,275,667,0.000333,1.573412,34,160488.0241,8916.001339,4720.236003,843.910525,30,0
2,0,84,86,35,102,137,418,291,709,0.000333,1.677502,34,171105.1614,9505.8423,5032.504747,860.11229,32,0
2,0,95,97,36,124,160,498,333,831,0.000333,2.028174,36,219042.8009,12169.04449,6084.522247,1048.437643,42,0
2,0,85,87,36,112,148,424,299,723,0.000333,1.737478,36,187647.6522,10424.86957,5212.434783,948.541051,33,0
2,0,100,102,37,133,170,512,368,880,0.000333,2.173421,36,234729.5049,13040.52805,6520.264024,1131.102338,44,0
1,0,48,49,31,48,79,249,222,471,0.000333,0.989694,60,178144.8439,9896.935775,2969.080732,421.658286,13,0
1,0,108,109,36,115,151,540,394,934,0.000333,2.253557,54,365076.1814,20282.01008,6760.670027,973.348656,43,0
1,0,89,90,36,101,137,440,328,768,0.000333,1.817096,54,294369.5865,16353.86592,5451.28864,858.59666,30,0
1,0,105,106,37,117,154,518,371,889,0.000333,2.153391,54,348849.3547,19380.5197,6460.173235,996.582447,44,0
2,0,105,107,37,122,159,533,379,912,0.000333,2.223116,54,360144.8598,20008.04777,6669.349255,1038.29973,43,0
2,0,109,111,37,124,161,559,395,954,0.000333,2.331232,54,377659.5139,20981.08411,6993.694702,1055.070117,45,0
1,0,110,111,37,123,160,528,374,902,0.000333,2.20146,54,356636.4736,19813.13743,6604.379142,1046.679059,45,0
2,0,110,112,38,134,172,565,403,968,0.000333,2.396208,57,409751.5841,22763.9769,7188.624283,1146.277197,46,0
2,0,102,104,37,131,168,496,358,854,0.000333,2.104346,36,227269.4068,12626.07816,6313.039079,1114.128188,36,0
2,0,110,112,39,140,179,581,407,988,0.000333,2.46467,38,280972.3795,15609.57664,7394.009988,1204.230309,42,0
1,0,86,87,37,103,140,418,305,723,0.000333,1.718157,36,185560.9784,10308.94324,5154.471621,881.459329,31,0
2,0,96,98,39,124,163,492,358,850,0.000333,2.08214,38,237363.9194,13186.88441,6246.418931,1068.451029,37,0
2,0,86,88,37,108,145,433,313,746,0.000333,1.785404,36,192823.6385,10712.42436,5356.212181,922.277625,30,0
2,0,90,92,37,110,147,459,329,788,0.000333,1.891114,36,204240.3051,11346.68362,5673.341808,938.699343,32,0
1,0,91,92,37,109,146,428,308,736,0.000333,1.763904,36,190501.5915,10583.42175,5291.710875,930.481866,32,0
2,0,101,103,39,131,170,539,371,910,0.000333,2.247515,38,256216.7386,14234.26325,6742.545752,1127.5091,42,0
2,0,91,93,38,120,158,465,337,802,0.000333,1.952544,38,222590.0221,12366.11234,5857.63216,1028.248117,33,0
2,0,106,108,40,141,181,553,406,959,0.000333,2.397451,40,287694.0882,15983.0049,7192.352206,1219.553864,44,0
2,0,110,112,36,123,159,550,376,926,0.000333,2.257243,54,365673.3993,20315.18885,6771.729617,1040.046584,51,0
2,0,112,114,36,116,152,583,387,970,0.000333,2.343497,54,379646.4432,21091.46906,7030.489688,981.643095,48,0
2,0,91,93,36,107,143,450,310,760,0.000333,1.813834,36,195894.0798,10883.00443,5441.502216,907.454268,38,0
2,0,88,90,35,103,138,428,297,725,0.000333,1.717893,34,175225.1279,9734.729326,5153.680231,868.23446,35,0
2,0,93,95,37,110,147,477,328,805,0.000333,1.931912,36,208646.5046,11591.47248,5795.736238,938.699343,40,0
2,0,107,109,35,133,168,543,369,912,0.000333,2.247264,34,229220.9786,12734.49881,6741.79349,1117.87747,45,0
3,0,39,42,35,60,95,208,142,350,0.000333,0.766483,34,78181.28174,4343.404541,2299.449463,533.938341,7,0
2,0,23,25,27,38,65,112,79,191,0.000333,0.383424,26,29907.07856,1661.504364,1150.272252,327.803208,5,0
2,0,29,31,29,44,73,146,100,246,0.000333,0.507566,28,42635.51156,2368.639531,1522.696841,381.09644,10,0
5,0,45,50,33,59,92,220,152,372,0.000333,0.808922,32,77656.48153,4314.248974,2426.765048,513.540946,8,0
2,0,23,25,28,40,68,117,81,198,0.000333,0.401773,28,33748.89399,1874.938555,1205.317643,347.483062,5,0
2,0,29,31,30,46,76,151,102,253,0.000333,0.526909,30,47421.76983,2634.542768,1580.725661,401.290568,10,0
7,0,48,55,34,58,92,235,160,395,0.000333,0.858936,34,87611.43707,4867.302059,2576.806973,512.736634,11,0
2,0,28,30,29,44,73,132,97,229,0.000333,0.47249,28,39689.15507,2204.95306,1417.469824,381.09644,5,0
1,0,46,47,33,43,76,207,147,354,0.000333,0.737255,48,106164.7843,5898.043573,2211.76634,399.79439,10,0
2,0,60,62,35,71,106,301,208,509,0.000333,1.141504,34,116433.3914,6468.521744,3424.511511,616.156951,15,0
2,0,43,45,36,53,89,210,148,358,0.000333,0.772771,36,83459.25246,4636.625137,2318.312568,489.697084,12,0
2,0,39,41,33,49,82,182,133,315,0.000333,0.667543,32,64084.12421,3560.229123,2002.628881,441.585788,8,0
3,0,52,55,34,57,91,233,170,403,0.000333,0.874214,34,89169.80216,4953.877898,2622.64124,505.448467,10,0
2,0,49,51,34,53,87,217,159,376,0.000333,0.807516,51,123549.8845,6863.882471,2422.546754,476.553521,9,0
1,0,45,46,33,44,77,197,142,339,0.000333,0.708147,48,101973.1506,5665.175033,2124.440637,406.679997,9,0
1,0,57,58,34,65,99,286,197,483,0.000333,1.067326,51,163300.9416,9072.274535,3201.979247,564.427644,15,0
1,0,65,66,34,65,99,336,224,560,0.000333,1.23748,51,189334.4251,10518.57917,3712.439707,564.427644,17,0
2,0,53,55,36,75,111,279,190,469,0.000333,1.062194,36,114716.9175,6373.162083,3186.581041,653.278702,16,0
2,0,49,51,34,71,105,251,175,426,0.000333,0.953423,34,97249.13208,5402.72956,2860.268591,609.605782,12,0
1,0,56,57,34,69,103,271,189,460,0.000333,1.025263,34,104576.8682,5809.826014,3075.790243,594.461924,14,0
1,0,56,57,34,68,102,271,190,461,0.000333,1.025329,34,104583.5948,5810.199712,3075.988083,586.92121,13,0
1,0,55,56,34,66,100,266,184,450,0.000333,0.996578,34,101650.9997,5647.277761,2989.735285,571.903748,13,0
1,0,46,47,33,48,81,202,147,349,0.000333,0.737536,48,106205.1672,5900.287069,2212.607651,434.543206,10,0
1,0,56,57,34,69,103,271,189,460,0.000333,1.025263,34,104576.8682,5809.826014,3075.790243,594.461924,14,0
2,0,42,44,31,53,84,195,140,335,0.000333,0.713809,30,64242.7901,3569.043894,2141.426337,457.15987,11,0
2,0,38,40,29,49,78,167,125,292,0.000333,0.611779,28,51389.44854,2854.969363,1835.337448,416.002231,7,0
1,0,45,46,28,43,71,187,139,326,0.000333,0.668273,42,84202.33756,4677.907642,2004.817561,367.935322,9,0
1,0,45,46,28,43,71,187,140,327,0.000333,0.670322,42,84460.62694,4692.257052,2010.967308,367.935322,8,0
1,0,44,45,30,48,78,182,134,316,0.000333,0.662062,30,59585.61304,3310.311835,1986.187101,415.284918,8,0
1,0,46,47,33,47,80,202,148,350,0.000333,0.737558,48,106208.392,5900.466222,2212.674833,427.530682,9,0
1,0,56,57,34,68,102,271,190,461,0.000333,1.025329,34,104583.5948,5810.199712,3075.988083,586.92121,13,0
2,0,42,44,31,52,83,195,141,336,0.000333,0.714004,30,64260.39747,3570.022082,2142.013249,450.002951,10,0
2,0,38,40,29,48,77,167,126,293,0.000333,0.612056,28,51412.71678,2856.262043,1836.168456,408.959649,6,0
1,0,45,46,28,43,71,187,140,327,0.000333,0.670322,42,84460.62694,4692.257052,2010.967308,367.935322,8,0
1,0,45,46,28,42,70,187,141,328,0.000333,0.670135,42,84437.00284,4690.944602,2010.40483,361.08327,7,0
1,0,44,45,30,47,77,182,135,317,0.000333,0.66219,30,59597.14,3310.952222,1986.571333,408.272394,7,0
1,0,45,46,33,44,77,197,142,339,0.000333,0.708147,48,101973.1506,5665.175033,2124.440637,406.679997,9,0
1,0,55,56,34,66,100,266,184,450,0.000333,0.996578,34,101650.9997,5647.277761,2989.735285,571.903748,13,0
2,0,41,43,33,53,86,190,135,325,0.000333,0.696179,32,66833.15345,3712.952969,2088.536045,470.04479,10,0
2,0,37,39,30,49,79,162,120,282,0.000333,0.592555,30,53329.98513,2962.776952,1777.666171,422.3275,6,0
1,0,44,45,30,48,78,182,134,316,0.000333,0.662062,30,59585.61304,3310.311835,1986.187101,415.284918,8,0
1,0,44,45,30,47,77,182,135,317,0.000333,0.66219,30,59597.14,3310.952222,1986.571333,408.272394,7,0
1,0,43,44,30,43,73,177,129,306,0.000333,0.631362,45,85233.88418,4735.215788,1894.086315,380.536102,7,0
1,0,9,10,20,19,39,59,37,96,0.000333,0.169133,10,5073.98613,281.888118,507.398613,167.149185,1,0
5,0,35,40,21,47,68,173,129,302,0.000333,0.612805,20,36768.27556,2042.681976,1838.413778,353.304342,7,0
6,0,74,80,29,106,135,438,290,728,0.000333,1.717307,28,144253.8091,8014.100507,5151.921755,854.041017,28,0
4,0,61,65,27,100,127,367,252,619,0.000333,1.441999,26,112475.8913,6248.66063,4325.995821,792.767582,22,0
4,0,59,63,27,98,125,354,244,598,0.000333,1.388513,26,108304.0141,6016.88967,4165.539002,776.623527,21,0
3,0,38,41,20,61,81,210,141,351,0.000333,0.741762,20,44505.74702,2472.541501,2225.287351,448.213539,14,0
3,0,37,40,20,60,80,202,137,339,0.000333,0.714378,20,42862.67248,2381.259582,2143.133624,440.851998,13,0
3,0,26,29,17,50,67,126,89,215,0.000333,0.434736,8,10433.67341,579.648523,1304.209176,351.679678,7,0
1,0,10,11,20,31,51,79,58,137,0.000333,0.259041,10,7771.222719,431.734595,777.122272,240.018648,8,0
9,0,64,73,22,70,92,359,224,583,0.000333,1.267746,33,125506.8085,6972.600471,3803.23662,527.157307,17,0
6,0,30,36,20,48,68,194,119,313,0.000333,0.635125,20,38107.51739,2117.084299,1905.375869,354.516762,11,0
9,0,64,73,22,70,92,359,224,583,0.000333,1.267746,33,125506.8085,6972.600471,3803.23662,527.157307,17,0
14,0,94,108,23,87,110,529,338,867,0.000333,1.959813,33,194021.4828,10778.97127,5879.438872,664.578009,23,0
7,0,32,39,18,49,67,205,132,337,0.000333,0.681424,18,36796.89703,2044.272057,2044.272057,350.179432,9,0
5,0,47,52,23,63,86,258,155,413,0.000333,0.884682,22,58389.04156,3243.835642,2654.047344,480.61056,14,0
3,0,16,19,19,34,53,105,60,165,0.000333,0.315036,9,8505.961875,472.553438,945.106875,253.684359,8,0
8,0,69,77,25,99,124,363,236,599,0.000333,1.388521,24,99973.52616,5554.084787,4165.56359,772.40271,18,0
8,0,57,65,25,84,109,312,200,512,0.000333,1.155103,24,83167.44898,4620.413832,3465.310374,653.051068,16,0
1,0,5,6,13,17,30,27,22,49,0.000333,0.080146,6,1442.625835,80.14588,240.437639,117.592585,1,0
0,0,40,40,22,40,62,252,159,411,0.000333,0.815725,33,80756.76456,4486.48692,2447.174684,310.984619,25,0
0,0,39,39,22,40,62,232,150,382,0.000333,0.758168,33,75058.59869,4169.922149,2274.502991,310.984619,22,0
0,0,38,38,22,40,62,212,141,353,0.000333,0.70061,33,69360.43282,3853.357379,2101.831298,310.984619,19,0
0,0,37,37,22,40,62,192,132,324,0.000333,0.643053,33,63662.26695,3536.792608,1929.159605,310.984619,16,0
0,0,36,36,22,40,62,148,111,259,0.000333,0.514046,22,33927.01058,1884.833921,1542.136844,310.984619,9,0
0,0,40,40,22,40,62,252,159,411,0.000333,0.815725,33,80756.76456,4486.48692,2447.174684,310.984619,25,0
0,0,39,39,22,40,62,232,150,382,0.000333,0.758168,33,75058.59869,4169.922149,2274.502991,310.984619,22,0
0,0,38,38,22,40,62,212,141,353,0.000333,0.70061,33,69360.43282,3853.357379,2101.831298,310.984619,19,0
0,0,37,37,22,40,62,192,132,324,0.000333,0.643053,33,63662.26695,3536.792608,1929.159605,310.984619,16,0
0,0,36,36,22,40,62,148,111,259,0.000333,0.514046,22,33927.01058,1884.833921,1542.136844,310.984619,9,0
0,0,3,3,12,10,22,23,16,39,0.000333,0.057973,6,1043.506999,57.972611,173.917833,76.238831,1,0
0,0,94,94,16,81,97,489,373,862,0.000333,1.896375,32,182051.9958,10113.99977,5689.12487,577.52785,15,0
0,0,92,92,16,75,91,469,356,825,0.000333,1.789644,32,171805.7785,9544.765472,5368.930578,531.161402,15,0
0,0,93,93,16,80,96,482,367,849,0.000333,1.863544,32,178900.2612,9938.903401,5590.633163,569.754248,15,0
0,0,93,93,16,75,91,475,361,836,0.000333,1.813505,32,174096.5222,9672.029012,5440.516319,531.161402,15,0
0,0,87,87,16,77,93,452,346,798,0.000333,1.739416,32,166983.9594,9276.886633,5218.248731,546.542564,14,0
0,0,89,89,16,74,90,465,356,821,0.000333,1.776604,32,170553.9645,9475.220253,5329.811392,523.499549,14,0
0,0,81,81,16,73,89,422,321,743,0.000333,1.603823,32,153967.0381,8553.724336,4811.469939,515.857193,13,0
0,0,85,85,16,73,89,455,350,805,0.000333,1.737655,32,166814.8932,9267.494066,5212.965412,515.857193,13,0
0,0,75,75,16,69,85,392,298,690,0.000333,1.47416,32,141519.3519,7862.186215,4422.479746,485.488188,12,0
0,0,35,35,14,60,74,326,279,605,0.000333,1.25224,28,105188.14,5843.785556,3756.719286,407.716405,1,0
0,0,35,35,14,60,74,326,279,605,0.000333,1.25224,28,105188.14,5843.785556,3756.719286,407.716405,1,0
0,0,35,35,14,60,74,326,279,605,0.000333,1.25224,28,105188.14,5843.785556,3756.719286,407.716405,1,0
0,0,41,41,16,62,78,345,294,639,0.000333,1.338791,32,128523.9046,7140.216921,4016.372018,433.160171,2,0
0,0,15,15,16,38,54,92,77,169,0.000333,0.324192,16,15561.21581,864.511989,972.575988,263.421246,2,0
0,0,45,45,16,63,79,355,300,655,0.000333,1.376325,32,132127.2445,7340.402471,4128.97639,440.568635,3,0
0,0,21,21,16,42,58,122,101,223,0.000333,0.435443,16,20901.27619,1161.182011,1306.329762,290.477332,3,0
0,0,49,49,16,64,80,365,305,670,0.000333,1.411897,32,135542.1384,7530.118797,4235.691824,448,4,0
0,0,27,27,16,46,62,152,123,275,0.000333,0.545801,16,26198.46377,1455.470209,1637.403985,318.08385,4,0
0,0,53,53,16,65,81,375,310,685,0.000333,1.447599,32,138969.5121,7720.528448,4342.797252,455.453908,5,0
0,0,33,33,16,49,65,182,145,327,0.000333,0.656438,16,31509.0284,1750.501578,1969.314275,339.120782,5,0
0,0,57,57,16,66,82,385,315,700,0.000333,1.483429,32,142409.1649,7911.620272,4450.286403,462.930012,6,0
0,0,39,39,16,53,69,212,167,379,0.000333,0.77171,24,55563.13846,3086.841025,2315.130769,367.579784,6,0
0,0,61,61,16,67,83,395,320,715,0.000333,1.519384,32,145860.9022,8103.383455,4558.153193,470.427976,7,0
0,0,45,45,16,55,71,242,189,431,0.000333,0.883514,24,63612.9842,3534.054678,2650.541009,381.974784,7,0
0,0,65,65,16,68,84,405,325,730,0.000333,1.555464,32,149324.535,8295.8075,4666.391719,477.947473,8,0
0,0,51,51,16,58,74,272,211,483,0.000333,0.999722,24,71979.98341,3998.887967,2999.165976,403.762898,8,0
0,0,69,69,16,69,85,415,330,745,0.000333,1.591665,32,152799.8799,8488.882218,4774.996247,485.488188,9,0
0,0,57,57,16,61,77,302,233,535,0.000333,1.117577,24,80465.53918,4470.307732,3352.730799,425.774978,9,0
0,0,73,73,16,70,86,425,335,760,0.000333,1.627987,32,156286.7588,8682.597713,4883.961214,493.049811,10,0
0,0,63,63,16,64,80,332,254,586,0.000333,1.234883,24,88911.59673,4939.533151,3704.649864,448,10,0
0,0,77,77,16,71,87,435,340,775,0.000333,1.664427,32,159784.9987,8876.944372,4993.281209,500.632045,11,0
0,0,69,69,16,66,82,362,276,638,0.000333,1.352039,32,129795.7817,7210.876763,4056.118179,462.930012,11,0
0,0,81,81,16,72,88,445,345,790,0.000333,1.700984,32,163294.4313,9071.912851,5102.950979,508.2346,12,0
0,0,3,3,13,18,31,49,34,83,0.000333,0.137066,6,2467.189763,137.066098,411.198294,123.164366,1,0
0,0,57,57,23,79,102,263,208,471,0.000333,1.047571,22,69139.67139,3841.092855,3142.712336,602.040604,63,0
0,0,54,54,21,77,98,254,204,458,0.000333,1.009846,20,60590.74217,3366.152343,3029.537109,574.78123,62,0
0,0,52,52,21,74,95,242,193,435,0.000333,0.952629,20,57157.74379,3175.430211,2857.88719,551.738215,60,0
0,0,5,5,11,13,24,20,18,38,0.000333,0.058076,5,871.142875,48.396826,174.228575,86.159464,7,0
0,0,15,15,16,30,46,47,46,93,0.000333,0.17123,8,4109.530095,228.307228,513.691262,211.206718,13,0
0,0,15,15,16,30,46,47,46,93,0.000333,0.17123,8,4109.530095,228.307228,513.691262,211.206718,13,0
0,0,7,7,14,20,34,29,27,56,0.000333,0.094966,7,1994.285434,110.793635,284.897919,139.741531,9,0
0,0,4,4,11,12,23,19,16,35,0.000333,0.052775,5,791.623342,43.979075,158.324668,81.073298,6,0
0,0,24,24,18,33,51,113,91,204,0.000333,0.385725,18,20829.14586,1157.17477,1157.17477,241.523656,6,0
0,0,24,24,18,33,51,113,91,204,0.000333,0.385725,18,20829.14586,1157.17477,1157.17477,241.523656,6,0
0,0,68,68,28,79,107,375,249,624,0.000333,1.402225,42,176680.3668,9815.575932,4206.6754,632.604617,49,0
0,0,67,67,28,79,107,359,241,600,0.000333,1.348293,42,169884.9681,9438.053781,4044.880192,632.604617,49,0
0,0,74,74,30,67,97,319,240,559,0.000333,1.229784,45,166020.8075,9223.378197,3689.351279,553.634694,38,0
0,0,4,4,14,13,27,23,18,41,0.000333,0.064983,7,1364.652713,75.81404,194.950388,101.408685,5,0
0,0,38,38,17,48,65,176,127,303,0.000333,0.608259,16,29196.43916,1622.024398,1824.777447,337.565068,32,0
0,0,38,38,17,48,65,176,127,303,0.000333,0.608259,16,29196.43916,1622.024398,1824.777447,337.565068,32,0
0,0,38,38,17,48,65,176,127,303,0.000333,0.608259,16,29196.43916,1622.024398,1824.777447,337.565068,32,0
0,0,35,35,17,45,62,155,113,268,0.000333,0.531908,16,25531.59378,1418.421877,1595.724611,316.620258,31,0
0,0,35,35,17,45,62,155,113,268,0.000333,0.531908,16,25531.59378,1418.421877,1595.724611,316.620258,31,0
0,0,35,35,17,45,62,155,113,268,0.000333,0.531908,16,25531.59378,1418.421877,1595.724611,316.620258,31,0
0,0,111,111,26,101,127,529,392,921,0.000333,2.145526,39,251026.5653,13945.92029,6436.578597,794.690792,53,0
0,0,103,103,26,97,123,505,361,866,0.000333,2.004073,39,234476.4849,13026.47138,6012.217562,762.402978,52,0
0,0,87,87,27,94,121,435,309,744,0.000333,1.715878,39,200757.7357,11153.20754,5147.634249,744.513315,43,0
0,0,5,5,13,18,31,40,35,75,0.000333,0.123855,6,2229.38834,123.854908,371.564723,123.164366,1,0
0,0,55,55,25,54,79,280,179,459,0.000333,0.964478,36,104163.6731,5786.870727,2893.435363,426.86033,33,0
0,0,105,105,29,111,140,505,354,859,0.000333,2.041351,42,257210.2727,14289.45959,6124.054112,895.06161,75,0
0,0,29,29,16,44,60,145,107,252,0.000333,0.496179,16,23816.58288,1323.143493,1488.53643,304.214991,9,0
0,0,42,42,25,59,84,225,158,383,0.000333,0.816086,24,58758.18175,3264.343431,2448.257573,463.172345,23,0
0,0,79,79,26,88,114,407,292,699,0.000333,1.592063,39,186271.4147,10348.41193,4776.19012,690.641415,41,0
0,0,79,79,26,88,114,407,292,699,0.000333,1.592063,39,186271.4147,10348.41193,4776.19012,690.641415,41,0
0,0,59,59,27,60,87,296,206,502,0.000333,1.078119,39,126139.9478,7007.774876,3234.357635,482.795398,34,0
0,0,59,59,27,60,87,296,206,502,0.000333,1.078119,39,126139.9478,7007.774876,3234.357635,482.795398,34,0
0,0,59,59,27,60,87,296,206,502,0.000333,1.078119,39,126139.9478,7007.774876,3234.357635,482.795398,34,0
0,0,59,59,27,60,87,296,206,502,0.000333,1.078119,39,126139.9478,7007.774876,3234.357635,482.795398,34,0
0,0,55,55,25,58,83,284,189,473,0.000333,1.005131,36,108554.1714,6030.787302,3015.393651,455.859302,33,0
0,0,52,52,25,57,82,271,181,452,0.000333,0.957871,36,103450.0862,5747.227012,2873.613506,448.571136,31,0
0,0,107,107,27,99,126,524,378,902,0.000333,2.097835,39,245446.7531,13635.93073,6293.506491,784.688268,53,0
0,0,113,113,28,106,134,543,405,948,0.000333,2.232884,42,281343.4072,15630.18929,6698.652553,847.765506,54,0
0,0,34,34,23,44,67,214,141,355,0.000333,0.717821,33,71064.23487,3948.013048,2153.461663,344.256916,19,0
0,0,34,34,23,44,67,214,141,355,0.000333,0.717821,33,71064.23487,3948.013048,2153.461663,344.256916,19,0
0,0,22,22,21,36,57,143,93,236,0.000333,0.458854,20,27531.24087,1529.513381,1376.562043,278.355966,16,0
0,0,17,17,21,31,52,106,69,175,0.000333,0.332526,20,19951.53901,1108.418834,997.576951,245.818752,13,0
0,0,79,79,24,67,91,525,446,971,0.000333,2.106356,72,454972.9389,25276.27438,6319.068596,516.467076,10,0
0,0,79,79,24,67,91,525,446,971,0.000333,2.106356,72,454972.9389,25276.27438,6319.068596,516.467076,10,0
0,0,69,69,24,71,95,452,381,833,0.000333,1.82423,60,328361.3833,18242.29907,5472.689722,546.671146,10,0
0,0,69,69,24,72,96,452,383,835,0.000333,1.832815,60,329906.6213,18328.14563,5498.443688,554.2737,10,0
0,0,79,79,24,67,91,525,446,971,0.000333,2.106356,72,454972.9389,25276.27438,6319.068596,516.467076,10,0
0,0,79,79,24,67,91,525,446,971,0.000333,2.106356,72,454972.9389,25276.27438,6319.068596,516.467076,10,0
0,0,69,69,24,71,95,452,381,833,0.000333,1.82423,60,328361.3833,18242.29907,5472.689722,546.671146,10,0
0,0,69,69,24,72,96,452,383,835,0.000333,1.832815,60,329906.6213,18328.14563,5498.443688,554.2737,10,0
0,0,58,58,24,70,94,373,314,687,0.000333,1.501001,48,216144.122,12008.00678,4503.002541,539.088911,9,0
0,0,57,57,24,70,94,365,306,671,0.000333,1.466043,48,211110.1977,11728.34432,4398.129119,539.088911,8,0
0,0,58,58,24,71,95,373,316,689,0.000333,1.508877,48,217278.2647,12071.0147,4526.630514,546.671146,9,0
0,0,79,79,24,67,91,525,446,971,0.000333,2.106356,72,454972.9389,25276.27438,6319.068596,516.467076,10,0
0,0,79,79,24,67,91,525,446,971,0.000333,2.106356,72,454972.9389,25276.27438,6319.068596,516.467076,10,0
0,0,69,69,24,71,95,452,381,833,0.000333,1.82423,60,328361.3833,18242.29907,5472.689722,546.671146,10,0
0,0,69,69,24,72,96,452,383,835,0.000333,1.832815,60,329906.6213,18328.14563,5498.443688,554.2737,10,0
0,0,79,79,24,67,91,525,446,971,0.000333,2.106356,72,454972.9389,25276.27438,6319.068596,516.467076,10,0
0,0,79,79,24,67,91,525,446,971,0.000333,2.106356,72,454972.9389,25276.27438,6319.068596,516.467076,10,0
0,0,69,69,24,71,95,452,381,833,0.000333,1.82423,60,328361.3833,18242.29907,5472.689722,546.671146,10,0
0,0,69,69,24,72,96,452,383,835,0.000333,1.832815,60,329906.6213,18328.14563,5498.443688,554.2737,10,0
0,0,58,58,24,70,94,373,314,687,0.000333,1.501001,48,216144.122,12008.00678,4503.002541,539.088911,9,0
0,0,57,57,24,70,94,365,306,671,0.000333,1.466043,48,211110.1977,11728.34432,4398.129119,539.088911,8,0
0,0,58,58,24,71,95,373,316,689,0.000333,1.508877,48,217278.2647,12071.0147,4526.630514,546.671146,9,0
0,0,79,79,24,67,91,525,446,971,0.000333,2.106356,72,454972.9389,25276.27438,6319.068596,516.467076,10,0
0,0,79,79,24,67,91,525,446,971,0.000333,2.106356,72,454972.9389,25276.27438,6319.068596,516.467076,10,0
0,0,69,69,24,71,95,452,381,833,0.000333,1.82423,60,328361.3833,18242.29907,5472.689722,546.671146,10,0
0,0,69,69,24,72,96,452,383,835,0.000333,1.832815,60,329906.6213,18328.14563,5498.443688,554.2737,10,0
0,0,79,79,24,67,91,525,446,971,0.000333,2.106356,72,454972.9389,25276.27438,6319.068596,516.467076,10,0
0,0,79,79,24,67,91,525,446,971,0.000333,2.106356,72,454972.9389,25276.27438,6319.068596,516.467076,10,0
0,0,69,69,24,71,95,452,381,833,0.000333,1.82423,60,328361.3833,18242.29907,5472.689722,546.671146,10,0
0,0,69,69,24,72,96,452,383,835,0.000333,1.832815,60,329906.6213,18328.14563,5498.443688,554.2737,10,0
0,0,58,58,24,70,94,373,314,687,0.000333,1.501001,48,216144.122,12008.00678,4503.002541,539.088911,9,0
0,0,57,57,24,70,94,365,306,671,0.000333,1.466043,48,211110.1977,11728.34432,4398.129119,539.088911,8,0
0,0,58,58,24,71,95,373,316,689,0.000333,1.508877,48,217278.2647,12071.0147,4526.630514,546.671146,9,0
0,0,79,79,24,67,91,525,446,971,0.000333,2.106356,72,454972.9389,25276.27438,6319.068596,516.467076,10,0
0,0,79,79,24,67,91,525,446,971,0.000333,2.106356,72,454972.9389,25276.27438,6319.068596,516.467076,10,0
0,0,69,69,24,71,95,452,381,833,0.000333,1.82423,60,328361.3833,18242.29907,5472.689722,546.671146,10,0
0,0,69,69,24,72,96,452,383,835,0.000333,1.832815,60,329906.6213,18328.14563,5498.443688,554.2737,10,0
0,0,79,79,24,67,91,525,446,971,0.000333,2.106356,72,454972.9389,25276.27438,6319.068596,516.467076,10,0
0,0,79,79,24,67,91,525,446,971,0.000333,2.106356,72,454972.9389,25276.27438,6319.068596,516.467076,10,0
0,0,69,69,24,71,95,452,381,833,0.000333,1.82423,60,328361.3833,18242.29907,5472.689722,546.671146,10,0
0,0,69,69,24,72,96,452,383,835,0.000333,1.832815,60,329906.6213,18328.14563,5498.443688,554.2737,10,0
0,0,58,58,24,70,94,373,314,687,0.000333,1.501001,48,216144.122,12008.00678,4503.002541,539.088911,9,0
0,0,57,57,24,70,94,365,306,671,0.000333,1.466043,48,211110.1977,11728.34432,4398.129119,539.088911,8,0
0,0,58,58,24,71,95,373,316,689,0.000333,1.508877,48,217278.2647,12071.0147,4526.630514,546.671146,9,0
0,0,62,62,22,59,81,432,364,796,0.000333,1.682174,66,333070.3598,18503.90888,5046.520602,445.183436,10,0
0,0,62,62,22,59,81,432,364,796,0.000333,1.682174,66,333070.3598,18503.90888,5046.520602,445.183436,10,0
0,0,52,52,22,63,85,359,299,658,0.000333,1.405793,44,185564.6864,10309.14924,4217.379236,474.676131,10,0
0,0,52,52,22,64,86,359,301,660,0.000333,1.413778,44,186618.7285,10367.70714,4241.334738,482.107496,10,0
0,0,62,62,22,59,81,432,364,796,0.000333,1.682174,66,333070.3598,18503.90888,5046.520602,445.183436,10,0
0,0,62,62,22,59,81,432,364,796,0.000333,1.682174,66,333070.3598,18503.90888,5046.520602,445.183436,10,0
0,0,52,52,22,63,85,359,299,658,0.000333,1.405793,44,185564.6864,10309.14924,4217.379236,474.676131,10,0
0,0,52,52,22,64,86,359,301,660,0.000333,1.413778,44,186618.7285,10367.70714,4241.334738,482.107496,10,0
0,0,41,41,22,62,84,280,232,512,0.000333,1.090956,33,108004.5952,6000.255288,3272.86652,467.267667,9,0
0,0,40,40,22,62,84,272,224,496,0.000333,1.056863,33,104629.4516,5812.74731,3170.589442,467.267667,8,0
0,0,41,41,22,63,85,280,234,514,0.000333,1.098142,33,108716.0891,6039.782725,3294.426941,474.676131,9,0
0,0,62,62,22,59,81,432,364,796,0.000333,1.682174,66,333070.3598,18503.90888,5046.520602,445.183436,10,0
0,0,62,62,22,59,81,432,364,796,0.000333,1.682174,66,333070.3598,18503.90888,5046.520602,445.183436,10,0
0,0,52,52,22,63,85,359,299,658,0.000333,1.405793,44,185564.6864,10309.14924,4217.379236,474.676131,10,0
0,0,52,52,22,64,86,359,301,660,0.000333,1.413778,44,186618.7285,10367.70714,4241.334738,482.107496,10,0
0,0,62,62,22,59,81,432,364,796,0.000333,1.682174,66,333070.3598,18503.90888,5046.520602,445.183436,10,0
0,0,62,62,22,59,81,432,364,796,0.000333,1.682174,66,333070.3598,18503.90888,5046.520602,445.183436,10,0
0,0,52,52,22,63,85,359,299,658,0.000333,1.405793,44,185564.6864,10309.14924,4217.379236,474.676131,10,0
0,0,52,52,22,64,86,359,301,660,0.000333,1.413778,44,186618.7285,10367.70714,4241.334738,482.107496,10,0
0,0,41,41,22,62,84,280,232,512,0.000333,1.090956,33,108004.5952,6000.255288,3272.86652,467.267667,9,0
0,0,40,40,22,62,84,272,224,496,0.000333,1.056863,33,104629.4516,5812.74731,3170.589442,467.267667,8,0
0,0,41,41,22,63,85,280,234,514,0.000333,1.098142,33,108716.0891,6039.782725,3294.426941,474.676131,9,0
0,0,62,62,22,59,81,432,364,796,0.000333,1.682174,66,333070.3598,18503.90888,5046.520602,445.183436,10,0
0,0,62,62,22,59,81,432,364,796,0.000333,1.682174,66,333070.3598,18503.90888,5046.520602,445.183436,10,0
0,0,52,52,22,63,85,359,299,658,0.000333,1.405793,44,185564.6864,10309.14924,4217.379236,474.676131,10,0
0,0,52,52,22,64,86,359,301,660,0.000333,1.413778,44,186618.7285,10367.70714,4241.334738,482.107496,10,0
0,0,62,62,22,59,81,432,364,796,0.000333,1.682174,66,333070.3598,18503.90888,5046.520602,445.183436,10,0
0,0,62,62,22,59,81,432,364,796,0.000333,1.682174,66,333070.3598,18503.90888,5046.520602,445.183436,10,0
0,0,52,52,22,63,85,359,299,658,0.000333,1.405793,44,185564.6864,10309.14924,4217.379236,474.676131,10,0
0,0,52,52,22,64,86,359,301,660,0.000333,1.413778,44,186618.7285,10367.70714,4241.334738,482.107496,10,0
0,0,41,41,22,62,84,280,232,512,0.000333,1.090956,33,108004.5952,6000.255288,3272.86652,467.267667,9,0
0,0,40,40,22,62,84,272,224,496,0.000333,1.056863,33,104629.4516,5812.74731,3170.589442,467.267667,8,0
0,0,41,41,22,63,85,280,234,514,0.000333,1.098142,33,108716.0891,6039.782725,3294.426941,474.676131,9,0
0,0,62,62,22,59,81,432,364,796,0.000333,1.682174,66,333070.3598,18503.90888,5046.520602,445.183436,10,0
0,0,62,62,22,59,81,432,364,796,0.000333,1.682174,66,333070.3598,18503.90888,5046.520602,445.183436,10,0
0,0,52,52,22,63,85,359,299,658,0.000333,1.405793,44,185564.6864,10309.14924,4217.379236,474.676131,10,0
0,0,52,52,22,64,86,359,301,660,0.000333,1.413778,44,186618.7285,10367.70714,4241.334738,482.107496,10,0
0,0,62,62,22,59,81,432,364,796,0.000333,1.682174,66,333070.3598,18503.90888,5046.520602,445.183436,10,0
0,0,62,62,22,59,81,432,364,796,0.000333,1.682174,66,333070.3598,18503.90888,5046.520602,445.183436,10,0
0,0,52,52,22,63,85,359,299,658,0.000333,1.405793,44,185564.6864,10309.14924,4217.379236,474.676131,10,0
0,0,52,52,22,64,86,359,301,660,0.000333,1.413778,44,186618.7285,10367.70714,4241.334738,482.107496,10,0
0,0,41,41,22,62,84,280,232,512,0.000333,1.090956,33,108004.5952,6000.255288,3272.86652,467.267667,9,0
0,0,40,40,22,62,84,272,224,496,0.000333,1.056863,33,104629.4516,5812.74731,3170.589442,467.267667,8,0
0,0,41,41,22,63,85,280,234,514,0.000333,1.098142,33,108716.0891,6039.782725,3294.426941,474.676131,9,0
0,0,62,62,22,59,81,432,364,796,0.000333,1.682174,66,333070.3598,18503.90888,5046.520602,445.183436,10,0
0,0,62,62,22,59,81,432,364,796,0.000333,1.682174,66,333070.3598,18503.90888,5046.520602,445.183436,10,0
0,0,52,52,22,63,85,359,299,658,0.000333,1.405793,44,185564.6864,10309.14924,4217.379236,474.676131,10,0
0,0,52,52,22,64,86,359,301,660,0.000333,1.413778,44,186618.7285,10367.70714,4241.334738,482.107496,10,0
0,0,62,62,22,59,81,432,364,796,0.000333,1.682174,66,333070.3598,18503.90888,5046.520602,445.183436,10,0
0,0,62,62,22,59,81,432,364,796,0.000333,1.682174,66,333070.3598,18503.90888,5046.520602,445.183436,10,0
0,0,52,52,22,63,85,359,299,658,0.000333,1.405793,44,185564.6864,10309.14924,4217.379236,474.676131,10,0
0,0,52,52,22,64,86,359,301,660,0.000333,1.413778,44,186618.7285,10367.70714,4241.334738,482.107496,10,0
0,0,41,41,22,62,84,280,232,512,0.000333,1.090956,33,108004.5952,6000.255288,3272.86652,467.267667,9,0
0,0,40,40,22,62,84,272,224,496,0.000333,1.056863,33,104629.4516,5812.74731,3170.589442,467.267667,8,0
0,0,41,41,22,63,85,280,234,514,0.000333,1.098142,33,108716.0891,6039.782725,3294.426941,474.676131,9,0
0,0,62,62,22,59,81,432,364,796,0.000333,1.682174,66,333070.3598,18503.90888,5046.520602,445.183436,10,0
0,0,62,62,22,59,81,432,364,796,0.000333,1.682174,66,333070.3598,18503.90888,5046.520602,445.183436,10,0
0,0,52,52,22,63,85,359,299,658,0.000333,1.405793,44,185564.6864,10309.14924,4217.379236,474.676131,10,0
0,0,52,52,22,64,86,359,301,660,0.000333,1.413778,44,186618.7285,10367.70714,4241.334738,482.107496,10,0
0,0,62,62,22,59,81,432,364,796,0.000333,1.682174,66,333070.3598,18503.90888,5046.520602,445.183436,10,0
0,0,62,62,22,59,81,432,364,796,0.000333,1.682174,66,333070.3598,18503.90888,5046.520602,445.183436,10,0
0,0,52,52,22,63,85,359,299,658,0.000333,1.405793,44,185564.6864,10309.14924,4217.379236,474.676131,10,0
0,0,52,52,22,64,86,359,301,660,0.000333,1.413778,44,186618.7285,10367.70714,4241.334738,482.107496,10,0
0,0,41,41,22,62,84,280,232,512,0.000333,1.090956,33,108004.5952,6000.255288,3272.86652,467.267667,9,0
0,0,40,40,22,62,84,272,224,496,0.000333,1.056863,33,104629.4516,5812.74731,3170.589442,467.267667,8,0
0,0,41,41,22,63,85,280,234,514,0.000333,1.098142,33,108716.0891,6039.782725,3294.426941,474.676131,9,0
0,0,62,62,22,59,81,432,364,796,0.000333,1.682174,66,333070.3598,18503.90888,5046.520602,445.183436,10,0
0,0,62,62,22,59,81,432,364,796,0.000333,1.682174,66,333070.3598,18503.90888,5046.520602,445.183436,10,0
0,0,52,52,22,63,85,359,299,658,0.000333,1.405793,44,185564.6864,10309.14924,4217.379236,474.676131,10,0
0,0,52,52,22,64,86,359,301,660,0.000333,1.413778,44,186618.7285,10367.70714,4241.334738,482.107496,10,0
0,0,62,62,22,59,81,432,364,796,0.000333,1.682174,66,333070.3598,18503.90888,5046.520602,445.183436,10,0
0,0,62,62,22,59,81,432,364,796,0.000333,1.682174,66,333070.3598,18503.90888,5046.520602,445.183436,10,0
0,0,52,52,22,63,85,359,299,658,0.000333,1.405793,44,185564.6864,10309.14924,4217.379236,474.676131,10,0
0,0,52,52,22,64,86,359,301,660,0.000333,1.413778,44,186618.7285,10367.70714,4241.334738,482.107496,10,0
0,0,41,41,22,62,84,280,232,512,0.000333,1.090956,33,108004.5952,6000.255288,3272.86652,467.267667,9,0
0,0,40,40,22,62,84,272,224,496,0.000333,1.056863,33,104629.4516,5812.74731,3170.589442,467.267667,8,0
0,0,41,41,22,63,85,280,234,514,0.000333,1.098142,33,108716.0891,6039.782725,3294.426941,474.676131,9,0
0,0,62,62,22,59,81,432,364,796,0.000333,1.682174,66,333070.3598,18503.90888,5046.520602,445.183436,10,0
0,0,62,62,22,59,81,432,364,796,0.000333,1.682174,66,333070.3598,18503.90888,5046.520602,445.183436,10,0
0,0,52,52,22,63,85,359,299,658,0.000333,1.405793,44,185564.6864,10309.14924,4217.379236,474.676131,10,0
0,0,52,52,22,64,86,359,301,660,0.000333,1.413778,44,186618.7285,10367.70714,4241.334738,482.107496,10,0
0,0,62,62,22,59,81,432,364,796,0.000333,1.682174,66,333070.3598,18503.90888,5046.520602,445.183436,10,0
0,0,62,62,22,59,81,432,364,796,0.000333,1.682174,66,333070.3598,18503.90888,5046.520602,445.183436,10,0
0,0,52,52,22,63,85,359,299,658,0.000333,1.405793,44,185564.6864,10309.14924,4217.379236,474.676131,10,0
0,0,52,52,22,64,86,359,301,660,0.000333,1.413778,44,186618.7285,10367.70714,4241.334738,482.107496,10,0
0,0,41,41,22,62,84,280,232,512,0.000333,1.090956,33,108004.5952,6000.255288,3272.86652,467.267667,9,0
0,0,40,40,22,62,84,272,224,496,0.000333,1.056863,33,104629.4516,5812.74731,3170.589442,467.267667,8,0
0,0,41,41,22,63,85,280,234,514,0.000333,1.098142,33,108716.0891,6039.782725,3294.426941,474.676131,9,0
0,0,71,71,24,67,91,453,390,843,0.000333,1.82869,60,329164.2529,18286.90294,5486.070882,516.467076,10,0
0,0,71,71,24,67,91,453,390,843,0.000333,1.82869,60,329164.2529,18286.90294,5486.070882,516.467076,10,0
0,0,61,61,24,71,95,380,325,705,0.000333,1.543916,48,222323.9138,12351.32854,4631.748204,546.671146,10,0
0,0,61,61,24,72,96,380,327,707,0.000333,1.551856,48,223467.2874,12414.8493,4655.568488,554.2737,10,0
0,0,71,71,24,67,91,453,390,843,0.000333,1.82869,60,329164.2529,18286.90294,5486.070882,516.467076,10,0
0,0,71,71,24,67,91,453,390,843,0.000333,1.82869,60,329164.2529,18286.90294,5486.070882,516.467076,10,0
0,0,61,61,24,71,95,380,325,705,0.000333,1.543916,48,222323.9138,12351.32854,4631.748204,546.671146,10,0
0,0,61,61,24,72,96,380,327,707,0.000333,1.551856,48,223467.2874,12414.8493,4655.568488,554.2737,10,0
0,0,50,50,24,70,94,301,258,559,0.000333,1.221338,36,131904.5461,7328.030336,3664.015168,539.088911,9,0
0,0,49,49,24,70,94,293,250,543,0.000333,1.186381,36,128129.1029,7118.283493,3559.141746,539.088911,8,0
0,0,50,50,24,71,95,301,260,561,0.000333,1.228563,36,132684.8039,7371.377993,3685.688996,546.671146,9,0
0,0,60,60,22,60,82,406,345,751,0.000333,1.591507,55,262598.6856,14588.81586,4774.521555,452.520931,10,0
0,0,60,60,22,60,82,406,345,751,0.000333,1.591507,55,262598.6856,14588.81586,4774.521555,452.520931,10,0
0,0,50,50,22,64,86,333,280,613,0.000333,1.3131,44,173329.213,9629.40072,3939.300295,482.107496,10,0
0,0,50,50,22,65,87,333,282,615,0.000333,1.320803,44,174346.051,9685.891722,3962.41025,489.561403,10,0
0,0,60,60,22,60,82,406,345,751,0.000333,1.591507,55,262598.6856,14588.81586,4774.521555,452.520931,10,0
0,0,60,60,22,60,82,406,345,751,0.000333,1.591507,55,262598.6856,14588.81586,4774.521555,452.520931,10,0
0,0,50,50,22,64,86,333,280,613,0.000333,1.3131,44,173329.213,9629.40072,3939.300295,482.107496,10,0
0,0,50,50,22,65,87,333,282,615,0.000333,1.320803,44,174346.051,9685.891722,3962.41025,489.561403,10,0
0,0,39,39,22,63,85,254,213,467,0.000333,0.997729,33,98775.12372,5487.506873,2993.185567,474.676131,9,0
0,0,38,38,22,63,85,246,205,451,0.000333,0.963545,33,95390.9653,5299.498072,2890.635312,474.676131,8,0
0,0,39,39,22,64,86,254,215,469,0.000333,1.004639,33,99459.29961,5525.516645,3013.91817,482.107496,9,0
0,0,60,60,22,60,82,406,345,751,0.000333,1.591507,55,262598.6856,14588.81586,4774.521555,452.520931,10,0
0,0,60,60,22,60,82,406,345,751,0.000333,1.591507,55,262598.6856,14588.81586,4774.521555,452.520931,10,0
0,0,50,50,22,64,86,333,280,613,0.000333,1.3131,44,173329.213,9629.40072,3939.300295,482.107496,10,0
0,0,50,50,22,65,87,333,282,615,0.000333,1.320803,44,174346.051,9685.891722,3962.41025,489.561403,10,0
0,0,60,60,22,60,82,406,345,751,0.000333,1.591507,55,262598.6856,14588.81586,4774.521555,452.520931,10,0
0,0,60,60,22,60,82,406,345,751,0.000333,1.591507,55,262598.6856,14588.81586,4774.521555,452.520931,10,0
0,0,50,50,22,64,86,333,280,613,0.000333,1.3131,44,173329.213,9629.40072,3939.300295,482.107496,10,0
0,0,50,50,22,65,87,333,282,615,0.000333,1.320803,44,174346.051,9685.891722,3962.41025,489.561403,10,0
0,0,39,39,22,63,85,254,213,467,0.000333,0.997729,33,98775.12372,5487.506873,2993.185567,474.676131,9,0
0,0,38,38,22,63,85,246,205,451,0.000333,0.963545,33,95390.9653,5299.498072,2890.635312,474.676131,8,0
0,0,39,39,22,64,86,254,215,469,0.000333,1.004639,33,99459.29961,5525.516645,3013.91817,482.107496,9,0
0,0,85,85,24,67,91,579,488,1067,0.000333,2.314606,84,583280.618,32404.47878,6943.816881,516.467076,10,0
0,0,85,85,24,67,91,579,488,1067,0.000333,2.314606,84,583280.618,32404.47878,6943.816881,516.467076,10,0
0,0,75,75,24,71,95,506,423,929,0.000333,2.034465,60,366203.7516,20344.65287,6103.39586,546.671146,10,0
0,0,75,75,24,72,96,506,425,931,0.000333,2.043533,60,367836.0053,20435.33363,6130.600088,554.2737,10,0
0,0,85,85,24,67,91,579,488,1067,0.000333,2.314606,84,583280.618,32404.47878,6943.816881,516.467076,10,0
0,0,85,85,24,67,91,579,488,1067,0.000333,2.314606,84,583280.618,32404.47878,6943.816881,516.467076,10,0
0,0,75,75,24,71,95,506,423,929,0.000333,2.034465,60,366203.7516,20344.65287,6103.39586,546.671146,10,0
0,0,75,75,24,72,96,506,425,931,0.000333,2.043533,60,367836.0053,20435.33363,6130.600088,554.2737,10,0
0,0,64,64,24,70,94,427,356,783,0.000333,1.710748,60,307934.5843,17107.4769,5132.243071,539.088911,9,0
0,0,63,63,24,70,94,419,348,767,0.000333,1.67579,48,241313.7432,13406.31907,5027.369649,539.088911,8,0
0,0,64,64,24,71,95,427,358,785,0.000333,1.719112,60,309440.1992,17191.12218,5157.336653,546.671146,9,0
0,0,85,85,24,67,91,579,488,1067,0.000333,2.314606,84,583280.618,32404.47878,6943.816881,516.467076,10,0
0,0,85,85,24,67,91,579,488,1067,0.000333,2.314606,84,583280.618,32404.47878,6943.816881,516.467076,10,0
0,0,75,75,24,71,95,506,423,929,0.000333,2.034465,60,366203.7516,20344.65287,6103.39586,546.671146,10,0
0,0,75,75,24,72,96,506,425,931,0.000333,2.043533,60,367836.0053,20435.33363,6130.600088,554.2737,10,0
0,0,85,85,24,67,91,579,488,1067,0.000333,2.314606,84,583280.618,32404.47878,6943.816881,516.467076,10,0
0,0,85,85,24,67,91,579,488,1067,0.000333,2.314606,84,583280.618,32404.47878,6943.816881,516.467076,10,0
0,0,75,75,24,71,95,506,423,929,0.000333,2.034465,60,366203.7516,20344.65287,6103.39586,546.671146,10,0
0,0,75,75,24,72,96,506,425,931,0.000333,2.043533,60,367836.0053,20435.33363,6130.600088,554.2737,10,0
0,0,64,64,24,70,94,427,356,783,0.000333,1.710748,60,307934.5843,17107.4769,5132.243071,539.088911,9,0
0,0,63,63,24,70,94,419,348,767,0.000333,1.67579,48,241313.7432,13406.31907,5027.369649,539.088911,8,0
0,0,64,64,24,71,95,427,358,785,0.000333,1.719112,60,309440.1992,17191.12218,5157.336653,546.671146,9,0
0,0,85,85,24,67,91,579,488,1067,0.000333,2.314606,84,583280.618,32404.47878,6943.816881,516.467076,10,0
0,0,85,85,24,67,91,579,488,1067,0.000333,2.314606,84,583280.618,32404.47878,6943.816881,516.467076,10,0
0,0,75,75,24,71,95,506,423,929,0.000333,2.034465,60,366203.7516,20344.65287,6103.39586,546.671146,10,0
0,0,75,75,24,72,96,506,425,931,0.000333,2.043533,60,367836.0053,20435.33363,6130.600088,554.2737,10,0
0,0,85,85,24,67,91,579,488,1067,0.000333,2.314606,84,583280.618,32404.47878,6943.816881,516.467076,10,0
0,0,85,85,24,67,91,579,488,1067,0.000333,2.314606,84,583280.618,32404.47878,6943.816881,516.467076,10,0
0,0,75,75,24,71,95,506,423,929,0.000333,2.034465,60,366203.7516,20344.65287,6103.39586,546.671146,10,0
0,0,75,75,24,72,96,506,425,931,0.000333,2.043533,60,367836.0053,20435.33363,6130.600088,554.2737,10,0
0,0,64,64,24,70,94,427,356,783,0.000333,1.710748,60,307934.5843,17107.4769,5132.243071,539.088911,9,0
0,0,63,63,24,70,94,419,348,767,0.000333,1.67579,48,241313.7432,13406.31907,5027.369649,539.088911,8,0
0,0,64,64,24,71,95,427,358,785,0.000333,1.719112,60,309440.1992,17191.12218,5157.336653,546.671146,9,0
0,0,57,57,22,55,77,395,337,732,0.000333,1.529096,66,302760.9914,16820.05508,4587.287748,416.08228,10,0
0,0,57,57,22,55,77,395,337,732,0.000333,1.529096,66,302760.9914,16820.05508,4587.287748,416.08228,10,0
0,0,47,47,22,59,81,322,272,594,0.000333,1.25529,44,165698.3197,9205.462204,3765.870902,445.183436,10,0
0,0,47,47,22,60,82,322,274,596,0.000333,1.263034,44,166720.4438,9262.246876,3789.100995,452.520931,10,0
0,0,57,57,22,55,77,395,337,732,0.000333,1.529096,66,302760.9914,16820.05508,4587.287748,416.08228,10,0
0,0,57,57,22,55,77,395,337,732,0.000333,1.529096,66,302760.9914,16820.05508,4587.287748,416.08228,10,0
0,0,47,47,22,59,81,322,272,594,0.000333,1.25529,44,165698.3197,9205.462204,3765.870902,445.183436,10,0
0,0,47,47,22,60,82,322,274,596,0.000333,1.263034,44,166720.4438,9262.246876,3789.100995,452.520931,10,0
0,0,36,36,22,58,80,243,205,448,0.000333,0.944075,33,93463.38496,5192.410275,2832.223787,437.870393,9,0
0,0,35,35,22,58,80,235,197,432,0.000333,0.910358,33,90125.40692,5006.967051,2731.072937,437.870393,8,0
0,0,36,36,22,59,81,243,207,450,0.000333,0.950978,33,94146.77254,5230.376252,2852.932501,445.183436,9,0
0,0,57,57,22,55,77,395,337,732,0.000333,1.529096,66,302760.9914,16820.05508,4587.287748,416.08228,10,0
0,0,57,57,22,55,77,395,337,732,0.000333,1.529096,66,302760.9914,16820.05508,4587.287748,416.08228,10,0
0,0,47,47,22,59,81,322,272,594,0.000333,1.25529,44,165698.3197,9205.462204,3765.870902,445.183436,10,0
0,0,47,47,22,60,82,322,274,596,0.000333,1.263034,44,166720.4438,9262.246876,3789.100995,452.520931,10,0
0,0,57,57,22,55,77,395,337,732,0.000333,1.529096,66,302760.9914,16820.05508,4587.287748,416.08228,10,0
0,0,57,57,22,55,77,395,337,732,0.000333,1.529096,66,302760.9914,16820.05508,4587.287748,416.08228,10,0
0,0,47,47,22,59,81,322,272,594,0.000333,1.25529,44,165698.3197,9205.462204,3765.870902,445.183436,10,0
0,0,47,47,22,60,82,322,274,596,0.000333,1.263034,44,166720.4438,9262.246876,3789.100995,452.520931,10,0
0,0,36,36,22,58,80,243,205,448,0.000333,0.944075,33,93463.38496,5192.410275,2832.223787,437.870393,9,0
0,0,35,35,22,58,80,235,197,432,0.000333,0.910358,33,90125.40692,5006.967051,2731.072937,437.870393,8,0
0,0,36,36,22,59,81,243,207,450,0.000333,0.950978,33,94146.77254,5230.376252,2852.932501,445.183436,9,0
0,0,57,57,22,55,77,395,337,732,0.000333,1.529096,66,302760.9914,16820.05508,4587.287748,416.08228,10,0
0,0,57,57,22,55,77,395,337,732,0.000333,1.529096,66,302760.9914,16820.05508,4587.287748,416.08228,10,0
0,0,47,47,22,59,81,322,272,594,0.000333,1.25529,44,165698.3197,9205.462204,3765.870902,445.183436,10,0
0,0,47,47,22,60,82,322,274,596,0.000333,1.263034,44,166720.4438,9262.246876,3789.100995,452.520931,10,0
0,0,57,57,22,55,77,395,337,732,0.000333,1.529096,66,302760.9914,16820.05508,4587.287748,416.08228,10,0
0,0,57,57,22,55,77,395,337,732,0.000333,1.529096,66,302760.9914,16820.05508,4587.287748,416.08228,10,0
0,0,47,47,22,59,81,322,272,594,0.000333,1.25529,44,165698.3197,9205.462204,3765.870902,445.183436,10,0
0,0,47,47,22,60,82,322,274,596,0.000333,1.263034,44,166720.4438,9262.246876,3789.100995,452.520931,10,0
0,0,36,36,22,58,80,243,205,448,0.000333,0.944075,33,93463.38496,5192.410275,2832.223787,437.870393,9,0
0,0,35,35,22,58,80,235,197,432,0.000333,0.910358,33,90125.40692,5006.967051,2731.072937,437.870393,8,0
0,0,36,36,22,59,81,243,207,450,0.000333,0.950978,33,94146.77254,5230.376252,2852.932501,445.183436,9,0
0,0,57,57,22,55,77,395,337,732,0.000333,1.529096,66,302760.9914,16820.05508,4587.287748,416.08228,10,0
0,0,57,57,22,55,77,395,337,732,0.000333,1.529096,66,302760.9914,16820.05508,4587.287748,416.08228,10,0
0,0,47,47,22,59,81,322,272,594,0.000333,1.25529,44,165698.3197,9205.462204,3765.870902,445.183436,10,0
0,0,47,47,22,60,82,322,274,596,0.000333,1.263034,44,166720.4438,9262.246876,3789.100995,452.520931,10,0
0,0,57,57,22,55,77,395,337,732,0.000333,1.529096,66,302760.9914,16820.05508,4587.287748,416.08228,10,0
0,0,57,57,22,55,77,395,337,732,0.000333,1.529096,66,302760.9914,16820.05508,4587.287748,416.08228,10,0
0,0,47,47,22,59,81,322,272,594,0.000333,1.25529,44,165698.3197,9205.462204,3765.870902,445.183436,10,0
0,0,47,47,22,60,82,322,274,596,0.000333,1.263034,44,166720.4438,9262.246876,3789.100995,452.520931,10,0
0,0,36,36,22,58,80,243,205,448,0.000333,0.944075,33,93463.38496,5192.410275,2832.223787,437.870393,9,0
0,0,35,35,22,58,80,235,197,432,0.000333,0.910358,33,90125.40692,5006.967051,2731.072937,437.870393,8,0
0,0,36,36,22,59,81,243,207,450,0.000333,0.950978,33,94146.77254,5230.376252,2852.932501,445.183436,9,0
0,0,57,57,22,55,77,395,337,732,0.000333,1.529096,66,302760.9914,16820.05508,4587.287748,416.08228,10,0
0,0,57,57,22,55,77,395,337,732,0.000333,1.529096,66,302760.9914,16820.05508,4587.287748,416.08228,10,0
0,0,47,47,22,59,81,322,272,594,0.000333,1.25529,44,165698.3197,9205.462204,3765.870902,445.183436,10,0
0,0,47,47,22,60,82,322,274,596,0.000333,1.263034,44,166720.4438,9262.246876,3789.100995,452.520931,10,0
0,0,57,57,22,55,77,395,337,732,0.000333,1.529096,66,302760.9914,16820.05508,4587.287748,416.08228,10,0
0,0,57,57,22,55,77,395,337,732,0.000333,1.529096,66,302760.9914,16820.05508,4587.287748,416.08228,10,0
0,0,47,47,22,59,81,322,272,594,0.000333,1.25529,44,165698.3197,9205.462204,3765.870902,445.183436,10,0
0,0,47,47,22,60,82,322,274,596,0.000333,1.263034,44,166720.4438,9262.246876,3789.100995,452.520931,10,0
0,0,36,36,22,58,80,243,205,448,0.000333,0.944075,33,93463.38496,5192.410275,2832.223787,437.870393,9,0
0,0,35,35,22,58,80,235,197,432,0.000333,0.910358,33,90125.40692,5006.967051,2731.072937,437.870393,8,0
0,0,36,36,22,59,81,243,207,450,0.000333,0.950978,33,94146.77254,5230.376252,2852.932501,445.183436,9,0
0,0,57,57,22,55,77,395,337,732,0.000333,1.529096,66,302760.9914,16820.05508,4587.287748,416.08228,10,0
0,0,57,57,22,55,77,395,337,732,0.000333,1.529096,66,302760.9914,16820.05508,4587.287748,416.08228,10,0
0,0,47,47,22,59,81,322,272,594,0.000333,1.25529,44,165698.3197,9205.462204,3765.870902,445.183436,10,0
0,0,47,47,22,60,82,322,274,596,0.000333,1.263034,44,166720.4438,9262.246876,3789.100995,452.520931,10,0
0,0,57,57,22,55,77,395,337,732,0.000333,1.529096,66,302760.9914,16820.05508,4587.287748,416.08228,10,0
0,0,57,57,22,55,77,395,337,732,0.000333,1.529096,66,302760.9914,16820.05508,4587.287748,416.08228,10,0
0,0,47,47,22,59,81,322,272,594,0.000333,1.25529,44,165698.3197,9205.462204,3765.870902,445.183436,10,0
0,0,47,47,22,60,82,322,274,596,0.000333,1.263034,44,166720.4438,9262.246876,3789.100995,452.520931,10,0
0,0,36,36,22,58,80,243,205,448,0.000333,0.944075,33,93463.38496,5192.410275,2832.223787,437.870393,9,0
0,0,35,35,22,58,80,235,197,432,0.000333,0.910358,33,90125.40692,5006.967051,2731.072937,437.870393,8,0
0,0,36,36,22,59,81,243,207,450,0.000333,0.950978,33,94146.77254,5230.376252,2852.932501,445.183436,9,0
0,0,104,104,33,100,133,521,409,930,0.000333,2.187138,64,419930.4106,23329.46725,6561.412665,830.850625,65,0
0,0,103,103,33,100,133,518,405,923,0.000333,2.170675,64,416769.644,23153.86911,6512.025688,830.850625,65,0
0,0,102,102,33,100,133,516,402,918,0.000333,2.158916,64,414511.9537,23028.44187,6476.749276,830.850625,65,0
0,0,102,102,33,100,133,516,402,918,0.000333,2.158916,64,414511.9537,23028.44187,6476.749276,830.850625,65,0
0,0,104,104,32,100,132,529,413,942,0.000333,2.21194,64,424692.4327,23594.02404,6635.81926,824.385619,65,0
0,0,103,103,32,100,132,526,409,935,0.000333,2.195503,64,421536.5441,23418.6969,6586.508502,824.385619,65,0
0,0,102,102,32,100,132,524,406,930,0.000333,2.183762,64,419282.338,23293.46322,6551.286531,824.385619,65,0
0,0,102,102,32,100,132,524,406,930,0.000333,2.183762,64,419282.338,23293.46322,6551.286531,824.385619,65,0
0,0,114,114,32,102,134,532,422,954,0.000333,2.247016,64,431427.1416,23968.17453,6741.049088,840.587385,64,0
0,0,112,112,31,101,132,525,416,941,0.000333,2.209592,60,397726.492,22095.91622,6628.774866,826.059445,64,0
0,0,105,105,32,99,131,496,387,883,0.000333,2.070171,48,298104.6005,16561.36669,6210.51251,816.306305,63,0
0,0,103,103,32,98,130,490,382,872,0.000333,2.041168,48,293928.2272,16329.34596,6123.504733,808.241565,62,0
0,0,103,103,32,98,130,490,382,872,0.000333,2.041168,48,293928.2272,16329.34596,6123.504733,808.241565,62,0
0,0,103,103,32,98,130,490,382,872,0.000333,2.041168,48,293928.2272,16329.34596,6123.504733,808.241565,62,0
0,0,103,103,32,98,130,490,382,872,0.000333,2.041168,48,293928.2272,16329.34596,6123.504733,808.241565,62,0
0,0,32,32,20,79,99,220,172,392,0.000333,0.866236,20,51974.1559,2887.453106,2598.707795,584.437241,10,0
0,0,32,32,20,79,99,220,172,392,0.000333,0.866236,20,51974.1559,2887.453106,2598.707795,584.437241,10,0
0,0,34,34,20,53,73,161,118,279,0.000333,0.575654,20,34539.22104,1918.845613,1726.961052,390.018346,10,0
0,0,33,33,20,52,72,154,113,267,0.000333,0.549123,20,32947.39951,1830.411084,1647.369975,382.861427,9,0
0,0,32,32,20,52,72,148,109,257,0.000333,0.528557,20,31713.41451,1761.856362,1585.670725,382.861427,8,0
0,0,31,31,20,52,72,143,106,249,0.000333,0.512104,20,30726.22651,1707.012584,1536.311325,382.861427,7,0
0,0,25,25,17,48,65,104,81,185,0.000333,0.371379,8,8913.104363,495.172465,1114.138045,337.565068,6,0
0,0,22,22,16,44,60,92,73,165,0.000333,0.324879,8,7797.095586,433.171977,974.636948,304.214991,5,0
1,0,7,8,21,16,37,58,31,89,0.000333,0.154547,10,4636.413495,257.578528,463.64135,156.238666,3,0
1,0,3,4,15,11,26,31,14,45,0.000333,0.070507,7,1480.638511,82.257695,211.519787,96.657107,2,0
1,0,5,6,19,15,34,42,20,62,0.000333,0.105141,9,2838.804265,157.711348,315.422696,139.313982,2,0
1,0,4,5,16,12,28,39,17,56,0.000333,0.089737,8,2153.695005,119.649723,269.211876,107.01955,2,0
1,0,17,18,22,21,43,112,59,171,0.000333,0.309297,22,20413.60801,1134.089334,927.891273,190.346161,12,0
1,0,3,4,15,11,26,40,14,54,0.000333,0.084608,7,1776.766213,98.709234,253.823745,96.657107,6,0
1,0,5,6,19,15,34,51,20,71,0.000333,0.120403,9,3250.888756,180.604931,361.209862,139.313982,6,0
1,0,13,14,17,17,34,91,43,134,0.000333,0.22724,16,10907.52033,605.973352,681.720021,138.973737,11,0
0,0,64,64,35,57,92,311,237,548,0.000333,1.191637,68,243094.0127,13505.22293,3574.911952,511.999636,25,0
0,0,64,64,35,57,92,311,237,548,0.000333,1.191637,68,243094.0127,13505.22293,3574.911952,511.999636,25,0
0,0,34,34,33,40,73,163,131,294,0.000333,0.606603,48,87350.80418,4852.822454,1819.80842,379.34213,14,0
0,0,34,34,33,40,73,163,131,294,0.000333,0.606603,48,87350.80418,4852.822454,1819.80842,379.34213,14,0
0,0,34,34,33,40,73,163,131,294,0.000333,0.606603,48,87350.80418,4852.822454,1819.80842,379.34213,14,0
0,0,34,34,33,40,73,163,131,294,0.000333,0.606603,48,87350.80418,4852.822454,1819.80842,379.34213,14,0
0,0,30,30,23,59,82,178,133,311,0.000333,0.659066,22,43498.37082,2416.576156,1977.198673,451.117865,12,0
0,0,30,30,25,67,92,193,142,335,0.000333,0.728464,24,52449.43813,2913.857674,2185.393255,522.524381,12,0
0,0,21,21,21,42,63,135,97,232,0.000333,0.462243,20,27734.57885,1540.809936,1386.728942,318.715998,11,0
0,0,28,28,23,57,80,171,125,296,0.000333,0.623764,22,41168.39575,2287.133097,1871.290716,436.516656,12,0
0,0,20,20,21,38,59,128,92,220,0.000333,0.431394,20,25883.62942,1437.979412,1294.181471,291.659911,11,0
0,0,20,20,20,42,62,129,94,223,0.000333,0.442595,20,26555.71554,1475.31753,1327.785777,312.915894,10,0
0,0,27,27,22,57,79,165,122,287,0.000333,0.603062,22,39802.07164,2211.226202,1809.185075,430.582226,11,0
0,0,19,19,20,38,58,122,89,211,0.000333,0.412011,20,24720.6798,1373.3711,1236.03399,285.859807,10,0
0,0,18,18,20,38,58,117,86,203,0.000333,0.39639,20,23783.40284,1321.300158,1189.170142,285.859807,9,0
0,0,74,74,27,80,107,371,279,650,0.000333,1.460651,39,170896.1881,9494.232673,4381.953541,634.13621,28,0
0,0,72,72,26,76,102,355,266,621,0.000333,1.381192,39,161599.4694,8977.748298,4143.576137,597.053924,28,0
0,0,72,72,26,76,102,350,266,616,0.000333,1.370071,39,160298.3464,8905.46369,4110.214011,597.053924,27,0
0,0,70,70,26,75,101,339,256,595,0.000333,1.320545,39,154503.7975,8583.544303,3961.635832,589.372834,27,0
0,0,73,73,27,80,107,367,275,642,0.000333,1.442674,39,168792.8504,9377.380578,4328.021805,634.13621,27,0
0,0,32,32,20,45,65,168,132,300,0.000333,0.602237,20,36134.20688,2007.455938,1806.710344,333.571951,15,0
0,0,35,35,23,48,71,188,145,333,0.000333,0.682622,33,67579.5711,3754.420616,2047.865791,372.120125,17,0
0,0,34,34,22,46,68,182,141,323,0.000333,0.655417,33,64886.26643,3604.792579,1966.250498,352.191346,16,0
0,0,70,70,30,80,110,346,261,607,0.000333,1.372095,45,185232.8406,10290.71337,4116.285346,652.960965,29,0
0,0,33,33,24,47,71,176,137,313,0.000333,0.641624,24,46196.90036,2566.494465,1924.870848,371.104776,17,0
0,0,68,68,29,78,107,343,256,599,0.000333,1.346046,42,169601.8264,9422.323691,4038.138725,631.142822,27,0
0,0,67,67,29,75,104,332,248,580,0.000333,1.295418,42,163222.7115,9067.928419,3886.255037,608.042851,27,0
0,0,37,37,27,52,79,232,162,394,0.000333,0.827897,39,96863.89498,5381.327499,2483.689615,424.804828,21,0
0,0,70,70,29,80,109,356,264,620,0.000333,1.398758,42,176243.5198,9791.306657,4196.274281,646.635696,29,0
0,0,14,14,16,28,44,80,58,138,0.000333,0.251134,16,12054.42501,669.690279,753.401563,198.605938,8,0
0,0,15,15,16,29,45,84,61,145,0.000333,0.26544,16,12741.09918,707.838844,796.318699,204.881449,8,0
0,0,22,22,20,39,59,129,96,225,0.000333,0.441198,20,26471.89372,1470.660762,1323.594686,292.569248,12,0
0,0,23,23,21,41,62,135,100,235,0.000333,0.466412,20,27984.72266,1554.706814,1399.236133,311.898298,13,0
0,0,26,26,23,44,67,154,116,270,0.000333,0.545948,22,36032.56979,2001.809433,1637.844081,344.256916,15,0
0,0,23,23,20,41,61,141,101,242,0.000333,0.478413,20,28704.76871,1594.709373,1435.238436,306.098194,12,0
0,0,24,24,20,46,66,148,108,256,0.000333,0.515788,20,30947.29789,1719.294327,1547.364895,340.522412,12,0
0,0,26,26,22,57,79,170,124,294,0.000333,0.617771,22,40772.85388,2265.158549,1853.31154,430.582226,12,0
0,0,26,26,22,59,81,170,124,294,0.000333,0.621305,22,41006.14982,2278.119434,1863.915901,445.183436,12,0
0,0,26,26,23,58,81,171,125,296,0.000333,0.625532,22,41285.10322,2293.616845,1876.595601,443.804823,12,0
0,0,24,24,20,42,62,144,105,249,0.000333,0.494198,20,29651.89763,1647.327646,1482.594881,312.915894,12,0
0,0,25,25,20,47,67,151,112,263,0.000333,0.531794,20,31907.62914,1772.646063,1595.381457,347.504238,12,0
0,0,27,27,20,52,72,161,120,281,0.000333,0.577916,20,34674.97851,1926.387695,1733.748925,382.861427,13,0
0,0,27,27,20,51,71,161,120,281,0.000333,0.576026,20,34561.57881,1920.087712,1728.078941,375.732254,13,0
0,0,27,27,22,45,67,147,116,263,0.000333,0.531794,22,35098.39206,1949.91067,1595.381457,345.240885,13,0
0,0,41,41,24,63,87,253,190,443,0.000333,0.951408,36,102752.0629,5708.447937,2854.223969,486.607735,20,0
0,0,29,29,22,48,70,156,122,278,0.000333,0.56798,22,37486.69493,2082.594163,1703.940679,366.185696,13,0
0,0,32,32,22,45,67,176,134,310,0.000333,0.626829,22,41370.72828,2298.373793,1880.487649,345.240885,16,0
0,0,33,33,23,47,70,182,138,320,0.000333,0.65379,22,43150.15244,2397.230691,1961.370565,365.107601,17,0
0,0,51,51,26,92,118,359,271,630,0.000333,1.445355,26,112737.6931,6263.205175,4336.065121,722.379133,11,0
0,0,75,75,27,80,107,380,285,665,0.000333,1.494359,39,174839.9463,9713.33035,4483.075546,634.13621,28,0
0,0,12,12,18,30,48,94,61,155,0.000333,0.288556,18,15582.04538,865.669188,865.669188,222.265368,6,0
0,0,14,14,17,31,48,110,75,185,0.000333,0.344406,16,16531.489,918.416056,1033.218063,223.066954,7,0
0,0,50,50,26,91,117,354,268,622,0.000333,1.424456,26,111107.5382,6172.641014,4273.366856,714.420745,10,0
0,0,50,50,26,68,94,372,251,623,0.000333,1.36117,39,159256.8453,8847.602518,4083.508855,536.158906,27,0
0,0,33,33,22,47,69,266,176,442,0.000333,0.899989,33,89098.93773,4949.940985,2699.96781,359.173172,19,0
0,0,35,35,22,65,87,292,204,496,0.000333,1.065233,33,105458.0991,5858.783286,3195.699974,489.561403,14,0
0,0,33,33,19,55,74,252,178,430,0.000333,0.890022,27,72091.75358,4005.097421,2670.064947,398.685407,15,0
0,0,26,26,18,43,61,198,135,333,0.000333,0.658312,27,53323.2594,2962.4033,1974.935533,308.388034,13,0
0,0,23,23,18,41,59,179,123,302,0.000333,0.592186,27,47967.07142,2664.837301,1776.558201,294.718282,12,0
0,0,74,74,27,80,107,371,279,650,0.000333,1.460651,39,170896.1881,9494.232673,4381.953541,634.13621,28,0
0,0,72,72,26,76,102,355,266,621,0.000333,1.381192,39,161599.4694,8977.748298,4143.576137,597.053924,28,0
0,0,72,72,26,76,102,350,266,616,0.000333,1.370071,39,160298.3464,8905.46369,4110.214011,597.053924,27,0
0,0,70,70,26,75,101,339,256,595,0.000333,1.320545,39,154503.7975,8583.544303,3961.635832,589.372834,27,0
0,0,73,73,27,80,107,367,275,642,0.000333,1.442674,39,168792.8504,9377.380578,4328.021805,634.13621,27,0
0,0,32,32,20,45,65,168,132,300,0.000333,0.602237,20,36134.20688,2007.455938,1806.710344,333.571951,15,0
0,0,35,35,23,48,71,188,145,333,0.000333,0.682622,33,67579.5711,3754.420616,2047.865791,372.120125,17,0
0,0,34,34,22,46,68,182,141,323,0.000333,0.655417,33,64886.26643,3604.792579,1966.250498,352.191346,16,0
0,0,70,70,30,80,110,346,261,607,0.000333,1.372095,45,185232.8406,10290.71337,4116.285346,652.960965,29,0
0,0,33,33,24,47,71,176,137,313,0.000333,0.641624,24,46196.90036,2566.494465,1924.870848,371.104776,17,0
0,0,68,68,29,78,107,343,256,599,0.000333,1.346046,42,169601.8264,9422.323691,4038.138725,631.142822,27,0
0,0,67,67,29,75,104,332,248,580,0.000333,1.295418,42,163222.7115,9067.928419,3886.255037,608.042851,27,0
0,0,37,37,27,52,79,232,162,394,0.000333,0.827897,39,96863.89498,5381.327499,2483.689615,424.804828,21,0
0,0,70,70,29,80,109,356,264,620,0.000333,1.398758,42,176243.5198,9791.306657,4196.274281,646.635696,29,0
0,0,14,14,16,28,44,80,58,138,0.000333,0.251134,16,12054.42501,669.690279,753.401563,198.605938,8,0
0,0,15,15,16,29,45,84,61,145,0.000333,0.26544,16,12741.09918,707.838844,796.318699,204.881449,8,0
0,0,22,22,20,39,59,129,96,225,0.000333,0.441198,20,26471.89372,1470.660762,1323.594686,292.569248,12,0
0,0,23,23,21,41,62,135,100,235,0.000333,0.466412,20,27984.72266,1554.706814,1399.236133,311.898298,13,0
0,0,26,26,23,44,67,154,116,270,0.000333,0.545948,22,36032.56979,2001.809433,1637.844081,344.256916,15,0
0,0,23,23,20,41,61,141,101,242,0.000333,0.478413,20,28704.76871,1594.709373,1435.238436,306.098194,12,0
0,0,24,24,20,46,66,148,108,256,0.000333,0.515788,20,30947.29789,1719.294327,1547.364895,340.522412,12,0
0,0,26,26,22,57,79,170,124,294,0.000333,0.617771,22,40772.85388,2265.158549,1853.31154,430.582226,12,0
0,0,26,26,22,59,81,170,124,294,0.000333,0.621305,22,41006.14982,2278.119434,1863.915901,445.183436,12,0
0,0,26,26,23,58,81,171,125,296,0.000333,0.625532,22,41285.10322,2293.616845,1876.595601,443.804823,12,0
0,0,24,24,20,42,62,144,105,249,0.000333,0.494198,20,29651.89763,1647.327646,1482.594881,312.915894,12,0
0,0,25,25,20,47,67,151,112,263,0.000333,0.531794,20,31907.62914,1772.646063,1595.381457,347.504238,12,0
0,0,27,27,20,52,72,161,120,281,0.000333,0.577916,20,34674.97851,1926.387695,1733.748925,382.861427,13,0
0,0,27,27,20,51,71,161,120,281,0.000333,0.576026,20,34561.57881,1920.087712,1728.078941,375.732254,13,0
0,0,27,27,22,45,67,147,116,263,0.000333,0.531794,22,35098.39206,1949.91067,1595.381457,345.240885,13,0
0,0,41,41,24,63,87,253,190,443,0.000333,0.951408,36,102752.0629,5708.447937,2854.223969,486.607735,20,0
0,0,29,29,22,48,70,156,122,278,0.000333,0.56798,22,37486.69493,2082.594163,1703.940679,366.185696,13,0
0,0,32,32,22,45,67,176,134,310,0.000333,0.626829,22,41370.72828,2298.373793,1880.487649,345.240885,16,0
0,0,33,33,23,47,70,182,138,320,0.000333,0.65379,22,43150.15244,2397.230691,1961.370565,365.107601,17,0
0,0,51,51,26,92,118,359,271,630,0.000333,1.445355,26,112737.6931,6263.205175,4336.065121,722.379133,11,0
0,0,75,75,27,80,107,380,285,665,0.000333,1.494359,39,174839.9463,9713.33035,4483.075546,634.13621,28,0
0,0,12,12,18,30,48,94,61,155,0.000333,0.288556,18,15582.04538,865.669188,865.669188,222.265368,6,0
0,0,12,12,17,29,46,93,63,156,0.000333,0.287225,16,13786.81064,765.933925,861.675665,210.368317,6,0
0,0,50,50,26,91,117,354,268,622,0.000333,1.424456,26,111107.5382,6172.641014,4273.366856,714.420745,10,0
0,0,50,50,26,68,94,372,251,623,0.000333,1.36117,39,159256.8453,8847.602518,4083.508855,536.158906,27,0
0,0,33,33,22,47,69,266,176,442,0.000333,0.899989,33,89098.93773,4949.940985,2699.96781,359.173172,19,0
0,0,35,35,22,65,87,292,204,496,0.000333,1.065233,33,105458.0991,5858.783286,3195.699974,489.561403,14,0
0,0,33,33,19,55,74,252,178,430,0.000333,0.890022,27,72091.75358,4005.097421,2670.064947,398.685407,15,0
0,0,26,26,18,43,61,198,135,333,0.000333,0.658312,27,53323.2594,2962.4033,1974.935533,308.388034,13,0
0,0,23,23,18,41,59,179,123,302,0.000333,0.592186,27,47967.07142,2664.837301,1776.558201,294.718282,12,0
0,0,74,74,27,80,107,371,279,650,0.000333,1.460651,39,170896.1881,9494.232673,4381.953541,634.13621,28,0
0,0,72,72,26,76,102,355,266,621,0.000333,1.381192,39,161599.4694,8977.748298,4143.576137,597.053924,28,0
0,0,72,72,26,76,102,350,266,616,0.000333,1.370071,39,160298.3464,8905.46369,4110.214011,597.053924,27,0
0,0,70,70,26,75,101,339,256,595,0.000333,1.320545,39,154503.7975,8583.544303,3961.635832,589.372834,27,0
0,0,73,73,27,80,107,367,275,642,0.000333,1.442674,39,168792.8504,9377.380578,4328.021805,634.13621,27,0
0,0,32,32,20,45,65,168,132,300,0.000333,0.602237,20,36134.20688,2007.455938,1806.710344,333.571951,15,0
0,0,35,35,23,48,71,188,145,333,0.000333,0.682622,33,67579.5711,3754.420616,2047.865791,372.120125,17,0
0,0,34,34,22,46,68,182,141,323,0.000333,0.655417,33,64886.26643,3604.792579,1966.250498,352.191346,16,0
0,0,70,70,30,80,110,346,261,607,0.000333,1.372095,45,185232.8406,10290.71337,4116.285346,652.960965,29,0
0,0,33,33,24,47,71,176,137,313,0.000333,0.641624,24,46196.90036,2566.494465,1924.870848,371.104776,17,0
0,0,68,68,29,78,107,343,256,599,0.000333,1.346046,42,169601.8264,9422.323691,4038.138725,631.142822,27,0
0,0,67,67,29,75,104,332,248,580,0.000333,1.295418,42,163222.7115,9067.928419,3886.255037,608.042851,27,0
0,0,37,37,27,52,79,232,162,394,0.000333,0.827897,39,96863.89498,5381.327499,2483.689615,424.804828,21,0
0,0,70,70,29,80,109,356,264,620,0.000333,1.398758,42,176243.5198,9791.306657,4196.274281,646.635696,29,0
0,0,14,14,16,28,44,80,58,138,0.000333,0.251134,16,12054.42501,669.690279,753.401563,198.605938,8,0
0,0,15,15,16,29,45,84,61,145,0.000333,0.26544,16,12741.09918,707.838844,796.318699,204.881449,8,0
0,0,22,22,20,39,59,129,96,225,0.000333,0.441198,20,26471.89372,1470.660762,1323.594686,292.569248,12,0
0,0,23,23,21,41,62,135,100,235,0.000333,0.466412,20,27984.72266,1554.706814,1399.236133,311.898298,13,0
0,0,26,26,23,44,67,154,116,270,0.000333,0.545948,22,36032.56979,2001.809433,1637.844081,344.256916,15,0
0,0,23,23,20,41,61,141,101,242,0.000333,0.478413,20,28704.76871,1594.709373,1435.238436,306.098194,12,0
0,0,24,24,20,46,66,148,108,256,0.000333,0.515788,20,30947.29789,1719.294327,1547.364895,340.522412,12,0
0,0,26,26,22,57,79,170,124,294,0.000333,0.617771,22,40772.85388,2265.158549,1853.31154,430.582226,12,0
0,0,26,26,22,59,81,170,124,294,0.000333,0.621305,22,41006.14982,2278.119434,1863.915901,445.183436,12,0
0,0,26,26,23,58,81,171,125,296,0.000333,0.625532,22,41285.10322,2293.616845,1876.595601,443.804823,12,0
0,0,24,24,20,42,62,144,105,249,0.000333,0.494198,20,29651.89763,1647.327646,1482.594881,312.915894,12,0
0,0,25,25,20,47,67,151,112,263,0.000333,0.531794,20,31907.62914,1772.646063,1595.381457,347.504238,12,0
0,0,27,27,20,52,72,161,120,281,0.000333,0.577916,20,34674.97851,1926.387695,1733.748925,382.861427,13,0
0,0,27,27,20,51,71,161,120,281,0.000333,0.576026,20,34561.57881,1920.087712,1728.078941,375.732254,13,0
0,0,27,27,22,45,67,147,116,263,0.000333,0.531794,22,35098.39206,1949.91067,1595.381457,345.240885,13,0
0,0,41,41,24,63,87,253,190,443,0.000333,0.951408,36,102752.0629,5708.447937,2854.223969,486.607735,20,0
0,0,29,29,22,48,70,156,122,278,0.000333,0.56798,22,37486.69493,2082.594163,1703.940679,366.185696,13,0
0,0,32,32,22,45,67,176,134,310,0.000333,0.626829,22,41370.72828,2298.373793,1880.487649,345.240885,16,0
0,0,33,33,23,47,70,182,138,320,0.000333,0.65379,22,43150.15244,2397.230691,1961.370565,365.107601,17,0
0,0,51,51,26,92,118,359,271,630,0.000333,1.445355,26,112737.6931,6263.205175,4336.065121,722.379133,11,0
0,0,75,75,27,80,107,380,285,665,0.000333,1.494359,39,174839.9463,9713.33035,4483.075546,634.13621,28,0
0,0,12,12,18,30,48,94,61,155,0.000333,0.288556,18,15582.04538,865.669188,865.669188,222.265368,6,0
0,0,12,12,17,29,46,93,63,156,0.000333,0.287225,16,13786.81064,765.933925,861.675665,210.368317,6,0
0,0,14,14,17,31,48,110,75,185,0.000333,0.344406,16,16531.489,918.416056,1033.218063,223.066954,7,0
0,0,50,50,26,91,117,354,268,622,0.000333,1.424456,26,111107.5382,6172.641014,4273.366856,714.420745,10,0
0,0,50,50,26,68,94,372,251,623,0.000333,1.36117,39,159256.8453,8847.602518,4083.508855,536.158906,27,0
0,0,33,33,22,47,69,266,176,442,0.000333,0.899989,33,89098.93773,4949.940985,2699.96781,359.173172,19,0
0,0,35,35,22,65,87,292,204,496,0.000333,1.065233,33,105458.0991,5858.783286,3195.699974,489.561403,14,0
0,0,33,33,19,55,74,252,178,430,0.000333,0.890022,27,72091.75358,4005.097421,2670.064947,398.685407,15,0
0,0,26,26,18,43,61,198,135,333,0.000333,0.658312,27,53323.2594,2962.4033,1974.935533,308.388034,13,0
0,0,74,74,27,80,107,371,279,650,0.000333,1.460651,39,170896.1881,9494.232673,4381.953541,634.13621,28,0
0,0,72,72,26,76,102,355,266,621,0.000333,1.381192,39,161599.4694,8977.748298,4143.576137,597.053924,28,0
0,0,72,72,26,76,102,350,266,616,0.000333,1.370071,39,160298.3464,8905.46369,4110.214011,597.053924,27,0
0,0,70,70,26,75,101,339,256,595,0.000333,1.320545,39,154503.7975,8583.544303,3961.635832,589.372834,27,0
0,0,73,73,27,80,107,367,275,642,0.000333,1.442674,39,168792.8504,9377.380578,4328.021805,634.13621,27,0
0,0,32,32,20,45,65,168,132,300,0.000333,0.602237,20,36134.20688,2007.455938,1806.710344,333.571951,15,0
0,0,35,35,23,48,71,188,145,333,0.000333,0.682622,33,67579.5711,3754.420616,2047.865791,372.120125,17,0
0,0,34,34,22,46,68,182,141,323,0.000333,0.655417,33,64886.26643,3604.792579,1966.250498,352.191346,16,0
0,0,70,70,30,80,110,346,261,607,0.000333,1.372095,45,185232.8406,10290.71337,4116.285346,652.960965,29,0
0,0,33,33,24,47,71,176,137,313,0.000333,0.641624,24,46196.90036,2566.494465,1924.870848,371.104776,17,0
0,0,68,68,29,78,107,343,256,599,0.000333,1.346046,42,169601.8264,9422.323691,4038.138725,631.142822,27,0
0,0,67,67,29,75,104,332,248,580,0.000333,1.295418,42,163222.7115,9067.928419,3886.255037,608.042851,27,0
0,0,37,37,27,52,79,232,162,394,0.000333,0.827897,39,96863.89498,5381.327499,2483.689615,424.804828,21,0
0,0,70,70,29,80,109,356,264,620,0.000333,1.398758,42,176243.5198,9791.306657,4196.274281,646.635696,29,0
0,0,14,14,16,28,44,80,58,138,0.000333,0.251134,16,12054.42501,669.690279,753.401563,198.605938,8,0
0,0,15,15,16,29,45,84,61,145,0.000333,0.26544,16,12741.09918,707.838844,796.318699,204.881449,8,0
0,0,22,22,20,39,59,129,96,225,0.000333,0.441198,20,26471.89372,1470.660762,1323.594686,292.569248,12,0
0,0,23,23,21,41,62,135,100,235,0.000333,0.466412,20,27984.72266,1554.706814,1399.236133,311.898298,13,0
0,0,26,26,23,44,67,154,116,270,0.000333,0.545948,22,36032.56979,2001.809433,1637.844081,344.256916,15,0
0,0,23,23,20,41,61,141,101,242,0.000333,0.478413,20,28704.76871,1594.709373,1435.238436,306.098194,12,0
0,0,24,24,20,46,66,148,108,256,0.000333,0.515788,20,30947.29789,1719.294327,1547.364895,340.522412,12,0
0,0,26,26,22,57,79,170,124,294,0.000333,0.617771,22,40772.85388,2265.158549,1853.31154,430.582226,12,0
0,0,26,26,22,59,81,170,124,294,0.000333,0.621305,22,41006.14982,2278.119434,1863.915901,445.183436,12,0
0,0,26,26,23,58,81,171,125,296,0.000333,0.625532,22,41285.10322,2293.616845,1876.595601,443.804823,12,0
0,0,24,24,20,42,62,144,105,249,0.000333,0.494198,20,29651.89763,1647.327646,1482.594881,312.915894,12,0
0,0,25,25,20,47,67,151,112,263,0.000333,0.531794,20,31907.62914,1772.646063,1595.381457,347.504238,12,0
0,0,27,27,20,52,72,161,120,281,0.000333,0.577916,20,34674.97851,1926.387695,1733.748925,382.861427,13,0
0,0,27,27,20,51,71,161,120,281,0.000333,0.576026,20,34561.57881,1920.087712,1728.078941,375.732254,13,0
0,0,27,27,22,45,67,147,116,263,0.000333,0.531794,22,35098.39206,1949.91067,1595.381457,345.240885,13,0
0,0,41,41,24,63,87,253,190,443,0.000333,0.951408,36,102752.0629,5708.447937,2854.223969,486.607735,20,0
0,0,29,29,22,48,70,156,122,278,0.000333,0.56798,22,37486.69493,2082.594163,1703.940679,366.185696,13,0
0,0,32,32,22,45,67,176,134,310,0.000333,0.626829,22,41370.72828,2298.373793,1880.487649,345.240885,16,0
0,0,33,33,23,47,70,182,138,320,0.000333,0.65379,22,43150.15244,2397.230691,1961.370565,365.107601,17,0
0,0,51,51,26,92,118,359,271,630,0.000333,1.445355,26,112737.6931,6263.205175,4336.065121,722.379133,11,0
0,0,75,75,27,80,107,380,285,665,0.000333,1.494359,39,174839.9463,9713.33035,4483.075546,634.13621,28,0
0,0,12,12,18,30,48,94,61,155,0.000333,0.288556,18,15582.04538,865.669188,865.669188,222.265368,6,0
0,0,12,12,17,29,46,93,63,156,0.000333,0.287225,16,13786.81064,765.933925,861.675665,210.368317,6,0
0,0,14,14,17,31,48,110,75,185,0.000333,0.344406,16,16531.489,918.416056,1033.218063,223.066954,7,0
0,0,50,50,26,91,117,354,268,622,0.000333,1.424456,26,111107.5382,6172.641014,4273.366856,714.420745,10,0
0,0,50,50,26,68,94,372,251,623,0.000333,1.36117,39,159256.8453,8847.602518,4083.508855,536.158906,27,0
0,0,33,33,22,47,69,266,176,442,0.000333,0.899989,33,89098.93773,4949.940985,2699.96781,359.173172,19,0
0,0,35,35,22,65,87,292,204,496,0.000333,1.065233,33,105458.0991,5858.783286,3195.699974,489.561403,14,0
0,0,33,33,19,55,74,252,178,430,0.000333,0.890022,27,72091.75358,4005.097421,2670.064947,398.685407,15,0
0,0,23,23,18,41,59,179,123,302,0.000333,0.592186,27,47967.07142,2664.837301,1776.558201,294.718282,12,0
0,0,74,74,27,80,107,371,279,650,0.000333,1.460651,39,170896.1881,9494.232673,4381.953541,634.13621,28,0
0,0,72,72,26,76,102,355,266,621,0.000333,1.381192,39,161599.4694,8977.748298,4143.576137,597.053924,28,0
0,0,72,72,26,76,102,350,266,616,0.000333,1.370071,39,160298.3464,8905.46369,4110.214011,597.053924,27,0
0,0,70,70,26,75,101,339,256,595,0.000333,1.320545,39,154503.7975,8583.544303,3961.635832,589.372834,27,0
0,0,73,73,27,80,107,367,275,642,0.000333,1.442674,39,168792.8504,9377.380578,4328.021805,634.13621,27,0
0,0,32,32,20,45,65,168,132,300,0.000333,0.602237,20,36134.20688,2007.455938,1806.710344,333.571951,15,0
0,0,35,35,23,48,71,188,145,333,0.000333,0.682622,33,67579.5711,3754.420616,2047.865791,372.120125,17,0
0,0,34,34,22,46,68,182,141,323,0.000333,0.655417,33,64886.26643,3604.792579,1966.250498,352.191346,16,0
0,0,70,70,30,80,110,346,261,607,0.000333,1.372095,45,185232.8406,10290.71337,4116.285346,652.960965,29,0
0,0,33,33,24,47,71,176,137,313,0.000333,0.641624,24,46196.90036,2566.494465,1924.870848,371.104776,17,0
0,0,68,68,29,78,107,343,256,599,0.000333,1.346046,42,169601.8264,9422.323691,4038.138725,631.142822,27,0
0,0,67,67,29,75,104,332,248,580,0.000333,1.295418,42,163222.7115,9067.928419,3886.255037,608.042851,27,0
0,0,37,37,27,52,79,232,162,394,0.000333,0.827897,39,96863.89498,5381.327499,2483.689615,424.804828,21,0
0,0,70,70,29,80,109,356,264,620,0.000333,1.398758,42,176243.5198,9791.306657,4196.274281,646.635696,29,0
0,0,14,14,16,28,44,80,58,138,0.000333,0.251134,16,12054.42501,669.690279,753.401563,198.605938,8,0
0,0,15,15,16,29,45,84,61,145,0.000333,0.26544,16,12741.09918,707.838844,796.318699,204.881449,8,0
0,0,22,22,20,39,59,129,96,225,0.000333,0.441198,20,26471.89372,1470.660762,1323.594686,292.569248,12,0
0,0,23,23,21,41,62,135,100,235,0.000333,0.466412,20,27984.72266,1554.706814,1399.236133,311.898298,13,0
0,0,26,26,23,44,67,154,116,270,0.000333,0.545948,22,36032.56979,2001.809433,1637.844081,344.256916,15,0
0,0,23,23,20,41,61,141,101,242,0.000333,0.478413,20,28704.76871,1594.709373,1435.238436,306.098194,12,0
0,0,24,24,20,46,66,148,108,256,0.000333,0.515788,20,30947.29789,1719.294327,1547.364895,340.522412,12,0
0,0,26,26,22,57,79,170,124,294,0.000333,0.617771,22,40772.85388,2265.158549,1853.31154,430.582226,12,0
0,0,26,26,22,59,81,170,124,294,0.000333,0.621305,22,41006.14982,2278.119434,1863.915901,445.183436,12,0
0,0,26,26,23,58,81,171,125,296,0.000333,0.625532,22,41285.10322,2293.616845,1876.595601,443.804823,12,0
0,0,24,24,20,42,62,144,105,249,0.000333,0.494198,20,29651.89763,1647.327646,1482.594881,312.915894,12,0
0,0,25,25,20,47,67,151,112,263,0.000333,0.531794,20,31907.62914,1772.646063,1595.381457,347.504238,12,0
0,0,27,27,20,52,72,161,120,281,0.000333,0.577916,20,34674.97851,1926.387695,1733.748925,382.861427,13,0
0,0,27,27,20,51,71,161,120,281,0.000333,0.576026,20,34561.57881,1920.087712,1728.078941,375.732254,13,0
0,0,27,27,22,45,67,147,116,263,0.000333,0.531794,22,35098.39206,1949.91067,1595.381457,345.240885,13,0
0,0,41,41,24,63,87,253,190,443,0.000333,0.951408,36,102752.0629,5708.447937,2854.223969,486.607735,20,0
0,0,29,29,22,48,70,156,122,278,0.000333,0.56798,22,37486.69493,2082.594163,1703.940679,366.185696,13,0
0,0,32,32,22,45,67,176,134,310,0.000333,0.626829,22,41370.72828,2298.373793,1880.487649,345.240885,16,0
0,0,33,33,23,47,70,182,138,320,0.000333,0.65379,22,43150.15244,2397.230691,1961.370565,365.107601,17,0
0,0,51,51,26,92,118,359,271,630,0.000333,1.445355,26,112737.6931,6263.205175,4336.065121,722.379133,11,0
0,0,75,75,27,80,107,380,285,665,0.000333,1.494359,39,174839.9463,9713.33035,4483.075546,634.13621,28,0
0,0,12,12,18,30,48,94,61,155,0.000333,0.288556,18,15582.04538,865.669188,865.669188,222.265368,6,0
0,0,12,12,17,29,46,93,63,156,0.000333,0.287225,16,13786.81064,765.933925,861.675665,210.368317,6,0
0,0,14,14,17,31,48,110,75,185,0.000333,0.344406,16,16531.489,918.416056,1033.218063,223.066954,7,0
0,0,50,50,26,91,117,354,268,622,0.000333,1.424456,26,111107.5382,6172.641014,4273.366856,714.420745,10,0
0,0,50,50,26,68,94,372,251,623,0.000333,1.36117,39,159256.8453,8847.602518,4083.508855,536.158906,27,0
0,0,33,33,22,47,69,266,176,442,0.000333,0.899989,33,89098.93773,4949.940985,2699.96781,359.173172,19,0
0,0,35,35,22,65,87,292,204,496,0.000333,1.065233,33,105458.0991,5858.783286,3195.699974,489.561403,14,0
0,0,26,26,18,43,61,198,135,333,0.000333,0.658312,27,53323.2594,2962.4033,1974.935533,308.388034,13,0
0,0,23,23,18,41,59,179,123,302,0.000333,0.592186,27,47967.07142,2664.837301,1776.558201,294.718282,12,0
0,0,74,74,27,80,107,371,279,650,0.000333,1.460651,39,170896.1881,9494.232673,4381.953541,634.13621,28,0
0,0,72,72,26,76,102,355,266,621,0.000333,1.381192,39,161599.4694,8977.748298,4143.576137,597.053924,28,0
0,0,72,72,26,76,102,350,266,616,0.000333,1.370071,39,160298.3464,8905.46369,4110.214011,597.053924,27,0
0,0,70,70,26,75,101,339,256,595,0.000333,1.320545,39,154503.7975,8583.544303,3961.635832,589.372834,27,0
0,0,73,73,27,80,107,367,275,642,0.000333,1.442674,39,168792.8504,9377.380578,4328.021805,634.13621,27,0
0,0,32,32,20,45,65,168,132,300,0.000333,0.602237,20,36134.20688,2007.455938,1806.710344,333.571951,15,0
0,0,35,35,23,48,71,188,145,333,0.000333,0.682622,33,67579.5711,3754.420616,2047.865791,372.120125,17,0
0,0,34,34,22,46,68,182,141,323,0.000333,0.655417,33,64886.26643,3604.792579,1966.250498,352.191346,16,0
0,0,70,70,30,80,110,346,261,607,0.000333,1.372095,45,185232.8406,10290.71337,4116.285346,652.960965,29,0
0,0,33,33,24,47,71,176,137,313,0.000333,0.641624,24,46196.90036,2566.494465,1924.870848,371.104776,17,0
0,0,68,68,29,78,107,343,256,599,0.000333,1.346046,42,169601.8264,9422.323691,4038.138725,631.142822,27,0
0,0,67,67,29,75,104,332,248,580,0.000333,1.295418,42,163222.7115,9067.928419,3886.255037,608.042851,27,0
0,0,37,37,27,52,79,232,162,394,0.000333,0.827897,39,96863.89498,5381.327499,2483.689615,424.804828,21,0
0,0,70,70,29,80,109,356,264,620,0.000333,1.398758,42,176243.5198,9791.306657,4196.274281,646.635696,29,0
0,0,14,14,16,28,44,80,58,138,0.000333,0.251134,16,12054.42501,669.690279,753.401563,198.605938,8,0
0,0,15,15,16,29,45,84,61,145,0.000333,0.26544,16,12741.09918,707.838844,796.318699,204.881449,8,0
0,0,22,22,20,39,59,129,96,225,0.000333,0.441198,20,26471.89372,1470.660762,1323.594686,292.569248,12,0
0,0,23,23,21,41,62,135,100,235,0.000333,0.466412,20,27984.72266,1554.706814,1399.236133,311.898298,13,0
0,0,26,26,23,44,67,154,116,270,0.000333,0.545948,22,36032.56979,2001.809433,1637.844081,344.256916,15,0
0,0,23,23,20,41,61,141,101,242,0.000333,0.478413,20,28704.76871,1594.709373,1435.238436,306.098194,12,0
0,0,24,24,20,46,66,148,108,256,0.000333,0.515788,20,30947.29789,1719.294327,1547.364895,340.522412,12,0
0,0,26,26,22,57,79,170,124,294,0.000333,0.617771,22,40772.85388,2265.158549,1853.31154,430.582226,12,0
0,0,26,26,22,59,81,170,124,294,0.000333,0.621305,22,41006.14982,2278.119434,1863.915901,445.183436,12,0
0,0,26,26,23,58,81,171,125,296,0.000333,0.625532,22,41285.10322,2293.616845,1876.595601,443.804823,12,0
0,0,24,24,20,42,62,144,105,249,0.000333,0.494198,20,29651.89763,1647.327646,1482.594881,312.915894,12,0
0,0,25,25,20,47,67,151,112,263,0.000333,0.531794,20,31907.62914,1772.646063,1595.381457,347.504238,12,0
0,0,27,27,20,52,72,161,120,281,0.000333,0.577916,20,34674.97851,1926.387695,1733.748925,382.861427,13,0
0,0,27,27,20,51,71,161,120,281,0.000333,0.576026,20,34561.57881,1920.087712,1728.078941,375.732254,13,0
0,0,27,27,22,45,67,147,116,263,0.000333,0.531794,22,35098.39206,1949.91067,1595.381457,345.240885,13,0
0,0,41,41,24,63,87,253,190,443,0.000333,0.951408,36,102752.0629,5708.447937,2854.223969,486.607735,20,0
0,0,29,29,22,48,70,156,122,278,0.000333,0.56798,22,37486.69493,2082.594163,1703.940679,366.185696,13,0
0,0,32,32,22,45,67,176,134,310,0.000333,0.626829,22,41370.72828,2298.373793,1880.487649,345.240885,16,0
0,0,33,33,23,47,70,182,138,320,0.000333,0.65379,22,43150.15244,2397.230691,1961.370565,365.107601,17,0
0,0,51,51,26,92,118,359,271,630,0.000333,1.445355,26,112737.6931,6263.205175,4336.065121,722.379133,11,0
0,0,75,75,27,80,107,380,285,665,0.000333,1.494359,39,174839.9463,9713.33035,4483.075546,634.13621,28,0
0,0,12,12,18,30,48,94,61,155,0.000333,0.288556,18,15582.04538,865.669188,865.669188,222.265368,6,0
0,0,12,12,17,29,46,93,63,156,0.000333,0.287225,16,13786.81064,765.933925,861.675665,210.368317,6,0
0,0,14,14,17,31,48,110,75,185,0.000333,0.344406,16,16531.489,918.416056,1033.218063,223.066954,7,0
0,0,50,50,26,91,117,354,268,622,0.000333,1.424456,26,111107.5382,6172.641014,4273.366856,714.420745,10,0
0,0,50,50,26,68,94,372,251,623,0.000333,1.36117,39,159256.8453,8847.602518,4083.508855,536.158906,27,0
0,0,33,33,22,47,69,266,176,442,0.000333,0.899989,33,89098.93773,4949.940985,2699.96781,359.173172,19,0
0,0,33,33,19,55,74,252,178,430,0.000333,0.890022,27,72091.75358,4005.097421,2670.064947,398.685407,15,0
0,0,26,26,18,43,61,198,135,333,0.000333,0.658312,27,53323.2594,2962.4033,1974.935533,308.388034,13,0
0,0,23,23,18,41,59,179,123,302,0.000333,0.592186,27,47967.07142,2664.837301,1776.558201,294.718282,12,0
0,0,74,74,27,80,107,371,279,650,0.000333,1.460651,39,170896.1881,9494.232673,4381.953541,634.13621,28,0
0,0,72,72,26,76,102,355,266,621,0.000333,1.381192,39,161599.4694,8977.748298,4143.576137,597.053924,28,0
0,0,72,72,26,76,102,350,266,616,0.000333,1.370071,39,160298.3464,8905.46369,4110.214011,597.053924,27,0
0,0,70,70,26,75,101,339,256,595,0.000333,1.320545,39,154503.7975,8583.544303,3961.635832,589.372834,27,0
0,0,73,73,27,80,107,367,275,642,0.000333,1.442674,39,168792.8504,9377.380578,4328.021805,634.13621,27,0
0,0,32,32,20,45,65,168,132,300,0.000333,0.602237,20,36134.20688,2007.455938,1806.710344,333.571951,15,0
0,0,35,35,23,48,71,188,145,333,0.000333,0.682622,33,67579.5711,3754.420616,2047.865791,372.120125,17,0
0,0,34,34,22,46,68,182,141,323,0.000333,0.655417,33,64886.26643,3604.792579,1966.250498,352.191346,16,0
0,0,70,70,30,80,110,346,261,607,0.000333,1.372095,45,185232.8406,10290.71337,4116.285346,652.960965,29,0
0,0,33,33,24,47,71,176,137,313,0.000333,0.641624,24,46196.90036,2566.494465,1924.870848,371.104776,17,0
0,0,68,68,29,78,107,343,256,599,0.000333,1.346046,42,169601.8264,9422.323691,4038.138725,631.142822,27,0
0,0,67,67,29,75,104,332,248,580,0.000333,1.295418,42,163222.7115,9067.928419,3886.255037,608.042851,27,0
0,0,37,37,27,52,79,232,162,394,0.000333,0.827897,39,96863.89498,5381.327499,2483.689615,424.804828,21,0
0,0,70,70,29,80,109,356,264,620,0.000333,1.398758,42,176243.5198,9791.306657,4196.274281,646.635696,29,0
0,0,14,14,16,28,44,80,58,138,0.000333,0.251134,16,12054.42501,669.690279,753.401563,198.605938,8,0
0,0,15,15,16,29,45,84,61,145,0.000333,0.26544,16,12741.09918,707.838844,796.318699,204.881449,8,0
0,0,22,22,20,39,59,129,96,225,0.000333,0.441198,20,26471.89372,1470.660762,1323.594686,292.569248,12,0
0,0,23,23,21,41,62,135,100,235,0.000333,0.466412,20,27984.72266,1554.706814,1399.236133,311.898298,13,0
0,0,26,26,23,44,67,154,116,270,0.000333,0.545948,22,36032.56979,2001.809433,1637.844081,344.256916,15,0
0,0,23,23,20,41,61,141,101,242,0.000333,0.478413,20,28704.76871,1594.709373,1435.238436,306.098194,12,0
0,0,24,24,20,46,66,148,108,256,0.000333,0.515788,20,30947.29789,1719.294327,1547.364895,340.522412,12,0
0,0,26,26,22,57,79,170,124,294,0.000333,0.617771,22,40772.85388,2265.158549,1853.31154,430.582226,12,0
0,0,26,26,22,59,81,170,124,294,0.000333,0.621305,22,41006.14982,2278.119434,1863.915901,445.183436,12,0
0,0,26,26,23,58,81,171,125,296,0.000333,0.625532,22,41285.10322,2293.616845,1876.595601,443.804823,12,0
0,0,24,24,20,42,62,144,105,249,0.000333,0.494198,20,29651.89763,1647.327646,1482.594881,312.915894,12,0
0,0,25,25,20,47,67,151,112,263,0.000333,0.531794,20,31907.62914,1772.646063,1595.381457,347.504238,12,0
0,0,27,27,20,52,72,161,120,281,0.000333,0.577916,20,34674.97851,1926.387695,1733.748925,382.861427,13,0
0,0,27,27,20,51,71,161,120,281,0.000333,0.576026,20,34561.57881,1920.087712,1728.078941,375.732254,13,0
0,0,27,27,22,45,67,147,116,263,0.000333,0.531794,22,35098.39206,1949.91067,1595.381457,345.240885,13,0
0,0,41,41,24,63,87,253,190,443,0.000333,0.951408,36,102752.0629,5708.447937,2854.223969,486.607735,20,0
0,0,29,29,22,48,70,156,122,278,0.000333,0.56798,22,37486.69493,2082.594163,1703.940679,366.185696,13,0
0,0,32,32,22,45,67,176,134,310,0.000333,0.626829,22,41370.72828,2298.373793,1880.487649,345.240885,16,0
0,0,33,33,23,47,70,182,138,320,0.000333,0.65379,22,43150.15244,2397.230691,1961.370565,365.107601,17,0
0,0,51,51,26,92,118,359,271,630,0.000333,1.445355,26,112737.6931,6263.205175,4336.065121,722.379133,11,0
0,0,75,75,27,80,107,380,285,665,0.000333,1.494359,39,174839.9463,9713.33035,4483.075546,634.13621,28,0
0,0,12,12,18,30,48,94,61,155,0.000333,0.288556,18,15582.04538,865.669188,865.669188,222.265368,6,0
0,0,12,12,17,29,46,93,63,156,0.000333,0.287225,16,13786.81064,765.933925,861.675665,210.368317,6,0
0,0,14,14,17,31,48,110,75,185,0.000333,0.344406,16,16531.489,918.416056,1033.218063,223.066954,7,0
0,0,50,50,26,91,117,354,268,622,0.000333,1.424456,26,111107.5382,6172.641014,4273.366856,714.420745,10,0
0,0,50,50,26,68,94,372,251,623,0.000333,1.36117,39,159256.8453,8847.602518,4083.508855,536.158906,27,0
0,0,35,35,22,65,87,292,204,496,0.000333,1.065233,33,105458.0991,5858.783286,3195.699974,489.561403,14,0
0,0,33,33,19,55,74,252,178,430,0.000333,0.890022,27,72091.75358,4005.097421,2670.064947,398.685407,15,0
0,0,26,26,18,43,61,198,135,333,0.000333,0.658312,27,53323.2594,2962.4033,1974.935533,308.388034,13,0
0,0,23,23,18,41,59,179,123,302,0.000333,0.592186,27,47967.07142,2664.837301,1776.558201,294.718282,12,0
0,0,95,95,30,96,126,537,385,922,0.000333,2.144351,60,385983.1254,21443.50697,6433.052089,779.363118,41,0
0,0,95,95,30,96,126,537,385,922,0.000333,2.144351,60,385983.1254,21443.50697,6433.052089,779.363118,41,0
0,0,95,95,30,96,126,537,385,922,0.000333,2.144351,60,385983.1254,21443.50697,6433.052089,779.363118,41,0
0,0,95,95,30,96,126,537,385,922,0.000333,2.144351,60,385983.1254,21443.50697,6433.052089,779.363118,41,0
0,0,95,95,30,96,126,537,385,922,0.000333,2.144351,60,385983.1254,21443.50697,6433.052089,779.363118,41,0
0,0,95,95,30,96,126,537,385,922,0.000333,2.144351,60,385983.1254,21443.50697,6433.052089,779.363118,41,0
0,0,95,95,30,96,126,537,385,922,0.000333,2.144351,60,385983.1254,21443.50697,6433.052089,779.363118,41,0
0,0,95,95,30,96,126,537,385,922,0.000333,2.144351,60,385983.1254,21443.50697,6433.052089,779.363118,41,0
0,0,65,65,28,81,109,360,267,627,0.000333,1.414551,42,178233.366,9901.853667,4243.651572,648.133788,31,0
0,0,27,27,22,48,70,182,137,319,0.000333,0.651747,22,43015.30821,2389.739345,1955.241282,366.185696,18,0
0,0,23,23,19,42,61,146,111,257,0.000333,0.508066,18,27435.59092,1524.199496,1524.199496,307.187955,11,0
0,0,27,27,22,48,70,182,137,319,0.000333,0.651747,22,43015.30821,2389.739345,1955.241282,366.185696,18,0
0,0,23,23,22,46,68,148,112,260,0.000333,0.52758,22,34820.28745,1934.460414,1582.740339,352.191346,14,0
0,0,19,19,19,39,58,116,90,206,0.000333,0.402248,18,21721.39353,1206.744085,1206.744085,286.841309,9,0
0,0,20,20,18,38,56,138,106,244,0.000333,0.472332,18,25505.90282,1416.994601,1416.994601,274.479896,15,0
0,0,74,74,27,80,107,371,279,650,0.000333,1.460651,39,170896.1881,9494.232673,4381.953541,634.13621,28,0
0,0,72,72,26,76,102,355,266,621,0.000333,1.381192,39,161599.4694,8977.748298,4143.576137,597.053924,28,0
0,0,72,72,26,76,102,350,266,616,0.000333,1.370071,39,160298.3464,8905.46369,4110.214011,597.053924,27,0
0,0,70,70,26,75,101,339,256,595,0.000333,1.320545,39,154503.7975,8583.544303,3961.635832,589.372834,27,0
0,0,73,73,27,80,107,367,275,642,0.000333,1.442674,39,168792.8504,9377.380578,4328.021805,634.13621,27,0
0,0,32,32,20,45,65,168,132,300,0.000333,0.602237,20,36134.20688,2007.455938,1806.710344,333.571951,15,0
0,0,35,35,23,48,71,188,145,333,0.000333,0.682622,33,67579.5711,3754.420616,2047.865791,372.120125,17,0
0,0,34,34,22,46,68,182,141,323,0.000333,0.655417,33,64886.26643,3604.792579,1966.250498,352.191346,16,0
0,0,70,70,30,80,110,346,261,607,0.000333,1.372095,45,185232.8406,10290.71337,4116.285346,652.960965,29,0
0,0,33,33,24,47,71,176,137,313,0.000333,0.641624,24,46196.90036,2566.494465,1924.870848,371.104776,17,0
0,0,68,68,29,78,107,343,256,599,0.000333,1.346046,42,169601.8264,9422.323691,4038.138725,631.142822,27,0
0,0,67,67,29,75,104,332,248,580,0.000333,1.295418,42,163222.7115,9067.928419,3886.255037,608.042851,27,0
0,0,37,37,27,52,79,232,162,394,0.000333,0.827897,39,96863.89498,5381.327499,2483.689615,424.804828,21,0
0,0,70,70,29,80,109,356,264,620,0.000333,1.398758,42,176243.5198,9791.306657,4196.274281,646.635696,29,0
0,0,14,14,16,28,44,80,58,138,0.000333,0.251134,16,12054.42501,669.690279,753.401563,198.605938,8,0
0,0,15,15,16,29,45,84,61,145,0.000333,0.26544,16,12741.09918,707.838844,796.318699,204.881449,8,0
0,0,22,22,20,39,59,129,96,225,0.000333,0.441198,20,26471.89372,1470.660762,1323.594686,292.569248,12,0
0,0,23,23,21,41,62,135,100,235,0.000333,0.466412,20,27984.72266,1554.706814,1399.236133,311.898298,13,0
0,0,26,26,23,44,67,154,116,270,0.000333,0.545948,22,36032.56979,2001.809433,1637.844081,344.256916,15,0
0,0,23,23,20,41,61,141,101,242,0.000333,0.478413,20,28704.76871,1594.709373,1435.238436,306.098194,12,0
0,0,24,24,20,46,66,148,108,256,0.000333,0.515788,20,30947.29789,1719.294327,1547.364895,340.522412,12,0
0,0,26,26,22,57,79,170,124,294,0.000333,0.617771,22,40772.85388,2265.158549,1853.31154,430.582226,12,0
0,0,26,26,22,59,81,170,124,294,0.000333,0.621305,22,41006.14982,2278.119434,1863.915901,445.183436,12,0
0,0,26,26,23,58,81,171,125,296,0.000333,0.625532,22,41285.10322,2293.616845,1876.595601,443.804823,12,0
0,0,24,24,20,42,62,144,105,249,0.000333,0.494198,20,29651.89763,1647.327646,1482.594881,312.915894,12,0
0,0,25,25,20,47,67,151,112,263,0.000333,0.531794,20,31907.62914,1772.646063,1595.381457,347.504238,12,0
0,0,27,27,20,52,72,161,120,281,0.000333,0.577916,20,34674.97851,1926.387695,1733.748925,382.861427,13,0
0,0,27,27,20,51,71,161,120,281,0.000333,0.576026,20,34561.57881,1920.087712,1728.078941,375.732254,13,0
0,0,27,27,22,45,67,147,116,263,0.000333,0.531794,22,35098.39206,1949.91067,1595.381457,345.240885,13,0
0,0,41,41,24,63,87,253,190,443,0.000333,0.951408,36,102752.0629,5708.447937,2854.223969,486.607735,20,0
0,0,29,29,22,48,70,156,122,278,0.000333,0.56798,22,37486.69493,2082.594163,1703.940679,366.185696,13,0
0,0,32,32,22,45,67,176,134,310,0.000333,0.626829,22,41370.72828,2298.373793,1880.487649,345.240885,16,0
0,0,33,33,23,47,70,182,138,320,0.000333,0.65379,22,43150.15244,2397.230691,1961.370565,365.107601,17,0
0,0,51,51,26,92,118,359,271,630,0.000333,1.445355,26,112737.6931,6263.205175,4336.065121,722.379133,11,0
0,0,75,75,27,80,107,380,285,665,0.000333,1.494359,39,174839.9463,9713.33035,4483.075546,634.13621,28,0
0,0,12,12,18,30,48,94,61,155,0.000333,0.288556,18,15582.04538,865.669188,865.669188,222.265368,6,0
0,0,12,12,17,29,46,93,63,156,0.000333,0.287225,16,13786.81064,765.933925,861.675665,210.368317,6,0
0,0,14,14,17,31,48,110,75,185,0.000333,0.344406,16,16531.489,918.416056,1033.218063,223.066954,7,0
0,0,50,50,26,91,117,354,268,622,0.000333,1.424456,26,111107.5382,6172.641014,4273.366856,714.420745,10,0
0,0,33,33,22,47,69,266,176,442,0.000333,0.899989,33,89098.93773,4949.940985,2699.96781,359.173172,19,0
0,0,35,35,22,65,87,292,204,496,0.000333,1.065233,33,105458.0991,5858.783286,3195.699974,489.561403,14,0
0,0,33,33,19,55,74,252,178,430,0.000333,0.890022,27,72091.75358,4005.097421,2670.064947,398.685407,15,0
0,0,26,26,18,43,61,198,135,333,0.000333,0.658312,27,53323.2594,2962.4033,1974.935533,308.388034,13,0
0,0,23,23,18,41,59,179,123,302,0.000333,0.592186,27,47967.07142,2664.837301,1776.558201,294.718282,12,0
0,0,12,12,19,30,49,79,58,137,0.000333,0.256405,9,6922.937238,384.607624,769.215249,227.917341,6,0
0,0,28,28,23,58,81,182,137,319,0.000333,0.674137,22,44493.06732,2471.837073,2022.412151,443.804823,12,0
0,0,13,13,19,31,50,82,61,143,0.000333,0.269024,9,7263.642916,403.535718,807.071435,234.290708,6,0
0,0,11,11,16,28,44,66,50,116,0.000333,0.211098,8,5066.352542,281.46403,633.294068,198.605938,6,0
0,0,12,12,14,27,41,64,53,117,0.000333,0.208945,7,4387.835092,243.768616,626.833585,181.684931,6,0
0,0,15,15,23,38,61,134,89,223,0.000333,0.440851,22,29096.19738,1616.45541,1322.554426,303.463171,11,0
0,0,3,3,11,15,26,18,19,37,0.000333,0.057972,5,869.581348,48.310075,173.91627,96.657107,2,0
0,0,14,14,13,29,42,84,68,152,0.000333,0.273211,12,9835.586979,546.421499,819.632248,188.987165,3,0
0,0,14,14,13,29,42,84,68,152,0.000333,0.273211,12,9835.586979,546.421499,819.632248,188.987165,3,0
0,0,14,14,13,29,42,84,68,152,0.000333,0.273211,12,9835.586979,546.421499,819.632248,188.987165,3,0
0,0,14,14,13,29,42,84,68,152,0.000333,0.273211,12,9835.586979,546.421499,819.632248,188.987165,3,0
0,0,14,14,13,29,42,84,68,152,0.000333,0.273211,12,9835.586979,546.421499,819.632248,188.987165,3,0
0,0,14,14,13,29,42,84,68,152,0.000333,0.273211,12,9835.586979,546.421499,819.632248,188.987165,3,0
0,0,14,14,13,29,42,84,68,152,0.000333,0.273211,12,9835.586979,546.421499,819.632248,188.987165,3,0
0,0,14,14,13,29,42,84,68,152,0.000333,0.273211,12,9835.586979,546.421499,819.632248,188.987165,3,0
0,0,14,14,13,29,42,84,68,152,0.000333,0.273211,12,9835.586979,546.421499,819.632248,188.987165,3,0
0,0,5,5,10,10,20,18,19,37,0.000333,0.053304,5,799.556698,44.419817,159.91134,66.438562,3,0
0,0,13,13,16,29,45,66,59,125,0.000333,0.228827,16,10983.70619,610.2059,686.481637,204.881449,7,0
0,0,13,13,16,29,45,66,59,125,0.000333,0.228827,16,10983.70619,610.2059,686.481637,204.881449,7,0
0,0,14,14,19,34,53,85,77,162,0.000333,0.309308,18,16702.61605,927.923114,927.923114,253.684359,7,0
0,0,18,18,21,36,57,113,109,222,0.000333,0.431634,30,38847.04749,2158.169305,1294.901583,278.355966,23,0
0,0,18,18,21,37,58,113,109,222,0.000333,0.433491,20,26009.43562,1444.968645,1300.471781,284.98844,23,0
0,0,14,14,19,34,53,85,77,162,0.000333,0.309308,18,16702.61605,927.923114,927.923114,253.684359,7,0
0,0,18,18,21,36,57,113,109,222,0.000333,0.431634,30,38847.04749,2158.169305,1294.901583,278.355966,23,0
0,0,18,18,21,36,57,112,108,220,0.000333,0.427745,30,38497.07409,2138.726339,1283.235803,278.355966,23,0
0,0,13,13,15,26,41,61,55,116,0.000333,0.207159,14,8700.664455,483.370248,621.476033,180.814792,7,0
0,0,14,14,15,28,43,65,58,123,0.000333,0.222477,14,9344.027908,519.112662,667.430565,193.209297,7,0
0,0,13,13,15,26,41,61,55,116,0.000333,0.207159,14,8700.664455,483.370248,621.476033,180.814792,7,0
0,0,13,13,15,25,40,61,55,116,0.000333,0.205781,14,8642.811226,480.156179,617.343659,174.699764,7,0
0,0,12,12,15,25,40,58,53,111,0.000333,0.196911,14,8270.276259,459.459792,590.734019,174.699764,6,0
0,0,13,13,15,27,42,62,56,118,0.000333,0.212098,14,8908.108382,494.89491,636.293456,186.985321,6,0
0,0,12,12,15,25,40,58,53,111,0.000333,0.196911,14,8270.276259,459.459792,590.734019,174.699764,6,0
0,0,12,12,15,24,39,58,53,111,0.000333,0.19556,14,8213.515048,456.306392,586.679646,168.642459,6,0
0,0,9,9,15,18,33,45,41,86,0.000333,0.144606,14,6073.45052,337.413918,433.817894,133.662009,5,0
0,0,28,28,20,41,61,99,87,186,0.000333,0.367706,20,22062.3429,1225.685716,1103.117145,306.098194,9,0
0,0,28,28,20,41,61,99,87,186,0.000333,0.367706,20,22062.3429,1225.685716,1103.117145,306.098194,9,0
0,0,19,19,21,39,60,134,102,236,0.000333,0.464675,20,27880.52361,1548.917978,1394.026181,298.369352,10,0
0,0,19,19,21,39,60,134,102,236,0.000333,0.464675,20,27880.52361,1548.917978,1394.026181,298.369352,10,0
0,0,14,14,20,36,56,91,72,163,0.000333,0.315533,20,18931.97705,1051.776503,946.598852,272.555862,7,0
0,0,16,16,20,39,59,111,83,194,0.000333,0.380411,20,22824.65503,1268.036391,1141.232752,292.569248,7,0
0,0,9,9,18,28,46,51,44,95,0.000333,0.174913,9,4722.645472,262.369193,524.738386,209.664588,5,0
0,0,13,13,19,36,55,91,66,157,0.000333,0.302558,9,8169.061275,453.836738,907.673475,266.827923,5,0
0,0,7,7,13,25,38,51,38,89,0.000333,0.155689,6,2802.393292,155.688516,467.065549,164.202121,3,0
0,0,9,9,14,30,44,67,48,115,0.000333,0.209278,7,4394.842453,244.157914,627.834636,200.509687,3,0
0,0,19,19,21,39,60,134,102,236,0.000333,0.464675,20,27880.52361,1548.917978,1394.026181,298.369352,10,0
0,0,19,19,21,39,60,134,102,236,0.000333,0.464675,20,27880.52361,1548.917978,1394.026181,298.369352,10,0
0,0,14,14,20,36,56,91,72,163,0.000333,0.315533,20,18931.97705,1051.776503,946.598852,272.555862,7,0
0,0,16,16,20,39,59,111,83,194,0.000333,0.380411,20,22824.65503,1268.036391,1141.232752,292.569248,7,0
0,0,9,9,18,28,46,51,44,95,0.000333,0.174913,9,4722.645472,262.369193,524.738386,209.664588,5,0
0,0,13,13,19,36,55,91,66,157,0.000333,0.302558,9,8169.061275,453.836738,907.673475,266.827923,5,0
0,0,5,5,14,23,37,34,29,63,0.000333,0.109399,7,2297.368934,127.631607,328.195562,157.344894,4,0
0,0,9,9,14,30,44,67,48,115,0.000333,0.209278,7,4394.842453,244.157914,627.834636,200.509687,3,0
0,0,19,19,21,39,60,134,102,236,0.000333,0.464675,20,27880.52361,1548.917978,1394.026181,298.369352,10,0
0,0,19,19,21,39,60,134,102,236,0.000333,0.464675,20,27880.52361,1548.917978,1394.026181,298.369352,10,0
0,0,14,14,20,36,56,91,72,163,0.000333,0.315533,20,18931.97705,1051.776503,946.598852,272.555862,7,0
0,0,16,16,20,39,59,111,83,194,0.000333,0.380411,20,22824.65503,1268.036391,1141.232752,292.569248,7,0
0,0,9,9,18,28,46,51,44,95,0.000333,0.174913,9,4722.645472,262.369193,524.738386,209.664588,5,0
0,0,13,13,19,36,55,91,66,157,0.000333,0.302558,9,8169.061275,453.836738,907.673475,266.827923,5,0
0,0,5,5,14,23,37,34,29,63,0.000333,0.109399,7,2297.368934,127.631607,328.195562,157.344894,4,0
0,0,7,7,13,25,38,51,38,89,0.000333,0.155689,6,2802.393292,155.688516,467.065549,164.202121,3,0
0,0,6,6,17,21,38,37,32,69,0.000333,0.120702,8,2896.855987,160.936444,362.106998,161.725534,3,0
0,0,6,6,15,21,36,35,32,67,0.000333,0.115462,7,2424.694826,134.705268,346.384975,150.842025,3,0
0,0,31,31,22,65,87,144,121,265,0.000333,0.569127,11,18781.18029,1043.398905,1707.380026,489.561403,17,0
0,0,11,11,15,25,40,61,48,109,0.000333,0.193363,7,4060.631136,225.590619,580.090162,174.699764,6,0
0,0,12,12,14,25,39,63,51,114,0.000333,0.200845,14,8435.501941,468.638997,602.535853,169.399374,6,0
0,0,12,12,16,28,44,65,57,122,0.000333,0.222017,16,10656.81052,592.045029,666.050657,198.605938,3,0
0,0,18,18,16,23,39,73,59,132,0.000333,0.232558,16,11162.76949,620.15386,697.673093,168.041925,6,0
0,0,3,3,11,13,24,17,17,34,0.000333,0.051963,5,779.443625,43.302424,155.888725,86.159464,2,0
0,0,10,10,14,21,35,48,32,80,0.000333,0.136781,7,2872.398489,159.577694,410.342641,145.541635,5,0
0,0,15,15,18,27,45,80,59,139,0.000333,0.254456,18,13740.61645,763.36758,763.36758,203.440613,5,0
0,0,11,11,15,21,36,52,37,89,0.000333,0.153374,7,3220.863276,178.936849,460.123325,150.842025,5,0
0,0,77,77,32,83,115,357,267,624,0.000333,1.423862,48,205036.118,11390.89545,4271.585792,689.128273,36,0
0,0,63,63,28,78,106,276,214,490,0.000333,1.098894,28,92307.06864,5128.17048,3296.681023,624.867311,31,0
0,0,51,51,29,72,101,235,178,413,0.000333,0.916614,28,76995.55759,4277.530977,2749.841342,585.116049,25,0
0,0,50,50,27,68,95,220,170,390,0.000333,0.854081,26,66618.33587,3701.018659,2562.243687,542.329436,25,0
0,0,50,50,28,69,97,234,174,408,0.000333,0.897588,28,75397.40431,4188.744684,2692.76444,556.094125,25,0
0,0,77,77,32,83,115,357,267,624,0.000333,1.423862,48,205036.118,11390.89545,4271.585792,689.128273,36,0
0,0,63,63,28,78,106,276,214,490,0.000333,1.098894,28,92307.06864,5128.17048,3296.681023,624.867311,31,0
0,0,51,51,29,72,101,235,178,413,0.000333,0.916614,28,76995.55759,4277.530977,2749.841342,585.116049,25,0
0,0,50,50,27,68,95,220,170,390,0.000333,0.854081,26,66618.33587,3701.018659,2562.243687,542.329436,25,0
0,0,62,62,29,79,108,280,212,492,0.000333,1.107802,28,93055.33023,5169.740568,3323.404651,638.880128,31,0
0,0,22,22,22,38,60,102,74,176,0.000333,0.346538,11,11435.74019,635.3189,1039.612745,297.528741,12,0
0,0,23,23,22,39,61,104,76,180,0.000333,0.355844,11,11742.85993,652.381107,1067.532721,304.238182,12,0
0,0,22,22,22,38,60,102,74,176,0.000333,0.346538,11,11435.74019,635.3189,1039.612745,297.528741,12,0
0,0,65,65,29,56,85,355,213,568,0.000333,1.213511,42,152902.4302,8494.579454,3640.534052,466.093324,37,0
0,0,64,64,28,47,75,281,170,451,0.000333,0.936399,42,117986.2836,6554.793535,2809.197229,395.671614,25,0
0,0,37,37,27,50,77,170,139,309,0.000333,0.645479,26,50347.36307,2797.075726,1936.437041,410.574772,20,0
0,0,38,38,26,46,72,170,139,309,0.000333,0.635502,39,74353.76619,4130.764788,1906.506825,376.295283,20,0
0,0,44,44,28,51,79,205,167,372,0.000333,0.781669,42,98490.27041,5471.681689,2345.006438,423.89963,21,0
0,0,41,41,29,52,81,194,155,349,0.000333,0.737536,28,61953.01423,3441.834124,2212.607651,437.304314,21,0
0,0,35,35,26,41,67,157,127,284,0.000333,0.574256,39,67188.00387,3732.666882,1722.76933,341.871065,20,0
0,0,59,59,26,43,69,234,175,409,0.000333,0.832796,52,129916.0981,7217.561008,2498.386503,355.540817,23,0
0,0,52,52,25,43,68,211,159,370,0.000333,0.750787,36,81085.00505,4504.722503,2252.361251,349.425789,21,0
0,0,57,57,26,43,69,230,171,401,0.000333,0.816506,39,95531.21398,5307.289666,2449.518307,355.540817,23,0
0,0,57,57,26,43,69,230,171,401,0.000333,0.816506,39,95531.21398,5307.289666,2449.518307,355.540817,23,0
0,0,59,59,26,43,69,234,175,409,0.000333,0.832796,52,129916.0981,7217.561008,2498.386503,355.540817,23,0
0,0,57,57,26,43,69,230,171,401,0.000333,0.816506,39,95531.21398,5307.289666,2449.518307,355.540817,23,0
0,0,57,57,26,43,69,230,171,401,0.000333,0.816506,39,95531.21398,5307.289666,2449.518307,355.540817,23,0
0,0,57,57,26,43,69,230,171,401,0.000333,0.816506,39,95531.21398,5307.289666,2449.518307,355.540817,23,0
0,0,57,57,26,43,69,230,171,401,0.000333,0.816506,39,95531.21398,5307.289666,2449.518307,355.540817,23,0
0,0,103,103,31,66,97,420,313,733,0.000333,1.612579,60,290264.1668,16125.78704,4837.736113,552.510097,30,0
0,0,72,72,30,53,83,282,213,495,0.000333,1.051882,60,189338.6711,10518.81506,3155.644519,450.786502,25,0
0,0,103,103,31,66,97,420,313,733,0.000333,1.612579,60,290264.1668,16125.78704,4837.736113,552.510097,30,0
0,0,103,103,31,66,97,420,313,733,0.000333,1.612579,60,290264.1668,16125.78704,4837.736113,552.510097,30,0
0,0,72,72,30,53,83,282,213,495,0.000333,1.051882,60,189338.6711,10518.81506,3155.644519,450.786502,25,0
0,0,103,103,31,66,97,420,313,733,0.000333,1.612579,60,290264.1668,16125.78704,4837.736113,552.510097,30,0
0,0,77,77,29,60,89,347,249,596,0.000333,1.286512,56,216134.079,12007.44883,3859.537125,495.294885,24,0
1,0,9,10,21,28,49,71,57,128,0.000333,0.239561,20,14373.6572,798.536511,718.68286,226.844604,4,0
1,0,9,10,21,28,49,71,57,128,0.000333,0.239561,20,14373.6572,798.536511,718.68286,226.844604,4,0
1,0,13,14,21,30,51,90,70,160,0.000333,0.302529,20,18151.76109,1008.431172,907.588055,239.445384,6,0
1,0,9,10,21,28,49,71,57,128,0.000333,0.239561,20,14373.6572,798.536511,718.68286,226.844604,4,0
1,0,3,4,13,12,25,23,17,40,0.000333,0.061918,6,1114.525486,61.918083,185.754248,91.125266,2,0
0,0,12,12,19,29,48,76,52,128,0.000333,0.238292,9,6433.876801,357.4376,714.8752,221.592072,4,0
0,0,13,13,19,30,49,79,54,133,0.000333,0.248919,9,6720.807683,373.378205,746.756409,227.917341,4,0
0,0,18,18,21,40,61,108,76,184,0.000333,0.363752,10,10912.5567,606.25315,1091.25567,305.11579,7,0
0,0,25,25,21,46,67,133,96,229,0.000333,0.463045,20,27782.68849,1543.482694,1389.134425,346.322516,9,0
0,0,12,12,19,29,48,76,52,128,0.000333,0.238292,9,6433.876801,357.4376,714.8752,221.592072,4,0
0,0,20,20,22,53,75,142,98,240,0.000333,0.498305,11,16444.08134,913.560075,1494.916486,401.68728,7,0
0,0,51,51,23,75,98,294,199,493,0.000333,1.087017,22,71743.14297,3985.730165,3261.051953,571.203327,14,0
0,0,29,29,22,64,86,180,127,307,0.000333,0.657621,11,21701.49608,1205.638671,1972.86328,482.107496,11,0
0,0,53,53,23,74,97,309,209,518,0.000333,1.139585,22,75212.60675,4178.478153,3418.754852,563.541474,16,0
0,0,19,19,22,52,74,139,96,235,0.000333,0.486407,11,16051.43695,891.746497,1459.221541,394.530361,7,0
0,0,50,50,23,74,97,291,197,488,0.000333,1.073586,22,70856.66427,3936.481349,3220.757467,563.541474,14,0
0,0,27,27,24,63,87,185,130,315,0.000333,0.676509,24,48708.65283,2706.036268,2029.527201,486.607735,8,0
0,0,58,58,24,84,108,337,231,568,0.000333,1.278925,24,92082.62643,5115.701468,3836.776101,646.993764,15,0
0,0,46,46,28,95,123,267,198,465,0.000333,1.07609,28,90391.53886,5021.752159,3228.269245,758.742221,11,0
0,0,77,77,28,112,140,419,299,718,0.000333,1.706275,28,143327.1058,7962.616987,5118.825206,897.029689,18,0
0,0,50,50,27,92,119,299,228,527,0.000333,1.21119,26,94472.79299,5248.4885,3633.568961,728.549663,10,0
0,0,81,81,27,109,136,451,329,780,0.000333,1.84274,39,215600.6196,11977.8122,5528.221016,866.114054,17,0
0,0,50,50,27,92,119,299,228,527,0.000333,1.21119,26,94472.79299,5248.4885,3633.568961,728.549663,10,0
0,0,81,81,27,109,136,451,329,780,0.000333,1.84274,39,215600.6196,11977.8122,5528.221016,866.114054,17,0
0,0,50,50,27,92,119,299,228,527,0.000333,1.21119,26,94472.79299,5248.4885,3633.568961,728.549663,10,0
0,0,81,81,27,109,136,451,329,780,0.000333,1.84274,39,215600.6196,11977.8122,5528.221016,866.114054,17,0
0,0,50,50,27,92,119,299,228,527,0.000333,1.21119,26,94472.79299,5248.4885,3633.568961,728.549663,10,0
0,0,81,81,27,109,136,451,329,780,0.000333,1.84274,39,215600.6196,11977.8122,5528.221016,866.114054,17,0
0,0,50,50,27,92,119,299,228,527,0.000333,1.21119,26,94472.79299,5248.4885,3633.568961,728.549663,10,0
0,0,81,81,27,109,136,451,329,780,0.000333,1.84274,39,215600.6196,11977.8122,5528.221016,866.114054,17,0
0,0,50,50,27,92,119,299,228,527,0.000333,1.21119,26,94472.79299,5248.4885,3633.568961,728.549663,10,0
0,0,81,81,27,109,136,451,329,780,0.000333,1.84274,39,215600.6196,11977.8122,5528.221016,866.114054,17,0
0,0,50,50,27,92,119,299,228,527,0.000333,1.21119,26,94472.79299,5248.4885,3633.568961,728.549663,10,0
0,0,81,81,27,109,136,451,329,780,0.000333,1.84274,39,215600.6196,11977.8122,5528.221016,866.114054,17,0
0,0,50,50,27,92,119,299,228,527,0.000333,1.21119,26,94472.79299,5248.4885,3633.568961,728.549663,10,0
0,0,81,81,27,109,136,451,329,780,0.000333,1.84274,39,215600.6196,11977.8122,5528.221016,866.114054,17,0
0,0,28,28,26,64,90,189,128,317,0.000333,0.685972,26,53505.85322,2972.547401,2057.917432,506.211433,10,0
0,0,59,59,26,81,107,341,229,570,0.000333,1.280879,26,99908.54074,5550.474485,3842.636182,635.739283,17,0
0,0,36,36,26,74,100,245,176,421,0.000333,0.932354,26,72723.64985,4040.20277,2797.063456,581.710982,10,0
0,0,67,67,26,91,117,397,277,674,0.000333,1.543542,39,180594.407,10033.02261,4630.625821,714.420745,17,0
1,0,81,82,28,72,100,375,262,637,0.000333,1.410712,42,177749.7285,9874.984917,4232.136393,578.840538,35,0
1,0,65,66,24,50,74,277,199,476,0.000333,0.985233,36,106405.1929,5911.399604,2955.699802,392.23191,26,0
1,0,68,69,28,75,103,347,251,598,0.000333,1.332842,42,167938.1472,9329.897069,3998.527315,601.76734,34,0
1,0,91,92,28,75,103,397,284,681,0.000333,1.517836,42,191247.2881,10624.84934,4553.506859,601.76734,35,0
4,0,120,124,28,55,83,453,326,779,0.000333,1.655385,70,347630.9002,19312.82779,4966.155717,452.580722,35,0
4,0,120,124,28,55,83,452,326,778,0.000333,1.65326,70,347184.6474,19288.03597,4959.780678,452.580722,35,0
4,0,118,122,28,55,83,445,321,766,0.000333,1.62776,70,341829.6143,18990.53413,4883.280204,452.580722,35,0
4,0,121,125,28,55,83,457,329,786,0.000333,1.67026,70,350754.6695,19486.37053,5010.780993,452.580722,35,0
4,0,121,125,28,55,83,457,329,786,0.000333,1.67026,70,350754.6695,19486.37053,5010.780993,452.580722,35,0
4,0,120,124,28,55,83,455,327,782,0.000333,1.66176,70,348969.6585,19387.20325,4985.280835,452.580722,35,0
4,0,106,110,27,51,78,415,295,710,0.000333,1.487545,65,290071.3124,16115.07291,4462.635575,417.675655,33,0
0,0,5,5,10,12,22,15,15,30,0.000333,0.044594,5,668.914743,37.16193,133.782949,76.238831,2,0
0,0,5,5,10,12,22,15,15,30,0.000333,0.044594,5,668.914743,37.16193,133.782949,76.238831,2,0
0,0,5,5,10,12,22,15,15,30,0.000333,0.044594,5,668.914743,37.16193,133.782949,76.238831,2,0
0,0,5,5,9,13,22,16,18,34,0.000333,0.05054,4,606.4827,33.693483,151.620675,76.635041,2,0
0,0,5,5,9,13,22,16,18,34,0.000333,0.05054,4,606.4827,33.693483,151.620675,76.635041,2,0
0,0,5,5,9,13,22,16,18,34,0.000333,0.05054,4,606.4827,33.693483,151.620675,76.635041,2,0
1,0,9,10,21,23,44,68,31,99,0.000333,0.180161,10,5404.837302,300.268739,540.48373,196.280591,9,0
1,0,9,10,21,23,44,68,31,99,0.000333,0.180161,10,5404.837302,300.268739,540.48373,196.280591,9,0
1,0,17,18,21,29,50,96,43,139,0.000333,0.261499,10,7844.960104,435.831117,784.49601,233.120115,13,0
1,0,17,18,21,29,50,96,43,139,0.000333,0.261499,10,7844.960104,435.831117,784.49601,233.120115,13,0
0,0,7,7,12,18,30,45,37,82,0.000333,0.134122,12,4828.380346,268.243353,402.365029,118.0782,1,0
0,0,7,7,12,18,30,45,37,82,0.000333,0.134122,12,4828.380346,268.243353,402.365029,118.0782,1,0
0,0,5,5,18,21,39,37,30,67,0.000333,0.118041,9,3187.097538,177.060974,354.121949,167.297316,3,0
0,0,4,4,14,11,25,22,14,36,0.000333,0.055726,7,1170.25176,65.013987,167.178823,91.356717,3,0
0,0,5,5,18,16,34,39,24,63,0.000333,0.106837,9,2884.591431,160.255079,320.510159,139.05865,3,0
0,0,13,13,13,19,32,51,42,93,0.000333,0.155,12,5580,310,465,128.816339,5,0
0,0,59,59,24,41,65,384,200,584,0.000333,1.172354,48,168819.0145,9378.834141,3517.062803,329.698732,31,0
0,0,58,58,24,41,65,382,197,579,0.000333,1.162317,48,167373.6463,9298.535903,3486.950964,329.698732,31,0
0,0,60,60,24,41,65,388,202,590,0.000333,1.184399,48,170553.4565,9475.192026,3553.19701,329.698732,32,0
0,0,59,59,24,41,65,386,199,585,0.000333,1.174362,48,169108.0882,9394.893788,3523.085171,329.698732,32,0
0,0,6,6,11,11,22,21,19,40,0.000333,0.059459,5,891.886324,49.54924,178.377265,76.107496,3,0
0,0,13,13,16,22,38,58,46,104,0.000333,0.181928,16,8732.551382,485.141743,545.784461,162.107496,7,0
0,0,17,17,23,37,60,109,70,179,0.000333,0.352444,11,11630.66758,646.148199,1057.333417,296.7917,10,0
0,0,16,16,12,20,32,57,50,107,0.000333,0.178333,12,6420,356.666667,535,129.458112,5,0
0,0,16,16,13,23,36,58,51,109,0.000333,0.187841,12,6762.261902,375.681217,563.521825,152.147641,5,0
0,0,18,18,15,26,41,75,65,140,0.000333,0.250019,14,10500.80193,583.377885,750.057281,180.814792,5,0
0,0,18,18,15,28,43,76,66,142,0.000333,0.256843,14,10787.41433,599.300796,770.529595,193.209297,5,0
0,0,25,25,19,43,62,140,99,239,0.000333,0.474351,18,25614.95253,1423.052918,1423.052918,314.040007,7,0
0,0,25,25,19,43,62,140,99,239,0.000333,0.474351,18,25614.95253,1423.052918,1423.052918,314.040007,7,0
0,0,32,32,25,50,75,173,128,301,0.000333,0.624958,24,44996.98622,2499.832568,1874.874426,398.289214,12,0
0,0,31,31,25,49,74,170,125,295,0.000333,0.610596,24,43962.92983,2442.38499,1831.788743,391.217187,12,0
0,0,31,31,25,49,74,170,125,295,0.000333,0.610596,24,43962.92983,2442.38499,1831.788743,391.217187,12,0
0,0,28,28,23,41,64,131,101,232,0.000333,0.464,22,30624,1701.333333,1392,323.701557,7,0
0,0,30,30,24,42,66,140,108,248,0.000333,0.49967,24,35976.2338,1998.679655,1499.009742,336.516432,8,0
0,0,75,75,25,63,88,355,225,580,0.000333,1.248823,36,134872.9322,7492.940678,3746.470339,492.66504,32,0
0,0,74,74,25,63,88,346,222,568,0.000333,1.222986,36,132082.4577,7337.914319,3668.957159,492.66504,31,0
0,0,79,79,25,63,88,389,236,625,0.000333,1.345715,36,145337.2114,8074.289523,4037.144762,492.66504,36,0
0,0,3,3,7,12,19,12,15,27,0.000333,0.038231,3,344.082129,19.115674,114.694043,62.671034,1,0
0,0,75,75,25,63,88,355,225,580,0.000333,1.248823,36,134872.9322,7492.940678,3746.470339,492.66504,32,0
0,0,74,74,25,63,88,346,222,568,0.000333,1.222986,36,132082.4577,7337.914319,3668.957159,492.66504,31,0
0,0,79,79,25,63,88,389,236,625,0.000333,1.345715,36,145337.2114,8074.289523,4037.144762,492.66504,36,0
0,0,3,3,7,12,19,12,15,27,0.000333,0.038231,3,344.082129,19.115674,114.694043,62.671034,1,0
0,0,75,75,25,63,88,355,225,580,0.000333,1.248823,36,134872.9322,7492.940678,3746.470339,492.66504,32,0
0,0,74,74,25,63,88,346,222,568,0.000333,1.222986,36,132082.4577,7337.914319,3668.957159,492.66504,31,0
0,0,79,79,25,63,88,389,236,625,0.000333,1.345715,36,145337.2114,8074.289523,4037.144762,492.66504,36,0
0,0,3,3,7,12,19,12,15,27,0.000333,0.038231,3,344.082129,19.115674,114.694043,62.671034,1,0
0,0,75,75,25,63,88,355,225,580,0.000333,1.248823,36,134872.9322,7492.940678,3746.470339,492.66504,32,0
0,0,74,74,25,63,88,346,222,568,0.000333,1.222986,36,132082.4577,7337.914319,3668.957159,492.66504,31,0
0,0,79,79,25,63,88,389,236,625,0.000333,1.345715,36,145337.2114,8074.289523,4037.144762,492.66504,36,0
0,0,3,3,7,12,19,12,15,27,0.000333,0.038231,3,344.082129,19.115674,114.694043,62.671034,1,0
0,0,49,49,28,80,108,283,229,512,0.000333,1.152834,28,96838.06723,5379.892624,3458.502401,640.360185,15,0
0,0,69,69,33,111,144,396,319,715,0.000333,1.708832,32,164047.884,9113.771335,5126.496376,920.645167,26,0
0,0,7,7,12,20,32,34,38,72,0.000333,0.12,6,2160,120,360,129.458112,1,0
0,0,23,23,21,53,74,124,103,227,0.000333,0.469849,10,14095.45914,783.081063,1409.545914,395.81845,5,0
0,0,32,32,24,68,92,190,155,345,0.000333,0.75021,24,54015.093,3000.8385,2250.628875,523.986573,10,0
0,0,26,26,20,54,74,145,120,265,0.000333,0.548502,20,32910.10284,1828.339047,1645.505142,397.202487,4,0
0,0,30,30,24,68,92,181,149,330,0.000333,0.717592,24,51666.61069,2870.367261,2152.775445,523.986573,9,0
0,0,24,24,20,54,74,136,114,250,0.000333,0.517454,20,31047.26683,1724.848157,1552.363341,397.202487,3,0
0,0,46,46,27,82,109,247,207,454,0.000333,1.024252,26,79891.64777,4438.424876,3072.755683,649.701227,16,0
0,0,40,40,24,71,95,202,172,374,0.000333,0.819042,24,58971.02394,3276.167997,2457.125998,546.671146,10,0
0,0,34,34,24,74,98,201,167,368,0.000333,0.811404,24,58421.11734,3245.61763,2434.213223,569.538649,12,0
0,0,28,28,21,60,81,156,132,288,0.000333,0.608626,20,36517.53602,2028.752001,1825.876801,446.652102,6,0
0,0,40,40,27,81,108,227,187,414,0.000333,0.932174,26,72709.60907,4039.422726,2796.523426,641.909813,15,0
0,0,29,29,21,61,82,164,137,301,0.000333,0.637874,20,38272.46307,2126.247948,1913.623153,454.013643,7,0
0,0,35,35,24,74,98,206,171,377,0.000333,0.831249,24,59849.89467,3324.994148,2493.745611,569.538649,13,0
0,0,29,29,21,62,83,161,136,297,0.000333,0.631129,20,37867.73422,2103.763012,1893.386711,461.398837,7,0
0,0,39,39,27,78,105,222,182,404,0.000333,0.904185,26,70526.43492,3918.135273,2712.555189,618.643336,14,0
0,0,29,29,21,62,83,164,137,301,0.000333,0.639629,20,38377.73738,2132.096521,1918.886869,461.398837,7,0
0,0,59,59,29,81,110,300,256,556,0.000333,1.256812,42,158358.312,8797.684002,3770.436001,654.409299,19,0
0,0,55,55,29,78,107,278,241,519,0.000333,1.166274,42,146950.4974,8163.916521,3498.821366,631.142822,16,0
0,0,44,44,25,71,96,234,195,429,0.000333,0.94165,24,67798.77391,3766.59855,2824.948913,552.72845,15,0
0,0,75,75,27,89,116,362,304,666,0.000333,1.522472,39,178129.1984,9896.066576,4567.415343,704.722238,37,0
0,0,34,34,24,60,84,175,149,324,0.000333,0.69037,24,49706.66028,2761.481127,2071.110845,464.452536,13,0
0,0,50,50,27,69,96,264,211,475,0.000333,1.042619,39,121986.4303,6777.023907,3127.857188,549.87015,25,0
0,0,50,50,27,69,96,263,210,473,0.000333,1.038229,39,121472.8033,6748.489069,3114.687263,549.87015,25,0
0,0,17,17,27,43,70,163,119,282,0.000333,0.576153,26,44939.90308,2496.661282,1728.457811,361.711347,21,0
0,0,17,17,27,43,70,163,119,282,0.000333,0.576153,26,44939.90308,2496.661282,1728.457811,361.711347,21,0
0,0,17,17,27,43,70,163,119,282,0.000333,0.576153,26,44939.90308,2496.661282,1728.457811,361.711347,21,0
0,0,17,17,27,43,70,163,119,282,0.000333,0.576153,26,44939.90308,2496.661282,1728.457811,361.711347,21,0
0,0,16,16,26,40,66,159,113,272,0.000333,0.548025,26,42745.95521,2374.77529,1644.0752,335.088556,20,0
0,0,16,16,26,40,66,159,113,272,0.000333,0.548025,26,42745.95521,2374.77529,1644.0752,335.088556,20,0
0,0,16,16,26,40,66,159,113,272,0.000333,0.548025,26,42745.95521,2374.77529,1644.0752,335.088556,20,0
0,0,16,16,26,40,66,159,113,272,0.000333,0.548025,26,42745.95521,2374.77529,1644.0752,335.088556,20,0
0,0,16,16,26,40,66,159,113,272,0.000333,0.548025,26,42745.95521,2374.77529,1644.0752,335.088556,20,0
0,0,16,16,26,40,66,159,113,272,0.000333,0.548025,26,42745.95521,2374.77529,1644.0752,335.088556,20,0
0,0,16,16,26,40,66,159,113,272,0.000333,0.548025,26,42745.95521,2374.77529,1644.0752,335.088556,20,0
0,0,16,16,26,40,66,159,113,272,0.000333,0.548025,26,42745.95521,2374.77529,1644.0752,335.088556,20,0
0,0,10,10,17,24,41,77,58,135,0.000333,0.24109,16,11572.31233,642.906241,723.269521,179.525968,3,0
0,0,8,8,17,23,40,72,52,124,0.000333,0.219973,16,10558.70534,586.594741,659.919084,173.528793,3,0
0,0,11,11,17,24,41,79,60,139,0.000333,0.248233,16,11915.19566,661.955314,744.699729,179.525968,3,0
0,0,8,8,17,23,40,72,52,124,0.000333,0.219973,16,10558.70534,586.594741,659.919084,173.528793,3,0
0,0,10,10,17,24,41,77,58,135,0.000333,0.24109,16,11572.31233,642.906241,723.269521,179.525968,3,0
0,0,8,8,17,23,40,72,52,124,0.000333,0.219973,16,10558.70534,586.594741,659.919084,173.528793,3,0
0,0,11,11,17,24,41,79,60,139,0.000333,0.248233,16,11915.19566,661.955314,744.699729,179.525968,3,0
0,0,8,8,17,23,40,72,52,124,0.000333,0.219973,16,10558.70534,586.594741,659.919084,173.528793,3,0
0,0,28,28,21,29,50,190,145,335,0.000333,0.630231,50,94534.59118,5251.921732,1890.691824,233.120115,5,0
0,0,30,30,21,30,51,194,149,343,0.000333,0.648547,40,77825.67569,4323.64865,1945.641892,239.445384,5,0
0,0,29,29,21,30,51,192,147,339,0.000333,0.640984,40,76918.08764,4273.227091,1922.952191,239.445384,5,0
0,0,28,28,21,29,50,190,145,335,0.000333,0.630231,50,94534.59118,5251.921732,1890.691824,233.120115,5,0
0,0,28,28,21,29,50,190,145,335,0.000333,0.630231,50,94534.59118,5251.921732,1890.691824,233.120115,5,0
0,0,30,30,21,30,51,194,149,343,0.000333,0.648547,40,77825.67569,4323.64865,1945.641892,239.445384,5,0
0,0,29,29,21,30,51,192,147,339,0.000333,0.640984,40,76918.08764,4273.227091,1922.952191,239.445384,5,0
0,0,28,28,21,29,50,190,145,335,0.000333,0.630231,50,94534.59118,5251.921732,1890.691824,233.120115,5,0
0,0,28,28,21,29,50,190,145,335,0.000333,0.630231,50,94534.59118,5251.921732,1890.691824,233.120115,5,0
0,0,30,30,21,30,51,194,149,343,0.000333,0.648547,40,77825.67569,4323.64865,1945.641892,239.445384,5,0
0,0,29,29,21,30,51,192,147,339,0.000333,0.640984,40,76918.08764,4273.227091,1922.952191,239.445384,5,0
0,0,28,28,21,29,50,190,145,335,0.000333,0.630231,50,94534.59118,5251.921732,1890.691824,233.120115,5,0
0,0,28,28,21,29,50,190,145,335,0.000333,0.630231,50,94534.59118,5251.921732,1890.691824,233.120115,5,0
0,0,30,30,21,30,51,194,149,343,0.000333,0.648547,40,77825.67569,4323.64865,1945.641892,239.445384,5,0
0,0,29,29,21,30,51,192,147,339,0.000333,0.640984,40,76918.08764,4273.227091,1922.952191,239.445384,5,0
0,0,28,28,21,29,50,190,145,335,0.000333,0.630231,50,94534.59118,5251.921732,1890.691824,233.120115,5,0
0,0,28,28,21,29,50,190,145,335,0.000333,0.630231,50,94534.59118,5251.921732,1890.691824,233.120115,5,0
0,0,30,30,21,30,51,194,149,343,0.000333,0.648547,40,77825.67569,4323.64865,1945.641892,239.445384,5,0
0,0,29,29,21,30,51,192,147,339,0.000333,0.640984,40,76918.08764,4273.227091,1922.952191,239.445384,5,0
0,0,28,28,21,29,50,190,145,335,0.000333,0.630231,50,94534.59118,5251.921732,1890.691824,233.120115,5,0
0,0,28,28,21,29,50,190,145,335,0.000333,0.630231,50,94534.59118,5251.921732,1890.691824,233.120115,5,0
0,0,30,30,21,30,51,194,149,343,0.000333,0.648547,40,77825.67569,4323.64865,1945.641892,239.445384,5,0
0,0,29,29,21,30,51,192,147,339,0.000333,0.640984,40,76918.08764,4273.227091,1922.952191,239.445384,5,0
0,0,28,28,21,29,50,190,145,335,0.000333,0.630231,50,94534.59118,5251.921732,1890.691824,233.120115,5,0
0,0,21,21,16,28,44,161,124,285,0.000333,0.518646,32,49790.01636,2766.11202,1555.938011,198.605938,2,0
0,0,23,23,16,29,45,165,128,293,0.000333,0.536371,32,51491.61463,2860.645257,1609.112957,204.881449,2,0
0,0,22,22,16,29,45,163,126,289,0.000333,0.529049,32,50788.65744,2821.59208,1587.145545,204.881449,2,0
0,0,21,21,16,28,44,161,124,285,0.000333,0.518646,32,49790.01636,2766.11202,1555.938011,198.605938,2,0
0,0,21,21,16,28,44,161,124,285,0.000333,0.518646,32,49790.01636,2766.11202,1555.938011,198.605938,2,0
0,0,23,23,16,29,45,165,128,293,0.000333,0.536371,32,51491.61463,2860.645257,1609.112957,204.881449,2,0
0,0,22,22,16,29,45,163,126,289,0.000333,0.529049,32,50788.65744,2821.59208,1587.145545,204.881449,2,0
0,0,21,21,16,28,44,161,124,285,0.000333,0.518646,32,49790.01636,2766.11202,1555.938011,198.605938,2,0
0,0,21,21,16,28,44,161,124,285,0.000333,0.518646,32,49790.01636,2766.11202,1555.938011,198.605938,2,0
0,0,23,23,16,29,45,165,128,293,0.000333,0.536371,32,51491.61463,2860.645257,1609.112957,204.881449,2,0
0,0,22,22,16,29,45,163,126,289,0.000333,0.529049,32,50788.65744,2821.59208,1587.145545,204.881449,2,0
0,0,21,21,16,28,44,161,124,285,0.000333,0.518646,32,49790.01636,2766.11202,1555.938011,198.605938,2,0
0,0,9,9,15,23,38,84,64,148,0.000333,0.258898,14,10873.70581,604.094767,776.693272,162.645284,2,0
0,0,8,8,15,23,38,82,62,144,0.000333,0.251901,14,10579.82187,587.767882,755.701562,162.645284,2,0
0,0,10,10,15,23,38,86,66,152,0.000333,0.265895,14,11167.58975,620.421653,797.684982,162.645284,2,0
0,0,8,8,15,23,38,82,62,144,0.000333,0.251901,14,10579.82187,587.767882,755.701562,162.645284,2,0
0,0,9,9,15,23,38,84,64,148,0.000333,0.258898,14,10873.70581,604.094767,776.693272,162.645284,2,0
0,0,8,8,15,23,38,82,62,144,0.000333,0.251901,14,10579.82187,587.767882,755.701562,162.645284,2,0
0,0,10,10,15,23,38,86,66,152,0.000333,0.265895,14,11167.58975,620.421653,797.684982,162.645284,2,0
0,0,8,8,15,23,38,82,62,144,0.000333,0.251901,14,10579.82187,587.767882,755.701562,162.645284,2,0
0,0,7,7,14,20,34,49,45,94,0.000333,0.159407,14,6695.101099,371.950061,478.221507,139.741531,2,0
0,0,7,7,14,20,34,49,45,94,0.000333,0.159407,14,6695.101099,371.950061,478.221507,139.741531,2,0
0,0,5,5,10,16,26,30,29,59,0.000333,0.092442,5,1386.629717,77.034984,277.325943,97.219281,1,0
0,0,7,7,13,18,31,68,59,127,0.000333,0.209728,18,11325.29277,629.182931,629.182931,123.164366,1,0
0,0,5,5,10,16,26,30,29,59,0.000333,0.092442,5,1386.629717,77.034984,277.325943,97.219281,1,0
0,0,7,7,13,18,31,68,59,127,0.000333,0.209728,18,11325.29277,629.182931,629.182931,123.164366,1,0
0,0,7,7,14,20,34,49,45,94,0.000333,0.159407,14,6695.101099,371.950061,478.221507,139.741531,2,0
0,0,7,7,14,20,34,49,45,94,0.000333,0.159407,14,6695.101099,371.950061,478.221507,139.741531,2,0
0,0,5,5,10,16,26,30,29,59,0.000333,0.092442,5,1386.629717,77.034984,277.325943,97.219281,1,0
0,0,7,7,14,20,34,49,45,94,0.000333,0.159407,14,6695.101099,371.950061,478.221507,139.741531,2,0
0,0,7,7,14,20,34,49,45,94,0.000333,0.159407,14,6695.101099,371.950061,478.221507,139.741531,2,0
0,0,5,5,10,16,26,30,29,59,0.000333,0.092442,5,1386.629717,77.034984,277.325943,97.219281,1,0
0,0,8,8,14,21,35,57,53,110,0.000333,0.188074,14,7899.095846,438.838658,564.221132,145.541635,2,0
0,0,8,8,14,21,35,57,53,110,0.000333,0.188074,14,7899.095846,438.838658,564.221132,145.541635,2,0
0,0,5,5,10,16,26,30,29,59,0.000333,0.092442,5,1386.629717,77.034984,277.325943,97.219281,1,0
0,0,7,7,13,19,32,64,57,121,0.000333,0.201667,18,10890,605,605,128.816339,1,0
0,0,7,7,13,19,32,64,57,121,0.000333,0.201667,18,10890,605,605,128.816339,1,0
0,0,5,5,10,16,26,30,29,59,0.000333,0.092442,5,1386.629717,77.034984,277.325943,97.219281,1,0
0,0,7,7,13,19,32,64,57,121,0.000333,0.201667,18,10890,605,605,128.816339,1,0
0,0,7,7,13,19,32,64,57,121,0.000333,0.201667,18,10890,605,605,128.816339,1,0
0,0,8,8,14,21,35,57,53,110,0.000333,0.188074,14,7899.095846,438.838658,564.221132,145.541635,2,0
0,0,8,8,14,21,35,57,53,110,0.000333,0.188074,14,7899.095846,438.838658,564.221132,145.541635,2,0
0,0,5,5,10,16,26,30,29,59,0.000333,0.092442,5,1386.629717,77.034984,277.325943,97.219281,1,0
0,0,8,8,14,21,35,57,53,110,0.000333,0.188074,14,7899.095846,438.838658,564.221132,145.541635,2,0
0,0,8,8,14,21,35,57,53,110,0.000333,0.188074,14,7899.095846,438.838658,564.221132,145.541635,2,0
0,0,5,5,10,16,26,30,29,59,0.000333,0.092442,5,1386.629717,77.034984,277.325943,97.219281,1,0
0,0,5,5,12,20,32,49,43,92,0.000333,0.153333,12,5520,306.666667,460,129.458112,1,0
0,0,5,5,12,20,32,49,43,92,0.000333,0.153333,12,5520,306.666667,460,129.458112,1,0
0,0,5,5,12,20,32,49,43,92,0.000333,0.153333,12,5520,306.666667,460,129.458112,1,0
0,0,5,5,12,20,32,49,43,92,0.000333,0.153333,12,5520,306.666667,460,129.458112,1,0
0,0,5,5,12,20,32,49,43,92,0.000333,0.153333,12,5520,306.666667,460,129.458112,1,0
0,0,5,5,12,19,31,49,42,91,0.000333,0.150277,12,5409.982371,300.554576,450.831864,123.730173,1,0
0,0,5,5,12,19,31,49,42,91,0.000333,0.150277,12,5409.982371,300.554576,450.831864,123.730173,1,0
0,0,5,5,12,19,31,49,42,91,0.000333,0.150277,12,5409.982371,300.554576,450.831864,123.730173,1,0
0,0,5,5,12,19,31,49,42,91,0.000333,0.150277,12,5409.982371,300.554576,450.831864,123.730173,1,0
0,0,5,5,12,19,31,49,42,91,0.000333,0.150277,12,5409.982371,300.554576,450.831864,123.730173,1,0
0,0,5,5,12,20,32,49,44,93,0.000333,0.155,12,5580,310,465,129.458112,1,0
0,0,5,5,12,20,32,49,44,93,0.000333,0.155,12,5580,310,465,129.458112,1,0
0,0,5,5,12,20,32,49,44,93,0.000333,0.155,12,5580,310,465,129.458112,1,0
0,0,5,5,12,20,32,49,44,93,0.000333,0.155,12,5580,310,465,129.458112,1,0
0,0,5,5,12,20,32,49,44,93,0.000333,0.155,12,5580,310,465,129.458112,1,0
0,0,5,5,12,19,31,49,43,92,0.000333,0.151929,12,5469.432727,303.857374,455.786061,123.730173,1,0
0,0,5,5,12,19,31,49,43,92,0.000333,0.151929,12,5469.432727,303.857374,455.786061,123.730173,1,0
0,0,5,5,12,19,31,49,43,92,0.000333,0.151929,12,5469.432727,303.857374,455.786061,123.730173,1,0
0,0,5,5,12,19,31,49,43,92,0.000333,0.151929,12,5469.432727,303.857374,455.786061,123.730173,1,0
0,0,5,5,12,19,31,49,43,92,0.000333,0.151929,12,5469.432727,303.857374,455.786061,123.730173,1,0
0,0,5,5,11,16,27,34,29,63,0.000333,0.099853,5,1497.789563,83.210531,299.557913,102.053748,2,0
0,0,7,7,13,21,34,65,58,123,0.000333,0.208586,12,7509.095154,417.171953,625.757929,140.344382,1,0
0,0,5,5,13,21,34,46,41,87,0.000333,0.147536,6,2655.655603,147.536422,442.609267,140.344382,1,0
0,0,5,5,13,21,34,46,41,87,0.000333,0.147536,6,2655.655603,147.536422,442.609267,140.344382,1,0
0,0,5,5,12,20,32,45,40,85,0.000333,0.141667,12,5100,283.333333,425,129.458112,1,0
0,0,5,5,11,16,27,34,29,63,0.000333,0.099853,5,1497.789563,83.210531,299.557913,102.053748,2,0
0,0,4,4,9,12,21,21,19,40,0.000333,0.058564,4,702.770788,39.042822,175.692697,71.548875,2,0
0,0,5,5,13,21,34,46,41,87,0.000333,0.147536,6,2655.655603,147.536422,442.609267,140.344382,1,0
0,0,5,5,13,21,34,46,41,87,0.000333,0.147536,6,2655.655603,147.536422,442.609267,140.344382,1,0
0,0,5,5,12,20,32,45,40,85,0.000333,0.141667,12,5100,283.333333,425,129.458112,1,0
0,0,7,7,13,21,34,65,58,123,0.000333,0.208586,12,7509.095154,417.171953,625.757929,140.344382,1,0
0,0,7,7,13,21,34,65,58,123,0.000333,0.208586,12,7509.095154,417.171953,625.757929,140.344382,1,0
0,0,7,7,12,21,33,63,56,119,0.000333,0.200094,12,7203.394802,400.1886,600.2829,135.258216,1,0
0,0,5,5,12,21,33,45,40,85,0.000333,0.142925,6,2572.641001,142.9245,428.7735,135.258216,1,0
0,0,5,5,12,20,32,45,40,85,0.000333,0.141667,12,5100,283.333333,425,129.458112,1,0
0,0,5,5,12,20,32,45,40,85,0.000333,0.141667,12,5100,283.333333,425,129.458112,1,0
0,0,5,5,12,21,33,45,40,85,0.000333,0.142925,6,2572.641001,142.9245,428.7735,135.258216,1,0
0,0,5,5,12,20,32,45,40,85,0.000333,0.141667,12,5100,283.333333,425,129.458112,1,0
0,0,5,5,12,20,32,45,40,85,0.000333,0.141667,12,5100,283.333333,425,129.458112,1,0
0,0,7,7,12,21,33,63,56,119,0.000333,0.200094,12,7203.394802,400.1886,600.2829,135.258216,1,0
0,0,7,7,12,21,33,63,56,119,0.000333,0.200094,12,7203.394802,400.1886,600.2829,135.258216,1,0
0,0,5,5,11,16,27,34,29,63,0.000333,0.099853,5,1497.789563,83.210531,299.557913,102.053748,2,0
0,0,7,7,13,21,34,65,58,123,0.000333,0.208586,12,7509.095154,417.171953,625.757929,140.344382,1,0
0,0,5,5,13,21,34,46,41,87,0.000333,0.147536,6,2655.655603,147.536422,442.609267,140.344382,1,0
0,0,5,5,13,21,34,46,41,87,0.000333,0.147536,6,2655.655603,147.536422,442.609267,140.344382,1,0
0,0,5,5,12,20,32,45,40,85,0.000333,0.141667,12,5100,283.333333,425,129.458112,1,0
0,0,5,5,11,16,27,34,29,63,0.000333,0.099853,5,1497.789563,83.210531,299.557913,102.053748,2,0
0,0,4,4,9,12,21,21,19,40,0.000333,0.058564,4,702.770788,39.042822,175.692697,71.548875,2,0
0,0,5,5,13,21,34,46,41,87,0.000333,0.147536,6,2655.655603,147.536422,442.609267,140.344382,1,0
0,0,5,5,13,21,34,46,41,87,0.000333,0.147536,6,2655.655603,147.536422,442.609267,140.344382,1,0
0,0,5,5,12,20,32,45,40,85,0.000333,0.141667,12,5100,283.333333,425,129.458112,1,0
0,0,7,7,13,21,34,65,58,123,0.000333,0.208586,12,7509.095154,417.171953,625.757929,140.344382,1,0
0,0,7,7,13,21,34,65,58,123,0.000333,0.208586,12,7509.095154,417.171953,625.757929,140.344382,1,0
0,0,7,7,12,21,33,63,56,119,0.000333,0.200094,12,7203.394802,400.1886,600.2829,135.258216,1,0
0,0,5,5,12,21,33,45,40,85,0.000333,0.142925,6,2572.641001,142.9245,428.7735,135.258216,1,0
0,0,5,5,12,20,32,45,40,85,0.000333,0.141667,12,5100,283.333333,425,129.458112,1,0
0,0,5,5,12,20,32,45,40,85,0.000333,0.141667,12,5100,283.333333,425,129.458112,1,0
0,0,5,5,12,21,33,45,40,85,0.000333,0.142925,6,2572.641001,142.9245,428.7735,135.258216,1,0
0,0,5,5,12,20,32,45,40,85,0.000333,0.141667,12,5100,283.333333,425,129.458112,1,0
0,0,5,5,12,20,32,45,40,85,0.000333,0.141667,12,5100,283.333333,425,129.458112,1,0
0,0,7,7,12,21,33,63,56,119,0.000333,0.200094,12,7203.394802,400.1886,600.2829,135.258216,1,0
0,0,7,7,12,21,33,63,56,119,0.000333,0.200094,12,7203.394802,400.1886,600.2829,135.258216,1,0
0,0,13,13,18,27,45,83,66,149,0.000333,0.272762,18,14729.15,818.286111,818.286111,203.440613,5,0
0,0,10,10,17,22,39,61,49,110,0.000333,0.193798,16,9302.307905,516.794884,581.394244,167.594364,4,0
0,0,14,14,18,27,45,85,68,153,0.000333,0.280085,18,15124.56343,840.253524,840.253524,203.440613,5,0
0,0,11,11,17,23,40,63,51,114,0.000333,0.202233,16,9707.196845,539.288714,606.699803,173.528793,4,0
0,0,29,29,20,34,54,112,110,222,0.000333,0.425862,30,38327.55076,2129.308376,1277.585025,259.412299,7,0
0,0,8,8,13,21,34,51,50,101,0.000333,0.171278,12,6166.004964,342.555831,513.833747,140.344382,1,0
0,0,8,8,13,21,34,51,50,101,0.000333,0.171278,12,6166.004964,342.555831,513.833747,140.344382,1,0
0,0,29,29,19,35,54,109,107,216,0.000333,0.414352,27,33562.50391,1864.583551,1243.0557,260.235528,7,0
0,0,8,8,12,22,34,48,47,95,0.000333,0.161103,12,5799.707639,322.20598,483.30897,141.127046,1,0
0,0,39,39,29,54,83,305,218,523,0.000333,1.111382,56,186712.1549,10372.89749,3334.145623,451.645374,37,0
0,0,39,39,29,54,83,305,218,523,0.000333,1.111382,56,186712.1549,10372.89749,3334.145623,451.645374,37,0
0,0,39,39,29,54,83,305,218,523,0.000333,1.111382,56,186712.1549,10372.89749,3334.145623,451.645374,37,0
0,0,39,39,29,54,83,305,218,523,0.000333,1.111382,56,186712.1549,10372.89749,3334.145623,451.645374,37,0
0,0,39,39,29,54,83,305,218,523,0.000333,1.111382,56,186712.1549,10372.89749,3334.145623,451.645374,37,0
0,0,39,39,29,54,83,305,218,523,0.000333,1.111382,56,186712.1549,10372.89749,3334.145623,451.645374,37,0
0,0,39,39,29,55,84,309,222,531,0.000333,1.13144,56,190081.9509,10560.10838,3394.320551,458.856233,37,0
0,0,39,39,29,55,84,309,222,531,0.000333,1.13144,56,190081.9509,10560.10838,3394.320551,458.856233,37,0
0,0,39,39,29,55,84,309,222,531,0.000333,1.13144,56,190081.9509,10560.10838,3394.320551,458.856233,37,0
0,0,39,39,29,55,84,309,222,531,0.000333,1.13144,56,190081.9509,10560.10838,3394.320551,458.856233,37,0
0,0,39,39,29,55,84,309,222,531,0.000333,1.13144,56,190081.9509,10560.10838,3394.320551,458.856233,37,0
0,0,39,39,29,55,84,309,222,531,0.000333,1.13144,56,190081.9509,10560.10838,3394.320551,458.856233,37,0
0,0,39,39,29,55,84,309,222,531,0.000333,1.13144,56,190081.9509,10560.10838,3394.320551,458.856233,37,0
0,0,39,39,29,55,84,309,222,531,0.000333,1.13144,56,190081.9509,10560.10838,3394.320551,458.856233,37,0
0,0,46,46,29,55,84,363,249,612,0.000333,1.304033,56,219077.5027,12170.97237,3912.098263,458.856233,46,0
0,0,46,46,29,55,84,363,249,612,0.000333,1.304033,56,219077.5027,12170.97237,3912.098263,458.856233,46,0
0,0,46,46,29,55,84,363,249,612,0.000333,1.304033,56,219077.5027,12170.97237,3912.098263,458.856233,46,0
0,0,46,46,29,55,84,363,249,612,0.000333,1.304033,56,219077.5027,12170.97237,3912.098263,458.856233,46,0
0,0,46,46,29,55,84,363,249,612,0.000333,1.304033,56,219077.5027,12170.97237,3912.098263,458.856233,46,0
0,0,46,46,29,55,84,363,249,612,0.000333,1.304033,56,219077.5027,12170.97237,3912.098263,458.856233,46,0
0,0,46,46,29,55,84,363,249,612,0.000333,1.304033,56,219077.5027,12170.97237,3912.098263,458.856233,46,0
0,0,46,46,29,55,84,363,249,612,0.000333,1.304033,56,219077.5027,12170.97237,3912.098263,458.856233,46,0
0,0,46,46,29,55,84,363,249,612,0.000333,1.304033,56,219077.5027,12170.97237,3912.098263,458.856233,46,0
0,0,46,46,29,55,84,363,249,612,0.000333,1.304033,56,219077.5027,12170.97237,3912.098263,458.856233,46,0
0,0,46,46,29,55,84,363,249,612,0.000333,1.304033,56,219077.5027,12170.97237,3912.098263,458.856233,46,0
0,0,46,46,29,55,84,363,249,612,0.000333,1.304033,56,219077.5027,12170.97237,3912.098263,458.856233,46,0
0,0,46,46,29,55,84,363,249,612,0.000333,1.304033,56,219077.5027,12170.97237,3912.098263,458.856233,46,0
0,0,46,46,29,55,84,363,249,612,0.000333,1.304033,56,219077.5027,12170.97237,3912.098263,458.856233,46,0
0,0,42,42,29,55,84,321,225,546,0.000333,1.163402,56,195451.4975,10858.41653,3490.205313,458.856233,41,0
0,0,42,42,29,55,84,321,225,546,0.000333,1.163402,56,195451.4975,10858.41653,3490.205313,458.856233,41,0
0,0,42,42,29,55,84,321,225,546,0.000333,1.163402,56,195451.4975,10858.41653,3490.205313,458.856233,41,0
0,0,42,42,29,55,84,321,225,546,0.000333,1.163402,56,195451.4975,10858.41653,3490.205313,458.856233,41,0
0,0,42,42,29,55,84,321,225,546,0.000333,1.163402,56,195451.4975,10858.41653,3490.205313,458.856233,41,0
0,0,42,42,29,55,84,321,225,546,0.000333,1.163402,56,195451.4975,10858.41653,3490.205313,458.856233,41,0
0,0,41,41,29,56,85,322,228,550,0.000333,1.175055,56,197409.2408,10967.18005,3525.165015,466.093324,40,0
0,0,41,41,29,56,85,322,228,550,0.000333,1.175055,56,197409.2408,10967.18005,3525.165015,466.093324,40,0
0,0,41,41,29,56,85,322,228,550,0.000333,1.175055,56,197409.2408,10967.18005,3525.165015,466.093324,40,0
0,0,41,41,29,56,85,322,228,550,0.000333,1.175055,56,197409.2408,10967.18005,3525.165015,466.093324,40,0
0,0,41,41,29,56,85,322,228,550,0.000333,1.175055,56,197409.2408,10967.18005,3525.165015,466.093324,40,0
0,0,41,41,29,56,85,322,228,550,0.000333,1.175055,56,197409.2408,10967.18005,3525.165015,466.093324,40,0
0,0,41,41,29,56,85,322,228,550,0.000333,1.175055,56,197409.2408,10967.18005,3525.165015,466.093324,40,0
0,0,41,41,29,56,85,322,228,550,0.000333,1.175055,56,197409.2408,10967.18005,3525.165015,466.093324,40,0
0,0,47,47,29,55,84,375,255,630,0.000333,1.342387,56,225520.9587,12528.94215,4027.159976,458.856233,48,0
0,0,47,47,29,55,84,375,255,630,0.000333,1.342387,56,225520.9587,12528.94215,4027.159976,458.856233,48,0
0,0,47,47,29,55,84,375,255,630,0.000333,1.342387,56,225520.9587,12528.94215,4027.159976,458.856233,48,0
0,0,47,47,29,55,84,375,255,630,0.000333,1.342387,56,225520.9587,12528.94215,4027.159976,458.856233,48,0
0,0,47,47,29,55,84,375,255,630,0.000333,1.342387,56,225520.9587,12528.94215,4027.159976,458.856233,48,0
0,0,47,47,29,55,84,375,255,630,0.000333,1.342387,56,225520.9587,12528.94215,4027.159976,458.856233,48,0
0,0,47,47,29,55,84,375,255,630,0.000333,1.342387,56,225520.9587,12528.94215,4027.159976,458.856233,48,0
0,0,47,47,29,55,84,375,255,630,0.000333,1.342387,56,225520.9587,12528.94215,4027.159976,458.856233,48,0
0,0,46,46,29,55,84,371,253,624,0.000333,1.329602,56,223373.14,12409.61889,3988.806072,458.856233,46,0
0,0,46,46,29,55,84,371,253,624,0.000333,1.329602,56,223373.14,12409.61889,3988.806072,458.856233,46,0
0,0,46,46,29,55,84,371,253,624,0.000333,1.329602,56,223373.14,12409.61889,3988.806072,458.856233,46,0
0,0,46,46,29,55,84,371,253,624,0.000333,1.329602,56,223373.14,12409.61889,3988.806072,458.856233,46,0
0,0,46,46,29,55,84,371,253,624,0.000333,1.329602,56,223373.14,12409.61889,3988.806072,458.856233,46,0
0,0,46,46,29,55,84,371,253,624,0.000333,1.329602,56,223373.14,12409.61889,3988.806072,458.856233,46,0
0,0,42,42,29,55,84,321,225,546,0.000333,1.163402,56,195451.4975,10858.41653,3490.205313,458.856233,41,0
0,0,42,42,29,55,84,321,225,546,0.000333,1.163402,56,195451.4975,10858.41653,3490.205313,458.856233,41,0
0,0,29,29,27,49,76,212,157,369,0.000333,0.768495,39,89913.92485,4995.218047,2305.485252,403.502745,34,0
0,0,29,29,27,49,76,212,157,369,0.000333,0.768495,39,89913.92485,4995.218047,2305.485252,403.502745,34,0
0,0,40,40,29,55,84,332,232,564,0.000333,1.201756,56,201894.9535,11216.38631,3605.267026,458.856233,40,0
0,0,40,40,29,55,84,332,232,564,0.000333,1.201756,56,201894.9535,11216.38631,3605.267026,458.856233,40,0
0,0,40,40,29,55,84,332,232,564,0.000333,1.201756,56,201894.9535,11216.38631,3605.267026,458.856233,40,0
0,0,40,40,29,55,84,332,232,564,0.000333,1.201756,56,201894.9535,11216.38631,3605.267026,458.856233,40,0
0,0,40,40,29,55,84,332,232,564,0.000333,1.201756,56,201894.9535,11216.38631,3605.267026,458.856233,40,0
0,0,40,40,29,55,84,332,232,564,0.000333,1.201756,56,201894.9535,11216.38631,3605.267026,458.856233,40,0
0,0,40,40,29,55,84,332,232,564,0.000333,1.201756,56,201894.9535,11216.38631,3605.267026,458.856233,40,0
0,0,40,40,29,55,84,332,232,564,0.000333,1.201756,56,201894.9535,11216.38631,3605.267026,458.856233,40,0
0,0,41,41,29,56,85,328,231,559,0.000333,1.194283,56,200639.5739,11146.64299,3582.849533,466.093324,40,0
0,0,41,41,29,56,85,328,231,559,0.000333,1.194283,56,200639.5739,11146.64299,3582.849533,466.093324,40,0
0,0,41,41,29,56,85,328,231,559,0.000333,1.194283,56,200639.5739,11146.64299,3582.849533,466.093324,40,0
0,0,41,41,29,56,85,328,231,559,0.000333,1.194283,56,200639.5739,11146.64299,3582.849533,466.093324,40,0
0,0,41,41,29,56,85,328,231,559,0.000333,1.194283,56,200639.5739,11146.64299,3582.849533,466.093324,40,0
0,0,41,41,29,56,85,328,231,559,0.000333,1.194283,56,200639.5739,11146.64299,3582.849533,466.093324,40,0
0,0,41,41,29,56,85,328,231,559,0.000333,1.194283,56,200639.5739,11146.64299,3582.849533,466.093324,40,0
0,0,41,41,29,56,85,328,231,559,0.000333,1.194283,56,200639.5739,11146.64299,3582.849533,466.093324,40,0
0,0,42,42,29,55,84,327,228,555,0.000333,1.182579,56,198673.2255,11037.40142,3547.73617,458.856233,41,0
0,0,42,42,29,55,84,327,228,555,0.000333,1.182579,56,198673.2255,11037.40142,3547.73617,458.856233,41,0
0,0,42,42,29,55,84,327,228,555,0.000333,1.182579,56,198673.2255,11037.40142,3547.73617,458.856233,41,0
0,0,42,42,29,55,84,327,228,555,0.000333,1.182579,56,198673.2255,11037.40142,3547.73617,458.856233,41,0
0,0,42,42,29,55,84,327,228,555,0.000333,1.182579,56,198673.2255,11037.40142,3547.73617,458.856233,41,0
0,0,42,42,29,55,84,327,228,555,0.000333,1.182579,56,198673.2255,11037.40142,3547.73617,458.856233,41,0
0,0,46,46,29,55,84,377,256,633,0.000333,1.348779,56,226594.868,12588.60378,4046.336929,458.856233,46,0
0,0,46,46,29,55,84,377,256,633,0.000333,1.348779,56,226594.868,12588.60378,4046.336929,458.856233,46,0
0,0,46,46,29,55,84,377,256,633,0.000333,1.348779,56,226594.868,12588.60378,4046.336929,458.856233,46,0
0,0,46,46,29,55,84,377,256,633,0.000333,1.348779,56,226594.868,12588.60378,4046.336929,458.856233,46,0
0,0,46,46,29,55,84,377,256,633,0.000333,1.348779,56,226594.868,12588.60378,4046.336929,458.856233,46,0
0,0,46,46,29,55,84,377,256,633,0.000333,1.348779,56,226594.868,12588.60378,4046.336929,458.856233,46,0
0,0,47,47,29,55,84,381,258,639,0.000333,1.361564,56,228742.6867,12707.92704,4084.690833,458.856233,48,0
0,0,47,47,29,55,84,381,258,639,0.000333,1.361564,56,228742.6867,12707.92704,4084.690833,458.856233,48,0
0,0,47,47,29,55,84,381,258,639,0.000333,1.361564,56,228742.6867,12707.92704,4084.690833,458.856233,48,0
0,0,47,47,29,55,84,381,258,639,0.000333,1.361564,56,228742.6867,12707.92704,4084.690833,458.856233,48,0
0,0,47,47,29,55,84,381,258,639,0.000333,1.361564,56,228742.6867,12707.92704,4084.690833,458.856233,48,0
0,0,47,47,29,55,84,381,258,639,0.000333,1.361564,56,228742.6867,12707.92704,4084.690833,458.856233,48,0
0,0,47,47,29,55,84,381,258,639,0.000333,1.361564,56,228742.6867,12707.92704,4084.690833,458.856233,48,0
0,0,47,47,29,55,84,381,258,639,0.000333,1.361564,56,228742.6867,12707.92704,4084.690833,458.856233,48,0
0,0,41,41,29,56,85,322,228,550,0.000333,1.175055,56,197409.2408,10967.18005,3525.165015,466.093324,40,0
0,0,41,41,29,56,85,322,228,550,0.000333,1.175055,56,197409.2408,10967.18005,3525.165015,466.093324,40,0
0,0,41,41,29,56,85,322,228,550,0.000333,1.175055,56,197409.2408,10967.18005,3525.165015,466.093324,40,0
0,0,41,41,29,56,85,322,228,550,0.000333,1.175055,56,197409.2408,10967.18005,3525.165015,466.093324,40,0
0,0,41,41,29,56,85,322,228,550,0.000333,1.175055,56,197409.2408,10967.18005,3525.165015,466.093324,40,0
0,0,41,41,29,56,85,322,228,550,0.000333,1.175055,56,197409.2408,10967.18005,3525.165015,466.093324,40,0
0,0,41,41,29,56,85,322,228,550,0.000333,1.175055,56,197409.2408,10967.18005,3525.165015,466.093324,40,0
0,0,41,41,29,56,85,322,228,550,0.000333,1.175055,56,197409.2408,10967.18005,3525.165015,466.093324,40,0
0,0,42,42,29,55,84,321,225,546,0.000333,1.163402,56,195451.4975,10858.41653,3490.205313,458.856233,41,0
0,0,42,42,29,55,84,321,225,546,0.000333,1.163402,56,195451.4975,10858.41653,3490.205313,458.856233,41,0
0,0,42,42,29,55,84,321,225,546,0.000333,1.163402,56,195451.4975,10858.41653,3490.205313,458.856233,41,0
0,0,42,42,29,55,84,321,225,546,0.000333,1.163402,56,195451.4975,10858.41653,3490.205313,458.856233,41,0
0,0,17,17,27,43,70,163,119,282,0.000333,0.576153,26,44939.90308,2496.661282,1728.457811,361.711347,21,0
0,0,17,17,27,43,70,163,119,282,0.000333,0.576153,26,44939.90308,2496.661282,1728.457811,361.711347,21,0
0,0,17,17,27,43,70,163,119,282,0.000333,0.576153,26,44939.90308,2496.661282,1728.457811,361.711347,21,0
0,0,17,17,27,43,70,163,119,282,0.000333,0.576153,26,44939.90308,2496.661282,1728.457811,361.711347,21,0
0,0,33,33,31,53,84,289,212,501,0.000333,1.067517,60,192153.0617,10675.1701,3202.551029,457.15987,28,0
0,0,33,33,31,53,84,289,212,501,0.000333,1.067517,60,192153.0617,10675.1701,3202.551029,457.15987,28,0
0,0,33,33,31,53,84,289,212,501,0.000333,1.067517,60,192153.0617,10675.1701,3202.551029,457.15987,28,0
0,0,33,33,31,53,84,289,212,501,0.000333,1.067517,60,192153.0617,10675.1701,3202.551029,457.15987,28,0
0,0,33,33,31,53,84,289,212,501,0.000333,1.067517,60,192153.0617,10675.1701,3202.551029,457.15987,28,0
0,0,33,33,31,53,84,289,212,501,0.000333,1.067517,60,192153.0617,10675.1701,3202.551029,457.15987,28,0
0,0,33,33,31,53,84,289,212,501,0.000333,1.067517,60,192153.0617,10675.1701,3202.551029,457.15987,28,0
0,0,33,33,31,53,84,289,212,501,0.000333,1.067517,60,192153.0617,10675.1701,3202.551029,457.15987,28,0
0,0,33,33,31,53,84,289,212,501,0.000333,1.067517,60,192153.0617,10675.1701,3202.551029,457.15987,28,0
0,0,33,33,31,53,84,289,212,501,0.000333,1.067517,60,192153.0617,10675.1701,3202.551029,457.15987,28,0
0,0,33,33,31,53,84,289,212,501,0.000333,1.067517,60,192153.0617,10675.1701,3202.551029,457.15987,28,0
0,0,33,33,31,53,84,289,212,501,0.000333,1.067517,60,192153.0617,10675.1701,3202.551029,457.15987,28,0
0,0,34,34,31,53,84,304,221,525,0.000333,1.118656,60,201357.9988,11186.55549,3355.966647,457.15987,28,0
0,0,34,34,31,53,84,304,221,525,0.000333,1.118656,60,201357.9988,11186.55549,3355.966647,457.15987,28,0
0,0,34,34,31,53,84,304,221,525,0.000333,1.118656,60,201357.9988,11186.55549,3355.966647,457.15987,28,0
0,0,34,34,31,53,84,304,221,525,0.000333,1.118656,60,201357.9988,11186.55549,3355.966647,457.15987,28,0
0,0,34,34,31,53,84,304,221,525,0.000333,1.118656,60,201357.9988,11186.55549,3355.966647,457.15987,28,0
0,0,34,34,31,53,84,304,221,525,0.000333,1.118656,60,201357.9988,11186.55549,3355.966647,457.15987,28,0
0,0,34,34,31,53,84,304,221,525,0.000333,1.118656,60,201357.9988,11186.55549,3355.966647,457.15987,28,0
0,0,34,34,31,53,84,304,221,525,0.000333,1.118656,60,201357.9988,11186.55549,3355.966647,457.15987,28,0
0,0,34,34,31,53,84,304,221,525,0.000333,1.118656,60,201357.9988,11186.55549,3355.966647,457.15987,28,0
0,0,34,34,31,53,84,304,221,525,0.000333,1.118656,60,201357.9988,11186.55549,3355.966647,457.15987,28,0
0,0,34,34,31,53,84,304,221,525,0.000333,1.118656,60,201357.9988,11186.55549,3355.966647,457.15987,28,0
0,0,34,34,31,53,84,304,221,525,0.000333,1.118656,60,201357.9988,11186.55549,3355.966647,457.15987,28,0
0,0,34,34,31,53,84,304,221,525,0.000333,1.118656,60,201357.9988,11186.55549,3355.966647,457.15987,28,0
0,0,34,34,31,53,84,304,221,525,0.000333,1.118656,60,201357.9988,11186.55549,3355.966647,457.15987,28,0
0,0,34,34,31,53,84,304,221,525,0.000333,1.118656,60,201357.9988,11186.55549,3355.966647,457.15987,28,0
0,0,34,34,31,53,84,304,221,525,0.000333,1.118656,60,201357.9988,11186.55549,3355.966647,457.15987,28,0
0,0,39,39,31,55,86,363,255,618,0.000333,1.323811,60,238285.8971,13238.1054,3971.431618,471.55487,31,0
0,0,39,39,31,55,86,363,255,618,0.000333,1.323811,60,238285.8971,13238.1054,3971.431618,471.55487,31,0
0,0,39,39,31,55,86,363,255,618,0.000333,1.323811,60,238285.8971,13238.1054,3971.431618,471.55487,31,0
0,0,39,39,31,55,86,363,255,618,0.000333,1.323811,60,238285.8971,13238.1054,3971.431618,471.55487,31,0
0,0,39,39,31,55,86,363,255,618,0.000333,1.323811,60,238285.8971,13238.1054,3971.431618,471.55487,31,0
0,0,39,39,31,55,86,363,255,618,0.000333,1.323811,60,238285.8971,13238.1054,3971.431618,471.55487,31,0
0,0,39,39,31,55,86,363,255,618,0.000333,1.323811,60,238285.8971,13238.1054,3971.431618,471.55487,31,0
0,0,39,39,31,55,86,363,255,618,0.000333,1.323811,60,238285.8971,13238.1054,3971.431618,471.55487,31,0
0,0,39,39,31,55,86,363,255,618,0.000333,1.323811,60,238285.8971,13238.1054,3971.431618,471.55487,31,0
0,0,39,39,31,55,86,363,255,618,0.000333,1.323811,60,238285.8971,13238.1054,3971.431618,471.55487,31,0
0,0,39,39,31,55,86,363,255,618,0.000333,1.323811,60,238285.8971,13238.1054,3971.431618,471.55487,31,0
0,0,39,39,31,55,86,363,255,618,0.000333,1.323811,60,238285.8971,13238.1054,3971.431618,471.55487,31,0
0,0,37,37,31,55,86,350,248,598,0.000333,1.280969,60,230574.3794,12809.68774,3842.906323,471.55487,28,0
0,0,37,37,31,55,86,350,248,598,0.000333,1.280969,60,230574.3794,12809.68774,3842.906323,471.55487,28,0
0,0,37,37,31,55,86,350,248,598,0.000333,1.280969,60,230574.3794,12809.68774,3842.906323,471.55487,28,0
0,0,37,37,31,55,86,350,248,598,0.000333,1.280969,60,230574.3794,12809.68774,3842.906323,471.55487,28,0
0,0,37,37,31,55,86,350,248,598,0.000333,1.280969,60,230574.3794,12809.68774,3842.906323,471.55487,28,0
0,0,37,37,31,55,86,350,248,598,0.000333,1.280969,60,230574.3794,12809.68774,3842.906323,471.55487,28,0
0,0,37,37,31,55,86,350,248,598,0.000333,1.280969,60,230574.3794,12809.68774,3842.906323,471.55487,28,0
0,0,37,37,31,55,86,350,248,598,0.000333,1.280969,60,230574.3794,12809.68774,3842.906323,471.55487,28,0
0,0,37,37,31,55,86,350,248,598,0.000333,1.280969,60,230574.3794,12809.68774,3842.906323,471.55487,28,0
0,0,37,37,31,55,86,350,248,598,0.000333,1.280969,60,230574.3794,12809.68774,3842.906323,471.55487,28,0
0,0,37,37,31,55,86,350,248,598,0.000333,1.280969,60,230574.3794,12809.68774,3842.906323,471.55487,28,0
0,0,37,37,31,55,86,350,248,598,0.000333,1.280969,60,230574.3794,12809.68774,3842.906323,471.55487,28,0
0,0,34,34,31,54,85,320,229,549,0.000333,1.172919,60,211125.3374,11729.18541,3518.755624,464.344011,28,0
0,0,34,34,31,54,85,320,229,549,0.000333,1.172919,60,211125.3374,11729.18541,3518.755624,464.344011,28,0
0,0,34,34,31,54,85,320,229,549,0.000333,1.172919,60,211125.3374,11729.18541,3518.755624,464.344011,28,0
0,0,34,34,31,54,85,320,229,549,0.000333,1.172919,60,211125.3374,11729.18541,3518.755624,464.344011,28,0
0,0,34,34,31,54,85,320,229,549,0.000333,1.172919,60,211125.3374,11729.18541,3518.755624,464.344011,28,0
0,0,34,34,31,54,85,320,229,549,0.000333,1.172919,60,211125.3374,11729.18541,3518.755624,464.344011,28,0
0,0,34,34,31,54,85,320,229,549,0.000333,1.172919,60,211125.3374,11729.18541,3518.755624,464.344011,28,0
0,0,34,34,31,54,85,320,229,549,0.000333,1.172919,60,211125.3374,11729.18541,3518.755624,464.344011,28,0
0,0,34,34,31,54,85,320,229,549,0.000333,1.172919,60,211125.3374,11729.18541,3518.755624,464.344011,28,0
0,0,34,34,31,54,85,320,229,549,0.000333,1.172919,60,211125.3374,11729.18541,3518.755624,464.344011,28,0
0,0,34,34,31,54,85,320,229,549,0.000333,1.172919,60,211125.3374,11729.18541,3518.755624,464.344011,28,0
0,0,34,34,31,54,85,320,229,549,0.000333,1.172919,60,211125.3374,11729.18541,3518.755624,464.344011,28,0
0,0,34,34,31,54,85,320,229,549,0.000333,1.172919,60,211125.3374,11729.18541,3518.755624,464.344011,28,0
0,0,34,34,31,54,85,320,229,549,0.000333,1.172919,60,211125.3374,11729.18541,3518.755624,464.344011,28,0
0,0,34,34,31,54,85,320,229,549,0.000333,1.172919,60,211125.3374,11729.18541,3518.755624,464.344011,28,0
0,0,34,34,31,54,85,320,229,549,0.000333,1.172919,60,211125.3374,11729.18541,3518.755624,464.344011,28,0
0,0,39,39,31,55,86,369,258,627,0.000333,1.343089,60,241756.0801,13430.89334,4029.268001,471.55487,31,0
0,0,39,39,31,55,86,369,258,627,0.000333,1.343089,60,241756.0801,13430.89334,4029.268001,471.55487,31,0
0,0,39,39,31,55,86,369,258,627,0.000333,1.343089,60,241756.0801,13430.89334,4029.268001,471.55487,31,0
0,0,39,39,31,55,86,369,258,627,0.000333,1.343089,60,241756.0801,13430.89334,4029.268001,471.55487,31,0
0,0,39,39,31,55,86,369,258,627,0.000333,1.343089,60,241756.0801,13430.89334,4029.268001,471.55487,31,0
0,0,39,39,31,55,86,369,258,627,0.000333,1.343089,60,241756.0801,13430.89334,4029.268001,471.55487,31,0
0,0,39,39,31,55,86,369,258,627,0.000333,1.343089,60,241756.0801,13430.89334,4029.268001,471.55487,31,0
0,0,39,39,31,55,86,369,258,627,0.000333,1.343089,60,241756.0801,13430.89334,4029.268001,471.55487,31,0
0,0,39,39,31,55,86,369,258,627,0.000333,1.343089,60,241756.0801,13430.89334,4029.268001,471.55487,31,0
0,0,39,39,31,55,86,369,258,627,0.000333,1.343089,60,241756.0801,13430.89334,4029.268001,471.55487,31,0
0,0,39,39,31,55,86,369,258,627,0.000333,1.343089,60,241756.0801,13430.89334,4029.268001,471.55487,31,0
0,0,39,39,31,55,86,369,258,627,0.000333,1.343089,60,241756.0801,13430.89334,4029.268001,471.55487,31,0
0,0,37,37,31,55,86,356,251,607,0.000333,1.300248,60,234044.5624,13002.47569,3900.742706,471.55487,28,0
0,0,37,37,31,55,86,356,251,607,0.000333,1.300248,60,234044.5624,13002.47569,3900.742706,471.55487,28,0
0,0,37,37,31,55,86,356,251,607,0.000333,1.300248,60,234044.5624,13002.47569,3900.742706,471.55487,28,0
0,0,37,37,31,55,86,356,251,607,0.000333,1.300248,60,234044.5624,13002.47569,3900.742706,471.55487,28,0
0,0,29,29,28,47,75,223,161,384,0.000333,0.797289,42,100458.3878,5581.021547,2391.866377,395.671614,37,0
0,0,29,29,28,47,75,223,161,384,0.000333,0.797289,42,100458.3878,5581.021547,2391.866377,395.671614,37,0
0,0,29,29,28,47,75,223,161,384,0.000333,0.797289,42,100458.3878,5581.021547,2391.866377,395.671614,37,0
0,0,29,29,28,47,75,223,161,384,0.000333,0.797289,42,100458.3878,5581.021547,2391.866377,395.671614,37,0
0,0,33,33,30,55,85,261,196,457,0.000333,0.976364,45,131809.1246,7322.729145,2929.091658,465.181502,26,0
0,0,33,33,30,55,85,261,196,457,0.000333,0.976364,45,131809.1246,7322.729145,2929.091658,465.181502,26,0
0,0,33,33,30,55,85,261,196,457,0.000333,0.976364,45,131809.1246,7322.729145,2929.091658,465.181502,26,0
0,0,33,33,30,55,85,261,196,457,0.000333,0.976364,45,131809.1246,7322.729145,2929.091658,465.181502,26,0
0,0,33,33,30,55,85,261,196,457,0.000333,0.976364,45,131809.1246,7322.729145,2929.091658,465.181502,26,0
0,0,33,33,30,55,85,261,196,457,0.000333,0.976364,45,131809.1246,7322.729145,2929.091658,465.181502,26,0
0,0,33,33,30,55,85,261,196,457,0.000333,0.976364,45,131809.1246,7322.729145,2929.091658,465.181502,26,0
0,0,33,33,30,55,85,261,196,457,0.000333,0.976364,45,131809.1246,7322.729145,2929.091658,465.181502,26,0
0,0,33,33,30,55,85,261,196,457,0.000333,0.976364,45,131809.1246,7322.729145,2929.091658,465.181502,26,0
0,0,33,33,30,55,85,261,196,457,0.000333,0.976364,45,131809.1246,7322.729145,2929.091658,465.181502,26,0
0,0,33,33,30,55,85,261,196,457,0.000333,0.976364,45,131809.1246,7322.729145,2929.091658,465.181502,26,0
0,0,33,33,30,55,85,261,196,457,0.000333,0.976364,45,131809.1246,7322.729145,2929.091658,465.181502,26,0
0,0,34,34,30,54,84,270,201,471,0.000333,1.003594,45,135485.1678,7526.953765,3010.781506,457.970643,28,0
0,0,34,34,30,54,84,270,201,471,0.000333,1.003594,45,135485.1678,7526.953765,3010.781506,457.970643,28,0
0,0,34,34,30,54,84,270,201,471,0.000333,1.003594,45,135485.1678,7526.953765,3010.781506,457.970643,28,0
0,0,34,34,30,54,84,270,201,471,0.000333,1.003594,45,135485.1678,7526.953765,3010.781506,457.970643,28,0
0,0,34,34,30,54,84,270,201,471,0.000333,1.003594,45,135485.1678,7526.953765,3010.781506,457.970643,28,0
0,0,34,34,30,54,84,270,201,471,0.000333,1.003594,45,135485.1678,7526.953765,3010.781506,457.970643,28,0
0,0,34,34,30,54,84,270,201,471,0.000333,1.003594,45,135485.1678,7526.953765,3010.781506,457.970643,28,0
0,0,34,34,30,54,84,270,201,471,0.000333,1.003594,45,135485.1678,7526.953765,3010.781506,457.970643,28,0
0,0,34,34,30,54,84,270,201,471,0.000333,1.003594,45,135485.1678,7526.953765,3010.781506,457.970643,28,0
0,0,34,34,30,54,84,270,201,471,0.000333,1.003594,45,135485.1678,7526.953765,3010.781506,457.970643,28,0
0,0,34,34,30,54,84,270,201,471,0.000333,1.003594,45,135485.1678,7526.953765,3010.781506,457.970643,28,0
0,0,34,34,30,54,84,270,201,471,0.000333,1.003594,45,135485.1678,7526.953765,3010.781506,457.970643,28,0
0,0,34,34,30,54,84,270,201,471,0.000333,1.003594,45,135485.1678,7526.953765,3010.781506,457.970643,28,0
0,0,34,34,30,54,84,270,201,471,0.000333,1.003594,45,135485.1678,7526.953765,3010.781506,457.970643,28,0
0,0,34,34,30,54,84,270,201,471,0.000333,1.003594,45,135485.1678,7526.953765,3010.781506,457.970643,28,0
0,0,34,34,30,54,84,270,201,471,0.000333,1.003594,45,135485.1678,7526.953765,3010.781506,457.970643,28,0
0,0,37,37,30,55,85,316,228,544,0.000333,1.162236,60,209202.5202,11622.36223,3486.708669,465.181502,28,0
0,0,37,37,30,55,85,316,228,544,0.000333,1.162236,60,209202.5202,11622.36223,3486.708669,465.181502,28,0
0,0,37,37,30,55,85,316,228,544,0.000333,1.162236,60,209202.5202,11622.36223,3486.708669,465.181502,28,0
0,0,37,37,30,55,85,316,228,544,0.000333,1.162236,60,209202.5202,11622.36223,3486.708669,465.181502,28,0
0,0,37,37,30,55,85,316,228,544,0.000333,1.162236,60,209202.5202,11622.36223,3486.708669,465.181502,28,0
0,0,37,37,30,55,85,316,228,544,0.000333,1.162236,60,209202.5202,11622.36223,3486.708669,465.181502,28,0
0,0,37,37,30,55,85,316,228,544,0.000333,1.162236,60,209202.5202,11622.36223,3486.708669,465.181502,28,0
0,0,37,37,30,55,85,316,228,544,0.000333,1.162236,60,209202.5202,11622.36223,3486.708669,465.181502,28,0
0,0,37,37,30,55,85,316,228,544,0.000333,1.162236,60,209202.5202,11622.36223,3486.708669,465.181502,28,0
0,0,37,37,30,55,85,316,228,544,0.000333,1.162236,60,209202.5202,11622.36223,3486.708669,465.181502,28,0
0,0,37,37,30,55,85,316,228,544,0.000333,1.162236,60,209202.5202,11622.36223,3486.708669,465.181502,28,0
0,0,37,37,30,55,85,316,228,544,0.000333,1.162236,60,209202.5202,11622.36223,3486.708669,465.181502,28,0
0,0,43,43,31,56,87,364,261,625,0.000333,1.34228,60,241610.3811,13422.79895,4026.839685,478.791961,31,0
0,0,43,43,31,56,87,364,261,625,0.000333,1.34228,60,241610.3811,13422.79895,4026.839685,478.791961,31,0
0,0,43,43,31,56,87,364,261,625,0.000333,1.34228,60,241610.3811,13422.79895,4026.839685,478.791961,31,0
0,0,43,43,31,56,87,364,261,625,0.000333,1.34228,60,241610.3811,13422.79895,4026.839685,478.791961,31,0
0,0,43,43,31,56,87,364,261,625,0.000333,1.34228,60,241610.3811,13422.79895,4026.839685,478.791961,31,0
0,0,43,43,31,56,87,364,261,625,0.000333,1.34228,60,241610.3811,13422.79895,4026.839685,478.791961,31,0
0,0,43,43,31,56,87,364,261,625,0.000333,1.34228,60,241610.3811,13422.79895,4026.839685,478.791961,31,0
0,0,43,43,31,56,87,364,261,625,0.000333,1.34228,60,241610.3811,13422.79895,4026.839685,478.791961,31,0
0,0,43,43,31,56,87,364,261,625,0.000333,1.34228,60,241610.3811,13422.79895,4026.839685,478.791961,31,0
0,0,43,43,31,56,87,364,261,625,0.000333,1.34228,60,241610.3811,13422.79895,4026.839685,478.791961,31,0
0,0,43,43,31,56,87,364,261,625,0.000333,1.34228,60,241610.3811,13422.79895,4026.839685,478.791961,31,0
0,0,43,43,31,56,87,364,261,625,0.000333,1.34228,60,241610.3811,13422.79895,4026.839685,478.791961,31,0
0,0,34,34,31,54,85,312,225,537,0.000333,1.147281,60,206510.576,11472.80978,3441.842933,464.344011,28,0
0,0,34,34,31,54,85,312,225,537,0.000333,1.147281,60,206510.576,11472.80978,3441.842933,464.344011,28,0
0,0,34,34,31,54,85,312,225,537,0.000333,1.147281,60,206510.576,11472.80978,3441.842933,464.344011,28,0
0,0,34,34,31,54,85,312,225,537,0.000333,1.147281,60,206510.576,11472.80978,3441.842933,464.344011,28,0
0,0,34,34,31,54,85,312,225,537,0.000333,1.147281,60,206510.576,11472.80978,3441.842933,464.344011,28,0
0,0,34,34,31,54,85,312,225,537,0.000333,1.147281,60,206510.576,11472.80978,3441.842933,464.344011,28,0
0,0,34,34,31,54,85,312,225,537,0.000333,1.147281,60,206510.576,11472.80978,3441.842933,464.344011,28,0
0,0,34,34,31,54,85,312,225,537,0.000333,1.147281,60,206510.576,11472.80978,3441.842933,464.344011,28,0
0,0,34,34,31,54,85,312,225,537,0.000333,1.147281,60,206510.576,11472.80978,3441.842933,464.344011,28,0
0,0,34,34,31,54,85,312,225,537,0.000333,1.147281,60,206510.576,11472.80978,3441.842933,464.344011,28,0
0,0,34,34,31,54,85,312,225,537,0.000333,1.147281,60,206510.576,11472.80978,3441.842933,464.344011,28,0
0,0,34,34,31,54,85,312,225,537,0.000333,1.147281,60,206510.576,11472.80978,3441.842933,464.344011,28,0
0,0,34,34,31,54,85,312,225,537,0.000333,1.147281,60,206510.576,11472.80978,3441.842933,464.344011,28,0
0,0,34,34,31,54,85,312,225,537,0.000333,1.147281,60,206510.576,11472.80978,3441.842933,464.344011,28,0
0,0,34,34,31,54,85,312,225,537,0.000333,1.147281,60,206510.576,11472.80978,3441.842933,464.344011,28,0
0,0,34,34,31,54,85,312,225,537,0.000333,1.147281,60,206510.576,11472.80978,3441.842933,464.344011,28,0
0,0,37,37,31,55,86,356,251,607,0.000333,1.300248,60,234044.5624,13002.47569,3900.742706,471.55487,28,0
0,0,37,37,31,55,86,356,251,607,0.000333,1.300248,60,234044.5624,13002.47569,3900.742706,471.55487,28,0
0,0,37,37,31,55,86,356,251,607,0.000333,1.300248,60,234044.5624,13002.47569,3900.742706,471.55487,28,0
0,0,37,37,31,55,86,356,251,607,0.000333,1.300248,60,234044.5624,13002.47569,3900.742706,471.55487,28,0
0,0,37,37,31,55,86,356,251,607,0.000333,1.300248,60,234044.5624,13002.47569,3900.742706,471.55487,28,0
0,0,37,37,31,55,86,356,251,607,0.000333,1.300248,60,234044.5624,13002.47569,3900.742706,471.55487,28,0
0,0,37,37,31,55,86,356,251,607,0.000333,1.300248,60,234044.5624,13002.47569,3900.742706,471.55487,28,0
0,0,37,37,31,55,86,356,251,607,0.000333,1.300248,60,234044.5624,13002.47569,3900.742706,471.55487,28,0
0,0,16,16,26,40,66,159,113,272,0.000333,0.548025,26,42745.95521,2374.77529,1644.0752,335.088556,20,0
0,0,16,16,26,40,66,159,113,272,0.000333,0.548025,26,42745.95521,2374.77529,1644.0752,335.088556,20,0
0,0,16,16,26,40,66,159,113,272,0.000333,0.548025,26,42745.95521,2374.77529,1644.0752,335.088556,20,0
0,0,16,16,26,40,66,159,113,272,0.000333,0.548025,26,42745.95521,2374.77529,1644.0752,335.088556,20,0
0,0,16,16,26,40,66,159,113,272,0.000333,0.548025,26,42745.95521,2374.77529,1644.0752,335.088556,20,0
0,0,16,16,26,40,66,159,113,272,0.000333,0.548025,26,42745.95521,2374.77529,1644.0752,335.088556,20,0
0,0,16,16,26,40,66,159,113,272,0.000333,0.548025,26,42745.95521,2374.77529,1644.0752,335.088556,20,0
0,0,16,16,26,40,66,159,113,272,0.000333,0.548025,26,42745.95521,2374.77529,1644.0752,335.088556,20,0
0,0,18,18,21,30,51,132,97,229,0.000333,0.432995,30,38969.5621,2164.975672,1298.985403,239.445384,5,0
0,0,18,18,21,30,51,132,97,229,0.000333,0.432995,30,38969.5621,2164.975672,1298.985403,239.445384,5,0
0,0,18,18,21,30,51,132,97,229,0.000333,0.432995,30,38969.5621,2164.975672,1298.985403,239.445384,5,0
0,0,18,18,21,30,51,132,97,229,0.000333,0.432995,30,38969.5621,2164.975672,1298.985403,239.445384,5,0
0,0,20,20,21,30,51,145,108,253,0.000333,0.478375,30,43053.70835,2391.872686,1435.123612,239.445384,6,0
0,0,20,20,21,30,51,145,108,253,0.000333,0.478375,30,43053.70835,2391.872686,1435.123612,239.445384,6,0
0,0,20,20,21,30,51,145,108,253,0.000333,0.478375,30,43053.70835,2391.872686,1435.123612,239.445384,6,0
0,0,20,20,21,30,51,145,108,253,0.000333,0.478375,30,43053.70835,2391.872686,1435.123612,239.445384,6,0
0,0,20,20,21,30,51,145,108,253,0.000333,0.478375,30,43053.70835,2391.872686,1435.123612,239.445384,6,0
0,0,20,20,21,30,51,145,108,253,0.000333,0.478375,30,43053.70835,2391.872686,1435.123612,239.445384,6,0
0,0,25,25,21,32,53,170,123,293,0.000333,0.559427,30,50348.4208,2797.134489,1678.280693,252.238666,5,0
0,0,26,26,21,32,53,172,125,297,0.000333,0.567064,30,51035.77125,2835.320625,1701.192375,252.238666,5,0
0,0,25,25,21,32,53,170,123,293,0.000333,0.559427,30,50348.4208,2797.134489,1678.280693,252.238666,5,0
0,0,26,26,21,32,53,172,125,297,0.000333,0.567064,30,51035.77125,2835.320625,1701.192375,252.238666,5,0
0,0,24,24,21,32,53,158,120,278,0.000333,0.530787,30,47770.85659,2653.936477,1592.361886,252.238666,7,0
0,0,25,25,21,32,53,160,122,282,0.000333,0.538425,30,48458.20705,2692.122614,1615.273568,252.238666,7,0
0,0,24,24,21,32,53,158,120,278,0.000333,0.530787,30,47770.85659,2653.936477,1592.361886,252.238666,7,0
0,0,25,25,21,32,53,160,122,282,0.000333,0.538425,30,48458.20705,2692.122614,1615.273568,252.238666,7,0
0,0,24,24,21,32,53,158,120,278,0.000333,0.530787,30,47770.85659,2653.936477,1592.361886,252.238666,7,0
0,0,25,25,21,32,53,160,122,282,0.000333,0.538425,30,48458.20705,2692.122614,1615.273568,252.238666,7,0
0,0,24,24,21,32,53,158,120,278,0.000333,0.530787,30,47770.85659,2653.936477,1592.361886,252.238666,7,0
0,0,25,25,21,32,53,160,122,282,0.000333,0.538425,30,48458.20705,2692.122614,1615.273568,252.238666,7,0
0,0,24,24,21,32,53,158,120,278,0.000333,0.530787,30,47770.85659,2653.936477,1592.361886,252.238666,7,0
0,0,25,25,21,32,53,160,122,282,0.000333,0.538425,30,48458.20705,2692.122614,1615.273568,252.238666,7,0
0,0,24,24,21,32,53,158,120,278,0.000333,0.530787,30,47770.85659,2653.936477,1592.361886,252.238666,7,0
0,0,25,25,21,32,53,160,122,282,0.000333,0.538425,30,48458.20705,2692.122614,1615.273568,252.238666,7,0
0,0,11,11,17,24,41,79,60,139,0.000333,0.248233,16,11915.19566,661.955314,744.699729,179.525968,3,0
0,0,10,10,17,24,41,77,58,135,0.000333,0.24109,16,11572.31233,642.906241,723.269521,179.525968,3,0
0,0,8,8,17,23,40,72,52,124,0.000333,0.219973,16,10558.70534,586.594741,659.919084,173.528793,3,0
0,0,8,8,17,23,40,72,52,124,0.000333,0.219973,16,10558.70534,586.594741,659.919084,173.528793,3,0
0,0,11,11,17,24,41,79,60,139,0.000333,0.248233,16,11915.19566,661.955314,744.699729,179.525968,3,0
0,0,10,10,17,24,41,77,58,135,0.000333,0.24109,16,11572.31233,642.906241,723.269521,179.525968,3,0
0,0,8,8,17,23,40,72,52,124,0.000333,0.219973,16,10558.70534,586.594741,659.919084,173.528793,3,0
0,0,8,8,17,23,40,72,52,124,0.000333,0.219973,16,10558.70534,586.594741,659.919084,173.528793,3,0
0,0,33,33,19,29,48,233,173,406,0.000333,0.755832,45,102037.2649,5668.736938,2267.494775,221.592072,7,0
0,0,33,33,19,29,48,233,173,406,0.000333,0.755832,45,102037.2649,5668.736938,2267.494775,221.592072,7,0
0,0,33,33,19,29,48,235,174,409,0.000333,0.761417,54,123349.4818,6852.748988,2284.249663,221.592072,7,0
0,0,33,33,19,29,48,235,174,409,0.000333,0.761417,54,123349.4818,6852.748988,2284.249663,221.592072,7,0
0,0,6,6,11,15,26,33,27,60,0.000333,0.094009,5,1410.131915,78.340662,282.026383,96.657107,2,0
0,0,5,5,10,15,25,33,28,61,0.000333,0.094425,5,1416.376138,78.687563,283.275228,91.82264,1,0
0,0,5,5,10,15,25,33,28,61,0.000333,0.094425,5,1416.376138,78.687563,283.275228,91.82264,1,0
0,0,5,5,10,15,25,33,28,61,0.000333,0.094425,5,1416.376138,78.687563,283.275228,91.82264,1,0
0,0,6,6,11,15,26,33,27,60,0.000333,0.094009,5,1410.131915,78.340662,282.026383,96.657107,2,0
0,0,5,5,9,10,19,20,17,37,0.000333,0.052391,4,628.693272,34.927404,157.173318,61.748606,2,0
0,0,5,5,10,15,25,33,28,61,0.000333,0.094425,5,1416.376138,78.687563,283.275228,91.82264,1,0
0,0,5,5,10,15,25,33,28,61,0.000333,0.094425,5,1416.376138,78.687563,283.275228,91.82264,1,0
0,0,5,5,10,15,25,33,28,61,0.000333,0.094425,5,1416.376138,78.687563,283.275228,91.82264,1,0
0,0,5,5,10,15,25,33,28,61,0.000333,0.094425,5,1416.376138,78.687563,283.275228,91.82264,1,0
0,0,5,5,10,15,25,33,28,61,0.000333,0.094425,5,1416.376138,78.687563,283.275228,91.82264,1,0
0,0,5,5,10,15,25,33,28,61,0.000333,0.094425,5,1416.376138,78.687563,283.275228,91.82264,1,0
0,0,5,5,10,15,25,33,28,61,0.000333,0.094425,5,1416.376138,78.687563,283.275228,91.82264,1,0
0,0,5,5,10,15,25,33,28,61,0.000333,0.094425,5,1416.376138,78.687563,283.275228,91.82264,1,0
0,0,5,5,10,15,25,33,28,61,0.000333,0.094425,5,1416.376138,78.687563,283.275228,91.82264,1,0
0,0,28,28,21,29,50,190,145,335,0.000333,0.630231,50,94534.59118,5251.921732,1890.691824,233.120115,5,0
0,0,30,30,21,30,51,194,149,343,0.000333,0.648547,40,77825.67569,4323.64865,1945.641892,239.445384,5,0
0,0,29,29,21,30,51,192,147,339,0.000333,0.640984,40,76918.08764,4273.227091,1922.952191,239.445384,5,0
0,0,28,28,21,29,50,190,145,335,0.000333,0.630231,50,94534.59118,5251.921732,1890.691824,233.120115,5,0
0,0,28,28,21,29,50,190,145,335,0.000333,0.630231,50,94534.59118,5251.921732,1890.691824,233.120115,5,0
0,0,30,30,21,30,51,194,149,343,0.000333,0.648547,40,77825.67569,4323.64865,1945.641892,239.445384,5,0
0,0,29,29,21,30,51,192,147,339,0.000333,0.640984,40,76918.08764,4273.227091,1922.952191,239.445384,5,0
0,0,28,28,21,29,50,190,145,335,0.000333,0.630231,50,94534.59118,5251.921732,1890.691824,233.120115,5,0
0,0,28,28,21,29,50,190,145,335,0.000333,0.630231,50,94534.59118,5251.921732,1890.691824,233.120115,5,0
0,0,30,30,21,30,51,194,149,343,0.000333,0.648547,40,77825.67569,4323.64865,1945.641892,239.445384,5,0
0,0,29,29,21,30,51,192,147,339,0.000333,0.640984,40,76918.08764,4273.227091,1922.952191,239.445384,5,0
0,0,28,28,21,29,50,190,145,335,0.000333,0.630231,50,94534.59118,5251.921732,1890.691824,233.120115,5,0
0,0,21,21,16,28,44,161,124,285,0.000333,0.518646,32,49790.01636,2766.11202,1555.938011,198.605938,2,0
0,0,23,23,16,29,45,165,128,293,0.000333,0.536371,32,51491.61463,2860.645257,1609.112957,204.881449,2,0
0,0,22,22,16,29,45,163,126,289,0.000333,0.529049,32,50788.65744,2821.59208,1587.145545,204.881449,2,0
0,0,21,21,16,28,44,161,124,285,0.000333,0.518646,32,49790.01636,2766.11202,1555.938011,198.605938,2,0
0,0,21,21,16,28,44,161,124,285,0.000333,0.518646,32,49790.01636,2766.11202,1555.938011,198.605938,2,0
0,0,23,23,16,29,45,165,128,293,0.000333,0.536371,32,51491.61463,2860.645257,1609.112957,204.881449,2,0
0,0,22,22,16,29,45,163,126,289,0.000333,0.529049,32,50788.65744,2821.59208,1587.145545,204.881449,2,0
0,0,21,21,16,28,44,161,124,285,0.000333,0.518646,32,49790.01636,2766.11202,1555.938011,198.605938,2,0
0,0,21,21,16,28,44,161,124,285,0.000333,0.518646,32,49790.01636,2766.11202,1555.938011,198.605938,2,0
0,0,23,23,16,29,45,165,128,293,0.000333,0.536371,32,51491.61463,2860.645257,1609.112957,204.881449,2,0
0,0,22,22,16,29,45,163,126,289,0.000333,0.529049,32,50788.65744,2821.59208,1587.145545,204.881449,2,0
0,0,21,21,16,28,44,161,124,285,0.000333,0.518646,32,49790.01636,2766.11202,1555.938011,198.605938,2,0
0,0,40,40,20,29,49,269,206,475,0.000333,0.888996,70,186689.1023,10371.6168,2666.987176,227.320011,5,0
0,0,40,40,20,29,49,269,206,475,0.000333,0.888996,70,186689.1023,10371.6168,2666.987176,227.320011,5,0
0,0,40,40,19,29,48,256,196,452,0.000333,0.841468,54,136317.7647,7573.209151,2524.40305,221.592072,5,0
0,0,40,40,19,29,48,256,196,452,0.000333,0.841468,54,136317.7647,7573.209151,2524.40305,221.592072,5,0
0,0,40,40,20,29,49,269,206,475,0.000333,0.888996,70,186689.1023,10371.6168,2666.987176,227.320011,5,0
0,0,40,40,20,29,49,269,206,475,0.000333,0.888996,70,186689.1023,10371.6168,2666.987176,227.320011,5,0
0,0,10,10,15,23,38,86,66,152,0.000333,0.265895,14,11167.58975,620.421653,797.684982,162.645284,2,0
0,0,9,9,15,23,38,84,64,148,0.000333,0.258898,14,10873.70581,604.094767,776.693272,162.645284,2,0
0,0,8,8,15,23,38,82,62,144,0.000333,0.251901,14,10579.82187,587.767882,755.701562,162.645284,2,0
0,0,8,8,15,23,38,82,62,144,0.000333,0.251901,14,10579.82187,587.767882,755.701562,162.645284,2,0
0,0,10,10,15,23,38,86,66,152,0.000333,0.265895,14,11167.58975,620.421653,797.684982,162.645284,2,0
0,0,9,9,15,23,38,84,64,148,0.000333,0.258898,14,10873.70581,604.094767,776.693272,162.645284,2,0
0,0,8,8,15,23,38,82,62,144,0.000333,0.251901,14,10579.82187,587.767882,755.701562,162.645284,2,0
0,0,8,8,15,23,38,82,62,144,0.000333,0.251901,14,10579.82187,587.767882,755.701562,162.645284,2,0
0,0,12,12,16,20,36,77,64,141,0.000333,0.242986,24,17495.02621,971.9459,728.959425,150.438562,3,0
0,0,10,10,16,21,37,73,60,133,0.000333,0.230952,16,11085.71676,615.873153,692.857298,156.238666,3,0
0,0,12,12,16,20,36,77,64,141,0.000333,0.242986,24,17495.02621,971.9459,728.959425,150.438562,3,0
0,0,8,8,13,20,33,63,51,114,0.000333,0.191687,12,6900.731155,383.373953,575.06093,134.544278,2,0
0,0,6,6,12,18,30,47,39,86,0.000333,0.140664,12,5063.911095,281.328394,421.992591,118.0782,2,0
0,0,8,8,12,19,31,71,58,129,0.000333,0.21303,18,11503.64383,639.091324,639.091324,123.730173,1,0
0,0,12,12,16,20,36,77,64,141,0.000333,0.242986,24,17495.02621,971.9459,728.959425,150.438562,3,0
0,0,10,10,16,21,37,74,60,134,0.000333,0.232689,16,11169.06802,620.503779,698.066751,156.238666,3,0
0,0,12,12,16,20,36,77,64,141,0.000333,0.242986,24,17495.02621,971.9459,728.959425,150.438562,3,0
0,0,8,8,13,20,33,64,51,115,0.000333,0.193368,12,6961.263885,386.736882,580.105324,134.544278,2,0
0,0,6,6,12,18,30,47,39,86,0.000333,0.140664,12,5063.911095,281.328394,421.992591,118.0782,2,0
0,0,8,8,12,19,31,72,58,130,0.000333,0.214682,18,11592.81937,644.04552,644.04552,123.730173,1,0
0,0,18,18,16,25,41,107,91,198,0.000333,0.353598,24,25459.08713,1414.393729,1060.795297,180.096405,3,0
0,0,18,18,16,25,41,107,91,198,0.000333,0.353598,24,25459.08713,1414.393729,1060.795297,180.096405,3,0
0,0,97,97,29,93,122,583,511,1094,0.000333,2.527409,70,530755.8653,29486.43696,7582.226647,749.023218,75,0
0,0,94,94,30,90,120,549,495,1044,0.000333,2.403598,75,540809.5336,30044.97409,7210.793782,731.473497,75,0
0,0,89,89,28,87,115,511,463,974,0.000333,2.222502,70,466725.5117,25929.19509,6667.50731,695.142022,72,0
0,0,93,93,29,87,116,567,495,1062,0.000333,2.427725,70,509822.3072,28323.46151,7283.175817,701.417533,76,0
0,0,88,88,29,87,116,538,472,1010,0.000333,2.308854,70,484859.2564,26936.62535,6926.560805,701.417533,72,0
0,0,94,94,30,90,120,549,495,1044,0.000333,2.403598,75,540809.5336,30044.97409,7210.793782,731.473497,75,0
0,0,89,89,28,87,115,511,463,974,0.000333,2.222502,70,466725.5117,25929.19509,6667.50731,695.142022,72,0
0,0,85,85,28,81,109,496,446,942,0.000333,2.12521,70,446294.0744,24794.11524,6375.629634,648.133788,66,0
0,0,5,5,11,17,28,34,30,64,0.000333,0.102557,5,1538.353575,85.464088,307.670715,107.540616,2,0
0,0,4,4,12,22,34,62,51,113,0.000333,0.191628,12,6898.599613,383.255534,574.883301,141.127046,1,0
0,0,5,5,11,17,28,34,30,64,0.000333,0.102557,5,1538.353575,85.464088,307.670715,107.540616,2,0
0,0,4,4,9,13,22,21,20,41,0.000333,0.060946,4,731.346785,40.630377,182.836696,76.635041,2,0
0,0,4,4,12,22,34,62,51,113,0.000333,0.191628,12,6898.599613,383.255534,574.883301,141.127046,1,0
0,0,4,4,12,22,34,62,51,113,0.000333,0.191628,12,6898.599613,383.255534,574.883301,141.127046,1,0
0,0,4,4,12,22,34,62,51,113,0.000333,0.191628,12,6898.599613,383.255534,574.883301,141.127046,1,0
0,0,5,5,11,17,28,34,30,64,0.000333,0.102557,5,1538.353575,85.464088,307.670715,107.540616,2,0
0,0,4,4,12,19,31,41,36,77,0.000333,0.127158,6,2288.838695,127.157705,381.473116,123.730173,1,0
0,0,4,4,12,19,31,41,36,77,0.000333,0.127158,6,2288.838695,127.157705,381.473116,123.730173,1,0
0,0,4,4,10,17,27,34,31,65,0.000333,0.103023,5,1545.338438,85.852135,309.067688,102.706149,1,0
0,0,5,5,11,17,28,34,30,64,0.000333,0.102557,5,1538.353575,85.464088,307.670715,107.540616,2,0
0,0,4,4,9,13,22,21,20,41,0.000333,0.060946,4,731.346785,40.630377,182.836696,76.635041,2,0
0,0,4,4,12,19,31,41,36,77,0.000333,0.127158,6,2288.838695,127.157705,381.473116,123.730173,1,0
0,0,4,4,12,19,31,41,36,77,0.000333,0.127158,6,2288.838695,127.157705,381.473116,123.730173,1,0
0,0,4,4,10,17,27,34,31,65,0.000333,0.103023,5,1545.338438,85.852135,309.067688,102.706149,1,0
0,0,4,4,12,19,31,41,36,77,0.000333,0.127158,6,2288.838695,127.157705,381.473116,123.730173,1,0
0,0,4,4,12,19,31,41,36,77,0.000333,0.127158,6,2288.838695,127.157705,381.473116,123.730173,1,0
0,0,4,4,10,17,27,34,31,65,0.000333,0.103023,5,1545.338438,85.852135,309.067688,102.706149,1,0
0,0,4,4,12,19,31,41,36,77,0.000333,0.127158,6,2288.838695,127.157705,381.473116,123.730173,1,0
0,0,4,4,12,19,31,41,36,77,0.000333,0.127158,6,2288.838695,127.157705,381.473116,123.730173,1,0
0,0,4,4,10,17,27,34,31,65,0.000333,0.103023,5,1545.338438,85.852135,309.067688,102.706149,1,0
0,0,14,14,21,20,41,87,71,158,0.000333,0.282164,30,25394.7965,1410.822028,846.493217,178.677228,6,0
0,0,7,7,18,14,32,50,41,91,0.000333,0.151667,18,8190,455,455,128.361619,5,0
0,0,7,7,15,15,30,45,38,83,0.000333,0.135757,14,5701.806872,316.767048,407.271919,117.206718,3,0
0,0,5,5,13,14,27,43,34,77,0.000333,0.122042,12,4393.516052,244.084225,366.126338,101.408685,3,0
0,0,4,4,11,11,22,27,23,50,0.000333,0.074324,10,2229.715809,123.873101,222.971581,76.107496,3,0
0,0,7,7,15,15,30,45,38,83,0.000333,0.135757,14,5701.806872,316.767048,407.271919,117.206718,3,0
0,0,5,5,13,14,27,43,34,77,0.000333,0.122042,12,4393.516052,244.084225,366.126338,101.408685,3,0
0,0,10,10,17,18,35,55,45,100,0.000333,0.170976,16,8206.852827,455.936268,512.928302,144.545518,4,0
0,0,7,7,18,14,32,50,41,91,0.000333,0.151667,18,8190,455,455,128.361619,5,0
0,0,4,4,11,11,22,27,23,50,0.000333,0.074324,10,2229.715809,123.873101,222.971581,76.107496,3,0
0,0,8,8,14,16,30,46,38,84,0.000333,0.137393,14,5770.50334,320.583519,412.17881,117.302969,3,0
0,0,5,5,13,14,27,43,34,77,0.000333,0.122042,12,4393.516052,244.084225,366.126338,101.408685,3,0
0,0,25,25,27,41,68,205,159,364,0.000333,0.738612,39,86417.62249,4800.979027,2215.836474,348.041595,24,0
0,0,15,15,23,34,57,156,121,277,0.000333,0.53857,33,53318.44762,2962.135979,1615.710534,277.015662,20,0
0,0,12,12,22,29,51,118,88,206,0.000333,0.389507,33,38561.14748,2142.285971,1168.51962,238.988944,18,0
0,0,30,30,29,48,77,270,193,463,0.000333,0.967174,56,162485.2414,9026.957857,2901.522168,408.959649,22,0
0,0,27,27,31,46,77,214,157,371,0.000333,0.774993,45,104624.0013,5812.444516,2324.977807,407.663936,19,0
0,0,27,27,30,47,77,240,169,409,0.000333,0.854372,45,115340.2063,6407.789238,2563.115695,408.272394,17,0
0,0,13,13,20,34,54,114,91,205,0.000333,0.393251,20,23595.03876,1310.835487,1179.751938,259.412299,13,0
0,0,14,14,21,38,59,126,101,227,0.000333,0.44512,20,26707.19944,1483.733302,1335.359972,291.659911,13,0
0,0,21,21,28,36,64,184,124,308,0.000333,0.616,42,77616,4312,1848,320.723238,7,0
0,0,15,15,23,34,57,156,121,277,0.000333,0.53857,33,53318.44762,2962.135979,1615.710534,277.015662,20,0
0,0,13,13,20,34,54,114,91,205,0.000333,0.393251,20,23595.03876,1310.835487,1179.751938,259.412299,13,0
0,0,14,14,21,38,59,126,101,227,0.000333,0.44512,20,26707.19944,1483.733302,1335.359972,291.659911,13,0
0,0,7,7,16,17,33,40,31,71,0.000333,0.119384,8,2865.21586,159.178659,358.151982,133.486868,5,0
0,0,7,7,16,17,33,40,31,71,0.000333,0.119384,8,2865.21586,159.178659,358.151982,133.486868,5,0
0,0,21,21,28,36,64,184,124,308,0.000333,0.616,42,77616,4312,1848,320.723238,7,0
0,0,18,18,23,35,58,156,119,275,0.000333,0.536982,33,53161.17753,2953.398752,1610.944774,283.566831,20,0
0,0,12,12,22,29,51,118,88,206,0.000333,0.389507,33,38561.14748,2142.285971,1168.51962,238.988944,18,0
0,0,26,26,29,44,73,229,156,385,0.000333,0.794361,42,100089.4631,5560.525729,2383.082455,381.09644,19,0
0,0,28,28,31,50,81,216,158,374,0.000333,0.790368,45,106699.6755,5927.759753,2371.103901,435.772895,18,0
0,0,24,24,29,43,72,203,137,340,0.000333,0.699258,42,88106.52902,4894.807168,2097.7745,374.210833,15,0
0,0,15,15,23,34,57,156,121,277,0.000333,0.53857,33,53318.44762,2962.135979,1615.710534,277.015662,20,0
0,0,8,8,17,18,35,53,37,90,0.000333,0.153878,16,7386.167544,410.342641,461.635472,144.545518,8,0
0,0,25,25,24,38,62,198,134,332,0.000333,0.658931,36,71164.5543,3953.58635,1976.793175,309.460346,6,0
0,0,54,54,22,50,72,236,145,381,0.000333,0.78358,22,51716.31136,2873.128409,2350.741426,380.300305,21,0
0,0,54,54,22,49,71,236,145,381,0.000333,0.781018,22,51547.18036,2863.732242,2343.053653,373.228278,21,0
0,0,54,54,22,48,70,230,141,371,0.000333,0.757988,22,50027.20798,2779.289332,2273.963999,366.185696,21,0
1,0,6,7,15,25,40,77,39,116,0.000333,0.205781,7,4321.405613,240.07809,617.343659,174.699764,2,0
1,0,3,4,12,16,28,35,27,62,0.000333,0.099352,6,1788.336031,99.352002,298.056005,107.01955,1,0
1,0,11,12,19,28,47,63,42,105,0.000333,0.194411,9,5249.086465,291.615915,583.231829,215.316561,14,0
1,0,10,11,21,26,47,56,42,98,0.000333,0.18145,10,5443.497075,302.416504,544.349707,214.450099,11,0
1,0,8,9,17,25,42,42,33,75,0.000333,0.134808,8,3235.390454,179.743914,404.423807,185.583273,9,0
1,0,6,7,16,19,35,30,23,53,0.000333,0.090617,8,2174.815999,120.823111,271.852,144.710623,7,0
1,0,6,7,14,20,34,34,27,61,0.000333,0.103445,7,2172.346633,120.685924,310.335233,139.741531,8,0
1,0,8,9,18,26,44,43,35,78,0.000333,0.141945,9,3832.520996,212.917833,425.835666,197.270083,9,0
1,0,6,7,17,20,37,31,25,56,0.000333,0.097243,8,2333.835108,129.657506,291.729388,155.92543,7,0
1,0,6,7,15,22,37,35,29,64,0.000333,0.111135,7,2333.835108,129.657506,333.405015,156.710855,8,0
1,0,9,10,20,23,43,51,39,90,0.000333,0.162788,10,4883.638279,271.313238,488.363828,190.480487,10,0
1,0,6,7,16,19,35,30,23,53,0.000333,0.090617,8,2174.815999,120.823111,271.852,144.710623,7,0
1,0,6,7,14,21,35,34,27,61,0.000333,0.104295,7,2190.203848,121.677992,312.886264,145.541635,8,0
1,0,8,9,17,25,42,42,33,75,0.000333,0.134808,8,3235.390454,179.743914,404.423807,185.583273,9,0
1,0,6,7,16,20,36,30,24,54,0.000333,0.093059,8,2233.407601,124.0782,279.17595,150.438562,7,0
1,0,6,7,14,21,35,34,27,61,0.000333,0.104295,7,2190.203848,121.677992,312.886264,145.541635,8,0
1,0,8,9,18,27,45,50,37,87,0.000333,0.159264,9,4300.120974,238.89561,477.791219,203.440613,10,0
1,0,8,9,21,26,47,55,38,93,0.000333,0.172192,10,5165.767632,286.987091,516.576763,214.450099,11,0
1,0,8,9,17,26,43,49,36,85,0.000333,0.153744,8,3689.860033,204.992224,461.232504,191.698301,10,0
1,0,6,7,18,18,36,31,26,57,0.000333,0.098229,9,2652.171526,147.342863,294.685725,150.1173,8,0
1,0,4,5,11,14,25,18,18,36,0.000333,0.055726,5,835.894114,46.438562,167.178823,91.356717,5,0
1,0,3,4,10,12,22,15,13,28,0.000333,0.041621,5,624.320427,34.684468,124.864085,76.238831,5,0
1,0,8,9,17,25,42,42,33,75,0.000333,0.134808,8,3235.390454,179.743914,404.423807,185.583273,9,0
1,0,6,7,16,19,35,30,23,53,0.000333,0.090617,8,2174.815999,120.823111,271.852,144.710623,7,0
1,0,6,7,14,20,34,34,27,61,0.000333,0.103445,7,2172.346633,120.685924,310.335233,139.741531,8,0
1,0,8,9,18,26,44,43,35,78,0.000333,0.141945,9,3832.520996,212.917833,425.835666,197.270083,9,0
1,0,6,7,17,20,37,31,25,56,0.000333,0.097243,8,2333.835108,129.657506,291.729388,155.92543,7,0
1,0,6,7,15,22,37,35,29,64,0.000333,0.111135,7,2333.835108,129.657506,333.405015,156.710855,8,0
1,0,9,10,20,23,43,51,39,90,0.000333,0.162788,10,4883.638279,271.313238,488.363828,190.480487,10,0
1,0,6,7,16,19,35,30,23,53,0.000333,0.090617,8,2174.815999,120.823111,271.852,144.710623,7,0
1,0,6,7,14,21,35,34,27,61,0.000333,0.104295,7,2190.203848,121.677992,312.886264,145.541635,8,0
1,0,8,9,17,25,42,42,33,75,0.000333,0.134808,8,3235.390454,179.743914,404.423807,185.583273,9,0
1,0,6,7,16,20,36,30,24,54,0.000333,0.093059,8,2233.407601,124.0782,279.17595,150.438562,7,0
1,0,6,7,14,21,35,34,27,61,0.000333,0.104295,7,2190.203848,121.677992,312.886264,145.541635,8,0
1,0,8,9,17,26,43,49,35,84,0.000333,0.151935,8,3646.449915,202.580551,455.806239,191.698301,10,0
1,0,8,9,21,26,47,55,38,93,0.000333,0.172192,10,5165.767632,286.987091,516.576763,214.450099,11,0
1,0,8,9,17,26,43,49,36,85,0.000333,0.153744,8,3689.860033,204.992224,461.232504,191.698301,10,0
1,0,10,11,20,25,45,55,43,98,0.000333,0.179401,10,5382.016034,299.000891,538.201603,202.534967,10,0
1,0,9,10,20,23,43,51,39,90,0.000333,0.162788,10,4883.638279,271.313238,488.363828,190.480487,10,0
1,0,8,9,17,25,42,42,33,75,0.000333,0.134808,8,3235.390454,179.743914,404.423807,185.583273,9,0
1,0,6,7,16,19,35,30,23,53,0.000333,0.090617,8,2174.815999,120.823111,271.852,144.710623,7,0
1,0,6,7,14,20,34,34,27,61,0.000333,0.103445,7,2172.346633,120.685924,310.335233,139.741531,8,0
1,0,8,9,18,26,44,43,35,78,0.000333,0.141945,9,3832.520996,212.917833,425.835666,197.270083,9,0
1,0,6,7,17,20,37,31,25,56,0.000333,0.097243,8,2333.835108,129.657506,291.729388,155.92543,7,0
1,0,6,7,15,22,37,35,29,64,0.000333,0.111135,7,2333.835108,129.657506,333.405015,156.710855,8,0
1,0,9,10,20,23,43,51,39,90,0.000333,0.162788,10,4883.638279,271.313238,488.363828,190.480487,10,0
1,0,6,7,16,19,35,30,23,53,0.000333,0.090617,8,2174.815999,120.823111,271.852,144.710623,7,0
1,0,6,7,14,21,35,34,27,61,0.000333,0.104295,7,2190.203848,121.677992,312.886264,145.541635,8,0
1,0,8,9,17,25,42,42,33,75,0.000333,0.134808,8,3235.390454,179.743914,404.423807,185.583273,9,0
1,0,6,7,16,20,36,30,24,54,0.000333,0.093059,8,2233.407601,124.0782,279.17595,150.438562,7,0
1,0,6,7,14,21,35,34,27,61,0.000333,0.104295,7,2190.203848,121.677992,312.886264,145.541635,8,0
1,0,8,9,17,26,43,49,35,84,0.000333,0.151935,8,3646.449915,202.580551,455.806239,191.698301,10,0
1,0,8,9,18,27,45,50,37,87,0.000333,0.159264,9,4300.120974,238.89561,477.791219,203.440613,10,0
1,0,8,9,17,26,43,49,36,85,0.000333,0.153744,8,3689.860033,204.992224,461.232504,191.698301,10,0
1,0,6,7,18,18,36,31,26,57,0.000333,0.098229,9,2652.171526,147.342863,294.685725,150.1173,8,0
1,0,4,5,11,14,25,18,18,36,0.000333,0.055726,5,835.894114,46.438562,167.178823,91.356717,5,0
1,0,3,4,10,12,22,15,13,28,0.000333,0.041621,5,624.320427,34.684468,124.864085,76.238831,5,0
1,0,8,9,17,25,42,42,33,75,0.000333,0.134808,8,3235.390454,179.743914,404.423807,185.583273,9,0
1,0,6,7,16,19,35,30,23,53,0.000333,0.090617,8,2174.815999,120.823111,271.852,144.710623,7,0
1,0,6,7,14,20,34,34,27,61,0.000333,0.103445,7,2172.346633,120.685924,310.335233,139.741531,8,0
1,0,8,9,18,26,44,43,35,78,0.000333,0.141945,9,3832.520996,212.917833,425.835666,197.270083,9,0
1,0,6,7,17,20,37,31,25,56,0.000333,0.097243,8,2333.835108,129.657506,291.729388,155.92543,7,0
1,0,6,7,15,22,37,35,29,64,0.000333,0.111135,7,2333.835108,129.657506,333.405015,156.710855,8,0
1,0,9,10,20,23,43,51,39,90,0.000333,0.162788,10,4883.638279,271.313238,488.363828,190.480487,10,0
1,0,6,7,16,19,35,30,23,53,0.000333,0.090617,8,2174.815999,120.823111,271.852,144.710623,7,0
1,0,6,7,14,21,35,34,27,61,0.000333,0.104295,7,2190.203848,121.677992,312.886264,145.541635,8,0
1,0,8,9,17,25,42,42,33,75,0.000333,0.134808,8,3235.390454,179.743914,404.423807,185.583273,9,0
1,0,6,7,16,20,36,30,24,54,0.000333,0.093059,8,2233.407601,124.0782,279.17595,150.438562,7,0
1,0,6,7,14,21,35,34,27,61,0.000333,0.104295,7,2190.203848,121.677992,312.886264,145.541635,8,0
1,0,8,9,17,26,43,49,35,84,0.000333,0.151935,8,3646.449915,202.580551,455.806239,191.698301,10,0
1,0,8,9,18,27,45,50,37,87,0.000333,0.159264,9,4300.120974,238.89561,477.791219,203.440613,10,0
1,0,8,9,21,26,47,55,38,93,0.000333,0.172192,10,5165.767632,286.987091,516.576763,214.450099,11,0
1,0,6,7,18,18,36,31,26,57,0.000333,0.098229,9,2652.171526,147.342863,294.685725,150.1173,8,0
1,0,4,5,11,14,25,18,18,36,0.000333,0.055726,5,835.894114,46.438562,167.178823,91.356717,5,0
1,0,3,4,10,12,22,15,13,28,0.000333,0.041621,5,624.320427,34.684468,124.864085,76.238831,5,0
0,0,6,6,14,14,28,27,22,49,0.000333,0.07852,7,1648.922738,91.606819,235.560391,106.605938,2,0
0,0,4,4,9,10,19,17,15,32,0.000333,0.045311,4,543.734722,30.207485,135.93368,61.748606,2,0
0,0,10,10,14,33,47,59,47,106,0.000333,0.196262,7,4121.504928,228.972496,588.786418,219.767975,5,0
0,0,10,10,14,33,47,59,47,106,0.000333,0.196262,7,4121.504928,228.972496,588.786418,219.767975,5,0
0,0,9,9,14,26,40,50,37,87,0.000333,0.154336,7,3241.05421,180.058567,463.007744,175.514402,3,0
0,0,8,8,14,27,41,46,37,83,0.000333,0.148226,7,3112.737715,172.929873,444.676816,181.684931,2,0
0,0,7,7,13,24,37,41,33,74,0.000333,0.1285,6,2312.997294,128.49985,385.499549,158.144816,3,0
0,0,7,7,13,24,37,41,33,74,0.000333,0.1285,6,2312.997294,128.49985,385.499549,158.144816,3,0
0,0,6,6,13,21,34,34,28,62,0.000333,0.105141,6,1892.536177,105.140899,315.422696,140.344382,2,0
0,0,7,7,13,22,35,27,25,52,0.000333,0.088908,6,1600.336301,88.907572,266.722717,146.213212,3,0
0,0,7,7,13,22,35,27,25,52,0.000333,0.088908,6,1600.336301,88.907572,266.722717,146.213212,3,0
0,0,17,17,22,41,63,82,72,154,0.000333,0.306834,11,10125.51219,562.528455,920.501108,317.767128,3,0
0,0,17,17,22,41,63,82,72,154,0.000333,0.306834,11,10125.51219,562.528455,920.501108,317.767128,3,0
0,0,7,7,11,22,33,31,27,58,0.000333,0.097525,5,1462.874295,81.270794,292.574859,136.161243,1,0
0,0,12,12,18,31,49,61,50,111,0.000333,0.207744,9,5609.095134,311.616396,623.232793,228.638736,2,0
0,0,8,8,16,27,43,51,34,85,0.000333,0.153744,8,3689.860033,204.992224,461.232504,192.381963,7,0
0,0,8,8,16,27,43,51,34,85,0.000333,0.153744,8,3689.860033,204.992224,461.232504,192.381963,7,0
0,0,7,7,16,24,40,54,36,90,0.000333,0.159658,8,3831.788228,212.877124,478.973529,174.0391,6,0
0,0,7,7,13,22,35,27,25,52,0.000333,0.088908,6,1600.336301,88.907572,266.722717,146.213212,3,0
0,0,7,7,13,22,35,27,25,52,0.000333,0.088908,6,1600.336301,88.907572,266.722717,146.213212,3,0
0,0,7,7,13,23,36,31,27,58,0.000333,0.099952,6,1799.133901,99.951883,299.85565,152.147641,3,0
0,0,7,7,13,23,36,31,27,58,0.000333,0.099952,6,1799.133901,99.951883,299.85565,152.147641,3,0
0,0,6,6,13,23,36,30,26,56,0.000333,0.096505,6,1737.0948,96.505267,289.5158,152.147641,2,0
0,0,7,7,15,25,40,43,32,75,0.000333,0.133048,7,2794.01225,155.222903,399.144607,174.699764,4,0
0,0,7,7,15,25,40,43,32,75,0.000333,0.133048,7,2794.01225,155.222903,399.144607,174.699764,4,0
0,0,16,16,23,37,60,93,74,167,0.000333,0.328817,22,21701.91605,1205.662003,986.450729,296.7917,3,0
0,0,7,7,15,25,40,43,32,75,0.000333,0.133048,7,2794.01225,155.222903,399.144607,174.699764,4,0
0,0,7,7,15,25,40,43,32,75,0.000333,0.133048,7,2794.01225,155.222903,399.144607,174.699764,4,0
0,0,16,16,23,37,60,93,74,167,0.000333,0.328817,22,21701.91605,1205.662003,986.450729,296.7917,3,0
0,0,19,19,26,49,75,115,85,200,0.000333,0.415255,13,16194.9286,899.718255,1245.763738,397.332215,4,0
0,0,18,18,26,49,75,112,82,194,0.000333,0.402797,13,15709.08074,872.726708,1208.390826,397.332215,4,0
0,0,20,20,26,52,78,120,90,210,0.000333,0.439978,13,17159.14806,953.286003,1319.934466,418.634298,4,0
0,0,19,19,26,49,75,115,85,200,0.000333,0.415255,13,16194.9286,899.718255,1245.763738,397.332215,4,0
0,0,5,5,9,13,22,13,14,27,0.000333,0.040135,4,481.618615,26.75659,120.404654,76.635041,2,0
0,0,6,6,11,22,33,27,25,52,0.000333,0.087436,5,1311.542471,72.863471,262.308494,136.161243,2,0
0,0,6,6,11,22,33,27,25,52,0.000333,0.087436,5,1311.542471,72.863471,262.308494,136.161243,2,0
0,0,15,15,19,37,56,89,67,156,0.000333,0.301982,9,8153.526311,452.973684,905.947368,273.460397,4,0
0,0,15,15,19,37,56,89,67,156,0.000333,0.301982,9,8153.526311,452.973684,905.947368,273.460397,4,0
0,0,19,19,26,49,75,115,85,200,0.000333,0.415255,13,16194.9286,899.718255,1245.763738,397.332215,4,0
0,0,18,18,26,49,75,112,82,194,0.000333,0.402797,13,15709.08074,872.726708,1208.390826,397.332215,4,0
0,0,20,20,26,52,78,120,90,210,0.000333,0.439978,13,17159.14806,953.286003,1319.934466,418.634298,4,0
0,0,19,19,26,49,75,115,85,200,0.000333,0.415255,13,16194.9286,899.718255,1245.763738,397.332215,4,0
0,0,7,7,13,26,39,39,34,73,0.000333,0.128611,6,2315.006172,128.611454,385.834362,170.317149,3,0
0,0,7,7,13,26,39,39,34,73,0.000333,0.128611,6,2315.006172,128.611454,385.834362,170.317149,3,0
0,0,6,6,14,25,39,39,32,71,0.000333,0.125088,7,2626.844903,145.935828,375.263558,169.399374,2,0
0,0,7,7,13,26,39,39,34,73,0.000333,0.128611,6,2315.006172,128.611454,385.834362,170.317149,3,0
0,0,7,7,13,26,39,39,34,73,0.000333,0.128611,6,2315.006172,128.611454,385.834362,170.317149,3,0
0,0,6,6,14,25,39,39,32,71,0.000333,0.125088,7,2626.844903,145.935828,375.263558,169.399374,2,0
0,0,8,8,13,24,37,32,30,62,0.000333,0.107662,6,1937.916652,107.662036,322.986109,158.144816,2,0
0,0,7,7,13,21,34,27,25,52,0.000333,0.088183,6,1587.288406,88.182689,264.548068,140.344382,2,0
0,0,4,4,6,7,13,7,9,16,0.000333,0.019736,3,177.621106,9.867839,59.207035,35.161259,1,0
0,0,4,4,7,9,16,11,11,22,0.000333,0.029333,3,264,14.666667,88,48.180809,1,0
0,0,12,12,13,28,41,58,45,103,0.000333,0.183943,6,3310.967139,183.942619,551.827856,182.711654,4,0
0,0,15,15,19,27,46,61,45,106,0.000333,0.195166,9,5269.478106,292.748784,585.497567,209.092585,5,0
0,0,12,12,15,31,46,66,47,113,0.000333,0.208054,7,4369.137507,242.729862,624.162501,212.183445,12,0
0,0,11,11,15,30,45,60,43,103,0.000333,0.188554,7,3959.626082,219.979227,565.660869,205.810077,12,0
0,0,8,8,14,19,33,37,27,64,0.000333,0.107614,7,2259.888565,125.549365,322.841224,134.013592,4,0
0,0,7,7,16,21,37,38,28,66,0.000333,0.114608,8,2750.591377,152.810632,343.823922,156.238666,3,0
0,0,3,3,9,9,18,13,10,23,0.000333,0.031969,4,383.6331,21.31295,95.908275,57.05865,1,0
0,0,29,29,20,45,65,115,116,231,0.000333,0.463722,20,27823.3393,1545.741072,1391.166965,333.571951,7,0
0,0,27,27,20,44,64,108,110,218,0.000333,0.436,20,26160,1453.333333,1308,326.653553,7,0
0,0,22,22,18,41,59,98,94,192,0.000333,0.376489,18,20330.41438,1129.467465,1129.467465,294.718282,7,0
0,0,10,10,11,26,37,47,45,92,0.000333,0.159757,5,2396.348548,133.130475,479.26971,160.26518,5,0
0,0,3,3,8,10,18,11,11,22,0.000333,0.030579,4,366.9534,20.3863,91.73835,57.219281,1,0
0,0,21,21,18,41,59,95,91,186,0.000333,0.364724,18,19695.08893,1094.171607,1094.171607,294.718282,6,0
0,0,10,10,11,26,37,47,45,92,0.000333,0.159757,5,2396.348548,133.130475,479.26971,160.26518,5,0
0,0,4,4,10,11,21,17,13,30,0.000333,0.043923,5,658.847613,36.602645,131.769523,71.273029,2,0
0,0,3,3,9,9,18,13,10,23,0.000333,0.031969,4,383.6331,21.31295,95.908275,57.05865,2,0
0,0,20,20,18,41,59,92,88,180,0.000333,0.352959,18,19059.76348,1058.875749,1058.875749,294.718282,6,0
0,0,10,10,11,26,37,47,45,92,0.000333,0.159757,5,2396.348548,133.130475,479.26971,160.26518,5,0
0,0,4,4,10,11,21,17,13,30,0.000333,0.043923,5,658.847613,36.602645,131.769523,71.273029,2,0
0,0,3,3,9,9,18,13,10,23,0.000333,0.031969,4,383.6331,21.31295,95.908275,57.05865,2,0
0,0,19,19,18,41,59,89,85,174,0.000333,0.341193,18,18424.43803,1023.579891,1023.579891,294.718282,6,0
0,0,10,10,11,26,37,47,45,92,0.000333,0.159757,5,2396.348548,133.130475,479.26971,160.26518,5,0
0,0,3,3,8,10,18,11,11,22,0.000333,0.030579,4,366.9534,20.3863,91.73835,57.219281,1,0
0,0,18,18,18,41,59,86,82,168,0.000333,0.329428,18,17789.11258,988.284032,988.284032,294.718282,6,0
0,0,10,10,11,26,37,47,45,92,0.000333,0.159757,5,2396.348548,133.130475,479.26971,160.26518,5,0
0,0,17,17,18,41,59,83,79,162,0.000333,0.317663,9,8576.893566,476.494087,952.988174,294.718282,6,0
0,0,10,10,11,26,37,47,45,92,0.000333,0.159757,5,2396.348548,133.130475,479.26971,160.26518,5,0
0,0,18,18,24,38,62,86,63,149,0.000333,0.295725,12,10646.103,591.450167,887.17525,309.460346,6,0
0,0,18,18,21,39,60,88,67,155,0.000333,0.305189,10,9155.680423,508.648912,915.568042,298.369352,8,0
0,0,18,18,21,38,59,89,67,156,0.000333,0.305897,10,9176.923157,509.829064,917.692316,291.659911,8,0
0,0,16,16,21,30,51,72,55,127,0.000333,0.240133,10,7203.980184,400.221121,720.398018,239.445384,6,0
0,0,19,19,24,39,63,105,79,184,0.000333,0.366607,24,26395.66814,1466.426008,1099.819506,316.169787,9,0
0,0,19,19,24,38,62,106,79,185,0.000333,0.367175,24,26436.63162,1468.701757,1101.526317,309.460346,9,0
0,0,17,17,24,33,57,86,66,152,0.000333,0.295533,24,21278.38277,1182.132376,886.599282,276.504106,7,0
0,0,16,16,25,38,63,99,75,174,0.000333,0.346682,12,12480.56048,693.364471,1040.046707,315.51765,7,0
0,0,16,16,25,38,63,99,75,174,0.000333,0.346682,12,12480.56048,693.364471,1040.046707,315.51765,7,0
0,0,25,25,31,42,73,126,95,221,0.000333,0.455984,30,41038.53683,2279.918713,1367.951228,380.057417,6,0
0,0,24,24,31,42,73,122,93,215,0.000333,0.443604,30,39924.36841,2218.020467,1330.81228,380.057417,6,0
0,0,29,29,32,56,88,150,118,268,0.000333,0.577043,32,55396.08556,3077.560309,1731.127674,485.211876,10,0
0,0,27,27,32,51,83,134,105,239,0.000333,0.507878,32,48756.30157,2708.683421,1523.634424,449.293692,8,0
0,0,7,7,16,20,36,37,27,64,0.000333,0.110292,8,2647.001601,147.055644,330.8752,150.438562,3,0
0,0,7,7,16,20,36,37,27,64,0.000333,0.110292,8,2647.001601,147.055644,330.8752,150.438562,3,0
0,0,4,4,10,13,23,15,15,30,0.000333,0.045236,5,678.534293,37.69635,135.706859,81.324997,1,0
0,0,3,3,8,11,19,12,12,24,0.000333,0.033983,4,407.801041,22.655613,101.95026,62.053748,1,0
0,0,5,5,10,12,22,21,17,38,0.000333,0.056486,5,847.292008,47.071778,169.458402,76.238831,2,0
0,0,4,4,10,10,20,17,14,31,0.000333,0.04466,5,669.898855,37.216603,133.979771,66.438562,2,0
0,0,13,13,18,22,40,43,35,78,0.000333,0.13837,9,3735.993523,207.555196,415.110391,173.166146,3,0
0,0,4,4,10,13,23,15,15,30,0.000333,0.045236,5,678.534293,37.69635,135.706859,81.324997,1,0
0,0,3,3,8,11,19,12,12,24,0.000333,0.033983,4,407.801041,22.655613,101.95026,62.053748,1,0
0,0,4,4,10,10,20,17,14,31,0.000333,0.04466,5,669.898855,37.216603,133.979771,66.438562,2,0
0,0,3,3,8,11,19,12,12,24,0.000333,0.033983,4,407.801041,22.655613,101.95026,62.053748,1,0
0,0,4,4,10,13,23,15,15,30,0.000333,0.045236,5,678.534293,37.69635,135.706859,81.324997,1,0
0,0,3,3,8,11,19,12,12,24,0.000333,0.033983,4,407.801041,22.655613,101.95026,62.053748,1,0
0,0,4,4,8,7,15,11,10,21,0.000333,0.027348,4,328.17881,18.232156,82.044703,43.651484,2,0
0,0,4,4,8,9,17,12,12,24,0.000333,0.0327,4,392.396433,21.799802,98.099108,52.529325,3,0
1,0,30,31,29,44,73,148,130,278,0.000333,0.57359,28,48181.59437,2676.755243,1720.771227,381.09644,11,0
1,0,109,110,33,64,97,467,300,767,0.000333,1.687378,64,323976.5216,17998.69564,5062.13315,550.465006,43,0
0,0,24,24,27,36,63,120,107,227,0.000333,0.452281,26,35277.90611,1959.883673,1356.842543,314.499263,8,0
0,0,24,24,27,36,63,120,107,227,0.000333,0.452281,26,35277.90611,1959.883673,1356.842543,314.499263,8,0
0,0,33,33,30,46,76,220,191,411,0.000333,0.855966,60,154073.8925,8559.660693,2567.898208,401.290568,18,0
0,0,22,22,27,33,60,110,97,207,0.000333,0.407575,26,31790.88519,1766.160288,1222.726353,294.846968,8,0
0,0,22,22,27,33,60,110,97,207,0.000333,0.407575,26,31790.88519,1766.160288,1222.726353,294.846968,8,0
0,0,6,6,13,16,29,44,31,75,0.000333,0.12145,6,2186.091448,121.449525,364.348575,112.105716,8,0
0,0,6,6,13,16,29,44,31,75,0.000333,0.12145,6,2186.091448,121.449525,364.348575,112.105716,8,0
0,0,6,6,13,16,29,44,31,75,0.000333,0.12145,6,2186.091448,121.449525,364.348575,112.105716,8,0
0,0,5,5,10,10,20,18,14,32,0.000333,0.046101,5,691.508495,38.417139,138.301699,66.438562,3,0
0,0,3,3,8,7,15,12,9,21,0.000333,0.027348,4,328.17881,18.232156,82.044703,43.651484,1,0
0,0,4,4,12,17,29,25,23,48,0.000333,0.077728,6,1399.098527,77.727696,233.183088,112.506418,4,0
0,0,4,4,12,17,29,25,23,48,0.000333,0.077728,6,1399.098527,77.727696,233.183088,112.506418,4,0
0,0,27,27,16,31,47,145,84,229,0.000333,0.424,16,20352.01355,1130.66742,1272.000847,217.580086,21,0
0,0,26,26,16,30,46,144,82,226,0.000333,0.416108,16,19973.20003,1109.622224,1248.325002,211.206718,21,0
0,0,23,23,15,28,43,133,75,208,0.000333,0.376221,14,15801.28297,877.849054,1128.663069,193.209297,21,0
0,0,22,22,14,28,42,127,71,198,0.000333,0.355893,14,14947.5039,830.416883,1067.67885,187.908907,20,0
0,0,23,23,16,31,47,117,72,189,0.000333,0.349939,16,16797.07669,933.170927,1049.817293,217.580086,17,0
0,0,22,22,16,30,46,116,70,186,0.000333,0.342461,16,16438.12038,913.22891,1027.382524,211.206718,17,0
0,0,19,19,15,28,43,105,63,168,0.000333,0.303871,14,12762.5747,709.031928,911.612479,193.209297,17,0
0,0,18,18,14,28,42,99,59,158,0.000333,0.283995,14,11927.80614,662.655897,851.986153,187.908907,16,0
0,0,16,16,16,32,48,72,53,125,0.000333,0.232707,8,5584.962501,310.275694,698.120313,224,9,0
0,0,15,15,16,31,47,71,51,122,0.000333,0.225887,8,5421.278719,301.182151,677.65984,217.580086,9,0
0,0,12,12,15,29,44,60,44,104,0.000333,0.18926,7,3974.466218,220.803679,567.780888,199.484808,9,0
0,0,11,11,14,29,43,54,40,94,0.000333,0.170023,7,3570.482209,198.360123,510.068887,194.184418,8,0
0,0,19,19,15,26,41,106,59,165,0.000333,0.294665,14,12375.94513,687.552507,883.996081,180.814792,17,0
0,0,12,12,15,27,42,61,40,101,0.000333,0.181541,7,3812.368418,211.798245,544.62406,186.985321,9,0
0,0,27,27,16,31,47,145,84,229,0.000333,0.424,16,20352.01355,1130.66742,1272.000847,217.580086,21,0
0,0,26,26,16,30,46,144,82,226,0.000333,0.416108,16,19973.20003,1109.622224,1248.325002,211.206718,21,0
0,0,23,23,15,28,43,133,75,208,0.000333,0.376221,14,15801.28297,877.849054,1128.663069,193.209297,21,0
0,0,22,22,14,28,42,127,71,198,0.000333,0.355893,14,14947.5039,830.416883,1067.67885,187.908907,20,0
0,0,23,23,16,31,47,117,72,189,0.000333,0.349939,16,16797.07669,933.170927,1049.817293,217.580086,17,0
0,0,22,22,16,30,46,116,70,186,0.000333,0.342461,16,16438.12038,913.22891,1027.382524,211.206718,17,0
0,0,19,19,15,28,43,105,63,168,0.000333,0.303871,14,12762.5747,709.031928,911.612479,193.209297,17,0
0,0,18,18,14,28,42,99,59,158,0.000333,0.283995,14,11927.80614,662.655897,851.986153,187.908907,16,0
0,0,16,16,16,32,48,72,53,125,0.000333,0.232707,8,5584.962501,310.275694,698.120313,224,9,0
0,0,15,15,16,31,47,71,51,122,0.000333,0.225887,8,5421.278719,301.182151,677.65984,217.580086,9,0
0,0,12,12,15,29,44,60,44,104,0.000333,0.18926,7,3974.466218,220.803679,567.780888,199.484808,9,0
0,0,11,11,14,29,43,54,40,94,0.000333,0.170023,7,3570.482209,198.360123,510.068887,194.184418,8,0
0,0,23,23,15,26,41,134,71,205,0.000333,0.366099,14,15376.17425,854.231903,1098.298161,180.814792,21,0
0,0,12,12,15,27,42,61,40,101,0.000333,0.181541,7,3812.368418,211.798245,544.62406,186.985321,9,0
0,0,27,27,16,31,47,145,84,229,0.000333,0.424,16,20352.01355,1130.66742,1272.000847,217.580086,21,0
0,0,26,26,16,30,46,144,82,226,0.000333,0.416108,16,19973.20003,1109.622224,1248.325002,211.206718,21,0
0,0,23,23,15,28,43,133,75,208,0.000333,0.376221,14,15801.28297,877.849054,1128.663069,193.209297,21,0
0,0,22,22,14,28,42,127,71,198,0.000333,0.355893,14,14947.5039,830.416883,1067.67885,187.908907,20,0
0,0,23,23,16,31,47,117,72,189,0.000333,0.349939,16,16797.07669,933.170927,1049.817293,217.580086,17,0
0,0,22,22,16,30,46,116,70,186,0.000333,0.342461,16,16438.12038,913.22891,1027.382524,211.206718,17,0
0,0,19,19,15,28,43,105,63,168,0.000333,0.303871,14,12762.5747,709.031928,911.612479,193.209297,17,0
0,0,18,18,14,28,42,99,59,158,0.000333,0.283995,14,11927.80614,662.655897,851.986153,187.908907,16,0
0,0,16,16,16,32,48,72,53,125,0.000333,0.232707,8,5584.962501,310.275694,698.120313,224,9,0
0,0,15,15,16,31,47,71,51,122,0.000333,0.225887,8,5421.278719,301.182151,677.65984,217.580086,9,0
0,0,12,12,15,29,44,60,44,104,0.000333,0.18926,7,3974.466218,220.803679,567.780888,199.484808,9,0
0,0,11,11,14,29,43,54,40,94,0.000333,0.170023,7,3570.482209,198.360123,510.068887,194.184418,8,0
0,0,23,23,15,26,41,134,71,205,0.000333,0.366099,14,15376.17425,854.231903,1098.298161,180.814792,21,0
0,0,19,19,15,26,41,106,59,165,0.000333,0.294665,14,12375.94513,687.552507,883.996081,180.814792,17,0
1,0,85,86,27,38,65,347,193,540,0.000333,1.084026,65,211385.1102,11743.61724,3252.078619,327.803208,36,0
1,0,88,89,27,42,69,357,204,561,0.000333,1.142294,52,178197.8755,9899.88197,3426.88222,354.859294,36,0
1,0,88,89,27,42,69,357,204,561,0.000333,1.142294,52,178197.8755,9899.88197,3426.88222,354.859294,36,0
0,0,6,6,13,15,28,21,18,39,0.000333,0.062496,6,1124.921052,62.495614,187.486842,106.709075,1,0
1,0,11,12,18,22,40,48,37,85,0.000333,0.150788,9,4071.274993,226.181944,452.363888,173.166146,7,0
1,0,8,9,17,22,39,49,33,82,0.000333,0.144468,8,3467.223856,192.623548,433.402982,167.594364,4,0
1,0,11,12,18,22,40,49,39,88,0.000333,0.15611,9,4214.967051,234.164836,468.329672,173.166146,12,0
1,0,8,9,17,22,39,49,33,82,0.000333,0.144468,8,3467.223856,192.623548,433.402982,167.594364,10,0
2,0,31,33,25,38,63,141,84,225,0.000333,0.448296,24,32277.31159,1793.183977,1344.887983,315.51765,37,0
2,0,30,32,25,35,60,134,78,212,0.000333,0.41742,24,30054.25935,1669.681075,1252.260806,295.62131,37,0
2,0,30,32,25,35,60,134,78,212,0.000333,0.41742,24,30054.25935,1669.681075,1252.260806,295.62131,37,0
2,0,27,29,23,31,54,118,64,182,0.000333,0.34913,22,23042.56956,1280.142753,1047.389525,257.622011,35,0
2,0,27,29,22,34,56,118,68,186,0.000333,0.360056,22,23763.69634,1320.205352,1080.168016,271.081232,36,0
2,0,28,30,23,35,58,123,70,193,0.000333,0.376863,22,24872.98731,1381.832628,1130.590332,283.566831,35,0
2,0,26,28,22,31,53,111,63,174,0.000333,0.332219,22,21926.4795,1218.13775,996.658159,251.687581,34,0
2,0,26,28,22,33,55,115,66,181,0.000333,0.348809,22,23021.37438,1278.965243,1046.426108,264.572502,35,0
2,0,29,31,23,39,62,136,79,215,0.000333,0.426717,22,28163.34855,1564.630475,1280.152207,310.172612,36,0
2,0,30,32,25,35,60,134,78,212,0.000333,0.41742,24,30054.25935,1669.681075,1252.260806,295.62131,37,0
2,0,27,29,23,31,54,118,64,182,0.000333,0.34913,22,23042.56956,1280.142753,1047.389525,257.622011,35,0
2,0,27,29,22,34,56,118,68,186,0.000333,0.360056,22,23763.69634,1320.205352,1080.168016,271.081232,36,0
2,0,28,30,23,35,58,123,70,193,0.000333,0.376863,22,24872.98731,1381.832628,1130.590332,283.566831,35,0
2,0,26,28,22,31,53,111,63,174,0.000333,0.332219,22,21926.4795,1218.13775,996.658159,251.687581,34,0
2,0,26,28,22,33,55,115,66,181,0.000333,0.348809,22,23021.37438,1278.965243,1046.426108,264.572502,35,0
2,0,29,31,23,38,61,140,77,217,0.000333,0.42899,22,28313.34005,1572.963336,1286.970002,303.463171,37,0
2,0,27,29,23,35,58,122,69,191,0.000333,0.372958,11,12307.61807,683.756559,1118.87437,283.566831,34,0
2,0,25,27,22,30,52,110,61,171,0.000333,0.324925,22,21445.05422,1191.391901,974.775192,245.314213,33,0
2,0,25,27,22,33,55,114,65,179,0.000333,0.344954,11,11383.49728,632.416515,1034.863389,264.572502,34,0
1,0,26,27,26,41,67,149,88,237,0.000333,0.479221,26,37379.24159,2076.624533,1437.663138,341.871065,49,0
1,0,26,27,26,41,67,149,88,237,0.000333,0.479221,26,37379.24159,2076.624533,1437.663138,341.871065,49,0
1,0,26,27,26,41,67,149,88,237,0.000333,0.479221,26,37379.24159,2076.624533,1437.663138,341.871065,49,0
1,0,26,27,26,41,67,149,88,237,0.000333,0.479221,26,37379.24159,2076.624533,1437.663138,341.871065,49,0
1,0,26,27,26,41,67,149,88,237,0.000333,0.479221,26,37379.24159,2076.624533,1437.663138,341.871065,49,0
1,0,26,27,26,41,67,149,88,237,0.000333,0.479221,26,37379.24159,2076.624533,1437.663138,341.871065,49,0
1,0,28,29,27,43,70,164,100,264,0.000333,0.539377,26,42071.39863,2337.299924,1618.130716,361.711347,59,0
1,0,72,73,30,131,161,386,268,654,0.000333,1.59814,30,143832.5891,7990.699397,4794.419638,1068.585131,46,0
1,0,80,81,30,135,165,400,288,688,0.000333,1.689343,30,152040.8905,8446.716139,5068.029683,1102.576823,45,0
1,0,69,70,30,130,160,372,258,630,0.000333,1.537605,15,69192.2205,3844.01225,4612.8147,1060.114534,48,0
1,0,69,70,30,130,160,372,258,630,0.000333,1.537605,15,69192.2205,3844.01225,4612.8147,1060.114534,48,0
1,0,70,71,30,131,161,376,259,635,0.000333,1.551711,15,69826.98326,3879.276848,4655.132218,1068.585131,53,0
1,0,73,74,30,134,164,384,268,652,0.000333,1.599041,30,143913.7172,7995.206512,4797.123907,1094.062669,50,0
1,0,70,71,30,131,161,376,259,635,0.000333,1.551711,15,69826.98326,3879.276848,4655.132218,1068.585131,53,0
1,0,73,74,30,134,164,384,268,652,0.000333,1.599041,30,143913.7172,7995.206512,4797.123907,1094.062669,50,0
1,0,72,73,30,131,161,386,268,654,0.000333,1.59814,30,143832.5891,7990.699397,4794.419638,1068.585131,46,0
1,0,80,81,30,135,165,400,288,688,0.000333,1.689343,30,152040.8905,8446.716139,5068.029683,1102.576823,45,0
1,0,11,12,18,20,38,57,39,96,0.000333,0.167934,9,4534.209372,251.900521,503.801041,161.497212,9,0
1,0,7,8,13,16,29,35,26,61,0.000333,0.098779,6,1778.021044,98.778947,296.336841,112.105716,8,0
1,0,10,11,18,20,38,55,37,92,0.000333,0.160936,9,4345.283981,241.404666,482.809331,161.497212,9,0
1,0,10,11,18,20,38,55,37,92,0.000333,0.160936,9,4345.283981,241.404666,482.809331,161.497212,9,0
1,0,9,10,18,20,38,49,33,82,0.000333,0.143443,9,3872.970505,215.165028,430.330056,161.497212,9,0
0,0,91,91,32,99,131,473,372,845,0.000333,1.981081,48,285275.6369,15848.6465,5943.242436,816.306305,31,0
0,0,83,83,32,94,126,443,346,789,0.000333,1.835025,48,264243.5453,14680.19696,5505.07386,776.131352,29,0
0,0,93,93,32,100,132,488,385,873,0.000333,2.049919,48,295188.2912,16399.34951,6149.756066,824.385619,33,0
0,0,85,85,32,95,127,458,359,817,0.000333,1.903252,48,274068.2587,15226.01437,5709.755389,784.136283,31,0
0,0,93,93,32,100,132,488,385,873,0.000333,2.049919,48,295188.2912,16399.34951,6149.756066,824.385619,33,0
0,0,85,85,32,95,127,458,359,817,0.000333,1.903252,48,274068.2587,15226.01437,5709.755389,784.136283,31,0
0,0,93,93,32,100,132,488,385,873,0.000333,2.049919,48,295188.2912,16399.34951,6149.756066,824.385619,33,0
0,0,85,85,32,95,127,458,359,817,0.000333,1.903252,48,274068.2587,15226.01437,5709.755389,784.136283,31,0
0,0,93,93,32,100,132,488,385,873,0.000333,2.049919,48,295188.2912,16399.34951,6149.756066,824.385619,33,0
0,0,85,85,32,95,127,458,359,817,0.000333,1.903252,48,274068.2587,15226.01437,5709.755389,784.136283,31,0
0,0,91,91,33,107,140,470,382,852,0.000333,2.024716,48,291559.1583,16197.73101,6074.14913,887.801973,32,0
0,0,83,83,33,103,136,440,356,796,0.000333,1.88054,48,270797.7802,15044.32112,5641.620422,855.17456,30,0
0,0,93,93,33,108,141,485,395,880,0.000333,2.094268,48,301574.6491,16754.14717,6282.80519,895.992856,34,0
0,0,85,85,33,104,137,455,369,824,0.000333,1.949593,48,280741.3649,15596.7425,5848.778436,863.310737,32,0
0,0,93,93,33,108,141,485,395,880,0.000333,2.094268,48,301574.6491,16754.14717,6282.80519,895.992856,34,0
0,0,85,85,33,104,137,455,369,824,0.000333,1.949593,48,280741.3649,15596.7425,5848.778436,863.310737,32,0
0,0,93,93,33,108,141,485,395,880,0.000333,2.094268,48,301574.6491,16754.14717,6282.80519,895.992856,34,0
0,0,85,85,33,104,137,455,369,824,0.000333,1.949593,48,280741.3649,15596.7425,5848.778436,863.310737,32,0
0,0,93,93,33,108,141,485,395,880,0.000333,2.094268,48,301574.6491,16754.14717,6282.80519,895.992856,34,0
0,0,85,85,33,104,137,455,369,824,0.000333,1.949593,48,280741.3649,15596.7425,5848.778436,863.310737,32,0
0,0,91,91,32,97,129,469,369,838,0.000333,1.958469,48,282019.6051,15667.75584,5875.40844,800.191546,32,0
0,0,83,83,32,93,125,439,343,782,0.000333,1.815748,48,261467.6789,14525.98216,5447.243311,768.141769,30,0
0,0,93,93,32,98,130,484,382,866,0.000333,2.027124,48,291905.7853,16216.98807,6081.370526,808.241565,34,0
0,0,85,85,32,94,126,454,356,810,0.000333,1.883866,48,271276.6434,15070.92464,5651.596738,776.131352,32,0
0,0,93,93,32,98,130,484,382,866,0.000333,2.027124,48,291905.7853,16216.98807,6081.370526,808.241565,34,0
0,0,85,85,32,94,126,454,356,810,0.000333,1.883866,48,271276.6434,15070.92464,5651.596738,776.131352,32,0
0,0,93,93,32,98,130,484,382,866,0.000333,2.027124,48,291905.7853,16216.98807,6081.370526,808.241565,34,0
0,0,85,85,32,94,126,454,356,810,0.000333,1.883866,48,271276.6434,15070.92464,5651.596738,776.131352,32,0
0,0,93,93,32,98,130,484,382,866,0.000333,2.027124,48,291905.7853,16216.98807,6081.370526,808.241565,34,0
0,0,85,85,32,94,126,454,356,810,0.000333,1.883866,48,271276.6434,15070.92464,5651.596738,776.131352,32,0
0,0,90,90,32,103,135,466,373,839,0.000333,1.979149,48,284997.5177,15833.19543,5937.448286,848.709554,31,0
0,0,82,82,32,99,131,436,347,783,0.000333,1.835723,48,264344.1701,14685.78723,5507.17021,816.306305,29,0
0,0,92,92,32,104,136,481,386,867,0.000333,2.048277,48,294951.8536,16386.21409,6144.830283,856.845731,33,0
0,0,84,84,32,100,132,451,360,811,0.000333,1.904335,48,274224.1743,15234.67635,5713.003631,824.385619,31,0
0,0,92,92,32,104,136,481,386,867,0.000333,2.048277,48,294951.8536,16386.21409,6144.830283,856.845731,33,0
0,0,84,84,32,100,132,451,360,811,0.000333,1.904335,48,274224.1743,15234.67635,5713.003631,824.385619,31,0
0,0,92,92,32,104,136,481,386,867,0.000333,2.048277,48,294951.8536,16386.21409,6144.830283,856.845731,33,0
0,0,84,84,32,100,132,451,360,811,0.000333,1.904335,48,274224.1743,15234.67635,5713.003631,824.385619,31,0
0,0,92,92,32,104,136,481,386,867,0.000333,2.048277,48,294951.8536,16386.21409,6144.830283,856.845731,33,0
0,0,84,84,32,100,132,451,360,811,0.000333,1.904335,48,274224.1743,15234.67635,5713.003631,824.385619,31,0
0,0,91,91,33,115,148,473,409,882,0.000333,2.119579,48,305219.4177,16956.63432,6358.737868,953.696362,32,0
0,0,83,83,33,110,143,443,383,826,0.000333,1.971351,48,283874.5788,15770.80993,5914.053724,912.414574,30,0
0,0,93,93,33,116,149,488,422,910,0.000333,2.189814,48,315333.281,17518.51561,6569.443354,961.990801,34,0
0,0,85,85,33,111,144,458,396,854,0.000333,2.041039,48,293909.5657,16328.3092,6123.115951,920.645167,32,0
0,0,93,93,33,116,149,488,422,910,0.000333,2.189814,48,315333.281,17518.51561,6569.443354,961.990801,34,0
0,0,85,85,33,111,144,458,396,854,0.000333,2.041039,48,293909.5657,16328.3092,6123.115951,920.645167,32,0
0,0,93,93,33,116,149,488,422,910,0.000333,2.189814,48,315333.281,17518.51561,6569.443354,961.990801,34,0
0,0,85,85,33,111,144,458,396,854,0.000333,2.041039,48,293909.5657,16328.3092,6123.115951,920.645167,32,0
0,0,93,93,33,116,149,488,422,910,0.000333,2.189814,48,315333.281,17518.51561,6569.443354,961.990801,34,0
0,0,85,85,33,111,144,458,396,854,0.000333,2.041039,48,293909.5657,16328.3092,6123.115951,920.645167,32,0
0,0,91,91,32,107,139,470,379,849,0.000333,2.01466,48,290111.0866,16117.28259,6043.980971,881.336968,32,0
0,0,83,83,32,102,134,440,353,793,0.000333,1.867803,48,268963.6189,14942.42328,5603.408728,840.587385,30,0
0,0,93,93,32,108,140,485,392,877,0.000333,2.084127,48,300114.2979,16673.01655,6252.381206,889.52785,34,0
0,0,85,85,32,103,135,455,366,821,0.000333,1.936689,48,278883.149,15493.50828,5810.065605,848.709554,32,0
0,0,93,93,32,108,140,485,392,877,0.000333,2.084127,48,300114.2979,16673.01655,6252.381206,889.52785,34,0
0,0,85,85,32,103,135,455,366,821,0.000333,1.936689,48,278883.149,15493.50828,5810.065605,848.709554,32,0
0,0,93,93,32,108,140,485,392,877,0.000333,2.084127,48,300114.2979,16673.01655,6252.381206,889.52785,34,0
0,0,85,85,32,103,135,455,366,821,0.000333,1.936689,48,278883.149,15493.50828,5810.065605,848.709554,32,0
0,0,93,93,32,108,140,485,392,877,0.000333,2.084127,48,300114.2979,16673.01655,6252.381206,889.52785,34,0
0,0,85,85,32,103,135,455,366,821,0.000333,1.936689,48,278883.149,15493.50828,5810.065605,848.709554,32,0
0,0,91,91,32,98,130,472,371,843,0.000333,1.973285,48,284153.0912,15786.28284,5919.856066,808.241565,31,0
0,0,83,83,32,94,126,442,345,787,0.000333,1.830373,48,263573.7264,14642.9848,5491.1193,776.131352,29,0
0,0,93,93,32,99,131,487,384,871,0.000333,2.042037,48,294053.3488,16336.29716,6126.111434,816.306305,33,0
0,0,85,85,32,95,127,457,358,815,0.000333,1.898593,48,273397.3449,15188.74139,5695.77802,784.136283,31,0
0,0,93,93,32,99,131,487,384,871,0.000333,2.042037,48,294053.3488,16336.29716,6126.111434,816.306305,33,0
0,0,85,85,32,95,127,457,358,815,0.000333,1.898593,48,273397.3449,15188.74139,5695.77802,784.136283,31,0
0,0,93,93,32,99,131,487,384,871,0.000333,2.042037,48,294053.3488,16336.29716,6126.111434,816.306305,33,0
0,0,85,85,32,95,127,457,358,815,0.000333,1.898593,48,273397.3449,15188.74139,5695.77802,784.136283,31,0
0,0,93,93,32,99,131,487,384,871,0.000333,2.042037,48,294053.3488,16336.29716,6126.111434,816.306305,33,0
0,0,85,85,32,95,127,457,358,815,0.000333,1.898593,48,273397.3449,15188.74139,5695.77802,784.136283,31,0
0,0,90,90,32,104,136,467,374,841,0.000333,1.986852,48,286106.7,15894.81667,5960.556249,856.845731,31,0
0,0,82,82,32,99,131,437,348,785,0.000333,1.840412,48,265019.3787,14723.29882,5521.237056,816.306305,29,0
0,0,92,92,32,105,137,482,387,869,0.000333,2.056063,48,296073.1142,16448.50635,6168.18988,864.995779,33,0
0,0,84,84,32,100,132,452,361,813,0.000333,1.909031,48,274900.4361,15272.24645,5727.092419,824.385619,31,0
0,0,92,92,32,105,137,482,387,869,0.000333,2.056063,48,296073.1142,16448.50635,6168.18988,864.995779,33,0
0,0,84,84,32,100,132,452,361,813,0.000333,1.909031,48,274900.4361,15272.24645,5727.092419,824.385619,31,0
0,0,92,92,32,105,137,482,387,869,0.000333,2.056063,48,296073.1142,16448.50635,6168.18988,864.995779,33,0
0,0,84,84,32,100,132,452,361,813,0.000333,1.909031,48,274900.4361,15272.24645,5727.092419,824.385619,31,0
0,0,92,92,32,105,137,482,387,869,0.000333,2.056063,48,296073.1142,16448.50635,6168.18988,864.995779,33,0
0,0,84,84,32,100,132,452,361,813,0.000333,1.909031,48,274900.4361,15272.24645,5727.092419,824.385619,31,0
0,0,91,91,32,98,130,470,370,840,0.000333,1.966263,48,283141.8702,15730.1039,5898.788963,808.241565,32,0
0,0,83,83,32,93,125,440,344,784,0.000333,1.820392,48,262136.3942,14563.13301,5461.174879,768.141769,30,0
0,0,93,93,32,99,131,485,383,868,0.000333,2.035004,48,293040.5359,16280.02977,6105.011165,816.306305,34,0
0,0,85,85,32,94,126,455,357,812,0.000333,1.888517,48,271946.4623,15108.13679,5665.551298,776.131352,32,0
0,0,93,93,32,99,131,485,383,868,0.000333,2.035004,48,293040.5359,16280.02977,6105.011165,816.306305,34,0
0,0,85,85,32,94,126,455,357,812,0.000333,1.888517,48,271946.4623,15108.13679,5665.551298,776.131352,32,0
0,0,93,93,32,99,131,485,383,868,0.000333,2.035004,48,293040.5359,16280.02977,6105.011165,816.306305,34,0
0,0,85,85,32,94,126,455,357,812,0.000333,1.888517,48,271946.4623,15108.13679,5665.551298,776.131352,32,0
0,0,93,93,32,99,131,485,383,868,0.000333,2.035004,48,293040.5359,16280.02977,6105.011165,816.306305,34,0
0,0,85,85,32,94,126,455,357,812,0.000333,1.888517,48,271946.4623,15108.13679,5665.551298,776.131352,32,0
0,0,91,91,32,97,129,469,369,838,0.000333,1.958469,48,282019.6051,15667.75584,5875.40844,800.191546,32,0
0,0,83,83,32,93,125,439,343,782,0.000333,1.815748,48,261467.6789,14525.98216,5447.243311,768.141769,30,0
0,0,93,93,32,98,130,484,382,866,0.000333,2.027124,48,291905.7853,16216.98807,6081.370526,808.241565,34,0
0,0,85,85,32,94,126,454,356,810,0.000333,1.883866,48,271276.6434,15070.92464,5651.596738,776.131352,32,0
0,0,93,93,32,98,130,484,382,866,0.000333,2.027124,48,291905.7853,16216.98807,6081.370526,808.241565,34,0
0,0,85,85,32,94,126,454,356,810,0.000333,1.883866,48,271276.6434,15070.92464,5651.596738,776.131352,32,0
0,0,93,93,32,98,130,484,382,866,0.000333,2.027124,48,291905.7853,16216.98807,6081.370526,808.241565,34,0
0,0,85,85,32,94,126,454,356,810,0.000333,1.883866,48,271276.6434,15070.92464,5651.596738,776.131352,32,0
0,0,93,93,32,98,130,484,382,866,0.000333,2.027124,48,291905.7853,16216.98807,6081.370526,808.241565,34,0
0,0,85,85,32,94,126,454,356,810,0.000333,1.883866,48,271276.6434,15070.92464,5651.596738,776.131352,32,0
0,0,91,91,32,98,130,470,370,840,0.000333,1.966263,48,283141.8702,15730.1039,5898.788963,808.241565,32,0
0,0,83,83,32,93,125,440,344,784,0.000333,1.820392,48,262136.3942,14563.13301,5461.174879,768.141769,30,0
0,0,93,93,32,99,131,485,383,868,0.000333,2.035004,48,293040.5359,16280.02977,6105.011165,816.306305,34,0
0,0,85,85,32,94,126,455,357,812,0.000333,1.888517,48,271946.4623,15108.13679,5665.551298,776.131352,32,0
0,0,93,93,32,99,131,485,383,868,0.000333,2.035004,48,293040.5359,16280.02977,6105.011165,816.306305,34,0
0,0,85,85,32,94,126,455,357,812,0.000333,1.888517,48,271946.4623,15108.13679,5665.551298,776.131352,32,0
0,0,93,93,32,99,131,485,383,868,0.000333,2.035004,48,293040.5359,16280.02977,6105.011165,816.306305,34,0
0,0,85,85,32,94,126,455,357,812,0.000333,1.888517,48,271946.4623,15108.13679,5665.551298,776.131352,32,0
0,0,93,93,32,99,131,485,383,868,0.000333,2.035004,48,293040.5359,16280.02977,6105.011165,816.306305,34,0
0,0,85,85,32,94,126,455,357,812,0.000333,1.888517,48,271946.4623,15108.13679,5665.551298,776.131352,32,0
0,0,91,91,32,106,138,469,378,847,0.000333,2.006973,48,289004.1703,16055.78724,6020.920215,873.159568,32,0
0,0,83,83,32,102,134,439,352,791,0.000333,1.863092,48,268285.2744,14904.73747,5589.27655,840.587385,30,0
0,0,93,93,32,107,139,484,391,875,0.000333,2.076358,48,298995.5251,16610.8625,6229.073439,881.336968,34,0
0,0,85,85,32,103,135,454,365,819,0.000333,1.931971,48,278203.7748,15455.76526,5795.911974,848.709554,32,0
0,0,93,93,32,107,139,484,391,875,0.000333,2.076358,48,298995.5251,16610.8625,6229.073439,881.336968,34,0
0,0,85,85,32,103,135,454,365,819,0.000333,1.931971,48,278203.7748,15455.76526,5795.911974,848.709554,32,0
0,0,93,93,32,107,139,484,391,875,0.000333,2.076358,48,298995.5251,16610.8625,6229.073439,881.336968,34,0
0,0,85,85,32,103,135,454,365,819,0.000333,1.931971,48,278203.7748,15455.76526,5795.911974,848.709554,32,0
0,0,93,93,32,107,139,484,391,875,0.000333,2.076358,48,298995.5251,16610.8625,6229.073439,881.336968,34,0
0,0,85,85,32,103,135,454,365,819,0.000333,1.931971,48,278203.7748,15455.76526,5795.911974,848.709554,32,0
0,0,90,90,32,120,152,467,399,866,0.000333,2.092235,48,301281.8509,16737.8806,6276.705227,988.826871,31,0
0,0,82,82,32,115,147,437,373,810,0.000333,1.943912,48,279923.2608,15551.29227,5831.734599,947.231356,29,0
0,0,92,92,32,121,153,482,412,894,0.000333,2.162702,48,311429.0271,17301.61262,6488.104731,997.182452,33,0
0,0,84,84,32,116,148,452,386,838,0.000333,2.013841,48,289993.0522,16110.72512,6041.52192,955.525795,31,0
0,0,92,92,32,121,153,482,412,894,0.000333,2.162702,48,311429.0271,17301.61262,6488.104731,997.182452,33,0
0,0,84,84,32,116,148,452,386,838,0.000333,2.013841,48,289993.0522,16110.72512,6041.52192,955.525795,31,0
0,0,92,92,32,121,153,482,412,894,0.000333,2.162702,48,311429.0271,17301.61262,6488.104731,997.182452,33,0
0,0,84,84,32,116,148,452,386,838,0.000333,2.013841,48,289993.0522,16110.72512,6041.52192,955.525795,31,0
0,0,92,92,32,121,153,482,412,894,0.000333,2.162702,48,311429.0271,17301.61262,6488.104731,997.182452,33,0
0,0,84,84,32,116,148,452,386,838,0.000333,2.013841,48,289993.0522,16110.72512,6041.52192,955.525795,31,0
0,0,90,90,32,119,151,466,398,864,0.000333,2.084661,48,300191.1213,16677.28452,6253.981695,980.483314,31,0
0,0,82,82,32,115,147,436,372,808,0.000333,1.939112,48,279232.0922,15512.89401,5817.335255,947.231356,29,0
0,0,92,92,32,120,152,481,411,892,0.000333,2.15505,48,310327.2644,17240.40358,6465.151342,988.826871,33,0
0,0,84,84,32,116,148,451,385,836,0.000333,2.009034,48,289300.9447,16072.2747,6027.103014,955.525795,31,0
0,0,92,92,32,120,152,481,411,892,0.000333,2.15505,48,310327.2644,17240.40358,6465.151342,988.826871,33,0
0,0,84,84,32,116,148,451,385,836,0.000333,2.009034,48,289300.9447,16072.2747,6027.103014,955.525795,31,0
0,0,92,92,32,120,152,481,411,892,0.000333,2.15505,48,310327.2644,17240.40358,6465.151342,988.826871,33,0
0,0,84,84,32,116,148,451,385,836,0.000333,2.009034,48,289300.9447,16072.2747,6027.103014,955.525795,31,0
0,0,92,92,32,120,152,481,411,892,0.000333,2.15505,48,310327.2644,17240.40358,6465.151342,988.826871,33,0
0,0,84,84,32,116,148,451,385,836,0.000333,2.009034,48,289300.9447,16072.2747,6027.103014,955.525795,31,0
0,0,91,91,32,98,130,470,370,840,0.000333,1.966263,48,283141.8702,15730.1039,5898.788963,808.241565,32,0
0,0,83,83,32,93,125,440,344,784,0.000333,1.820392,48,262136.3942,14563.13301,5461.174879,768.141769,30,0
0,0,93,93,32,99,131,485,383,868,0.000333,2.035004,48,293040.5359,16280.02977,6105.011165,816.306305,34,0
0,0,85,85,32,94,126,455,357,812,0.000333,1.888517,48,271946.4623,15108.13679,5665.551298,776.131352,32,0
0,0,93,93,32,99,131,485,383,868,0.000333,2.035004,48,293040.5359,16280.02977,6105.011165,816.306305,34,0
0,0,85,85,32,94,126,455,357,812,0.000333,1.888517,48,271946.4623,15108.13679,5665.551298,776.131352,32,0
0,0,93,93,32,99,131,485,383,868,0.000333,2.035004,48,293040.5359,16280.02977,6105.011165,816.306305,34,0
0,0,85,85,32,94,126,455,357,812,0.000333,1.888517,48,271946.4623,15108.13679,5665.551298,776.131352,32,0
0,0,93,93,32,99,131,485,383,868,0.000333,2.035004,48,293040.5359,16280.02977,6105.011165,816.306305,34,0
0,0,85,85,32,94,126,455,357,812,0.000333,1.888517,48,271946.4623,15108.13679,5665.551298,776.131352,32,0
0,0,91,91,33,108,141,471,383,854,0.000333,2.032392,48,292664.489,16259.13828,6097.176855,895.992856,32,0
0,0,83,83,33,103,136,441,357,798,0.000333,1.885265,48,271478.1767,15082.12093,5655.795347,855.17456,30,0
0,0,93,93,33,109,142,486,396,882,0.000333,2.102026,48,302691.6941,16816.20523,6306.076959,904.197097,34,0
0,0,85,85,33,104,137,456,370,826,0.000333,1.954325,48,281422.776,15634.59867,5862.974501,863.310737,32,0
0,0,93,93,33,109,142,486,396,882,0.000333,2.102026,48,302691.6941,16816.20523,6306.076959,904.197097,34,0
0,0,85,85,33,104,137,456,370,826,0.000333,1.954325,48,281422.776,15634.59867,5862.974501,863.310737,32,0
0,0,93,93,33,109,142,486,396,882,0.000333,2.102026,48,302691.6941,16816.20523,6306.076959,904.197097,34,0
0,0,85,85,33,104,137,456,370,826,0.000333,1.954325,48,281422.776,15634.59867,5862.974501,863.310737,32,0
0,0,93,93,33,109,142,486,396,882,0.000333,2.102026,48,302691.6941,16816.20523,6306.076959,904.197097,34,0
0,0,85,85,33,104,137,456,370,826,0.000333,1.954325,48,281422.776,15634.59867,5862.974501,863.310737,32,0
0,0,91,91,33,112,145,470,387,857,0.000333,2.051061,48,295352.7403,16408.48557,6153.18209,928.888757,32,0
0,0,83,83,33,108,141,440,361,801,0.000333,1.90626,48,274501.4704,15250.08169,5718.780633,895.992856,30,0
0,0,93,93,33,113,146,485,400,885,0.000333,2.120998,48,305423.7473,16967.98596,6362.994735,937.145229,34,0
0,0,85,85,33,109,142,455,374,829,0.000333,1.975713,48,284502.7374,15805.70763,5927.140362,904.197097,32,0
0,0,93,93,33,113,146,485,400,885,0.000333,2.120998,48,305423.7473,16967.98596,6362.994735,937.145229,34,0
0,0,85,85,33,109,142,455,374,829,0.000333,1.975713,48,284502.7374,15805.70763,5927.140362,904.197097,32,0
0,0,93,93,33,113,146,485,400,885,0.000333,2.120998,48,305423.7473,16967.98596,6362.994735,937.145229,34,0
0,0,85,85,33,109,142,455,374,829,0.000333,1.975713,48,284502.7374,15805.70763,5927.140362,904.197097,32,0
0,0,93,93,33,113,146,485,400,885,0.000333,2.120998,48,305423.7473,16967.98596,6362.994735,937.145229,34,0
0,0,85,85,33,109,142,455,374,829,0.000333,1.975713,48,284502.7374,15805.70763,5927.140362,904.197097,32,0
0,0,91,91,33,112,145,472,399,871,0.000333,2.084567,48,300177.6392,16676.53551,6253.700817,928.888757,32,0
0,0,83,83,33,107,140,442,373,815,0.000333,1.936789,48,278897.5516,15494.30842,5810.365659,887.801973,30,0
0,0,93,93,33,113,146,487,412,899,0.000333,2.154551,48,310255.3094,17236.40608,6463.652278,937.145229,34,0
0,0,85,85,33,108,141,457,386,843,0.000333,2.006214,48,288894.8059,16049.71144,6018.64179,895.992856,32,0
0,0,93,93,33,113,146,487,412,899,0.000333,2.154551,48,310255.3094,17236.40608,6463.652278,937.145229,34,0
0,0,85,85,33,108,141,457,386,843,0.000333,2.006214,48,288894.8059,16049.71144,6018.64179,895.992856,32,0
0,0,93,93,33,113,146,487,412,899,0.000333,2.154551,48,310255.3094,17236.40608,6463.652278,937.145229,34,0
0,0,85,85,33,108,141,457,386,843,0.000333,2.006214,48,288894.8059,16049.71144,6018.64179,895.992856,32,0
0,0,93,93,33,113,146,487,412,899,0.000333,2.154551,48,310255.3094,17236.40608,6463.652278,937.145229,34,0
0,0,85,85,33,108,141,457,386,843,0.000333,2.006214,48,288894.8059,16049.71144,6018.64179,895.992856,32,0
0,0,90,90,32,119,151,468,404,872,0.000333,2.103963,48,302970.6688,16831.70382,6311.888933,980.483314,31,0
0,0,82,82,32,114,146,438,378,816,0.000333,1.955632,48,281611.0483,15645.05824,5866.89684,938.949462,29,0
0,0,92,92,32,120,152,483,417,900,0.000333,2.174378,48,313110.4686,17395.02603,6523.134762,988.826871,33,0
0,0,84,84,32,115,147,453,391,844,0.000333,2.025508,48,291673.126,16204.06256,6076.523459,947.231356,31,0
0,0,92,92,32,120,152,483,417,900,0.000333,2.174378,48,313110.4686,17395.02603,6523.134762,988.826871,33,0
0,0,84,84,32,115,147,453,391,844,0.000333,2.025508,48,291673.126,16204.06256,6076.523459,947.231356,31,0
0,0,92,92,32,120,152,483,417,900,0.000333,2.174378,48,313110.4686,17395.02603,6523.134762,988.826871,33,0
0,0,84,84,32,115,147,453,391,844,0.000333,2.025508,48,291673.126,16204.06256,6076.523459,947.231356,31,0
0,0,92,92,32,120,152,483,417,900,0.000333,2.174378,48,313110.4686,17395.02603,6523.134762,988.826871,33,0
0,0,84,84,32,115,147,453,391,844,0.000333,2.025508,48,291673.126,16204.06256,6076.523459,947.231356,31,0
0,0,91,91,33,111,144,471,398,869,0.000333,2.076888,48,299071.9117,16615.1062,6230.664826,920.645167,32,0
0,0,83,83,33,107,140,441,372,813,0.000333,1.932036,48,278213.1405,15456.28558,5796.107093,887.801973,30,0
0,0,93,93,33,112,145,486,411,897,0.000333,2.146793,48,309138.1658,17174.34254,6440.378454,928.888757,34,0
0,0,85,85,33,108,141,456,385,841,0.000333,2.001454,48,288209.409,16011.63383,6004.362687,895.992856,32,0
0,0,93,93,33,112,145,486,411,897,0.000333,2.146793,48,309138.1658,17174.34254,6440.378454,928.888757,34,0
0,0,85,85,33,108,141,456,385,841,0.000333,2.001454,48,288209.409,16011.63383,6004.362687,895.992856,32,0
0,0,93,93,33,112,145,486,411,897,0.000333,2.146793,48,309138.1658,17174.34254,6440.378454,928.888757,34,0
0,0,85,85,33,108,141,456,385,841,0.000333,2.001454,48,288209.409,16011.63383,6004.362687,895.992856,32,0
0,0,93,93,33,112,145,486,411,897,0.000333,2.146793,48,309138.1658,17174.34254,6440.378454,928.888757,34,0
0,0,85,85,33,108,141,456,385,841,0.000333,2.001454,48,288209.409,16011.63383,6004.362687,895.992856,32,0
0,0,91,91,33,113,146,471,388,859,0.000333,2.058686,48,296450.8462,16469.49146,6176.059296,937.145229,32,0
0,0,83,83,33,108,141,441,362,803,0.000333,1.91102,48,275186.8673,15288.1593,5733.059736,895.992856,30,0
0,0,93,93,33,114,147,486,401,887,0.000333,2.128703,48,306533.2498,17029.62499,6386.10937,945.414468,34,0
0,0,85,85,33,109,142,456,375,831,0.000333,1.98048,48,285189.1131,15843.83962,5941.439856,904.197097,32,0
0,0,93,93,33,114,147,486,401,887,0.000333,2.128703,48,306533.2498,17029.62499,6386.10937,945.414468,34,0
0,0,85,85,33,109,142,456,375,831,0.000333,1.98048,48,285189.1131,15843.83962,5941.439856,904.197097,32,0
0,0,93,93,33,114,147,486,401,887,0.000333,2.128703,48,306533.2498,17029.62499,6386.10937,945.414468,34,0
0,0,85,85,33,109,142,456,375,831,0.000333,1.98048,48,285189.1131,15843.83962,5941.439856,904.197097,32,0
0,0,93,93,33,114,147,486,401,887,0.000333,2.128703,48,306533.2498,17029.62499,6386.10937,945.414468,34,0
0,0,85,85,33,109,142,456,375,831,0.000333,1.98048,48,285189.1131,15843.83962,5941.439856,904.197097,32,0
0,0,91,91,32,98,130,473,372,845,0.000333,1.977967,48,284827.2385,15823.73547,5933.900802,808.241565,31,0
0,0,83,83,32,93,125,443,346,789,0.000333,1.832001,48,263808.1824,14656.01014,5496.003801,768.141769,29,0
0,0,93,93,32,99,131,488,385,873,0.000333,2.046726,48,294728.5575,16373.80875,6140.17828,816.306305,33,0
0,0,85,85,32,94,126,458,359,817,0.000333,1.900146,48,273621.0095,15201.16719,5700.437697,776.131352,31,0
0,0,93,93,32,99,131,488,385,873,0.000333,2.046726,48,294728.5575,16373.80875,6140.17828,816.306305,33,0
0,0,85,85,32,94,126,458,359,817,0.000333,1.900146,48,273621.0095,15201.16719,5700.437697,776.131352,31,0
0,0,93,93,32,99,131,488,385,873,0.000333,2.046726,48,294728.5575,16373.80875,6140.17828,816.306305,33,0
0,0,85,85,32,94,126,458,359,817,0.000333,1.900146,48,273621.0095,15201.16719,5700.437697,776.131352,31,0
0,0,93,93,32,99,131,488,385,873,0.000333,2.046726,48,294728.5575,16373.80875,6140.17828,816.306305,33,0
0,0,85,85,32,94,126,458,359,817,0.000333,1.900146,48,273621.0095,15201.16719,5700.437697,776.131352,31,0
0,0,91,91,33,106,139,470,382,852,0.000333,2.021779,48,291136.2141,16174.23412,6065.337794,879.624574,32,0
0,0,83,83,33,102,135,440,356,796,0.000333,1.877715,48,270390.9703,15021.72057,5633.145215,847.052391,30,0
0,0,93,93,33,107,140,485,395,880,0.000333,2.091256,48,301140.9146,16730.05081,6273.769055,887.801973,34,0
0,0,85,85,33,103,136,455,369,824,0.000333,1.94669,48,280323.3303,15573.51835,5840.069381,855.17456,32,0
0,0,93,93,33,107,140,485,395,880,0.000333,2.091256,48,301140.9146,16730.05081,6273.769055,887.801973,34,0
0,0,85,85,33,103,136,455,369,824,0.000333,1.94669,48,280323.3303,15573.51835,5840.069381,855.17456,32,0
0,0,93,93,33,107,140,485,395,880,0.000333,2.091256,48,301140.9146,16730.05081,6273.769055,887.801973,34,0
0,0,85,85,33,103,136,455,369,824,0.000333,1.94669,48,280323.3303,15573.51835,5840.069381,855.17456,32,0
0,0,93,93,33,107,140,485,395,880,0.000333,2.091256,48,301140.9146,16730.05081,6273.769055,887.801973,34,0
0,0,85,85,33,103,136,455,369,824,0.000333,1.94669,48,280323.3303,15573.51835,5840.069381,855.17456,32,0
0,0,91,91,32,96,128,469,369,838,0.000333,1.955333,48,281568,15642.66667,5866,792.1564,32,0
0,0,83,83,32,92,124,439,343,782,0.000333,1.812727,48,261032.7127,14501.81737,5438.181515,760.1677,30,0
0,0,93,93,32,97,129,484,382,866,0.000333,2.023908,48,291442.6946,16191.26081,6071.722803,800.191546,34,0
0,0,85,85,32,93,125,454,356,810,0.000333,1.880762,48,270829.693,15046.09406,5642.285271,768.141769,32,0
0,0,93,93,32,97,129,484,382,866,0.000333,2.023908,48,291442.6946,16191.26081,6071.722803,800.191546,34,0
0,0,85,85,32,93,125,454,356,810,0.000333,1.880762,48,270829.693,15046.09406,5642.285271,768.141769,32,0
0,0,93,93,32,97,129,484,382,866,0.000333,2.023908,48,291442.6946,16191.26081,6071.722803,800.191546,34,0
0,0,85,85,32,93,125,454,356,810,0.000333,1.880762,48,270829.693,15046.09406,5642.285271,768.141769,32,0
0,0,93,93,32,97,129,484,382,866,0.000333,2.023908,48,291442.6946,16191.26081,6071.722803,800.191546,34,0
0,0,85,85,32,93,125,454,356,810,0.000333,1.880762,48,270829.693,15046.09406,5642.285271,768.141769,32,0
0,0,90,90,32,102,134,466,373,839,0.000333,1.97615,48,284565.5439,15809.19688,5928.448831,840.587385,31,0
0,0,82,82,32,98,130,436,347,783,0.000333,1.832838,48,263928.6719,14662.70399,5498.513998,808.241565,29,0
0,0,92,92,32,103,135,481,386,867,0.000333,2.0452,48,294508.7579,16361.59766,6135.599123,848.709554,33,0
0,0,84,84,32,99,131,451,360,811,0.000333,1.901369,48,273797.0906,15210.94948,5704.106054,816.306305,31,0
0,0,92,92,32,103,135,481,386,867,0.000333,2.0452,48,294508.7579,16361.59766,6135.599123,848.709554,33,0
0,0,84,84,32,99,131,451,360,811,0.000333,1.901369,48,273797.0906,15210.94948,5704.106054,816.306305,31,0
0,0,92,92,32,103,135,481,386,867,0.000333,2.0452,48,294508.7579,16361.59766,6135.599123,848.709554,33,0
0,0,84,84,32,99,131,451,360,811,0.000333,1.901369,48,273797.0906,15210.94948,5704.106054,816.306305,31,0
0,0,92,92,32,103,135,481,386,867,0.000333,2.0452,48,294508.7579,16361.59766,6135.599123,848.709554,33,0
0,0,84,84,32,99,131,451,360,811,0.000333,1.901369,48,273797.0906,15210.94948,5704.106054,816.306305,31,0
0,0,91,91,33,114,147,473,409,882,0.000333,2.116704,48,304805.3284,16933.62936,6350.111008,945.414468,32,0
0,0,83,83,33,109,142,443,383,826,0.000333,1.968564,48,283473.1738,15748.50966,5905.691121,904.197097,30,0
0,0,93,93,33,115,148,488,422,910,0.000333,2.186868,48,314908.923,17494.94017,6560.602563,953.696362,34,0
0,0,85,85,33,110,143,458,396,854,0.000333,2.038177,48,293497.4458,16305.41366,6114.530122,912.414574,32,0
0,0,93,93,33,115,148,488,422,910,0.000333,2.186868,48,314908.923,17494.94017,6560.602563,953.696362,34,0
0,0,85,85,33,110,143,458,396,854,0.000333,2.038177,48,293497.4458,16305.41366,6114.530122,912.414574,32,0
0,0,93,93,33,115,148,488,422,910,0.000333,2.186868,48,314908.923,17494.94017,6560.602563,953.696362,34,0
0,0,85,85,33,110,143,458,396,854,0.000333,2.038177,48,293497.4458,16305.41366,6114.530122,912.414574,32,0
0,0,93,93,33,115,148,488,422,910,0.000333,2.186868,48,314908.923,17494.94017,6560.602563,953.696362,34,0
0,0,85,85,33,110,143,458,396,854,0.000333,2.038177,48,293497.4458,16305.41366,6114.530122,912.414574,32,0
0,0,91,91,32,106,138,470,379,849,0.000333,2.011712,48,289686.5887,16093.69937,6035.137264,873.159568,32,0
0,0,83,83,32,101,133,440,353,793,0.000333,1.864946,48,268552.2706,14919.57059,5594.838971,832.47936,30,0
0,0,93,93,32,107,139,485,392,877,0.000333,2.081104,48,299678.9434,16648.83019,6243.311321,881.336968,34,0
0,0,85,85,32,102,134,455,366,821,0.000333,1.933753,48,278460.4428,15470.0246,5801.259225,840.587385,32,0
0,0,93,93,32,107,139,485,392,877,0.000333,2.081104,48,299678.9434,16648.83019,6243.311321,881.336968,34,0
0,0,85,85,32,102,134,455,366,821,0.000333,1.933753,48,278460.4428,15470.0246,5801.259225,840.587385,32,0
0,0,93,93,32,107,139,485,392,877,0.000333,2.081104,48,299678.9434,16648.83019,6243.311321,881.336968,34,0
0,0,85,85,32,102,134,455,366,821,0.000333,1.933753,48,278460.4428,15470.0246,5801.259225,840.587385,32,0
0,0,93,93,32,107,139,485,392,877,0.000333,2.081104,48,299678.9434,16648.83019,6243.311321,881.336968,34,0
0,0,85,85,32,102,134,455,366,821,0.000333,1.933753,48,278460.4428,15470.0246,5801.259225,840.587385,32,0
0,0,91,91,32,97,129,472,371,843,0.000333,1.970155,48,283702.2997,15761.23887,5910.464576,800.191546,31,0
0,0,83,83,32,93,125,442,345,787,0.000333,1.827357,48,263139.4671,14618.85929,5482.072232,768.141769,29,0
0,0,93,93,32,98,130,487,384,871,0.000333,2.038827,48,293591.1535,16310.61964,6116.482365,808.241565,33,0
0,0,85,85,32,94,126,457,358,815,0.000333,1.895494,48,272951.1906,15163.95503,5686.483138,776.131352,31,0
0,0,93,93,32,98,130,487,384,871,0.000333,2.038827,48,293591.1535,16310.61964,6116.482365,808.241565,33,0
0,0,85,85,32,94,126,457,358,815,0.000333,1.895494,48,272951.1906,15163.95503,5686.483138,776.131352,31,0
0,0,93,93,32,98,130,487,384,871,0.000333,2.038827,48,293591.1535,16310.61964,6116.482365,808.241565,33,0
0,0,85,85,32,94,126,457,358,815,0.000333,1.895494,48,272951.1906,15163.95503,5686.483138,776.131352,31,0
0,0,93,93,32,98,130,487,384,871,0.000333,2.038827,48,293591.1535,16310.61964,6116.482365,808.241565,33,0
0,0,85,85,32,94,126,457,358,815,0.000333,1.895494,48,272951.1906,15163.95503,5686.483138,776.131352,31,0
0,0,90,90,32,103,135,467,374,841,0.000333,1.983867,48,285676.892,15870.93845,5951.601917,848.709554,31,0
0,0,82,82,32,98,130,437,348,785,0.000333,1.83752,48,264602.8192,14700.15662,5512.558733,808.241565,29,0
0,0,92,92,32,104,136,482,387,869,0.000333,2.053002,48,295632.25,16424.01389,6159.005209,856.845731,33,0
0,0,84,84,32,99,131,452,361,813,0.000333,1.906058,48,274472.2992,15248.46107,5718.1729,816.306305,31,0
0,0,92,92,32,104,136,482,387,869,0.000333,2.053002,48,295632.25,16424.01389,6159.005209,856.845731,33,0
0,0,84,84,32,99,131,452,361,813,0.000333,1.906058,48,274472.2992,15248.46107,5718.1729,816.306305,31,0
0,0,92,92,32,104,136,482,387,869,0.000333,2.053002,48,295632.25,16424.01389,6159.005209,856.845731,33,0
0,0,84,84,32,99,131,452,361,813,0.000333,1.906058,48,274472.2992,15248.46107,5718.1729,816.306305,31,0
0,0,92,92,32,104,136,482,387,869,0.000333,2.053002,48,295632.25,16424.01389,6159.005209,856.845731,33,0
0,0,84,84,32,99,131,452,361,813,0.000333,1.906058,48,274472.2992,15248.46107,5718.1729,816.306305,31,0
0,0,91,91,32,97,129,470,370,840,0.000333,1.963144,48,282692.6829,15705.14905,5889.430895,800.191546,32,0
0,0,83,83,32,92,124,440,344,784,0.000333,1.817363,48,261700.3156,14538.90642,5452.089907,760.1677,30,0
0,0,93,93,32,98,130,485,383,868,0.000333,2.031805,48,292579.9326,16254.4407,6095.415262,808.241565,34,0
0,0,85,85,32,93,125,455,357,812,0.000333,1.885406,48,271498.4083,15083.2449,5656.216839,768.141769,32,0
0,0,93,93,32,98,130,485,383,868,0.000333,2.031805,48,292579.9326,16254.4407,6095.415262,808.241565,34,0
0,0,85,85,32,93,125,455,357,812,0.000333,1.885406,48,271498.4083,15083.2449,5656.216839,768.141769,32,0
0,0,93,93,32,98,130,485,383,868,0.000333,2.031805,48,292579.9326,16254.4407,6095.415262,808.241565,34,0
0,0,85,85,32,93,125,455,357,812,0.000333,1.885406,48,271498.4083,15083.2449,5656.216839,768.141769,32,0
0,0,93,93,32,98,130,485,383,868,0.000333,2.031805,48,292579.9326,16254.4407,6095.415262,808.241565,34,0
0,0,85,85,32,93,125,455,357,812,0.000333,1.885406,48,271498.4083,15083.2449,5656.216839,768.141769,32,0
0,0,91,91,32,96,128,469,369,838,0.000333,1.955333,48,281568,15642.66667,5866,792.1564,32,0
0,0,83,83,32,92,124,439,343,782,0.000333,1.812727,48,261032.7127,14501.81737,5438.181515,760.1677,30,0
0,0,93,93,32,97,129,484,382,866,0.000333,2.023908,48,291442.6946,16191.26081,6071.722803,800.191546,34,0
0,0,85,85,32,93,125,454,356,810,0.000333,1.880762,48,270829.693,15046.09406,5642.285271,768.141769,32,0
0,0,93,93,32,97,129,484,382,866,0.000333,2.023908,48,291442.6946,16191.26081,6071.722803,800.191546,34,0
0,0,85,85,32,93,125,454,356,810,0.000333,1.880762,48,270829.693,15046.09406,5642.285271,768.141769,32,0
0,0,93,93,32,97,129,484,382,866,0.000333,2.023908,48,291442.6946,16191.26081,6071.722803,800.191546,34,0
0,0,85,85,32,93,125,454,356,810,0.000333,1.880762,48,270829.693,15046.09406,5642.285271,768.141769,32,0
0,0,93,93,32,97,129,484,382,866,0.000333,2.023908,48,291442.6946,16191.26081,6071.722803,800.191546,34,0
0,0,85,85,32,93,125,454,356,810,0.000333,1.880762,48,270829.693,15046.09406,5642.285271,768.141769,32,0
0,0,91,91,32,97,129,470,370,840,0.000333,1.963144,48,282692.6829,15705.14905,5889.430895,800.191546,32,0
0,0,83,83,32,92,124,440,344,784,0.000333,1.817363,48,261700.3156,14538.90642,5452.089907,760.1677,30,0
0,0,93,93,32,98,130,485,383,868,0.000333,2.031805,48,292579.9326,16254.4407,6095.415262,808.241565,34,0
0,0,85,85,32,93,125,455,357,812,0.000333,1.885406,48,271498.4083,15083.2449,5656.216839,768.141769,32,0
0,0,93,93,32,98,130,485,383,868,0.000333,2.031805,48,292579.9326,16254.4407,6095.415262,808.241565,34,0
0,0,85,85,32,93,125,455,357,812,0.000333,1.885406,48,271498.4083,15083.2449,5656.216839,768.141769,32,0
0,0,93,93,32,98,130,485,383,868,0.000333,2.031805,48,292579.9326,16254.4407,6095.415262,808.241565,34,0
0,0,85,85,32,93,125,455,357,812,0.000333,1.885406,48,271498.4083,15083.2449,5656.216839,768.141769,32,0
0,0,93,93,32,98,130,485,383,868,0.000333,2.031805,48,292579.9326,16254.4407,6095.415262,808.241565,34,0
0,0,85,85,32,93,125,455,357,812,0.000333,1.885406,48,271498.4083,15083.2449,5656.216839,768.141769,32,0
0,0,91,91,32,105,137,469,378,847,0.000333,2.004011,48,288577.5924,16032.08847,6012.033174,864.995779,32,0
0,0,83,83,32,101,133,439,352,791,0.000333,1.860243,48,267874.9635,14881.94242,5580.728406,832.47936,30,0
0,0,93,93,32,106,138,484,391,875,0.000333,2.07332,48,298558.0272,16586.55707,6219.9589,873.159568,34,0
0,0,85,85,32,102,134,454,365,819,0.000333,1.929042,48,277782.0983,15432.33879,5787.127047,840.587385,32,0
0,0,93,93,32,106,138,484,391,875,0.000333,2.07332,48,298558.0272,16586.55707,6219.9589,873.159568,34,0
0,0,85,85,32,102,134,454,365,819,0.000333,1.929042,48,277782.0983,15432.33879,5787.127047,840.587385,32,0
0,0,93,93,32,106,138,484,391,875,0.000333,2.07332,48,298558.0272,16586.55707,6219.9589,873.159568,34,0
0,0,85,85,32,102,134,454,365,819,0.000333,1.929042,48,277782.0983,15432.33879,5787.127047,840.587385,32,0
0,0,93,93,32,106,138,484,391,875,0.000333,2.07332,48,298558.0272,16586.55707,6219.9589,873.159568,34,0
0,0,85,85,32,102,134,454,365,819,0.000333,1.929042,48,277782.0983,15432.33879,5787.127047,840.587385,32,0
0,0,90,90,32,119,151,467,399,866,0.000333,2.089486,48,300886.0082,16715.88935,6268.458504,980.483314,31,0
0,0,82,82,32,114,146,437,373,810,0.000333,1.941253,48,279540.3788,15530.02105,5823.757893,938.949462,29,0
0,0,92,92,32,120,152,482,412,894,0.000333,2.159882,48,311023.0655,17279.05919,6479.647197,988.826871,33,0
0,0,84,84,32,115,147,452,386,838,0.000333,2.011108,48,289599.6204,16088.8678,6033.325425,947.231356,31,0
0,0,92,92,32,120,152,482,412,894,0.000333,2.159882,48,311023.0655,17279.05919,6479.647197,988.826871,33,0
0,0,84,84,32,115,147,452,386,838,0.000333,2.011108,48,289599.6204,16088.8678,6033.325425,947.231356,31,0
0,0,92,92,32,120,152,482,412,894,0.000333,2.159882,48,311023.0655,17279.05919,6479.647197,988.826871,33,0
0,0,84,84,32,115,147,452,386,838,0.000333,2.011108,48,289599.6204,16088.8678,6033.325425,947.231356,31,0
0,0,92,92,32,120,152,482,412,894,0.000333,2.159882,48,311023.0655,17279.05919,6479.647197,988.826871,33,0
0,0,84,84,32,115,147,452,386,838,0.000333,2.011108,48,289599.6204,16088.8678,6033.325425,947.231356,31,0
0,0,90,90,32,118,150,466,398,864,0.000333,2.0819,48,299793.5687,16655.19826,6245.699349,972.15188,31,0
0,0,82,82,32,114,146,436,372,808,0.000333,1.936459,48,278850.1557,15491.67532,5809.378244,938.949462,29,0
0,0,92,92,32,119,151,481,411,892,0.000333,2.152219,48,309919.5373,17217.75207,6456.657027,980.483314,33,0
0,0,84,84,32,115,147,451,385,836,0.000333,2.006309,48,288908.4519,16050.46955,6018.92608,947.231356,31,0
0,0,92,92,32,119,151,481,411,892,0.000333,2.152219,48,309919.5373,17217.75207,6456.657027,980.483314,33,0
0,0,84,84,32,115,147,451,385,836,0.000333,2.006309,48,288908.4519,16050.46955,6018.92608,947.231356,31,0
0,0,92,92,32,119,151,481,411,892,0.000333,2.152219,48,309919.5373,17217.75207,6456.657027,980.483314,33,0
0,0,84,84,32,115,147,451,385,836,0.000333,2.006309,48,288908.4519,16050.46955,6018.92608,947.231356,31,0
0,0,92,92,32,119,151,481,411,892,0.000333,2.152219,48,309919.5373,17217.75207,6456.657027,980.483314,33,0
0,0,84,84,32,115,147,451,385,836,0.000333,2.006309,48,288908.4519,16050.46955,6018.92608,947.231356,31,0
0,0,91,91,32,97,129,470,370,840,0.000333,1.963144,48,282692.6829,15705.14905,5889.430895,800.191546,32,0
0,0,83,83,32,92,124,440,344,784,0.000333,1.817363,48,261700.3156,14538.90642,5452.089907,760.1677,30,0
0,0,93,93,32,98,130,485,383,868,0.000333,2.031805,48,292579.9326,16254.4407,6095.415262,808.241565,34,0
0,0,85,85,32,93,125,455,357,812,0.000333,1.885406,48,271498.4083,15083.2449,5656.216839,768.141769,32,0
0,0,93,93,32,98,130,485,383,868,0.000333,2.031805,48,292579.9326,16254.4407,6095.415262,808.241565,34,0
0,0,85,85,32,93,125,455,357,812,0.000333,1.885406,48,271498.4083,15083.2449,5656.216839,768.141769,32,0
0,0,93,93,32,98,130,485,383,868,0.000333,2.031805,48,292579.9326,16254.4407,6095.415262,808.241565,34,0
0,0,85,85,32,93,125,455,357,812,0.000333,1.885406,48,271498.4083,15083.2449,5656.216839,768.141769,32,0
0,0,93,93,32,98,130,485,383,868,0.000333,2.031805,48,292579.9326,16254.4407,6095.415262,808.241565,34,0
0,0,85,85,32,93,125,455,357,812,0.000333,1.885406,48,271498.4083,15083.2449,5656.216839,768.141769,32,0
0,0,91,91,33,107,140,471,383,854,0.000333,2.029469,48,292243.5694,16235.75386,6088.407696,887.801973,32,0
0,0,83,83,33,102,135,441,357,798,0.000333,1.882433,48,271070.3446,15059.46359,5647.298846,847.052391,30,0
0,0,93,93,33,108,141,486,396,882,0.000333,2.099028,48,302260.0461,16792.22478,6297.084293,895.992856,34,0
0,0,85,85,33,103,136,456,370,826,0.000333,1.951415,48,281003.7267,15611.31815,5854.244307,855.17456,32,0
0,0,93,93,33,108,141,486,396,882,0.000333,2.099028,48,302260.0461,16792.22478,6297.084293,895.992856,34,0
0,0,85,85,33,103,136,456,370,826,0.000333,1.951415,48,281003.7267,15611.31815,5854.244307,855.17456,32,0
0,0,93,93,33,108,141,486,396,882,0.000333,2.099028,48,302260.0461,16792.22478,6297.084293,895.992856,34,0
0,0,85,85,33,103,136,456,370,826,0.000333,1.951415,48,281003.7267,15611.31815,5854.244307,855.17456,32,0
0,0,93,93,33,108,141,486,396,882,0.000333,2.099028,48,302260.0461,16792.22478,6297.084293,895.992856,34,0
0,0,85,85,33,103,136,456,370,826,0.000333,1.951415,48,281003.7267,15611.31815,5854.244307,855.17456,32,0
0,0,91,91,33,111,144,470,387,857,0.000333,2.048209,48,294942.0349,16385.6686,6144.625726,920.645167,32,0
0,0,83,83,33,107,140,440,361,801,0.000333,1.903519,48,274106.6734,15228.14852,5710.555697,887.801973,30,0
0,0,93,93,33,112,145,485,400,885,0.000333,2.118073,48,305002.5381,16944.58545,6354.219545,928.888757,34,0
0,0,85,85,33,108,141,455,374,829,0.000333,1.972896,48,284097.0274,15783.16819,5918.688071,895.992856,32,0
0,0,93,93,33,112,145,485,400,885,0.000333,2.118073,48,305002.5381,16944.58545,6354.219545,928.888757,34,0
0,0,85,85,33,108,141,455,374,829,0.000333,1.972896,48,284097.0274,15783.16819,5918.688071,895.992856,32,0
0,0,93,93,33,112,145,485,400,885,0.000333,2.118073,48,305002.5381,16944.58545,6354.219545,928.888757,34,0
0,0,85,85,33,108,141,455,374,829,0.000333,1.972896,48,284097.0274,15783.16819,5918.688071,895.992856,32,0
0,0,93,93,33,112,145,485,400,885,0.000333,2.118073,48,305002.5381,16944.58545,6354.219545,928.888757,34,0
0,0,85,85,33,108,141,455,374,829,0.000333,1.972896,48,284097.0274,15783.16819,5918.688071,895.992856,32,0
0,0,91,91,33,111,144,472,399,871,0.000333,2.081668,48,299760.2245,16653.3458,6245.004676,920.645167,32,0
0,0,83,83,33,106,139,442,373,815,0.000333,1.933979,48,278492.9748,15471.83193,5801.936974,879.624574,30,0
0,0,93,93,33,112,145,487,412,899,0.000333,2.151579,48,309827.4371,17212.63539,6454.738272,928.888757,34,0
0,0,85,85,33,107,140,457,386,843,0.000333,2.003329,48,288479.308,16026.62822,6009.985583,887.801973,32,0
0,0,93,93,33,112,145,487,412,899,0.000333,2.151579,48,309827.4371,17212.63539,6454.738272,928.888757,34,0
0,0,85,85,33,107,140,457,386,843,0.000333,2.003329,48,288479.308,16026.62822,6009.985583,887.801973,32,0
0,0,93,93,33,112,145,487,412,899,0.000333,2.151579,48,309827.4371,17212.63539,6454.738272,928.888757,34,0
0,0,85,85,33,107,140,457,386,843,0.000333,2.003329,48,288479.308,16026.62822,6009.985583,887.801973,32,0
0,0,93,93,33,112,145,487,412,899,0.000333,2.151579,48,309827.4371,17212.63539,6454.738272,928.888757,34,0
0,0,85,85,33,107,140,457,386,843,0.000333,2.003329,48,288479.308,16026.62822,6009.985583,887.801973,32,0
0,0,90,90,32,118,150,468,404,872,0.000333,2.101177,48,302569.4351,16809.41306,6303.529898,972.15188,31,0
0,0,82,82,32,113,145,438,378,816,0.000333,1.952935,48,281222.6792,15623.48218,5858.805817,930.680223,29,0
0,0,92,92,32,119,151,483,417,900,0.000333,2.171521,48,312699.0847,17372.17137,6514.564265,980.483314,33,0
0,0,84,84,32,114,146,453,391,844,0.000333,2.022737,48,291274.1725,16181.89847,6068.211928,938.949462,31,0
0,0,92,92,32,119,151,483,417,900,0.000333,2.171521,48,312699.0847,17372.17137,6514.564265,980.483314,33,0
0,0,84,84,32,114,146,453,391,844,0.000333,2.022737,48,291274.1725,16181.89847,6068.211928,938.949462,31,0
0,0,92,92,32,119,151,483,417,900,0.000333,2.171521,48,312699.0847,17372.17137,6514.564265,980.483314,33,0
0,0,84,84,32,114,146,453,391,844,0.000333,2.022737,48,291274.1725,16181.89847,6068.211928,938.949462,31,0
0,0,92,92,32,119,151,483,417,900,0.000333,2.171521,48,312699.0847,17372.17137,6514.564265,980.483314,33,0
0,0,84,84,32,114,146,453,391,844,0.000333,2.022737,48,291274.1725,16181.89847,6068.211928,938.949462,31,0
0,0,91,91,33,110,143,471,398,869,0.000333,2.073976,48,298652.5532,16591.80851,6221.928192,912.414574,32,0
0,0,83,83,33,106,139,441,372,813,0.000333,1.929233,48,277809.5564,15433.86425,5787.699092,879.624574,30,0
0,0,93,93,33,111,144,486,411,897,0.000333,2.143808,48,308708.2909,17150.4606,6431.422726,920.645167,34,0
0,0,85,85,33,107,140,456,385,841,0.000333,1.998576,48,287794.8968,15988.60538,5995.727017,887.801973,32,0
0,0,93,93,33,111,144,486,411,897,0.000333,2.143808,48,308708.2909,17150.4606,6431.422726,920.645167,34,0
0,0,85,85,33,107,140,456,385,841,0.000333,1.998576,48,287794.8968,15988.60538,5995.727017,887.801973,32,0
0,0,93,93,33,111,144,486,411,897,0.000333,2.143808,48,308708.2909,17150.4606,6431.422726,920.645167,34,0
0,0,85,85,33,107,140,456,385,841,0.000333,1.998576,48,287794.8968,15988.60538,5995.727017,887.801973,32,0
0,0,93,93,33,111,144,486,411,897,0.000333,2.143808,48,308708.2909,17150.4606,6431.422726,920.645167,34,0
0,0,85,85,33,107,140,456,385,841,0.000333,1.998576,48,287794.8968,15988.60538,5995.727017,887.801973,32,0
0,0,91,91,33,112,145,471,388,859,0.000333,2.055847,48,296042.0116,16446.77842,6167.541908,928.888757,32,0
0,0,83,83,33,107,140,441,362,803,0.000333,1.908271,48,274791.0846,15266.17137,5724.814263,887.801973,30,0
0,0,93,93,33,113,146,486,401,887,0.000333,2.125791,48,306113.9704,17006.33169,6377.374384,937.145229,34,0
0,0,85,85,33,108,141,456,375,831,0.000333,1.977656,48,284782.4243,15821.2458,5932.967174,895.992856,32,0
0,0,93,93,33,113,146,486,401,887,0.000333,2.125791,48,306113.9704,17006.33169,6377.374384,937.145229,34,0
0,0,85,85,33,108,141,456,375,831,0.000333,1.977656,48,284782.4243,15821.2458,5932.967174,895.992856,32,0
0,0,93,93,33,113,146,486,401,887,0.000333,2.125791,48,306113.9704,17006.33169,6377.374384,937.145229,34,0
0,0,85,85,33,108,141,456,375,831,0.000333,1.977656,48,284782.4243,15821.2458,5932.967174,895.992856,32,0
0,0,93,93,33,113,146,486,401,887,0.000333,2.125791,48,306113.9704,17006.33169,6377.374384,937.145229,34,0
0,0,85,85,33,108,141,456,375,831,0.000333,1.977656,48,284782.4243,15821.2458,5932.967174,895.992856,32,0
0,0,92,92,32,99,131,472,375,847,0.000333,1.98577,48,285950.8456,15886.15809,5957.309282,816.306305,32,0
0,0,84,84,32,94,126,442,349,791,0.000333,1.839676,48,264913.3641,14717.40912,5519.028419,776.131352,30,0
0,0,94,94,32,100,132,487,388,875,0.000333,2.054615,48,295864.553,16436.91961,6163.844854,824.385619,34,0
0,0,86,86,32,95,127,457,362,819,0.000333,1.907911,48,274739.1724,15263.28736,5723.732758,784.136283,32,0
0,0,94,94,32,100,132,487,388,875,0.000333,2.054615,48,295864.553,16436.91961,6163.844854,824.385619,34,0
0,0,86,86,32,95,127,457,362,819,0.000333,1.907911,48,274739.1724,15263.28736,5723.732758,784.136283,32,0
0,0,94,94,32,100,132,487,388,875,0.000333,2.054615,48,295864.553,16436.91961,6163.844854,824.385619,34,0
0,0,86,86,32,95,127,457,362,819,0.000333,1.907911,48,274739.1724,15263.28736,5723.732758,784.136283,32,0
0,0,94,94,32,100,132,487,388,875,0.000333,2.054615,48,295864.553,16436.91961,6163.844854,824.385619,34,0
0,0,86,86,32,95,127,457,362,819,0.000333,1.907911,48,274739.1724,15263.28736,5723.732758,784.136283,32,0
0,0,92,92,32,107,139,469,385,854,0.000333,2.026525,48,291819.6325,16212.2018,6079.575676,881.336968,33,0
0,0,84,84,32,103,135,439,359,798,0.000333,1.882433,48,271070.3446,15059.46359,5647.298846,848.709554,31,0
0,0,94,94,32,108,140,484,398,882,0.000333,2.096009,48,301825.3258,16768.07366,6288.027621,889.52785,35,0
0,0,86,86,32,104,136,454,372,826,0.000333,1.951415,48,281003.7267,15611.31815,5854.244307,856.845731,33,0
0,0,94,94,32,108,140,484,398,882,0.000333,2.096009,48,301825.3258,16768.07366,6288.027621,889.52785,35,0
0,0,86,86,32,104,136,454,372,826,0.000333,1.951415,48,281003.7267,15611.31815,5854.244307,856.845731,33,0
0,0,94,94,32,108,140,484,398,882,0.000333,2.096009,48,301825.3258,16768.07366,6288.027621,889.52785,35,0
0,0,86,86,32,104,136,454,372,826,0.000333,1.951415,48,281003.7267,15611.31815,5854.244307,856.845731,33,0
0,0,94,94,32,108,140,484,398,882,0.000333,2.096009,48,301825.3258,16768.07366,6288.027621,889.52785,35,0
0,0,86,86,32,104,136,454,372,826,0.000333,1.951415,48,281003.7267,15611.31815,5854.244307,856.845731,33,0
0,0,92,92,31,97,128,468,372,840,0.000333,1.96,45,264600,14700,5880,793.771631,33,0
0,0,84,84,31,93,124,438,346,784,0.000333,1.817363,45,245344.0458,13630.22477,5452.089907,761.721855,31,0
0,0,94,94,31,98,129,483,385,868,0.000333,2.028582,45,273858.5366,15214.36314,6085.745258,801.82165,35,0
0,0,86,86,31,94,125,453,359,812,0.000333,1.885406,45,254529.7578,14140.5421,5656.216839,769.711438,33,0
0,0,94,94,31,98,129,483,385,868,0.000333,2.028582,45,273858.5366,15214.36314,6085.745258,801.82165,35,0
0,0,86,86,31,94,125,453,359,812,0.000333,1.885406,45,254529.7578,14140.5421,5656.216839,769.711438,33,0
0,0,94,94,31,98,129,483,385,868,0.000333,2.028582,45,273858.5366,15214.36314,6085.745258,801.82165,35,0
0,0,86,86,31,94,125,453,359,812,0.000333,1.885406,45,254529.7578,14140.5421,5656.216839,769.711438,33,0
0,0,94,94,31,98,129,483,385,868,0.000333,2.028582,45,273858.5366,15214.36314,6085.745258,801.82165,35,0
0,0,86,86,31,94,125,453,359,812,0.000333,1.885406,45,254529.7578,14140.5421,5656.216839,769.711438,33,0
0,0,91,91,31,103,134,465,376,841,0.000333,1.98086,45,267416.1454,14856.45252,5942.581009,842.28964,32,0
0,0,83,83,31,99,130,435,350,785,0.000333,1.83752,45,248065.143,13781.39683,5512.558733,809.886391,30,0
0,0,93,93,31,104,135,480,389,869,0.000333,2.049918,45,276738.8739,15374.38189,6149.752754,850.425816,34,0
0,0,85,85,31,100,131,450,363,813,0.000333,1.906058,45,257317.7805,14295.43225,5718.1729,817.965705,32,0
0,0,93,93,31,104,135,480,389,869,0.000333,2.049918,45,276738.8739,15374.38189,6149.752754,850.425816,34,0
0,0,85,85,31,100,131,450,363,813,0.000333,1.906058,45,257317.7805,14295.43225,5718.1729,817.965705,32,0
0,0,93,93,31,104,135,480,389,869,0.000333,2.049918,45,276738.8739,15374.38189,6149.752754,850.425816,34,0
0,0,85,85,31,100,131,450,363,813,0.000333,1.906058,45,257317.7805,14295.43225,5718.1729,817.965705,32,0
0,0,93,93,31,104,135,480,389,869,0.000333,2.049918,45,276738.8739,15374.38189,6149.752754,850.425816,34,0
0,0,85,85,31,100,131,450,363,813,0.000333,1.906058,45,257317.7805,14295.43225,5718.1729,817.965705,32,0
0,0,92,92,32,115,147,472,412,884,0.000333,2.121503,48,305496.4969,16972.02761,6364.510353,947.231356,33,0
0,0,84,84,32,110,142,442,386,828,0.000333,1.97333,48,284159.5495,15786.64164,5919.990615,905.949568,31,0
0,0,94,94,32,116,148,487,425,912,0.000333,2.191674,48,315601.0305,17533.39059,6575.021469,955.525795,35,0
0,0,86,86,32,111,143,457,399,856,0.000333,2.04295,48,294184.7935,16343.59964,6128.849864,914.180161,33,0
0,0,94,94,32,116,148,487,425,912,0.000333,2.191674,48,315601.0305,17533.39059,6575.021469,955.525795,35,0
0,0,86,86,32,111,143,457,399,856,0.000333,2.04295,48,294184.7935,16343.59964,6128.849864,914.180161,33,0
0,0,94,94,32,116,148,487,425,912,0.000333,2.191674,48,315601.0305,17533.39059,6575.021469,955.525795,35,0
0,0,86,86,32,111,143,457,399,856,0.000333,2.04295,48,294184.7935,16343.59964,6128.849864,914.180161,33,0
0,0,94,94,32,116,148,487,425,912,0.000333,2.191674,48,315601.0305,17533.39059,6575.021469,955.525795,35,0
0,0,86,86,32,111,143,457,399,856,0.000333,2.04295,48,294184.7935,16343.59964,6128.849864,914.180161,33,0
0,0,92,92,31,107,138,469,382,851,0.000333,2.016451,45,272220.9441,15123.38578,6049.354313,874.917053,33,0
0,0,84,84,31,102,133,439,356,795,0.000333,1.86965,45,252402.7291,14022.37384,5608.949536,834.167471,31,0
0,0,94,94,31,108,139,484,395,879,0.000333,2.08585,45,281589.7141,15643.87301,6257.549203,883.107936,35,0
0,0,86,86,31,103,134,454,369,823,0.000333,1.938464,45,261692.6132,14538.47851,5815.391404,842.28964,33,0
0,0,94,94,31,108,139,484,395,879,0.000333,2.08585,45,281589.7141,15643.87301,6257.549203,883.107936,35,0
0,0,86,86,31,103,134,454,369,823,0.000333,1.938464,45,261692.6132,14538.47851,5815.391404,842.28964,33,0
0,0,94,94,31,108,139,484,395,879,0.000333,2.08585,45,281589.7141,15643.87301,6257.549203,883.107936,35,0
0,0,86,86,31,103,134,454,369,823,0.000333,1.938464,45,261692.6132,14538.47851,5815.391404,842.28964,33,0
0,0,94,94,31,108,139,484,395,879,0.000333,2.08585,45,281589.7141,15643.87301,6257.549203,883.107936,35,0
0,0,86,86,31,103,134,454,369,823,0.000333,1.938464,45,261692.6132,14538.47851,5815.391404,842.28964,33,0
0,0,92,92,32,98,130,471,374,845,0.000333,1.977967,48,284827.2385,15823.73547,5933.900802,808.241565,32,0
0,0,84,84,32,94,126,441,348,789,0.000333,1.835025,48,264243.5453,14680.19696,5505.07386,776.131352,30,0
0,0,94,94,32,99,131,486,387,873,0.000333,2.046726,48,294728.5575,16373.80875,6140.17828,816.306305,34,0
0,0,86,86,32,95,127,456,361,817,0.000333,1.903252,48,274068.2587,15226.01437,5709.755389,784.136283,32,0
0,0,94,94,32,99,131,486,387,873,0.000333,2.046726,48,294728.5575,16373.80875,6140.17828,816.306305,34,0
0,0,86,86,32,95,127,456,361,817,0.000333,1.903252,48,274068.2587,15226.01437,5709.755389,784.136283,32,0
0,0,94,94,32,99,131,486,387,873,0.000333,2.046726,48,294728.5575,16373.80875,6140.17828,816.306305,34,0
0,0,86,86,32,95,127,456,361,817,0.000333,1.903252,48,274068.2587,15226.01437,5709.755389,784.136283,32,0
0,0,94,94,32,99,131,486,387,873,0.000333,2.046726,48,294728.5575,16373.80875,6140.17828,816.306305,34,0
0,0,86,86,32,95,127,456,361,817,0.000333,1.903252,48,274068.2587,15226.01437,5709.755389,784.136283,32,0
0,0,91,91,31,104,135,466,377,843,0.000333,1.988585,45,268458.9997,14914.38887,5965.755548,850.425816,32,0
0,0,83,83,31,99,130,436,351,787,0.000333,1.842201,45,248697.1561,13816.50867,5526.603469,809.886391,30,0
0,0,93,93,31,105,136,481,390,871,0.000333,2.057727,45,277793.1061,15432.95034,6173.180135,858.575865,34,0
0,0,85,85,31,100,131,451,364,815,0.000333,1.910747,45,257950.7886,14330.59937,5732.239746,817.965705,32,0
0,0,93,93,31,105,136,481,390,871,0.000333,2.057727,45,277793.1061,15432.95034,6173.180135,858.575865,34,0
0,0,85,85,31,100,131,451,364,815,0.000333,1.910747,45,257950.7886,14330.59937,5732.239746,817.965705,32,0
0,0,93,93,31,105,136,481,390,871,0.000333,2.057727,45,277793.1061,15432.95034,6173.180135,858.575865,34,0
0,0,85,85,31,100,131,451,364,815,0.000333,1.910747,45,257950.7886,14330.59937,5732.239746,817.965705,32,0
0,0,93,93,31,105,136,481,390,871,0.000333,2.057727,45,277793.1061,15432.95034,6173.180135,858.575865,34,0
0,0,85,85,31,100,131,451,364,815,0.000333,1.910747,45,257950.7886,14330.59937,5732.239746,817.965705,32,0
0,0,92,92,31,98,129,469,373,842,0.000333,1.967818,45,265655.4007,14758.63337,5903.453349,801.82165,33,0
0,0,84,84,31,93,124,439,347,786,0.000333,1.821999,45,245969.9235,13664.99575,5465.9983,761.721855,31,0
0,0,94,94,31,99,130,484,386,870,0.000333,2.036487,45,274925.6999,15273.64999,6109.459997,809.886391,35,0
0,0,86,86,31,94,125,454,360,814,0.000333,1.890049,45,255156.6783,14175.37102,5670.148408,769.711438,33,0
0,0,94,94,31,99,130,484,386,870,0.000333,2.036487,45,274925.6999,15273.64999,6109.459997,809.886391,35,0
0,0,86,86,31,94,125,454,360,814,0.000333,1.890049,45,255156.6783,14175.37102,5670.148408,769.711438,33,0
0,0,94,94,31,99,130,484,386,870,0.000333,2.036487,45,274925.6999,15273.64999,6109.459997,809.886391,35,0
0,0,86,86,31,94,125,454,360,814,0.000333,1.890049,45,255156.6783,14175.37102,5670.148408,769.711438,33,0
0,0,94,94,31,99,130,484,386,870,0.000333,2.036487,45,274925.6999,15273.64999,6109.459997,809.886391,35,0
0,0,86,86,31,94,125,454,360,814,0.000333,1.890049,45,255156.6783,14175.37102,5670.148408,769.711438,33,0
0,0,92,92,31,97,128,468,372,840,0.000333,1.96,45,264600,14700,5880,793.771631,33,0
0,0,84,84,31,93,124,438,346,784,0.000333,1.817363,45,245344.0458,13630.22477,5452.089907,761.721855,31,0
0,0,94,94,31,98,129,483,385,868,0.000333,2.028582,45,273858.5366,15214.36314,6085.745258,801.82165,35,0
0,0,86,86,31,94,125,453,359,812,0.000333,1.885406,45,254529.7578,14140.5421,5656.216839,769.711438,33,0
0,0,94,94,31,98,129,483,385,868,0.000333,2.028582,45,273858.5366,15214.36314,6085.745258,801.82165,35,0
0,0,86,86,31,94,125,453,359,812,0.000333,1.885406,45,254529.7578,14140.5421,5656.216839,769.711438,33,0
0,0,94,94,31,98,129,483,385,868,0.000333,2.028582,45,273858.5366,15214.36314,6085.745258,801.82165,35,0
0,0,86,86,31,94,125,453,359,812,0.000333,1.885406,45,254529.7578,14140.5421,5656.216839,769.711438,33,0
0,0,94,94,31,98,129,483,385,868,0.000333,2.028582,45,273858.5366,15214.36314,6085.745258,801.82165,35,0
0,0,86,86,31,94,125,453,359,812,0.000333,1.885406,45,254529.7578,14140.5421,5656.216839,769.711438,33,0
0,0,92,92,31,98,129,469,373,842,0.000333,1.967818,45,265655.4007,14758.63337,5903.453349,801.82165,33,0
0,0,84,84,31,93,124,439,347,786,0.000333,1.821999,45,245969.9235,13664.99575,5465.9983,761.721855,31,0
0,0,94,94,31,99,130,484,386,870,0.000333,2.036487,45,274925.6999,15273.64999,6109.459997,809.886391,35,0
0,0,86,86,31,94,125,454,360,814,0.000333,1.890049,45,255156.6783,14175.37102,5670.148408,769.711438,33,0
0,0,94,94,31,99,130,484,386,870,0.000333,2.036487,45,274925.6999,15273.64999,6109.459997,809.886391,35,0
0,0,86,86,31,94,125,454,360,814,0.000333,1.890049,45,255156.6783,14175.37102,5670.148408,769.711438,33,0
0,0,94,94,31,99,130,484,386,870,0.000333,2.036487,45,274925.6999,15273.64999,6109.459997,809.886391,35,0
0,0,86,86,31,94,125,454,360,814,0.000333,1.890049,45,255156.6783,14175.37102,5670.148408,769.711438,33,0
0,0,94,94,31,99,130,484,386,870,0.000333,2.036487,45,274925.6999,15273.64999,6109.459997,809.886391,35,0
0,0,86,86,31,94,125,454,360,814,0.000333,1.890049,45,255156.6783,14175.37102,5670.148408,769.711438,33,0
0,0,92,92,31,106,137,468,381,849,0.000333,2.008743,45,271180.3157,15065.5731,6026.229238,866.739654,33,0
0,0,84,84,31,102,133,438,355,793,0.000333,1.864946,45,251767.7537,13987.09743,5594.838971,834.167471,31,0
0,0,94,94,31,107,138,483,394,877,0.000333,2.078059,45,280537.9177,15585.43987,6234.175949,874.917053,35,0
0,0,86,86,31,103,134,453,368,821,0.000333,1.933753,45,261056.6651,14503.14806,5801.259225,842.28964,33,0
0,0,94,94,31,107,138,483,394,877,0.000333,2.078059,45,280537.9177,15585.43987,6234.175949,874.917053,35,0
0,0,86,86,31,103,134,453,368,821,0.000333,1.933753,45,261056.6651,14503.14806,5801.259225,842.28964,33,0
0,0,94,94,31,107,138,483,394,877,0.000333,2.078059,45,280537.9177,15585.43987,6234.175949,874.917053,35,0
0,0,86,86,31,103,134,453,368,821,0.000333,1.933753,45,261056.6651,14503.14806,5801.259225,842.28964,33,0
0,0,94,94,31,107,138,483,394,877,0.000333,2.078059,45,280537.9177,15585.43987,6234.175949,874.917053,35,0
0,0,86,86,31,103,134,453,368,821,0.000333,1.933753,45,261056.6651,14503.14806,5801.259225,842.28964,33,0
0,0,91,91,31,120,151,466,402,868,0.000333,2.094312,45,282732.0891,15707.33828,6282.935314,982.406957,32,0
0,0,83,83,31,115,146,436,376,812,0.000333,1.946046,45,262716.1894,14595.34386,5838.137542,940.811441,30,0
0,0,93,93,31,121,152,481,415,896,0.000333,2.164714,45,292236.4373,16235.35763,6494.143052,990.762537,34,0
0,0,85,85,31,116,147,451,389,840,0.000333,2.015908,45,272147.6146,15119.31192,6047.72477,949.105881,32,0
0,0,93,93,31,121,152,481,415,896,0.000333,2.164714,45,292236.4373,16235.35763,6494.143052,990.762537,34,0
0,0,85,85,31,116,147,451,389,840,0.000333,2.015908,45,272147.6146,15119.31192,6047.72477,949.105881,32,0
0,0,93,93,31,121,152,481,415,896,0.000333,2.164714,45,292236.4373,16235.35763,6494.143052,990.762537,34,0
0,0,85,85,31,116,147,451,389,840,0.000333,2.015908,45,272147.6146,15119.31192,6047.72477,949.105881,32,0
0,0,93,93,31,121,152,481,415,896,0.000333,2.164714,45,292236.4373,16235.35763,6494.143052,990.762537,34,0
0,0,85,85,31,116,147,451,389,840,0.000333,2.015908,45,272147.6146,15119.31192,6047.72477,949.105881,32,0
0,0,91,91,31,119,150,465,401,866,0.000333,2.086719,45,281707.0644,15650.39247,6260.156986,974.063399,32,0
0,0,83,83,31,115,146,435,375,810,0.000333,1.941253,45,262069.1052,14559.39473,5823.757893,940.811441,30,0
0,0,93,93,31,120,151,480,414,894,0.000333,2.157045,45,291201.0227,16177.83459,6471.133837,982.406957,34,0
0,0,85,85,31,116,147,450,388,838,0.000333,2.011108,45,271499.6441,15083.31356,6033.325425,949.105881,32,0
0,0,93,93,31,120,151,480,414,894,0.000333,2.157045,45,291201.0227,16177.83459,6471.133837,982.406957,34,0
0,0,85,85,31,116,147,450,388,838,0.000333,2.011108,45,271499.6441,15083.31356,6033.325425,949.105881,32,0
0,0,93,93,31,120,151,480,414,894,0.000333,2.157045,45,291201.0227,16177.83459,6471.133837,982.406957,34,0
0,0,85,85,31,116,147,450,388,838,0.000333,2.011108,45,271499.6441,15083.31356,6033.325425,949.105881,32,0
0,0,93,93,31,120,151,480,414,894,0.000333,2.157045,45,291201.0227,16177.83459,6471.133837,982.406957,34,0
0,0,85,85,31,116,147,450,388,838,0.000333,2.011108,45,271499.6441,15083.31356,6033.325425,949.105881,32,0
0,0,92,92,31,98,129,469,373,842,0.000333,1.967818,45,265655.4007,14758.63337,5903.453349,801.82165,33,0
0,0,84,84,31,93,124,439,347,786,0.000333,1.821999,45,245969.9235,13664.99575,5465.9983,761.721855,31,0
0,0,94,94,31,99,130,484,386,870,0.000333,2.036487,45,274925.6999,15273.64999,6109.459997,809.886391,35,0
0,0,86,86,31,94,125,454,360,814,0.000333,1.890049,45,255156.6783,14175.37102,5670.148408,769.711438,33,0
0,0,94,94,31,99,130,484,386,870,0.000333,2.036487,45,274925.6999,15273.64999,6109.459997,809.886391,35,0
0,0,86,86,31,94,125,454,360,814,0.000333,1.890049,45,255156.6783,14175.37102,5670.148408,769.711438,33,0
0,0,94,94,31,99,130,484,386,870,0.000333,2.036487,45,274925.6999,15273.64999,6109.459997,809.886391,35,0
0,0,86,86,31,94,125,454,360,814,0.000333,1.890049,45,255156.6783,14175.37102,5670.148408,769.711438,33,0
0,0,94,94,31,99,130,484,386,870,0.000333,2.036487,45,274925.6999,15273.64999,6109.459997,809.886391,35,0
0,0,86,86,31,94,125,454,360,814,0.000333,1.890049,45,255156.6783,14175.37102,5670.148408,769.711438,33,0
0,0,92,92,32,108,140,470,386,856,0.000333,2.034222,48,292927.9806,16273.7767,6102.666263,889.52785,33,0
0,0,84,84,32,103,135,440,360,800,0.000333,1.887151,48,271749.7189,15097.20661,5661.452478,848.709554,31,0
0,0,94,94,32,109,141,485,399,884,0.000333,2.103788,48,302945.443,16830.30239,6311.363396,897.732091,35,0
0,0,86,86,32,104,136,455,373,828,0.000333,1.95614,48,281684.1232,15649.11795,5868.419233,856.845731,33,0
0,0,94,94,32,109,141,485,399,884,0.000333,2.103788,48,302945.443,16830.30239,6311.363396,897.732091,35,0
0,0,86,86,32,104,136,455,373,828,0.000333,1.95614,48,281684.1232,15649.11795,5868.419233,856.845731,33,0
0,0,94,94,32,109,141,485,399,884,0.000333,2.103788,48,302945.443,16830.30239,6311.363396,897.732091,35,0
0,0,86,86,32,104,136,455,373,828,0.000333,1.95614,48,281684.1232,15649.11795,5868.419233,856.845731,33,0
0,0,94,94,32,109,141,485,399,884,0.000333,2.103788,48,302945.443,16830.30239,6311.363396,897.732091,35,0
0,0,86,86,32,104,136,455,373,828,0.000333,1.95614,48,281684.1232,15649.11795,5868.419233,856.845731,33,0
0,0,92,92,32,112,144,469,390,859,0.000333,2.052989,48,295630.3477,16423.9082,6158.965576,922.423751,33,0
0,0,84,84,32,108,140,439,364,803,0.000333,1.908271,48,274791.0846,15266.17137,5724.814263,889.52785,31,0
0,0,94,94,32,113,145,484,403,887,0.000333,2.12286,48,305691.8094,16982.8783,6368.579363,930.680223,35,0
0,0,86,86,32,109,141,454,377,831,0.000333,1.977656,48,284782.4243,15821.2458,5932.967174,897.732091,33,0
0,0,94,94,32,113,145,484,403,887,0.000333,2.12286,48,305691.8094,16982.8783,6368.579363,930.680223,35,0
0,0,86,86,32,109,141,454,377,831,0.000333,1.977656,48,284782.4243,15821.2458,5932.967174,897.732091,33,0
0,0,94,94,32,113,145,484,403,887,0.000333,2.12286,48,305691.8094,16982.8783,6368.579363,930.680223,35,0
0,0,86,86,32,109,141,454,377,831,0.000333,1.977656,48,284782.4243,15821.2458,5932.967174,897.732091,33,0
0,0,94,94,32,113,145,484,403,887,0.000333,2.12286,48,305691.8094,16982.8783,6368.579363,930.680223,35,0
0,0,86,86,32,109,141,454,377,831,0.000333,1.977656,48,284782.4243,15821.2458,5932.967174,897.732091,33,0
0,0,92,92,32,112,144,471,402,873,0.000333,2.086448,48,300448.5373,16691.5854,6259.344526,922.423751,33,0
0,0,84,84,32,107,139,441,376,817,0.000333,1.938725,48,279176.3931,15509.79962,5816.174856,881.336968,31,0
0,0,94,94,32,113,145,486,415,901,0.000333,2.156366,48,310516.7083,17250.92824,6469.09809,930.680223,35,0
0,0,86,86,32,108,140,456,389,845,0.000333,2.008081,48,289163.7192,16064.65107,6024.244149,889.52785,33,0
0,0,94,94,32,113,145,486,415,901,0.000333,2.156366,48,310516.7083,17250.92824,6469.09809,930.680223,35,0
0,0,86,86,32,108,140,456,389,845,0.000333,2.008081,48,289163.7192,16064.65107,6024.244149,889.52785,33,0
0,0,94,94,32,113,145,486,415,901,0.000333,2.156366,48,310516.7083,17250.92824,6469.09809,930.680223,35,0
0,0,86,86,32,108,140,456,389,845,0.000333,2.008081,48,289163.7192,16064.65107,6024.244149,889.52785,33,0
0,0,94,94,32,113,145,486,415,901,0.000333,2.156366,48,310516.7083,17250.92824,6469.09809,930.680223,35,0
0,0,86,86,32,108,140,456,389,845,0.000333,2.008081,48,289163.7192,16064.65107,6024.244149,889.52785,33,0
0,0,91,91,31,119,150,467,407,874,0.000333,2.105996,45,284309.4391,15794.96884,6317.987535,974.063399,32,0
0,0,83,83,31,114,145,437,381,818,0.000333,1.957722,45,264292.4536,14682.91409,5873.165636,932.529547,30,0
0,0,93,93,31,120,151,482,420,902,0.000333,2.176347,45,293806.8484,16322.60269,6529.041075,982.406957,34,0
0,0,85,85,31,115,146,452,394,846,0.000333,2.027531,45,273716.621,15206.47894,6082.591577,940.811441,32,0
0,0,93,93,31,120,151,482,420,902,0.000333,2.176347,45,293806.8484,16322.60269,6529.041075,982.406957,34,0
0,0,85,85,31,115,146,452,394,846,0.000333,2.027531,45,273716.621,15206.47894,6082.591577,940.811441,32,0
0,0,93,93,31,120,151,482,420,902,0.000333,2.176347,45,293806.8484,16322.60269,6529.041075,982.406957,34,0
0,0,85,85,31,115,146,452,394,846,0.000333,2.027531,45,273716.621,15206.47894,6082.591577,940.811441,32,0
0,0,93,93,31,120,151,482,420,902,0.000333,2.176347,45,293806.8484,16322.60269,6529.041075,982.406957,34,0
0,0,85,85,31,115,146,452,394,846,0.000333,2.027531,45,273716.621,15206.47894,6082.591577,940.811441,32,0
0,0,92,92,32,111,143,470,401,871,0.000333,2.078749,48,299339.9008,16629.99449,6236.247934,914.180161,33,0
0,0,84,84,32,107,139,440,375,815,0.000333,1.933979,48,278492.9748,15471.83193,5801.936974,881.336968,31,0
0,0,94,94,32,112,144,485,414,899,0.000333,2.148588,48,309396.6037,17188.7002,6445.762576,922.423751,35,0
0,0,86,86,32,108,140,455,388,843,0.000333,2.003329,48,288479.308,16026.62822,6009.985583,889.52785,33,0
0,0,94,94,32,112,144,485,414,899,0.000333,2.148588,48,309396.6037,17188.7002,6445.762576,922.423751,35,0
0,0,86,86,32,108,140,455,388,843,0.000333,2.003329,48,288479.308,16026.62822,6009.985583,889.52785,33,0
0,0,94,94,32,112,144,485,414,899,0.000333,2.148588,48,309396.6037,17188.7002,6445.762576,922.423751,35,0
0,0,86,86,32,108,140,455,388,843,0.000333,2.003329,48,288479.308,16026.62822,6009.985583,889.52785,33,0
0,0,94,94,32,112,144,485,414,899,0.000333,2.148588,48,309396.6037,17188.7002,6445.762576,922.423751,35,0
0,0,86,86,32,108,140,455,388,843,0.000333,2.003329,48,288479.308,16026.62822,6009.985583,889.52785,33,0
0,0,92,92,32,113,145,470,391,861,0.000333,2.060634,48,296731.2829,16485.07127,6181.901727,930.680223,33,0
0,0,84,84,32,108,140,440,365,805,0.000333,1.913024,48,275475.4958,15304.19421,5739.072829,889.52785,31,0
0,0,94,94,32,114,146,485,404,889,0.000333,2.130585,48,306804.1936,17044.67742,6391.754033,938.949462,35,0
0,0,86,86,32,109,141,455,378,833,0.000333,1.982415,48,285467.8213,15859.3234,5947.246277,897.732091,33,0
0,0,94,94,32,114,146,485,404,889,0.000333,2.130585,48,306804.1936,17044.67742,6391.754033,938.949462,35,0
0,0,86,86,32,109,141,455,378,833,0.000333,1.982415,48,285467.8213,15859.3234,5947.246277,897.732091,33,0
0,0,94,94,32,114,146,485,404,889,0.000333,2.130585,48,306804.1936,17044.67742,6391.754033,938.949462,35,0
0,0,86,86,32,109,141,455,378,833,0.000333,1.982415,48,285467.8213,15859.3234,5947.246277,897.732091,33,0
0,0,94,94,32,114,146,485,404,889,0.000333,2.130585,48,306804.1936,17044.67742,6391.754033,938.949462,35,0
0,0,86,86,32,109,141,455,378,833,0.000333,1.982415,48,285467.8213,15859.3234,5947.246277,897.732091,33,0
0,0,70,70,31,93,124,460,342,802,0.000333,1.859088,45,250976.9448,13943.1636,5577.265441,761.721855,32,0
0,0,56,56,28,77,105,359,266,625,0.000333,1.398801,42,176248.9448,9791.608047,4196.403449,617.148501,29,0
0,0,60,60,29,79,108,385,285,670,0.000333,1.508592,42,190082.5343,10560.1408,4525.774626,638.880128,30,0
0,0,55,55,28,77,105,355,264,619,0.000333,1.385373,42,174556.955,9697.608609,4156.117975,617.148501,28,0
0,0,58,58,29,78,107,378,278,656,0.000333,1.474134,42,185740.8984,10318.9388,4422.402343,631.142822,30,0
0,0,66,66,32,85,117,406,303,709,0.000333,1.623696,48,233812.2521,12989.56956,4871.088586,704.79823,32,0
0,0,66,66,32,85,117,406,303,709,0.000333,1.623696,48,233812.2521,12989.56956,4871.088586,704.79823,32,0
0,0,68,68,32,86,118,413,310,723,0.000333,1.658717,48,238855.2444,13269.7358,4976.150925,712.658769,32,0
0,0,54,54,29,80,109,359,262,621,0.000333,1.401014,42,176527.7836,9807.099087,4203.042466,646.635696,30,0
0,0,52,52,28,79,107,340,250,590,0.000333,1.325822,42,167053.5519,9280.752885,3977.465522,632.604617,29,0
0,0,56,56,29,81,110,366,269,635,0.000333,1.435388,42,180858.8636,10047.71464,4306.163418,654.409299,30,0
0,0,51,51,28,79,107,336,248,584,0.000333,1.312339,42,165354.7022,9186.372347,3937.01672,632.604617,28,0
0,0,54,54,29,80,109,359,262,621,0.000333,1.401014,42,176527.7836,9807.099087,4203.042466,646.635696,30,0
0,0,62,62,31,87,118,387,287,674,0.000333,1.5463,45,208750.5637,11597.25354,4638.901415,714.11617,32,0
0,0,62,62,31,87,118,387,287,674,0.000333,1.5463,45,208750.5637,11597.25354,4638.901415,714.11617,32,0
0,0,64,64,31,88,119,394,294,688,0.000333,1.581212,45,213463.558,11859.08655,4743.634621,722.010068,32,0
0,0,66,66,32,95,127,467,342,809,0.000333,1.884615,48,271384.6038,15076.92243,5653.845912,784.136283,33,0
0,0,54,54,29,81,110,363,266,629,0.000333,1.421825,42,179149.9609,9952.775606,4265.47526,654.409299,30,0
0,0,58,58,30,83,113,389,285,674,0.000333,1.532267,45,206856.0279,11492.00155,4596.800621,676.334991,31,0
0,0,53,53,29,81,110,359,264,623,0.000333,1.408262,42,177441.0583,9857.83657,4224.787102,654.409299,29,0
0,0,56,56,30,82,112,382,278,660,0.000333,1.497618,45,202178.4412,11232.13562,4492.854249,668.525982,31,0
0,0,64,64,32,89,121,410,303,713,0.000333,1.644383,48,236791.1754,13155.0653,4933.149488,736.340275,33,0
0,0,64,64,32,89,121,410,303,713,0.000333,1.644383,48,236791.1754,13155.0653,4933.149488,736.340275,33,0
0,0,66,66,32,90,122,417,310,727,0.000333,1.679549,48,241855.0101,13436.38945,5038.646044,744.266779,33,0
0,0,70,70,31,94,125,457,340,797,0.000333,1.850577,45,249827.8534,13879.32519,5551.730075,769.711438,32,0
0,0,56,56,28,78,106,356,264,620,0.000333,1.390437,42,175195.0486,9733.058258,4171.310682,624.867311,29,0
0,0,60,60,29,80,109,382,283,665,0.000333,1.500281,42,189035.3882,10501.96601,4500.842576,646.635696,30,0
0,0,55,55,28,78,106,352,262,614,0.000333,1.376981,42,173499.6127,9638.867371,4130.943159,624.867311,28,0
0,0,58,58,29,79,108,375,276,651,0.000333,1.465811,42,184692.1341,10260.67412,4397.431764,638.880128,30,0
0,0,66,66,32,86,118,403,301,704,0.000333,1.615127,48,232578.2739,12921.01522,4845.380707,712.658769,32,0
0,0,66,66,32,86,118,403,301,704,0.000333,1.615127,48,232578.2739,12921.01522,4845.380707,712.658769,32,0
0,0,68,68,32,87,119,410,308,718,0.000333,1.65016,48,237622.9994,13201.27774,4950.479154,720.536084,32,0
0,0,54,54,29,80,109,359,262,621,0.000333,1.401014,42,176527.7836,9807.099087,4203.042466,646.635696,30,0
0,0,52,52,28,79,107,340,250,590,0.000333,1.325822,42,167053.5519,9280.752885,3977.465522,632.604617,29,0
0,0,56,56,29,81,110,366,269,635,0.000333,1.435388,42,180858.8636,10047.71464,4306.163418,654.409299,30,0
0,0,51,51,28,79,107,336,248,584,0.000333,1.312339,42,165354.7022,9186.372347,3937.01672,632.604617,28,0
0,0,54,54,29,80,109,359,262,621,0.000333,1.401014,42,176527.7836,9807.099087,4203.042466,646.635696,30,0
0,0,62,62,31,87,118,387,287,674,0.000333,1.5463,45,208750.5637,11597.25354,4638.901415,714.11617,32,0
0,0,62,62,31,87,118,387,287,674,0.000333,1.5463,45,208750.5637,11597.25354,4638.901415,714.11617,32,0
0,0,64,64,31,88,119,394,294,688,0.000333,1.581212,45,213463.558,11859.08655,4743.634621,722.010068,32,0
0,0,66,66,32,96,128,464,340,804,0.000333,1.876,48,270144,15008,5628,792.1564,33,0
0,0,54,54,29,82,111,360,264,624,0.000333,1.413239,42,178068.051,9892.669501,4239.715501,662.200713,30,0
0,0,58,58,30,84,114,386,283,669,0.000333,1.523734,45,205704.1539,11428.00855,4571.203419,684.161381,31,0
0,0,53,53,29,82,111,356,262,618,0.000333,1.39965,42,176355.8582,9797.547679,4198.949005,662.200713,29,0
0,0,56,56,30,83,113,379,276,655,0.000333,1.489072,45,201024.7749,11168.04305,4467.21722,676.334991,31,0
0,0,64,64,32,90,122,407,301,708,0.000333,1.635654,48,235534.1777,13085.23209,4906.962035,744.266779,33,0
0,0,64,64,32,90,122,407,301,708,0.000333,1.635654,48,235534.1777,13085.23209,4906.962035,744.266779,33,0
0,0,66,66,32,91,123,414,308,722,0.000333,1.670832,48,240599.7827,13366.65459,5012.495473,752.209312,33,0
0,0,60,60,29,81,110,485,343,828,0.000333,1.871655,56,314438.0872,17468.78262,5614.965843,654.409299,30,0
0,0,64,64,30,83,113,511,362,873,0.000333,1.984672,60,357240.9741,19846.72078,5954.016234,676.334991,31,0
0,0,59,59,29,81,110,481,341,822,0.000333,1.858093,56,312159.5503,17342.19724,5574.277685,654.409299,29,0
0,0,62,62,30,82,112,504,355,859,0.000333,1.949173,60,350851.0727,19491.72626,5847.517878,668.525982,31,0
0,0,70,70,33,90,123,532,380,912,0.000333,2.110524,64,405220.6866,22512.26037,6331.573229,750.731785,33,0
0,0,70,70,33,90,123,532,380,912,0.000333,2.110524,64,405220.6866,22512.26037,6331.573229,750.731785,33,0
0,0,72,72,33,91,124,539,387,926,0.000333,2.146529,64,412133.4901,22896.30501,6439.585783,758.674318,33,0
0,0,60,60,29,81,110,485,343,828,0.000333,1.871655,56,314438.0872,17468.78262,5614.965843,654.409299,30,0
0,0,64,64,30,83,113,511,362,873,0.000333,1.984672,60,357240.9741,19846.72078,5954.016234,676.334991,31,0
0,0,59,59,29,81,110,481,341,822,0.000333,1.858093,56,312159.5503,17342.19724,5574.277685,654.409299,29,0
0,0,62,62,30,82,112,504,355,859,0.000333,1.949173,60,350851.0727,19491.72626,5847.517878,668.525982,31,0
0,0,70,70,33,90,123,532,380,912,0.000333,2.110524,64,405220.6866,22512.26037,6331.573229,750.731785,33,0
0,0,70,70,33,90,123,532,380,912,0.000333,2.110524,64,405220.6866,22512.26037,6331.573229,750.731785,33,0
0,0,72,72,33,91,124,539,387,926,0.000333,2.146529,64,412133.4901,22896.30501,6439.585783,758.674318,33,0
0,0,44,44,27,71,98,304,223,527,0.000333,1.161984,39,135952.1314,7552.89619,3485.952088,565.014008,22,0
0,0,42,42,26,70,96,285,211,496,0.000333,1.088714,39,127379.5146,7076.639701,3266.1414,551.261244,21,0
0,0,46,46,27,72,99,311,230,541,0.000333,1.195494,39,139872.7953,7770.710852,3586.481931,572.616563,22,0
0,0,41,41,26,70,96,281,209,490,0.000333,1.075544,26,83892.42226,4660.690126,3226.631625,551.261244,20,0
0,0,44,44,27,71,98,304,223,527,0.000333,1.161984,39,135952.1314,7552.89619,3485.952088,565.014008,22,0
0,0,52,52,30,79,109,332,248,580,0.000333,1.308516,45,176649.6109,9813.867271,3925.546908,645.205397,24,0
0,0,52,52,30,79,109,332,248,580,0.000333,1.308516,45,176649.6109,9813.867271,3925.546908,645.205397,24,0
0,0,54,54,30,80,110,339,255,594,0.000333,1.342709,45,181265.7451,10070.31918,4028.12767,652.960965,24,0
0,0,66,66,32,96,128,464,340,804,0.000333,1.876,48,270144,15008,5628,792.1564,33,0
0,0,54,54,29,82,111,360,264,624,0.000333,1.413239,42,178068.051,9892.669501,4239.715501,662.200713,30,0
0,0,58,58,30,84,114,386,283,669,0.000333,1.523734,45,205704.1539,11428.00855,4571.203419,684.161381,31,0
0,0,53,53,29,82,111,356,262,618,0.000333,1.39965,42,176355.8582,9797.547679,4198.949005,662.200713,29,0
0,0,56,56,30,83,113,379,276,655,0.000333,1.489072,45,201024.7749,11168.04305,4467.21722,676.334991,31,0
0,0,64,64,32,90,122,407,301,708,0.000333,1.635654,48,235534.1777,13085.23209,4906.962035,744.266779,33,0
0,0,64,64,32,90,122,407,301,708,0.000333,1.635654,48,235534.1777,13085.23209,4906.962035,744.266779,33,0
0,0,66,66,32,91,123,414,308,722,0.000333,1.670832,48,240599.7827,13366.65459,5012.495473,752.209312,33,0
0,0,55,55,29,79,108,460,325,785,0.000333,1.767529,56,296944.8546,16496.93637,5302.586689,638.880128,27,0
0,0,59,59,30,81,111,486,344,830,0.000333,1.879788,60,338361.9101,18797.8839,5639.365169,660.734568,28,0
0,0,54,54,29,79,108,456,323,779,0.000333,1.754019,56,294675.2124,16370.84513,5262.057364,638.880128,26,0
0,0,57,57,30,80,110,479,337,816,0.000333,1.84453,60,332015.3716,18445.29842,5533.589526,652.960965,28,0
0,0,65,65,33,88,121,507,362,869,0.000333,2.004164,64,384799.4978,21377.74988,6012.492153,734.894988,30,0
0,0,65,65,33,88,121,507,362,869,0.000333,2.004164,64,384799.4978,21377.74988,6012.492153,734.894988,30,0
0,0,67,67,33,89,122,514,369,883,0.000333,2.039947,64,391669.8284,21759.43491,6119.841069,742.805281,30,0
0,0,70,70,31,93,124,460,342,802,0.000333,1.859088,45,250976.9448,13943.1636,5577.265441,761.721855,32,0
0,0,56,56,28,77,105,359,266,625,0.000333,1.398801,42,176248.9448,9791.608047,4196.403449,617.148501,29,0
0,0,60,60,29,79,108,385,285,670,0.000333,1.508592,42,190082.5343,10560.1408,4525.774626,638.880128,30,0
0,0,55,55,28,77,105,355,264,619,0.000333,1.385373,42,174556.955,9697.608609,4156.117975,617.148501,28,0
0,0,58,58,29,78,107,378,278,656,0.000333,1.474134,42,185740.8984,10318.9388,4422.402343,631.142822,30,0
0,0,66,66,32,85,117,406,303,709,0.000333,1.623696,48,233812.2521,12989.56956,4871.088586,704.79823,32,0
0,0,66,66,32,85,117,406,303,709,0.000333,1.623696,48,233812.2521,12989.56956,4871.088586,704.79823,32,0
0,0,68,68,32,86,118,413,310,723,0.000333,1.658717,48,238855.2444,13269.7358,4976.150925,712.658769,32,0
0,0,54,54,29,80,109,359,262,621,0.000333,1.401014,42,176527.7836,9807.099087,4203.042466,646.635696,30,0
0,0,52,52,28,79,107,340,250,590,0.000333,1.325822,42,167053.5519,9280.752885,3977.465522,632.604617,29,0
0,0,56,56,29,81,110,366,269,635,0.000333,1.435388,42,180858.8636,10047.71464,4306.163418,654.409299,30,0
0,0,51,51,28,79,107,336,248,584,0.000333,1.312339,42,165354.7022,9186.372347,3937.01672,632.604617,28,0
0,0,54,54,29,80,109,359,262,621,0.000333,1.401014,42,176527.7836,9807.099087,4203.042466,646.635696,30,0
0,0,62,62,31,87,118,387,287,674,0.000333,1.5463,45,208750.5637,11597.25354,4638.901415,714.11617,32,0
0,0,62,62,31,87,118,387,287,674,0.000333,1.5463,45,208750.5637,11597.25354,4638.901415,714.11617,32,0
0,0,64,64,31,88,119,394,294,688,0.000333,1.581212,45,213463.558,11859.08655,4743.634621,722.010068,32,0
0,0,66,66,32,95,127,467,342,809,0.000333,1.884615,48,271384.6038,15076.92243,5653.845912,784.136283,33,0
0,0,54,54,29,81,110,363,266,629,0.000333,1.421825,42,179149.9609,9952.775606,4265.47526,654.409299,30,0
0,0,58,58,30,83,113,389,285,674,0.000333,1.532267,45,206856.0279,11492.00155,4596.800621,676.334991,31,0
0,0,53,53,29,81,110,359,264,623,0.000333,1.408262,42,177441.0583,9857.83657,4224.787102,654.409299,29,0
0,0,56,56,30,82,112,382,278,660,0.000333,1.497618,45,202178.4412,11232.13562,4492.854249,668.525982,31,0
0,0,64,64,32,89,121,410,303,713,0.000333,1.644383,48,236791.1754,13155.0653,4933.149488,736.340275,33,0
0,0,64,64,32,89,121,410,303,713,0.000333,1.644383,48,236791.1754,13155.0653,4933.149488,736.340275,33,0
0,0,66,66,32,90,122,417,310,727,0.000333,1.679549,48,241855.0101,13436.38945,5038.646044,744.266779,33,0
0,0,70,70,31,94,125,457,340,797,0.000333,1.850577,45,249827.8534,13879.32519,5551.730075,769.711438,32,0
0,0,56,56,28,78,106,356,264,620,0.000333,1.390437,42,175195.0486,9733.058258,4171.310682,624.867311,29,0
0,0,60,60,29,80,109,382,283,665,0.000333,1.500281,42,189035.3882,10501.96601,4500.842576,646.635696,30,0
0,0,55,55,28,78,106,352,262,614,0.000333,1.376981,42,173499.6127,9638.867371,4130.943159,624.867311,28,0
0,0,58,58,29,79,108,375,276,651,0.000333,1.465811,42,184692.1341,10260.67412,4397.431764,638.880128,30,0
0,0,66,66,32,86,118,403,301,704,0.000333,1.615127,48,232578.2739,12921.01522,4845.380707,712.658769,32,0
0,0,66,66,32,86,118,403,301,704,0.000333,1.615127,48,232578.2739,12921.01522,4845.380707,712.658769,32,0
0,0,68,68,32,87,119,410,308,718,0.000333,1.65016,48,237622.9994,13201.27774,4950.479154,720.536084,32,0
0,0,54,54,29,80,109,359,262,621,0.000333,1.401014,42,176527.7836,9807.099087,4203.042466,646.635696,30,0
0,0,52,52,28,79,107,340,250,590,0.000333,1.325822,42,167053.5519,9280.752885,3977.465522,632.604617,29,0
0,0,56,56,29,81,110,366,269,635,0.000333,1.435388,42,180858.8636,10047.71464,4306.163418,654.409299,30,0
0,0,51,51,28,79,107,336,248,584,0.000333,1.312339,42,165354.7022,9186.372347,3937.01672,632.604617,28,0
0,0,54,54,29,80,109,359,262,621,0.000333,1.401014,42,176527.7836,9807.099087,4203.042466,646.635696,30,0
0,0,62,62,31,87,118,387,287,674,0.000333,1.5463,45,208750.5637,11597.25354,4638.901415,714.11617,32,0
0,0,62,62,31,87,118,387,287,674,0.000333,1.5463,45,208750.5637,11597.25354,4638.901415,714.11617,32,0
0,0,64,64,31,88,119,394,294,688,0.000333,1.581212,45,213463.558,11859.08655,4743.634621,722.010068,32,0
0,0,66,66,32,96,128,464,340,804,0.000333,1.876,48,270144,15008,5628,792.1564,33,0
0,0,54,54,29,82,111,360,264,624,0.000333,1.413239,42,178068.051,9892.669501,4239.715501,662.200713,30,0
0,0,58,58,30,84,114,386,283,669,0.000333,1.523734,45,205704.1539,11428.00855,4571.203419,684.161381,31,0
0,0,53,53,29,82,111,356,262,618,0.000333,1.39965,42,176355.8582,9797.547679,4198.949005,662.200713,29,0
0,0,56,56,30,83,113,379,276,655,0.000333,1.489072,45,201024.7749,11168.04305,4467.21722,676.334991,31,0
0,0,64,64,32,90,122,407,301,708,0.000333,1.635654,48,235534.1777,13085.23209,4906.962035,744.266779,33,0
0,0,64,64,32,90,122,407,301,708,0.000333,1.635654,48,235534.1777,13085.23209,4906.962035,744.266779,33,0
0,0,66,66,32,91,123,414,308,722,0.000333,1.670832,48,240599.7827,13366.65459,5012.495473,752.209312,33,0
0,0,60,60,29,81,110,485,343,828,0.000333,1.871655,56,314438.0872,17468.78262,5614.965843,654.409299,30,0
0,0,64,64,30,83,113,511,362,873,0.000333,1.984672,60,357240.9741,19846.72078,5954.016234,676.334991,31,0
0,0,59,59,29,81,110,481,341,822,0.000333,1.858093,56,312159.5503,17342.19724,5574.277685,654.409299,29,0
0,0,62,62,30,82,112,504,355,859,0.000333,1.949173,60,350851.0727,19491.72626,5847.517878,668.525982,31,0
0,0,70,70,33,90,123,532,380,912,0.000333,2.110524,64,405220.6866,22512.26037,6331.573229,750.731785,33,0
0,0,70,70,33,90,123,532,380,912,0.000333,2.110524,64,405220.6866,22512.26037,6331.573229,750.731785,33,0
0,0,72,72,33,91,124,539,387,926,0.000333,2.146529,64,412133.4901,22896.30501,6439.585783,758.674318,33,0
0,0,60,60,29,81,110,485,343,828,0.000333,1.871655,56,314438.0872,17468.78262,5614.965843,654.409299,30,0
0,0,64,64,30,83,113,511,362,873,0.000333,1.984672,60,357240.9741,19846.72078,5954.016234,676.334991,31,0
0,0,59,59,29,81,110,481,341,822,0.000333,1.858093,56,312159.5503,17342.19724,5574.277685,654.409299,29,0
0,0,62,62,30,82,112,504,355,859,0.000333,1.949173,60,350851.0727,19491.72626,5847.517878,668.525982,31,0
0,0,70,70,33,90,123,532,380,912,0.000333,2.110524,64,405220.6866,22512.26037,6331.573229,750.731785,33,0
0,0,70,70,33,90,123,532,380,912,0.000333,2.110524,64,405220.6866,22512.26037,6331.573229,750.731785,33,0
0,0,72,72,33,91,124,539,387,926,0.000333,2.146529,64,412133.4901,22896.30501,6439.585783,758.674318,33,0
0,0,44,44,27,71,98,304,223,527,0.000333,1.161984,39,135952.1314,7552.89619,3485.952088,565.014008,22,0
0,0,42,42,26,70,96,285,211,496,0.000333,1.088714,39,127379.5146,7076.639701,3266.1414,551.261244,21,0
0,0,46,46,27,72,99,311,230,541,0.000333,1.195494,39,139872.7953,7770.710852,3586.481931,572.616563,22,0
0,0,41,41,26,70,96,281,209,490,0.000333,1.075544,26,83892.42226,4660.690126,3226.631625,551.261244,20,0
0,0,44,44,27,71,98,304,223,527,0.000333,1.161984,39,135952.1314,7552.89619,3485.952088,565.014008,22,0
0,0,52,52,30,79,109,332,248,580,0.000333,1.308516,45,176649.6109,9813.867271,3925.546908,645.205397,24,0
0,0,52,52,30,79,109,332,248,580,0.000333,1.308516,45,176649.6109,9813.867271,3925.546908,645.205397,24,0
0,0,54,54,30,80,110,339,255,594,0.000333,1.342709,45,181265.7451,10070.31918,4028.12767,652.960965,24,0
0,0,66,66,32,95,127,467,342,809,0.000333,1.884615,48,271384.6038,15076.92243,5653.845912,784.136283,33,0
0,0,54,54,29,81,110,363,266,629,0.000333,1.421825,42,179149.9609,9952.775606,4265.47526,654.409299,30,0
0,0,58,58,30,83,113,389,285,674,0.000333,1.532267,45,206856.0279,11492.00155,4596.800621,676.334991,31,0
0,0,53,53,29,81,110,359,264,623,0.000333,1.408262,42,177441.0583,9857.83657,4224.787102,654.409299,29,0
0,0,56,56,30,82,112,382,278,660,0.000333,1.497618,45,202178.4412,11232.13562,4492.854249,668.525982,31,0
0,0,64,64,32,89,121,410,303,713,0.000333,1.644383,48,236791.1754,13155.0653,4933.149488,736.340275,33,0
0,0,64,64,32,89,121,410,303,713,0.000333,1.644383,48,236791.1754,13155.0653,4933.149488,736.340275,33,0
0,0,66,66,32,90,122,417,310,727,0.000333,1.679549,48,241855.0101,13436.38945,5038.646044,744.266779,33,0
0,0,55,55,29,79,108,460,325,785,0.000333,1.767529,56,296944.8546,16496.93637,5302.586689,638.880128,27,0
0,0,59,59,30,81,111,486,344,830,0.000333,1.879788,60,338361.9101,18797.8839,5639.365169,660.734568,28,0
0,0,54,54,29,79,108,456,323,779,0.000333,1.754019,56,294675.2124,16370.84513,5262.057364,638.880128,26,0
0,0,57,57,30,80,110,479,337,816,0.000333,1.84453,60,332015.3716,18445.29842,5533.589526,652.960965,28,0
0,0,65,65,33,88,121,507,362,869,0.000333,2.004164,64,384799.4978,21377.74988,6012.492153,734.894988,30,0
0,0,65,65,33,88,121,507,362,869,0.000333,2.004164,64,384799.4978,21377.74988,6012.492153,734.894988,30,0
0,0,67,67,33,89,122,514,369,883,0.000333,2.039947,64,391669.8284,21759.43491,6119.841069,742.805281,30,0
0,0,43,43,24,71,95,236,182,418,0.000333,0.9154,24,65908.79146,3661.599526,2746.199644,546.671146,17,0
0,0,47,47,25,74,99,262,201,463,0.000333,1.023131,24,73665.41076,4092.52282,3069.392115,575.595954,18,0
0,0,42,42,24,70,94,232,180,412,0.000333,0.900164,24,64811.77457,3600.654143,2700.490607,539.088911,16,0
0,0,45,45,25,72,97,255,194,449,0.000333,0.987787,24,71120.66079,3951.147822,2963.360866,560.331005,18,0
0,0,39,39,22,69,91,226,172,398,0.000333,0.863367,22,56982.24987,3165.680548,2590.102267,519.595683,14,0
0,0,43,43,23,72,95,252,191,443,0.000333,0.970149,22,64029.81276,3557.21182,2910.446034,548.276525,15,0
0,0,38,38,22,68,90,222,170,392,0.000333,0.848269,22,55985.7411,3110.31895,2544.806414,512.054969,13,0
0,0,41,41,23,70,93,245,184,429,0.000333,0.9351,22,61716.58086,3428.698937,2805.29913,533.091736,15,0
0,0,56,56,29,89,118,310,244,554,0.000333,1.270995,28,106763.559,5931.308832,3812.984249,717.221724,24,0
0,0,58,58,29,91,120,317,251,568,0.000333,1.307705,28,109847.188,6102.621557,3923.113858,733.090761,24,0
0,0,49,49,26,78,104,278,214,492,0.000333,1.098872,26,85712.02487,4761.77916,3296.616341,612.472806,17,0
0,0,51,51,26,80,106,285,221,506,0.000333,1.134776,26,88512.5215,4917.362306,3404.32775,627.96568,17,0
1,0,3,4,12,14,26,31,16,47,0.000333,0.07364,6,1325.524001,73.640222,220.920667,96.322519,1,0
0,0,67,67,28,56,84,282,195,477,0.000333,1.016378,42,128063.6872,7114.649292,3049.135411,459.817813,22,0
0,0,66,66,28,56,84,278,192,470,0.000333,1.001463,42,126184.3459,7010.24144,3004.389189,459.817813,21,0
0,0,67,67,28,56,84,282,195,477,0.000333,1.016378,42,128063.6872,7114.649292,3049.135411,459.817813,22,0
0,0,66,66,28,56,84,278,192,470,0.000333,1.001463,42,126184.3459,7010.24144,3004.389189,459.817813,21,0
1,0,6,7,13,13,26,31,21,52,0.000333,0.081474,6,1466.537192,81.474288,244.422865,96.211433,4,0
1,0,7,8,13,13,26,35,24,59,0.000333,0.092442,6,1663.95566,92.441981,277.325943,96.211433,5,0
2,0,10,12,14,16,30,43,27,70,0.000333,0.114494,7,2404.376392,133.576466,343.482342,117.302969,6,0
1,0,47,48,23,52,75,217,165,382,0.000333,0.793136,33,78520.48841,4362.249356,2379.40874,400.46479,20,0
1,0,30,31,21,36,57,148,112,260,0.000333,0.505517,30,45496.54211,2527.585673,1516.551404,278.355966,8,0
1,0,30,31,21,36,57,148,112,260,0.000333,0.505517,30,45496.54211,2527.585673,1516.551404,278.355966,8,0
0,0,95,95,31,84,115,398,348,746,0.000333,1.702245,60,306404.1347,17022.45193,5106.735578,690.534749,14,0
0,0,45,45,22,69,91,223,179,402,0.000333,0.872044,22,57554.9358,3197.496433,2616.133445,519.595683,8,0
0,0,62,62,29,78,107,275,227,502,0.000333,1.128072,28,94758.05996,5264.336664,3384.216427,631.142822,10,0
3,0,64,67,24,63,87,269,206,475,0.000333,1.020133,36,110174.3338,6120.796321,3060.398161,486.607735,19,0
1,0,41,42,23,47,70,195,147,342,0.000333,0.698738,33,69175.08813,3843.060452,2096.214792,365.107601,16,0
1,0,41,42,23,47,70,195,147,342,0.000333,0.698738,33,69175.08813,3843.060452,2096.214792,365.107601,16,0
1,0,41,42,23,47,70,195,147,342,0.000333,0.698738,33,69175.08813,3843.060452,2096.214792,365.107601,16,0
2,0,40,42,24,48,72,260,169,429,0.000333,0.882299,36,95288.32172,5293.795651,2646.897826,378.1173,13,0
2,0,41,43,24,48,72,261,170,431,0.000333,0.886413,36,95732.55632,5318.475351,2659.237676,378.1173,13,0
1,0,61,62,25,72,97,307,224,531,0.000333,1.168185,36,126163.9339,7009.107438,3504.553719,560.331005,20,0
1,0,39,40,24,48,72,191,142,333,0.000333,0.684862,24,49310.04061,2739.446701,2054.585025,378.1173,13,0
0,0,52,52,24,76,100,246,192,438,0.000333,0.970003,24,69840.21627,3880.012015,2910.009011,584.881591,13,0
0,0,69,69,31,84,115,298,240,538,0.000333,1.227625,30,110486.2094,6138.122746,3682.873647,690.534749,15,0
0,0,53,53,24,78,102,257,201,458,0.000333,1.018657,24,73343.29936,4074.627742,3055.970807,600.300473,13,0
1,0,39,40,24,48,72,191,142,333,0.000333,0.684862,24,49310.04061,2739.446701,2054.585025,378.1173,13,0
0,0,70,70,31,86,117,309,249,558,0.000333,1.277888,30,115009.9054,6389.439189,3833.663514,706.238855,15,0
1,0,44,45,25,49,74,214,164,378,0.000333,0.782391,36,84498.2414,4694.346744,2347.173372,391.217187,16,0
1,0,39,40,24,47,71,192,143,335,0.000333,0.686722,36,74165.95026,4120.33057,2060.165285,371.104776,14,0
0,0,52,52,24,75,99,247,193,440,0.000333,0.972306,24,70006.00591,3889.22255,2916.916913,577.200502,14,0
0,0,69,69,31,83,114,299,241,540,0.000333,1.22992,30,110692.8182,6149.601013,3689.760608,682.708358,16,0
0,0,53,53,24,77,101,258,202,460,0.000333,1.020926,24,73506.65477,4083.703043,3062.777282,592.581664,14,0
1,0,39,40,24,47,71,192,143,335,0.000333,0.686722,36,74165.95026,4120.33057,2060.165285,371.104776,14,0
0,0,70,70,31,85,116,310,250,560,0.000333,1.280156,30,115214.0807,6400.782262,3840.469357,698.378315,16,0
2,0,50,52,23,61,84,308,211,519,0.000333,1.105871,33,109481.2205,6082.290028,3317.612742,465.816903,11,0
2,0,51,53,23,61,84,309,212,521,0.000333,1.110132,33,109903.1135,6105.728525,3330.397377,465.816903,11,0
1,0,32,33,23,38,61,160,121,281,0.000333,0.555512,33,54995.72733,3055.318185,1666.537192,303.463171,10,0
1,0,33,34,23,39,62,164,123,287,0.000333,0.569618,33,56392.19326,3132.899625,1708.854341,310.172612,11,0
0,0,46,46,24,69,93,219,173,392,0.000333,0.85445,24,61520.4061,3417.800339,2563.350254,531.527288,11,0
0,0,63,63,30,78,108,271,221,492,0.000333,1.107802,30,99702.13953,5539.007752,3323.404651,637.468091,13,0
0,0,47,47,24,71,95,230,182,412,0.000333,0.90226,24,64962.73226,3609.040681,2706.780511,546.671146,11,0
1,0,33,34,23,39,62,164,123,287,0.000333,0.569618,33,56392.19326,3132.899625,1708.854341,310.172612,11,0
0,0,64,64,30,80,110,282,230,512,0.000333,1.157352,30,104161.6852,5786.760289,3472.056173,652.960965,13,0
2,0,32,34,24,42,66,168,117,285,0.000333,0.574217,24,41343.65578,2296.869765,1722.652324,336.516432,11,0
2,0,33,35,24,42,66,169,118,287,0.000333,0.578247,24,41633.78669,2312.98815,1734.741112,336.516432,11,0
0,0,54,54,22,78,100,269,213,482,0.000333,1.067446,22,70451.45104,3913.969502,3202.338683,588.368869,12,0
1,0,38,39,22,45,67,183,137,320,0.000333,0.64705,33,64057.90185,3558.772325,1941.148541,345.240885,12,0
0,0,71,71,30,87,117,321,261,582,0.000333,1.332851,45,179934.852,9996.380667,3998.552267,707.742802,14,0
0,0,53,53,22,76,98,258,204,462,0.000333,1.018665,22,67231.91086,3735.106159,3055.995948,572.949987,12,0
0,0,70,70,30,85,115,310,252,562,0.000333,1.282388,30,115414.9623,6411.942348,3847.165409,692.004947,14,0
1,0,29,30,21,35,56,144,110,254,0.000333,0.491689,30,44252.04451,2458.446917,1475.06815,271.763571,7,0
1,0,30,31,21,36,57,148,112,260,0.000333,0.505517,30,45496.54211,2527.585673,1516.551404,278.355966,8,0
0,0,43,43,22,66,88,203,162,365,0.000333,0.785898,22,51869.2359,2881.624217,2357.692541,497.037507,8,0
0,0,60,60,29,75,104,255,210,465,0.000333,1.038568,28,87239.72513,4846.651396,3115.704469,608.042851,10,0
0,0,44,44,22,68,90,214,171,385,0.000333,0.833121,22,54985.99573,3054.77754,2499.363442,512.054969,8,0
1,0,30,31,21,36,57,148,112,260,0.000333,0.505517,30,45496.54211,2527.585673,1516.551404,278.355966,8,0
0,0,61,61,29,77,106,266,219,485,0.000333,1.08768,28,91365.15977,5075.84221,3263.04142,623.424012,10,0
1,0,52,53,24,57,81,245,183,428,0.000333,0.904485,36,97684.40884,5426.911602,2713.455801,442.513831,20,0
1,0,48,49,23,54,77,222,167,389,0.000333,0.812593,33,80446.73882,4469.263268,2437.779964,414.80585,20,0
1,0,63,64,24,62,86,279,218,497,0.000333,1.064618,36,114978.729,6387.707166,3193.853583,479.199271,28,0
1,0,47,48,23,52,75,217,165,382,0.000333,0.793136,33,78520.48841,4362.249356,2379.40874,400.46479,20,0
1,0,48,49,23,56,79,235,177,412,0.000333,0.865719,33,85706.20305,4761.455725,2597.157668,429.253801,13,0
0,0,55,55,22,81,103,274,216,490,0.000333,1.092128,22,72080.47568,4004.470871,3276.385258,611.635346,12,0
1,0,39,40,22,48,70,188,140,328,0.000333,0.670135,22,44228.90625,2457.161458,2010.40483,366.185696,12,0
0,0,72,72,30,90,120,326,264,590,0.000333,1.358355,30,122251.9635,6791.775752,4075.065451,731.473497,14,0
0,0,54,54,22,79,101,263,207,470,0.000333,1.04312,22,68845.90673,3824.772596,3129.359397,596.106175,12,0
0,0,71,71,30,88,118,315,255,570,0.000333,1.307702,30,117693.1961,6538.510897,3923.106538,715.6367,14,0
2,0,38,40,23,53,76,216,151,367,0.000333,0.76433,22,50445.76674,2802.542597,2292.989397,407.621709,10,0
2,0,39,41,23,53,76,217,152,369,0.000333,0.768495,22,50720.67555,2817.815309,2305.485252,407.621709,10,0
2,0,47,49,23,59,82,279,191,470,0.000333,0.996016,33,98605.63159,5478.090644,2988.049442,451.117865,11,0
2,0,48,50,23,59,82,280,192,472,0.000333,1.000255,33,99025.23002,5501.401668,3000.764546,451.117865,11,0
3,0,63,66,25,63,88,274,207,481,0.000333,1.035662,36,111851.5179,6213.973217,3106.986609,492.66504,16,0
2,0,48,50,23,60,83,302,206,508,0.000333,1.079507,33,106871.161,5937.286724,3238.520031,458.455361,10,0
2,0,49,51,23,60,83,303,207,510,0.000333,1.083757,33,107291.9136,5960.661868,3251.27011,458.455361,10,0
1,0,52,53,24,58,82,245,186,431,0.000333,0.913368,36,98643.7769,5480.209828,2740.104914,449.801998,20,0
1,0,48,49,23,55,78,222,168,390,0.000333,0.817102,33,80893.12656,4494.062586,2451.306865,422.016709,20,0
2,0,37,39,23,42,65,220,148,368,0.000333,0.738744,33,73135.63472,4063.090818,2216.231355,330.519257,11,0
2,0,38,40,23,42,65,221,149,370,0.000333,0.742759,33,73533.111,4085.172833,2228.276091,330.519257,11,0
2,0,31,33,23,45,68,172,122,294,0.000333,0.596571,22,39373.70966,2187.428314,1789.714075,351.175314,10,0
2,0,32,34,23,45,68,173,123,296,0.000333,0.60063,22,39641.55802,2202.308779,1801.889001,351.175314,10,0
2,0,88,90,24,92,116,513,363,876,0.000333,2.00253,36,216273.2887,12015.1827,6007.591352,710.2068,11,0
1,0,51,52,23,55,78,250,185,435,0.000333,0.911383,33,90226.94885,5012.60827,2734.149965,422.016709,20,0
1,0,51,52,23,55,78,250,185,435,0.000333,0.911383,33,90226.94885,5012.60827,2734.149965,422.016709,20,0
2,0,50,52,23,60,83,307,209,516,0.000333,1.096507,33,108554.1714,6030.787302,3289.520347,458.455361,11,0
2,0,51,53,23,60,83,308,210,518,0.000333,1.100757,33,108974.924,6054.162447,3302.270425,458.455361,11,0
1,0,42,43,22,49,71,216,158,374,0.000333,0.766668,33,75900.17895,4216.676608,2300.005423,373.228278,12,0
0,0,58,58,22,82,104,302,234,536,0.000333,1.197145,22,79011.58516,4389.532509,3591.435689,619.42676,12,0
1,0,42,43,22,49,71,216,158,374,0.000333,0.766668,33,75900.17895,4216.676608,2300.005423,373.228278,12,0
0,0,75,75,30,91,121,354,282,636,0.000333,1.466799,45,198017.8659,11000.99255,4400.397019,739.41603,14,0
0,0,57,57,22,80,102,291,225,516,0.000333,1.147657,22,75745.37248,4208.076249,3442.971476,603.861743,12,0
0,0,74,74,30,89,119,343,273,616,0.000333,1.415736,45,191124.3484,10618.01936,4247.207742,723.546993,14,0
1,0,41,42,24,48,72,215,158,373,0.000333,0.767127,36,82849.75292,4602.764051,2301.382026,378.1173,12,0
1,0,42,43,24,49,73,219,160,379,0.000333,0.781981,36,84453.96628,4691.887016,2345.943508,385.159882,13,0
0,0,55,55,24,77,101,274,210,484,0.000333,1.074191,24,77341.78458,4296.76581,3222.574358,592.581664,13,0
0,0,72,72,31,85,116,326,258,584,0.000333,1.33502,45,180227.7406,10012.65225,4005.060901,698.378315,15,0
0,0,56,56,24,79,103,285,219,504,0.000333,1.123332,24,80879.91038,4493.328354,3369.996266,608.037779,13,0
1,0,42,43,24,49,73,219,160,379,0.000333,0.781981,36,84453.96628,4691.887016,2345.943508,385.159882,13,0
0,0,73,73,31,87,118,337,267,604,0.000333,1.385705,45,187070.2381,10392.79101,4157.116402,714.11617,15,0
1,0,51,52,23,56,79,250,186,436,0.000333,0.916149,33,90698.79741,5038.822078,2748.448406,429.253801,20,0
1,0,51,52,23,56,79,250,186,436,0.000333,0.916149,33,90698.79741,5038.822078,2748.448406,429.253801,20,0
2,0,53,55,23,62,85,336,229,565,0.000333,1.207102,33,119503.094,6639.060778,3621.305879,473.202096,11,0
2,0,54,56,23,62,85,337,230,567,0.000333,1.211375,33,119926.1138,6662.561878,3634.124661,473.202096,11,0
1,0,48,49,23,55,78,223,169,392,0.000333,0.821293,33,81307.9631,4517.109061,2463.87767,422.016709,19,0
1,0,31,32,22,39,61,154,116,270,0.000333,0.533766,22,35228.57979,1957.143321,1601.299081,304.238182,7,0
1,0,31,32,22,39,61,154,116,270,0.000333,0.533766,22,35228.57979,1957.143321,1601.299081,304.238182,7,0
0,0,96,96,31,87,118,404,352,756,0.000333,1.734426,60,312196.6887,17344.26048,5203.278145,714.11617,13,0
0,0,46,46,22,72,94,229,183,412,0.000333,0.900164,22,59410.79335,3300.599631,2700.490607,542.342096,7,0
0,0,63,63,30,81,111,281,231,512,0.000333,1.15958,30,104362.2277,5797.901539,3478.740924,660.734568,9,0
3,0,65,68,24,66,90,275,210,485,0.000333,1.049516,36,113347.7551,6297.097503,3148.548752,508.969112,18,0
1,0,42,43,23,50,73,201,151,352,0.000333,0.726273,33,71901.00208,3994.500115,2178.818245,386.234734,15,0
1,0,42,43,23,50,73,201,151,352,0.000333,0.726273,33,71901.00208,3994.500115,2178.818245,386.234734,15,0
1,0,42,43,23,50,73,201,151,352,0.000333,0.726273,33,71901.00208,3994.500115,2178.818245,386.234734,15,0
2,0,41,43,24,51,75,266,173,439,0.000333,0.911484,36,98440.25059,5468.90281,2734.451405,399.332792,12,0
2,0,42,44,24,51,75,267,174,441,0.000333,0.915636,36,98888.72553,5493.818085,2746.909043,399.332792,12,0
1,0,62,63,25,75,100,313,228,541,0.000333,1.198109,36,129395.7432,7188.652397,3594.326199,583.257807,19,0
1,0,40,41,24,51,75,197,146,343,0.000333,0.712162,24,51275.63546,2848.646414,2136.484811,399.332792,12,0
0,0,53,53,24,79,103,252,196,448,0.000333,0.998517,24,71893.25367,3994.069648,2995.552236,608.037779,12,0
0,0,70,70,31,87,118,304,244,548,0.000333,1.257229,30,113150.6517,6286.147318,3771.688391,714.11617,14,0
0,0,54,54,24,81,105,263,205,468,0.000333,1.047422,24,75414.40565,4189.689203,3142.266902,623.56695,12,0
1,0,40,41,24,51,75,197,146,343,0.000333,0.712162,24,51275.63546,2848.646414,2136.484811,399.332792,12,0
0,0,71,71,31,89,120,315,253,568,0.000333,1.307705,30,117693.4157,6538.523097,3923.113858,729.920361,14,0
1,0,45,46,25,52,77,220,168,388,0.000333,0.810504,36,87534.4744,4863.026356,2431.513178,412.51927,15,0
1,0,40,41,24,50,74,198,147,345,0.000333,0.714087,24,51414.27387,2856.348548,2142.261411,392.23191,13,0
0,0,53,53,24,78,102,253,197,450,0.000333,1.000864,24,72062.19369,4003.455205,3002.591404,600.300473,13,0
0,0,70,70,31,86,117,305,245,550,0.000333,1.259567,30,113361.0179,6297.834326,3778.700596,706.238855,15,0
0,0,54,54,24,80,104,264,206,470,0.000333,1.049736,24,75580.96002,4198.942223,3149.206668,615.793348,13,0
1,0,40,41,24,50,74,198,147,345,0.000333,0.714087,24,51414.27387,2856.348548,2142.261411,392.23191,13,0
0,0,71,71,31,88,119,316,254,570,0.000333,1.310015,30,117901.3838,6550.076875,3930.046125,722.010068,15,0
2,0,51,53,23,64,87,314,215,529,0.000333,1.136106,33,112474.4646,6248.581367,3408.317109,488.041925,10,0
2,0,52,54,23,64,87,315,216,531,0.000333,1.140401,33,112899.6989,6272.205493,3421.202996,488.041925,10,0
1,0,33,34,24,41,65,166,125,291,0.000333,0.58417,36,63090.32521,3505.018067,1752.509034,329.698732,9,0
1,0,34,35,24,42,66,170,127,297,0.000333,0.598395,36,64626.66192,3590.370107,1795.185053,336.516432,10,0
0,0,47,47,24,72,96,225,177,402,0.000333,0.882385,24,63531.71821,3529.5399,2647.154925,554.2737,10,0
0,0,64,64,31,81,112,277,225,502,0.000333,1.139097,30,102518.7651,5695.486951,3417.292171,667.107936,12,0
0,0,48,48,24,74,98,236,186,422,0.000333,0.930469,24,66993.7813,3721.876739,2791.407554,569.538649,10,0
1,0,34,35,24,42,66,170,127,297,0.000333,0.598395,36,64626.66192,3590.370107,1795.185053,336.516432,10,0
0,0,65,65,31,83,114,288,234,522,0.000333,1.188923,30,107003.0576,5944.614312,3566.768587,682.708358,12,0
2,0,33,35,24,45,69,174,121,295,0.000333,0.600672,24,43248.35315,2402.686286,1802.014715,357.172489,10,0
2,0,34,36,24,45,69,175,122,297,0.000333,0.604744,24,43541.56233,2418.975685,1814.231764,357.172489,10,0
0,0,55,55,22,81,103,275,217,492,0.000333,1.096586,22,72374.68171,4020.81565,3289.758259,611.635346,11,0
1,0,39,40,22,48,70,189,141,330,0.000333,0.674221,22,44498.5947,2472.14415,2022.663396,366.185696,11,0
0,0,72,72,30,90,120,327,265,592,0.000333,1.36296,30,122666.377,6814.798721,4088.879233,731.473497,13,0
0,0,54,54,22,79,101,264,208,472,0.000333,1.047559,22,69138.86804,3841.048224,3142.67582,596.106175,11,0
0,0,71,71,30,88,118,316,256,572,0.000333,1.312291,30,118106.1547,6561.45304,3936.871824,715.6367,13,0
1,0,30,31,22,38,60,150,114,264,0.000333,0.519806,33,51460.83087,2858.935048,1559.419117,297.528741,6,0
1,0,31,32,22,39,61,154,116,270,0.000333,0.533766,22,35228.57979,1957.143321,1601.299081,304.238182,7,0
0,0,44,44,22,69,91,209,166,375,0.000333,0.813474,22,53689.30578,2982.73921,2440.42299,519.595683,7,0
0,0,61,61,30,78,108,261,214,475,0.000333,1.069524,30,96257.14691,5347.619273,3208.571564,637.468091,9,0
0,0,45,45,22,71,93,220,175,395,0.000333,0.860989,22,56825.29007,3156.960559,2582.96773,534.739541,7,0
1,0,31,32,22,39,61,154,116,270,0.000333,0.533766,22,35228.57979,1957.143321,1601.299081,304.238182,7,0
0,0,62,62,30,80,110,272,223,495,0.000333,1.118924,30,100703.1917,5594.621764,3356.773058,652.960965,9,0
1,0,53,54,24,60,84,251,187,438,0.000333,0.933278,36,100794.0611,5599.670062,2799.835031,464.452536,19,0
1,0,49,50,23,57,80,228,171,399,0.000333,0.840816,33,83240.82723,4624.490401,2522.44931,436.516656,19,0
1,0,64,65,24,65,89,285,222,507,0.000333,1.094399,36,118195.0866,6566.393699,3283.196849,501.493008,27,0
1,0,48,49,23,55,78,223,169,392,0.000333,0.821293,33,81307.9631,4517.109061,2463.87767,422.016709,19,0
1,0,49,50,23,59,82,241,181,422,0.000333,0.894296,33,88535.26922,4918.626068,2682.886946,451.117865,12,0
0,0,56,56,22,84,106,280,220,500,0.000333,1.12132,22,74007.125,4111.506944,3363.960227,635.062159,11,0
1,0,40,41,22,51,73,194,144,338,0.000333,0.697387,22,46027.53542,2557.085301,2092.160701,387.401188,11,0
0,0,73,73,30,93,123,332,268,600,0.000333,1.388503,30,124965.2611,6942.514505,4165.508703,755.348487,13,0
0,0,55,55,22,82,104,269,211,480,0.000333,1.07207,22,70756.64342,3930.924635,3216.211065,619.42676,11,0
0,0,72,72,30,91,121,321,259,580,0.000333,1.337647,30,120388.2203,6688.234463,4012.940678,739.41603,13,0
2,0,39,41,23,56,79,222,155,377,0.000333,0.792175,22,52283.55753,2904.642085,2376.525342,429.253801,9,0
2,0,40,42,23,56,79,223,156,379,0.000333,0.796378,22,52560.92388,2920.051327,2389.132904,429.253801,9,0
2,0,48,50,23,62,85,285,195,480,0.000333,1.025503,33,101524.7524,5640.264024,3076.507649,473.202096,10,0
2,0,49,51,23,62,85,286,196,482,0.000333,1.029775,33,101947.7722,5663.765124,3089.326431,473.202096,10,0
3,0,64,67,25,66,91,280,211,491,0.000333,1.065109,36,115031.7781,6390.654337,3195.327168,515.026417,15,0
2,0,49,51,23,63,86,308,210,518,0.000333,1.109602,33,109850.5697,6102.809429,3328.805143,480.61056,9,0
2,0,50,52,23,63,86,309,211,520,0.000333,1.113886,33,110274.7032,6126.372399,3341.657672,480.61056,9,0
1,0,53,54,24,61,85,251,190,441,0.000333,0.94218,36,101755.4905,5653.082806,2826.541403,471.814078,19,0
1,0,49,50,23,58,81,228,172,400,0.000333,0.845313,22,55790.68003,3099.482224,2535.940001,443.804823,19,0
2,0,38,40,23,45,68,226,152,378,0.000333,0.76702,33,75935.01148,4218.611749,2301.060954,351.175314,10,0
2,0,39,41,23,45,68,227,153,380,0.000333,0.771079,33,76336.78403,4240.932446,2313.23588,351.175314,10,0
2,0,32,34,23,48,71,178,126,304,0.000333,0.623174,22,41129.50874,2284.972708,1869.523124,372.120125,9,0
2,0,33,35,23,48,71,179,127,306,0.000333,0.627274,22,41400.09761,2300.005423,1881.822619,372.120125,9,0
2,0,89,91,24,95,119,519,367,886,0.000333,2.03627,36,219917.1074,12217.61708,6108.808538,734.175383,10,0
1,0,52,53,23,58,81,256,189,445,0.000333,0.940411,33,93100.69729,5172.260961,2821.233251,443.804823,19,0
1,0,52,53,23,58,81,256,189,445,0.000333,0.940411,33,93100.69729,5172.260961,2821.233251,443.804823,19,0
2,0,51,53,23,63,86,313,213,526,0.000333,1.126738,33,111547.1036,6197.061312,3380.215261,480.61056,10,0
2,0,52,54,23,63,86,314,214,528,0.000333,1.131023,33,111971.2371,6220.624283,3393.06779,480.61056,10,0
1,0,43,44,22,52,74,222,162,384,0.000333,0.79481,33,78686.19305,4371.455169,2384.430092,394.530361,11,0
0,0,59,59,22,85,107,308,238,546,0.000333,1.226947,22,80978.50144,4498.805636,3680.840975,642.905725,11,0
1,0,43,44,22,52,74,222,162,384,0.000333,0.79481,33,78686.19305,4371.455169,2384.430092,394.530361,11,0
0,0,76,76,30,94,124,360,286,646,0.000333,1.49747,45,202158.4867,11231.02704,4492.410817,763.33807,13,0
0,0,58,58,22,83,105,297,229,526,0.000333,1.177231,22,77697.24913,4316.513841,3531.693142,627.235768,11,0
0,0,75,75,30,92,122,349,277,626,0.000333,1.446214,45,195238.8708,10846.60393,4338.641573,747.374418,13,0
1,0,42,43,24,51,75,221,162,383,0.000333,0.795213,36,85882.95211,4771.275117,2385.637558,399.332792,11,0
1,0,43,44,24,52,76,225,164,389,0.000333,0.810148,36,87495.9769,4860.887605,2430.443803,406.461965,12,0
0,0,56,56,24,80,104,280,214,494,0.000333,1.103339,24,79440.4133,4413.356294,3310.017221,615.793348,12,0
0,0,73,73,31,88,119,332,262,594,0.000333,1.365174,30,122865.6525,6825.869586,4095.521751,722.010068,14,0
0,0,57,57,24,82,106,291,223,514,0.000333,1.152717,24,82995.62673,4610.868152,3458.151114,631.358364,12,0
1,0,43,44,24,52,76,225,164,389,0.000333,0.810148,36,87495.9769,4860.887605,2430.443803,406.461965,12,0
0,0,74,74,31,90,121,343,271,614,0.000333,1.416061,45,191168.1912,10620.45507,4248.182028,737.846864,14,0
1,0,52,53,23,59,82,256,190,446,0.000333,0.945156,33,93570.4504,5198.358356,2835.468194,451.117865,19,0
1,0,52,53,23,59,82,256,190,446,0.000333,0.945156,33,93570.4504,5198.358356,2835.468194,451.117865,19,0
2,0,54,56,23,65,88,342,233,575,0.000333,1.238058,33,122567.715,6809.317498,3714.173181,495.495833,10,0
2,0,55,57,23,65,88,343,234,577,0.000333,1.242364,33,122994.0375,6833.002081,3727.092044,495.495833,10,0
4,0,96,100,30,73,103,377,284,661,0.000333,1.473259,45,198889.9582,11049.44212,4419.776848,599.063911,27,0
2,0,31,33,18,40,58,130,97,227,0.000333,0.443254,18,23935.71035,1329.761686,1329.761686,287.935774,17,0
3,0,91,94,28,99,127,404,307,711,0.000333,1.656318,42,208696.1021,11594.2279,4968.954812,790.912243,40,0
2,0,89,91,26,96,122,386,298,684,0.000333,1.580208,39,184884.3492,10271.35273,4740.624339,754.367833,39,0
2,0,89,91,27,98,125,395,301,696,0.000333,1.616062,39,189079.2486,10504.4027,4848.185862,776.623527,39,0
2,0,88,90,26,95,121,380,293,673,0.000333,1.552132,39,181599.4034,10088.85574,4656.394959,746.347715,39,0
2,0,89,91,25,93,118,377,290,667,0.000333,1.530241,36,165266.0249,9181.445828,4590.722914,724.238174,40,0
2,0,88,90,26,96,122,389,298,687,0.000333,1.587139,39,185695.2455,10316.40253,4761.416551,754.367833,39,0
2,0,89,91,27,99,126,395,301,696,0.000333,1.618729,39,189391.2862,10521.73813,4856.186827,784.688268,39,0
2,0,40,42,22,60,82,185,141,326,0.000333,0.690854,22,45596.36298,2533.131277,2072.561954,452.520931,20,0
2,0,89,91,26,97,123,386,298,684,0.000333,1.582893,39,185198.5169,10288.8065,4748.679922,762.402978,39,0
2,0,89,91,27,99,126,395,301,696,0.000333,1.618729,39,189391.2862,10521.73813,4856.186827,784.688268,39,0
2,0,81,83,25,98,123,356,282,638,0.000333,1.476441,24,106303.7821,5905.765673,4429.324254,764.337969,35,0
2,0,88,90,26,96,122,380,293,673,0.000333,1.554795,39,181911.0629,10106.17016,4664.386228,754.367833,39,0
2,0,89,91,25,94,119,377,290,667,0.000333,1.532948,36,165558.3641,9197.686896,4598.843448,732.227757,40,0
2,0,88,90,26,97,123,389,298,687,0.000333,1.589836,39,186010.7911,10333.93284,4769.507465,762.402978,39,0
2,0,26,28,16,33,49,100,75,175,0.000333,0.327525,16,15721.18756,873.399309,982.574223,230.465006,14,0
2,0,26,28,16,33,49,100,75,175,0.000333,0.327525,16,15721.18756,873.399309,982.574223,230.465006,14,0
3,0,86,89,26,94,120,374,285,659,0.000333,1.517214,39,177513.9952,9861.888622,4551.640903,738.342785,37,0
2,0,84,86,24,91,115,356,276,632,0.000333,1.442117,36,155748.5896,8652.699424,4326.349712,702.248412,36,0
2,0,84,86,25,93,118,365,279,644,0.000333,1.477474,36,159567.1965,8864.844248,4432.422124,724.238174,36,0
2,0,141,143,26,115,141,572,404,976,0.000333,2.322734,39,271759.8827,15097.77126,6968.20212,909.442789,40,0
2,0,83,85,24,90,114,350,271,621,0.000333,1.414408,36,152756.0892,8486.449398,4243.224699,694.305879,36,0
2,0,84,86,23,88,111,347,268,615,0.000333,1.392855,33,137892.67,7660.703889,4178.565758,672.471907,37,0
2,0,83,85,24,91,115,359,276,635,0.000333,1.448962,36,156487.9026,8693.772365,4346.886182,702.248412,36,0
2,0,84,86,25,94,119,365,279,644,0.000333,1.480088,24,106566.3034,5920.350186,4440.26264,732.227757,36,0
2,0,35,37,20,54,74,155,119,274,0.000333,0.56713,20,34027.80444,1890.43358,1701.390222,397.202487,17,0
2,0,84,86,24,92,116,356,276,632,0.000333,1.444748,36,156032.7836,8668.487978,4334.243989,710.2068,36,0
2,0,84,86,25,94,119,365,279,644,0.000333,1.480088,24,106566.3034,5920.350186,4440.26264,732.227757,36,0
2,0,76,78,23,93,116,326,260,586,0.000333,1.339592,22,88413.09099,4911.838388,4018.776863,712.183694,32,0
2,0,83,85,24,91,115,350,271,621,0.000333,1.417016,24,102025.1837,5668.065762,4251.049322,702.248412,36,0
2,0,84,86,23,89,112,347,268,615,0.000333,1.395508,33,138155.2681,7675.292675,4186.523277,680.3822,37,0
2,0,83,85,24,92,116,359,276,635,0.000333,1.451606,36,156773.4455,8709.635864,4354.817932,710.2068,36,0
2,0,126,128,25,80,105,520,353,873,0.000333,1.953845,48,281353.7442,15630.76357,5861.536337,621.850652,30,0
2,0,29,31,16,38,54,115,86,201,0.000333,0.385577,16,18507.71821,1028.206567,1156.732388,263.421246,16,0
3,0,89,92,26,97,123,389,296,685,0.000333,1.585207,39,185469.275,10303.84861,4755.622436,762.402978,39,0
2,0,87,89,24,95,119,371,287,658,0.000333,1.512263,36,163324.4432,9073.580177,4536.790088,734.175383,38,0
2,0,87,89,25,96,121,380,290,670,0.000333,1.545213,36,166882.9813,9271.276738,4635.638369,748.252805,38,0
2,0,85,87,24,94,118,367,294,661,0.000333,1.516476,36,163779.374,9098.854111,4549.427056,726.170452,37,0
2,0,86,88,24,93,117,365,282,647,0.000333,1.481709,36,160024.535,8890.251947,4445.125974,718.180869,38,0
2,0,87,89,23,91,114,362,279,641,0.000333,1.459961,33,144536.1225,8029.784582,4379.882499,696.251237,39,0
2,0,86,88,24,94,118,374,287,661,0.000333,1.516476,36,163779.374,9098.854111,4549.427056,726.170452,38,0
2,0,87,89,25,97,122,380,290,670,0.000333,1.547865,24,111446.2564,6191.458688,4643.594016,756.28795,38,0
2,0,38,40,20,58,78,170,130,300,0.000333,0.62854,20,37712.41331,2095.134073,1885.620666,426.20146,19,0
2,0,87,89,24,96,120,371,287,658,0.000333,1.514911,24,109073.6163,6059.645349,4544.734012,742.1955,38,0
2,0,87,89,25,97,122,380,290,670,0.000333,1.547865,24,111446.2564,6191.458688,4643.594016,756.28795,38,0
2,0,79,81,23,92,115,341,271,612,0.000333,1.39648,22,92167.67805,5120.426558,4189.439911,704.209625,34,0
2,0,86,88,24,94,118,365,282,647,0.000333,1.484357,36,160310.5219,8906.140106,4453.070053,726.170452,38,0
2,0,87,89,23,92,115,362,279,641,0.000333,1.462653,33,144802.651,8044.591725,4387.959123,704.209625,39,0
2,0,86,88,24,95,119,374,287,661,0.000333,1.519158,36,164069.0835,9114.949083,4557.474542,734.175383,38,0
2,0,31,33,16,40,56,125,94,219,0.000333,0.423937,16,20348.97165,1130.498425,1271.810728,276.877124,17,0
3,0,91,94,26,99,125,399,304,703,0.000333,1.632315,39,190980.9077,10610.05043,4896.946352,778.517738,40,0
2,0,89,91,24,97,121,381,295,676,0.000333,1.559051,36,168377.4557,9354.303097,4677.151548,750.230646,39,0
2,0,89,91,25,98,123,390,298,688,0.000333,1.59215,36,171952.1993,9552.899959,4776.44998,764.337969,39,0
2,0,110,112,25,108,133,522,384,906,0.000333,2.130695,36,230115.0919,12784.17177,6392.085887,845.624255,40,0
2,0,88,90,24,95,119,375,290,665,0.000333,1.528351,36,165061.9373,9170.107625,4585.053813,734.175383,39,0
2,0,89,91,23,93,116,372,287,659,0.000333,1.50647,33,149140.5127,8285.584039,4519.409476,712.183694,40,0
2,0,88,90,24,96,120,384,295,679,0.000333,1.56326,36,168832.0337,9379.557429,4689.778714,742.1955,39,0
2,0,89,91,25,99,124,390,298,688,0.000333,1.594829,36,172241.5342,9568.974123,4784.487062,772.40271,39,0
2,0,40,42,20,60,80,180,138,318,0.000333,0.670124,20,40207.46268,2233.747927,2010.373134,440.851998,20,0
2,0,89,91,24,98,122,381,295,676,0.000333,1.561726,36,168666.4238,9370.35688,4685.17844,758.280665,39,0
2,0,89,91,25,99,124,390,298,688,0.000333,1.594829,36,172241.5342,9568.974123,4784.487062,772.40271,39,0
2,0,81,83,23,95,118,351,279,630,0.000333,1.445355,22,95393.43266,5299.635148,4336.065121,728.178208,35,0
2,0,88,90,24,96,120,375,290,665,0.000333,1.531027,36,165350.9609,9186.164492,4593.082246,742.1955,39,0
2,0,89,91,23,94,117,372,287,659,0.000333,1.50919,33,149409.8216,8300.545642,4527.57035,720.173277,40,0
2,0,88,90,24,97,121,384,295,679,0.000333,1.565969,36,169124.693,9395.816276,4697.908138,750.230646,39,0
4,0,96,100,30,72,102,377,284,661,0.000333,1.470158,45,198471.2918,11026.18288,4410.473151,591.441318,27,0
2,0,31,33,18,40,58,130,97,227,0.000333,0.443254,18,23935.71035,1329.761686,1329.761686,287.935774,17,0
3,0,91,94,28,98,126,404,307,711,0.000333,1.653615,42,208355.5331,11575.30739,4960.846026,782.847503,40,0
2,0,89,91,26,95,121,386,298,684,0.000333,1.577501,39,184567.5957,10253.75532,4732.502454,746.347715,39,0
2,0,89,91,27,97,124,395,301,696,0.000333,1.613374,39,188764.7046,10486.92804,4840.120632,768.573508,39,0
2,0,88,90,26,94,120,380,293,673,0.000333,1.549446,39,181285.1575,10071.39764,4648.337371,738.342785,39,0
2,0,89,91,25,92,117,377,290,667,0.000333,1.527511,36,164971.1976,9165.066536,4582.533268,716.264105,40,0
2,0,88,90,26,96,122,389,298,687,0.000333,1.587139,39,185695.2455,10316.40253,4761.416551,754.367833,39,0
2,0,89,91,27,98,125,395,301,696,0.000333,1.616062,39,189079.2486,10504.4027,4848.185862,776.623527,39,0
2,0,40,42,22,60,82,185,141,326,0.000333,0.690854,22,45596.36298,2533.131277,2072.561954,452.520931,20,0
2,0,89,91,26,96,122,386,298,684,0.000333,1.580208,39,184884.3492,10271.35273,4740.624339,754.367833,39,0
2,0,89,91,27,98,125,395,301,696,0.000333,1.616062,39,189079.2486,10504.4027,4848.185862,776.623527,39,0
2,0,81,83,25,98,123,356,282,638,0.000333,1.476441,24,106303.7821,5905.765673,4429.324254,764.337969,35,0
2,0,88,90,26,95,121,380,293,673,0.000333,1.552132,39,181599.4034,10088.85574,4656.394959,746.347715,39,0
2,0,89,91,25,93,118,377,290,667,0.000333,1.530241,36,165266.0249,9181.445828,4590.722914,724.238174,40,0
2,0,88,90,26,97,123,389,298,687,0.000333,1.589836,39,186010.7911,10333.93284,4769.507465,762.402978,39,0
2,0,26,28,16,33,49,100,75,175,0.000333,0.327525,16,15721.18756,873.399309,982.574223,230.465006,14,0
2,0,26,28,16,33,49,100,75,175,0.000333,0.327525,16,15721.18756,873.399309,982.574223,230.465006,14,0
3,0,86,89,26,93,119,374,285,659,0.000333,1.514562,39,177203.7113,9844.65063,4543.684906,730.353202,37,0
2,0,84,86,24,90,114,356,276,632,0.000333,1.439462,36,155461.9136,8636.772978,4318.386489,694.305879,36,0
2,0,84,86,25,92,117,365,279,644,0.000333,1.474838,36,159282.5357,8849.029759,4424.514879,716.264105,36,0
2,0,141,143,26,115,141,572,404,976,0.000333,2.322734,39,271759.8827,15097.77126,6968.20212,909.442789,40,0
2,0,83,85,24,89,113,350,271,621,0.000333,1.411777,36,152471.9209,8470.662271,4235.331136,686.379375,36,0
2,0,84,86,23,87,110,347,268,615,0.000333,1.390179,33,137627.6954,7645.983077,4170.536224,664.578009,37,0
2,0,83,85,24,91,115,359,276,635,0.000333,1.448962,36,156487.9026,8693.772365,4346.886182,702.248412,36,0
2,0,84,86,25,93,118,365,279,644,0.000333,1.477474,36,159567.1965,8864.844248,4432.422124,724.238174,36,0
2,0,35,37,20,54,74,155,119,274,0.000333,0.56713,20,34027.80444,1890.43358,1701.390222,397.202487,17,0
2,0,84,86,24,91,115,356,276,632,0.000333,1.442117,36,155748.5896,8652.699424,4326.349712,702.248412,36,0
2,0,84,86,25,93,118,365,279,644,0.000333,1.477474,36,159567.1965,8864.844248,4432.422124,724.238174,36,0
2,0,76,78,23,93,116,326,260,586,0.000333,1.339592,22,88413.09099,4911.838388,4018.776863,712.183694,32,0
2,0,83,85,24,90,114,350,271,621,0.000333,1.414408,36,152756.0892,8486.449398,4243.224699,694.305879,36,0
2,0,84,86,23,88,111,347,268,615,0.000333,1.392855,33,137892.67,7660.703889,4178.565758,672.471907,37,0
2,0,83,85,24,92,116,359,276,635,0.000333,1.451606,36,156773.4455,8709.635864,4354.817932,710.2068,36,0
2,0,125,127,25,81,106,517,361,878,0.000333,1.969038,48,283541.4796,15752.30442,5907.114159,629.624255,30,0
2,0,29,31,16,38,54,115,86,201,0.000333,0.385577,16,18507.71821,1028.206567,1156.732388,263.421246,16,0
3,0,89,92,26,96,122,389,296,685,0.000333,1.582518,39,185154.648,10286.36933,4747.555076,754.367833,39,0
2,0,87,89,24,94,118,371,287,658,0.000333,1.509593,36,163036.0486,9057.558253,4528.779126,726.170452,38,0
2,0,87,89,25,95,120,380,290,670,0.000333,1.542539,36,166594.2012,9255.233398,4627.616699,740.232688,38,0
2,0,86,88,24,92,116,365,282,647,0.000333,1.479038,36,159736.0933,8874.227408,4437.113704,710.2068,38,0
2,0,87,89,23,90,113,362,279,641,0.000333,1.457245,33,144267.2456,8014.846977,4371.734715,688.308704,39,0
2,0,86,88,24,94,118,374,287,661,0.000333,1.516476,36,163779.374,9098.854111,4549.427056,726.170452,38,0
2,0,87,89,25,96,121,380,290,670,0.000333,1.545213,36,166882.9813,9271.276738,4635.638369,748.252805,38,0
2,0,38,40,20,58,78,170,130,300,0.000333,0.62854,20,37712.41331,2095.134073,1885.620666,426.20146,19,0
2,0,87,89,24,95,119,371,287,658,0.000333,1.512263,36,163324.4432,9073.580177,4536.790088,734.175383,38,0
2,0,87,89,25,96,121,380,290,670,0.000333,1.545213,36,166882.9813,9271.276738,4635.638369,748.252805,38,0
2,0,79,81,23,94,117,341,271,612,0.000333,1.401554,22,92502.59058,5139.03281,4204.663208,720.173277,34,0
2,0,86,88,24,93,117,365,282,647,0.000333,1.481709,36,160024.535,8890.251947,4445.125974,718.180869,38,0
2,0,87,89,23,91,114,362,279,641,0.000333,1.459961,33,144536.1225,8029.784582,4379.882499,696.251237,39,0
2,0,86,88,24,95,119,374,287,661,0.000333,1.519158,36,164069.0835,9114.949083,4557.474542,734.175383,38,0
2,0,31,33,16,40,56,125,94,219,0.000333,0.423937,16,20348.97165,1130.498425,1271.810728,276.877124,17,0
3,0,91,94,26,98,124,399,304,703,0.000333,1.6296,39,190663.2002,10592.40001,4888.800006,770.452997,40,0
2,0,89,91,24,96,120,381,295,676,0.000333,1.556353,36,168086.0895,9338.116085,4669.058043,742.1955,39,0
2,0,89,91,25,97,122,390,298,688,0.000333,1.589449,36,171660.5024,9536.694576,4768.347288,756.28795,39,0
2,0,88,90,24,94,118,375,290,665,0.000333,1.525653,36,164770.4746,9153.915256,4576.957628,726.170452,39,0
2,0,89,91,23,92,115,372,287,659,0.000333,1.503726,33,148868.8721,8270.492897,4511.177944,704.209625,40,0
2,0,88,90,24,96,120,384,295,679,0.000333,1.56326,36,168832.0337,9379.557429,4689.778714,742.1955,39,0
2,0,89,91,25,98,123,390,298,688,0.000333,1.59215,36,171952.1993,9552.899959,4776.44998,764.337969,39,0
2,0,40,42,20,60,80,180,138,318,0.000333,0.670124,20,40207.46268,2233.747927,2010.373134,440.851998,20,0
2,0,89,91,24,97,121,381,295,676,0.000333,1.559051,36,168377.4557,9354.303097,4677.151548,750.230646,39,0
2,0,89,91,25,98,123,390,298,688,0.000333,1.59215,36,171952.1993,9552.899959,4776.44998,764.337969,39,0
2,0,81,83,23,96,119,351,279,630,0.000333,1.447912,22,95562.1742,5309.009678,4343.735191,736.198325,35,0
2,0,88,90,24,95,119,375,290,665,0.000333,1.528351,36,165061.9373,9170.107625,4585.053813,734.175383,39,0
2,0,89,91,23,93,116,372,287,659,0.000333,1.50647,33,149140.5127,8285.584039,4519.409476,712.183694,40,0
2,0,88,90,24,97,121,384,295,679,0.000333,1.565969,36,169124.693,9395.816276,4697.908138,750.230646,39,0
0,0,108,108,30,97,127,426,367,793,0.000333,1.847342,45,249391.213,13855.06739,5542.026957,787.398264,14,0
0,0,64,64,27,71,98,243,216,459,0.000333,1.012051,39,118409.9209,6578.32894,3036.151818,565.014008,11,0
2,0,22,24,17,31,48,95,71,166,0.000333,0.309035,16,14833.6604,824.092245,927.103775,223.066954,11,0
2,0,23,25,17,32,49,99,73,172,0.000333,0.32191,16,15451.68149,858.42675,965.730093,229.486868,12,0
2,0,23,25,17,32,49,99,73,172,0.000333,0.32191,16,15451.68149,858.42675,965.730093,229.486868,12,0
3,0,82,85,26,92,118,369,281,650,0.000333,1.491239,39,174475.0013,9693.055628,4473.717982,722.379133,34,0
2,0,111,113,25,100,125,470,379,849,0.000333,1.971317,36,212902.2309,11827.90172,5913.950858,780.482024,38,0
2,0,80,82,24,89,113,351,272,623,0.000333,1.416324,36,152962.9738,8497.942987,4248.971494,686.379375,33,0
2,0,80,82,25,91,116,360,275,635,0.000333,1.451606,36,156773.4455,8709.635864,4354.817932,708.305717,33,0
2,0,137,139,27,113,140,567,400,967,0.000333,2.298006,39,268866.6504,14937.03613,6894.016677,899.062185,37,0
2,0,79,81,24,88,112,345,267,612,0.000333,1.3887,36,149979.6436,8332.202425,4166.101212,678.469082,33,0
2,0,80,82,23,86,109,342,264,606,0.000333,1.367173,33,135350.1501,7519.452785,4101.519701,656.700694,34,0
2,0,79,81,24,90,114,354,272,626,0.000333,1.425796,36,153986.0094,8554.778298,4277.389149,694.305879,33,0
2,0,81,83,25,92,117,364,277,641,0.000333,1.467968,36,158540.5363,8807.807571,4403.903785,716.264105,34,0
2,0,32,34,20,52,72,154,117,271,0.000333,0.55735,20,33440.99351,1857.832973,1672.049675,382.861427,15,0
2,0,81,83,24,90,114,355,274,629,0.000333,1.432629,36,154723.9615,8595.775638,4297.887819,694.305879,34,0
2,0,81,83,25,92,117,364,277,641,0.000333,1.467968,36,158540.5363,8807.807571,4403.903785,716.264105,34,0
2,0,73,75,24,92,116,325,258,583,0.000333,1.332734,24,95956.87008,5330.937227,3998.20292,710.2068,30,0
2,0,80,82,24,89,113,349,269,618,0.000333,1.404957,36,151735.3416,8429.741198,4214.870599,686.379375,34,0
2,0,81,83,23,87,110,346,266,612,0.000333,1.383397,33,136956.3408,7608.685599,4150.192145,664.578009,35,0
2,0,80,82,24,91,115,358,274,632,0.000333,1.442117,36,155748.5896,8652.699424,4326.349712,702.248412,34,0
0,0,48,48,20,59,79,196,175,371,0.000333,0.779568,20,46774.05315,2598.558508,2338.702658,433.514502,10,0
0,0,49,49,20,61,81,207,184,391,0.000333,0.826294,30,74366.44053,4131.468919,2478.881351,448.213539,10,0
2,0,81,83,25,91,116,364,277,641,0.000333,1.465322,36,158254.7694,8791.931636,4395.965818,708.305717,34,0
2,0,32,34,20,52,72,154,117,271,0.000333,0.55735,20,33440.99351,1857.832973,1672.049675,382.861427,15,0
2,0,81,83,24,89,113,355,274,629,0.000333,1.429964,36,154436.1324,8579.785135,4289.892567,686.379375,34,0
2,0,81,83,25,91,116,364,277,641,0.000333,1.465322,36,158254.7694,8791.931636,4395.965818,708.305717,34,0
2,0,73,75,24,91,115,325,258,583,0.000333,1.330307,24,95782.09679,5321.2276,3990.9207,702.248412,30,0
2,0,80,82,24,88,112,349,269,618,0.000333,1.402315,36,151450.0323,8413.890684,4206.945342,678.469082,34,0
2,0,81,83,23,86,109,346,266,612,0.000333,1.38071,33,136690.2506,7593.902812,4142.128807,656.700694,35,0
2,0,80,82,24,90,114,358,274,632,0.000333,1.439462,36,155461.9136,8636.772978,4318.386489,694.305879,34,0
0,0,98,98,31,98,129,361,307,668,0.000333,1.561167,45,210757.4913,11708.74952,4683.499807,801.82165,13,0
0,0,68,68,28,75,103,267,230,497,0.000333,1.10773,42,139574.012,7754.111778,3323.190762,601.76734,12,0
2,0,26,28,19,36,55,119,85,204,0.000333,0.393132,18,21229.15287,1179.397382,1179.397382,266.827923,12,0
2,0,27,29,19,37,56,123,87,210,0.000333,0.406515,18,21951.80161,1219.544534,1219.544534,273.460397,13,0
2,0,27,29,19,37,56,123,87,210,0.000333,0.406515,18,21951.80161,1219.544534,1219.544534,273.460397,13,0
3,0,86,89,27,97,124,393,295,688,0.000333,1.594829,39,186594.9954,10366.38863,4784.487062,768.573508,35,0
2,0,115,117,26,105,131,494,393,887,0.000333,2.079549,39,243307.2019,13517.06677,6238.646202,827.207212,39,0
2,0,84,86,25,94,119,375,286,661,0.000333,1.519158,36,164069.0835,9114.949083,4557.474542,732.227757,34,0
2,0,84,86,26,96,122,384,289,673,0.000333,1.554795,39,181911.0629,10106.17016,4664.386228,754.367833,34,0
2,0,83,85,25,93,118,369,281,650,0.000333,1.491239,36,161053.8474,8947.435964,4473.717982,724.238174,34,0
2,0,84,86,24,91,115,366,278,644,0.000333,1.469499,36,158705.8413,8816.991186,4408.495593,702.248412,35,0
2,0,83,85,25,94,119,378,286,664,0.000333,1.526053,36,164813.7238,9156.31799,4578.158995,732.227757,34,0
2,0,85,87,26,97,123,388,291,679,0.000333,1.571322,39,183844.7266,10213.59592,4713.967349,762.402978,35,0
2,0,36,38,22,58,80,178,131,309,0.000333,0.651159,22,42976.46719,2387.581511,1953.475781,437.870393,16,0
2,0,85,87,25,95,120,379,288,667,0.000333,1.535632,36,165848.257,9213.792055,4606.896027,740.232688,35,0
2,0,85,87,26,97,123,388,291,679,0.000333,1.571322,39,183844.7266,10213.59592,4713.967349,762.402978,35,0
2,0,77,79,25,96,121,349,272,621,0.000333,1.432205,24,103118.7377,5728.81876,4296.61407,748.252805,31,0
2,0,84,86,25,94,119,373,283,656,0.000333,1.507667,36,162828.0163,9046.000905,4523.000453,732.227757,35,0
2,0,85,87,24,92,116,370,280,650,0.000333,1.485896,36,160476.7553,8915.375294,4457.687647,710.2068,36,0
2,0,84,86,25,95,120,382,288,670,0.000333,1.542539,36,166594.2012,9255.233398,4627.616699,740.232688,35,0
0,0,52,52,21,63,84,220,189,409,0.000333,0.871486,30,78433.73478,4357.42971,2614.457826,468.807301,11,0
0,0,53,53,21,65,86,231,198,429,0.000333,0.918956,30,82706.02739,4594.7793,2756.86758,483.692574,11,0
2,0,85,87,26,96,122,388,291,679,0.000333,1.568657,39,183532.8554,10196.26975,4705.970652,754.367833,35,0
2,0,36,38,22,58,80,178,131,309,0.000333,0.651159,22,42976.46719,2387.581511,1953.475781,437.870393,16,0
2,0,85,87,25,94,119,379,288,667,0.000333,1.532948,36,165558.3641,9197.686896,4598.843448,732.227757,35,0
2,0,85,87,26,96,122,388,291,679,0.000333,1.568657,39,183532.8554,10196.26975,4705.970652,754.367833,35,0
2,0,77,79,25,95,120,349,272,621,0.000333,1.429726,24,102940.2974,5718.905413,4289.17906,740.232688,31,0
2,0,84,86,25,93,118,373,283,656,0.000333,1.505005,36,162540.4983,9030.027681,4515.01384,724.238174,35,0
2,0,85,87,24,91,115,370,280,650,0.000333,1.48319,36,160184.4672,8899.137066,4449.568533,702.248412,36,0
2,0,84,86,25,94,119,382,288,670,0.000333,1.539843,36,166303.0045,9239.055803,4619.527901,732.227757,35,0
0,0,105,105,29,94,123,410,356,766,0.000333,1.772655,42,223354.5767,12408.58759,5317.966111,757.012801,11,0
0,0,61,61,26,68,94,227,205,432,0.000333,0.943861,39,110431.713,6135.095165,2831.582384,536.158906,8,0
2,0,19,21,15,28,43,79,60,139,0.000333,0.251417,14,10559.51121,586.639512,754.250801,193.209297,8,0
2,0,20,22,15,29,44,83,62,145,0.000333,0.263873,14,11082.64619,615.702566,791.617585,199.484808,9,0
2,0,20,22,15,29,44,83,62,145,0.000333,0.263873,14,11082.64619,615.702566,791.617585,199.484808,9,0
3,0,79,82,26,90,116,353,270,623,0.000333,1.424174,39,166628.3642,9257.131347,4272.52216,706.478211,31,0
2,0,108,110,25,98,123,454,368,822,0.000333,1.902249,36,205442.8892,11413.49385,5706.746923,764.337969,35,0
2,0,77,79,24,87,111,335,261,596,0.000333,1.349824,36,145780.9868,8098.943713,4049.471856,670.575184,30,0
2,0,77,79,25,89,114,344,264,608,0.000333,1.384799,24,99705.53109,5539.196171,4154.397129,692.43668,30,0
2,0,134,136,26,112,138,551,389,940,0.000333,2.227338,39,260598.5066,14477.69481,6682.012989,884.635184,34,0
2,0,76,78,24,86,110,329,256,585,0.000333,1.322365,24,95210.29038,5289.460577,3967.095432,662.697869,30,0
2,0,77,79,23,84,107,326,253,579,0.000333,1.301103,33,128809.2097,7156.067206,3903.309385,640.996589,31,0
2,0,76,78,24,88,112,338,261,599,0.000333,1.359202,24,97862.53436,5436.807464,4077.605598,678.469082,30,0
2,0,78,80,25,90,115,348,266,614,0.000333,1.401044,24,100875.1414,5604.174522,4203.130891,700.363183,31,0
2,0,29,31,19,49,68,138,106,244,0.000333,0.495114,18,26736.1368,1485.340933,1485.340933,355.831405,12,0
2,0,78,80,24,88,112,339,263,602,0.000333,1.366009,24,98352.66391,5464.036884,4098.027663,678.469082,31,0
2,0,78,80,25,90,115,348,266,614,0.000333,1.401044,24,100875.1414,5604.174522,4203.130891,700.363183,31,0
2,0,70,72,23,90,113,309,247,556,0.000333,1.264007,22,83424.42907,4634.690504,3792.019503,688.308704,27,0
2,0,77,79,24,87,111,333,258,591,0.000333,1.3385,24,96371.99465,5353.999703,4015.499777,670.575184,31,0
2,0,78,80,23,85,108,330,255,585,0.000333,1.317203,33,130403.1032,7244.616846,3951.609189,648.840155,32,0
2,0,77,79,24,89,113,342,263,605,0.000333,1.375403,24,99028.99853,5501.61103,4126.208272,686.379375,31,0
0,0,45,45,18,56,74,180,164,344,0.000333,0.712017,18,38448.93524,2136.051958,2136.051958,400.270526,7,0
0,0,46,46,18,58,76,191,173,364,0.000333,0.758082,18,40936.42107,2274.245615,2274.245615,414.821548,7,0
2,0,78,80,25,89,114,348,266,614,0.000333,1.398465,24,100689.4672,5593.859292,4195.394469,692.43668,31,0
2,0,29,31,19,49,68,138,106,244,0.000333,0.495114,18,26736.1368,1485.340933,1485.340933,355.831405,12,0
2,0,78,80,24,87,111,339,263,602,0.000333,1.363413,36,147248.5807,8180.476703,4090.238352,670.575184,31,0
2,0,78,80,25,89,114,348,266,614,0.000333,1.398465,24,100689.4672,5593.859292,4195.394469,692.43668,31,0
2,0,70,72,23,89,112,309,247,556,0.000333,1.26163,22,83267.56541,4625.975856,3784.889337,680.3822,27,0
2,0,77,79,24,86,110,333,258,591,0.000333,1.335928,36,144280.2093,8015.567181,4007.783591,662.697869,31,0
2,0,78,80,23,84,107,330,255,585,0.000333,1.314586,33,130144.0202,7230.223343,3943.758187,640.996589,32,0
2,0,77,79,24,88,112,342,263,605,0.000333,1.372817,24,98842.79347,5491.266304,4118.449728,678.469082,31,0
0,0,87,87,29,86,115,319,281,600,0.000333,1.369098,42,172506.3493,9583.686071,4107.294031,693.540218,9,0
0,0,65,65,26,70,96,241,214,455,0.000333,0.998719,39,116850.1596,6491.675532,2996.157938,551.261244,9,0
2,0,23,25,16,31,47,93,69,162,0.000333,0.299948,16,14397.4943,799.860795,899.843394,217.580086,9,0
2,0,24,26,16,32,48,97,71,168,0.000333,0.312758,16,15012.3792,834.021067,938.2737,224,10,0
2,0,24,26,16,32,48,97,71,168,0.000333,0.312758,16,15012.3792,834.021067,938.2737,224,10,0
3,0,83,86,26,93,119,367,279,646,0.000333,1.484684,39,173708.0387,9650.446596,4454.052275,730.353202,32,0
2,0,112,114,25,101,126,468,377,845,0.000333,1.965267,36,212248.8553,11791.60307,5895.801535,788.575765,36,0
2,0,81,83,24,90,114,349,270,619,0.000333,1.409853,36,152264.1211,8459.117838,4229.558919,694.305879,31,0
2,0,81,83,25,92,117,358,273,631,0.000333,1.445067,24,104044.8033,5780.266851,4335.200138,716.264105,31,0
2,0,138,140,26,114,140,565,398,963,0.000333,2.2885,39,267754.4823,14875.24902,6865.499545,901.160894,35,0
2,0,80,82,24,89,113,343,265,608,0.000333,1.382223,24,99520.05142,5528.891746,4146.668809,686.379375,31,0
2,0,81,83,23,87,110,340,262,602,0.000333,1.360793,33,134718.4921,7484.36067,4082.378548,664.578009,32,0
2,0,80,82,24,90,114,352,270,622,0.000333,1.416686,36,153002.0732,8500.115178,4250.057589,694.305879,31,0
2,0,82,84,25,93,118,362,275,637,0.000333,1.461415,24,105221.8469,5845.658163,4384.243622,724.238174,32,0
2,0,33,35,20,53,73,152,115,267,0.000333,0.550894,20,33053.66314,1836.314619,1652.683157,390.018346,13,0
2,0,82,84,24,91,115,353,272,625,0.000333,1.426144,24,102682.3508,5704.575042,4278.431282,702.248412,32,0
2,0,82,84,25,93,118,362,275,637,0.000333,1.461415,24,105221.8469,5845.658163,4384.243622,724.238174,32,0
2,0,74,76,23,92,115,323,256,579,0.000333,1.32118,22,87197.85227,4844.325126,3963.538739,704.209625,28,0
2,0,81,83,24,90,114,347,267,614,0.000333,1.398465,24,100689.4672,5593.859292,4195.394469,694.305879,32,0
2,0,82,84,23,88,111,344,264,608,0.000333,1.377002,33,136323.1599,7573.508886,4131.004847,672.471907,33,0
2,0,81,83,24,91,115,356,272,628,0.000333,1.432989,24,103175.226,5731.957003,4298.967752,702.248412,32,0
0,0,49,49,18,58,76,194,173,367,0.000333,0.76433,18,41273.80915,2292.989397,2292.989397,414.821548,8,0
0,0,50,50,18,60,78,205,182,387,0.000333,0.810817,27,65676.16779,3648.675988,2432.450659,429.472086,8,0
2,0,82,84,25,92,117,362,275,637,0.000333,1.458807,24,105034.1358,5835.229768,4376.422326,716.264105,32,0
2,0,33,35,20,53,73,152,115,267,0.000333,0.550894,20,33053.66314,1836.314619,1652.683157,390.018346,13,0
2,0,82,84,24,90,114,353,272,625,0.000333,1.423519,36,153740.0253,8541.112518,4270.556259,694.305879,32,0
2,0,82,84,25,92,117,362,275,637,0.000333,1.458807,24,105034.1358,5835.229768,4376.422326,716.264105,32,0
2,0,74,76,23,91,114,323,256,579,0.000333,1.318748,22,87037.353,4835.4085,3956.243318,696.251237,28,0
2,0,81,83,24,89,113,347,267,614,0.000333,1.395863,36,150753.2358,8375.179766,4187.589883,686.379375,32,0
2,0,82,84,23,87,110,344,264,608,0.000333,1.374356,33,136061.2013,7558.955627,4123.066706,664.578009,33,0
2,0,81,83,24,90,114,356,272,628,0.000333,1.430352,36,154477.9774,8582.109858,4291.054929,694.305879,32,0
0,0,129,129,31,107,138,540,449,989,0.000333,2.343444,60,421819.8413,23434.43563,7030.330688,874.917053,16,0
0,0,64,64,27,72,99,251,221,472,0.000333,1.043019,39,122033.1967,6779.622037,3129.056325,572.616563,8,0
2,0,22,24,16,33,49,103,76,179,0.000333,0.335011,16,16080.52899,893.362722,1005.033062,230.465006,8,0
2,0,23,25,16,34,50,107,78,185,0.000333,0.348038,16,16705.81432,928.100796,1044.113395,236.973737,9,0
2,0,23,25,16,34,50,107,78,185,0.000333,0.348038,16,16705.81432,928.100796,1044.113395,236.973737,9,0
3,0,82,85,27,94,121,377,286,663,0.000333,1.529069,39,178901.0467,9938.94704,4587.206326,744.513315,31,0
2,0,111,113,26,102,128,478,384,862,0.000333,2.011333,39,235326,13073.66667,6034,802.798818,35,0
2,0,80,82,25,91,116,359,277,636,0.000333,1.453892,36,157020.3329,8723.351826,4361.675913,708.305717,30,0
2,0,80,82,26,93,119,368,280,648,0.000333,1.489281,39,174245.8345,9680.32414,4467.841911,730.353202,30,0
2,0,137,139,27,116,143,575,405,980,0.000333,2.338891,39,273650.2825,15202.79347,7016.67391,923.907758,34,0
2,0,79,81,25,90,115,353,272,625,0.000333,1.426144,36,154023.5261,8556.862564,4278.431282,700.363183,30,0
2,0,80,82,24,88,112,350,269,619,0.000333,1.404584,36,151695.0971,8427.505394,4213.752697,678.469082,31,0
2,0,79,81,25,92,117,362,277,639,0.000333,1.463388,36,158045.87,8780.326112,4390.163056,716.264105,30,0
2,0,81,83,26,94,120,372,282,654,0.000333,1.505702,39,176167.1515,9787.063974,4517.10645,738.342785,31,0
2,0,32,34,20,54,74,162,122,284,0.000333,0.587828,20,35269.69512,1959.427506,1763.484756,397.202487,12,0
2,0,81,83,25,92,117,363,279,642,0.000333,1.470258,36,158787.8694,8821.5483,4410.77415,716.264105,31,0
2,0,81,83,26,94,120,372,282,654,0.000333,1.505702,39,176167.1515,9787.063974,4517.10645,738.342785,31,0
2,0,73,75,24,94,118,333,263,596,0.000333,1.367352,24,98449.32618,5469.40701,4102.055257,726.170452,27,0
2,0,80,82,25,91,116,357,274,631,0.000333,1.442462,36,155785.8963,8654.772016,4327.386008,708.305717,31,0
2,0,81,83,24,89,113,354,271,625,0.000333,1.420871,36,153454.0267,8525.223703,4262.611852,686.379375,32,0
2,0,80,82,25,93,118,366,279,645,0.000333,1.479768,36,159814.9716,8878.609534,4439.304767,724.238174,31,0
0,0,48,48,19,60,79,204,180,384,0.000333,0.806884,27,65357.5988,3630.977711,2420.651807,435.124058,7,0
0,0,49,49,19,62,81,215,189,404,0.000333,0.853766,27,69155.08383,3841.949102,2561.299401,449.870794,7,0
2,0,81,83,26,93,119,372,282,654,0.000333,1.50307,39,175859.2219,9769.956771,4509.210817,730.353202,31,0
2,0,32,34,20,54,74,162,122,284,0.000333,0.587828,20,35269.69512,1959.427506,1763.484756,397.202487,12,0
2,0,81,83,25,91,116,363,279,642,0.000333,1.467608,36,158501.6568,8805.647598,4402.823799,708.305717,31,0
2,0,81,83,26,93,119,372,282,654,0.000333,1.50307,39,175859.2219,9769.956771,4509.210817,730.353202,31,0
2,0,73,75,24,93,117,333,263,596,0.000333,1.364912,24,98273.69695,5459.64983,4094.737373,718.180869,27,0
2,0,80,82,25,90,115,357,274,631,0.000333,1.439835,36,155502.152,8639.008444,4319.504222,700.363183,31,0
2,0,81,83,24,88,112,354,271,625,0.000333,1.418199,36,153165.4857,8509.193653,4254.596826,678.469082,32,0
2,0,80,82,25,92,117,366,279,645,0.000333,1.477128,36,159529.8688,8862.770488,4431.385244,716.264105,31,0
0,0,108,108,30,97,127,426,367,793,0.000333,1.847342,45,249391.213,13855.06739,5542.026957,787.398264,14,0
0,0,64,64,27,71,98,243,216,459,0.000333,1.012051,39,118409.9209,6578.32894,3036.151818,565.014008,11,0
2,0,22,24,17,31,48,95,71,166,0.000333,0.309035,16,14833.6604,824.092245,927.103775,223.066954,11,0
2,0,23,25,17,32,49,99,73,172,0.000333,0.32191,16,15451.68149,858.42675,965.730093,229.486868,12,0
2,0,23,25,17,32,49,99,73,172,0.000333,0.32191,16,15451.68149,858.42675,965.730093,229.486868,12,0
3,0,82,85,26,92,118,369,281,650,0.000333,1.491239,39,174475.0013,9693.055628,4473.717982,722.379133,34,0
2,0,111,113,25,100,125,470,379,849,0.000333,1.971317,36,212902.2309,11827.90172,5913.950858,780.482024,38,0
2,0,80,82,24,89,113,351,272,623,0.000333,1.416324,36,152962.9738,8497.942987,4248.971494,686.379375,33,0
2,0,80,82,25,91,116,360,275,635,0.000333,1.451606,36,156773.4455,8709.635864,4354.817932,708.305717,33,0
2,0,137,139,27,113,140,567,400,967,0.000333,2.298006,39,268866.6504,14937.03613,6894.016677,899.062185,37,0
2,0,79,81,24,88,112,345,267,612,0.000333,1.3887,36,149979.6436,8332.202425,4166.101212,678.469082,33,0
2,0,80,82,23,86,109,342,264,606,0.000333,1.367173,33,135350.1501,7519.452785,4101.519701,656.700694,34,0
2,0,79,81,24,90,114,354,272,626,0.000333,1.425796,36,153986.0094,8554.778298,4277.389149,694.305879,33,0
2,0,81,83,25,92,117,364,277,641,0.000333,1.467968,36,158540.5363,8807.807571,4403.903785,716.264105,34,0
2,0,32,34,20,52,72,154,117,271,0.000333,0.55735,20,33440.99351,1857.832973,1672.049675,382.861427,15,0
2,0,81,83,24,90,114,355,274,629,0.000333,1.432629,36,154723.9615,8595.775638,4297.887819,694.305879,34,0
2,0,81,83,25,92,117,364,277,641,0.000333,1.467968,36,158540.5363,8807.807571,4403.903785,716.264105,34,0
2,0,73,75,24,92,116,325,258,583,0.000333,1.332734,24,95956.87008,5330.937227,3998.20292,710.2068,30,0
2,0,80,82,24,89,113,349,269,618,0.000333,1.404957,36,151735.3416,8429.741198,4214.870599,686.379375,34,0
2,0,81,83,23,87,110,346,266,612,0.000333,1.383397,33,136956.3408,7608.685599,4150.192145,664.578009,35,0
2,0,80,82,24,91,115,358,274,632,0.000333,1.442117,36,155748.5896,8652.699424,4326.349712,702.248412,34,0
0,0,48,48,20,59,79,196,175,371,0.000333,0.779568,20,46774.05315,2598.558508,2338.702658,433.514502,10,0
0,0,49,49,20,61,81,207,184,391,0.000333,0.826294,30,74366.44053,4131.468919,2478.881351,448.213539,10,0
2,0,81,83,25,91,116,364,277,641,0.000333,1.465322,36,158254.7694,8791.931636,4395.965818,708.305717,34,0
2,0,32,34,20,52,72,154,117,271,0.000333,0.55735,20,33440.99351,1857.832973,1672.049675,382.861427,15,0
2,0,81,83,24,89,113,355,274,629,0.000333,1.429964,36,154436.1324,8579.785135,4289.892567,686.379375,34,0
2,0,81,83,25,91,116,364,277,641,0.000333,1.465322,36,158254.7694,8791.931636,4395.965818,708.305717,34,0
2,0,73,75,24,91,115,325,258,583,0.000333,1.330307,24,95782.09679,5321.2276,3990.9207,702.248412,30,0
2,0,80,82,24,88,112,349,269,618,0.000333,1.402315,36,151450.0323,8413.890684,4206.945342,678.469082,34,0
2,0,81,83,23,86,109,346,266,612,0.000333,1.38071,33,136690.2506,7593.902812,4142.128807,656.700694,35,0
2,0,80,82,24,90,114,358,274,632,0.000333,1.439462,36,155461.9136,8636.772978,4318.386489,694.305879,34,0
0,0,98,98,31,98,129,361,307,668,0.000333,1.561167,45,210757.4913,11708.74952,4683.499807,801.82165,13,0
0,0,68,68,28,75,103,267,230,497,0.000333,1.10773,42,139574.012,7754.111778,3323.190762,601.76734,12,0
2,0,26,28,19,36,55,119,85,204,0.000333,0.393132,18,21229.15287,1179.397382,1179.397382,266.827923,12,0
2,0,27,29,19,37,56,123,87,210,0.000333,0.406515,18,21951.80161,1219.544534,1219.544534,273.460397,13,0
2,0,27,29,19,37,56,123,87,210,0.000333,0.406515,18,21951.80161,1219.544534,1219.544534,273.460397,13,0
3,0,86,89,27,97,124,393,295,688,0.000333,1.594829,39,186594.9954,10366.38863,4784.487062,768.573508,35,0
2,0,115,117,26,105,131,494,393,887,0.000333,2.079549,39,243307.2019,13517.06677,6238.646202,827.207212,39,0
2,0,84,86,25,94,119,375,286,661,0.000333,1.519158,36,164069.0835,9114.949083,4557.474542,732.227757,34,0
2,0,84,86,26,96,122,384,289,673,0.000333,1.554795,39,181911.0629,10106.17016,4664.386228,754.367833,34,0
2,0,83,85,25,93,118,369,281,650,0.000333,1.491239,36,161053.8474,8947.435964,4473.717982,724.238174,34,0
2,0,84,86,24,91,115,366,278,644,0.000333,1.469499,36,158705.8413,8816.991186,4408.495593,702.248412,35,0
2,0,83,85,25,94,119,378,286,664,0.000333,1.526053,36,164813.7238,9156.31799,4578.158995,732.227757,34,0
2,0,85,87,26,97,123,388,291,679,0.000333,1.571322,39,183844.7266,10213.59592,4713.967349,762.402978,35,0
2,0,36,38,22,58,80,178,131,309,0.000333,0.651159,22,42976.46719,2387.581511,1953.475781,437.870393,16,0
2,0,85,87,25,95,120,379,288,667,0.000333,1.535632,36,165848.257,9213.792055,4606.896027,740.232688,35,0
2,0,85,87,26,97,123,388,291,679,0.000333,1.571322,39,183844.7266,10213.59592,4713.967349,762.402978,35,0
2,0,77,79,25,96,121,349,272,621,0.000333,1.432205,24,103118.7377,5728.81876,4296.61407,748.252805,31,0
2,0,84,86,25,94,119,373,283,656,0.000333,1.507667,36,162828.0163,9046.000905,4523.000453,732.227757,35,0
2,0,85,87,24,92,116,370,280,650,0.000333,1.485896,36,160476.7553,8915.375294,4457.687647,710.2068,36,0
2,0,84,86,25,95,120,382,288,670,0.000333,1.542539,36,166594.2012,9255.233398,4627.616699,740.232688,35,0
0,0,52,52,21,63,84,220,189,409,0.000333,0.871486,30,78433.73478,4357.42971,2614.457826,468.807301,11,0
0,0,53,53,21,65,86,231,198,429,0.000333,0.918956,30,82706.02739,4594.7793,2756.86758,483.692574,11,0
2,0,85,87,26,96,122,388,291,679,0.000333,1.568657,39,183532.8554,10196.26975,4705.970652,754.367833,35,0
2,0,36,38,22,58,80,178,131,309,0.000333,0.651159,22,42976.46719,2387.581511,1953.475781,437.870393,16,0
2,0,85,87,25,94,119,379,288,667,0.000333,1.532948,36,165558.3641,9197.686896,4598.843448,732.227757,35,0
2,0,85,87,26,96,122,388,291,679,0.000333,1.568657,39,183532.8554,10196.26975,4705.970652,754.367833,35,0
2,0,77,79,25,95,120,349,272,621,0.000333,1.429726,24,102940.2974,5718.905413,4289.17906,740.232688,31,0
2,0,84,86,25,93,118,373,283,656,0.000333,1.505005,36,162540.4983,9030.027681,4515.01384,724.238174,35,0
2,0,85,87,24,91,115,370,280,650,0.000333,1.48319,36,160184.4672,8899.137066,4449.568533,702.248412,36,0
2,0,84,86,25,94,119,382,288,670,0.000333,1.539843,36,166303.0045,9239.055803,4619.527901,732.227757,35,0
0,0,105,105,29,94,123,410,356,766,0.000333,1.772655,42,223354.5767,12408.58759,5317.966111,757.012801,11,0
0,0,61,61,26,68,94,227,205,432,0.000333,0.943861,39,110431.713,6135.095165,2831.582384,536.158906,8,0
2,0,19,21,15,28,43,79,60,139,0.000333,0.251417,14,10559.51121,586.639512,754.250801,193.209297,8,0
2,0,20,22,15,29,44,83,62,145,0.000333,0.263873,14,11082.64619,615.702566,791.617585,199.484808,9,0
2,0,20,22,15,29,44,83,62,145,0.000333,0.263873,14,11082.64619,615.702566,791.617585,199.484808,9,0
3,0,79,82,26,90,116,353,270,623,0.000333,1.424174,39,166628.3642,9257.131347,4272.52216,706.478211,31,0
2,0,108,110,25,98,123,454,368,822,0.000333,1.902249,36,205442.8892,11413.49385,5706.746923,764.337969,35,0
2,0,77,79,24,87,111,335,261,596,0.000333,1.349824,36,145780.9868,8098.943713,4049.471856,670.575184,30,0
2,0,77,79,25,89,114,344,264,608,0.000333,1.384799,24,99705.53109,5539.196171,4154.397129,692.43668,30,0
2,0,134,136,26,112,138,551,389,940,0.000333,2.227338,39,260598.5066,14477.69481,6682.012989,884.635184,34,0
2,0,76,78,24,86,110,329,256,585,0.000333,1.322365,24,95210.29038,5289.460577,3967.095432,662.697869,30,0
2,0,77,79,23,84,107,326,253,579,0.000333,1.301103,33,128809.2097,7156.067206,3903.309385,640.996589,31,0
2,0,76,78,24,88,112,338,261,599,0.000333,1.359202,24,97862.53436,5436.807464,4077.605598,678.469082,30,0
2,0,78,80,25,90,115,348,266,614,0.000333,1.401044,24,100875.1414,5604.174522,4203.130891,700.363183,31,0
2,0,29,31,19,49,68,138,106,244,0.000333,0.495114,18,26736.1368,1485.340933,1485.340933,355.831405,12,0
2,0,78,80,24,88,112,339,263,602,0.000333,1.366009,24,98352.66391,5464.036884,4098.027663,678.469082,31,0
2,0,78,80,25,90,115,348,266,614,0.000333,1.401044,24,100875.1414,5604.174522,4203.130891,700.363183,31,0
2,0,70,72,23,90,113,309,247,556,0.000333,1.264007,22,83424.42907,4634.690504,3792.019503,688.308704,27,0
2,0,77,79,24,87,111,333,258,591,0.000333,1.3385,24,96371.99465,5353.999703,4015.499777,670.575184,31,0
2,0,78,80,23,85,108,330,255,585,0.000333,1.317203,33,130403.1032,7244.616846,3951.609189,648.840155,32,0
2,0,77,79,24,89,113,342,263,605,0.000333,1.375403,24,99028.99853,5501.61103,4126.208272,686.379375,31,0
0,0,45,45,18,56,74,180,164,344,0.000333,0.712017,18,38448.93524,2136.051958,2136.051958,400.270526,7,0
0,0,46,46,18,58,76,191,173,364,0.000333,0.758082,18,40936.42107,2274.245615,2274.245615,414.821548,7,0
2,0,78,80,25,89,114,348,266,614,0.000333,1.398465,24,100689.4672,5593.859292,4195.394469,692.43668,31,0
2,0,29,31,19,49,68,138,106,244,0.000333,0.495114,18,26736.1368,1485.340933,1485.340933,355.831405,12,0
2,0,78,80,24,87,111,339,263,602,0.000333,1.363413,36,147248.5807,8180.476703,4090.238352,670.575184,31,0
2,0,78,80,25,89,114,348,266,614,0.000333,1.398465,24,100689.4672,5593.859292,4195.394469,692.43668,31,0
2,0,70,72,23,89,112,309,247,556,0.000333,1.26163,22,83267.56541,4625.975856,3784.889337,680.3822,27,0
2,0,77,79,24,86,110,333,258,591,0.000333,1.335928,36,144280.2093,8015.567181,4007.783591,662.697869,31,0
2,0,78,80,23,84,107,330,255,585,0.000333,1.314586,33,130144.0202,7230.223343,3943.758187,640.996589,32,0
2,0,77,79,24,88,112,342,263,605,0.000333,1.372817,24,98842.79347,5491.266304,4118.449728,678.469082,31,0
0,0,87,87,29,86,115,319,281,600,0.000333,1.369098,42,172506.3493,9583.686071,4107.294031,693.540218,9,0
0,0,65,65,26,70,96,241,214,455,0.000333,0.998719,39,116850.1596,6491.675532,2996.157938,551.261244,9,0
2,0,23,25,16,31,47,93,69,162,0.000333,0.299948,16,14397.4943,799.860795,899.843394,217.580086,9,0
2,0,24,26,16,32,48,97,71,168,0.000333,0.312758,16,15012.3792,834.021067,938.2737,224,10,0
2,0,24,26,16,32,48,97,71,168,0.000333,0.312758,16,15012.3792,834.021067,938.2737,224,10,0
3,0,83,86,26,93,119,367,279,646,0.000333,1.484684,39,173708.0387,9650.446596,4454.052275,730.353202,32,0
2,0,112,114,25,101,126,468,377,845,0.000333,1.965267,36,212248.8553,11791.60307,5895.801535,788.575765,36,0
2,0,81,83,24,90,114,349,270,619,0.000333,1.409853,36,152264.1211,8459.117838,4229.558919,694.305879,31,0
2,0,81,83,25,92,117,358,273,631,0.000333,1.445067,24,104044.8033,5780.266851,4335.200138,716.264105,31,0
2,0,138,140,26,114,140,565,398,963,0.000333,2.2885,39,267754.4823,14875.24902,6865.499545,901.160894,35,0
2,0,80,82,24,89,113,343,265,608,0.000333,1.382223,24,99520.05142,5528.891746,4146.668809,686.379375,31,0
2,0,81,83,23,87,110,340,262,602,0.000333,1.360793,33,134718.4921,7484.36067,4082.378548,664.578009,32,0
2,0,80,82,24,90,114,352,270,622,0.000333,1.416686,36,153002.0732,8500.115178,4250.057589,694.305879,31,0
2,0,82,84,25,93,118,362,275,637,0.000333,1.461415,24,105221.8469,5845.658163,4384.243622,724.238174,32,0
2,0,33,35,20,53,73,152,115,267,0.000333,0.550894,20,33053.66314,1836.314619,1652.683157,390.018346,13,0
2,0,82,84,24,91,115,353,272,625,0.000333,1.426144,24,102682.3508,5704.575042,4278.431282,702.248412,32,0
2,0,82,84,25,93,118,362,275,637,0.000333,1.461415,24,105221.8469,5845.658163,4384.243622,724.238174,32,0
2,0,74,76,23,92,115,323,256,579,0.000333,1.32118,22,87197.85227,4844.325126,3963.538739,704.209625,28,0
2,0,81,83,24,90,114,347,267,614,0.000333,1.398465,24,100689.4672,5593.859292,4195.394469,694.305879,32,0
2,0,82,84,23,88,111,344,264,608,0.000333,1.377002,33,136323.1599,7573.508886,4131.004847,672.471907,33,0
2,0,81,83,24,91,115,356,272,628,0.000333,1.432989,24,103175.226,5731.957003,4298.967752,702.248412,32,0
0,0,49,49,18,58,76,194,173,367,0.000333,0.76433,18,41273.80915,2292.989397,2292.989397,414.821548,8,0
0,0,50,50,18,60,78,205,182,387,0.000333,0.810817,27,65676.16779,3648.675988,2432.450659,429.472086,8,0
2,0,82,84,25,92,117,362,275,637,0.000333,1.458807,24,105034.1358,5835.229768,4376.422326,716.264105,32,0
2,0,33,35,20,53,73,152,115,267,0.000333,0.550894,20,33053.66314,1836.314619,1652.683157,390.018346,13,0
2,0,82,84,24,90,114,353,272,625,0.000333,1.423519,36,153740.0253,8541.112518,4270.556259,694.305879,32,0
2,0,82,84,25,92,117,362,275,637,0.000333,1.458807,24,105034.1358,5835.229768,4376.422326,716.264105,32,0
2,0,74,76,23,91,114,323,256,579,0.000333,1.318748,22,87037.353,4835.4085,3956.243318,696.251237,28,0
2,0,81,83,24,89,113,347,267,614,0.000333,1.395863,36,150753.2358,8375.179766,4187.589883,686.379375,32,0
2,0,82,84,23,87,110,344,264,608,0.000333,1.374356,33,136061.2013,7558.955627,4123.066706,664.578009,33,0
2,0,81,83,24,90,114,356,272,628,0.000333,1.430352,36,154477.9774,8582.109858,4291.054929,694.305879,32,0
0,0,121,121,32,109,141,497,416,913,0.000333,2.172803,48,312883.6985,17382.42769,6518.410385,897.732091,18,0
0,0,64,64,28,74,102,254,221,475,0.000333,1.056467,28,88743.25705,4930.180947,3169.402037,594.105487,11,0
2,0,22,24,18,35,53,106,76,182,0.000333,0.347494,18,18764.66741,1042.481523,1042.481523,254.583556,11,0
2,0,23,25,18,36,54,110,78,188,0.000333,0.36064,18,19474.53931,1081.91885,1081.91885,261.17595,12,0
2,0,23,25,18,36,54,110,78,188,0.000333,0.36064,18,19474.53931,1081.91885,1081.91885,261.17595,12,0
3,0,82,85,27,95,122,380,286,666,0.000333,1.538624,39,180018.9716,10001.05398,4615.871067,752.518245,34,0
2,0,111,113,26,103,129,481,384,865,0.000333,2.021571,39,236523.7515,13140.20842,6064.711576,810.920987,38,0
2,0,80,82,25,92,117,362,277,639,0.000333,1.463388,36,158045.87,8780.326112,4390.163056,716.264105,33,0
2,0,80,82,26,94,120,371,280,651,0.000333,1.498795,26,116906.0302,6494.779457,4496.385778,738.342785,33,0
2,0,137,139,28,116,144,578,405,983,0.000333,2.349345,42,296017.5236,16445.41798,7048.036276,930.131733,37,0
2,0,79,81,25,91,116,356,272,628,0.000333,1.435604,24,103363.4896,5742.416087,4306.812065,708.305717,33,0
2,0,80,82,24,89,113,353,269,622,0.000333,1.41405,36,152717.4473,8484.302629,4242.151315,686.379375,34,0
2,0,79,81,25,93,118,365,277,642,0.000333,1.472886,24,106047.7641,5891.54245,4418.656838,724.238174,33,0
2,0,81,83,26,95,121,375,282,657,0.000333,1.515231,26,118188.0218,6566.001212,4545.693147,746.347715,34,0
2,0,32,34,21,56,77,165,122,287,0.000333,0.599523,20,35971.35474,1998.408597,1798.567737,417.450542,15,0
2,0,81,83,25,93,118,366,279,645,0.000333,1.479768,36,159814.9716,8878.609534,4439.304767,724.238174,34,0
2,0,81,83,26,95,121,375,282,657,0.000333,1.515231,26,118188.0218,6566.001212,4545.693147,746.347715,34,0
2,0,73,75,25,95,120,336,263,599,0.000333,1.379076,24,99293.4592,5516.303289,4137.227467,740.232688,30,0
2,0,80,82,25,92,117,360,274,634,0.000333,1.451937,24,104539.4696,5807.74831,4355.811232,716.264105,34,0
2,0,81,83,24,90,114,357,271,628,0.000333,1.430352,36,154477.9774,8582.109858,4291.054929,694.305879,35,0
2,0,80,82,25,94,119,369,279,648,0.000333,1.489281,24,107228.2059,5957.122547,4467.841911,732.227757,34,0
0,0,48,48,21,62,83,207,180,387,0.000333,0.82238,20,49342.8052,2741.266955,2467.14026,461.398837,10,0
0,0,49,49,21,64,85,218,189,407,0.000333,0.869541,20,52172.44222,2898.469012,2608.622111,476.238666,10,0
2,0,81,83,26,94,120,375,282,657,0.000333,1.512609,39,176975.2577,9831.958763,4537.827121,738.342785,34,0
2,0,32,34,21,56,77,165,122,287,0.000333,0.599523,20,35971.35474,1998.408597,1798.567737,417.450542,15,0
2,0,81,83,25,92,117,366,279,645,0.000333,1.477128,36,159529.8688,8862.770488,4431.385244,716.264105,34,0
2,0,81,83,26,94,120,375,282,657,0.000333,1.512609,39,176975.2577,9831.958763,4537.827121,738.342785,34,0
2,0,73,75,25,94,119,336,263,599,0.000333,1.376665,24,99119.90017,5506.66112,4129.99584,732.227757,30,0
2,0,80,82,25,91,116,360,274,634,0.000333,1.44932,36,156526.5582,8695.919902,4347.959951,708.305717,34,0
2,0,81,83,24,89,113,357,271,628,0.000333,1.427691,36,154190.606,8566.144777,4283.072388,686.379375,35,0
2,0,80,82,25,93,118,369,279,648,0.000333,1.486651,36,160558.2971,8919.905392,4459.952696,724.238174,34,0
0,0,69,69,27,75,102,265,231,496,0.000333,1.103174,39,129071.3958,7170.633101,3309.52297,595.543364,13,0
2,0,27,29,18,38,56,117,86,203,0.000333,0.392964,18,21220.07489,1178.893049,1178.893049,274.479896,13,0
2,0,28,30,18,39,57,121,88,209,0.000333,0.406358,18,21943.33223,1219.074013,1219.074013,281.189337,14,0
2,0,28,30,18,39,57,121,88,209,0.000333,0.406358,18,21943.33223,1219.074013,1219.074013,281.189337,14,0
3,0,87,90,26,97,123,391,296,687,0.000333,1.589836,39,186010.7911,10333.93284,4769.507465,762.402978,36,0
2,0,116,118,25,105,130,492,394,886,0.000333,2.073939,36,223985.4438,12443.63577,6221.817882,821.092184,40,0
2,0,85,87,24,95,119,373,287,660,0.000333,1.51686,36,163820.8701,9101.159448,4550.579724,734.175383,35,0
2,0,85,87,25,96,121,382,290,672,0.000333,1.549825,36,167381.1394,9298.952191,4649.476095,748.252805,35,0
2,0,83,85,25,93,118,369,294,663,0.000333,1.521064,36,164274.9243,9126.384683,4563.192342,724.238174,34,0
2,0,84,86,24,93,117,367,282,649,0.000333,1.486289,36,160519.2013,8917.733406,4458.866703,718.180869,35,0
2,0,85,87,23,91,114,364,279,643,0.000333,1.464516,33,144987.0932,8054.838512,4393.548279,696.251237,36,0
2,0,84,86,24,94,118,376,287,663,0.000333,1.521064,36,164274.9243,9126.384683,4563.192342,726.170452,35,0
2,0,86,88,25,97,122,386,292,678,0.000333,1.566347,36,169165.4369,9398.07983,4699.039915,756.28795,36,0
2,0,37,39,21,58,79,176,132,308,0.000333,0.647188,20,38831.28941,2157.293856,1941.56447,432.001564,17,0
2,0,86,88,24,96,120,377,289,666,0.000333,1.53333,36,165599.6089,9199.978273,4599.989137,742.1955,36,0
2,0,86,88,25,97,122,386,292,678,0.000333,1.566347,36,169165.4369,9398.07983,4699.039915,756.28795,36,0
2,0,78,80,24,92,116,347,273,620,0.000333,1.417316,24,102046.7572,5669.264289,4251.948217,710.2068,32,0
2,0,85,87,24,94,118,371,284,655,0.000333,1.50271,36,162292.7231,9016.262395,4508.131197,726.170452,36,0
2,0,86,88,23,92,115,368,281,649,0.000333,1.480908,33,146609.8604,8144.992246,4442.723043,704.209625,37,0
2,0,85,87,24,95,119,380,289,669,0.000333,1.537544,36,166054.791,9225.266167,4612.633084,734.175383,36,0
0,0,53,53,20,64,84,218,190,408,0.000333,0.869355,20,52161.31017,2897.850565,2608.065508,470.438562,12,0
0,0,54,54,20,66,86,229,199,428,0.000333,0.916814,30,82513.23945,4584.068858,2750.441315,485.368574,12,0
2,0,86,88,25,96,121,386,292,678,0.000333,1.563663,36,168875.6139,9381.97855,4690.989275,748.252805,36,0
2,0,37,39,21,58,79,176,132,308,0.000333,0.647188,20,38831.28941,2157.293856,1941.56447,432.001564,17,0
2,0,86,88,24,95,119,377,289,666,0.000333,1.53065,36,165310.1507,9183.897261,4591.94863,734.175383,36,0
2,0,86,88,25,96,121,386,292,678,0.000333,1.563663,36,168875.6139,9381.97855,4690.989275,748.252805,36,0
2,0,78,80,24,91,115,347,273,620,0.000333,1.414735,36,152791.3379,8488.407663,4244.203832,702.248412,32,0
2,0,85,87,24,93,117,371,284,655,0.000333,1.50003,36,162003.2001,9000.177783,4500.088891,718.180869,36,0
2,0,86,88,23,91,114,368,281,649,0.000333,1.478182,33,146340.0054,8130.000302,4434.545619,696.251237,37,0
2,0,85,87,24,94,118,380,289,669,0.000333,1.534829,36,165761.5752,9208.9764,4604.4882,726.170452,36,0
0,0,70,70,27,76,103,269,236,505,0.000333,1.125561,39,131690.6279,7316.145993,3376.682766,603.224454,13,0
2,0,28,30,18,39,57,121,91,212,0.000333,0.412191,18,22258.30829,1236.572683,1236.572683,281.189337,13,0
2,0,29,31,18,40,58,125,93,218,0.000333,0.42568,18,22986.71743,1277.039857,1277.039857,287.935774,14,0
2,0,29,31,18,40,58,125,93,218,0.000333,0.42568,18,22986.71743,1277.039857,1277.039857,287.935774,14,0
3,0,88,91,26,98,124,395,301,696,0.000333,1.613374,39,188764.7046,10486.92804,4840.120632,770.452997,36,0
2,0,117,119,25,106,131,496,399,895,0.000333,2.098305,36,226616.8891,12589.82717,6294.913586,829.255973,40,0
2,0,86,88,24,96,120,377,292,669,0.000333,1.540237,36,166345.5531,9241.419617,4620.709808,742.1955,35,0
2,0,86,88,25,97,122,386,295,681,0.000333,1.573277,36,169913.9566,9439.664254,4719.832127,756.28795,35,0
2,0,107,109,26,106,132,518,381,899,0.000333,2.11097,39,246983.5022,13721.30568,6332.910313,835.371001,36,0
2,0,85,87,24,94,118,371,287,658,0.000333,1.509593,36,163036.0486,9057.558253,4528.779126,726.170452,35,0
2,0,86,88,23,92,115,368,284,652,0.000333,1.487753,33,147287.5639,8182.642441,4463.259513,704.209625,36,0
2,0,85,87,24,95,119,380,292,672,0.000333,1.544439,36,166799.4313,9266.635074,4633.317537,734.175383,35,0
2,0,87,89,25,98,123,390,297,687,0.000333,1.589836,36,171702.2687,9539.01493,4769.507465,764.337969,36,0
2,0,38,40,21,59,80,180,137,317,0.000333,0.668017,20,40081.02412,2226.723562,2004.051206,439.314606,17,0
2,0,87,89,24,97,121,381,294,675,0.000333,1.556744,36,168128.3767,9340.46537,4670.232685,750.230646,36,0
2,0,87,89,25,98,123,390,297,687,0.000333,1.589836,36,171702.2687,9539.01493,4769.507465,764.337969,36,0
2,0,79,81,24,94,118,351,278,629,0.000333,1.443061,24,103900.3795,5772.243304,4329.182478,726.170452,32,0
2,0,86,88,24,95,119,375,289,664,0.000333,1.526053,36,164813.7238,9156.31799,4578.158995,734.175383,36,0
2,0,87,89,23,93,116,372,286,658,0.000333,1.504184,33,148914.1993,8273.011074,4512.551495,712.183694,37,0
2,0,86,88,24,96,120,384,294,678,0.000333,1.560957,36,168583.3857,9365.743648,4682.871824,742.1955,36,0
0,0,54,54,20,65,85,222,195,417,0.000333,0.890905,30,80181.48061,4454.526701,2672.71602,477.89247,12,0
0,0,55,55,20,67,87,233,204,437,0.000333,0.938522,30,84466.98923,4692.610513,2815.566308,492.866538,12,0
2,0,87,89,25,97,122,390,297,687,0.000333,1.587139,36,171410.9958,9522.833102,4761.416551,756.28795,36,0
2,0,38,40,21,59,80,180,137,317,0.000333,0.668017,20,40081.02412,2226.723562,2004.051206,439.314606,17,0
2,0,87,89,24,96,120,381,294,675,0.000333,1.55405,36,167837.4415,9324.302304,4662.151152,742.1955,36,0
2,0,87,89,25,97,122,390,297,687,0.000333,1.587139,36,171410.9958,9522.833102,4761.416551,756.28795,36,0
2,0,79,81,24,93,117,351,278,629,0.000333,1.440486,24,103715.0258,5761.945878,4321.459409,718.180869,32,0
2,0,86,88,24,94,118,375,289,664,0.000333,1.523358,36,164522.6995,9140.14997,4570.074985,726.170452,36,0
2,0,87,89,23,92,115,372,286,658,0.000333,1.501444,33,148642.971,8257.942831,4504.332454,704.209625,37,0
2,0,86,88,24,95,119,384,294,678,0.000333,1.558229,36,168288.712,9349.372887,4674.686444,734.175383,36,0
0,0,45,45,24,62,86,178,156,334,0.000333,0.715457,24,51512.93827,2861.829904,2146.372428,479.199271,7,0
2,0,20,22,15,29,44,83,62,145,0.000333,0.263873,14,11082.64619,615.702566,791.617585,199.484808,9,0
2,0,20,22,15,29,44,83,62,145,0.000333,0.263873,14,11082.64619,615.702566,791.617585,199.484808,9,0
3,0,80,83,26,90,116,357,272,629,0.000333,1.43789,39,168233.1318,9346.2851,4313.670046,706.478211,32,0
2,0,109,111,25,98,123,458,370,828,0.000333,1.916134,36,206942.4724,11496.80402,5748.40201,764.337969,36,0
2,0,78,80,24,87,111,339,263,602,0.000333,1.363413,36,147248.5807,8180.476703,4090.238352,670.575184,31,0
2,0,78,80,25,89,114,348,266,614,0.000333,1.398465,24,100689.4672,5593.859292,4195.394469,692.43668,31,0
2,0,135,137,26,112,138,555,391,946,0.000333,2.241555,39,262261.9013,14570.10563,6724.664136,884.635184,35,0
2,0,77,79,24,86,110,333,258,591,0.000333,1.335928,36,144280.2093,8015.567181,4007.783591,662.697869,31,0
2,0,78,80,23,84,107,330,255,585,0.000333,1.314586,33,130144.0202,7230.223343,3943.758187,640.996589,32,0
2,0,77,79,24,88,112,342,263,605,0.000333,1.372817,24,98842.79347,5491.266304,4118.449728,678.469082,31,0
0,0,72,72,18,61,79,295,274,569,0.000333,1.195617,36,129126.6448,7173.702491,3586.851246,436.833628,10,0
2,0,78,80,25,90,115,348,266,614,0.000333,1.401044,24,100875.1414,5604.174522,4203.130891,700.363183,31,0
2,0,29,31,19,49,68,138,106,244,0.000333,0.495114,18,26736.1368,1485.340933,1485.340933,355.831405,12,0
2,0,78,80,24,88,112,339,263,602,0.000333,1.366009,24,98352.66391,5464.036884,4098.027663,678.469082,31,0
2,0,78,80,25,90,115,348,266,614,0.000333,1.401044,24,100875.1414,5604.174522,4203.130891,700.363183,31,0
2,0,70,72,23,90,113,309,247,556,0.000333,1.264007,22,83424.42907,4634.690504,3792.019503,688.308704,27,0
2,0,77,79,24,87,111,333,258,591,0.000333,1.3385,24,96371.99465,5353.999703,4015.499777,670.575184,31,0
2,0,78,80,23,85,108,330,255,585,0.000333,1.317203,33,130403.1032,7244.616846,3951.609189,648.840155,32,0
2,0,77,79,24,89,113,342,263,605,0.000333,1.375403,24,99028.99853,5501.61103,4126.208272,686.379375,31,0
0,0,39,39,18,57,75,172,153,325,0.000333,0.674789,18,36438.58934,2024.366074,2024.366074,407.533381,6,0
0,0,141,141,29,91,120,524,478,1002,0.000333,2.306901,70,484449.3064,26913.85035,6920.704377,733.090761,12,0
0,0,49,49,25,64,89,192,165,357,0.000333,0.770612,24,55484.08404,3082.449113,2311.836835,500.096405,8,0
2,0,24,26,16,32,48,97,71,168,0.000333,0.312758,16,15012.3792,834.021067,938.2737,224,10,0
2,0,24,26,16,32,48,97,71,168,0.000333,0.312758,16,15012.3792,834.021067,938.2737,224,10,0
3,0,84,87,26,92,118,371,281,652,0.000333,1.495828,39,175011.8475,9722.880414,4487.483268,722.379133,33,0
2,0,113,115,25,100,125,472,379,851,0.000333,1.975961,36,213403.7673,11855.76485,5927.882426,780.482024,37,0
2,0,82,84,24,89,113,353,272,625,0.000333,1.420871,36,153454.0267,8525.223703,4262.611852,686.379375,32,0
2,0,82,84,25,91,116,362,275,637,0.000333,1.456178,36,157267.2202,8737.067788,4368.533894,708.305717,32,0
2,0,139,141,26,114,140,569,400,969,0.000333,2.302758,39,269422.7345,14967.92969,6908.275243,901.160894,36,0
2,0,81,83,24,88,112,347,267,614,0.000333,1.393239,36,150469.7732,8359.431844,4179.715922,678.469082,32,0
2,0,82,84,23,86,109,344,264,608,0.000333,1.371685,33,135796.8503,7544.269461,4115.056069,656.700694,33,0
2,0,81,83,24,90,114,356,272,628,0.000333,1.430352,36,154477.9774,8582.109858,4291.054929,694.305879,32,0
0,0,76,76,18,63,81,309,283,592,0.000333,1.251064,36,135114.8833,7506.382403,3753.191202,451.627285,11,0
2,0,82,84,25,92,117,362,275,637,0.000333,1.458807,24,105034.1358,5835.229768,4376.422326,716.264105,32,0
2,0,33,35,20,53,73,152,115,267,0.000333,0.550894,20,33053.66314,1836.314619,1652.683157,390.018346,13,0
2,0,82,84,24,90,114,353,272,625,0.000333,1.423519,36,153740.0253,8541.112518,4270.556259,694.305879,32,0
2,0,82,84,25,92,117,362,275,637,0.000333,1.458807,24,105034.1358,5835.229768,4376.422326,716.264105,32,0
2,0,74,76,23,92,115,323,256,579,0.000333,1.32118,22,87197.85227,4844.325126,3963.538739,704.209625,28,0
2,0,81,83,24,89,113,347,267,614,0.000333,1.395863,36,150753.2358,8375.179766,4187.589883,686.379375,32,0
2,0,82,84,23,87,110,344,264,608,0.000333,1.374356,33,136061.2013,7558.955627,4123.066706,664.578009,33,0
2,0,81,83,24,91,115,356,272,628,0.000333,1.432989,24,103175.226,5731.957003,4298.967752,702.248412,32,0
0,0,43,43,18,59,77,186,162,348,0.000333,0.726947,18,39255.15089,2180.841716,2180.841716,422.13459,7,0
0,0,52,52,25,68,93,207,176,383,0.000333,0.834833,24,60107.94779,3339.330433,2504.497825,530.043878,10,0
2,0,27,29,16,37,53,112,82,194,0.000333,0.370406,16,17779.46509,987.748061,1111.216568,256.749775,12,0
2,0,27,29,16,37,53,112,82,194,0.000333,0.370406,16,17779.46509,987.748061,1111.216568,256.749775,12,0
3,0,87,90,26,94,120,386,292,678,0.000333,1.560957,39,182632.0011,10146.22229,4682.871824,738.342785,35,0
2,0,116,118,25,102,127,487,390,877,0.000333,2.043025,36,220646.7529,12258.15294,6129.07647,796.68379,39,0
2,0,85,87,24,92,116,368,283,651,0.000333,1.488182,36,160723.6426,8929.091256,4464.545628,710.2068,34,0
2,0,85,87,25,93,118,377,286,663,0.000333,1.521064,36,164274.9243,9126.384683,4563.192342,724.238174,34,0
2,0,84,86,24,90,114,362,278,640,0.000333,1.457683,36,157429.7859,8746.099218,4373.049609,694.305879,34,0
2,0,85,87,23,88,111,359,275,634,0.000333,1.435887,33,142152.7688,7897.376042,4307.659659,672.471907,35,0
2,0,84,86,24,92,116,371,283,654,0.000333,1.49504,36,161464.3045,8970.239142,4485.119571,710.2068,34,0
0,0,79,79,18,67,85,324,294,618,0.000333,1.320335,36,142596.1295,7922.007197,3961.003599,481.486626,13,0
2,0,85,87,25,94,119,377,286,663,0.000333,1.523755,36,164565.5104,9142.528354,4571.264177,732.227757,34,0
2,0,36,38,20,56,76,167,126,293,0.000333,0.610214,20,36612.85523,2034.047513,1830.642761,411.650438,15,0
2,0,85,87,24,93,117,368,283,651,0.000333,1.490869,36,161013.8676,8945.214865,4472.607432,718.180869,34,0
2,0,85,87,25,94,119,377,286,663,0.000333,1.523755,36,164565.5104,9142.528354,4571.264177,732.227757,34,0
2,0,77,79,23,92,115,338,267,605,0.000333,1.380507,22,91113.47258,5061.859588,4141.521481,704.209625,30,0
2,0,84,86,24,91,115,362,278,640,0.000333,1.460371,36,157720.0908,8762.227265,4381.113633,702.248412,34,0
2,0,85,87,23,89,112,359,275,634,0.000333,1.438621,33,142423.4797,7912.415538,4315.863021,680.3822,35,0
2,0,84,86,24,93,117,371,283,654,0.000333,1.49774,36,161755.867,8986.437053,4493.218527,718.180869,34,0
0,0,46,46,18,63,81,201,173,374,0.000333,0.790368,18,42679.87022,2371.103901,2371.103901,451.627285,9,0
0,0,54,54,25,71,96,217,184,401,0.000333,0.88019,24,63373.67911,3520.75995,2640.569963,552.72845,11,0
2,0,29,31,16,39,55,122,90,212,0.000333,0.408549,16,19610.37215,1089.465119,1225.648259,270.130687,13,0
2,0,29,31,16,39,55,122,90,212,0.000333,0.408549,16,19610.37215,1089.465119,1225.648259,270.130687,13,0
3,0,89,92,26,96,122,396,300,696,0.000333,1.607931,39,188127.9343,10451.55191,4823.793187,754.367833,36,0
2,0,118,120,25,104,129,497,398,895,0.000333,2.091683,36,225901.7422,12550.09679,6275.048394,812.942135,40,0
2,0,87,89,24,94,118,378,291,669,0.000333,1.534829,36,165761.5752,9208.9764,4604.4882,726.170452,35,0
2,0,87,89,25,95,120,387,294,681,0.000333,1.567864,36,169329.3298,9407.184991,4703.592496,740.232688,35,0
2,0,86,88,24,92,116,372,286,658,0.000333,1.504184,36,162451.8538,9025.10299,4512.551495,710.2068,35,0
2,0,87,89,23,90,113,369,283,652,0.000333,1.482252,33,146742.9706,8152.387253,4446.756683,688.308704,36,0
2,0,86,88,24,94,118,381,291,672,0.000333,1.541712,36,166504.9007,9250.272258,4625.136129,726.170452,35,0
0,0,81,81,18,69,87,334,302,636,0.000333,1.365904,36,147517.6343,8195.424127,4097.712063,496.546838,14,0
2,0,87,89,25,96,121,387,294,681,0.000333,1.570582,36,169622.8511,9423.491729,4711.745865,748.252805,35,0
2,0,38,40,20,58,78,177,134,311,0.000333,0.651587,20,39095.2018,2171.955656,1954.76009,426.20146,16,0
2,0,87,89,24,95,119,378,291,669,0.000333,1.537544,36,166054.791,9225.266167,4612.633084,734.175383,35,0
2,0,87,89,25,96,121,387,294,681,0.000333,1.570582,36,169622.8511,9423.491729,4711.745865,748.252805,35,0
2,0,79,81,23,94,117,348,275,623,0.000333,1.426746,22,94165.21885,5231.401047,4280.23722,720.173277,31,0
2,0,86,88,24,93,117,372,286,658,0.000333,1.5069,36,162745.1995,9041.399971,4520.699985,718.180869,35,0
2,0,87,89,23,91,114,369,283,652,0.000333,1.485015,33,147016.4615,8167.581197,4455.044289,696.251237,36,0
2,0,86,88,24,95,119,381,291,672,0.000333,1.544439,36,166799.4313,9266.635074,4633.317537,734.175383,35,0
0,0,48,48,18,65,83,211,181,392,0.000333,0.833005,18,44982.27823,2499.015457,2499.015457,466.512558,10,0
2,0,21,23,23,52,75,125,114,239,0.000333,0.496229,22,32751.12868,1819.507149,1488.687667,400.46479,24,0
2,0,16,18,24,44,68,114,100,214,0.000333,0.434239,24,31265.20915,1736.956064,1302.717048,350.254091,24,0
1,0,41,42,20,40,60,198,140,338,0.000333,0.66551,30,59895.87064,3327.548369,1996.529021,299.315686,16,0
0,0,122,122,24,75,99,554,348,902,0.000333,1.993227,48,287024.6242,15945.81246,5979.679671,577.200502,31,0
1,0,33,34,20,35,55,168,117,285,0.000333,0.549229,30,49430.62555,2746.145864,1647.687518,265.963467,14,0
0,0,88,88,23,66,89,482,307,789,0.000333,1.703118,44,224811.5618,12489.53121,5109.353677,502.971937,31,0
1,0,26,27,20,31,51,145,99,244,0.000333,0.461357,30,41522.1535,2306.786306,1384.071783,240.018648,13,0
1,0,41,42,20,40,60,198,140,338,0.000333,0.66551,30,59895.87064,3327.548369,1996.529021,299.315686,16,0
0,0,122,122,24,75,99,554,348,902,0.000333,1.993227,48,287024.6242,15945.81246,5979.679671,577.200502,31,0
1,0,33,34,20,35,55,168,117,285,0.000333,0.549229,30,49430.62555,2746.145864,1647.687518,265.963467,14,0
1,0,35,36,20,37,57,177,125,302,0.000333,0.587178,30,52845.98353,2935.887974,1761.532784,279.188336,15,0
1,0,55,56,24,75,99,259,213,472,0.000333,1.043019,24,75097.35179,4172.0751,3129.056325,577.200502,20,0
0,0,99,99,29,98,127,448,376,824,0.000333,1.919559,42,241864.3996,13436.91109,5758.676182,789.123014,25,0
0,0,91,91,26,94,120,407,356,763,0.000333,1.756653,39,205528.3435,11418.2413,5269.957524,738.342785,23,0
2,0,119,121,27,109,136,501,408,909,0.000333,2.147501,39,251257.6452,13958.75807,6442.503723,866.114054,31,0
1,0,63,64,25,74,99,289,229,518,0.000333,1.144669,36,123624.2423,6868.013458,3434.006729,575.595954,24,0
0,0,107,107,30,97,127,478,392,870,0.000333,2.026719,60,364809.3407,20267.18559,6080.155677,787.398264,29,0
0,0,99,99,27,93,120,437,372,809,0.000333,1.862558,52,290559.0736,16142.17075,5587.674492,736.523732,27,0
1,0,103,104,26,104,130,428,368,796,0.000333,1.863268,39,218002.3864,12111.24369,5589.804779,819.057163,22,0
1,0,51,52,22,69,91,233,199,432,0.000333,0.937122,22,61850.08026,3436.11557,2811.367285,519.595683,17,0
0,0,95,95,27,93,120,422,362,784,0.000333,1.805001,39,211185.0869,11732.50483,5415.002227,736.523732,22,0
0,0,87,87,24,89,113,381,342,723,0.000333,1.643663,36,177515.618,9861.97878,4930.98939,686.379375,20,0
1,0,131,132,24,77,101,507,461,968,0.000333,2.148383,60,386708.9229,21483.82905,6445.148715,592.581664,11,0
0,0,125,125,22,74,96,480,444,924,0.000333,2.028168,66,401577.3531,22309.85295,6084.505351,557.607045,9,0
0,0,107,107,22,72,94,411,378,789,0.000333,1.723857,55,284436.3832,15802.02129,5171.570604,542.342096,8,0
0,0,89,89,22,71,93,344,313,657,0.000333,1.432076,44,189034.0029,10501.88905,4296.227339,534.739541,7,0
0,0,71,71,22,69,91,275,247,522,0.000333,1.132356,33,112103.2705,6227.959471,3397.068802,519.595683,6,0
1,0,137,138,30,84,114,512,462,974,0.000333,2.218412,75,499142.6155,27730.14531,6655.234874,684.161381,12,0
0,0,131,131,29,81,110,486,447,933,0.000333,2.109003,70,442890.6029,24605.03349,6327.008613,654.409299,10,0
0,0,113,113,29,79,108,417,381,798,0.000333,1.7968,56,301862.4127,16770.13404,5390.400227,638.880128,9,0
0,0,95,95,29,78,107,350,316,666,0.000333,1.496606,56,251429.7527,13968.3196,4489.817013,631.142822,8,0
0,0,77,77,29,76,105,281,250,531,0.000333,1.188421,42,149741.1035,8318.950196,3565.26437,615.72394,7,0
1,0,137,138,30,84,114,512,462,974,0.000333,2.218412,75,499142.6155,27730.14531,6655.234874,684.161381,12,0
0,0,86,86,30,83,113,332,288,620,0.000333,1.409504,45,190282.9931,10571.27739,4228.510957,676.334991,10,0
0,0,52,52,29,49,78,212,156,368,0.000333,0.771009,42,97147.1767,5397.065372,2313.028017,416.002231,10,0
0,0,86,86,29,78,107,383,262,645,0.000333,1.449415,42,182626.3407,10145.90782,4348.246206,631.142822,30,0
0,0,55,55,29,57,86,252,185,437,0.000333,0.936093,42,117947.6633,6552.647962,2808.277698,473.35618,24,0
0,0,64,64,29,62,91,286,209,495,0.000333,1.073786,42,135297.0506,7516.502809,3221.358347,510.04162,28,0
1,0,29,30,18,30,48,122,97,219,0.000333,0.407702,27,33023.88327,1834.660181,1223.106788,222.265368,14,0
1,0,30,31,18,31,49,126,99,225,0.000333,0.421103,27,34109.3623,1894.964572,1263.309715,228.638736,15,0
0,0,83,83,24,84,108,328,282,610,0.000333,1.373494,36,148337.3295,8240.962753,4120.481376,646.993764,16,0
0,0,68,68,27,72,99,261,225,486,0.000333,1.073956,39,125652.8254,6980.712521,3221.867317,572.616563,18,0
0,0,61,61,20,68,88,250,215,465,0.000333,1.001212,30,90109.07108,5006.059504,3003.635703,500.386035,16,0
1,0,30,31,18,31,49,126,99,225,0.000333,0.421103,27,34109.3623,1894.964572,1263.309715,228.638736,15,0
0,0,69,69,27,74,101,272,234,506,0.000333,1.123018,39,131393.1454,7299.619189,3369.05501,587.881512,18,0
1,0,31,32,16,31,47,120,97,217,0.000333,0.401782,24,28928.29874,1607.127708,1205.345781,217.580086,17,0
1,0,31,32,16,31,47,120,97,217,0.000333,0.401782,24,28928.29874,1607.127708,1205.345781,217.580086,17,0
1,0,98,99,24,94,118,422,368,790,0.000333,1.812429,36,195742.3683,10874.57602,5437.288009,726.170452,29,0
0,0,91,91,25,92,117,389,331,720,0.000333,1.648888,36,178079.8535,9893.325196,4946.662598,716.264105,29,0
1,0,64,65,24,77,101,292,244,536,0.000333,1.1896,36,128476.8488,7137.60271,3568.801355,592.581664,25,0
0,0,99,99,28,94,122,451,378,829,0.000333,1.915194,56,321752.5502,17875.14168,5745.581253,750.73729,30,0
0,0,60,60,20,54,74,301,209,510,0.000333,1.055607,30,95004.63649,5278.035361,3166.821216,397.202487,25,0
1,0,41,42,20,40,60,176,132,308,0.000333,0.606441,30,54579.6691,3032.203839,1819.322303,299.315686,18,0
1,0,31,32,18,33,51,124,100,224,0.000333,0.423541,27,34306.82847,1905.934915,1270.623277,241.523656,15,0
1,0,32,33,18,34,52,128,102,230,0.000333,0.437034,27,35399.73065,1966.651703,1311.101135,248.032387,16,0
0,0,45,45,20,63,83,183,152,335,0.000333,0.711879,20,42712.76419,2372.931344,2135.63821,463.007197,16,0
0,0,62,62,27,71,98,235,200,435,0.000333,0.959133,26,74812.36834,4156.242685,2877.398782,565.014008,18,0
0,0,46,46,20,65,85,194,161,355,0.000333,0.758445,20,45506.67565,2528.148647,2275.333782,477.89247,16,0
1,0,32,33,18,34,52,128,102,230,0.000333,0.437034,27,35399.73065,1966.651703,1311.101135,248.032387,16,0
0,0,63,63,27,73,100,246,209,455,0.000333,1.007652,26,78596.81873,4366.489929,3022.954566,580.239155,18,0
1,0,34,35,16,34,50,128,103,231,0.000333,0.434577,24,31289.53872,1738.307706,1303.73078,236.973737,19,0
1,0,34,35,16,34,50,128,103,231,0.000333,0.434577,24,31289.53872,1738.307706,1303.73078,236.973737,19,0
0,0,94,94,29,88,117,407,278,685,0.000333,1.568733,42,197660.393,10981.13294,4706.199833,709.311431,31,0
0,0,55,55,29,60,89,260,191,451,0.000333,0.973519,42,122663.3426,6814.630147,2920.555777,495.294885,24,0
0,0,64,64,29,65,94,294,215,509,0.000333,1.112095,42,140124.0005,7784.666693,3336.285726,532.335357,28,0
1,0,29,30,18,33,51,130,103,233,0.000333,0.440558,27,35685.22783,1982.512657,1321.675105,241.523656,14,0
1,0,30,31,18,34,52,134,105,239,0.000333,0.454135,27,36784.9375,2043.607639,1362.405093,248.032387,15,0
0,0,83,83,24,87,111,336,288,624,0.000333,1.413239,36,152629.758,8479.431001,4239.715501,670.575184,16,0
0,0,68,68,27,75,102,269,231,500,0.000333,1.112071,39,130112.2942,7228.460787,3336.212671,595.543364,18,0
0,0,61,61,20,71,91,258,221,479,0.000333,1.039078,30,93517.00898,5195.389388,3117.233633,523.070607,16,0
1,0,30,31,18,34,52,134,105,239,0.000333,0.454135,27,36784.9375,2043.607639,1362.405093,248.032387,15,0
0,0,69,69,27,77,104,280,240,520,0.000333,1.16141,39,135884.9175,7549.162082,3484.228653,610.924526,18,0
1,0,31,32,16,34,50,128,103,231,0.000333,0.434577,24,31289.53872,1738.307706,1303.73078,236.973737,17,0
1,0,31,32,16,34,50,128,103,231,0.000333,0.434577,24,31289.53872,1738.307706,1303.73078,236.973737,17,0
1,0,98,99,24,97,121,430,374,804,0.000333,1.854255,36,200259.5775,11125.53209,5562.766043,750.230646,29,0
0,0,91,91,25,95,120,397,337,734,0.000333,1.689886,36,182507.6771,10139.31539,5069.657697,740.232688,29,0
1,0,64,65,24,80,104,300,250,550,0.000333,1.228414,36,132668.7064,7370.48369,3685.241845,615.793348,25,0
0,0,99,99,28,97,125,459,384,843,0.000333,1.957385,42,246630.5584,13701.69769,5872.156152,774.797484,30,0
0,0,60,60,20,57,77,309,215,524,0.000333,1.094599,30,98513.88442,5472.993579,3283.796147,418.913293,25,0
1,0,41,42,20,43,63,184,138,322,0.000333,0.641561,30,57740.52406,3207.806892,1924.684135,319.767946,18,0
1,0,31,32,18,36,54,132,106,238,0.000333,0.456554,18,24653.93806,1369.663226,1369.663226,261.17595,15,0
1,0,32,33,18,37,55,136,108,244,0.000333,0.470217,18,25391.73186,1410.65177,1410.65177,267.808425,16,0
0,0,45,45,20,66,86,191,158,349,0.000333,0.747589,20,44855.32799,2491.962666,2242.766399,485.368574,16,0
0,0,62,62,27,74,101,243,206,449,0.000333,0.996512,26,77727.96085,4318.220047,2989.536956,587.881512,18,0
0,0,46,46,20,68,88,202,167,369,0.000333,0.79451,20,47670.60535,2648.366964,2383.530267,500.386035,16,0
1,0,32,33,18,37,55,136,108,244,0.000333,0.470217,18,25391.73186,1410.65177,1410.65177,267.808425,16,0
0,0,63,63,27,76,103,254,215,469,0.000333,1.045323,26,81535.18743,4529.732635,3135.968747,603.224454,18,0
1,0,34,35,16,37,53,136,109,245,0.000333,0.46778,16,22453.44818,1247.413788,1403.340511,256.749775,19,0
1,0,34,35,16,37,53,136,109,245,0.000333,0.46778,16,22453.44818,1247.413788,1403.340511,256.749775,19,0
0,0,111,111,30,87,117,518,334,852,0.000333,1.951184,45,263409.7833,14633.87685,5853.550741,707.742802,32,0
0,0,71,71,30,66,96,369,245,614,0.000333,1.347722,45,181942.5139,10107.91744,4043.166975,546.13673,23,0
0,0,80,80,30,71,101,403,269,672,0.000333,1.491439,45,201344.3152,11185.79529,4474.318116,583.838763,27,0
1,0,45,46,21,38,59,239,157,396,0.000333,0.776509,40,93181.0659,5176.725883,2329.526648,291.659911,13,0
1,0,46,47,21,39,60,243,159,402,0.000333,0.791523,40,94982.80078,5276.822265,2374.570019,298.369352,14,0
0,0,99,99,25,92,117,445,342,787,0.000333,1.802326,36,194651.1732,10813.95407,5406.977034,716.264105,15,0
0,0,84,84,30,80,110,378,285,663,0.000333,1.49868,45,202321.8671,11240.10373,4496.04149,652.960965,17,0
0,0,77,77,23,75,98,367,275,642,0.000333,1.415548,33,140139.2428,7785.513487,4246.64372,571.203327,15,0
1,0,46,47,21,39,60,243,159,402,0.000333,0.791523,40,94982.80078,5276.822265,2374.570019,298.369352,14,0
0,0,85,85,30,81,111,389,294,683,0.000333,1.546862,45,208826.3717,11601.46509,4640.586037,660.734568,17,0
1,0,47,48,19,39,58,237,157,394,0.000333,0.769348,36,83089.60244,4616.089024,2308.044512,286.841309,16,0
1,0,47,48,19,39,58,237,157,394,0.000333,0.769348,36,83089.60244,4616.089024,2308.044512,286.841309,16,0
1,0,114,115,25,102,127,539,428,967,0.000333,2.252686,48,324386.7884,18021.48825,6758.058092,796.68379,28,0
0,0,107,107,26,100,126,506,391,897,0.000333,2.086207,39,244086.1836,13560.34353,6258.620091,786.597052,28,0
1,0,80,81,25,85,110,409,304,713,0.000333,1.611703,36,174063.9411,9670.218951,4835.109476,660.894634,24,0
0,0,76,76,23,63,86,418,269,687,0.000333,1.471615,44,194253.131,10791.84061,4414.843886,480.61056,24,0
1,0,57,58,23,49,72,293,192,485,0.000333,0.997471,33,98749.64965,5486.091647,2992.413626,379.162707,17,0
1,0,47,48,21,42,63,241,160,401,0.000333,0.798963,30,71906.67748,3994.815416,2396.889249,318.715998,14,0
1,0,48,49,21,43,64,245,162,407,0.000333,0.814,30,73260,4070,2442,325.56805,15,0
0,0,61,61,23,72,95,300,212,512,0.000333,1.121255,22,74002.85357,4111.269643,3363.766071,548.276525,15,0
0,0,78,78,30,80,110,352,260,612,0.000333,1.383397,45,186758.6465,10375.48036,4150.192145,652.960965,17,0
0,0,62,62,23,73,96,311,221,532,0.000333,1.167733,33,115605.6017,6422.533426,3503.20005,555.899118,15,0
1,0,48,49,21,43,64,245,162,407,0.000333,0.814,30,73260,4070,2442,325.56805,15,0
0,0,79,79,30,81,111,363,269,632,0.000333,1.431357,45,193233.1872,10735.17707,4294.070828,660.734568,17,0
1,0,50,51,19,43,62,245,163,408,0.000333,0.809771,27,65591.42656,3643.968142,2429.312095,314.040007,18,0
1,0,50,51,19,43,62,245,163,408,0.000333,0.809771,27,65591.42656,3643.968142,2429.312095,314.040007,18,0
0,0,70,70,28,67,95,360,248,608,0.000333,1.331491,42,167767.8328,9320.435156,3994.47221,541.033914,22,0
0,0,84,84,30,77,107,433,302,735,0.000333,1.651659,45,222974.0206,12387.44559,4954.978235,629.749282,28,0
1,0,47,48,19,41,60,237,167,404,0.000333,0.795461,36,85909.81682,4772.767601,2386.383801,300.370255,16,0
1,0,47,48,19,41,60,237,167,404,0.000333,0.795461,36,85909.81682,4772.767601,2386.383801,300.370255,16,0
1,0,45,46,19,40,59,234,163,397,0.000333,0.77847,36,84074.73446,4670.818581,2335.409291,293.587747,12,0
1,0,45,46,19,40,59,234,163,397,0.000333,0.77847,36,84074.73446,4670.818581,2335.409291,293.587747,12,0
0,0,110,110,29,86,115,484,399,883,0.000333,2.014856,56,338495.792,18805.32178,6044.567715,693.540218,18,0
0,0,60,60,21,72,93,309,230,539,0.000333,1.174869,30,105738.198,5874.344332,3524.606599,536.473266,12,0
0,0,77,77,29,81,110,361,278,639,0.000333,1.44443,42,181998.132,10111.00733,4333.288857,654.409299,14,0
0,0,95,95,23,71,94,497,340,837,0.000333,1.82873,44,241392.3982,13410.68879,5486.190869,540.67397,31,0
1,0,65,66,23,55,78,331,230,561,0.000333,1.17537,44,155148.8684,8619.381576,3526.110645,422.016709,19,0
1,0,48,49,19,44,63,242,169,411,0.000333,0.818887,27,66329.87531,3684.993073,2456.662049,320.925614,14,0
0,0,64,64,21,77,98,328,245,573,0.000333,1.26341,30,113706.8622,6317.047901,3790.228741,574.78123,14,0
1,0,48,49,19,44,63,242,169,411,0.000333,0.818887,27,66329.87531,3684.993073,2456.662049,320.925614,14,0
0,0,81,81,29,86,115,380,293,673,0.000333,1.535672,42,193494.6218,10749.70121,4607.014804,693.540218,16,0
0,0,63,63,21,76,97,317,236,553,0.000333,1.216584,30,109492.5541,6082.91967,3649.751802,567.081157,14,0
0,0,80,80,29,85,114,369,284,653,0.000333,1.487292,42,187398.8415,10411.04675,4461.877179,685.679678,16,0
1,0,50,51,19,45,64,245,173,418,0.000333,0.836,27,67716,3762,2508,327.844012,18,0
1,0,50,51,19,45,64,245,173,418,0.000333,0.836,27,67716,3762,2508,327.844012,18,0
0,0,135,135,30,81,111,537,345,882,0.000333,1.997558,60,359560.4876,19975.58265,5992.674794,660.734568,32,0
0,0,96,96,30,92,122,363,316,679,0.000333,1.568657,45,211768.6793,11764.92663,4705.970652,747.374418,16,0
0,0,74,74,27,76,103,285,249,534,0.000333,1.190197,39,139253.06,7736.28111,3570.591282,603.224454,16,0
1,0,89,90,25,92,117,381,323,704,0.000333,1.612246,36,174122.5235,9673.473525,4836.736763,716.264105,28,0
1,0,60,61,24,76,100,275,230,505,0.000333,1.118382,36,120785.3055,6710.294752,3355.147376,584.881591,23,0
0,0,95,95,28,93,121,434,364,798,0.000333,1.840418,42,231892.6203,12882.92335,5521.252863,742.747707,28,0
2,0,31,33,19,38,57,136,103,239,0.000333,0.464687,18,25093.09284,1394.060713,1394.060713,280.131868,16,0
2,0,32,34,19,39,58,137,104,241,0.000333,0.470591,18,25411.92156,1411.77342,1411.77342,286.841309,16,0
2,0,32,34,19,39,58,140,105,245,0.000333,0.478402,18,25833.69619,1435.205344,1435.205344,286.841309,17,0
2,0,33,35,19,40,59,141,106,247,0.000333,0.484338,18,26154.231,1453.012833,1453.012833,293.587747,17,0
0,0,53,53,20,64,84,218,188,406,0.000333,0.865094,20,51905.61747,2883.645415,2595.280874,470.438562,15,0
0,0,54,54,20,66,86,229,197,426,0.000333,0.91253,20,54751.77571,3041.765317,2737.588786,485.368574,15,0
2,0,32,34,19,39,58,140,105,245,0.000333,0.478402,18,25833.69619,1435.205344,1435.205344,286.841309,17,0
2,0,33,35,19,40,59,141,106,247,0.000333,0.484338,18,26154.231,1453.012833,1453.012833,293.587747,17,0
2,0,33,35,17,39,56,134,103,237,0.000333,0.458781,16,22021.48986,1223.416104,1376.343117,275.617555,19,0
2,0,34,36,17,40,57,135,104,239,0.000333,0.464687,16,22304.97141,1239.165079,1394.060713,282.363992,19,0
2,0,33,35,17,39,56,134,103,237,0.000333,0.458781,16,22021.48986,1223.416104,1376.343117,275.617555,19,0
2,0,34,36,17,40,57,135,104,239,0.000333,0.464687,16,22304.97141,1239.165079,1394.060713,282.363992,19,0
0,0,96,96,25,94,119,423,373,796,0.000333,1.829425,36,197577.8978,10976.54988,5488.27494,732.227757,26,0
0,0,133,133,29,82,111,525,346,871,0.000333,1.972645,56,331404.4283,18411.35713,5917.93622,662.200713,31,0
0,0,57,57,26,71,97,227,194,421,0.000333,0.926188,26,72242.64597,4013.480332,2778.563307,558.843478,13,0
2,0,33,35,17,40,57,134,103,237,0.000333,0.460798,16,22118.31893,1228.795496,1382.394933,282.363992,19,0
2,0,34,36,17,41,58,135,104,239,0.000333,0.466686,16,22400.91933,1244.495518,1400.057458,289.1465,19,0
2,0,33,35,17,40,57,134,103,237,0.000333,0.460798,16,22118.31893,1228.795496,1382.394933,282.363992,19,0
2,0,34,36,17,41,58,135,104,239,0.000333,0.466686,16,22400.91933,1244.495518,1400.057458,289.1465,19,0
2,0,31,33,17,39,56,131,99,230,0.000333,0.445231,16,21371.06611,1187.281451,1335.691632,275.617555,15,0
2,0,32,34,17,40,57,132,100,232,0.000333,0.451077,16,21651.68773,1202.871541,1353.230483,282.363992,15,0
0,0,79,79,18,69,87,324,292,616,0.000333,1.322951,36,142878.715,7937.706387,3968.853193,496.546838,16,0
2,0,31,33,17,39,56,131,99,230,0.000333,0.445231,16,21371.06611,1187.281451,1335.691632,275.617555,15,0
2,0,32,34,17,40,57,132,100,232,0.000333,0.451077,16,21651.68773,1202.871541,1353.230483,282.363992,15,0
0,0,46,46,18,64,82,201,171,372,0.000333,0.788336,18,42570.16822,2365.009346,2365.009346,459.05865,12,0
0,0,56,56,20,54,74,284,195,479,0.000333,0.991443,30,89229.84486,4957.213604,2974.328162,397.202487,23,0
1,0,37,38,20,40,60,159,118,277,0.000333,0.545403,20,32724.1739,1818.009661,1636.208695,299.315686,16,0
0,0,134,134,24,81,105,583,377,960,0.000333,2.148559,48,309392.4335,17188.46853,6445.675697,623.56695,35,0
1,0,45,46,20,45,65,197,146,343,0.000333,0.688557,30,61970.1648,3442.786933,2065.67216,333.571951,18,0
0,0,76,76,27,80,107,287,252,539,0.000333,1.211217,39,141712.3775,7872.909862,3633.650706,634.13621,17,0
2,0,33,35,19,42,61,138,106,244,0.000333,0.482367,18,26047.79839,1447.09991,1447.09991,307.187955,17,0
2,0,34,36,19,43,62,139,107,246,0.000333,0.488244,18,26365.18126,1464.732292,1464.732292,314.040007,17,0
2,0,34,36,19,43,62,142,108,250,0.000333,0.496183,18,26793.8834,1488.549078,1488.549078,314.040007,18,0
2,0,35,37,19,44,63,143,109,252,0.000333,0.502092,18,27112.94173,1506.274541,1506.274541,320.925614,18,0
0,0,55,55,20,68,88,220,191,411,0.000333,0.884942,20,53096.52791,2949.807106,2654.826395,500.386035,16,0
0,0,56,56,20,70,90,231,200,431,0.000333,0.932663,20,55959.77369,3108.876316,2797.988685,515.488373,16,0
2,0,34,36,19,43,62,142,108,250,0.000333,0.496183,18,26793.8834,1488.549078,1488.549078,314.040007,18,0
2,0,35,37,19,44,63,143,109,252,0.000333,0.502092,18,27112.94173,1506.274541,1506.274541,320.925614,18,0
2,0,36,38,17,43,60,142,109,251,0.000333,0.49421,16,23722.07263,1317.892924,1482.629539,302.816253,21,0
2,0,37,39,17,44,61,143,110,253,0.000333,0.500159,16,24007.62474,1333.75693,1500.476546,309.70186,21,0
2,0,36,38,17,43,60,142,109,251,0.000333,0.49421,16,23722.07263,1317.892924,1482.629539,302.816253,21,0
2,0,37,39,17,44,61,143,110,253,0.000333,0.500159,16,24007.62474,1333.75693,1500.476546,309.70186,21,0
0,0,60,60,26,75,101,235,200,435,0.000333,0.965441,26,75304.37187,4183.576215,2896.321995,589.372834,15,0
2,0,34,36,17,43,60,139,105,244,0.000333,0.480427,16,23060.50089,1281.138938,1441.281305,302.816253,17,0
2,0,35,37,17,44,61,140,106,246,0.000333,0.48632,16,23343.38216,1296.854564,1458.961385,309.70186,17,0
0,0,82,82,18,73,91,332,298,630,0.000333,1.366637,36,147596.7824,8199.821247,4099.910623,526.915843,18,0
2,0,34,36,17,43,60,139,105,244,0.000333,0.480427,16,23060.50089,1281.138938,1441.281305,302.816253,17,0
2,0,35,37,17,44,61,140,106,246,0.000333,0.48632,16,23343.38216,1296.854564,1458.961385,309.70186,17,0
0,0,49,49,18,68,86,209,177,386,0.000333,0.826846,18,44649.68752,2480.538195,2480.538195,489.006123,14,0
2,0,36,38,17,44,61,142,109,251,0.000333,0.496205,16,23817.84115,1323.213397,1488.615072,309.70186,21,0
2,0,37,39,17,45,62,143,110,253,0.000333,0.502137,16,24102.58666,1339.032592,1506.411667,316.620258,21,0
2,0,36,38,17,44,61,142,109,251,0.000333,0.496205,16,23817.84115,1323.213397,1488.615072,309.70186,21,0
2,0,37,39,17,45,62,143,110,253,0.000333,0.502137,16,24102.58666,1339.032592,1506.411667,316.620258,21,0
0,0,60,60,24,65,89,265,225,490,0.000333,1.057703,36,114231.9377,6346.218762,3173.109381,501.493008,15,0
0,0,59,59,24,65,89,261,222,483,0.000333,1.042593,36,112600.0529,6255.558494,3127.779247,501.493008,14,0
0,0,60,60,24,66,90,266,226,492,0.000333,1.064664,36,114983.702,6387.983447,3193.991723,508.969112,15,0
0,0,59,59,24,65,89,261,222,483,0.000333,1.042593,36,112600.0529,6255.558494,3127.779247,501.493008,14,0
0,0,7,7,19,25,44,50,37,87,0.000333,0.158324,9,4274.734957,237.485275,474.970551,196.807027,3,0
0,0,6,6,18,20,38,38,28,66,0.000333,0.115454,9,3117.268943,173.181608,346.363216,161.497212,2,0
0,0,6,6,21,24,45,44,32,76,0.000333,0.139127,10,4173.808353,231.878242,417.380835,202.277766,3,0
0,0,34,34,31,53,84,175,136,311,0.000333,0.66267,30,59640.32156,3313.351197,1988.010718,457.15987,8,0
0,0,5,5,15,12,27,31,19,50,0.000333,0.079248,7,1664.210626,92.456146,237.744375,101.622909,1,0
0,0,35,35,30,57,87,181,133,314,0.000333,0.674361,30,60692.52773,3371.807096,2023.084258,479.681449,11,0
0,0,34,34,30,56,86,171,126,297,0.000333,0.6362,30,57258.01896,3181.001054,1908.600632,472.418594,11,0
0,0,34,34,30,55,85,174,128,302,0.000333,0.645212,30,58069.08188,3226.060105,1935.636063,465.181502,10,0
0,0,32,32,30,55,85,170,124,294,0.000333,0.62812,30,56530.82806,3140.601559,1884.360935,465.181502,10,0
0,0,33,33,30,56,86,169,124,293,0.000333,0.627632,30,56486.86719,3138.159289,1882.895573,472.418594,11,0
0,0,34,34,30,57,87,179,131,310,0.000333,0.665771,30,59919.37451,3328.85414,1997.312484,479.681449,11,0
0,0,33,33,30,55,85,172,126,298,0.000333,0.636666,30,57299.95497,3183.330832,1909.998499,465.181502,10,0
0,0,31,31,29,55,84,168,122,290,0.000333,0.617924,28,51905.61747,2883.645415,1853.772053,458.856233,10,0
0,0,34,34,30,55,85,174,128,302,0.000333,0.645212,30,58069.08188,3226.060105,1935.636063,465.181502,10,0
0,0,33,33,30,55,85,172,126,298,0.000333,0.636666,30,57299.95497,3183.330832,1909.998499,465.181502,10,0
0,0,32,32,30,55,85,170,124,294,0.000333,0.62812,30,56530.82806,3140.601559,1884.360935,465.181502,10,0
0,0,31,31,29,55,84,168,122,290,0.000333,0.617924,28,51905.61747,2883.645415,1853.772053,458.856233,10,0
0,0,10,10,20,23,43,58,38,96,0.000333,0.17364,10,5209.214165,289.400787,520.921416,190.480487,4,0
0,0,19,19,21,46,67,112,73,185,0.000333,0.374076,10,11222.265,623.459167,1122.2265,346.322516,13,0
0,0,19,19,21,45,66,126,83,209,0.000333,0.421093,10,12632.78371,701.821317,1263.278371,339.372055,13,0
0,0,19,19,19,40,59,104,70,174,0.000333,0.341193,9,9212.219015,511.789945,1023.579891,293.587747,13,0
0,0,19,19,21,45,66,126,83,209,0.000333,0.421093,10,12632.78371,701.821317,1263.278371,339.372055,13,0
0,0,17,17,19,38,57,95,62,157,0.000333,0.305255,9,8241.87359,457.881866,915.763732,280.131868,13,0
0,0,19,19,21,45,66,130,85,215,0.000333,0.433182,10,12995.44736,721.969298,1299.544736,339.372055,13,0
0,0,18,18,19,36,55,93,64,157,0.000333,0.302558,9,8169.061275,453.836738,907.673475,266.827923,11,0
0,0,17,17,19,35,54,86,59,145,0.000333,0.278153,9,7510.12819,417.229344,834.458688,260.235528,11,0
0,0,13,13,19,29,48,72,48,120,0.000333,0.223399,9,6031.759501,335.09775,670.1955,221.592072,9,0
0,0,16,16,19,35,54,89,61,150,0.000333,0.287744,9,7769.098128,431.616563,863.233125,260.235528,10,0
0,0,11,11,17,22,39,68,48,116,0.000333,0.204369,16,9809.706518,544.983695,613.106657,167.594364,4,0
0,0,10,10,17,20,37,60,40,100,0.000333,0.173648,16,8335.125385,463.062521,520.945337,155.92543,4,0
0,0,10,10,16,20,36,63,42,105,0.000333,0.180947,16,8685.474002,482.526333,542.842125,150.438562,4,0
0,0,11,11,17,22,39,68,48,116,0.000333,0.204369,16,9809.706518,544.983695,613.106657,167.594364,4,0
0,0,10,10,17,20,37,60,40,100,0.000333,0.173648,16,8335.125385,463.062521,520.945337,155.92543,4,0
0,0,10,10,16,20,36,63,42,105,0.000333,0.180947,16,8685.474002,482.526333,542.842125,150.438562,4,0
0,0,14,14,19,26,45,70,55,125,0.000333,0.228827,18,12356.66947,686.481637,686.481637,202.922055,4,0
0,0,13,13,18,25,43,66,53,119,0.000333,0.215242,18,11623.05911,645.725506,645.725506,191.155055,3,0
0,0,8,8,16,15,31,32,25,57,0.000333,0.09413,8,2259.113518,125.506307,282.38919,122.603359,4,0
0,0,12,12,18,20,38,61,46,107,0.000333,0.187176,18,10107.50839,561.528244,561.528244,161.497212,4,0
0,0,28,28,27,52,79,184,161,345,0.000333,0.724935,39,84817.36997,4712.076109,2174.804358,424.804828,5,0
0,0,23,23,22,46,68,162,136,298,0.000333,0.604688,22,39909.40639,2217.189244,1814.063927,352.191346,4,0
0,0,28,28,27,52,79,184,161,345,0.000333,0.724935,39,84817.36997,4712.076109,2174.804358,424.804828,5,0
0,0,23,23,22,46,68,162,136,298,0.000333,0.604688,22,39909.40639,2217.189244,1814.063927,352.191346,4,0
0,0,28,28,27,52,79,184,161,345,0.000333,0.724935,39,84817.36997,4712.076109,2174.804358,424.804828,5,0
0,0,23,23,22,46,68,162,136,298,0.000333,0.604688,22,39909.40639,2217.189244,1814.063927,352.191346,4,0
0,0,20,20,23,39,62,110,100,210,0.000333,0.416794,22,27508.38695,1528.24372,1250.381225,310.172612,5,0
0,0,15,15,19,32,51,88,75,163,0.000333,0.308202,18,16642.89595,924.605331,924.605331,240.710623,4,0
0,0,66,66,30,67,97,372,295,667,0.000333,1.467381,60,264128.5119,14673.80622,4402.141866,553.634694,31,0
0,0,66,66,30,67,97,372,295,667,0.000333,1.467381,60,264128.5119,14673.80622,4402.141866,553.634694,31,0
0,0,66,66,30,67,97,372,295,667,0.000333,1.467381,60,264128.5119,14673.80622,4402.141866,553.634694,31,0
0,0,41,41,26,53,79,193,135,328,0.000333,0.689213,26,53758.64222,2986.591234,2067.640085,425.791217,18,0
0,0,41,41,26,53,79,193,135,328,0.000333,0.689213,26,53758.64222,2986.591234,2067.640085,425.791217,18,0
0,0,47,47,26,57,83,215,154,369,0.000333,0.78413,26,61162.1283,3397.896017,2352.38955,454.686163,18,0
0,0,16,16,23,30,53,97,72,169,0.000333,0.322673,22,21296.40825,1183.133792,968.018557,251.248643,12,0
0,0,15,15,21,28,49,83,62,145,0.000333,0.271378,20,16282.65855,904.592142,814.132927,226.844604,9,0
1,0,9,10,15,24,39,51,35,86,0.000333,0.151515,7,3181.812136,176.767341,454.544591,168.642459,6,0
1,0,8,9,16,42,58,113,81,194,0.000333,0.378816,8,9091.586504,505.088139,1136.448313,290.477332,4,0
1,0,14,15,20,22,42,62,45,107,0.000333,0.192326,20,11539.55929,641.086627,576.977964,184.546058,7,0
1,0,16,17,20,22,42,70,51,121,0.000333,0.21749,20,13049.40816,724.96712,652.470408,184.546058,7,0
1,0,21,22,16,30,46,87,55,142,0.000333,0.261449,8,6274.766382,348.598132,784.345798,211.206718,11,0
1,0,19,20,16,27,43,76,48,124,0.000333,0.224286,8,5382.854637,299.04748,672.85683,192.381963,10,0
1,0,18,19,16,27,43,70,46,116,0.000333,0.209816,8,5035.573692,279.754094,629.446712,192.381963,9,0
1,0,18,19,16,27,43,70,46,116,0.000333,0.209816,8,5035.573692,279.754094,629.446712,192.381963,9,0
0,0,73,73,26,89,115,351,315,666,0.000333,1.519699,39,177804.7586,9878.042144,4559.096374,698.551708,27,0
0,0,73,73,26,89,115,351,315,666,0.000333,1.519699,39,177804.7586,9878.042144,4559.096374,698.551708,27,0
0,0,47,47,23,61,84,211,197,408,0.000333,0.869355,33,86066.16178,4781.453432,2608.065508,465.816903,21,0
0,0,48,48,23,63,86,218,205,423,0.000333,0.906103,33,89704.22971,4983.568317,2718.309991,480.61056,21,0
0,0,48,48,23,63,86,218,205,423,0.000333,0.906103,33,89704.22971,4983.568317,2718.309991,480.61056,21,0
0,0,71,71,26,88,114,341,305,646,0.000333,1.471349,39,172147.831,9563.76839,4414.046949,690.641415,25,0
0,0,72,72,26,89,115,346,310,656,0.000333,1.49688,39,175135.0175,9729.723192,4490.641473,698.551708,26,0
0,0,73,73,26,91,117,353,318,671,0.000333,1.536672,39,179790.5743,9988.365241,4610.014727,714.420745,26,0
0,0,73,73,26,91,117,353,318,671,0.000333,1.536672,39,179790.5743,9988.365241,4610.014727,714.420745,26,0
0,0,99,99,27,107,134,471,410,881,0.000333,2.075075,39,242783.7585,13487.98658,6225.224577,849.71893,61,0
0,0,99,99,27,107,134,471,410,881,0.000333,2.075075,39,242783.7585,13487.98658,6225.224577,849.71893,61,0
1,0,10,11,18,26,44,55,35,90,0.000333,0.163783,9,4422.139611,245.674423,491.348846,197.270083,5,0
1,0,6,7,13,20,33,35,22,57,0.000333,0.095843,6,1725.182789,95.843488,287.530465,134.544278,3,0
1,0,11,12,15,28,43,71,41,112,0.000333,0.202581,7,4254.191568,236.343976,607.741653,193.209297,11,0
1,0,4,5,8,12,20,20,16,36,0.000333,0.051863,4,622.357646,34.575425,155.589411,67.01955,2,0
1,0,4,5,8,11,19,20,15,35,0.000333,0.049559,4,594.709852,33.039436,148.677463,62.053748,2,0
1,0,12,13,15,22,37,69,52,121,0.000333,0.210115,14,8824.814001,490.267445,630.343857,156.710855,6,0
1,0,12,13,15,22,37,69,52,121,0.000333,0.210115,14,8824.814001,490.267445,630.343857,156.710855,6,0
1,0,12,13,15,22,37,69,52,121,0.000333,0.210115,14,8824.814001,490.267445,630.343857,156.710855,6,0
1,0,12,13,15,22,37,69,52,121,0.000333,0.210115,14,8824.814001,490.267445,630.343857,156.710855,6,0
1,0,12,13,15,22,37,69,52,121,0.000333,0.210115,14,8824.814001,490.267445,630.343857,156.710855,6,0
1,0,12,13,15,22,37,69,52,121,0.000333,0.210115,14,8824.814001,490.267445,630.343857,156.710855,6,0
1,0,14,15,20,31,51,76,54,130,0.000333,0.245805,10,7374.152945,409.675164,737.415294,240.018648,5,0
1,0,13,14,20,31,51,63,46,109,0.000333,0.206098,10,6182.943623,343.496868,618.294362,240.018648,4,0
1,0,30,31,20,46,66,118,88,206,0.000333,0.415048,10,12451.45189,691.747327,1245.145189,340.522412,13,0
1,0,26,27,20,45,65,110,78,188,0.000333,0.377402,10,11322.05149,629.00286,1132.205149,333.571951,13,0
1,0,26,27,20,45,65,110,78,188,0.000333,0.377402,10,11322.05149,629.00286,1132.205149,333.571951,13,0
1,0,26,27,20,45,65,110,78,188,0.000333,0.377402,10,11322.05149,629.00286,1132.205149,333.571951,13,0
1,0,22,23,19,38,57,73,54,127,0.000333,0.246926,9,6666.993286,370.388516,740.777032,280.131868,11,0
1,0,22,23,19,38,57,73,54,127,0.000333,0.246926,9,6666.993286,370.388516,740.777032,280.131868,11,0
0,0,3,3,11,11,22,16,13,29,0.000333,0.043108,5,646.617585,35.923199,129.323517,76.107496,1,0
0,0,4,4,15,15,30,29,21,50,0.000333,0.081782,7,1717.411708,95.411762,245.34453,117.206718,1,0
0,0,15,15,21,33,54,86,73,159,0.000333,0.305009,20,18300.54226,1016.696792,915.027113,258.703672,6,0
0,0,15,15,21,33,54,86,73,159,0.000333,0.305009,20,18300.54226,1016.696792,915.027113,258.703672,6,0
0,0,13,13,16,31,47,67,63,130,0.000333,0.240699,16,11553.54481,641.863601,722.096551,217.580086,4,0
0,0,26,26,23,43,66,140,128,268,0.000333,0.539966,22,35637.74773,1979.874874,1619.897624,337.371309,6,0
0,0,15,15,21,33,54,86,73,159,0.000333,0.305009,20,18300.54226,1016.696792,915.027113,258.703672,6,0
0,0,18,18,20,35,55,100,88,188,0.000333,0.362299,20,21737.91252,1207.661807,1086.895626,265.963467,5,0
0,0,13,13,16,29,45,67,63,130,0.000333,0.23798,16,11423.05444,634.614136,713.940903,204.881449,4,0
0,0,20,20,19,34,53,96,87,183,0.000333,0.349403,18,18867.76998,1048.209443,1048.209443,253.684359,5,0
0,0,16,16,19,31,50,84,70,154,0.000333,0.289718,18,15644.76936,869.153853,869.153853,234.290708,5,0
0,0,25,25,22,40,62,118,106,224,0.000333,0.44458,22,29342.27942,1630.126634,1333.739974,310.984619,6,0
0,0,30,30,24,52,76,158,141,299,0.000333,0.62271,24,44835.12784,2490.840435,1868.130327,406.461965,6,0
0,0,15,15,21,33,54,86,73,159,0.000333,0.305009,20,18300.54226,1016.696792,915.027113,258.703672,6,0
0,0,13,13,16,29,45,67,63,130,0.000333,0.23798,16,11423.05444,634.614136,713.940903,204.881449,4,0
0,0,15,15,21,33,54,86,73,159,0.000333,0.305009,20,18300.54226,1016.696792,915.027113,258.703672,6,0
0,0,15,15,21,33,54,86,73,159,0.000333,0.305009,20,18300.54226,1016.696792,915.027113,258.703672,6,0
0,0,13,13,16,29,45,67,63,130,0.000333,0.23798,16,11423.05444,634.614136,713.940903,204.881449,4,0
0,0,16,16,19,31,50,84,71,155,0.000333,0.291599,18,15746.35877,874.797709,874.797709,234.290708,5,0
0,0,14,14,17,28,45,67,64,131,0.000333,0.239811,16,11510.92409,639.495783,719.432756,204.092806,4,0
0,0,13,13,16,31,47,67,63,130,0.000333,0.240699,16,11553.54481,641.863601,722.096551,217.580086,4,0
0,0,15,15,21,33,54,86,73,159,0.000333,0.305009,20,18300.54226,1016.696792,915.027113,258.703672,6,0
0,0,16,16,19,33,52,84,71,155,0.000333,0.294523,18,15904.22681,883.568156,883.568156,247.175629,5,0
0,0,13,13,16,29,45,64,61,125,0.000333,0.228827,16,10983.70619,610.2059,686.481637,204.881449,4,0
0,0,15,15,21,33,54,86,73,159,0.000333,0.305009,20,18300.54226,1016.696792,915.027113,258.703672,6,0
0,0,19,19,21,36,57,107,85,192,0.000333,0.373305,20,22398.29765,1244.34987,1119.914883,278.355966,5,0
0,0,15,15,21,31,52,83,71,154,0.000333,0.292623,20,17557.35433,975.408574,877.867717,245.818752,6,0
0,0,13,13,16,31,47,67,63,130,0.000333,0.240699,16,11553.54481,641.863601,722.096551,217.580086,4,0
0,0,13,13,16,31,47,67,63,130,0.000333,0.240699,16,11553.54481,641.863601,722.096551,217.580086,4,0
0,0,20,20,21,36,57,109,89,198,0.000333,0.384971,20,23098.24446,1283.235803,1154.912223,278.355966,5,0
0,0,16,16,19,31,50,84,70,154,0.000333,0.289718,18,15644.76936,869.153853,869.153853,234.290708,5,0
0,0,22,22,22,39,61,115,100,215,0.000333,0.425036,22,28052.38761,1558.465978,1275.108528,304.238182,5,0
0,0,17,17,21,37,58,101,80,181,0.000333,0.353432,20,21205.8912,1178.105067,1060.29456,284.98844,5,0
0,0,23,23,20,35,55,108,99,207,0.000333,0.398914,20,23934.82921,1329.712734,1196.741461,265.963467,5,0
0,0,13,13,16,31,47,67,63,130,0.000333,0.240699,16,11553.54481,641.863601,722.096551,217.580086,4,0
0,0,21,21,21,35,56,108,90,198,0.000333,0.383285,20,22997.12549,1277.618083,1149.856275,271.763571,5,0
0,0,15,15,21,33,54,86,73,159,0.000333,0.305009,20,18300.54226,1016.696792,915.027113,258.703672,6,0
0,0,14,14,17,30,47,70,66,136,0.000333,0.251808,16,12086.78534,671.488075,755.424084,216.693586,4,0
0,0,15,15,21,33,54,86,73,159,0.000333,0.305009,20,18300.54226,1016.696792,915.027113,258.703672,6,0
0,0,13,13,16,31,47,67,63,130,0.000333,0.240699,16,11553.54481,641.863601,722.096551,217.580086,4,0
0,0,16,16,19,32,51,86,71,157,0.000333,0.296857,18,16030.27402,890.570779,890.570779,240.710623,5,0
0,0,13,13,16,31,47,67,63,130,0.000333,0.240699,16,11553.54481,641.863601,722.096551,217.580086,4,0
0,0,19,19,22,38,60,109,97,206,0.000333,0.405606,22,26770.02818,1487.223788,1216.819463,297.528741,7,0
0,0,19,19,22,38,60,109,97,206,0.000333,0.405606,22,26770.02818,1487.223788,1216.819463,297.528741,7,0
0,0,19,19,22,38,60,109,97,206,0.000333,0.405606,22,26770.02818,1487.223788,1216.819463,297.528741,7,0
0,0,19,19,22,38,60,109,97,206,0.000333,0.405606,22,26770.02818,1487.223788,1216.819463,297.528741,7,0
0,0,19,19,22,38,60,109,97,206,0.000333,0.405606,22,26770.02818,1487.223788,1216.819463,297.528741,7,0
0,0,19,19,22,38,60,109,97,206,0.000333,0.405606,22,26770.02818,1487.223788,1216.819463,297.528741,7,0
0,0,19,19,22,38,60,109,97,206,0.000333,0.405606,22,26770.02818,1487.223788,1216.819463,297.528741,7,0
0,0,19,19,22,38,60,109,97,206,0.000333,0.405606,22,26770.02818,1487.223788,1216.819463,297.528741,7,0
0,0,19,19,22,36,58,106,95,201,0.000333,0.392485,22,25903.99196,1439.110664,1177.45418,284.224796,7,0
0,0,19,19,22,38,60,109,97,206,0.000333,0.405606,22,26770.02818,1487.223788,1216.819463,297.528741,7,0
0,0,19,19,22,38,60,109,97,206,0.000333,0.405606,22,26770.02818,1487.223788,1216.819463,297.528741,7,0
0,0,15,15,21,33,54,86,73,159,0.000333,0.305009,20,18300.54226,1016.696792,915.027113,258.703672,6,0
0,0,15,15,21,33,54,86,73,159,0.000333,0.305009,20,18300.54226,1016.696792,915.027113,258.703672,6,0
0,0,13,13,16,31,47,67,63,130,0.000333,0.240699,16,11553.54481,641.863601,722.096551,217.580086,4,0
0,0,26,26,23,43,66,140,128,268,0.000333,0.539966,22,35637.74773,1979.874874,1619.897624,337.371309,6,0
0,0,15,15,21,33,54,86,73,159,0.000333,0.305009,20,18300.54226,1016.696792,915.027113,258.703672,6,0
0,0,18,18,20,35,55,100,88,188,0.000333,0.362299,20,21737.91252,1207.661807,1086.895626,265.963467,5,0
0,0,13,13,16,29,45,67,63,130,0.000333,0.23798,16,11423.05444,634.614136,713.940903,204.881449,4,0
0,0,20,20,19,34,53,96,87,183,0.000333,0.349403,18,18867.76998,1048.209443,1048.209443,253.684359,5,0
0,0,16,16,19,31,50,84,70,154,0.000333,0.289718,18,15644.76936,869.153853,869.153853,234.290708,5,0
0,0,25,25,22,40,62,118,106,224,0.000333,0.44458,22,29342.27942,1630.126634,1333.739974,310.984619,6,0
0,0,30,30,24,52,76,158,141,299,0.000333,0.62271,24,44835.12784,2490.840435,1868.130327,406.461965,6,0
0,0,15,15,21,33,54,86,73,159,0.000333,0.305009,20,18300.54226,1016.696792,915.027113,258.703672,6,0
0,0,13,13,16,29,45,67,63,130,0.000333,0.23798,16,11423.05444,634.614136,713.940903,204.881449,4,0
0,0,15,15,21,33,54,86,73,159,0.000333,0.305009,20,18300.54226,1016.696792,915.027113,258.703672,6,0
0,0,15,15,21,33,54,86,73,159,0.000333,0.305009,20,18300.54226,1016.696792,915.027113,258.703672,6,0
0,0,13,13,16,29,45,67,63,130,0.000333,0.23798,16,11423.05444,634.614136,713.940903,204.881449,4,0
0,0,16,16,19,31,50,84,71,155,0.000333,0.291599,18,15746.35877,874.797709,874.797709,234.290708,5,0
0,0,14,14,17,28,45,67,64,131,0.000333,0.239811,16,11510.92409,639.495783,719.432756,204.092806,4,0
0,0,13,13,16,31,47,67,63,130,0.000333,0.240699,16,11553.54481,641.863601,722.096551,217.580086,4,0
0,0,15,15,21,33,54,86,73,159,0.000333,0.305009,20,18300.54226,1016.696792,915.027113,258.703672,6,0
0,0,16,16,19,33,52,84,71,155,0.000333,0.294523,18,15904.22681,883.568156,883.568156,247.175629,5,0
0,0,13,13,16,29,45,64,61,125,0.000333,0.228827,16,10983.70619,610.2059,686.481637,204.881449,4,0
0,0,15,15,21,33,54,86,73,159,0.000333,0.305009,20,18300.54226,1016.696792,915.027113,258.703672,6,0
0,0,19,19,21,36,57,107,85,192,0.000333,0.373305,20,22398.29765,1244.34987,1119.914883,278.355966,5,0
0,0,15,15,21,31,52,83,71,154,0.000333,0.292623,20,17557.35433,975.408574,877.867717,245.818752,6,0
0,0,13,13,16,31,47,67,63,130,0.000333,0.240699,16,11553.54481,641.863601,722.096551,217.580086,4,0
0,0,13,13,16,31,47,67,63,130,0.000333,0.240699,16,11553.54481,641.863601,722.096551,217.580086,4,0
0,0,20,20,21,36,57,109,89,198,0.000333,0.384971,20,23098.24446,1283.235803,1154.912223,278.355966,5,0
0,0,16,16,19,31,50,84,70,154,0.000333,0.289718,18,15644.76936,869.153853,869.153853,234.290708,5,0
0,0,22,22,22,39,61,115,100,215,0.000333,0.425036,22,28052.38761,1558.465978,1275.108528,304.238182,5,0
0,0,17,17,21,37,58,101,80,181,0.000333,0.353432,20,21205.8912,1178.105067,1060.29456,284.98844,5,0
0,0,23,23,20,35,55,108,99,207,0.000333,0.398914,20,23934.82921,1329.712734,1196.741461,265.963467,5,0
0,0,13,13,16,31,47,67,63,130,0.000333,0.240699,16,11553.54481,641.863601,722.096551,217.580086,4,0
0,0,21,21,21,35,56,108,90,198,0.000333,0.383285,20,22997.12549,1277.618083,1149.856275,271.763571,5,0
0,0,15,15,21,33,54,86,73,159,0.000333,0.305009,20,18300.54226,1016.696792,915.027113,258.703672,6,0
0,0,14,14,17,30,47,70,66,136,0.000333,0.251808,16,12086.78534,671.488075,755.424084,216.693586,4,0
0,0,15,15,21,33,54,86,73,159,0.000333,0.305009,20,18300.54226,1016.696792,915.027113,258.703672,6,0
0,0,13,13,16,31,47,67,63,130,0.000333,0.240699,16,11553.54481,641.863601,722.096551,217.580086,4,0
0,0,16,16,19,32,51,86,71,157,0.000333,0.296857,18,16030.27402,890.570779,890.570779,240.710623,5,0
0,0,13,13,16,31,47,67,63,130,0.000333,0.240699,16,11553.54481,641.863601,722.096551,217.580086,4,0
0,0,19,19,22,38,60,109,97,206,0.000333,0.405606,22,26770.02818,1487.223788,1216.819463,297.528741,7,0
0,0,19,19,22,38,60,109,97,206,0.000333,0.405606,22,26770.02818,1487.223788,1216.819463,297.528741,7,0
0,0,19,19,22,38,60,109,97,206,0.000333,0.405606,22,26770.02818,1487.223788,1216.819463,297.528741,7,0
0,0,19,19,22,38,60,109,97,206,0.000333,0.405606,22,26770.02818,1487.223788,1216.819463,297.528741,7,0
0,0,19,19,22,38,60,109,97,206,0.000333,0.405606,22,26770.02818,1487.223788,1216.819463,297.528741,7,0
0,0,19,19,22,38,60,109,97,206,0.000333,0.405606,22,26770.02818,1487.223788,1216.819463,297.528741,7,0
0,0,19,19,22,38,60,109,97,206,0.000333,0.405606,22,26770.02818,1487.223788,1216.819463,297.528741,7,0
0,0,19,19,22,38,60,109,97,206,0.000333,0.405606,22,26770.02818,1487.223788,1216.819463,297.528741,7,0
0,0,19,19,22,36,58,106,95,201,0.000333,0.392485,22,25903.99196,1439.110664,1177.45418,284.224796,7,0
0,0,19,19,22,38,60,109,97,206,0.000333,0.405606,22,26770.02818,1487.223788,1216.819463,297.528741,7,0
0,0,19,19,22,38,60,109,97,206,0.000333,0.405606,22,26770.02818,1487.223788,1216.819463,297.528741,7,0
0,0,16,16,22,36,58,92,79,171,0.000333,0.333905,22,22037.7245,1224.318028,1001.71475,284.224796,7,0
0,0,16,16,22,36,58,92,79,171,0.000333,0.333905,22,22037.7245,1224.318028,1001.71475,284.224796,7,0
0,0,14,14,17,35,52,73,69,142,0.000333,0.269821,8,6475.69952,359.761084,809.46244,249.011774,5,0
0,0,27,27,25,46,71,146,134,280,0.000333,0.573976,24,41326.30064,2295.905591,1721.929193,370.180255,7,0
0,0,16,16,22,36,58,92,79,171,0.000333,0.333905,22,22037.7245,1224.318028,1001.71475,284.224796,7,0
0,0,19,19,22,39,61,106,94,200,0.000333,0.395382,22,26095.24429,1449.735794,1186.147468,304.238182,6,0
0,0,14,14,17,34,51,73,69,142,0.000333,0.268495,16,12887.75038,715.986132,805.484399,242.460605,5,0
0,0,21,21,21,37,58,102,93,195,0.000333,0.380769,20,22846.12588,1269.229216,1142.306294,284.98844,6,0
0,0,17,17,21,34,55,90,76,166,0.000333,0.319902,20,19194.11425,1066.33968,959.705712,265.212402,6,0
0,0,26,26,24,44,68,124,112,236,0.000333,0.47888,24,34479.38953,1915.521641,1436.641231,350.254091,7,0
0,0,31,31,26,54,80,164,147,311,0.000333,0.655373,26,51119.11058,2839.950588,1966.119638,432.975358,7,0
0,0,16,16,22,36,58,92,79,171,0.000333,0.333905,22,22037.7245,1224.318028,1001.71475,284.224796,7,0
0,0,14,14,17,34,51,73,69,142,0.000333,0.268495,16,12887.75038,715.986132,805.484399,242.460605,5,0
0,0,16,16,22,36,58,92,79,171,0.000333,0.333905,22,22037.7245,1224.318028,1001.71475,284.224796,7,0
0,0,16,16,22,36,58,92,79,171,0.000333,0.333905,22,22037.7245,1224.318028,1001.71475,284.224796,7,0
0,0,14,14,17,34,51,73,69,142,0.000333,0.268495,16,12887.75038,715.986132,805.484399,242.460605,5,0
0,0,17,17,21,35,56,90,77,167,0.000333,0.323276,20,19396.56544,1077.586969,969.828272,271.763571,6,0
0,0,15,15,18,33,51,73,70,143,0.000333,0.270386,18,14600.82283,811.156824,811.156824,241.523656,5,0
0,0,14,14,17,35,52,73,69,142,0.000333,0.269821,8,6475.69952,359.761084,809.46244,249.011774,5,0
0,0,16,16,22,36,58,92,79,171,0.000333,0.333905,22,22037.7245,1224.318028,1001.71475,284.224796,7,0
0,0,17,17,21,36,57,90,77,167,0.000333,0.324698,20,19481.85265,1082.325147,974.092632,278.355966,6,0
0,0,14,14,17,33,50,70,67,137,0.000333,0.257736,16,12371.33277,687.296265,773.208298,235.951874,5,0
0,0,16,16,22,36,58,92,79,171,0.000333,0.333905,22,22037.7245,1224.318028,1001.71475,284.224796,7,0
0,0,20,20,23,39,62,113,91,204,0.000333,0.404885,22,26722.43304,1484.579613,1214.656047,310.172612,6,0
0,0,16,16,22,34,56,89,77,166,0.000333,0.32134,22,21208.46018,1178.247788,964.020917,271.081232,7,0
0,0,14,14,17,35,52,73,69,142,0.000333,0.269821,8,6475.69952,359.761084,809.46244,249.011774,5,0
0,0,14,14,17,35,52,73,69,142,0.000333,0.269821,8,6475.69952,359.761084,809.46244,249.011774,5,0
0,0,21,21,23,39,62,115,95,210,0.000333,0.416794,22,27508.38695,1528.24372,1250.381225,310.172612,6,0
0,0,17,17,21,34,55,90,76,166,0.000333,0.319902,20,19194.11425,1066.33968,959.705712,265.212402,6,0
0,0,23,23,24,42,66,121,106,227,0.000333,0.457359,24,32929.85916,1829.43662,1372.077465,336.516432,6,0
0,0,18,18,23,40,63,107,86,193,0.000333,0.384538,22,25379.53056,1409.97392,1153.615025,316.919049,6,0
0,0,24,24,22,39,61,114,105,219,0.000333,0.432944,22,28574.29249,1587.460694,1298.831477,304.238182,6,0
0,0,14,14,17,35,52,73,69,142,0.000333,0.269821,8,6475.69952,359.761084,809.46244,249.011774,5,0
0,0,22,22,23,38,61,114,96,210,0.000333,0.415152,22,27400.0065,1522.222583,1245.454841,303.463171,6,0
0,0,16,16,22,36,58,92,79,171,0.000333,0.333905,22,22037.7245,1224.318028,1001.71475,284.224796,7,0
0,0,15,15,18,35,53,76,72,148,0.000333,0.282577,18,15259.18009,847.732227,847.732227,254.583556,5,0
0,0,16,16,22,36,58,92,79,171,0.000333,0.333905,22,22037.7245,1224.318028,1001.71475,284.224796,7,0
0,0,14,14,17,35,52,73,69,142,0.000333,0.269821,8,6475.69952,359.761084,809.46244,249.011774,5,0
0,0,17,17,21,36,57,92,77,169,0.000333,0.328586,20,19715.16825,1095.287125,985.758412,278.355966,6,0
0,0,14,14,17,35,52,73,69,142,0.000333,0.269821,8,6475.69952,359.761084,809.46244,249.011774,5,0
0,0,20,20,23,41,64,115,103,218,0.000333,0.436,22,28776,1598.666667,1308,323.701557,8,0
0,0,20,20,23,41,64,115,103,218,0.000333,0.436,22,28776,1598.666667,1308,323.701557,8,0
0,0,20,20,23,41,64,115,103,218,0.000333,0.436,22,28776,1598.666667,1308,323.701557,8,0
0,0,20,20,23,41,64,115,103,218,0.000333,0.436,22,28776,1598.666667,1308,323.701557,8,0
0,0,20,20,23,41,64,115,103,218,0.000333,0.436,22,28776,1598.666667,1308,323.701557,8,0
0,0,20,20,23,41,64,115,103,218,0.000333,0.436,22,28776,1598.666667,1308,323.701557,8,0
0,0,20,20,23,41,64,115,103,218,0.000333,0.436,22,28776,1598.666667,1308,323.701557,8,0
0,0,20,20,23,41,64,115,103,218,0.000333,0.436,22,28776,1598.666667,1308,323.701557,8,0
0,0,20,20,23,39,62,112,101,213,0.000333,0.422748,22,27901.36391,1550.075773,1268.243814,310.172612,8,0
0,0,20,20,23,41,64,115,103,218,0.000333,0.436,22,28776,1598.666667,1308,323.701557,8,0
0,0,20,20,23,41,64,115,103,218,0.000333,0.436,22,28776,1598.666667,1308,323.701557,8,0
0,0,16,16,23,36,59,96,80,176,0.000333,0.345115,22,22777.59389,1265.421883,1035.345177,290.159225,7,0
0,0,16,16,23,36,59,96,80,176,0.000333,0.345115,22,22777.59389,1265.421883,1035.345177,290.159225,7,0
0,0,14,14,18,34,52,77,70,147,0.000333,0.279322,18,15083.36349,837.964639,837.964639,248.032387,5,0
0,0,27,27,26,45,71,150,135,285,0.000333,0.584226,39,68354.43923,3797.468846,1752.677929,369.344822,7,0
0,0,16,16,23,36,59,96,80,176,0.000333,0.345115,22,22777.59389,1265.421883,1035.345177,290.159225,7,0
0,0,19,19,23,38,61,110,95,205,0.000333,0.405267,22,26747.62539,1485.979188,1215.801154,303.463171,6,0
0,0,14,14,18,33,51,77,70,147,0.000333,0.277949,18,15009.23746,833.846525,833.846525,241.523656,5,0
0,0,21,21,22,37,59,106,94,200,0.000333,0.392176,22,25883.62942,1437.979412,1176.52861,290.85727,6,0
0,0,17,17,22,34,56,94,77,171,0.000333,0.331019,22,21847.26922,1213.737179,993.057692,271.081232,6,0
0,0,26,26,25,43,68,128,113,241,0.000333,0.489026,24,35209.88507,1956.104726,1467.078545,349.425789,7,0
0,0,31,31,27,54,81,168,148,316,0.000333,0.667798,26,52088.20762,2893.789312,2003.392601,439.145888,7,0
0,0,16,16,23,36,59,96,80,176,0.000333,0.345115,22,22777.59389,1265.421883,1035.345177,290.159225,7,0
0,0,14,14,18,33,51,77,70,147,0.000333,0.277949,18,15009.23746,833.846525,833.846525,241.523656,5,0
0,0,16,16,23,36,59,96,80,176,0.000333,0.345115,22,22777.59389,1265.421883,1035.345177,290.159225,7,0
0,0,16,16,23,36,59,96,80,176,0.000333,0.345115,22,22777.59389,1265.421883,1035.345177,290.159225,7,0
0,0,14,14,18,33,51,77,70,147,0.000333,0.277949,18,15009.23746,833.846525,833.846525,241.523656,5,0
0,0,17,17,22,34,56,94,78,172,0.000333,0.332955,22,21975.03103,1220.835057,998.865047,271.081232,6,0
0,0,15,15,19,32,51,77,71,148,0.000333,0.27984,18,15111.34111,839.518951,839.518951,240.710623,5,0
0,0,14,14,18,34,52,77,70,147,0.000333,0.279322,18,15083.36349,837.964639,837.964639,248.032387,5,0
0,0,16,16,23,36,59,96,80,176,0.000333,0.345115,22,22777.59389,1265.421883,1035.345177,290.159225,7,0
0,0,17,17,22,35,57,94,78,172,0.000333,0.334419,22,22071.65581,1226.203101,1003.257082,277.632401,6,0
0,0,14,14,18,32,50,74,68,142,0.000333,0.267143,18,14425.69642,801.427579,801.427579,235.05865,5,0
0,0,16,16,23,36,59,96,80,176,0.000333,0.345115,22,22777.59389,1265.421883,1035.345177,290.159225,7,0
0,0,20,20,24,39,63,117,92,209,0.000333,0.416417,24,29982.0361,1665.668672,1249.251504,316.169787,6,0
0,0,16,16,23,34,57,93,78,171,0.000333,0.332475,22,21943.33223,1219.074013,997.424192,277.015662,7,0
0,0,14,14,18,34,52,77,70,147,0.000333,0.279322,18,15083.36349,837.964639,837.964639,248.032387,5,0
0,0,14,14,18,34,52,77,70,147,0.000333,0.279322,18,15083.36349,837.964639,837.964639,248.032387,5,0
0,0,21,21,24,39,63,119,96,215,0.000333,0.428372,24,30842.76441,1713.486911,1285.115184,316.169787,6,0
0,0,17,17,22,34,56,94,77,171,0.000333,0.331019,22,21847.26922,1213.737179,993.057692,271.081232,6,0
0,0,23,23,25,41,66,125,107,232,0.000333,0.467433,24,33655.18646,1869.732581,1402.299436,335.756037,6,0
0,0,18,18,24,39,63,111,87,198,0.000333,0.3945,24,28404.0342,1578.0019,1183.501425,316.169787,6,0
0,0,24,24,23,38,61,118,106,224,0.000333,0.442828,22,29226.6736,1623.704089,1328.485164,303.463171,6,0
0,0,14,14,18,34,52,77,70,147,0.000333,0.279322,18,15083.36349,837.964639,837.964639,248.032387,5,0
0,0,22,22,24,38,62,118,97,215,0.000333,0.426717,24,30723.65296,1706.869609,1280.152207,309.460346,6,0
0,0,16,16,23,36,59,96,80,176,0.000333,0.345115,22,22777.59389,1265.421883,1035.345177,290.159225,7,0
0,0,15,15,19,34,53,80,73,153,0.000333,0.292124,18,15774.69293,876.37183,876.37183,253.684359,5,0
0,0,16,16,23,36,59,96,80,176,0.000333,0.345115,22,22777.59389,1265.421883,1035.345177,290.159225,7,0
0,0,14,14,18,34,52,77,70,147,0.000333,0.279322,18,15083.36349,837.964639,837.964639,248.032387,5,0
0,0,17,17,22,35,57,96,78,174,0.000333,0.338308,22,22328.30297,1240.461276,1014.922862,277.632401,6,0
0,0,14,14,18,34,52,77,70,147,0.000333,0.279322,18,15083.36349,837.964639,837.964639,248.032387,5,0
0,0,20,20,24,41,65,119,104,223,0.000333,0.447663,24,32231.71254,1790.650696,1342.988022,329.698732,8,0
0,0,20,20,24,41,65,119,104,223,0.000333,0.447663,24,32231.71254,1790.650696,1342.988022,329.698732,8,0
0,0,20,20,24,41,65,119,104,223,0.000333,0.447663,24,32231.71254,1790.650696,1342.988022,329.698732,8,0
0,0,20,20,24,41,65,119,104,223,0.000333,0.447663,24,32231.71254,1790.650696,1342.988022,329.698732,8,0
0,0,20,20,24,41,65,119,104,223,0.000333,0.447663,24,32231.71254,1790.650696,1342.988022,329.698732,8,0
0,0,20,20,24,41,65,119,104,223,0.000333,0.447663,24,32231.71254,1790.650696,1342.988022,329.698732,8,0
0,0,20,20,24,41,65,119,104,223,0.000333,0.447663,24,32231.71254,1790.650696,1342.988022,329.698732,8,0
0,0,20,20,24,41,65,119,104,223,0.000333,0.447663,24,32231.71254,1790.650696,1342.988022,329.698732,8,0
0,0,20,20,24,39,63,116,102,218,0.000333,0.434349,24,31273.12856,1737.396031,1303.047023,316.169787,8,0
0,0,20,20,24,41,65,119,104,223,0.000333,0.447663,24,32231.71254,1790.650696,1342.988022,329.698732,8,0
0,0,20,20,24,41,65,119,104,223,0.000333,0.447663,24,32231.71254,1790.650696,1342.988022,329.698732,8,0
0,0,58,58,28,76,104,306,264,570,0.000333,1.273084,42,160408.5269,8911.584825,3819.250639,609.448429,16,0
0,0,53,53,26,65,91,267,232,499,0.000333,1.082463,39,126648.1915,7036.010638,3247.389525,513.665341,15,0
0,0,61,61,30,87,117,332,284,616,0.000333,1.410715,45,190446.51,10580.36167,4232.144667,707.742802,16,0
0,0,53,53,27,71,98,277,239,516,0.000333,1.13773,39,133114.4209,7395.245606,3413.19028,565.014008,15,0
0,0,59,59,28,76,104,316,272,588,0.000333,1.313286,42,165474.0593,9193.003293,3939.858554,609.448429,16,0
0,0,54,54,26,65,91,277,240,517,0.000333,1.12151,39,131216.6633,7289.814629,3364.529829,513.665341,15,0
0,0,51,51,28,76,104,272,238,510,0.000333,1.139075,42,143523.4188,7973.523265,3417.224256,609.448429,14,0
0,0,46,46,26,65,91,233,206,439,0.000333,0.952307,39,111419.952,6189.997335,2856.921847,513.665341,13,0
0,0,40,40,24,66,90,207,186,393,0.000333,0.850433,24,61231.15841,3401.731022,2551.298267,508.969112,9,0
0,0,35,35,22,53,75,168,154,322,0.000333,0.66856,22,44124.9516,2451.3862,2005.679618,401.68728,8,0
0,0,45,45,31,71,102,235,206,441,0.000333,0.980847,30,88276.18727,4904.232626,2942.539576,590.212131,10,0
0,0,26,26,22,47,69,127,119,246,0.000333,0.500899,22,33059.33436,1836.629687,1502.697016,359.173172,6,0
0,0,32,32,23,63,86,173,156,329,0.000333,0.704747,22,46513.3043,2584.072461,2114.241104,480.61056,7,0
0,0,24,24,20,43,63,118,111,229,0.000333,0.456266,20,27375.94205,1520.885669,1368.797102,319.767946,6,0
0,0,30,30,22,55,77,170,152,322,0.000333,0.672635,22,44393.91585,2466.328659,2017.905266,416.08228,7,0
0,0,25,25,20,43,63,131,120,251,0.000333,0.500099,20,30005.94522,1666.996956,1500.297261,319.767946,6,0
0,0,26,26,22,66,88,176,163,339,0.000333,0.729916,22,48174.44101,2676.357834,2189.747319,497.037507,8,0
0,0,25,25,23,61,84,171,151,322,0.000333,0.686109,22,45283.17662,2515.732035,2058.32621,465.816903,10,0
0,0,24,24,23,59,82,177,154,331,0.000333,0.70145,22,46295.6937,2571.982983,2104.349714,451.117865,10,0
0,0,23,23,20,59,79,152,141,293,0.000333,0.615669,20,36940.15518,2052.230844,1847.007759,433.514502,8,0
0,0,23,23,20,64,84,168,155,323,0.000333,0.68824,20,41294.37055,2294.131697,2064.718528,470.438562,4,0
0,0,21,21,19,57,76,141,133,274,0.000333,0.570644,18,30814.7785,1711.932139,1711.932139,413.185354,4,0
0,0,21,21,19,59,78,152,138,290,0.000333,0.607589,18,32809.79958,1822.766643,1822.766643,427.786563,4,0
0,0,21,21,18,59,77,146,138,284,0.000333,0.593256,18,32035.8128,1779.767378,1779.767378,422.13459,4,0
0,0,22,22,22,58,80,157,143,300,0.000333,0.632193,22,41724.72543,2318.040301,1896.578428,437.870393,6,0
0,0,21,21,22,56,78,163,146,309,0.000333,0.647396,22,42728.16428,2373.786905,1942.189286,423.319371,6,0
0,0,20,20,17,56,73,138,133,271,0.000333,0.559147,16,26839.07929,1491.05996,1677.442455,394.698744,4,0
0,0,4,4,10,9,19,15,13,28,0.000333,0.039647,5,594.709852,33.039436,118.94197,61.748606,1,0
0,0,13,13,22,34,56,102,77,179,0.000333,0.346506,22,22869.36368,1270.520205,1039.516531,271.081232,9,0
0,0,35,35,32,62,94,246,173,419,0.000333,0.915458,32,87883.92732,4882.440407,2746.372729,529.160171,12,0
0,0,5,5,14,14,28,35,25,60,0.000333,0.096147,7,2019.089067,112.171615,288.441295,106.605938,2,0
0,0,36,36,33,63,96,258,179,437,0.000333,0.95921,32,92084.11561,5115.784201,2877.628613,543.033641,12,0
0,0,75,75,27,91,118,358,320,678,0.000333,1.555477,39,181990.8475,10110.60264,4666.431987,720.591275,28,0
0,0,75,75,27,91,118,358,320,678,0.000333,1.555477,39,181990.8475,10110.60264,4666.431987,720.591275,28,0
0,0,48,48,24,63,87,214,200,414,0.000333,0.889126,36,96025.62986,5334.757215,2667.378607,486.607735,21,0
0,0,49,49,24,65,89,221,208,429,0.000333,0.92603,36,100011.2271,5556.179284,2778.089642,501.493008,21,0
0,0,49,49,24,65,89,221,208,429,0.000333,0.92603,36,100011.2271,5556.179284,2778.089642,501.493008,21,0
0,0,73,73,27,90,117,348,310,658,0.000333,1.5069,39,176307.2994,9794.849969,4520.699985,712.648741,26,0
0,0,74,74,27,91,118,353,315,668,0.000333,1.532535,39,179306.6167,9961.478707,4597.605557,720.591275,27,0
0,0,75,75,27,93,120,360,323,683,0.000333,1.572469,39,183978.8448,10221.04693,4717.406277,736.523732,27,0
0,0,75,75,27,93,120,360,323,683,0.000333,1.572469,39,183978.8448,10221.04693,4717.406277,736.523732,27,0
0,0,100,100,27,109,136,474,413,887,0.000333,2.095527,39,245176.6021,13620.92234,6286.57954,866.114054,61,0
0,0,100,100,27,109,136,474,413,887,0.000333,2.095527,39,245176.6021,13620.92234,6286.57954,866.114054,61,0
0,0,11,11,14,24,38,48,41,89,0.000333,0.155689,7,3269.458841,181.636602,467.065549,163.342069,4,0
0,0,17,17,17,35,52,88,75,163,0.000333,0.309724,16,14866.74679,825.930377,929.171674,249.011774,4,0
0,0,11,11,17,30,47,74,70,144,0.000333,0.26662,16,12797.77271,710.987373,799.860795,216.693586,8,0
0,0,41,41,25,65,90,217,199,416,0.000333,0.900204,36,97221.99197,5401.221776,2700.610888,507.550313,21,0
0,0,100,100,32,125,157,459,404,863,0.000333,2.098419,48,302172.3699,16787.35388,6295.257706,1030.723036,45,0
0,0,84,84,29,108,137,388,332,720,0.000333,1.703528,42,214644.4902,11924.6939,5110.5831,870.409299,43,0
0,0,72,72,32,97,129,552,454,1006,0.000333,2.351098,64,451410.8556,25078.38087,7053.294619,800.191546,37,0
0,0,72,72,33,107,140,476,395,871,0.000333,2.069869,48,298061.0644,16558.94802,6209.605508,887.801973,40,0
0,0,72,72,32,97,129,552,454,1006,0.000333,2.351098,64,451410.8556,25078.38087,7053.294619,800.191546,37,0
0,0,72,72,33,107,140,476,395,871,0.000333,2.069869,48,298061.0644,16558.94802,6209.605508,887.801973,40,0
0,0,72,72,32,97,129,552,454,1006,0.000333,2.351098,64,451410.8556,25078.38087,7053.294619,800.191546,37,0
0,0,72,72,33,107,140,476,395,871,0.000333,2.069869,48,298061.0644,16558.94802,6209.605508,887.801973,40,0
0,0,105,105,32,119,151,464,402,866,0.000333,2.089486,48,300886.0082,16715.88935,6268.458504,980.483314,44,0
0,0,89,89,29,102,131,393,330,723,0.000333,1.695055,42,213576.9229,11865.3846,5085.16483,821.468834,42,0
0,0,105,105,32,119,151,464,402,866,0.000333,2.089486,48,300886.0082,16715.88935,6268.458504,980.483314,44,0
0,0,89,89,29,102,131,393,330,723,0.000333,1.695055,42,213576.9229,11865.3846,5085.16483,821.468834,42,0
0,0,27,27,20,44,64,134,137,271,0.000333,0.542,30,48780,2710,1626,326.653553,10,0
0,0,22,22,18,41,59,115,116,231,0.000333,0.452964,18,24460.0298,1358.890544,1358.890544,294.718282,7,0
0,0,10,10,21,15,36,54,42,96,0.000333,0.165438,20,9926.256003,551.458667,496.3128,150.842025,4,0
0,0,65,65,27,80,107,279,234,513,0.000333,1.152791,26,89917.68667,4995.427037,3458.372564,634.13621,23,0
0,0,60,60,25,75,100,256,212,468,0.000333,1.036442,24,74623.79272,4145.766262,3109.324697,583.257807,22,0
0,0,62,62,25,77,102,258,212,470,0.000333,1.045347,24,75264.95786,4181.386548,3136.039911,598.638968,23,0
0,0,61,61,26,76,102,263,216,479,0.000333,1.065364,26,83098.38521,4616.576956,3196.091739,597.053924,23,0
0,0,61,61,25,74,99,259,214,473,0.000333,1.045229,24,75256.45635,4180.914242,3135.685681,575.595954,23,0
0,0,61,61,25,74,99,259,214,473,0.000333,1.045229,24,75256.45635,4180.914242,3135.685681,575.595954,23,0
0,0,61,61,26,75,101,263,216,479,0.000333,1.063094,26,82921.36581,4606.742545,3189.2833,589.372834,23,0
0,0,61,61,26,75,101,263,216,479,0.000333,1.063094,26,82921.36581,4606.742545,3189.2833,589.372834,23,0
0,0,99,99,36,118,154,477,395,872,0.000333,2.112213,54,342178.4446,19009.91359,6336.637863,998.26918,30,0
0,0,79,79,27,102,129,354,295,649,0.000333,1.516762,26,118307.4487,6572.636039,4550.286489,808.969347,26,0
0,0,81,81,27,104,131,356,295,651,0.000333,1.526253,26,119047.7177,6613.762096,4578.758374,825.227693,27,0
0,0,80,80,28,103,131,361,299,660,0.000333,1.547353,28,129977.6571,7220.980948,4642.059181,823.315492,27,0
0,0,80,80,27,101,128,357,297,654,0.000333,1.526,26,119028,6612.666667,4578,800.861322,27,0
0,0,80,80,27,101,128,357,297,654,0.000333,1.526,26,119028,6612.666667,4578,800.861322,27,0
0,0,80,80,28,101,129,361,299,660,0.000333,1.54247,28,129567.4797,7198.193316,4627.409989,807.085298,27,0
0,0,80,80,28,101,129,361,299,660,0.000333,1.54247,28,129567.4797,7198.193316,4627.409989,807.085298,27,0
0,0,99,99,36,118,154,477,393,870,0.000333,2.107368,54,341393.6317,18966.31287,6322.10429,998.26918,30,0
0,0,79,79,27,102,129,354,293,647,0.000333,1.512088,26,117942.8649,6552.381383,4536.264034,808.969347,26,0
0,0,81,81,27,104,131,356,293,649,0.000333,1.521564,26,118681.9797,6593.443318,4564.691528,825.227693,27,0
0,0,80,80,28,103,131,361,297,658,0.000333,1.542664,28,129583.7854,7199.099188,4627.992335,823.315492,27,0
0,0,80,80,27,101,128,357,295,652,0.000333,1.521333,26,118664,6592.444444,4564,800.861322,27,0
0,0,80,80,27,101,128,357,295,652,0.000333,1.521333,26,118664,6592.444444,4564,800.861322,27,0
0,0,80,80,28,101,129,361,297,658,0.000333,1.537796,28,129174.851,7176.380609,4613.387534,807.085298,27,0
0,0,80,80,28,101,129,361,297,658,0.000333,1.537796,28,129174.851,7176.380609,4613.387534,807.085298,27,0
0,0,86,86,37,111,148,402,340,742,0.000333,1.783138,54,288868.3775,16048.24319,5349.414397,946.929936,26,0
0,0,69,69,29,96,125,303,260,563,0.000333,1.307246,28,109808.6235,6100.479081,3921.736552,773.037849,22,0
0,0,71,71,29,98,127,305,260,565,0.000333,1.316202,28,110560.9917,6142.277319,3948.606848,789.123014,23,0
0,0,70,70,30,97,127,310,264,574,0.000333,1.337168,30,120345.1503,6685.841684,4011.50501,787.398264,23,0
0,0,70,70,29,95,124,306,262,568,0.000333,1.316661,28,110599.5381,6144.418784,3949.983504,765.017732,23,0
0,0,70,70,29,95,124,306,262,568,0.000333,1.316661,28,110599.5381,6144.418784,3949.983504,765.017732,23,0
0,0,70,70,30,96,126,310,264,574,0.000333,1.334986,30,120148.7603,6674.931127,4004.958676,779.363118,23,0
0,0,70,70,30,96,126,310,264,574,0.000333,1.334986,30,120148.7603,6674.931127,4004.958676,779.363118,23,0
0,0,95,95,37,125,162,458,391,849,0.000333,2.077178,54,336502.7632,18694.59796,6231.532652,1063.47281,28,0
0,0,76,76,29,109,138,347,302,649,0.000333,1.537811,28,129176.1064,7176.450357,4613.432372,878.61354,24,0
0,0,78,78,29,111,140,349,302,651,0.000333,1.547054,28,129952.5708,7219.587268,4641.163244,895.06161,25,0
0,0,77,77,30,110,140,354,306,660,0.000333,1.568442,30,141159.8037,7842.211319,4705.326791,893.156286,25,0
0,0,77,77,29,108,137,350,304,654,0.000333,1.547371,28,129979.1635,7221.064639,4642.112982,870.409299,25,0
0,0,77,77,29,108,137,350,304,654,0.000333,1.547371,28,129979.1635,7221.064639,4642.112982,870.409299,25,0
0,0,77,77,30,108,138,354,306,660,0.000333,1.563875,30,140748.7842,7819.376902,4691.626141,876.734568,25,0
0,0,77,77,30,108,138,354,306,660,0.000333,1.563875,30,140748.7842,7819.376902,4691.626141,876.734568,25,0
0,0,93,93,36,121,157,462,391,853,0.000333,2.074104,54,336004.8209,18666.9345,6222.311499,1023.299752,27,0
0,0,72,72,27,106,133,329,283,612,0.000333,1.439278,26,112263.6541,6236.869673,4317.832851,841.541531,23,0
0,0,74,74,27,108,135,331,283,614,0.000333,1.448388,26,112974.2842,6276.349122,4345.164777,857.909813,24,0
0,0,73,73,28,107,135,336,287,623,0.000333,1.469619,28,123447.9713,6858.220626,4408.856117,855.942905,24,0
0,0,73,73,27,105,132,332,285,617,0.000333,1.448797,26,113006.1705,6278.120581,4346.391172,833.377742,24,0
0,0,73,73,27,105,132,332,285,617,0.000333,1.448797,26,113006.1705,6278.120581,4346.391172,833.377742,24,0
0,0,73,73,28,105,133,336,287,623,0.000333,1.465147,28,123072.3468,6837.3526,4395.440957,839.601717,24,0
0,0,73,73,28,105,133,336,287,623,0.000333,1.465147,28,123072.3468,6837.3526,4395.440957,839.601717,24,0
0,0,90,90,36,120,156,453,381,834,0.000333,2.025342,54,328105.3743,18228.07635,6076.025451,1014.944172,27,0
0,0,69,69,27,105,132,320,273,593,0.000333,1.392442,26,108610.4685,6033.914918,4177.325713,833.377742,23,0
0,0,71,71,27,107,134,322,273,595,0.000333,1.401441,26,109312.3998,6072.911099,4204.323068,849.71893,24,0
0,0,70,70,28,106,134,327,277,604,0.000333,1.422639,28,119501.7004,6638.983355,4267.917871,847.765506,24,0
0,0,70,70,27,104,131,323,275,598,0.000333,1.401996,26,109355.6608,6075.31449,4205.986955,825.227693,24,0
0,0,70,70,27,104,131,323,275,598,0.000333,1.401996,26,109355.6608,6075.31449,4205.986955,825.227693,24,0
0,0,70,70,28,104,132,327,277,604,0.000333,1.418271,28,119134.7933,6618.59963,4254.814048,831.451669,24,0
0,0,70,70,28,104,132,327,277,604,0.000333,1.418271,28,119134.7933,6618.59963,4254.814048,831.451669,24,0
0,0,65,65,27,80,107,279,234,513,0.000333,1.152791,26,89917.68667,4995.427037,3458.372564,634.13621,23,0
0,0,60,60,25,75,100,256,212,468,0.000333,1.036442,24,74623.79272,4145.766262,3109.324697,583.257807,22,0
0,0,62,62,25,77,102,258,212,470,0.000333,1.045347,24,75264.95786,4181.386548,3136.039911,598.638968,23,0
0,0,61,61,26,76,102,263,216,479,0.000333,1.065364,26,83098.38521,4616.576956,3196.091739,597.053924,23,0
0,0,61,61,25,74,99,259,214,473,0.000333,1.045229,24,75256.45635,4180.914242,3135.685681,575.595954,23,0
0,0,61,61,25,74,99,259,214,473,0.000333,1.045229,24,75256.45635,4180.914242,3135.685681,575.595954,23,0
0,0,61,61,26,75,101,263,216,479,0.000333,1.063094,26,82921.36581,4606.742545,3189.2833,589.372834,23,0
0,0,61,61,26,75,101,263,216,479,0.000333,1.063094,26,82921.36581,4606.742545,3189.2833,589.372834,23,0
0,0,99,99,36,118,154,477,395,872,0.000333,2.112213,54,342178.4446,19009.91359,6336.637863,998.26918,30,0
0,0,79,79,27,102,129,354,295,649,0.000333,1.516762,26,118307.4487,6572.636039,4550.286489,808.969347,26,0
0,0,81,81,27,104,131,356,295,651,0.000333,1.526253,26,119047.7177,6613.762096,4578.758374,825.227693,27,0
0,0,80,80,28,103,131,361,299,660,0.000333,1.547353,28,129977.6571,7220.980948,4642.059181,823.315492,27,0
0,0,80,80,27,101,128,357,297,654,0.000333,1.526,26,119028,6612.666667,4578,800.861322,27,0
0,0,80,80,27,101,128,357,297,654,0.000333,1.526,26,119028,6612.666667,4578,800.861322,27,0
0,0,80,80,28,101,129,361,299,660,0.000333,1.54247,28,129567.4797,7198.193316,4627.409989,807.085298,27,0
0,0,80,80,28,101,129,361,299,660,0.000333,1.54247,28,129567.4797,7198.193316,4627.409989,807.085298,27,0
0,0,99,99,36,118,154,477,393,870,0.000333,2.107368,54,341393.6317,18966.31287,6322.10429,998.26918,30,0
0,0,79,79,27,102,129,354,293,647,0.000333,1.512088,26,117942.8649,6552.381383,4536.264034,808.969347,26,0
0,0,81,81,27,104,131,356,293,649,0.000333,1.521564,26,118681.9797,6593.443318,4564.691528,825.227693,27,0
0,0,80,80,28,103,131,361,297,658,0.000333,1.542664,28,129583.7854,7199.099188,4627.992335,823.315492,27,0
0,0,80,80,27,101,128,357,295,652,0.000333,1.521333,26,118664,6592.444444,4564,800.861322,27,0
0,0,80,80,27,101,128,357,295,652,0.000333,1.521333,26,118664,6592.444444,4564,800.861322,27,0
0,0,80,80,28,101,129,361,297,658,0.000333,1.537796,28,129174.851,7176.380609,4613.387534,807.085298,27,0
0,0,80,80,28,101,129,361,297,658,0.000333,1.537796,28,129174.851,7176.380609,4613.387534,807.085298,27,0
0,0,86,86,37,111,148,402,340,742,0.000333,1.783138,54,288868.3775,16048.24319,5349.414397,946.929936,26,0
0,0,69,69,29,96,125,303,260,563,0.000333,1.307246,28,109808.6235,6100.479081,3921.736552,773.037849,22,0
0,0,71,71,29,98,127,305,260,565,0.000333,1.316202,28,110560.9917,6142.277319,3948.606848,789.123014,23,0
0,0,70,70,30,97,127,310,264,574,0.000333,1.337168,30,120345.1503,6685.841684,4011.50501,787.398264,23,0
0,0,70,70,29,95,124,306,262,568,0.000333,1.316661,28,110599.5381,6144.418784,3949.983504,765.017732,23,0
0,0,70,70,29,95,124,306,262,568,0.000333,1.316661,28,110599.5381,6144.418784,3949.983504,765.017732,23,0
0,0,70,70,30,96,126,310,264,574,0.000333,1.334986,30,120148.7603,6674.931127,4004.958676,779.363118,23,0
0,0,70,70,30,96,126,310,264,574,0.000333,1.334986,30,120148.7603,6674.931127,4004.958676,779.363118,23,0
0,0,95,95,37,125,162,458,391,849,0.000333,2.077178,54,336502.7632,18694.59796,6231.532652,1063.47281,28,0
0,0,76,76,29,109,138,347,302,649,0.000333,1.537811,28,129176.1064,7176.450357,4613.432372,878.61354,24,0
0,0,78,78,29,111,140,349,302,651,0.000333,1.547054,28,129952.5708,7219.587268,4641.163244,895.06161,25,0
0,0,77,77,30,110,140,354,306,660,0.000333,1.568442,30,141159.8037,7842.211319,4705.326791,893.156286,25,0
0,0,77,77,29,108,137,350,304,654,0.000333,1.547371,28,129979.1635,7221.064639,4642.112982,870.409299,25,0
0,0,77,77,29,108,137,350,304,654,0.000333,1.547371,28,129979.1635,7221.064639,4642.112982,870.409299,25,0
0,0,77,77,30,108,138,354,306,660,0.000333,1.563875,30,140748.7842,7819.376902,4691.626141,876.734568,25,0
0,0,77,77,30,108,138,354,306,660,0.000333,1.563875,30,140748.7842,7819.376902,4691.626141,876.734568,25,0
0,0,93,93,36,121,157,462,391,853,0.000333,2.074104,54,336004.8209,18666.9345,6222.311499,1023.299752,27,0
0,0,72,72,27,106,133,329,283,612,0.000333,1.439278,26,112263.6541,6236.869673,4317.832851,841.541531,23,0
0,0,74,74,27,108,135,331,283,614,0.000333,1.448388,26,112974.2842,6276.349122,4345.164777,857.909813,24,0
0,0,73,73,28,107,135,336,287,623,0.000333,1.469619,28,123447.9713,6858.220626,4408.856117,855.942905,24,0
0,0,73,73,27,105,132,332,285,617,0.000333,1.448797,26,113006.1705,6278.120581,4346.391172,833.377742,24,0
0,0,73,73,27,105,132,332,285,617,0.000333,1.448797,26,113006.1705,6278.120581,4346.391172,833.377742,24,0
0,0,73,73,28,105,133,336,287,623,0.000333,1.465147,28,123072.3468,6837.3526,4395.440957,839.601717,24,0
0,0,73,73,28,105,133,336,287,623,0.000333,1.465147,28,123072.3468,6837.3526,4395.440957,839.601717,24,0
0,0,96,96,36,117,153,468,383,851,0.000333,2.058679,54,333506.0009,18528.11116,6176.037054,989.949972,30,0
0,0,76,76,27,101,128,345,283,628,0.000333,1.465333,26,114296,6349.777778,4396,800.861322,26,0
0,0,78,78,27,103,130,347,283,630,0.000333,1.474697,26,115026.3848,6390.35471,4424.091722,817.091517,27,0
0,0,77,77,28,102,130,352,287,639,0.000333,1.495764,28,125644.2049,6980.233606,4487.293033,815.193323,27,0
0,0,77,77,27,100,127,348,285,633,0.000333,1.474612,26,115019.7726,6389.987365,4423.837407,792.767582,27,0
0,0,77,77,27,100,127,348,285,633,0.000333,1.474612,26,115019.7726,6389.987365,4423.837407,792.767582,27,0
0,0,77,77,28,100,128,352,287,639,0.000333,1.491,28,125244,6958,4473,798.991557,27,0
0,0,77,77,28,100,128,352,287,639,0.000333,1.491,28,125244,6958,4473,798.991557,27,0
0,0,35,35,18,54,72,160,148,308,0.000333,0.633446,18,34206.06421,1900.3369,1900.3369,385.822575,19,0
0,0,37,37,18,56,74,162,148,310,0.000333,0.641644,18,34648.74978,1924.930543,1924.930543,400.270526,20,0
0,0,36,36,20,55,75,167,152,319,0.000333,0.662331,20,39739.86325,2207.77018,1986.993162,404.413346,20,0
0,0,36,36,18,53,71,163,150,313,0.000333,0.641624,18,34647.67527,1924.870848,1924.870848,378.638434,20,0
0,0,36,36,18,53,71,163,150,313,0.000333,0.641624,18,34647.67527,1924.870848,1924.870848,378.638434,20,0
0,0,36,36,20,54,74,167,152,319,0.000333,0.660272,20,39616.31247,2200.906248,1980.815624,397.202487,20,0
0,0,36,36,20,54,74,167,152,319,0.000333,0.660272,20,39616.31247,2200.906248,1980.815624,397.202487,20,0
0,0,16,16,21,42,63,100,110,210,0.000333,0.41841,20,25104.57568,1394.698649,1255.228784,318.715998,3,0
0,0,17,17,19,37,56,92,99,191,0.000333,0.369735,18,19965.68622,1109.20479,1109.20479,273.460397,4,0
0,0,19,19,19,37,56,98,104,202,0.000333,0.391029,18,21115.5425,1173.085694,1173.085694,273.460397,5,0
0,0,17,17,19,37,56,96,107,203,0.000333,0.392964,18,21220.07489,1178.893049,1178.893049,273.460397,4,0
0,0,17,17,19,37,56,96,103,199,0.000333,0.385221,18,20801.94533,1155.663629,1155.663629,273.460397,4,0
0,0,19,19,19,37,56,98,103,201,0.000333,0.389093,18,21011.01011,1167.278339,1167.278339,273.460397,5,0
0,0,46,46,21,59,80,218,246,464,0.000333,0.977792,40,117334.9854,6518.610302,2933.374636,439.314606,5,0
0,0,36,36,21,55,76,180,186,366,0.000333,0.762247,30,68602.2441,3811.235783,2286.74147,410.21345,6,0
0,0,33,33,21,53,74,171,182,353,0.000333,0.730646,30,65758.11114,3653.228397,2191.937038,395.81845,5,0
0,0,35,35,21,53,74,173,179,352,0.000333,0.728576,30,65571.82754,3642.879308,2185.727585,395.81845,6,0
0,0,21,21,19,38,57,110,124,234,0.000333,0.454965,27,36852.19911,2047.344395,1364.896263,280.131868,5,0
0,0,23,23,19,38,57,112,121,233,0.000333,0.453021,27,36694.71108,2038.59506,1359.063373,280.131868,6,0
0,0,73,73,24,86,110,457,430,887,0.000333,2.005022,60,360903.964,20050.22022,6015.066066,662.697869,6,0
0,0,38,38,21,54,75,182,197,379,0.000333,0.786907,30,70821.66851,3934.537139,2360.722284,403.002591,5,0
0,0,35,35,21,57,78,185,196,381,0.000333,0.798246,30,71842.14736,3991.230409,2394.738245,424.713397,5,0
0,0,37,37,21,57,78,187,193,380,0.000333,0.796151,30,71653.5853,3980.754739,2388.452843,424.713397,6,0
0,0,23,23,19,38,57,112,121,233,0.000333,0.453021,27,36694.71108,2038.59506,1359.063373,280.131868,6,0
0,0,21,21,19,38,57,110,124,234,0.000333,0.454965,27,36852.19911,2047.344395,1364.896263,280.131868,5,0
0,0,25,25,24,33,57,119,91,210,0.000333,0.408302,24,29397.76567,1633.209204,1224.906903,276.504106,8,0
0,0,20,20,21,32,53,108,87,195,0.000333,0.372315,20,22338.88977,1241.049432,1116.944489,252.238666,8,0
0,0,25,25,24,33,57,120,92,212,0.000333,0.412191,24,29677.74439,1648.763577,1236.572683,276.504106,8,0
0,0,20,20,21,31,52,109,88,197,0.000333,0.374329,20,22459.73249,1247.762916,1122.986624,245.818752,8,0
0,0,86,86,30,99,129,456,387,843,0.000333,1.970155,45,265970.9059,14776.16144,5910.464576,803.513023,39,0
0,0,71,71,30,90,120,392,337,729,0.000333,1.678374,45,226580.546,12587.80811,5035.123244,731.473497,32,0
0,0,24,24,22,33,55,106,85,191,0.000333,0.36808,22,24293.27352,1349.626306,1104.239705,264.572502,8,0
0,0,19,19,19,32,51,95,81,176,0.000333,0.332782,18,17970.24348,998.34686,998.34686,240.710623,8,0
0,0,24,24,22,33,55,107,86,193,0.000333,0.371934,22,24547.65334,1363.758519,1115.802425,264.572502,8,0
0,0,19,19,19,31,50,96,82,178,0.000333,0.334869,18,18082.91523,1004.606402,1004.606402,234.290708,8,0
0,0,85,85,30,99,129,443,381,824,0.000333,1.92575,45,259976.3066,14443.12815,5777.251258,803.513023,39,0
0,0,70,70,30,90,120,379,331,710,0.000333,1.634631,45,220675.1545,12259.73081,4903.892323,731.473497,32,0
0,0,24,24,22,33,55,106,85,191,0.000333,0.36808,22,24293.27352,1349.626306,1104.239705,264.572502,8,0
0,0,19,19,19,32,51,95,81,176,0.000333,0.332782,18,17970.24348,998.34686,998.34686,240.710623,8,0
0,0,24,24,22,33,55,107,86,193,0.000333,0.371934,22,24547.65334,1363.758519,1115.802425,264.572502,8,0
0,0,19,19,19,31,50,96,82,178,0.000333,0.334869,18,18082.91523,1004.606402,1004.606402,234.290708,8,0
0,0,85,85,30,99,129,443,381,824,0.000333,1.92575,45,259976.3066,14443.12815,5777.251258,803.513023,39,0
0,0,70,70,30,90,120,379,331,710,0.000333,1.634631,45,220675.1545,12259.73081,4903.892323,731.473497,32,0
0,0,23,23,22,33,55,103,81,184,0.000333,0.35459,22,23402.94412,1300.163562,1063.770187,264.572502,8,0
0,0,18,18,19,32,51,92,77,169,0.000333,0.319547,18,17255.51789,958.639883,958.639883,240.710623,8,0
0,0,23,23,22,33,55,104,82,186,0.000333,0.358444,22,23657.32395,1314.295775,1075.332907,264.572502,8,0
0,0,18,18,19,31,50,93,78,171,0.000333,0.3217,18,17371.78935,965.099408,965.099408,234.290708,8,0
0,0,84,84,30,99,129,440,377,817,0.000333,1.909391,45,257767.77,14320.43167,5728.172668,803.513023,39,0
0,0,69,69,30,90,120,376,327,703,0.000333,1.618515,45,218499.484,12138.86022,4855.544089,731.473497,32,0
0,0,23,23,22,33,55,103,81,184,0.000333,0.35459,22,23402.94412,1300.163562,1063.770187,264.572502,8,0
0,0,18,18,19,32,51,92,77,169,0.000333,0.319547,18,17255.51789,958.639883,958.639883,240.710623,8,0
0,0,23,23,22,33,55,104,82,186,0.000333,0.358444,22,23657.32395,1314.295775,1075.332907,264.572502,8,0
0,0,18,18,19,31,50,93,78,171,0.000333,0.3217,18,17371.78935,965.099408,965.099408,234.290708,8,0
0,0,84,84,30,99,129,440,377,817,0.000333,1.909391,45,257767.77,14320.43167,5728.172668,803.513023,39,0
0,0,69,69,30,90,120,376,327,703,0.000333,1.618515,45,218499.484,12138.86022,4855.544089,731.473497,32,0
0,0,21,21,24,40,64,112,86,198,0.000333,0.396,24,28512,1584,1188,322.916224,3,0
0,0,15,15,23,35,58,88,66,154,0.000333,0.30071,11,9923.419806,551.3011,902.129073,283.566831,3,0
0,0,15,15,23,35,58,88,66,154,0.000333,0.30071,11,9923.419806,551.3011,902.129073,283.566831,3,0
0,0,105,105,40,111,151,550,448,998,0.000333,2.407976,80,577914.2344,32106.34636,7223.92793,967.057285,50,0
0,0,106,106,39,111,150,557,454,1011,0.000333,2.436112,76,555433.5129,30857.41738,7308.335696,960.310848,51,0
0,0,105,105,40,111,151,550,448,998,0.000333,2.407976,80,577914.2344,32106.34636,7223.92793,967.057285,50,0
0,0,106,106,39,111,150,557,454,1011,0.000333,2.436112,76,555433.5129,30857.41738,7308.335696,960.310848,51,0
0,0,105,105,40,111,151,550,448,998,0.000333,2.407976,80,577914.2344,32106.34636,7223.92793,967.057285,50,0
0,0,106,106,39,111,150,557,454,1011,0.000333,2.436112,76,555433.5129,30857.41738,7308.335696,960.310848,51,0
0,0,105,105,40,111,151,550,448,998,0.000333,2.407976,80,577914.2344,32106.34636,7223.92793,967.057285,50,0
0,0,106,106,39,111,150,557,454,1011,0.000333,2.436112,76,555433.5129,30857.41738,7308.335696,960.310848,51,0
0,0,105,105,40,111,151,550,448,998,0.000333,2.407976,80,577914.2344,32106.34636,7223.92793,967.057285,50,0
0,0,105,105,40,111,151,550,448,998,0.000333,2.407976,80,577914.2344,32106.34636,7223.92793,967.057285,50,0
0,0,106,106,39,111,150,557,454,1011,0.000333,2.436112,76,555433.5129,30857.41738,7308.335696,960.310848,51,0
0,0,105,105,40,111,151,550,448,998,0.000333,2.407976,80,577914.2344,32106.34636,7223.92793,967.057285,50,0
0,0,106,106,39,111,150,557,454,1011,0.000333,2.436112,76,555433.5129,30857.41738,7308.335696,960.310848,51,0
0,0,105,105,40,111,151,550,448,998,0.000333,2.407976,80,577914.2344,32106.34636,7223.92793,967.057285,50,0
0,0,106,106,39,111,150,557,454,1011,0.000333,2.436112,76,555433.5129,30857.41738,7308.335696,960.310848,51,0
0,0,105,105,40,111,151,550,448,998,0.000333,2.407976,80,577914.2344,32106.34636,7223.92793,967.057285,50,0
0,0,106,106,39,111,150,557,454,1011,0.000333,2.436112,76,555433.5129,30857.41738,7308.335696,960.310848,51,0
0,0,105,105,40,111,151,550,448,998,0.000333,2.407976,80,577914.2344,32106.34636,7223.92793,967.057285,50,0
0,0,105,105,40,111,151,550,448,998,0.000333,2.407976,80,577914.2344,32106.34636,7223.92793,967.057285,50,0
0,0,106,106,39,111,150,557,454,1011,0.000333,2.436112,76,555433.5129,30857.41738,7308.335696,960.310848,51,0
0,0,105,105,40,111,151,550,448,998,0.000333,2.407976,80,577914.2344,32106.34636,7223.92793,967.057285,50,0
0,0,106,106,39,111,150,557,454,1011,0.000333,2.436112,76,555433.5129,30857.41738,7308.335696,960.310848,51,0
0,0,105,105,40,111,151,550,448,998,0.000333,2.407976,80,577914.2344,32106.34636,7223.92793,967.057285,50,0
0,0,106,106,39,111,150,557,454,1011,0.000333,2.436112,76,555433.5129,30857.41738,7308.335696,960.310848,51,0
0,0,105,105,40,111,151,550,448,998,0.000333,2.407976,80,577914.2344,32106.34636,7223.92793,967.057285,50,0
0,0,106,106,39,111,150,557,454,1011,0.000333,2.436112,76,555433.5129,30857.41738,7308.335696,960.310848,51,0
0,0,105,105,40,111,151,550,448,998,0.000333,2.407976,80,577914.2344,32106.34636,7223.92793,967.057285,50,0
0,0,103,103,40,110,150,551,447,998,0.000333,2.404787,80,577148.8842,32063.8269,7214.361053,958.826692,50,0
0,0,104,104,39,110,149,558,453,1011,0.000333,2.43286,76,554692.0324,30816.22402,7298.579374,952.080255,51,0
0,0,103,103,40,110,150,551,447,998,0.000333,2.404787,80,577148.8842,32063.8269,7214.361053,958.826692,50,0
0,0,104,104,39,110,149,558,453,1011,0.000333,2.43286,76,554692.0324,30816.22402,7298.579374,952.080255,51,0
0,0,103,103,40,110,150,551,447,998,0.000333,2.404787,80,577148.8842,32063.8269,7214.361053,958.826692,50,0
0,0,104,104,39,110,149,558,453,1011,0.000333,2.43286,76,554692.0324,30816.22402,7298.579374,952.080255,51,0
0,0,103,103,40,110,150,551,447,998,0.000333,2.404787,80,577148.8842,32063.8269,7214.361053,958.826692,50,0
0,0,104,104,39,110,149,558,453,1011,0.000333,2.43286,76,554692.0324,30816.22402,7298.579374,952.080255,51,0
0,0,103,103,40,110,150,551,447,998,0.000333,2.404787,80,577148.8842,32063.8269,7214.361053,958.826692,50,0
0,0,102,102,39,105,144,537,438,975,0.000333,2.330226,76,531291.4426,29516.19126,6990.676876,911.126466,50,0
0,0,103,103,38,105,143,544,444,988,0.000333,2.357984,76,537620.4189,29867.80105,7073.952881,904.417025,51,0
0,0,102,102,39,105,144,537,438,975,0.000333,2.330226,76,531291.4426,29516.19126,6990.676876,911.126466,50,0
0,0,103,103,38,105,143,544,444,988,0.000333,2.357984,76,537620.4189,29867.80105,7073.952881,904.417025,51,0
0,0,102,102,39,105,144,537,438,975,0.000333,2.330226,76,531291.4426,29516.19126,6990.676876,911.126466,50,0
0,0,103,103,38,105,143,544,444,988,0.000333,2.357984,76,537620.4189,29867.80105,7073.952881,904.417025,51,0
0,0,102,102,39,105,144,537,438,975,0.000333,2.330226,76,531291.4426,29516.19126,6990.676876,911.126466,50,0
0,0,103,103,38,105,143,544,444,988,0.000333,2.357984,76,537620.4189,29867.80105,7073.952881,904.417025,51,0
0,0,102,102,39,105,144,537,438,975,0.000333,2.330226,76,531291.4426,29516.19126,6990.676876,911.126466,50,0
0,0,103,103,40,110,150,546,446,992,0.000333,2.390329,80,573679.0513,31871.0584,7170.988141,958.826692,50,0
0,0,104,104,39,110,149,553,452,1005,0.000333,2.418421,76,551400.0916,30633.33842,7255.264363,952.080255,51,0
0,0,103,103,40,110,150,546,446,992,0.000333,2.390329,80,573679.0513,31871.0584,7170.988141,958.826692,50,0
0,0,104,104,39,110,149,553,452,1005,0.000333,2.418421,76,551400.0916,30633.33842,7255.264363,952.080255,51,0
0,0,103,103,40,110,150,546,446,992,0.000333,2.390329,80,573679.0513,31871.0584,7170.988141,958.826692,50,0
0,0,104,104,39,110,149,553,452,1005,0.000333,2.418421,76,551400.0916,30633.33842,7255.264363,952.080255,51,0
0,0,103,103,40,110,150,546,446,992,0.000333,2.390329,80,573679.0513,31871.0584,7170.988141,958.826692,50,0
0,0,104,104,39,110,149,553,452,1005,0.000333,2.418421,76,551400.0916,30633.33842,7255.264363,952.080255,51,0
0,0,103,103,40,110,150,546,446,992,0.000333,2.390329,80,573679.0513,31871.0584,7170.988141,958.826692,50,0
0,0,103,103,40,110,150,546,446,992,0.000333,2.390329,80,573679.0513,31871.0584,7170.988141,958.826692,50,0
0,0,104,104,39,110,149,553,452,1005,0.000333,2.418421,76,551400.0916,30633.33842,7255.264363,952.080255,51,0
0,0,103,103,40,110,150,546,446,992,0.000333,2.390329,80,573679.0513,31871.0584,7170.988141,958.826692,50,0
0,0,104,104,39,110,149,553,452,1005,0.000333,2.418421,76,551400.0916,30633.33842,7255.264363,952.080255,51,0
0,0,103,103,40,110,150,546,446,992,0.000333,2.390329,80,573679.0513,31871.0584,7170.988141,958.826692,50,0
0,0,104,104,39,110,149,553,452,1005,0.000333,2.418421,76,551400.0916,30633.33842,7255.264363,952.080255,51,0
0,0,103,103,40,110,150,546,446,992,0.000333,2.390329,80,573679.0513,31871.0584,7170.988141,958.826692,50,0
0,0,104,104,39,110,149,553,452,1005,0.000333,2.418421,76,551400.0916,30633.33842,7255.264363,952.080255,51,0
0,0,103,103,40,110,150,546,446,992,0.000333,2.390329,80,573679.0513,31871.0584,7170.988141,958.826692,50,0
0,0,102,102,39,105,144,537,438,975,0.000333,2.330226,76,531291.4426,29516.19126,6990.676876,911.126466,50,0
0,0,103,103,38,105,143,544,444,988,0.000333,2.357984,76,537620.4189,29867.80105,7073.952881,904.417025,51,0
0,0,102,102,39,105,144,537,438,975,0.000333,2.330226,76,531291.4426,29516.19126,6990.676876,911.126466,50,0
0,0,103,103,38,105,143,544,444,988,0.000333,2.357984,76,537620.4189,29867.80105,7073.952881,904.417025,51,0
0,0,102,102,39,105,144,537,438,975,0.000333,2.330226,76,531291.4426,29516.19126,6990.676876,911.126466,50,0
0,0,103,103,38,105,143,544,444,988,0.000333,2.357984,76,537620.4189,29867.80105,7073.952881,904.417025,51,0
0,0,102,102,39,105,144,537,438,975,0.000333,2.330226,76,531291.4426,29516.19126,6990.676876,911.126466,50,0
0,0,103,103,38,105,143,544,444,988,0.000333,2.357984,76,537620.4189,29867.80105,7073.952881,904.417025,51,0
0,0,102,102,39,105,144,537,438,975,0.000333,2.330226,76,531291.4426,29516.19126,6990.676876,911.126466,50,0
0,0,102,102,39,105,144,537,438,975,0.000333,2.330226,76,531291.4426,29516.19126,6990.676876,911.126466,50,0
0,0,103,103,38,105,143,544,444,988,0.000333,2.357984,76,537620.4189,29867.80105,7073.952881,904.417025,51,0
0,0,102,102,39,105,144,537,438,975,0.000333,2.330226,76,531291.4426,29516.19126,6990.676876,911.126466,50,0
0,0,103,103,38,105,143,544,444,988,0.000333,2.357984,76,537620.4189,29867.80105,7073.952881,904.417025,51,0
0,0,102,102,39,105,144,537,438,975,0.000333,2.330226,76,531291.4426,29516.19126,6990.676876,911.126466,50,0
0,0,103,103,38,105,143,544,444,988,0.000333,2.357984,76,537620.4189,29867.80105,7073.952881,904.417025,51,0
0,0,102,102,39,105,144,537,438,975,0.000333,2.330226,76,531291.4426,29516.19126,6990.676876,911.126466,50,0
0,0,103,103,38,105,143,544,444,988,0.000333,2.357984,76,537620.4189,29867.80105,7073.952881,904.417025,51,0
0,0,102,102,39,105,144,537,438,975,0.000333,2.330226,76,531291.4426,29516.19126,6990.676876,911.126466,50,0
0,0,94,94,34,105,139,499,413,912,0.000333,2.164158,51,331116.1872,18395.34373,6492.474258,877.969516,43,0
0,0,79,79,34,96,130,435,363,798,0.000333,1.86795,51,285796.3253,15877.57363,5603.849515,805.130137,36,0
0,0,80,80,33,96,129,442,369,811,0.000333,1.895368,48,272933.0546,15162.94748,5686.105304,798.621406,37,0
0,0,79,79,34,96,130,435,363,798,0.000333,1.86795,51,285796.3253,15877.57363,5603.849515,805.130137,36,0
0,0,80,80,33,96,129,442,369,811,0.000333,1.895368,48,272933.0546,15162.94748,5686.105304,798.621406,37,0
0,0,79,79,34,96,130,435,363,798,0.000333,1.86795,51,285796.3253,15877.57363,5603.849515,805.130137,36,0
0,0,80,80,33,96,129,442,369,811,0.000333,1.895368,48,272933.0546,15162.94748,5686.105304,798.621406,37,0
0,0,79,79,34,96,130,435,363,798,0.000333,1.86795,51,285796.3253,15877.57363,5603.849515,805.130137,36,0
0,0,80,80,33,96,129,442,369,811,0.000333,1.895368,48,272933.0546,15162.94748,5686.105304,798.621406,37,0
0,0,79,79,34,96,130,435,363,798,0.000333,1.86795,51,285796.3253,15877.57363,5603.849515,805.130137,36,0
0,0,57,57,29,85,114,270,233,503,0.000333,1.145648,28,96234.42296,5346.356831,3436.943677,685.679678,20,0
0,0,42,42,28,76,104,206,183,389,0.000333,0.868824,28,72981.18941,4054.510523,2606.47105,609.448429,13,0
0,0,57,57,28,79,107,251,221,472,0.000333,1.060657,28,89095.22769,4949.734872,3181.972418,632.604617,20,0
0,0,42,42,27,70,97,187,171,358,0.000333,0.78759,26,61431.98874,3412.888263,2362.768798,557.431774,13,0
0,0,58,58,29,85,114,272,234,506,0.000333,1.152481,28,96808.38572,5378.243651,3457.442347,685.679678,20,0
0,0,43,43,28,76,104,208,184,392,0.000333,0.875524,28,73544.02635,4085.779241,2626.57237,609.448429,13,0
0,0,58,58,29,85,114,272,234,506,0.000333,1.152481,28,96808.38572,5378.243651,3457.442347,685.679678,20,0
0,0,43,43,28,76,104,208,184,392,0.000333,0.875524,28,73544.02635,4085.779241,2626.57237,609.448429,13,0
0,0,58,58,29,85,114,272,234,506,0.000333,1.152481,28,96808.38572,5378.243651,3457.442347,685.679678,20,0
0,0,43,43,28,76,104,208,184,392,0.000333,0.875524,28,73544.02635,4085.779241,2626.57237,609.448429,13,0
0,0,58,58,29,85,114,272,234,506,0.000333,1.152481,28,96808.38572,5378.243651,3457.442347,685.679678,20,0
0,0,43,43,28,76,104,208,184,392,0.000333,0.875524,28,73544.02635,4085.779241,2626.57237,609.448429,13,0
0,0,35,35,29,59,88,214,155,369,0.000333,0.79451,28,66738.84748,3707.713749,2383.530267,487.957389,11,0
0,0,35,35,29,59,88,214,155,369,0.000333,0.79451,28,66738.84748,3707.713749,2383.530267,487.957389,11,0
0,0,34,34,29,57,86,203,148,351,0.000333,0.751873,28,63157.33001,3508.740556,2255.618929,473.35618,11,0
0,0,35,35,29,59,88,214,155,369,0.000333,0.79451,28,66738.84748,3707.713749,2383.530267,487.957389,11,0
0,0,33,33,29,58,87,209,149,358,0.000333,0.768858,28,64584.0656,3588.003645,2306.573772,480.644347,11,0
0,0,33,33,29,58,87,209,149,358,0.000333,0.768858,28,64584.0656,3588.003645,2306.573772,480.644347,11,0
0,0,28,28,28,48,76,134,96,230,0.000333,0.479008,28,40236.65319,2235.369621,1437.023328,402.684138,12,0
0,0,17,17,19,34,53,101,69,170,0.000333,0.324582,18,17527.43659,973.746477,973.746477,253.684359,11,0
0,0,17,17,19,34,53,101,69,170,0.000333,0.324582,18,17527.43659,973.746477,973.746477,253.684359,11,0
0,0,60,60,24,65,89,265,225,490,0.000333,1.057703,36,114231.9377,6346.218762,3173.109381,501.493008,15,0
0,0,59,59,24,65,89,261,222,483,0.000333,1.042593,36,112600.0529,6255.558494,3127.779247,501.493008,14,0
0,0,60,60,24,66,90,266,226,492,0.000333,1.064664,36,114983.702,6387.983447,3193.991723,508.969112,15,0
0,0,59,59,24,65,89,261,222,483,0.000333,1.042593,36,112600.0529,6255.558494,3127.779247,501.493008,14,0
0,0,64,64,35,57,92,311,237,548,0.000333,1.191637,68,243094.0127,13505.22293,3574.911952,511.999636,25,0
0,0,64,64,35,57,92,311,237,548,0.000333,1.191637,68,243094.0127,13505.22293,3574.911952,511.999636,25,0
0,0,34,34,33,40,73,163,131,294,0.000333,0.606603,48,87350.80418,4852.822454,1819.80842,379.34213,14,0
0,0,34,34,33,40,73,163,131,294,0.000333,0.606603,48,87350.80418,4852.822454,1819.80842,379.34213,14,0
0,0,34,34,33,40,73,163,131,294,0.000333,0.606603,48,87350.80418,4852.822454,1819.80842,379.34213,14,0
0,0,34,34,33,40,73,163,131,294,0.000333,0.606603,48,87350.80418,4852.822454,1819.80842,379.34213,14,0
0,0,24,24,19,48,67,136,104,240,0.000333,0.485287,18,26205.5053,1455.861406,1455.861406,348.788823,10,0
0,0,24,24,21,56,77,151,113,264,0.000333,0.551477,20,33088.63294,1838.257385,1654.431647,417.450542,10,0
0,0,17,17,19,36,55,104,76,180,0.000333,0.346882,18,18731.60547,1040.644748,1040.644748,266.827923,10,0
0,0,21,21,19,45,64,125,94,219,0.000333,0.438,18,23652,1314,1314,327.844012,10,0
0,0,14,14,17,27,44,84,63,147,0.000333,0.267512,16,12840.58317,713.365732,802.536448,197.868831,8,0
0,0,16,16,18,36,54,98,73,171,0.000333,0.328029,18,17713.54373,984.085763,984.085763,261.17595,9,0
0,0,20,20,18,45,63,119,91,210,0.000333,0.41841,18,22594.11811,1255.228784,1255.228784,322.192039,9,0
0,0,13,13,16,27,43,78,60,138,0.000333,0.249608,16,11981.19258,665.62181,748.824536,192.381963,7,0
0,0,12,12,16,27,43,73,57,130,0.000333,0.235138,16,11286.63069,627.035038,705.414418,192.381963,6,0
0,0,86,86,30,83,113,426,308,734,0.000333,1.66867,45,225270.5111,12515.0284,5006.011358,676.334991,38,0
0,0,85,85,30,80,110,413,298,711,0.000333,1.607182,45,216969.604,12053.86689,4821.546756,652.960965,38,0
0,0,85,85,30,81,111,408,298,706,0.000333,1.598953,45,215858.5921,11992.144,4796.857602,660.734568,37,0
0,0,83,83,30,80,110,397,288,685,0.000333,1.54841,45,209035.4132,11613.07851,4645.231404,652.960965,37,0
0,0,83,83,29,83,112,403,297,700,0.000333,1.588383,42,200136.2347,11118.67971,4765.148445,670.009722,34,0
0,0,29,29,17,38,55,135,110,245,0.000333,0.472144,16,22662.93008,1259.051671,1416.43313,268.908114,14,0
0,0,32,32,19,40,59,155,123,278,0.000333,0.545125,27,44155.11873,2453.062152,1635.374768,293.587747,16,0
0,0,31,31,18,38,56,149,119,268,0.000333,0.51879,27,42022.02022,2334.556679,1556.371119,274.479896,15,0
0,0,81,81,31,84,115,386,284,670,0.000333,1.528826,45,206391.525,11466.19584,4586.478334,690.534749,37,0
0,0,30,30,20,39,59,143,115,258,0.000333,0.505907,20,30354.43814,1686.357674,1517.721907,292.569248,16,0
0,0,79,79,30,83,113,383,279,662,0.000333,1.504986,45,203173.1313,11287.39618,4514.958473,676.334991,35,0
0,0,77,77,30,80,110,368,270,638,0.000333,1.442169,45,194692.8374,10816.26874,4326.507497,652.960965,34,0
0,0,84,84,33,86,119,434,302,736,0.000333,1.691529,48,243580.1219,13532.229,5074.585874,719.123775,41,0
0,0,81,81,30,85,115,396,287,683,0.000333,1.55849,45,210396.1367,11688.67426,4675.469705,692.004947,37,0
0,0,30,30,20,39,59,149,116,265,0.000333,0.519633,20,31178.00816,1732.111565,1558.900408,292.569248,16,0
0,0,16,16,17,30,47,88,63,151,0.000333,0.279581,16,13419.88667,745.549259,838.742917,216.693586,9,0
0,0,17,17,17,31,48,92,66,158,0.000333,0.294141,16,14118.7852,784.376956,882.424075,223.066954,9,0
0,0,18,18,17,31,48,93,72,165,0.000333,0.307173,16,14744.301,819.127833,921.518813,223.066954,10,0
0,0,19,19,18,33,51,99,76,175,0.000333,0.330891,18,17868.13983,992.674435,992.674435,241.523656,11,0
0,0,22,22,21,36,57,118,92,210,0.000333,0.408302,20,24498.13806,1361.00767,1224.906903,278.355966,13,0
0,0,20,20,17,33,50,108,79,187,0.000333,0.3518,16,16886.41772,938.134318,1055.401107,235.951874,11,0
0,0,21,21,17,38,55,115,86,201,0.000333,0.387351,16,18592.85284,1032.936269,1162.053302,268.908114,11,0
0,0,23,23,17,37,54,121,90,211,0.000333,0.40476,16,19428.50021,1079.361123,1214.281263,262.236643,13,0
0,0,23,23,19,49,68,137,102,239,0.000333,0.484968,18,26188.26514,1454.903619,1454.903619,355.831405,11,0
0,0,23,23,19,51,70,137,102,239,0.000333,0.4883,18,26368.17554,1464.898641,1464.898641,370.004315,11,0
0,0,23,23,20,50,70,138,103,241,0.000333,0.492386,20,29543.14414,1641.285786,1477.157207,368.631371,11,0
0,0,21,21,17,34,51,111,83,194,0.000333,0.366817,16,17607.20826,978.178237,1100.450516,242.460605,11,0
0,0,22,22,17,39,56,118,90,208,0.000333,0.402643,16,19326.87718,1073.715399,1207.929824,275.617555,11,0
0,0,24,24,17,44,61,128,98,226,0.000333,0.446782,16,21445.54621,1191.419234,1340.346638,309.70186,12,0
0,0,24,24,17,43,60,128,98,226,0.000333,0.444986,16,21359.31639,1186.628689,1334.957275,302.816253,12,0
0,0,24,24,18,37,55,114,94,208,0.000333,0.400841,18,21645.41077,1202.52282,1202.52282,267.808425,12,0
0,0,38,38,20,56,76,220,168,388,0.000333,0.808065,30,72725.87626,4040.326459,2424.195875,411.650438,19,0
0,0,26,26,18,40,58,123,100,223,0.000333,0.435443,18,23513.93571,1306.329762,1306.329762,287.935774,12,0
0,0,29,29,19,37,56,143,112,255,0.000333,0.493625,27,39983.63864,2221.313258,1480.875505,273.460397,15,0
0,0,74,74,29,93,122,479,310,789,0.000333,1.822784,42,229670.7739,12759.48744,5468.351759,749.023218,39,0
0,0,88,88,30,83,113,438,317,755,0.000333,1.716412,45,231715.5802,12873.08779,5149.235117,676.334991,38,0
0,0,12,12,18,30,48,94,61,155,0.000333,0.288556,18,15582.04538,865.669188,865.669188,222.265368,6,0
0,0,14,14,17,31,48,110,75,185,0.000333,0.344406,16,16531.489,918.416056,1033.218063,223.066954,7,0
0,0,72,72,28,92,120,471,304,775,0.000333,1.78428,42,224819.2889,12489.96049,5352.840212,734.773638,38,0
0,0,52,52,27,70,97,380,256,636,0.000333,1.399182,39,163704.2381,9094.679897,4197.544568,557.431774,28,0
0,0,33,33,22,47,69,266,176,442,0.000333,0.899989,33,89098.93773,4949.940985,2699.96781,359.173172,19,0
0,0,39,39,22,68,90,308,217,525,0.000333,1.136074,33,112471.3549,6248.408605,3408.222876,512.054969,17,0
0,0,33,33,19,55,74,252,178,430,0.000333,0.890022,27,72091.75358,4005.097421,2670.064947,398.685407,15,0
0,0,26,26,18,43,61,198,135,333,0.000333,0.658312,27,53323.2594,2962.4033,1974.935533,308.388034,13,0
0,0,23,23,18,41,59,179,123,302,0.000333,0.592186,27,47967.07142,2664.837301,1776.558201,294.718282,12,0
0,0,86,86,30,83,113,426,308,734,0.000333,1.66867,45,225270.5111,12515.0284,5006.011358,676.334991,38,0
0,0,85,85,30,80,110,413,298,711,0.000333,1.607182,45,216969.604,12053.86689,4821.546756,652.960965,38,0
0,0,85,85,30,81,111,408,298,706,0.000333,1.598953,45,215858.5921,11992.144,4796.857602,660.734568,37,0
0,0,83,83,30,80,110,397,288,685,0.000333,1.54841,45,209035.4132,11613.07851,4645.231404,652.960965,37,0
0,0,83,83,29,83,112,403,297,700,0.000333,1.588383,42,200136.2347,11118.67971,4765.148445,670.009722,34,0
0,0,29,29,17,38,55,135,110,245,0.000333,0.472144,16,22662.93008,1259.051671,1416.43313,268.908114,14,0
0,0,32,32,19,40,59,155,123,278,0.000333,0.545125,27,44155.11873,2453.062152,1635.374768,293.587747,16,0
0,0,31,31,18,38,56,149,119,268,0.000333,0.51879,27,42022.02022,2334.556679,1556.371119,274.479896,15,0
0,0,81,81,31,84,115,386,284,670,0.000333,1.528826,45,206391.525,11466.19584,4586.478334,690.534749,37,0
0,0,30,30,20,39,59,143,115,258,0.000333,0.505907,20,30354.43814,1686.357674,1517.721907,292.569248,16,0
0,0,79,79,30,83,113,383,279,662,0.000333,1.504986,45,203173.1313,11287.39618,4514.958473,676.334991,35,0
0,0,77,77,30,80,110,368,270,638,0.000333,1.442169,45,194692.8374,10816.26874,4326.507497,652.960965,34,0
0,0,84,84,33,86,119,434,302,736,0.000333,1.691529,48,243580.1219,13532.229,5074.585874,719.123775,41,0
0,0,81,81,30,85,115,396,287,683,0.000333,1.55849,45,210396.1367,11688.67426,4675.469705,692.004947,37,0
0,0,30,30,20,39,59,149,116,265,0.000333,0.519633,20,31178.00816,1732.111565,1558.900408,292.569248,16,0
0,0,16,16,17,30,47,88,63,151,0.000333,0.279581,16,13419.88667,745.549259,838.742917,216.693586,9,0
0,0,17,17,17,31,48,92,66,158,0.000333,0.294141,16,14118.7852,784.376956,882.424075,223.066954,9,0
0,0,18,18,17,31,48,93,72,165,0.000333,0.307173,16,14744.301,819.127833,921.518813,223.066954,10,0
0,0,19,19,18,33,51,99,76,175,0.000333,0.330891,18,17868.13983,992.674435,992.674435,241.523656,11,0
0,0,22,22,21,36,57,118,92,210,0.000333,0.408302,20,24498.13806,1361.00767,1224.906903,278.355966,13,0
0,0,20,20,17,33,50,108,79,187,0.000333,0.3518,16,16886.41772,938.134318,1055.401107,235.951874,11,0
0,0,21,21,17,38,55,115,86,201,0.000333,0.387351,16,18592.85284,1032.936269,1162.053302,268.908114,11,0
0,0,23,23,17,37,54,121,90,211,0.000333,0.40476,16,19428.50021,1079.361123,1214.281263,262.236643,13,0
0,0,23,23,19,49,68,137,102,239,0.000333,0.484968,18,26188.26514,1454.903619,1454.903619,355.831405,11,0
0,0,23,23,19,51,70,137,102,239,0.000333,0.4883,18,26368.17554,1464.898641,1464.898641,370.004315,11,0
0,0,23,23,20,50,70,138,103,241,0.000333,0.492386,20,29543.14414,1641.285786,1477.157207,368.631371,11,0
0,0,21,21,17,34,51,111,83,194,0.000333,0.366817,16,17607.20826,978.178237,1100.450516,242.460605,11,0
0,0,22,22,17,39,56,118,90,208,0.000333,0.402643,16,19326.87718,1073.715399,1207.929824,275.617555,11,0
0,0,24,24,17,44,61,128,98,226,0.000333,0.446782,16,21445.54621,1191.419234,1340.346638,309.70186,12,0
0,0,24,24,17,43,60,128,98,226,0.000333,0.444986,16,21359.31639,1186.628689,1334.957275,302.816253,12,0
0,0,24,24,18,37,55,114,94,208,0.000333,0.400841,18,21645.41077,1202.52282,1202.52282,267.808425,12,0
0,0,38,38,20,56,76,220,168,388,0.000333,0.808065,30,72725.87626,4040.326459,2424.195875,411.650438,19,0
0,0,26,26,18,40,58,123,100,223,0.000333,0.435443,18,23513.93571,1306.329762,1306.329762,287.935774,12,0
0,0,29,29,19,37,56,143,112,255,0.000333,0.493625,27,39983.63864,2221.313258,1480.875505,273.460397,15,0
0,0,74,74,29,93,122,479,310,789,0.000333,1.822784,42,229670.7739,12759.48744,5468.351759,749.023218,39,0
0,0,88,88,30,83,113,438,317,755,0.000333,1.716412,45,231715.5802,12873.08779,5149.235117,676.334991,38,0
0,0,12,12,18,30,48,94,61,155,0.000333,0.288556,18,15582.04538,865.669188,865.669188,222.265368,6,0
0,0,12,12,17,29,46,93,63,156,0.000333,0.287225,16,13786.81064,765.933925,861.675665,210.368317,6,0
0,0,72,72,28,92,120,471,304,775,0.000333,1.78428,42,224819.2889,12489.96049,5352.840212,734.773638,38,0
0,0,52,52,27,70,97,380,256,636,0.000333,1.399182,39,163704.2381,9094.679897,4197.544568,557.431774,28,0
0,0,33,33,22,47,69,266,176,442,0.000333,0.899989,33,89098.93773,4949.940985,2699.96781,359.173172,19,0
0,0,39,39,22,68,90,308,217,525,0.000333,1.136074,33,112471.3549,6248.408605,3408.222876,512.054969,17,0
0,0,33,33,19,55,74,252,178,430,0.000333,0.890022,27,72091.75358,4005.097421,2670.064947,398.685407,15,0
0,0,26,26,18,43,61,198,135,333,0.000333,0.658312,27,53323.2594,2962.4033,1974.935533,308.388034,13,0
0,0,23,23,18,41,59,179,123,302,0.000333,0.592186,27,47967.07142,2664.837301,1776.558201,294.718282,12,0
0,0,86,86,30,83,113,426,308,734,0.000333,1.66867,45,225270.5111,12515.0284,5006.011358,676.334991,38,0
0,0,85,85,30,80,110,413,298,711,0.000333,1.607182,45,216969.604,12053.86689,4821.546756,652.960965,38,0
0,0,85,85,30,81,111,408,298,706,0.000333,1.598953,45,215858.5921,11992.144,4796.857602,660.734568,37,0
0,0,83,83,30,80,110,397,288,685,0.000333,1.54841,45,209035.4132,11613.07851,4645.231404,652.960965,37,0
0,0,83,83,29,83,112,403,297,700,0.000333,1.588383,42,200136.2347,11118.67971,4765.148445,670.009722,34,0
0,0,29,29,17,38,55,135,110,245,0.000333,0.472144,16,22662.93008,1259.051671,1416.43313,268.908114,14,0
0,0,32,32,19,40,59,155,123,278,0.000333,0.545125,27,44155.11873,2453.062152,1635.374768,293.587747,16,0
0,0,31,31,18,38,56,149,119,268,0.000333,0.51879,27,42022.02022,2334.556679,1556.371119,274.479896,15,0
0,0,81,81,31,84,115,386,284,670,0.000333,1.528826,45,206391.525,11466.19584,4586.478334,690.534749,37,0
0,0,30,30,20,39,59,143,115,258,0.000333,0.505907,20,30354.43814,1686.357674,1517.721907,292.569248,16,0
0,0,79,79,30,83,113,383,279,662,0.000333,1.504986,45,203173.1313,11287.39618,4514.958473,676.334991,35,0
0,0,77,77,30,80,110,368,270,638,0.000333,1.442169,45,194692.8374,10816.26874,4326.507497,652.960965,34,0
0,0,84,84,33,86,119,434,302,736,0.000333,1.691529,48,243580.1219,13532.229,5074.585874,719.123775,41,0
0,0,81,81,30,85,115,396,287,683,0.000333,1.55849,45,210396.1367,11688.67426,4675.469705,692.004947,37,0
0,0,30,30,20,39,59,149,116,265,0.000333,0.519633,20,31178.00816,1732.111565,1558.900408,292.569248,16,0
0,0,16,16,17,30,47,88,63,151,0.000333,0.279581,16,13419.88667,745.549259,838.742917,216.693586,9,0
0,0,17,17,17,31,48,92,66,158,0.000333,0.294141,16,14118.7852,784.376956,882.424075,223.066954,9,0
0,0,18,18,17,31,48,93,72,165,0.000333,0.307173,16,14744.301,819.127833,921.518813,223.066954,10,0
0,0,19,19,18,33,51,99,76,175,0.000333,0.330891,18,17868.13983,992.674435,992.674435,241.523656,11,0
0,0,22,22,21,36,57,118,92,210,0.000333,0.408302,20,24498.13806,1361.00767,1224.906903,278.355966,13,0
0,0,20,20,17,33,50,108,79,187,0.000333,0.3518,16,16886.41772,938.134318,1055.401107,235.951874,11,0
0,0,21,21,17,38,55,115,86,201,0.000333,0.387351,16,18592.85284,1032.936269,1162.053302,268.908114,11,0
0,0,23,23,17,37,54,121,90,211,0.000333,0.40476,16,19428.50021,1079.361123,1214.281263,262.236643,13,0
0,0,23,23,19,49,68,137,102,239,0.000333,0.484968,18,26188.26514,1454.903619,1454.903619,355.831405,11,0
0,0,23,23,19,51,70,137,102,239,0.000333,0.4883,18,26368.17554,1464.898641,1464.898641,370.004315,11,0
0,0,23,23,20,50,70,138,103,241,0.000333,0.492386,20,29543.14414,1641.285786,1477.157207,368.631371,11,0
0,0,21,21,17,34,51,111,83,194,0.000333,0.366817,16,17607.20826,978.178237,1100.450516,242.460605,11,0
0,0,22,22,17,39,56,118,90,208,0.000333,0.402643,16,19326.87718,1073.715399,1207.929824,275.617555,11,0
0,0,24,24,17,44,61,128,98,226,0.000333,0.446782,16,21445.54621,1191.419234,1340.346638,309.70186,12,0
0,0,24,24,17,43,60,128,98,226,0.000333,0.444986,16,21359.31639,1186.628689,1334.957275,302.816253,12,0
0,0,24,24,18,37,55,114,94,208,0.000333,0.400841,18,21645.41077,1202.52282,1202.52282,267.808425,12,0
0,0,38,38,20,56,76,220,168,388,0.000333,0.808065,30,72725.87626,4040.326459,2424.195875,411.650438,19,0
0,0,26,26,18,40,58,123,100,223,0.000333,0.435443,18,23513.93571,1306.329762,1306.329762,287.935774,12,0
0,0,29,29,19,37,56,143,112,255,0.000333,0.493625,27,39983.63864,2221.313258,1480.875505,273.460397,15,0
0,0,74,74,29,93,122,479,310,789,0.000333,1.822784,42,229670.7739,12759.48744,5468.351759,749.023218,39,0
0,0,88,88,30,83,113,438,317,755,0.000333,1.716412,45,231715.5802,12873.08779,5149.235117,676.334991,38,0
0,0,12,12,18,30,48,94,61,155,0.000333,0.288556,18,15582.04538,865.669188,865.669188,222.265368,6,0
0,0,12,12,17,29,46,93,63,156,0.000333,0.287225,16,13786.81064,765.933925,861.675665,210.368317,6,0
0,0,14,14,17,31,48,110,75,185,0.000333,0.344406,16,16531.489,918.416056,1033.218063,223.066954,7,0
0,0,72,72,28,92,120,471,304,775,0.000333,1.78428,42,224819.2889,12489.96049,5352.840212,734.773638,38,0
0,0,52,52,27,70,97,380,256,636,0.000333,1.399182,39,163704.2381,9094.679897,4197.544568,557.431774,28,0
0,0,33,33,22,47,69,266,176,442,0.000333,0.899989,33,89098.93773,4949.940985,2699.96781,359.173172,19,0
0,0,39,39,22,68,90,308,217,525,0.000333,1.136074,33,112471.3549,6248.408605,3408.222876,512.054969,17,0
0,0,33,33,19,55,74,252,178,430,0.000333,0.890022,27,72091.75358,4005.097421,2670.064947,398.685407,15,0
0,0,26,26,18,43,61,198,135,333,0.000333,0.658312,27,53323.2594,2962.4033,1974.935533,308.388034,13,0
0,0,86,86,30,83,113,426,308,734,0.000333,1.66867,45,225270.5111,12515.0284,5006.011358,676.334991,38,0
0,0,85,85,30,80,110,413,298,711,0.000333,1.607182,45,216969.604,12053.86689,4821.546756,652.960965,38,0
0,0,85,85,30,81,111,408,298,706,0.000333,1.598953,45,215858.5921,11992.144,4796.857602,660.734568,37,0
0,0,83,83,30,80,110,397,288,685,0.000333,1.54841,45,209035.4132,11613.07851,4645.231404,652.960965,37,0
0,0,83,83,29,83,112,403,297,700,0.000333,1.588383,42,200136.2347,11118.67971,4765.148445,670.009722,34,0
0,0,29,29,17,38,55,135,110,245,0.000333,0.472144,16,22662.93008,1259.051671,1416.43313,268.908114,14,0
0,0,32,32,19,40,59,155,123,278,0.000333,0.545125,27,44155.11873,2453.062152,1635.374768,293.587747,16,0
0,0,31,31,18,38,56,149,119,268,0.000333,0.51879,27,42022.02022,2334.556679,1556.371119,274.479896,15,0
0,0,81,81,31,84,115,386,284,670,0.000333,1.528826,45,206391.525,11466.19584,4586.478334,690.534749,37,0
0,0,30,30,20,39,59,143,115,258,0.000333,0.505907,20,30354.43814,1686.357674,1517.721907,292.569248,16,0
0,0,79,79,30,83,113,383,279,662,0.000333,1.504986,45,203173.1313,11287.39618,4514.958473,676.334991,35,0
0,0,77,77,30,80,110,368,270,638,0.000333,1.442169,45,194692.8374,10816.26874,4326.507497,652.960965,34,0
0,0,84,84,33,86,119,434,302,736,0.000333,1.691529,48,243580.1219,13532.229,5074.585874,719.123775,41,0
0,0,81,81,30,85,115,396,287,683,0.000333,1.55849,45,210396.1367,11688.67426,4675.469705,692.004947,37,0
0,0,30,30,20,39,59,149,116,265,0.000333,0.519633,20,31178.00816,1732.111565,1558.900408,292.569248,16,0
0,0,16,16,17,30,47,88,63,151,0.000333,0.279581,16,13419.88667,745.549259,838.742917,216.693586,9,0
0,0,17,17,17,31,48,92,66,158,0.000333,0.294141,16,14118.7852,784.376956,882.424075,223.066954,9,0
0,0,18,18,17,31,48,93,72,165,0.000333,0.307173,16,14744.301,819.127833,921.518813,223.066954,10,0
0,0,19,19,18,33,51,99,76,175,0.000333,0.330891,18,17868.13983,992.674435,992.674435,241.523656,11,0
0,0,22,22,21,36,57,118,92,210,0.000333,0.408302,20,24498.13806,1361.00767,1224.906903,278.355966,13,0
0,0,20,20,17,33,50,108,79,187,0.000333,0.3518,16,16886.41772,938.134318,1055.401107,235.951874,11,0
0,0,21,21,17,38,55,115,86,201,0.000333,0.387351,16,18592.85284,1032.936269,1162.053302,268.908114,11,0
0,0,23,23,17,37,54,121,90,211,0.000333,0.40476,16,19428.50021,1079.361123,1214.281263,262.236643,13,0
0,0,23,23,19,49,68,137,102,239,0.000333,0.484968,18,26188.26514,1454.903619,1454.903619,355.831405,11,0
0,0,23,23,19,51,70,137,102,239,0.000333,0.4883,18,26368.17554,1464.898641,1464.898641,370.004315,11,0
0,0,23,23,20,50,70,138,103,241,0.000333,0.492386,20,29543.14414,1641.285786,1477.157207,368.631371,11,0
0,0,21,21,17,34,51,111,83,194,0.000333,0.366817,16,17607.20826,978.178237,1100.450516,242.460605,11,0
0,0,22,22,17,39,56,118,90,208,0.000333,0.402643,16,19326.87718,1073.715399,1207.929824,275.617555,11,0
0,0,24,24,17,44,61,128,98,226,0.000333,0.446782,16,21445.54621,1191.419234,1340.346638,309.70186,12,0
0,0,24,24,17,43,60,128,98,226,0.000333,0.444986,16,21359.31639,1186.628689,1334.957275,302.816253,12,0
0,0,24,24,18,37,55,114,94,208,0.000333,0.400841,18,21645.41077,1202.52282,1202.52282,267.808425,12,0
0,0,38,38,20,56,76,220,168,388,0.000333,0.808065,30,72725.87626,4040.326459,2424.195875,411.650438,19,0
0,0,26,26,18,40,58,123,100,223,0.000333,0.435443,18,23513.93571,1306.329762,1306.329762,287.935774,12,0
0,0,29,29,19,37,56,143,112,255,0.000333,0.493625,27,39983.63864,2221.313258,1480.875505,273.460397,15,0
0,0,74,74,29,93,122,479,310,789,0.000333,1.822784,42,229670.7739,12759.48744,5468.351759,749.023218,39,0
0,0,88,88,30,83,113,438,317,755,0.000333,1.716412,45,231715.5802,12873.08779,5149.235117,676.334991,38,0
0,0,12,12,18,30,48,94,61,155,0.000333,0.288556,18,15582.04538,865.669188,865.669188,222.265368,6,0
0,0,12,12,17,29,46,93,63,156,0.000333,0.287225,16,13786.81064,765.933925,861.675665,210.368317,6,0
0,0,14,14,17,31,48,110,75,185,0.000333,0.344406,16,16531.489,918.416056,1033.218063,223.066954,7,0
0,0,72,72,28,92,120,471,304,775,0.000333,1.78428,42,224819.2889,12489.96049,5352.840212,734.773638,38,0
0,0,52,52,27,70,97,380,256,636,0.000333,1.399182,39,163704.2381,9094.679897,4197.544568,557.431774,28,0
0,0,33,33,22,47,69,266,176,442,0.000333,0.899989,33,89098.93773,4949.940985,2699.96781,359.173172,19,0
0,0,39,39,22,68,90,308,217,525,0.000333,1.136074,33,112471.3549,6248.408605,3408.222876,512.054969,17,0
0,0,33,33,19,55,74,252,178,430,0.000333,0.890022,27,72091.75358,4005.097421,2670.064947,398.685407,15,0
0,0,23,23,18,41,59,179,123,302,0.000333,0.592186,27,47967.07142,2664.837301,1776.558201,294.718282,12,0
0,0,86,86,30,83,113,426,308,734,0.000333,1.66867,45,225270.5111,12515.0284,5006.011358,676.334991,38,0
0,0,85,85,30,80,110,413,298,711,0.000333,1.607182,45,216969.604,12053.86689,4821.546756,652.960965,38,0
0,0,85,85,30,81,111,408,298,706,0.000333,1.598953,45,215858.5921,11992.144,4796.857602,660.734568,37,0
0,0,83,83,30,80,110,397,288,685,0.000333,1.54841,45,209035.4132,11613.07851,4645.231404,652.960965,37,0
0,0,83,83,29,83,112,403,297,700,0.000333,1.588383,42,200136.2347,11118.67971,4765.148445,670.009722,34,0
0,0,29,29,17,38,55,135,110,245,0.000333,0.472144,16,22662.93008,1259.051671,1416.43313,268.908114,14,0
0,0,32,32,19,40,59,155,123,278,0.000333,0.545125,27,44155.11873,2453.062152,1635.374768,293.587747,16,0
0,0,31,31,18,38,56,149,119,268,0.000333,0.51879,27,42022.02022,2334.556679,1556.371119,274.479896,15,0
0,0,81,81,31,84,115,386,284,670,0.000333,1.528826,45,206391.525,11466.19584,4586.478334,690.534749,37,0
0,0,30,30,20,39,59,143,115,258,0.000333,0.505907,20,30354.43814,1686.357674,1517.721907,292.569248,16,0
0,0,79,79,30,83,113,383,279,662,0.000333,1.504986,45,203173.1313,11287.39618,4514.958473,676.334991,35,0
0,0,77,77,30,80,110,368,270,638,0.000333,1.442169,45,194692.8374,10816.26874,4326.507497,652.960965,34,0
0,0,84,84,33,86,119,434,302,736,0.000333,1.691529,48,243580.1219,13532.229,5074.585874,719.123775,41,0
0,0,81,81,30,85,115,396,287,683,0.000333,1.55849,45,210396.1367,11688.67426,4675.469705,692.004947,37,0
0,0,30,30,20,39,59,149,116,265,0.000333,0.519633,20,31178.00816,1732.111565,1558.900408,292.569248,16,0
0,0,16,16,17,30,47,88,63,151,0.000333,0.279581,16,13419.88667,745.549259,838.742917,216.693586,9,0
0,0,17,17,17,31,48,92,66,158,0.000333,0.294141,16,14118.7852,784.376956,882.424075,223.066954,9,0
0,0,18,18,17,31,48,93,72,165,0.000333,0.307173,16,14744.301,819.127833,921.518813,223.066954,10,0
0,0,19,19,18,33,51,99,76,175,0.000333,0.330891,18,17868.13983,992.674435,992.674435,241.523656,11,0
0,0,22,22,21,36,57,118,92,210,0.000333,0.408302,20,24498.13806,1361.00767,1224.906903,278.355966,13,0
0,0,20,20,17,33,50,108,79,187,0.000333,0.3518,16,16886.41772,938.134318,1055.401107,235.951874,11,0
0,0,21,21,17,38,55,115,86,201,0.000333,0.387351,16,18592.85284,1032.936269,1162.053302,268.908114,11,0
0,0,23,23,17,37,54,121,90,211,0.000333,0.40476,16,19428.50021,1079.361123,1214.281263,262.236643,13,0
0,0,23,23,19,49,68,137,102,239,0.000333,0.484968,18,26188.26514,1454.903619,1454.903619,355.831405,11,0
0,0,23,23,19,51,70,137,102,239,0.000333,0.4883,18,26368.17554,1464.898641,1464.898641,370.004315,11,0
0,0,23,23,20,50,70,138,103,241,0.000333,0.492386,20,29543.14414,1641.285786,1477.157207,368.631371,11,0
0,0,21,21,17,34,51,111,83,194,0.000333,0.366817,16,17607.20826,978.178237,1100.450516,242.460605,11,0
0,0,22,22,17,39,56,118,90,208,0.000333,0.402643,16,19326.87718,1073.715399,1207.929824,275.617555,11,0
0,0,24,24,17,44,61,128,98,226,0.000333,0.446782,16,21445.54621,1191.419234,1340.346638,309.70186,12,0
0,0,24,24,17,43,60,128,98,226,0.000333,0.444986,16,21359.31639,1186.628689,1334.957275,302.816253,12,0
0,0,24,24,18,37,55,114,94,208,0.000333,0.400841,18,21645.41077,1202.52282,1202.52282,267.808425,12,0
0,0,38,38,20,56,76,220,168,388,0.000333,0.808065,30,72725.87626,4040.326459,2424.195875,411.650438,19,0
0,0,26,26,18,40,58,123,100,223,0.000333,0.435443,18,23513.93571,1306.329762,1306.329762,287.935774,12,0
0,0,29,29,19,37,56,143,112,255,0.000333,0.493625,27,39983.63864,2221.313258,1480.875505,273.460397,15,0
0,0,74,74,29,93,122,479,310,789,0.000333,1.822784,42,229670.7739,12759.48744,5468.351759,749.023218,39,0
0,0,88,88,30,83,113,438,317,755,0.000333,1.716412,45,231715.5802,12873.08779,5149.235117,676.334991,38,0
0,0,12,12,18,30,48,94,61,155,0.000333,0.288556,18,15582.04538,865.669188,865.669188,222.265368,6,0
0,0,12,12,17,29,46,93,63,156,0.000333,0.287225,16,13786.81064,765.933925,861.675665,210.368317,6,0
0,0,14,14,17,31,48,110,75,185,0.000333,0.344406,16,16531.489,918.416056,1033.218063,223.066954,7,0
0,0,72,72,28,92,120,471,304,775,0.000333,1.78428,42,224819.2889,12489.96049,5352.840212,734.773638,38,0
0,0,52,52,27,70,97,380,256,636,0.000333,1.399182,39,163704.2381,9094.679897,4197.544568,557.431774,28,0
0,0,33,33,22,47,69,266,176,442,0.000333,0.899989,33,89098.93773,4949.940985,2699.96781,359.173172,19,0
0,0,39,39,22,68,90,308,217,525,0.000333,1.136074,33,112471.3549,6248.408605,3408.222876,512.054969,17,0
0,0,26,26,18,43,61,198,135,333,0.000333,0.658312,27,53323.2594,2962.4033,1974.935533,308.388034,13,0
0,0,23,23,18,41,59,179,123,302,0.000333,0.592186,27,47967.07142,2664.837301,1776.558201,294.718282,12,0
0,0,86,86,30,83,113,426,308,734,0.000333,1.66867,45,225270.5111,12515.0284,5006.011358,676.334991,38,0
0,0,85,85,30,80,110,413,298,711,0.000333,1.607182,45,216969.604,12053.86689,4821.546756,652.960965,38,0
0,0,85,85,30,81,111,408,298,706,0.000333,1.598953,45,215858.5921,11992.144,4796.857602,660.734568,37,0
0,0,83,83,30,80,110,397,288,685,0.000333,1.54841,45,209035.4132,11613.07851,4645.231404,652.960965,37,0
0,0,83,83,29,83,112,403,297,700,0.000333,1.588383,42,200136.2347,11118.67971,4765.148445,670.009722,34,0
0,0,29,29,17,38,55,135,110,245,0.000333,0.472144,16,22662.93008,1259.051671,1416.43313,268.908114,14,0
0,0,32,32,19,40,59,155,123,278,0.000333,0.545125,27,44155.11873,2453.062152,1635.374768,293.587747,16,0
0,0,31,31,18,38,56,149,119,268,0.000333,0.51879,27,42022.02022,2334.556679,1556.371119,274.479896,15,0
0,0,81,81,31,84,115,386,284,670,0.000333,1.528826,45,206391.525,11466.19584,4586.478334,690.534749,37,0
0,0,30,30,20,39,59,143,115,258,0.000333,0.505907,20,30354.43814,1686.357674,1517.721907,292.569248,16,0
0,0,79,79,30,83,113,383,279,662,0.000333,1.504986,45,203173.1313,11287.39618,4514.958473,676.334991,35,0
0,0,77,77,30,80,110,368,270,638,0.000333,1.442169,45,194692.8374,10816.26874,4326.507497,652.960965,34,0
0,0,84,84,33,86,119,434,302,736,0.000333,1.691529,48,243580.1219,13532.229,5074.585874,719.123775,41,0
0,0,81,81,30,85,115,396,287,683,0.000333,1.55849,45,210396.1367,11688.67426,4675.469705,692.004947,37,0
0,0,30,30,20,39,59,149,116,265,0.000333,0.519633,20,31178.00816,1732.111565,1558.900408,292.569248,16,0
0,0,16,16,17,30,47,88,63,151,0.000333,0.279581,16,13419.88667,745.549259,838.742917,216.693586,9,0
0,0,17,17,17,31,48,92,66,158,0.000333,0.294141,16,14118.7852,784.376956,882.424075,223.066954,9,0
0,0,18,18,17,31,48,93,72,165,0.000333,0.307173,16,14744.301,819.127833,921.518813,223.066954,10,0
0,0,19,19,18,33,51,99,76,175,0.000333,0.330891,18,17868.13983,992.674435,992.674435,241.523656,11,0
0,0,22,22,21,36,57,118,92,210,0.000333,0.408302,20,24498.13806,1361.00767,1224.906903,278.355966,13,0
0,0,20,20,17,33,50,108,79,187,0.000333,0.3518,16,16886.41772,938.134318,1055.401107,235.951874,11,0
0,0,21,21,17,38,55,115,86,201,0.000333,0.387351,16,18592.85284,1032.936269,1162.053302,268.908114,11,0
0,0,23,23,17,37,54,121,90,211,0.000333,0.40476,16,19428.50021,1079.361123,1214.281263,262.236643,13,0
0,0,23,23,19,49,68,137,102,239,0.000333,0.484968,18,26188.26514,1454.903619,1454.903619,355.831405,11,0
0,0,23,23,19,51,70,137,102,239,0.000333,0.4883,18,26368.17554,1464.898641,1464.898641,370.004315,11,0
0,0,23,23,20,50,70,138,103,241,0.000333,0.492386,20,29543.14414,1641.285786,1477.157207,368.631371,11,0
0,0,21,21,17,34,51,111,83,194,0.000333,0.366817,16,17607.20826,978.178237,1100.450516,242.460605,11,0
0,0,22,22,17,39,56,118,90,208,0.000333,0.402643,16,19326.87718,1073.715399,1207.929824,275.617555,11,0
0,0,24,24,17,44,61,128,98,226,0.000333,0.446782,16,21445.54621,1191.419234,1340.346638,309.70186,12,0
0,0,24,24,17,43,60,128,98,226,0.000333,0.444986,16,21359.31639,1186.628689,1334.957275,302.816253,12,0
0,0,24,24,18,37,55,114,94,208,0.000333,0.400841,18,21645.41077,1202.52282,1202.52282,267.808425,12,0
0,0,38,38,20,56,76,220,168,388,0.000333,0.808065,30,72725.87626,4040.326459,2424.195875,411.650438,19,0
0,0,26,26,18,40,58,123,100,223,0.000333,0.435443,18,23513.93571,1306.329762,1306.329762,287.935774,12,0
0,0,29,29,19,37,56,143,112,255,0.000333,0.493625,27,39983.63864,2221.313258,1480.875505,273.460397,15,0
0,0,74,74,29,93,122,479,310,789,0.000333,1.822784,42,229670.7739,12759.48744,5468.351759,749.023218,39,0
0,0,88,88,30,83,113,438,317,755,0.000333,1.716412,45,231715.5802,12873.08779,5149.235117,676.334991,38,0
0,0,12,12,18,30,48,94,61,155,0.000333,0.288556,18,15582.04538,865.669188,865.669188,222.265368,6,0
0,0,12,12,17,29,46,93,63,156,0.000333,0.287225,16,13786.81064,765.933925,861.675665,210.368317,6,0
0,0,14,14,17,31,48,110,75,185,0.000333,0.344406,16,16531.489,918.416056,1033.218063,223.066954,7,0
0,0,72,72,28,92,120,471,304,775,0.000333,1.78428,42,224819.2889,12489.96049,5352.840212,734.773638,38,0
0,0,52,52,27,70,97,380,256,636,0.000333,1.399182,39,163704.2381,9094.679897,4197.544568,557.431774,28,0
0,0,33,33,22,47,69,266,176,442,0.000333,0.899989,33,89098.93773,4949.940985,2699.96781,359.173172,19,0
0,0,33,33,19,55,74,252,178,430,0.000333,0.890022,27,72091.75358,4005.097421,2670.064947,398.685407,15,0
0,0,26,26,18,43,61,198,135,333,0.000333,0.658312,27,53323.2594,2962.4033,1974.935533,308.388034,13,0
0,0,23,23,18,41,59,179,123,302,0.000333,0.592186,27,47967.07142,2664.837301,1776.558201,294.718282,12,0
0,0,86,86,30,83,113,426,308,734,0.000333,1.66867,45,225270.5111,12515.0284,5006.011358,676.334991,38,0
0,0,85,85,30,80,110,413,298,711,0.000333,1.607182,45,216969.604,12053.86689,4821.546756,652.960965,38,0
0,0,85,85,30,81,111,408,298,706,0.000333,1.598953,45,215858.5921,11992.144,4796.857602,660.734568,37,0
0,0,83,83,30,80,110,397,288,685,0.000333,1.54841,45,209035.4132,11613.07851,4645.231404,652.960965,37,0
0,0,83,83,29,83,112,403,297,700,0.000333,1.588383,42,200136.2347,11118.67971,4765.148445,670.009722,34,0
0,0,29,29,17,38,55,135,110,245,0.000333,0.472144,16,22662.93008,1259.051671,1416.43313,268.908114,14,0
0,0,32,32,19,40,59,155,123,278,0.000333,0.545125,27,44155.11873,2453.062152,1635.374768,293.587747,16,0
0,0,31,31,18,38,56,149,119,268,0.000333,0.51879,27,42022.02022,2334.556679,1556.371119,274.479896,15,0
0,0,81,81,31,84,115,386,284,670,0.000333,1.528826,45,206391.525,11466.19584,4586.478334,690.534749,37,0
0,0,30,30,20,39,59,143,115,258,0.000333,0.505907,20,30354.43814,1686.357674,1517.721907,292.569248,16,0
0,0,79,79,30,83,113,383,279,662,0.000333,1.504986,45,203173.1313,11287.39618,4514.958473,676.334991,35,0
0,0,77,77,30,80,110,368,270,638,0.000333,1.442169,45,194692.8374,10816.26874,4326.507497,652.960965,34,0
0,0,84,84,33,86,119,434,302,736,0.000333,1.691529,48,243580.1219,13532.229,5074.585874,719.123775,41,0
0,0,81,81,30,85,115,396,287,683,0.000333,1.55849,45,210396.1367,11688.67426,4675.469705,692.004947,37,0
0,0,30,30,20,39,59,149,116,265,0.000333,0.519633,20,31178.00816,1732.111565,1558.900408,292.569248,16,0
0,0,16,16,17,30,47,88,63,151,0.000333,0.279581,16,13419.88667,745.549259,838.742917,216.693586,9,0
0,0,17,17,17,31,48,92,66,158,0.000333,0.294141,16,14118.7852,784.376956,882.424075,223.066954,9,0
0,0,18,18,17,31,48,93,72,165,0.000333,0.307173,16,14744.301,819.127833,921.518813,223.066954,10,0
0,0,19,19,18,33,51,99,76,175,0.000333,0.330891,18,17868.13983,992.674435,992.674435,241.523656,11,0
0,0,22,22,21,36,57,118,92,210,0.000333,0.408302,20,24498.13806,1361.00767,1224.906903,278.355966,13,0
0,0,20,20,17,33,50,108,79,187,0.000333,0.3518,16,16886.41772,938.134318,1055.401107,235.951874,11,0
0,0,21,21,17,38,55,115,86,201,0.000333,0.387351,16,18592.85284,1032.936269,1162.053302,268.908114,11,0
0,0,23,23,17,37,54,121,90,211,0.000333,0.40476,16,19428.50021,1079.361123,1214.281263,262.236643,13,0
0,0,23,23,19,49,68,137,102,239,0.000333,0.484968,18,26188.26514,1454.903619,1454.903619,355.831405,11,0
0,0,23,23,19,51,70,137,102,239,0.000333,0.4883,18,26368.17554,1464.898641,1464.898641,370.004315,11,0
0,0,23,23,20,50,70,138,103,241,0.000333,0.492386,20,29543.14414,1641.285786,1477.157207,368.631371,11,0
0,0,21,21,17,34,51,111,83,194,0.000333,0.366817,16,17607.20826,978.178237,1100.450516,242.460605,11,0
0,0,22,22,17,39,56,118,90,208,0.000333,0.402643,16,19326.87718,1073.715399,1207.929824,275.617555,11,0
0,0,24,24,17,44,61,128,98,226,0.000333,0.446782,16,21445.54621,1191.419234,1340.346638,309.70186,12,0
0,0,24,24,17,43,60,128,98,226,0.000333,0.444986,16,21359.31639,1186.628689,1334.957275,302.816253,12,0
0,0,24,24,18,37,55,114,94,208,0.000333,0.400841,18,21645.41077,1202.52282,1202.52282,267.808425,12,0
0,0,38,38,20,56,76,220,168,388,0.000333,0.808065,30,72725.87626,4040.326459,2424.195875,411.650438,19,0
0,0,26,26,18,40,58,123,100,223,0.000333,0.435443,18,23513.93571,1306.329762,1306.329762,287.935774,12,0
0,0,29,29,19,37,56,143,112,255,0.000333,0.493625,27,39983.63864,2221.313258,1480.875505,273.460397,15,0
0,0,74,74,29,93,122,479,310,789,0.000333,1.822784,42,229670.7739,12759.48744,5468.351759,749.023218,39,0
0,0,88,88,30,83,113,438,317,755,0.000333,1.716412,45,231715.5802,12873.08779,5149.235117,676.334991,38,0
0,0,12,12,18,30,48,94,61,155,0.000333,0.288556,18,15582.04538,865.669188,865.669188,222.265368,6,0
0,0,12,12,17,29,46,93,63,156,0.000333,0.287225,16,13786.81064,765.933925,861.675665,210.368317,6,0
0,0,14,14,17,31,48,110,75,185,0.000333,0.344406,16,16531.489,918.416056,1033.218063,223.066954,7,0
0,0,72,72,28,92,120,471,304,775,0.000333,1.78428,42,224819.2889,12489.96049,5352.840212,734.773638,38,0
0,0,52,52,27,70,97,380,256,636,0.000333,1.399182,39,163704.2381,9094.679897,4197.544568,557.431774,28,0
0,0,39,39,22,68,90,308,217,525,0.000333,1.136074,33,112471.3549,6248.408605,3408.222876,512.054969,17,0
0,0,33,33,19,55,74,252,178,430,0.000333,0.890022,27,72091.75358,4005.097421,2670.064947,398.685407,15,0
0,0,26,26,18,43,61,198,135,333,0.000333,0.658312,27,53323.2594,2962.4033,1974.935533,308.388034,13,0
0,0,23,23,18,41,59,179,123,302,0.000333,0.592186,27,47967.07142,2664.837301,1776.558201,294.718282,12,0
0,0,101,101,33,96,129,520,380,900,0.000333,2.103368,48,302885.0174,16826.94541,6310.10453,798.621406,54,0
0,0,22,22,19,39,58,142,111,253,0.000333,0.494023,18,26677.24545,1482.069192,1482.069192,286.841309,15,0
0,0,18,18,16,33,49,106,85,191,0.000333,0.35747,16,17158.55328,953.25296,1072.40958,230.465006,8,0
0,0,22,22,19,39,58,142,111,253,0.000333,0.494023,18,26677.24545,1482.069192,1482.069192,286.841309,15,0
0,0,18,18,19,37,56,108,86,194,0.000333,0.375542,18,20279.28339,1126.626855,1126.626855,273.460397,11,0
0,0,14,14,15,30,45,76,64,140,0.000333,0.256286,14,10764.03207,598.001782,768.859433,205.810077,6,0
0,0,21,21,18,40,58,142,109,251,0.000333,0.490118,18,26466.35814,1470.35323,1470.35323,287.935774,15,0
0,0,86,86,30,83,113,426,308,734,0.000333,1.66867,45,225270.5111,12515.0284,5006.011358,676.334991,38,0
0,0,85,85,30,80,110,413,298,711,0.000333,1.607182,45,216969.604,12053.86689,4821.546756,652.960965,38,0
0,0,85,85,30,81,111,408,298,706,0.000333,1.598953,45,215858.5921,11992.144,4796.857602,660.734568,37,0
0,0,83,83,30,80,110,397,288,685,0.000333,1.54841,45,209035.4132,11613.07851,4645.231404,652.960965,37,0
0,0,83,83,29,83,112,403,297,700,0.000333,1.588383,42,200136.2347,11118.67971,4765.148445,670.009722,34,0
0,0,29,29,17,38,55,135,110,245,0.000333,0.472144,16,22662.93008,1259.051671,1416.43313,268.908114,14,0
0,0,32,32,19,40,59,155,123,278,0.000333,0.545125,27,44155.11873,2453.062152,1635.374768,293.587747,16,0
0,0,31,31,18,38,56,149,119,268,0.000333,0.51879,27,42022.02022,2334.556679,1556.371119,274.479896,15,0
0,0,81,81,31,84,115,386,284,670,0.000333,1.528826,45,206391.525,11466.19584,4586.478334,690.534749,37,0
0,0,30,30,20,39,59,143,115,258,0.000333,0.505907,20,30354.43814,1686.357674,1517.721907,292.569248,16,0
0,0,79,79,30,83,113,383,279,662,0.000333,1.504986,45,203173.1313,11287.39618,4514.958473,676.334991,35,0
0,0,77,77,30,80,110,368,270,638,0.000333,1.442169,45,194692.8374,10816.26874,4326.507497,652.960965,34,0
0,0,84,84,33,86,119,434,302,736,0.000333,1.691529,48,243580.1219,13532.229,5074.585874,719.123775,41,0
0,0,81,81,30,85,115,396,287,683,0.000333,1.55849,45,210396.1367,11688.67426,4675.469705,692.004947,37,0
0,0,30,30,20,39,59,149,116,265,0.000333,0.519633,20,31178.00816,1732.111565,1558.900408,292.569248,16,0
0,0,16,16,17,30,47,88,63,151,0.000333,0.279581,16,13419.88667,745.549259,838.742917,216.693586,9,0
0,0,17,17,17,31,48,92,66,158,0.000333,0.294141,16,14118.7852,784.376956,882.424075,223.066954,9,0
0,0,18,18,17,31,48,93,72,165,0.000333,0.307173,16,14744.301,819.127833,921.518813,223.066954,10,0
0,0,19,19,18,33,51,99,76,175,0.000333,0.330891,18,17868.13983,992.674435,992.674435,241.523656,11,0
0,0,22,22,21,36,57,118,92,210,0.000333,0.408302,20,24498.13806,1361.00767,1224.906903,278.355966,13,0
0,0,20,20,17,33,50,108,79,187,0.000333,0.3518,16,16886.41772,938.134318,1055.401107,235.951874,11,0
0,0,21,21,17,38,55,115,86,201,0.000333,0.387351,16,18592.85284,1032.936269,1162.053302,268.908114,11,0
0,0,23,23,17,37,54,121,90,211,0.000333,0.40476,16,19428.50021,1079.361123,1214.281263,262.236643,13,0
0,0,23,23,19,49,68,137,102,239,0.000333,0.484968,18,26188.26514,1454.903619,1454.903619,355.831405,11,0
0,0,23,23,19,51,70,137,102,239,0.000333,0.4883,18,26368.17554,1464.898641,1464.898641,370.004315,11,0
0,0,23,23,20,50,70,138,103,241,0.000333,0.492386,20,29543.14414,1641.285786,1477.157207,368.631371,11,0
0,0,21,21,17,34,51,111,83,194,0.000333,0.366817,16,17607.20826,978.178237,1100.450516,242.460605,11,0
0,0,22,22,17,39,56,118,90,208,0.000333,0.402643,16,19326.87718,1073.715399,1207.929824,275.617555,11,0
0,0,24,24,17,44,61,128,98,226,0.000333,0.446782,16,21445.54621,1191.419234,1340.346638,309.70186,12,0
0,0,24,24,17,43,60,128,98,226,0.000333,0.444986,16,21359.31639,1186.628689,1334.957275,302.816253,12,0
0,0,24,24,18,37,55,114,94,208,0.000333,0.400841,18,21645.41077,1202.52282,1202.52282,267.808425,12,0
0,0,38,38,20,56,76,220,168,388,0.000333,0.808065,30,72725.87626,4040.326459,2424.195875,411.650438,19,0
0,0,26,26,18,40,58,123,100,223,0.000333,0.435443,18,23513.93571,1306.329762,1306.329762,287.935774,12,0
0,0,29,29,19,37,56,143,112,255,0.000333,0.493625,27,39983.63864,2221.313258,1480.875505,273.460397,15,0
0,0,74,74,29,93,122,479,310,789,0.000333,1.822784,42,229670.7739,12759.48744,5468.351759,749.023218,39,0
0,0,88,88,30,83,113,438,317,755,0.000333,1.716412,45,231715.5802,12873.08779,5149.235117,676.334991,38,0
0,0,12,12,18,30,48,94,61,155,0.000333,0.288556,18,15582.04538,865.669188,865.669188,222.265368,6,0
0,0,12,12,17,29,46,93,63,156,0.000333,0.287225,16,13786.81064,765.933925,861.675665,210.368317,6,0
0,0,14,14,17,31,48,110,75,185,0.000333,0.344406,16,16531.489,918.416056,1033.218063,223.066954,7,0
0,0,72,72,28,92,120,471,304,775,0.000333,1.78428,42,224819.2889,12489.96049,5352.840212,734.773638,38,0
0,0,33,33,22,47,69,266,176,442,0.000333,0.899989,33,89098.93773,4949.940985,2699.96781,359.173172,19,0
0,0,39,39,22,68,90,308,217,525,0.000333,1.136074,33,112471.3549,6248.408605,3408.222876,512.054969,17,0
0,0,33,33,19,55,74,252,178,430,0.000333,0.890022,27,72091.75358,4005.097421,2670.064947,398.685407,15,0
0,0,26,26,18,43,61,198,135,333,0.000333,0.658312,27,53323.2594,2962.4033,1974.935533,308.388034,13,0
0,0,23,23,18,41,59,179,123,302,0.000333,0.592186,27,47967.07142,2664.837301,1776.558201,294.718282,12,0
0,0,14,14,20,33,53,87,63,150,0.000333,0.286396,10,8591.880682,477.326705,859.188068,252.903568,7,0
0,0,85,85,33,99,132,461,324,785,0.000333,1.843283,48,265432.7704,14746.26502,5529.849384,822.771311,37,0
0,0,15,15,20,34,54,90,66,156,0.000333,0.299254,10,8977.624503,498.756917,897.76245,259.412299,7,0
0,0,13,13,17,31,48,74,55,129,0.000333,0.240153,8,5763.681301,320.204517,720.460163,223.066954,7,0
0,0,14,14,15,30,45,72,58,130,0.000333,0.23798,7,4997.586318,277.643684,713.940903,205.810077,7,0
0,0,16,16,23,40,63,138,92,230,0.000333,0.458258,22,30245.03641,1680.279801,1374.774382,316.919049,11,0
0,0,6,6,13,19,32,31,26,57,0.000333,0.095,6,1710,95,285,128.816339,4,0
0,0,5,5,12,18,30,25,24,49,0.000333,0.080146,6,1442.625835,80.14588,240.437639,118.0782,3,0
0,0,14,14,13,29,42,84,68,152,0.000333,0.273211,12,9835.586979,546.421499,819.632248,188.987165,3,0
0,0,14,14,13,29,42,84,68,152,0.000333,0.273211,12,9835.586979,546.421499,819.632248,188.987165,3,0
0,0,14,14,13,29,42,84,68,152,0.000333,0.273211,12,9835.586979,546.421499,819.632248,188.987165,3,0
0,0,14,14,13,29,42,84,68,152,0.000333,0.273211,12,9835.586979,546.421499,819.632248,188.987165,3,0
0,0,14,14,13,29,42,84,68,152,0.000333,0.273211,12,9835.586979,546.421499,819.632248,188.987165,3,0
0,0,14,14,13,29,42,84,68,152,0.000333,0.273211,12,9835.586979,546.421499,819.632248,188.987165,3,0
0,0,14,14,13,29,42,84,68,152,0.000333,0.273211,12,9835.586979,546.421499,819.632248,188.987165,3,0
0,0,14,14,13,29,42,84,68,152,0.000333,0.273211,12,9835.586979,546.421499,819.632248,188.987165,3,0
0,0,14,14,13,29,42,84,68,152,0.000333,0.273211,12,9835.586979,546.421499,819.632248,188.987165,3,0
0,0,5,5,10,10,20,18,19,37,0.000333,0.053304,5,799.556698,44.419817,159.91134,66.438562,3,0
0,0,14,14,17,29,46,70,60,130,0.000333,0.239354,16,11489.00887,638.27827,718.063054,210.368317,8,0
0,0,14,14,17,29,46,70,60,130,0.000333,0.239354,16,11489.00887,638.27827,718.063054,210.368317,8,0
0,0,15,15,20,35,55,89,78,167,0.000333,0.321829,20,19309.74144,1072.763414,965.487072,265.963467,8,0
0,0,19,19,22,37,59,117,110,227,0.000333,0.44512,22,29377.91939,1632.106633,1335.359972,290.85727,24,0
0,0,19,19,22,38,60,117,110,227,0.000333,0.446955,22,29499.01163,1638.83398,1340.864165,297.528741,24,0
0,0,15,15,20,35,55,89,78,167,0.000333,0.321829,20,19309.74144,1072.763414,965.487072,265.963467,8,0
0,0,19,19,22,37,59,117,110,227,0.000333,0.44512,22,29377.91939,1632.106633,1335.359972,290.85727,24,0
0,0,19,19,22,37,59,116,109,225,0.000333,0.441198,22,29119.08309,1617.726839,1323.594686,290.85727,24,0
0,0,13,13,15,26,41,61,55,116,0.000333,0.207159,14,8700.664455,483.370248,621.476033,180.814792,7,0
0,0,14,14,15,28,43,65,58,123,0.000333,0.222477,14,9344.027908,519.112662,667.430565,193.209297,7,0
0,0,13,13,15,26,41,61,55,116,0.000333,0.207159,14,8700.664455,483.370248,621.476033,180.814792,7,0
0,0,13,13,15,25,40,61,55,116,0.000333,0.205781,14,8642.811226,480.156179,617.343659,174.699764,7,0
0,0,12,12,15,25,40,58,53,111,0.000333,0.196911,14,8270.276259,459.459792,590.734019,174.699764,6,0
0,0,13,13,15,27,42,62,56,118,0.000333,0.212098,14,8908.108382,494.89491,636.293456,186.985321,6,0
0,0,12,12,15,25,40,58,53,111,0.000333,0.196911,14,8270.276259,459.459792,590.734019,174.699764,6,0
0,0,12,12,15,24,39,58,53,111,0.000333,0.19556,14,8213.515048,456.306392,586.679646,168.642459,6,0
0,0,9,9,15,18,33,45,41,86,0.000333,0.144606,14,6073.45052,337.413918,433.817894,133.662009,5,0
0,0,34,34,23,58,81,160,118,278,0.000333,0.587493,22,38774.52262,2154.140145,1762.478301,443.804823,17,0
0,0,34,34,23,58,81,160,118,278,0.000333,0.587493,22,38774.52262,2154.140145,1762.478301,443.804823,17,0
0,0,15,15,17,33,50,110,84,194,0.000333,0.364969,16,17518.52961,973.251645,1094.908101,235.951874,8,0
0,0,15,15,17,33,50,110,84,194,0.000333,0.364969,16,17518.52961,973.251645,1094.908101,235.951874,8,0
0,0,10,10,16,30,46,67,54,121,0.000333,0.222784,8,5346.807973,297.044887,668.350997,211.206718,5,0
0,0,12,12,16,33,49,87,65,152,0.000333,0.284479,8,6827.48717,379.304843,853.435896,230.465006,5,0
0,0,5,5,12,22,34,27,26,53,0.000333,0.089879,6,1617.813184,89.87851,269.635531,141.127046,3,0
0,0,9,9,14,30,44,67,48,115,0.000333,0.209278,7,4394.842453,244.157914,627.834636,200.509687,3,0
0,0,7,7,13,25,38,51,38,89,0.000333,0.155689,6,2802.393292,155.688516,467.065549,164.202121,3,0
0,0,9,9,14,30,44,67,48,115,0.000333,0.209278,7,4394.842453,244.157914,627.834636,200.509687,3,0
0,0,15,15,17,33,50,110,84,194,0.000333,0.364969,16,17518.52961,973.251645,1094.908101,235.951874,8,0
0,0,15,15,17,33,50,110,84,194,0.000333,0.364969,16,17518.52961,973.251645,1094.908101,235.951874,8,0
0,0,10,10,16,30,46,67,54,121,0.000333,0.222784,8,5346.807973,297.044887,668.350997,211.206718,5,0
0,0,12,12,16,33,49,87,65,152,0.000333,0.284479,8,6827.48717,379.304843,853.435896,230.465006,5,0
0,0,5,5,12,22,34,27,26,53,0.000333,0.089879,6,1617.813184,89.87851,269.635531,141.127046,3,0
0,0,9,9,14,30,44,67,48,115,0.000333,0.209278,7,4394.842453,244.157914,627.834636,200.509687,3,0
0,0,5,5,14,23,37,34,29,63,0.000333,0.109399,7,2297.368934,127.631607,328.195562,157.344894,4,0
0,0,9,9,14,30,44,67,48,115,0.000333,0.209278,7,4394.842453,244.157914,627.834636,200.509687,3,0
0,0,15,15,17,33,50,110,84,194,0.000333,0.364969,16,17518.52961,973.251645,1094.908101,235.951874,8,0
0,0,15,15,17,33,50,110,84,194,0.000333,0.364969,16,17518.52961,973.251645,1094.908101,235.951874,8,0
0,0,10,10,16,30,46,67,54,121,0.000333,0.222784,8,5346.807973,297.044887,668.350997,211.206718,5,0
0,0,12,12,16,33,49,87,65,152,0.000333,0.284479,8,6827.48717,379.304843,853.435896,230.465006,5,0
0,0,5,5,12,22,34,27,26,53,0.000333,0.089879,6,1617.813184,89.87851,269.635531,141.127046,3,0
0,0,9,9,14,30,44,67,48,115,0.000333,0.209278,7,4394.842453,244.157914,627.834636,200.509687,3,0
0,0,5,5,14,23,37,34,29,63,0.000333,0.109399,7,2297.368934,127.631607,328.195562,157.344894,4,0
0,0,7,7,13,25,38,51,38,89,0.000333,0.155689,6,2802.393292,155.688516,467.065549,164.202121,3,0
0,0,8,8,19,27,46,49,40,89,0.000333,0.163866,9,4424.373127,245.798507,491.597014,209.092585,4,0
0,0,8,8,17,27,44,47,40,87,0.000333,0.158324,8,3799.764407,211.098023,474.970551,197.868831,4,0
0,0,35,35,26,69,95,162,134,296,0.000333,0.648226,13,25280.80438,1404.489132,1944.67726,543.69962,23,0
0,0,12,12,16,26,42,65,50,115,0.000333,0.206706,8,4960.932029,275.607335,620.116504,186.211433,7,0
0,0,13,13,15,26,41,67,53,120,0.000333,0.214302,14,9000.687368,500.038187,642.906241,180.814792,7,0
0,0,12,12,16,28,44,65,57,122,0.000333,0.222017,16,10656.81052,592.045029,666.050657,198.605938,3,0
0,0,19,19,17,24,41,77,61,138,0.000333,0.246447,16,11829.47483,657.193046,739.342177,179.525968,7,0
0,0,3,3,11,13,24,17,17,34,0.000333,0.051963,5,779.443625,43.302424,155.888725,86.159464,2,0
0,0,10,10,14,21,35,48,32,80,0.000333,0.136781,7,2872.398489,159.577694,410.342641,145.541635,5,0
0,0,15,15,18,28,46,80,59,139,0.000333,0.255925,18,13819.95201,767.775112,767.775112,209.664588,5,0
0,0,11,11,15,21,36,52,37,89,0.000333,0.153374,7,3220.863276,178.936849,460.123325,150.842025,5,0
0,0,95,95,32,91,123,468,333,801,0.000333,1.853651,48,266925.7977,14829.21098,5560.954119,752.209312,42,0
0,0,93,93,31,87,118,446,322,768,0.000333,1.761957,45,237864.1438,13214.67466,5285.869862,714.11617,42,0
0,0,49,49,27,70,97,224,169,393,0.000333,0.864589,26,67437.90942,3746.550523,2593.765747,557.431774,24,0
0,0,48,48,26,66,92,209,161,370,0.000333,0.804573,26,62756.66602,3486.481445,2413.717924,521.141445,24,0
0,0,48,48,27,67,94,223,165,388,0.000333,0.847727,26,66122.69234,3673.482908,2543.180474,534.809938,24,0
0,0,95,95,32,91,123,468,333,801,0.000333,1.853651,48,266925.7977,14829.21098,5560.954119,752.209312,42,0
0,0,93,93,31,87,118,446,322,768,0.000333,1.761957,45,237864.1438,13214.67466,5285.869862,714.11617,42,0
0,0,49,49,27,70,97,224,169,393,0.000333,0.864589,26,67437.90942,3746.550523,2593.765747,557.431774,24,0
0,0,48,48,26,66,92,209,161,370,0.000333,0.804573,26,62756.66602,3486.481445,2413.717924,521.141445,24,0
0,0,92,92,32,90,122,450,320,770,0.000333,1.778889,48,256160.052,14231.114,5336.66775,744.266779,42,0
0,0,11,11,16,26,42,53,43,96,0.000333,0.172554,8,4141.299781,230.07221,517.662473,186.211433,5,0
0,0,12,12,16,27,43,55,45,100,0.000333,0.180875,8,4341.011804,241.167322,542.626475,192.381963,5,0
0,0,11,11,16,26,42,53,43,96,0.000333,0.172554,8,4141.299781,230.07221,517.662473,186.211433,5,0
0,0,65,65,29,56,85,355,213,568,0.000333,1.213511,42,152902.4302,8494.579454,3640.534052,466.093324,37,0
0,0,64,64,28,47,75,281,170,451,0.000333,0.936399,42,117986.2836,6554.793535,2809.197229,395.671614,25,0
0,0,37,37,27,50,77,170,139,309,0.000333,0.645479,26,50347.36307,2797.075726,1936.437041,410.574772,20,0
0,0,38,38,26,46,72,170,139,309,0.000333,0.635502,39,74353.76619,4130.764788,1906.506825,376.295283,20,0
0,0,44,44,28,51,79,205,167,372,0.000333,0.781669,42,98490.27041,5471.681689,2345.006438,423.89963,21,0
0,0,41,41,29,52,81,194,155,349,0.000333,0.737536,28,61953.01423,3441.834124,2212.607651,437.304314,21,0
0,0,35,35,26,41,67,157,127,284,0.000333,0.574256,39,67188.00387,3732.666882,1722.76933,341.871065,20,0
1,0,3,4,7,10,17,18,14,32,0.000333,0.0436,3,392.396433,21.799802,130.798811,52.870765,1,0
1,0,3,4,7,7,14,8,8,16,0.000333,0.020306,3,182.753036,10.152946,60.917679,39.302969,1,0
1,0,3,4,7,10,17,18,14,32,0.000333,0.0436,3,392.396433,21.799802,130.798811,52.870765,1,0
1,0,3,4,7,7,14,8,8,16,0.000333,0.020306,3,182.753036,10.152946,60.917679,39.302969,1,0
2,0,36,38,28,74,102,248,187,435,0.000333,0.967502,28,81270.14067,4515.007815,2902.505024,594.105487,15,0
0,0,3,3,14,15,29,29,22,51,0.000333,0.082586,7,1734.299215,96.349956,247.757031,111.906328,2,0
0,0,4,4,14,8,22,29,16,45,0.000333,0.066891,14,2809.44192,156.080107,200.674423,77.302969,3,0
0,0,4,4,13,8,21,24,14,38,0.000333,0.055636,6,1001.448372,55.636021,166.908062,72.105716,3,0
0,0,8,8,17,27,44,67,49,116,0.000333,0.211098,8,5066.352542,281.46403,633.294068,197.868831,3,0
0,0,8,8,15,26,41,68,49,117,0.000333,0.208945,7,4387.835092,243.768616,626.833585,180.814792,3,0
4,0,43,47,29,76,105,391,290,681,0.000333,1.524134,42,192040.8503,10668.93613,4572.401198,615.72394,19,0
2,0,30,32,28,58,86,223,156,379,0.000333,0.811851,28,68195.52158,3788.640088,2435.554342,474.368836,14,0
2,0,29,31,28,56,84,215,150,365,0.000333,0.777732,28,65329.48406,3629.415781,2333.195859,459.817813,14,0
3,0,33,36,31,68,99,252,181,433,0.000333,0.956837,30,86115.3425,4784.185694,2870.511416,567.527559,16,0
5,0,59,64,32,88,120,483,359,842,0.000333,1.938534,64,372198.5204,20677.69558,5815.601882,728.429982,28,0
2,0,25,27,26,55,81,182,129,311,0.000333,0.657231,26,51264.02712,2848.001507,1971.693351,440.186217,12,0
3,0,45,48,31,77,108,314,229,543,0.000333,1.222635,30,110037.1174,6113.173189,3667.903914,636.122649,23,0
3,0,44,47,31,77,108,308,225,533,0.000333,1.200118,30,108010.6512,6000.591731,3600.355039,636.122649,21,0
3,0,43,46,31,77,108,304,223,527,0.000333,1.186609,30,106794.7714,5933.042856,3559.825714,636.122649,20,0
3,0,42,45,31,77,108,298,219,517,0.000333,1.164092,30,104768.3052,5820.461398,3492.276839,636.122649,18,0
0,0,30,30,21,44,65,195,138,333,0.000333,0.668483,30,60163.45445,3342.414136,2005.448482,332.453657,12,0
0,0,24,24,16,33,49,136,92,228,0.000333,0.426718,16,20482.46151,1137.914528,1280.153844,230.465006,11,0
0,0,23,23,19,36,55,136,93,229,0.000333,0.44131,18,23830.76474,1323.931374,1323.931374,266.827923,10,0
0,0,22,22,16,32,48,121,82,203,0.000333,0.377916,16,18139.9582,1007.775456,1133.747388,224,10,0
0,0,31,31,21,45,66,202,143,345,0.000333,0.695105,30,62559.47914,3475.526619,2085.315971,339.372055,12,0
0,0,22,22,21,34,55,158,115,273,0.000333,0.526104,30,47349.33605,2630.51867,1578.311202,265.212402,9,0
0,0,24,24,17,42,59,116,84,200,0.000333,0.392176,16,18824.45776,1045.803209,1176.52861,295.9642,7,0
0,0,19,19,15,35,50,94,67,161,0.000333,0.302887,7,6360.625926,353.368107,908.660847,238.128265,7,0
0,0,19,19,15,35,50,94,68,162,0.000333,0.304768,7,6400.132919,355.56294,914.304703,238.128265,7,0
0,0,19,19,15,35,50,94,67,161,0.000333,0.302887,7,6360.625926,353.368107,908.660847,238.128265,7,0
0,0,23,23,17,42,59,123,84,207,0.000333,0.405902,16,19483.31378,1082.406321,1217.707111,295.9642,7,0
0,0,23,23,17,42,59,123,84,207,0.000333,0.405902,16,19483.31378,1082.406321,1217.707111,295.9642,7,0
0,0,23,23,17,42,59,123,84,207,0.000333,0.405902,16,19483.31378,1082.406321,1217.707111,295.9642,7,0
0,0,23,23,17,42,59,123,84,207,0.000333,0.405902,16,19483.31378,1082.406321,1217.707111,295.9642,7,0
0,0,109,109,26,77,103,474,325,799,0.000333,1.780838,52,277810.7239,15433.92911,5342.513921,604.753996,32,0
0,0,62,62,24,52,76,274,201,475,0.000333,0.989255,36,106839.5605,5935.531138,2967.765569,406.461965,19,0
0,0,17,17,19,30,49,88,62,150,0.000333,0.280735,18,15159.71658,842.206477,842.206477,227.917341,7,0
0,0,108,108,26,77,103,467,320,787,0.000333,1.754092,52,273638.3476,15202.13042,5262.275915,604.753996,31,0
0,0,61,61,24,52,76,267,196,463,0.000333,0.964263,36,104140.4558,5785.580877,2892.790439,406.461965,18,0
0,0,16,16,19,30,49,81,57,138,0.000333,0.258277,9,6973.469626,387.414979,774.829958,227.917341,6,0
0,0,13,13,18,24,42,56,39,95,0.000333,0.170757,9,4610.431396,256.135078,512.270155,185.09775,2,0
0,0,13,13,18,24,42,56,39,95,0.000333,0.170757,9,4610.431396,256.135078,512.270155,185.09775,2,0
0,0,28,28,22,46,68,131,116,247,0.000333,0.501201,22,33079.27308,1837.737393,1503.603322,352.191346,5,0
0,0,30,30,22,48,70,140,120,260,0.000333,0.531205,22,35059.49886,1947.749936,1593.613584,366.185696,7,0
0,0,56,56,31,59,90,297,226,523,0.000333,1.131746,45,152785.7626,8488.097923,3395.239169,500.656026,18,0
0,0,28,28,22,46,68,131,116,247,0.000333,0.501201,22,33079.27308,1837.737393,1503.603322,352.191346,5,0
0,0,30,30,22,48,70,140,120,260,0.000333,0.531205,22,35059.49886,1947.749936,1593.613584,366.185696,7,0
0,0,28,28,22,46,68,131,116,247,0.000333,0.501201,22,33079.27308,1837.737393,1503.603322,352.191346,5,0
0,0,30,30,22,48,70,140,120,260,0.000333,0.531205,22,35059.49886,1947.749936,1593.613584,366.185696,7,0
0,0,28,28,22,46,68,131,116,247,0.000333,0.501201,22,33079.27308,1837.737393,1503.603322,352.191346,5,0
0,0,30,30,22,48,70,140,120,260,0.000333,0.531205,22,35059.49886,1947.749936,1593.613584,366.185696,7,0
0,0,28,28,22,46,68,131,116,247,0.000333,0.501201,22,33079.27308,1837.737393,1503.603322,352.191346,5,0
0,0,30,30,22,48,70,140,120,260,0.000333,0.531205,22,35059.49886,1947.749936,1593.613584,366.185696,7,0
0,0,28,28,22,46,68,131,116,247,0.000333,0.501201,22,33079.27308,1837.737393,1503.603322,352.191346,5,0
0,0,30,30,22,48,70,140,120,260,0.000333,0.531205,22,35059.49886,1947.749936,1593.613584,366.185696,7,0
0,0,26,26,20,46,66,122,107,229,0.000333,0.461389,20,27683.32507,1537.962504,1384.166253,340.522412,5,0
0,0,28,28,20,48,68,131,111,242,0.000333,0.491055,20,29463.32015,1636.85112,1473.166008,354.516762,7,0
0,0,54,54,29,59,88,288,217,505,0.000333,1.087338,42,137004.5446,7611.363591,3262.012967,487.957389,18,0
0,0,26,26,20,46,66,122,107,229,0.000333,0.461389,20,27683.32507,1537.962504,1384.166253,340.522412,5,0
0,0,28,28,20,48,68,131,111,242,0.000333,0.491055,20,29463.32015,1636.85112,1473.166008,354.516762,7,0
0,0,26,26,20,46,66,122,107,229,0.000333,0.461389,20,27683.32507,1537.962504,1384.166253,340.522412,5,0
0,0,28,28,20,48,68,131,111,242,0.000333,0.491055,20,29463.32015,1636.85112,1473.166008,354.516762,7,0
0,0,26,26,20,46,66,122,107,229,0.000333,0.461389,20,27683.32507,1537.962504,1384.166253,340.522412,5,0
0,0,28,28,20,48,68,131,111,242,0.000333,0.491055,20,29463.32015,1636.85112,1473.166008,354.516762,7,0
0,0,26,26,20,46,66,122,107,229,0.000333,0.461389,20,27683.32507,1537.962504,1384.166253,340.522412,5,0
0,0,28,28,20,48,68,131,111,242,0.000333,0.491055,20,29463.32015,1636.85112,1473.166008,354.516762,7,0
0,0,26,26,20,46,66,122,107,229,0.000333,0.461389,20,27683.32507,1537.962504,1384.166253,340.522412,5,0
0,0,28,28,20,48,68,131,111,242,0.000333,0.491055,20,29463.32015,1636.85112,1473.166008,354.516762,7,0
0,0,25,25,20,46,66,119,106,225,0.000333,0.45333,20,27199.77354,1511.09853,1359.988677,340.522412,4,0
0,0,27,27,20,48,68,128,110,238,0.000333,0.482939,20,28976.32312,1609.795729,1448.816156,354.516762,6,0
0,0,53,53,29,59,88,285,216,501,0.000333,1.078725,42,135919.3601,7551.075562,3236.175241,487.957389,17,0
0,0,25,25,20,46,66,119,106,225,0.000333,0.45333,20,27199.77354,1511.09853,1359.988677,340.522412,4,0
0,0,27,27,20,48,68,128,110,238,0.000333,0.482939,20,28976.32312,1609.795729,1448.816156,354.516762,6,0
0,0,25,25,20,46,66,119,106,225,0.000333,0.45333,20,27199.77354,1511.09853,1359.988677,340.522412,4,0
0,0,27,27,20,48,68,128,110,238,0.000333,0.482939,20,28976.32312,1609.795729,1448.816156,354.516762,6,0
0,0,25,25,20,46,66,119,106,225,0.000333,0.45333,20,27199.77354,1511.09853,1359.988677,340.522412,4,0
0,0,27,27,20,48,68,128,110,238,0.000333,0.482939,20,28976.32312,1609.795729,1448.816156,354.516762,6,0
0,0,25,25,20,46,66,119,106,225,0.000333,0.45333,20,27199.77354,1511.09853,1359.988677,340.522412,4,0
0,0,27,27,20,48,68,128,110,238,0.000333,0.482939,20,28976.32312,1609.795729,1448.816156,354.516762,6,0
0,0,25,25,20,46,66,119,106,225,0.000333,0.45333,20,27199.77354,1511.09853,1359.988677,340.522412,4,0
0,0,27,27,20,48,68,128,110,238,0.000333,0.482939,20,28976.32312,1609.795729,1448.816156,354.516762,6,0
0,0,28,28,22,46,68,131,116,247,0.000333,0.501201,22,33079.27308,1837.737393,1503.603322,352.191346,5,0
0,0,30,30,22,48,70,140,120,260,0.000333,0.531205,22,35059.49886,1947.749936,1593.613584,366.185696,7,0
0,0,56,56,31,59,90,297,226,523,0.000333,1.131746,45,152785.7626,8488.097923,3395.239169,500.656026,18,0
0,0,28,28,22,46,68,131,116,247,0.000333,0.501201,22,33079.27308,1837.737393,1503.603322,352.191346,5,0
0,0,30,30,22,48,70,140,120,260,0.000333,0.531205,22,35059.49886,1947.749936,1593.613584,366.185696,7,0
0,0,28,28,22,46,68,131,116,247,0.000333,0.501201,22,33079.27308,1837.737393,1503.603322,352.191346,5,0
0,0,30,30,22,48,70,140,120,260,0.000333,0.531205,22,35059.49886,1947.749936,1593.613584,366.185696,7,0
0,0,28,28,22,46,68,131,116,247,0.000333,0.501201,22,33079.27308,1837.737393,1503.603322,352.191346,5,0
0,0,30,30,22,48,70,140,120,260,0.000333,0.531205,22,35059.49886,1947.749936,1593.613584,366.185696,7,0
0,0,28,28,22,46,68,131,116,247,0.000333,0.501201,22,33079.27308,1837.737393,1503.603322,352.191346,5,0
0,0,30,30,22,48,70,140,120,260,0.000333,0.531205,22,35059.49886,1947.749936,1593.613584,366.185696,7,0
0,0,28,28,22,46,68,131,116,247,0.000333,0.501201,22,33079.27308,1837.737393,1503.603322,352.191346,5,0
0,0,30,30,22,48,70,140,120,260,0.000333,0.531205,22,35059.49886,1947.749936,1593.613584,366.185696,7,0
0,0,22,22,17,42,59,95,86,181,0.000333,0.354919,16,17036.13427,946.451904,1064.758392,295.9642,3,0
0,0,24,24,17,44,61,104,90,194,0.000333,0.383521,16,18409.0087,1022.722705,1150.563043,309.70186,5,0
0,0,50,50,30,57,87,261,196,457,0.000333,0.981475,45,132499.133,7361.062944,2944.425178,479.681449,16,0
0,0,22,22,17,41,58,95,86,181,0.000333,0.353432,16,16964.71296,942.484053,1060.29456,289.1465,3,0
0,0,24,24,17,43,60,104,90,194,0.000333,0.381979,16,18334.98841,1018.610467,1145.936776,302.816253,5,0
0,0,22,22,17,41,58,95,86,181,0.000333,0.353432,16,16964.71296,942.484053,1060.29456,289.1465,3,0
0,0,24,24,17,43,60,104,90,194,0.000333,0.381979,16,18334.98841,1018.610467,1145.936776,302.816253,5,0
0,0,22,22,17,42,59,95,86,181,0.000333,0.354919,16,17036.13427,946.451904,1064.758392,295.9642,3,0
0,0,24,24,17,44,61,104,90,194,0.000333,0.383521,16,18409.0087,1022.722705,1150.563043,309.70186,5,0
0,0,22,22,17,41,58,95,86,181,0.000333,0.353432,16,16964.71296,942.484053,1060.29456,289.1465,3,0
0,0,24,24,17,43,60,104,90,194,0.000333,0.381979,16,18334.98841,1018.610467,1145.936776,302.816253,5,0
0,0,22,22,17,41,58,95,86,181,0.000333,0.353432,16,16964.71296,942.484053,1060.29456,289.1465,3,0
0,0,24,24,17,43,60,104,90,194,0.000333,0.381979,16,18334.98841,1018.610467,1145.936776,302.816253,5,0
0,0,28,28,22,46,68,131,116,247,0.000333,0.501201,22,33079.27308,1837.737393,1503.603322,352.191346,5,0
0,0,30,30,22,48,70,140,120,260,0.000333,0.531205,22,35059.49886,1947.749936,1593.613584,366.185696,7,0
0,0,56,56,31,59,90,297,226,523,0.000333,1.131746,45,152785.7626,8488.097923,3395.239169,500.656026,18,0
0,0,28,28,22,46,68,131,116,247,0.000333,0.501201,22,33079.27308,1837.737393,1503.603322,352.191346,5,0
0,0,30,30,22,48,70,140,120,260,0.000333,0.531205,22,35059.49886,1947.749936,1593.613584,366.185696,7,0
0,0,28,28,22,46,68,131,116,247,0.000333,0.501201,22,33079.27308,1837.737393,1503.603322,352.191346,5,0
0,0,30,30,22,48,70,140,120,260,0.000333,0.531205,22,35059.49886,1947.749936,1593.613584,366.185696,7,0
0,0,28,28,22,46,68,131,116,247,0.000333,0.501201,22,33079.27308,1837.737393,1503.603322,352.191346,5,0
0,0,30,30,22,48,70,140,120,260,0.000333,0.531205,22,35059.49886,1947.749936,1593.613584,366.185696,7,0
0,0,28,28,22,46,68,131,116,247,0.000333,0.501201,22,33079.27308,1837.737393,1503.603322,352.191346,5,0
0,0,30,30,22,48,70,140,120,260,0.000333,0.531205,22,35059.49886,1947.749936,1593.613584,366.185696,7,0
0,0,28,28,22,46,68,131,116,247,0.000333,0.501201,22,33079.27308,1837.737393,1503.603322,352.191346,5,0
0,0,30,30,22,48,70,140,120,260,0.000333,0.531205,22,35059.49886,1947.749936,1593.613584,366.185696,7,0
0,0,22,22,17,42,59,95,86,181,0.000333,0.354919,16,17036.13427,946.451904,1064.758392,295.9642,3,0
0,0,24,24,17,44,61,104,90,194,0.000333,0.383521,16,18409.0087,1022.722705,1150.563043,309.70186,5,0
0,0,50,50,30,57,87,261,196,457,0.000333,0.981475,45,132499.133,7361.062944,2944.425178,479.681449,16,0
0,0,22,22,17,41,58,95,86,181,0.000333,0.353432,16,16964.71296,942.484053,1060.29456,289.1465,3,0
0,0,24,24,17,43,60,104,90,194,0.000333,0.381979,16,18334.98841,1018.610467,1145.936776,302.816253,5,0
0,0,22,22,17,41,58,95,86,181,0.000333,0.353432,16,16964.71296,942.484053,1060.29456,289.1465,3,0
0,0,24,24,17,43,60,104,90,194,0.000333,0.381979,16,18334.98841,1018.610467,1145.936776,302.816253,5,0
0,0,22,22,17,42,59,95,86,181,0.000333,0.354919,16,17036.13427,946.451904,1064.758392,295.9642,3,0
0,0,24,24,17,44,61,104,90,194,0.000333,0.383521,16,18409.0087,1022.722705,1150.563043,309.70186,5,0
0,0,22,22,17,41,58,95,86,181,0.000333,0.353432,16,16964.71296,942.484053,1060.29456,289.1465,3,0
0,0,24,24,17,43,60,104,90,194,0.000333,0.381979,16,18334.98841,1018.610467,1145.936776,302.816253,5,0
0,0,22,22,17,41,58,95,86,181,0.000333,0.353432,16,16964.71296,942.484053,1060.29456,289.1465,3,0
0,0,24,24,17,43,60,104,90,194,0.000333,0.381979,16,18334.98841,1018.610467,1145.936776,302.816253,5,0
0,0,45,45,27,49,76,238,169,407,0.000333,0.847635,39,99173.35342,5509.630746,2542.906498,403.502745,16,0
0,0,38,38,26,49,75,206,148,354,0.000333,0.735001,39,85995.07084,4777.503936,2205.001816,397.332215,12,0
0,0,45,45,27,49,76,238,169,407,0.000333,0.847635,39,99173.35342,5509.630746,2542.906498,403.502745,16,0
0,0,26,26,22,37,59,114,88,202,0.000333,0.396098,22,26142.46571,1452.359206,1188.293896,290.85727,10,0
0,0,34,34,26,49,75,186,131,317,0.000333,0.658179,26,51337.92365,2852.106869,1974.535525,397.332215,12,0
0,0,94,94,30,82,112,550,393,943,0.000333,2.139779,60,385160.1415,21397.78564,6419.335692,668.525982,59,0
0,0,94,94,30,82,112,550,393,943,0.000333,2.139779,60,385160.1415,21397.78564,6419.335692,668.525982,59,0
0,0,94,94,30,82,112,550,393,943,0.000333,2.139779,60,385160.1415,21397.78564,6419.335692,668.525982,59,0
0,0,93,93,32,86,118,538,387,925,0.000333,2.122148,64,407452.4685,22636.24825,6366.444821,712.658769,51,0
0,0,93,93,32,86,118,538,387,925,0.000333,2.122148,64,407452.4685,22636.24825,6366.444821,712.658769,51,0
0,0,93,93,32,86,118,538,387,925,0.000333,2.122148,64,407452.4685,22636.24825,6366.444821,712.658769,51,0
0,0,93,93,32,88,120,526,381,907,0.000333,2.088183,64,400931.1853,22273.95474,6264.54977,728.429982,51,0
0,0,93,93,32,88,120,526,381,907,0.000333,2.088183,64,400931.1853,22273.95474,6264.54977,728.429982,51,0
0,0,93,93,32,88,120,526,381,907,0.000333,2.088183,64,400931.1853,22273.95474,6264.54977,728.429982,51,0
0,0,92,92,30,81,111,509,366,875,0.000333,1.981705,60,356706.833,19817.04628,5945.113883,660.734568,51,0
0,0,92,92,30,81,111,509,366,875,0.000333,1.981705,60,356706.833,19817.04628,5945.113883,660.734568,51,0
0,0,92,92,30,81,111,509,366,875,0.000333,1.981705,60,356706.833,19817.04628,5945.113883,660.734568,51,0
0,0,92,92,30,81,111,509,366,875,0.000333,1.981705,60,356706.833,19817.04628,5945.113883,660.734568,51,0
0,0,92,92,30,81,111,509,366,875,0.000333,1.981705,60,356706.833,19817.04628,5945.113883,660.734568,51,0
0,0,92,92,30,81,111,509,366,875,0.000333,1.981705,60,356706.833,19817.04628,5945.113883,660.734568,51,0
0,0,94,94,30,82,112,550,393,943,0.000333,2.139779,60,385160.1415,21397.78564,6419.335692,668.525982,59,0
0,0,94,94,30,82,112,550,393,943,0.000333,2.139779,60,385160.1415,21397.78564,6419.335692,668.525982,59,0
0,0,94,94,30,82,112,550,393,943,0.000333,2.139779,60,385160.1415,21397.78564,6419.335692,668.525982,59,0
0,0,93,93,32,86,118,538,387,925,0.000333,2.122148,64,407452.4685,22636.24825,6366.444821,712.658769,51,0
0,0,93,93,32,86,118,538,387,925,0.000333,2.122148,64,407452.4685,22636.24825,6366.444821,712.658769,51,0
0,0,93,93,32,86,118,538,387,925,0.000333,2.122148,64,407452.4685,22636.24825,6366.444821,712.658769,51,0
0,0,93,93,32,88,120,526,381,907,0.000333,2.088183,64,400931.1853,22273.95474,6264.54977,728.429982,51,0
0,0,93,93,32,88,120,526,381,907,0.000333,2.088183,64,400931.1853,22273.95474,6264.54977,728.429982,51,0
0,0,93,93,32,88,120,526,381,907,0.000333,2.088183,64,400931.1853,22273.95474,6264.54977,728.429982,51,0
0,0,92,92,30,81,111,509,366,875,0.000333,1.981705,60,356706.833,19817.04628,5945.113883,660.734568,51,0
0,0,92,92,30,81,111,509,366,875,0.000333,1.981705,60,356706.833,19817.04628,5945.113883,660.734568,51,0
0,0,92,92,30,81,111,509,366,875,0.000333,1.981705,60,356706.833,19817.04628,5945.113883,660.734568,51,0
0,0,92,92,30,81,111,509,366,875,0.000333,1.981705,60,356706.833,19817.04628,5945.113883,660.734568,51,0
0,0,92,92,30,81,111,509,366,875,0.000333,1.981705,60,356706.833,19817.04628,5945.113883,660.734568,51,0
0,0,92,92,30,81,111,509,366,875,0.000333,1.981705,60,356706.833,19817.04628,5945.113883,660.734568,51,0
0,0,11,11,14,24,38,48,41,89,0.000333,0.155689,7,3269.458841,181.636602,467.065549,163.342069,4,0
0,0,17,17,17,35,52,88,75,163,0.000333,0.309724,16,14866.74679,825.930377,929.171674,249.011774,4,0
0,0,41,41,20,69,89,226,193,419,0.000333,0.904444,20,54266.64615,3014.813675,2713.332308,507.926749,9,0
0,0,37,37,22,62,84,203,171,374,0.000333,0.796909,22,52595.98776,2921.99932,2390.726716,467.267667,9,0
0,0,38,38,22,62,84,207,173,380,0.000333,0.809694,22,53439.77365,2968.876314,2429.080621,467.267667,10,0
0,0,43,43,25,71,96,243,198,441,0.000333,0.967989,24,69695.24311,3871.95795,2903.968463,552.72845,13,0
0,0,82,82,28,117,145,533,436,969,0.000333,2.319111,42,292207.9401,16233.77445,6957.331908,938.43861,29,0
0,0,58,58,26,83,109,324,260,584,0.000333,1.31754,39,154152.1662,8564.009232,3952.619646,651.339705,16,0
1,0,11,12,19,25,44,58,45,103,0.000333,0.18744,9,5060.89311,281.160728,562.321457,196.807027,6,0
1,0,11,12,19,25,44,58,45,103,0.000333,0.18744,9,5060.89311,281.160728,562.321457,196.807027,6,0
1,0,11,12,19,25,44,58,45,103,0.000333,0.18744,9,5060.89311,281.160728,562.321457,196.807027,6,0
1,0,16,17,20,38,58,89,62,151,0.000333,0.294852,10,8845.551303,491.419517,884.55513,285.859807,12,0
1,0,39,40,22,46,68,220,138,358,0.000333,0.726437,33,71917.28601,3995.404778,2179.311697,352.191346,30,0
0,0,34,34,22,31,53,116,95,211,0.000333,0.402864,33,39883.51013,2215.750563,1208.591216,251.687581,7,0
1,0,15,16,23,31,54,103,70,173,0.000333,0.331865,22,21903.10183,1216.838991,995.595538,257.622011,8,0
1,0,15,16,23,31,54,103,70,173,0.000333,0.331865,22,21903.10183,1216.838991,995.595538,257.622011,8,0
1,0,9,10,19,24,43,52,35,87,0.000333,0.157362,9,4248.765303,236.042517,472.085034,190.749723,8,0
0,0,27,27,22,43,65,169,100,269,0.000333,0.540006,22,35640.37272,1980.020707,1620.016942,331.43688,9,0
0,0,33,33,22,44,66,200,124,324,0.000333,0.652795,22,43084.44128,2393.580071,1958.383695,338.322487,13,0
0,0,57,57,31,74,105,336,211,547,0.000333,1.224231,30,110180.7689,6121.15383,3672.692298,613.079635,18,0
0,0,34,34,25,49,74,205,130,335,0.000333,0.693389,24,49924.00506,2773.555837,2080.166877,391.217187,12,0
0,0,56,56,31,73,104,333,209,542,0.000333,1.210546,30,108949.1498,6052.730545,3631.638327,605.437278,18,0
0,0,33,33,25,48,73,202,128,330,0.000333,0.680881,24,49023.41051,2723.522806,2042.642104,384.174605,12,0
0,0,11,11,17,24,41,65,45,110,0.000333,0.196444,8,4714.645764,261.924765,589.330721,179.525968,6,0
0,0,17,17,17,24,41,96,69,165,0.000333,0.294665,16,14143.93729,785.774294,883.996081,179.525968,10,0
0,0,79,79,27,79,106,343,226,569,0.000333,1.276062,26,99532.85521,5529.603067,3828.186739,626.380642,13,0
0,0,45,45,22,50,72,194,125,319,0.000333,0.656069,22,43300.53366,2405.585203,1968.206075,380.300305,8,0
0,0,20,20,18,42,60,91,87,178,0.000333,0.350476,18,18925.67747,1051.426526,1051.426526,301.535982,10,0
0,0,19,19,18,42,60,89,87,176,0.000333,0.346538,18,18713.02941,1039.612745,1039.612745,301.535982,8,0
0,0,12,12,12,24,36,51,51,102,0.000333,0.175777,12,6327.988202,351.5549,527.33235,153.05865,3,0
0,0,12,12,12,24,36,51,51,102,0.000333,0.175777,12,6327.988202,351.5549,527.33235,153.05865,3,0
0,0,13,13,14,28,42,58,55,113,0.000333,0.203111,7,4265.323081,236.962393,609.331869,187.908907,4,0
0,0,13,13,13,30,43,58,57,115,0.000333,0.208007,6,3744.122681,208.006816,624.020447,195.312434,3,0
0,0,76,76,30,87,117,330,239,569,0.000333,1.303079,30,117277.1258,6515.395876,3909.237525,707.742802,28,0
0,0,75,75,30,86,116,325,235,560,0.000333,1.280156,30,115214.0807,6400.782262,3840.469357,699.865487,28,0
0,0,53,53,28,63,91,231,157,388,0.000333,0.841675,28,70700.68097,3927.81561,2525.02432,511.174573,24,0
0,0,44,44,27,69,96,248,168,416,0.000333,0.913115,26,71222.95441,3956.8308,2739.3444,549.87015,25,0
0,0,73,73,28,82,110,366,246,612,0.000333,1.383397,42,174308.0701,9683.781671,4150.192145,655.925202,37,0
0,0,36,36,24,62,86,218,141,359,0.000333,0.76901,24,55368.69713,3076.038729,2307.029047,479.199271,23,0
0,0,67,67,27,74,101,332,220,552,0.000333,1.225111,26,95558.6512,5308.813956,3675.332738,587.881512,33,0
0,0,35,35,23,61,84,211,137,348,0.000333,0.741509,22,48939.58219,2718.865677,2224.526463,465.816903,21,0
1,0,11,12,21,31,52,61,45,106,0.000333,0.201416,10,6042.466101,335.692561,604.24661,245.818752,7,0
1,0,9,10,19,25,44,45,31,76,0.000333,0.138306,9,3734.251227,207.458402,414.916803,196.807027,5,0
1,0,15,16,20,34,54,94,69,163,0.000333,0.312682,20,18760.93326,1042.27407,938.046663,259.412299,8,0
1,0,10,11,22,29,51,69,52,121,0.000333,0.228788,11,7549.99813,419.444341,686.363466,238.988944,5,0
1,0,11,12,19,28,47,68,50,118,0.000333,0.21848,9,5898.97336,327.720742,655.441484,215.316561,5,0
1,0,19,20,23,41,64,123,81,204,0.000333,0.408,11,13464,748,1224,323.701557,13,0
1,0,19,20,22,40,62,119,79,198,0.000333,0.392977,11,12968.23956,720.457754,1178.930869,310.984619,12,0
1,0,6,7,13,12,25,39,22,61,0.000333,0.094425,6,1699.651365,94.425076,283.275228,91.125266,4,0
1,0,4,5,12,11,23,20,14,34,0.000333,0.051267,6,922.806639,51.267036,153.801107,81.073298,3,0
1,0,4,5,12,11,23,20,14,34,0.000333,0.051267,6,922.806639,51.267036,153.801107,81.073298,3,0
0,0,31,31,24,54,78,221,191,412,0.000333,0.863195,36,93225.08571,5179.171428,2589.585714,420.803025,6,0
0,0,12,12,19,22,41,76,61,137,0.000333,0.244662,18,13211.72324,733.984625,733.984625,178.818118,4,0
0,0,28,28,23,44,67,195,162,357,0.000333,0.721865,33,71464.59675,3970.255375,2165.593841,344.256916,3,0
0,0,34,34,21,44,65,148,95,243,0.000333,0.487812,20,29268.70757,1626.03931,1463.435379,332.453657,12,0
0,0,34,34,21,44,65,148,95,243,0.000333,0.487812,20,29268.70757,1626.03931,1463.435379,332.453657,12,0
0,0,34,34,21,44,65,148,95,243,0.000333,0.487812,20,29268.70757,1626.03931,1463.435379,332.453657,12,0
0,0,30,30,21,43,64,132,86,218,0.000333,0.436,20,26160,1453.333333,1308,325.56805,10,0
0,0,30,30,21,43,64,132,86,218,0.000333,0.436,20,26160,1453.333333,1308,325.56805,10,0
0,0,25,25,21,39,60,118,75,193,0.000333,0.38001,10,11400.29885,633.349936,1140.029885,298.369352,8,0
0,0,19,19,21,36,57,86,57,143,0.000333,0.278034,10,8341.03272,463.390707,834.103272,278.355966,5,0
0,0,17,17,21,36,57,81,52,133,0.000333,0.258591,10,7757.743719,430.985762,775.774372,278.355966,5,0
0,0,25,25,21,39,60,118,75,193,0.000333,0.38001,10,11400.29885,633.349936,1140.029885,298.369352,8,0
0,0,19,19,21,36,57,86,57,143,0.000333,0.278034,10,8341.03272,463.390707,834.103272,278.355966,5,0
0,0,17,17,21,36,57,81,52,133,0.000333,0.258591,10,7757.743719,430.985762,775.774372,278.355966,5,0
0,0,33,33,22,41,63,144,89,233,0.000333,0.464235,22,30639.53689,1702.196494,1392.706222,317.767128,12,0
0,0,29,29,22,40,62,128,80,208,0.000333,0.412824,22,27246.40232,1513.689018,1238.472833,310.984619,10,0
0,0,25,25,22,38,60,112,71,183,0.000333,0.36032,11,11890.57077,660.587265,1080.960979,297.528741,8,0
0,0,19,19,22,35,57,80,53,133,0.000333,0.258591,11,8533.518091,474.084338,775.774372,277.632401,5,0
0,0,44,44,24,57,81,299,251,550,0.000333,1.162306,48,167372.0401,9298.446671,3486.917502,442.513831,6,0
0,0,25,25,21,32,53,154,121,275,0.000333,0.525059,30,47255.34375,2625.296875,1575.178125,252.238666,4,0
0,0,44,44,24,57,81,299,251,550,0.000333,1.162306,48,167372.0401,9298.446671,3486.917502,442.513831,6,0
0,0,25,25,21,32,53,154,121,275,0.000333,0.525059,30,47255.34375,2625.296875,1575.178125,252.238666,4,0
0,0,44,44,24,57,81,299,251,550,0.000333,1.162306,48,167372.0401,9298.446671,3486.917502,442.513831,6,0
0,0,25,25,21,32,53,154,121,275,0.000333,0.525059,30,47255.34375,2625.296875,1575.178125,252.238666,4,0
0,0,44,44,24,57,81,299,251,550,0.000333,1.162306,48,167372.0401,9298.446671,3486.917502,442.513831,6,0
0,0,25,25,21,32,53,154,121,275,0.000333,0.525059,30,47255.34375,2625.296875,1575.178125,252.238666,4,0
0,0,44,44,24,57,81,299,251,550,0.000333,1.162306,48,167372.0401,9298.446671,3486.917502,442.513831,6,0
0,0,25,25,21,32,53,154,121,275,0.000333,0.525059,30,47255.34375,2625.296875,1575.178125,252.238666,4,0
0,0,44,44,24,57,81,299,251,550,0.000333,1.162306,48,167372.0401,9298.446671,3486.917502,442.513831,6,0
0,0,25,25,21,32,53,154,121,275,0.000333,0.525059,30,47255.34375,2625.296875,1575.178125,252.238666,4,0
0,0,44,44,24,57,81,299,251,550,0.000333,1.162306,48,167372.0401,9298.446671,3486.917502,442.513831,6,0
0,0,25,25,21,32,53,154,121,275,0.000333,0.525059,30,47255.34375,2625.296875,1575.178125,252.238666,4,0
0,0,44,44,24,57,81,299,251,550,0.000333,1.162306,48,167372.0401,9298.446671,3486.917502,442.513831,6,0
0,0,25,25,21,32,53,154,121,275,0.000333,0.525059,30,47255.34375,2625.296875,1575.178125,252.238666,4,0
0,0,44,44,24,57,81,299,251,550,0.000333,1.162306,48,167372.0401,9298.446671,3486.917502,442.513831,6,0
0,0,25,25,21,32,53,154,121,275,0.000333,0.525059,30,47255.34375,2625.296875,1575.178125,252.238666,4,0
0,0,35,35,24,57,81,235,203,438,0.000333,0.925618,36,99966.75485,5553.708603,2776.854301,442.513831,6,0
0,0,16,16,19,25,44,90,73,163,0.000333,0.296629,18,16017.97237,889.887354,889.887354,196.807027,4,0
0,0,44,44,24,57,81,299,251,550,0.000333,1.162306,48,167372.0401,9298.446671,3486.917502,442.513831,6,0
0,0,25,25,21,32,53,154,121,275,0.000333,0.525059,30,47255.34375,2625.296875,1575.178125,252.238666,4,0
0,0,44,44,24,57,81,299,251,550,0.000333,1.162306,48,167372.0401,9298.446671,3486.917502,442.513831,6,0
0,0,25,25,21,32,53,154,121,275,0.000333,0.525059,30,47255.34375,2625.296875,1575.178125,252.238666,4,0
0,0,44,44,24,57,81,299,251,550,0.000333,1.162306,48,167372.0401,9298.446671,3486.917502,442.513831,6,0
0,0,25,25,21,32,53,154,121,275,0.000333,0.525059,30,47255.34375,2625.296875,1575.178125,252.238666,4,0
0,0,44,44,24,57,81,299,251,550,0.000333,1.162306,48,167372.0401,9298.446671,3486.917502,442.513831,6,0
0,0,25,25,21,32,53,154,121,275,0.000333,0.525059,30,47255.34375,2625.296875,1575.178125,252.238666,4,0
0,0,44,44,24,57,81,299,251,550,0.000333,1.162306,48,167372.0401,9298.446671,3486.917502,442.513831,6,0
0,0,25,25,21,32,53,154,121,275,0.000333,0.525059,30,47255.34375,2625.296875,1575.178125,252.238666,4,0
0,0,44,44,24,57,81,299,251,550,0.000333,1.162306,48,167372.0401,9298.446671,3486.917502,442.513831,6,0
0,0,25,25,21,32,53,154,121,275,0.000333,0.525059,30,47255.34375,2625.296875,1575.178125,252.238666,4,0
0,0,44,44,24,57,81,299,251,550,0.000333,1.162306,48,167372.0401,9298.446671,3486.917502,442.513831,6,0
0,0,25,25,21,32,53,154,121,275,0.000333,0.525059,30,47255.34375,2625.296875,1575.178125,252.238666,4,0
0,0,44,44,24,57,81,299,251,550,0.000333,1.162306,48,167372.0401,9298.446671,3486.917502,442.513831,6,0
0,0,25,25,21,32,53,154,121,275,0.000333,0.525059,30,47255.34375,2625.296875,1575.178125,252.238666,4,0
0,0,44,44,24,57,81,299,251,550,0.000333,1.162306,48,167372.0401,9298.446671,3486.917502,442.513831,6,0
0,0,25,25,21,32,53,154,121,275,0.000333,0.525059,30,47255.34375,2625.296875,1575.178125,252.238666,4,0
0,0,31,31,24,54,78,221,191,412,0.000333,0.863195,36,93225.08571,5179.171428,2589.585714,420.803025,6,0
0,0,28,28,23,44,67,195,162,357,0.000333,0.721865,33,71464.59675,3970.255375,2165.593841,344.256916,3,0
0,0,42,42,21,51,72,256,208,464,0.000333,0.954282,40,114513.808,6361.878224,2862.845201,381.532358,3,0
0,0,42,42,21,51,72,256,208,464,0.000333,0.954282,40,114513.808,6361.878224,2862.845201,381.532358,3,0
0,0,42,42,21,51,72,256,208,464,0.000333,0.954282,40,114513.808,6361.878224,2862.845201,381.532358,3,0
0,0,42,42,21,51,72,256,208,464,0.000333,0.954282,40,114513.808,6361.878224,2862.845201,381.532358,3,0
0,0,41,41,21,50,71,251,203,454,0.000333,0.930662,40,111679.4077,6204.411538,2791.985192,374.431475,3,0
0,0,39,39,21,49,70,241,194,435,0.000333,0.888746,30,79987.14337,4443.730187,2666.238112,367.359448,3,0
0,0,38,38,21,48,69,236,189,425,0.000333,0.865374,30,77883.68682,4326.87149,2596.122894,360.316866,3,0
0,0,36,36,21,47,68,226,180,406,0.000333,0.823837,30,74145.29741,4119.183189,2471.509914,353.304342,3,0
0,0,35,35,21,46,67,221,175,396,0.000333,0.800724,30,72065.13958,4003.618866,2402.171319,346.322516,3,0
0,0,6,6,15,13,28,25,17,42,0.000333,0.067303,7,1413.362347,78.52013,201.908907,106.709075,3,0
0,0,12,12,19,22,41,76,61,137,0.000333,0.244662,18,13211.72324,733.984625,733.984625,178.818118,4,0
0,0,6,6,15,12,27,28,18,46,0.000333,0.072908,7,1531.073776,85.059654,218.724825,101.622909,3,0
0,0,60,60,24,65,89,265,225,490,0.000333,1.057703,36,114231.9377,6346.218762,3173.109381,501.493008,15,0
0,0,59,59,24,65,89,261,222,483,0.000333,1.042593,36,112600.0529,6255.558494,3127.779247,501.493008,14,0
0,0,60,60,24,66,90,266,226,492,0.000333,1.064664,36,114983.702,6387.983447,3193.991723,508.969112,15,0
0,0,59,59,24,65,89,261,222,483,0.000333,1.042593,36,112600.0529,6255.558494,3127.779247,501.493008,14,0
0,0,11,11,16,19,35,39,33,72,0.000333,0.123103,8,2954.467018,164.137057,369.308377,144.710623,5,0
0,0,27,27,22,39,61,94,84,178,0.000333,0.35189,22,23224.76741,1290.264856,1055.671246,304.238182,9,0
0,0,6,6,11,13,24,19,20,39,0.000333,0.059605,5,894.067688,49.670427,178.813538,86.159464,2,0
0,0,7,7,14,12,26,42,28,70,0.000333,0.109677,14,4606.430924,255.912829,329.03078,96.322519,5,0
0,0,5,5,15,13,28,27,19,46,0.000333,0.073713,7,1547.968285,85.998238,221.138326,106.709075,3,0
0,0,6,6,11,14,25,30,22,52,0.000333,0.080494,5,1207.402609,67.077923,241.480522,91.356717,1,0
0,0,29,29,20,42,62,135,92,227,0.000333,0.450534,20,27032.05125,1501.780625,1351.602562,312.915894,8,0
0,0,41,41,25,61,86,192,133,325,0.000333,0.696179,24,50124.86509,2784.714727,2088.536045,477.871382,12,0
0,0,38,38,23,50,73,160,116,276,0.000333,0.569464,22,37584.61472,2088.034151,1708.391578,386.234734,11,0
0,0,12,12,15,16,31,53,30,83,0.000333,0.137066,7,2878.388056,159.910448,411.198294,122.603359,6,0
0,0,10,10,15,16,31,44,26,70,0.000333,0.115598,7,2427.556192,134.864233,346.793742,122.603359,5,0
0,0,8,8,15,16,31,35,22,57,0.000333,0.09413,7,1976.724328,109.818018,282.38919,122.603359,4,0
0,0,12,12,15,16,31,53,30,83,0.000333,0.137066,7,2878.388056,159.910448,411.198294,122.603359,6,0
0,0,11,11,15,16,31,47,27,74,0.000333,0.122204,7,2566.273689,142.57076,366.610527,122.603359,6,0
0,0,10,10,15,16,31,41,24,65,0.000333,0.107341,7,2254.159321,125.231073,322.02276,122.603359,6,0
0,0,54,54,25,61,86,267,156,423,0.000333,0.906103,24,65239.43979,3624.413322,2718.309991,477.871382,18,0
0,0,48,48,22,53,75,220,140,360,0.000333,0.747458,22,49332.24403,2740.680224,2242.374729,401.68728,12,0
0,0,46,46,22,54,76,211,136,347,0.000333,0.722677,22,47696.67864,2649.81548,2168.030847,408.871421,11,0
0,0,44,44,22,53,75,202,132,334,0.000333,0.693475,22,45769.35974,2542.742208,2080.425443,401.68728,10,0
0,0,20,20,18,28,46,95,57,152,0.000333,0.27986,18,15112.46551,839.581417,839.581417,209.664588,10,0
0,0,19,19,18,28,46,88,53,141,0.000333,0.259607,9,7009.400122,389.411118,778.822236,209.664588,10,0
0,0,7,7,15,17,32,36,23,59,0.000333,0.098333,7,2065,114.722222,295,128.090227,3,0
0,0,33,33,22,45,67,205,132,337,0.000333,0.681424,22,44973.98526,2498.554737,2044.272057,345.240885,7,0
0,0,20,20,18,30,48,112,78,190,0.000333,0.353714,18,19100.57175,1061.142875,1061.142875,222.265368,3,0
0,0,52,52,26,71,97,258,173,431,0.000333,0.948187,26,73958.62331,4108.812406,2844.562435,558.843478,14,0
0,0,43,43,21,54,75,217,148,365,0.000333,0.75784,20,45470.37644,2526.132024,2273.518822,403.002591,10,0
0,0,49,49,24,60,84,226,156,382,0.000333,0.813955,24,58604.76613,3255.820341,2441.865256,464.452536,13,0
0,0,24,24,21,34,55,144,90,234,0.000333,0.450946,20,27056.76346,1503.153526,1352.838173,265.212402,7,0
0,0,11,11,15,17,32,51,36,87,0.000333,0.145,14,6090,338.333333,435,128.090227,3,0
0,0,43,43,25,60,85,197,131,328,0.000333,0.70076,24,50454.72545,2803.040303,2102.280227,470.50984,14,0
0,0,34,34,20,43,63,156,106,262,0.000333,0.522016,20,31320.9468,1740.0526,1566.04734,319.767946,10,0
0,0,40,40,23,49,72,165,114,279,0.000333,0.573803,22,37870.99966,2103.944425,1721.409075,379.162707,13,0
1,0,9,10,21,23,44,68,31,99,0.000333,0.180161,10,5404.837302,300.268739,540.48373,196.280591,9,0
1,0,9,10,21,23,44,68,31,99,0.000333,0.180161,10,5404.837302,300.268739,540.48373,196.280591,9,0
1,0,17,18,21,29,50,96,43,139,0.000333,0.261499,10,7844.960104,435.831117,784.49601,233.120115,13,0
1,0,17,18,21,29,50,96,43,139,0.000333,0.261499,10,7844.960104,435.831117,784.49601,233.120115,13,0
0,0,27,27,22,43,65,167,100,267,0.000333,0.535991,22,35375.38853,1965.299363,1607.972206,331.43688,9,0
0,0,32,32,22,44,66,198,125,323,0.000333,0.65078,22,42951.46461,2386.192478,1952.339301,338.322487,13,0
0,0,56,56,31,72,103,331,208,539,0.000333,1.201341,30,108120.7135,6006.706307,3604.023784,597.814686,17,0
0,0,33,33,25,49,74,203,131,334,0.000333,0.691319,24,49774.97818,2765.276565,2073.957424,391.217187,12,0
0,0,55,55,31,71,102,328,206,534,0.000333,1.187692,30,106892.254,5938.458554,3563.075133,590.212131,17,0
0,0,32,32,25,48,73,200,129,329,0.000333,0.678817,24,48874.85472,2715.269706,2036.45228,384.174605,12,0
0,0,11,11,17,24,41,63,45,108,0.000333,0.192872,8,4628.924932,257.162496,578.615616,179.525968,6,0
0,0,16,16,17,24,41,94,70,164,0.000333,0.29288,16,14058.21646,781.012026,878.638529,179.525968,10,0
0,0,42,42,22,50,72,194,128,322,0.000333,0.662239,22,43707.74871,2428.208262,1986.71585,380.300305,8,0
0,0,76,76,27,74,101,329,219,548,0.000333,1.216233,26,94866.19721,5270.344289,3648.699893,587.881512,13,0
0,0,11,11,16,19,35,39,33,72,0.000333,0.123103,8,2954.467018,164.137057,369.308377,144.710623,5,0
0,0,27,27,22,39,61,94,84,178,0.000333,0.35189,22,23224.76741,1290.264856,1055.671246,304.238182,9,0
0,0,6,6,11,13,24,19,20,39,0.000333,0.059605,5,894.067688,49.670427,178.813538,86.159464,2,0
1,0,5,6,10,10,20,15,12,27,0.000333,0.038897,5,583.460293,32.414461,116.692059,66.438562,2,0
1,0,7,8,13,17,30,25,21,46,0.000333,0.075239,6,1354.301804,75.238989,225.716967,117.592585,2,0
1,0,8,9,16,21,37,46,26,72,0.000333,0.125027,8,3000.645139,166.702508,375.080642,156.238666,4,0
1,0,39,40,29,42,71,174,127,301,0.000333,0.617025,42,77745.10309,4319.172394,1851.073883,367.358781,17,0
1,0,42,43,29,47,76,188,140,328,0.000333,0.683107,28,57380.96628,3187.83146,2049.320224,401.947125,17,0
1,0,4,5,13,10,23,23,16,39,0.000333,0.058806,6,1058.513498,58.806305,176.418916,81.324997,2,0
1,0,4,5,13,10,23,23,16,39,0.000333,0.058806,6,1058.513498,58.806305,176.418916,81.324997,2,0
1,0,4,5,13,10,23,23,16,39,0.000333,0.058806,6,1058.513498,58.806305,176.418916,81.324997,2,0
1,0,4,5,13,10,23,23,16,39,0.000333,0.058806,6,1058.513498,58.806305,176.418916,81.324997,2,0
1,0,4,5,13,10,23,23,16,39,0.000333,0.058806,6,1058.513498,58.806305,176.418916,81.324997,2,0
1,0,4,5,13,10,23,23,16,39,0.000333,0.058806,6,1058.513498,58.806305,176.418916,81.324997,2,0
1,0,3,4,16,9,25,42,13,55,0.000333,0.085137,8,2043.296724,113.516485,255.41209,92.529325,2,0
1,0,19,20,24,38,62,98,69,167,0.000333,0.33145,12,11932.20941,662.900523,994.350784,309.460346,5,0
1,0,20,21,24,40,64,109,75,184,0.000333,0.368,12,13248,736,1104,322.916224,6,0
1,0,20,21,24,40,64,105,73,178,0.000333,0.356,12,12816,712,1068,322.916224,6,0
1,0,26,27,21,30,51,105,74,179,0.000333,0.338455,20,20307.28272,1128.182374,1015.364136,239.445384,10,0
1,0,17,18,21,27,48,68,49,117,0.000333,0.217814,10,6534.406126,363.022563,653.440613,220.620628,6,0
1,0,9,10,17,18,35,37,25,62,0.000333,0.106005,8,2544.124376,141.340243,318.015547,144.545518,3,0
1,0,9,10,16,18,34,36,27,63,0.000333,0.106837,8,2564.081272,142.44896,320.510159,139.05865,2,0
1,0,19,20,24,39,63,108,73,181,0.000333,0.360629,12,12982.65199,721.258444,1081.887666,316.169787,6,0
1,0,19,20,24,39,63,104,71,175,0.000333,0.348675,12,12552.28784,697.349324,1046.023987,316.169787,6,0
1,0,7,8,16,17,33,30,22,52,0.000333,0.087436,8,2098.467954,116.581553,262.308494,133.486868,2,0
1,0,7,8,16,17,33,30,22,52,0.000333,0.087436,8,2098.467954,116.581553,262.308494,133.486868,2,0
1,0,8,9,17,17,34,36,23,59,0.000333,0.100053,8,2401.282461,133.404581,300.160308,138.973737,3,0
1,0,8,9,16,17,33,35,25,60,0.000333,0.100888,8,2421.309177,134.517177,302.663647,133.486868,2,0
1,0,19,20,24,38,62,98,69,167,0.000333,0.33145,12,11932.20941,662.900523,994.350784,309.460346,5,0
1,0,20,21,24,40,64,109,75,184,0.000333,0.368,12,13248,736,1104,322.916224,6,0
1,0,20,21,24,40,64,105,73,178,0.000333,0.356,12,12816,712,1068,322.916224,6,0
1,0,26,27,21,30,51,105,74,179,0.000333,0.338455,20,20307.28272,1128.182374,1015.364136,239.445384,10,0
1,0,17,18,21,27,48,68,49,117,0.000333,0.217814,10,6534.406126,363.022563,653.440613,220.620628,6,0
1,0,9,10,17,18,35,37,25,62,0.000333,0.106005,8,2544.124376,141.340243,318.015547,144.545518,3,0
1,0,9,10,16,18,34,36,27,63,0.000333,0.106837,8,2564.081272,142.44896,320.510159,139.05865,2,0
1,0,18,19,24,37,61,97,67,164,0.000333,0.324214,12,11671.69108,648.427282,972.640923,302.788875,5,0
1,0,19,20,24,39,63,104,71,175,0.000333,0.348675,12,12552.28784,697.349324,1046.023987,316.169787,6,0
1,0,7,8,16,17,33,30,22,52,0.000333,0.087436,8,2098.467954,116.581553,262.308494,133.486868,2,0
1,0,7,8,16,17,33,30,22,52,0.000333,0.087436,8,2098.467954,116.581553,262.308494,133.486868,2,0
1,0,8,9,17,17,34,36,23,59,0.000333,0.100053,8,2401.282461,133.404581,300.160308,138.973737,3,0
1,0,8,9,16,17,33,35,25,60,0.000333,0.100888,8,2421.309177,134.517177,302.663647,133.486868,2,0
1,0,19,20,24,38,62,98,69,167,0.000333,0.33145,12,11932.20941,662.900523,994.350784,309.460346,5,0
1,0,20,21,24,40,64,109,75,184,0.000333,0.368,12,13248,736,1104,322.916224,6,0
1,0,20,21,24,40,64,105,73,178,0.000333,0.356,12,12816,712,1068,322.916224,6,0
1,0,26,27,21,30,51,105,74,179,0.000333,0.338455,20,20307.28272,1128.182374,1015.364136,239.445384,10,0
1,0,17,18,21,27,48,68,49,117,0.000333,0.217814,10,6534.406126,363.022563,653.440613,220.620628,6,0
1,0,9,10,17,18,35,37,25,62,0.000333,0.106005,8,2544.124376,141.340243,318.015547,144.545518,3,0
1,0,9,10,16,18,34,36,27,63,0.000333,0.106837,8,2564.081272,142.44896,320.510159,139.05865,2,0
1,0,18,19,24,37,61,97,67,164,0.000333,0.324214,12,11671.69108,648.427282,972.640923,302.788875,5,0
1,0,19,20,24,39,63,108,73,181,0.000333,0.360629,12,12982.65199,721.258444,1081.887666,316.169787,6,0
1,0,7,8,16,17,33,30,22,52,0.000333,0.087436,8,2098.467954,116.581553,262.308494,133.486868,2,0
1,0,7,8,16,17,33,30,22,52,0.000333,0.087436,8,2098.467954,116.581553,262.308494,133.486868,2,0
1,0,8,9,17,17,34,36,23,59,0.000333,0.100053,8,2401.282461,133.404581,300.160308,138.973737,3,0
1,0,8,9,16,17,33,35,25,60,0.000333,0.100888,8,2421.309177,134.517177,302.663647,133.486868,2,0
1,0,19,20,24,38,62,98,69,167,0.000333,0.33145,12,11932.20941,662.900523,994.350784,309.460346,5,0
1,0,20,21,24,40,64,109,75,184,0.000333,0.368,12,13248,736,1104,322.916224,6,0
1,0,20,21,24,40,64,105,73,178,0.000333,0.356,12,12816,712,1068,322.916224,6,0
1,0,26,27,21,30,51,105,74,179,0.000333,0.338455,20,20307.28272,1128.182374,1015.364136,239.445384,10,0
1,0,17,18,21,27,48,68,49,117,0.000333,0.217814,10,6534.406126,363.022563,653.440613,220.620628,6,0
1,0,9,10,17,18,35,37,25,62,0.000333,0.106005,8,2544.124376,141.340243,318.015547,144.545518,3,0
1,0,9,10,16,18,34,36,27,63,0.000333,0.106837,8,2564.081272,142.44896,320.510159,139.05865,2,0
1,0,18,19,24,37,61,97,67,164,0.000333,0.324214,12,11671.69108,648.427282,972.640923,302.788875,5,0
1,0,19,20,24,39,63,108,73,181,0.000333,0.360629,12,12982.65199,721.258444,1081.887666,316.169787,6,0
1,0,19,20,24,39,63,104,71,175,0.000333,0.348675,12,12552.28784,697.349324,1046.023987,316.169787,6,0
1,0,7,8,16,17,33,30,22,52,0.000333,0.087436,8,2098.467954,116.581553,262.308494,133.486868,2,0
1,0,8,9,17,17,34,36,23,59,0.000333,0.100053,8,2401.282461,133.404581,300.160308,138.973737,3,0
1,0,8,9,16,17,33,35,25,60,0.000333,0.100888,8,2421.309177,134.517177,302.663647,133.486868,2,0
1,0,9,10,11,14,25,26,25,51,0.000333,0.078946,5,1184.183328,65.787963,236.836666,91.356717,6,0
1,0,8,9,15,22,37,32,28,60,0.000333,0.104189,7,2187.970414,121.553912,312.567202,156.710855,4,0
1,0,7,8,11,14,25,19,18,37,0.000333,0.057274,5,859.113395,47.728522,171.822679,91.356717,4,0
1,0,8,9,15,22,37,32,28,60,0.000333,0.104189,7,2187.970414,121.553912,312.567202,156.710855,4,0
1,0,9,10,15,23,38,36,31,67,0.000333,0.117204,7,2461.278004,136.737667,351.611143,162.645284,4,0
1,0,12,13,18,20,38,48,36,84,0.000333,0.146942,9,3967.4332,220.412956,440.825911,161.497212,6,0
1,0,12,13,18,20,38,48,36,84,0.000333,0.146942,9,3967.4332,220.412956,440.825911,161.497212,6,0
1,0,11,12,16,19,35,40,31,71,0.000333,0.121393,8,2913.432754,161.857375,364.179094,144.710623,6,0
1,0,10,11,16,17,33,36,27,63,0.000333,0.105932,8,2542.374636,141.243035,317.79683,133.486868,4,0
1,0,19,20,24,38,62,98,69,167,0.000333,0.33145,12,11932.20941,662.900523,994.350784,309.460346,5,0
1,0,20,21,24,40,64,109,75,184,0.000333,0.368,12,13248,736,1104,322.916224,6,0
1,0,20,21,24,40,64,105,73,178,0.000333,0.356,12,12816,712,1068,322.916224,6,0
1,0,26,27,21,30,51,105,74,179,0.000333,0.338455,20,20307.28272,1128.182374,1015.364136,239.445384,10,0
1,0,17,18,21,27,48,68,49,117,0.000333,0.217814,10,6534.406126,363.022563,653.440613,220.620628,6,0
1,0,9,10,17,18,35,37,25,62,0.000333,0.106005,8,2544.124376,141.340243,318.015547,144.545518,3,0
1,0,9,10,16,18,34,36,27,63,0.000333,0.106837,8,2564.081272,142.44896,320.510159,139.05865,2,0
1,0,18,19,24,37,61,97,67,164,0.000333,0.324214,12,11671.69108,648.427282,972.640923,302.788875,5,0
1,0,19,20,24,39,63,108,73,181,0.000333,0.360629,12,12982.65199,721.258444,1081.887666,316.169787,6,0
1,0,19,20,24,39,63,104,71,175,0.000333,0.348675,12,12552.28784,697.349324,1046.023987,316.169787,6,0
1,0,7,8,16,17,33,30,22,52,0.000333,0.087436,8,2098.467954,116.581553,262.308494,133.486868,2,0
1,0,8,9,17,17,34,36,23,59,0.000333,0.100053,8,2401.282461,133.404581,300.160308,138.973737,3,0
1,0,8,9,16,17,33,35,25,60,0.000333,0.100888,8,2421.309177,134.517177,302.663647,133.486868,2,0
1,0,9,10,11,14,25,26,25,51,0.000333,0.078946,5,1184.183328,65.787963,236.836666,91.356717,6,0
1,0,8,9,15,22,37,32,28,60,0.000333,0.104189,7,2187.970414,121.553912,312.567202,156.710855,4,0
1,0,7,8,11,14,25,19,18,37,0.000333,0.057274,5,859.113395,47.728522,171.822679,91.356717,4,0
1,0,8,9,15,22,37,32,28,60,0.000333,0.104189,7,2187.970414,121.553912,312.567202,156.710855,4,0
1,0,8,9,15,22,37,32,28,60,0.000333,0.104189,7,2187.970414,121.553912,312.567202,156.710855,4,0
1,0,12,13,18,20,38,54,42,96,0.000333,0.167934,18,9068.418743,503.801041,503.801041,161.497212,6,0
1,0,12,13,18,20,38,54,42,96,0.000333,0.167934,18,9068.418743,503.801041,503.801041,161.497212,6,0
1,0,11,12,16,19,35,46,37,83,0.000333,0.14191,8,3405.843923,189.213551,425.73049,144.710623,6,0
1,0,10,11,16,17,33,42,33,75,0.000333,0.12611,8,3026.636472,168.146471,378.329559,133.486868,4,0
1,0,19,20,24,38,62,98,69,167,0.000333,0.33145,12,11932.20941,662.900523,994.350784,309.460346,5,0
1,0,20,21,24,40,64,109,75,184,0.000333,0.368,12,13248,736,1104,322.916224,6,0
1,0,20,21,24,40,64,105,73,178,0.000333,0.356,12,12816,712,1068,322.916224,6,0
1,0,26,27,21,30,51,105,74,179,0.000333,0.338455,20,20307.28272,1128.182374,1015.364136,239.445384,10,0
1,0,17,18,21,27,48,68,49,117,0.000333,0.217814,10,6534.406126,363.022563,653.440613,220.620628,6,0
1,0,9,10,17,18,35,37,25,62,0.000333,0.106005,8,2544.124376,141.340243,318.015547,144.545518,3,0
1,0,9,10,16,18,34,36,27,63,0.000333,0.106837,8,2564.081272,142.44896,320.510159,139.05865,2,0
1,0,18,19,24,37,61,97,67,164,0.000333,0.324214,12,11671.69108,648.427282,972.640923,302.788875,5,0
1,0,19,20,24,39,63,108,73,181,0.000333,0.360629,12,12982.65199,721.258444,1081.887666,316.169787,6,0
1,0,19,20,24,39,63,104,71,175,0.000333,0.348675,12,12552.28784,697.349324,1046.023987,316.169787,6,0
1,0,7,8,16,17,33,30,22,52,0.000333,0.087436,8,2098.467954,116.581553,262.308494,133.486868,2,0
1,0,7,8,16,17,33,30,22,52,0.000333,0.087436,8,2098.467954,116.581553,262.308494,133.486868,2,0
1,0,8,9,16,17,33,35,25,60,0.000333,0.100888,8,2421.309177,134.517177,302.663647,133.486868,2,0
1,0,19,20,24,38,62,98,69,167,0.000333,0.33145,12,11932.20941,662.900523,994.350784,309.460346,5,0
1,0,20,21,24,40,64,109,75,184,0.000333,0.368,12,13248,736,1104,322.916224,6,0
1,0,20,21,24,40,64,105,73,178,0.000333,0.356,12,12816,712,1068,322.916224,6,0
1,0,26,27,21,30,51,105,74,179,0.000333,0.338455,20,20307.28272,1128.182374,1015.364136,239.445384,10,0
1,0,17,18,21,27,48,68,49,117,0.000333,0.217814,10,6534.406126,363.022563,653.440613,220.620628,6,0
1,0,9,10,17,18,35,37,25,62,0.000333,0.106005,8,2544.124376,141.340243,318.015547,144.545518,3,0
1,0,9,10,16,18,34,36,27,63,0.000333,0.106837,8,2564.081272,142.44896,320.510159,139.05865,2,0
1,0,18,19,24,37,61,97,67,164,0.000333,0.324214,12,11671.69108,648.427282,972.640923,302.788875,5,0
1,0,19,20,24,39,63,108,73,181,0.000333,0.360629,12,12982.65199,721.258444,1081.887666,316.169787,6,0
1,0,19,20,24,39,63,104,71,175,0.000333,0.348675,12,12552.28784,697.349324,1046.023987,316.169787,6,0
1,0,7,8,16,17,33,30,22,52,0.000333,0.087436,8,2098.467954,116.581553,262.308494,133.486868,2,0
1,0,7,8,16,17,33,30,22,52,0.000333,0.087436,8,2098.467954,116.581553,262.308494,133.486868,2,0
1,0,8,9,17,17,34,36,23,59,0.000333,0.100053,8,2401.282461,133.404581,300.160308,138.973737,3,0
0,0,11,11,14,24,38,48,41,89,0.000333,0.155689,7,3269.458841,181.636602,467.065549,163.342069,4,0
0,0,17,17,17,35,52,88,75,163,0.000333,0.309724,16,14866.74679,825.930377,929.171674,249.011774,4,0
0,0,11,11,14,24,38,48,41,89,0.000333,0.155689,7,3269.458841,181.636602,467.065549,163.342069,4,0
0,0,17,17,17,35,52,88,75,163,0.000333,0.309724,16,14866.74679,825.930377,929.171674,249.011774,4,0
0,0,14,14,14,30,44,59,49,108,0.000333,0.19654,7,4127.330304,229.296128,589.618615,200.509687,6,0
0,0,14,14,14,30,44,59,49,108,0.000333,0.19654,7,4127.330304,229.296128,589.618615,200.509687,6,0
0,0,13,13,13,28,41,55,46,101,0.000333,0.180371,6,3246.676515,180.370917,541.112752,182.711654,6,0
0,0,15,15,23,29,52,94,57,151,0.000333,0.286922,11,9468.430372,526.02391,860.766397,244.923374,10,0
0,0,17,17,23,29,52,104,63,167,0.000333,0.317324,22,20943.41552,1163.523085,951.973433,244.923374,10,0
0,0,17,17,23,29,52,104,63,167,0.000333,0.317324,22,20943.41552,1163.523085,951.973433,244.923374,10,0
0,0,24,24,25,42,67,132,85,217,0.000333,0.43878,24,31592.1925,1755.121806,1316.341354,342.573737,15,0
0,0,24,24,25,42,67,132,85,217,0.000333,0.43878,24,31592.1925,1755.121806,1316.341354,342.573737,15,0
0,0,18,18,18,35,53,84,73,157,0.000333,0.299761,18,16187.10321,899.283511,899.283511,254.583556,6,0
0,0,17,17,18,33,51,76,67,143,0.000333,0.270386,18,14600.82283,811.156824,811.156824,241.523656,6,0
0,0,6,6,16,18,34,44,29,73,0.000333,0.123795,8,2971.078299,165.059906,371.384787,139.05865,8,0
0,0,73,73,29,71,100,420,322,742,0.000333,1.643247,56,276065.5124,15336.97291,4929.741293,577.513494,15,0
0,0,4,4,16,15,31,26,19,45,0.000333,0.074313,8,1783.510672,99.083926,222.938834,122.603359,5,0
1,0,6,7,13,82,95,310,196,506,0.000333,1.108116,12,39892.16325,2216.231292,3324.346938,569.424981,1,0
1,0,3,4,12,85,97,173,165,338,0.000333,0.74359,6,13384.62324,743.59018,2230.770541,587.81778,5,0
1,0,19,20,21,43,64,101,74,175,0.000333,0.35,10,10500,583.333333,1050,325.56805,8,0
1,0,13,14,15,33,48,63,55,118,0.000333,0.219675,7,4613.179026,256.287724,659.025575,225.068365,7,0
1,0,22,23,15,40,55,93,96,189,0.000333,0.364226,14,15297.4778,849.859878,1092.676986,271.480483,6,0
1,0,21,22,15,44,59,93,93,186,0.000333,0.364724,14,15318.4025,851.022361,1094.171607,298.81835,6,0
1,0,22,23,15,40,55,93,96,189,0.000333,0.364226,14,15297.4778,849.859878,1092.676986,271.480483,6,0
1,0,6,7,14,35,49,66,48,114,0.000333,0.213359,7,4480.538456,248.918803,640.076922,232.827875,2,0
1,0,3,4,12,8,20,19,10,29,0.000333,0.041779,6,752.015489,41.778638,125.335915,67.01955,1,0
1,0,22,23,19,49,68,116,84,200,0.000333,0.405831,9,10957.43311,608.746284,1217.492568,355.831405,3,0
1,0,22,23,20,54,74,143,100,243,0.000333,0.502966,10,15088.97168,838.276204,1508.897168,397.202487,3,0
1,0,22,23,19,49,68,117,86,203,0.000333,0.411918,9,11121.79461,617.877478,1235.754957,355.831405,3,0
1,0,22,23,19,48,67,116,84,200,0.000333,0.404406,9,10918.96054,606.608919,1213.217838,348.788823,3,0
1,0,18,19,16,40,56,82,63,145,0.000333,0.280689,8,6736.53171,374.251762,842.066464,276.877124,3,0
1,0,8,9,12,14,26,25,17,42,0.000333,0.065806,6,1184.510809,65.806156,197.418468,96.322519,4,0
1,0,27,28,17,50,67,182,112,294,0.000333,0.594477,16,28534.88355,1585.271308,1783.430222,351.679678,16,0
1,0,24,25,17,47,64,168,103,271,0.000333,0.542,16,26016,1445.333333,1626,330.552544,15,0
1,0,23,24,15,39,54,167,103,270,0.000333,0.51794,14,21753.47476,1208.526375,1553.819626,264.734045,14,0
1,0,19,20,15,36,51,138,86,224,0.000333,0.423541,14,17788.72587,988.262548,1270.623277,244.720659,12,0
1,0,17,18,15,37,52,121,76,197,0.000333,0.374329,14,15721.81274,873.434041,1122.986624,251.353133,11,0
1,0,9,10,15,27,42,68,44,112,0.000333,0.201313,7,4227.576859,234.865381,603.939551,186.985321,6,0
1,0,18,19,15,38,53,142,86,228,0.000333,0.435322,14,18283.52209,1015.751227,1305.965864,258.024604,13,0
1,0,18,19,15,40,55,148,89,237,0.000333,0.456727,14,19182.55153,1065.697307,1370.182252,271.480483,13,0
1,0,29,30,21,42,63,176,123,299,0.000333,0.595736,20,35744.13394,1985.785219,1787.206697,318.715998,6,0
1,0,29,30,21,42,63,176,123,299,0.000333,0.595736,20,35744.13394,1985.785219,1787.206697,318.715998,6,0
1,0,21,22,19,35,54,141,100,241,0.000333,0.462309,18,24964.70198,1386.927888,1386.927888,260.235528,3,0
1,0,21,22,19,35,54,141,100,241,0.000333,0.462309,18,24964.70198,1386.927888,1386.927888,260.235528,3,0
0,0,29,29,22,45,67,209,167,376,0.000333,0.760283,33,75268.03468,4181.557482,2280.849536,345.240885,16,0
0,0,21,21,20,42,62,170,136,306,0.000333,0.607328,30,54659.52213,3036.640118,1821.984071,312.915894,15,0
0,0,21,21,20,42,62,170,136,306,0.000333,0.607328,30,54659.52213,3036.640118,1821.984071,312.915894,15,0
0,0,21,21,20,42,62,170,136,306,0.000333,0.607328,30,54659.52213,3036.640118,1821.984071,312.915894,15,0
0,0,21,21,20,41,61,170,136,306,0.000333,0.604935,30,54444.16876,3024.676042,1814.805625,306.098194,15,0
0,0,21,21,20,41,61,170,136,306,0.000333,0.604935,30,54444.16876,3024.676042,1814.805625,306.098194,15,0
0,0,21,21,20,41,61,170,136,306,0.000333,0.604935,30,54444.16876,3024.676042,1814.805625,306.098194,15,0
0,0,21,21,20,39,59,176,142,318,0.000333,0.62356,30,56120.41469,3117.800816,1870.68049,292.569248,15,0
0,0,21,21,20,39,59,176,142,318,0.000333,0.62356,30,56120.41469,3117.800816,1870.68049,292.569248,15,0
0,0,21,21,20,39,59,176,142,318,0.000333,0.62356,30,56120.41469,3117.800816,1870.68049,292.569248,15,0
0,0,55,55,29,77,106,299,231,530,0.000333,1.188599,42,149763.5093,8320.194962,3565.797841,623.424012,26,0
0,0,56,56,29,79,108,306,237,543,0.000333,1.222635,42,154051.9644,8558.442465,3667.903914,638.880128,26,0
0,0,46,46,29,62,91,220,169,389,0.000333,0.843844,28,70882.89922,3937.938846,2531.532115,510.04162,18,0
0,0,101,101,34,112,146,554,465,1019,0.000333,2.442144,68,498197.3233,27677.62907,7326.431225,935.397488,36,0
0,0,101,101,34,113,147,554,465,1019,0.000333,2.445489,68,498879.6961,27715.53867,7336.466119,943.653959,36,0
0,0,56,56,31,77,108,303,235,538,0.000333,1.211376,45,163535.8264,9085.32369,3634.129476,636.122649,27,0
0,0,57,57,31,79,110,310,241,551,0.000333,1.24551,45,168143.8141,9341.323005,3736.529202,651.578765,27,0
0,0,47,47,31,62,93,224,173,397,0.000333,0.865349,30,77881.38144,4326.743413,2596.046048,522.740257,19,0
0,0,102,102,34,112,146,558,469,1027,0.000333,2.461317,68,502108.5879,27894.92155,7383.949822,935.397488,37,0
0,0,102,102,34,112,146,558,469,1027,0.000333,2.461317,68,502108.5879,27894.92155,7383.949822,935.397488,37,0
0,0,20,20,21,39,60,109,85,194,0.000333,0.381979,20,22918.73551,1273.263084,1145.936776,298.369352,7,0
0,0,18,18,21,39,60,99,78,177,0.000333,0.348507,20,20910.39271,1161.688484,1045.519635,298.369352,6,0
0,0,103,103,33,114,147,549,458,1007,0.000333,2.41669,64,464004.4833,25778.02685,7250.070051,945.414468,35,0
0,0,97,97,32,110,142,519,435,954,0.000333,2.27362,48,327401.2201,18188.95667,6820.858752,905.949568,34,0
0,0,103,103,33,114,147,549,458,1007,0.000333,2.41669,64,464004.4833,25778.02685,7250.070051,945.414468,35,0
0,0,97,97,32,110,142,519,435,954,0.000333,2.27362,48,327401.2201,18188.95667,6820.858752,905.949568,34,0
0,0,103,103,33,114,147,549,458,1007,0.000333,2.41669,64,464004.4833,25778.02685,7250.070051,945.414468,35,0
0,0,97,97,32,110,142,519,435,954,0.000333,2.27362,48,327401.2201,18188.95667,6820.858752,905.949568,34,0
0,0,103,103,33,114,147,549,458,1007,0.000333,2.41669,64,464004.4833,25778.02685,7250.070051,945.414468,35,0
0,0,97,97,32,110,142,519,435,954,0.000333,2.27362,48,327401.2201,18188.95667,6820.858752,905.949568,34,0